First_pokemon_HP,First_pokemon_ATK,First_pokemon_DEF,First_pokemon_SP_ATK,First_pokemon_DP_DEF,First_pokemon_Speed,First_pokemon_STATS_SUM,First_pokemon_RATIO,Second_pokemon_HP,Second_pokemon_ATK,Second_pokemon_DEF,Second_pokemon_SP_ATK,Second_pokemon_DP_DEF,Second_pokemon_Speed,Second_pokemon_STATS_SUM,Second_pokemon_RATIO,Relation
79,115,70,125,80,111,580,0.8468468468468469,70,75,80,135,80,135,575,0.917910447761194,0.5
150,100,120,100,120,90,680,0.6666666666666666,100,73,83,73,83,55,467,0.371900826446281,1.0
100,110,90,85,90,60,535,0.47794117647058826,115,140,130,55,55,40,535,0.4519230769230769,8.0
79,103,120,135,115,78,630,0.5763888888888888,95,145,130,120,90,120,700,0.9398496240601504,0.5
80,52,50,90,50,89,411,0.6666666666666666,105,105,75,65,100,50,500,0.37593984962406013,0.5
106,190,100,154,100,130,780,0.9259259259259259,70,80,70,80,70,110,480,0.6594202898550725,0.0
95,135,80,110,80,100,600,0.8248175182481752,50,50,95,40,50,35,320,0.20279720279720279,1.0
70,110,70,115,70,90,525,0.75,65,90,120,85,70,60,490,0.43410852713178294,0.5
78,84,78,109,85,100,534,0.8620689655172413,70,140,70,110,65,105,560,0.95,0.5
35,35,40,35,55,50,250,0.40336134453781514,100,110,90,85,90,60,535,0.47794117647058826,4.0
78,130,111,130,85,100,634,0.8561151079136691,90,93,55,70,55,55,418,0.3819444444444444,0.5
60,80,50,40,40,30,300,0.15328467153284672,40,55,30,30,30,85,270,0.688,1.0
61,90,45,50,50,160,456,0.9230769230769231,50,180,20,180,20,150,600,0.9029850746268657,2.0
68,75,53,83,113,60,452,0.45384615384615384,82,121,119,69,59,71,521,0.5394736842105263,2.0
60,40,80,60,45,40,325,0.23529411764705882,100,100,100,100,100,100,600,0.8758169934640523,0.125
80,95,82,60,82,75,474,0.6,50,95,90,95,90,180,600,0.9172413793103448,1.0
56,61,65,48,45,38,313,0.17567567567567569,115,140,130,55,55,40,535,0.4519230769230769,4.0
50,75,75,65,65,50,380,0.4049586776859504,30,45,55,70,55,85,340,0.5633802816901409,1.0
50,65,107,105,107,86,520,0.7758620689655172,100,180,160,150,90,90,770,0.7520661157024794,0.0
95,110,80,70,80,50,485,0.37209302325581395,62,55,52,109,94,109,481,0.7833333333333333,1.0
65,130,60,95,110,65,525,0.5303030303030303,75,90,50,110,80,95,500,0.7985611510791367,0.5
60,45,50,90,80,70,395,0.625,60,130,80,60,60,70,460,0.5153846153846153,4.0
55,68,64,45,55,31,318,0.11666666666666667,165,75,80,40,45,65,470,0.5151515151515151,2.0
135,85,40,40,85,5,390,0.6864406779661016,70,75,80,135,80,135,575,0.917910447761194,1.0
73,100,60,100,60,65,458,0.42657342657342656,80,185,115,40,105,75,600,0.6230769230769231,1.0
35,65,35,65,35,65,300,0.46621621621621623,20,10,55,15,20,80,200,0.17985611510791366,0.5
100,100,80,60,60,50,450,0.3050847457627119,105,180,100,180,100,115,780,0.9477611940298507,0.0
170,90,45,90,45,60,500,0.427536231884058,100,103,75,120,75,127,600,0.940677966101695,0.5
55,95,55,35,75,115,430,0.9380530973451328,90,100,60,90,60,80,480,0.6422764227642277,1.0
44,48,65,50,64,43,314,0.1623931623931624,55,55,45,63,45,45,308,0.25,0.5
35,45,160,30,45,70,385,0.48148148148148145,108,170,115,120,95,92,700,0.7083333333333334,0.5
75,95,125,45,75,95,510,0.8257575757575758,56,61,65,48,45,38,313,0.17567567567567569,1.0
70,130,100,55,80,65,500,0.608,50,120,53,35,110,87,455,0.640625,0.5
90,132,105,132,105,30,594,0.4246575342465753,75,55,70,55,95,110,460,0.8444444444444444,1.0
65,76,84,54,96,105,480,0.9008264462809917,45,95,50,40,50,75,355,0.54,0.5
60,60,40,65,45,35,305,0.15833333333333333,45,60,30,80,50,65,330,0.4603174603174603,1.0
64,66,68,81,76,50,405,0.25190839694656486,30,80,90,55,45,55,355,0.4295774647887324,1.0
70,110,80,55,80,105,500,0.8794326241134752,70,80,50,35,35,35,305,0.14,1.0
70,60,62,80,82,60,414,0.4375,60,40,60,40,60,35,295,0.18055555555555555,4.0
60,48,45,43,90,42,328,0.21897810218978103,80,120,80,120,80,100,580,0.8478260869565217,1.0
70,120,40,95,40,95,460,0.8106060606060606,65,83,57,95,85,105,490,0.8914728682170543,1.0
60,60,60,35,35,30,280,0.11194029850746269,45,35,50,70,50,30,280,0.15753424657534246,1.0
44,38,39,61,79,42,303,0.2251655629139073,45,30,35,20,20,45,195,0.14782608695652175,1.0
45,55,39,35,39,42,255,0.18518518518518517,80,85,95,30,30,25,345,0.2857142857142857,0.5
90,100,60,90,60,80,480,0.6422764227642277,125,170,100,120,90,95,700,0.77,0.5
65,63,45,45,45,45,308,0.2595419847328244,60,82,45,45,45,74,351,0.5752212389380531,1.0
45,53,70,40,60,42,310,0.25735294117647056,68,125,65,65,115,80,518,0.6277372262773723,1.0
55,45,45,25,25,15,210,0.048,75,90,140,60,60,40,465,0.3008130081300813,1.0
65,95,75,55,55,85,430,0.6933333333333334,76,65,45,92,42,91,411,0.7449664429530202,1.0
40,65,95,60,45,35,340,0.13986013986013987,90,130,80,65,85,55,505,0.4396551724137931,1.0
40,45,35,30,40,55,245,0.3793103448275862,55,75,85,25,25,15,280,0.1875,0.25
38,35,35,65,55,50,278,0.2647058823529412,64,165,75,93,83,75,555,0.6587301587301587,1.0
70,55,75,45,65,60,370,0.45901639344262296,55,75,50,40,40,80,340,0.6302521008403361,1.0
60,65,70,85,75,40,395,0.21705426356589147,116,55,85,107,95,29,487,0.06818181818181818,1.0
65,90,115,45,115,58,488,0.5041322314049587,55,75,50,40,40,80,340,0.6302521008403361,1.0
100,100,100,100,100,100,600,0.8778625954198473,70,110,180,60,60,50,530,0.4117647058823529,0.5
105,30,105,140,105,55,540,0.3524590163934426,70,62,67,55,55,56,365,0.38513513513513514,2.0
80,100,80,80,80,100,520,0.9051724137931034,55,84,105,114,75,52,485,0.2890625,1.0
95,23,48,23,48,23,260,0.046153846153846156,55,95,55,35,75,115,430,0.9380530973451328,0.0
90,92,87,75,85,76,505,0.5409836065573771,55,70,45,70,50,60,350,0.45,2.0
60,55,50,40,55,45,305,0.22377622377622378,82,80,86,85,75,72,480,0.6183206106870229,1.0
40,45,65,100,120,90,460,0.5588235294117647,95,155,109,70,130,81,640,0.6788321167883211,0.0
100,134,110,95,100,61,600,0.4057971014492754,80,100,80,80,80,100,520,0.9051724137931034,0.5
65,76,84,54,96,105,480,0.9008264462809917,73,115,60,60,60,90,458,0.6694915254237288,1.0
40,30,30,55,30,85,270,0.4666666666666667,110,80,90,95,90,65,530,0.5033557046979866,0.5
42,52,67,39,56,50,306,0.2868217054263566,90,85,100,95,125,85,580,0.6834532374100719,4.0
70,40,50,55,50,25,290,0.061068702290076333,68,75,53,83,113,60,452,0.45384615384615384,1.0
80,100,80,80,80,100,520,0.9051724137931034,55,55,55,85,55,30,335,0.1320754716981132,1.0
60,85,49,60,49,60,363,0.4444444444444444,40,45,35,65,55,70,310,0.4482758620689655,0.5
59,45,40,35,40,31,250,0.14285714285714285,60,40,80,60,45,40,325,0.23529411764705882,1.0
75,125,230,55,95,30,610,0.3448275862068966,70,80,102,80,102,40,474,0.2677165354330709,0.0
51,65,65,80,75,59,395,0.4365079365079365,70,40,50,55,50,25,290,0.061068702290076333,0.25
75,95,122,58,75,69,494,0.5725806451612904,60,85,49,60,49,60,363,0.4444444444444444,1.0
126,131,95,131,98,99,680,0.8294573643410853,91,72,90,129,90,108,580,0.8925619834710744,2.0
75,75,130,75,130,95,580,0.7479674796747967,40,65,95,60,45,35,340,0.13986013986013987,2.0
59,45,40,35,40,31,250,0.14285714285714285,75,105,75,105,75,45,480,0.3274336283185841,1.0
100,100,100,100,100,100,600,0.831858407079646,100,120,100,150,120,90,680,0.728,1.0
30,42,118,42,88,30,350,0.112,90,50,34,60,44,70,348,0.6283185840707964,2.0
30,42,118,42,88,30,350,0.112,115,45,20,45,25,20,270,0.11538461538461539,0.5
50,65,107,105,107,86,520,0.7272727272727273,67,57,55,77,55,114,425,0.8879310344827587,2.0
60,90,55,90,80,110,485,0.8677685950413223,95,117,184,44,46,28,514,0.2975206611570248,1.0
50,64,50,45,50,41,300,0.22727272727272727,40,27,60,37,50,66,280,0.36220472440944884,0.5
65,100,70,80,80,105,500,0.8666666666666667,50,85,85,55,55,50,380,0.3902439024390244,2.0
50,60,60,60,60,30,320,0.11290322580645161,50,65,107,105,107,86,520,0.6991150442477876,2.0
80,80,50,40,50,25,325,0.176056338028169,95,125,79,60,100,81,540,0.6165413533834586,1.0
56,61,65,48,45,38,313,0.17567567567567569,85,115,80,105,80,50,515,0.3063063063063063,1.0
97,165,60,65,50,58,495,0.3902439024390244,53,54,53,37,46,45,288,0.3090909090909091,1.0
95,145,130,120,90,120,700,0.9398496240601504,60,50,100,85,70,65,430,0.47580645161290325,1.0
71,82,64,64,59,112,452,0.9327731092436975,60,40,60,95,60,55,370,0.4222222222222222,0.0
60,45,50,90,80,70,395,0.625,77,85,51,55,51,65,384,0.5163934426229508,2.0
55,55,45,63,45,45,308,0.25,190,33,58,33,58,33,405,0.13432835820895522,1.0
28,25,25,45,35,40,198,0.16083916083916083,80,120,79,95,79,70,523,0.5833333333333334,1.0
90,55,75,60,75,30,385,0.13970588235294118,70,100,115,30,65,30,410,0.24390243902439024,0.5
71,95,85,110,95,79,535,0.664,60,55,50,40,55,45,305,0.22377622377622378,1.0
70,94,50,94,50,66,424,0.48148148148148145,75,125,75,30,75,85,465,0.625,1.0
130,85,80,85,95,60,535,0.43884892086330934,80,145,150,105,110,110,700,0.8692307692307693,0.5
60,75,85,100,85,115,520,0.8992248062015504,75,75,75,125,95,40,485,0.15671641791044777,0.5
50,45,45,35,35,50,260,0.23529411764705882,55,55,85,65,85,35,380,0.2014388489208633,0.5
70,90,45,15,45,50,315,0.3629032258064516,70,60,62,80,82,60,414,0.4375,2.0
90,70,80,70,95,70,475,0.5190839694656488,100,110,90,85,90,60,535,0.47794117647058826,1.0
55,65,95,95,45,85,440,0.6610169491525424,65,125,100,60,70,70,490,0.6099290780141844,1.0
55,35,50,55,110,85,390,0.6277372262773723,110,78,73,76,71,60,468,0.3333333333333333,1.0
58,64,58,80,65,80,405,0.5423728813559322,50,85,125,85,115,20,480,0.4306569343065693,1.0
78,104,78,159,115,100,634,0.8444444444444444,80,145,150,105,110,110,700,0.8692307692307693,1.0
70,70,70,70,70,70,420,0.5289256198347108,60,62,80,63,80,60,405,0.4336283185840708,1.0
60,85,60,50,50,125,430,0.9090909090909091,65,65,60,130,95,110,525,0.823943661971831,1.0
71,73,88,120,89,59,500,0.43537414965986393,70,100,70,105,75,40,460,0.23214285714285715,4.0
70,90,45,15,45,50,315,0.3629032258064516,60,40,60,95,60,55,370,0.4222222222222222,0.5
20,40,15,35,35,60,205,0.34285714285714286,45,80,100,35,37,28,325,0.3125,1.0
120,120,120,120,120,120,720,0.9344262295081968,65,80,65,35,65,60,370,0.38405797101449274,1.0
55,50,40,40,40,75,300,0.5945945945945946,64,165,75,93,83,75,555,0.6587301587301587,0.0
50,65,107,105,107,86,520,0.7272727272727273,78,84,78,109,85,100,534,0.8620689655172413,1.0
90,120,100,150,120,100,680,0.7718120805369127,50,60,60,60,60,30,320,0.11290322580645161,0.5
60,80,110,50,80,45,425,0.2833333333333333,90,60,70,75,70,45,410,0.23880597014925373,1.0
40,65,40,80,40,65,330,0.5038167938931297,70,94,50,94,50,66,424,0.48148148148148145,1.0
100,100,100,100,100,100,600,0.8805970149253731,45,55,39,35,39,42,255,0.18518518518518517,1.0
70,85,140,85,70,20,470,0.272,40,45,65,100,120,90,460,0.5588235294117647,1.0
100,150,110,95,110,70,635,0.5923076923076923,30,56,35,25,35,72,253,0.48148148148148145,1.0
75,90,140,60,60,40,465,0.3008130081300813,75,95,122,58,75,69,494,0.5725806451612904,1.0
35,55,35,30,30,35,220,0.23684210526315788,70,100,115,30,65,30,410,0.24390243902439024,1.0
84,86,88,111,101,60,530,0.4634146341463415,60,50,50,60,70,50,340,0.28346456692913385,0.125
58,64,58,80,65,80,405,0.609271523178808,60,55,145,75,150,40,525,0.2,1.0
95,124,78,69,71,58,495,0.37398373983739835,60,90,140,50,50,40,430,0.2535211267605634,4.0
66,117,70,40,50,67,410,0.4573643410852713,70,135,105,60,105,20,495,0.5806451612903226,0.5
100,100,100,100,100,100,600,0.831858407079646,65,40,50,125,60,30,370,0.07258064516129033,0.5
126,131,95,131,98,99,680,0.8294573643410853,45,30,15,85,65,65,305,0.36220472440944884,1.0
60,60,40,65,45,35,305,0.15833333333333333,75,103,80,70,80,92,500,0.7933884297520661,1.0
95,110,80,70,80,50,485,0.37209302325581395,35,20,65,40,65,20,245,0.02459016393442623,1.0
61,84,65,70,70,70,420,0.5,80,120,70,110,70,80,530,0.6422764227642277,1.0
77,85,51,55,51,65,384,0.5163934426229508,100,150,140,100,90,90,670,0.7969924812030075,1.0
150,160,100,95,65,100,670,0.8866666666666667,68,72,78,38,42,32,330,0.23809523809523808,1.0
63,120,85,90,55,55,468,0.2809917355371901,105,140,55,30,55,95,480,0.8195488721804511,2.0
108,130,95,80,85,102,600,0.7637795275590551,70,84,70,65,70,51,410,0.2949640287769784,2.0
40,55,30,30,30,85,270,0.688,50,105,79,35,110,76,455,0.6214285714285714,2.0
52,65,50,45,50,38,300,0.27419354838709675,60,48,45,43,90,42,328,0.21897810218978103,2.0
65,75,105,35,65,85,430,0.6940298507462687,90,95,95,70,90,70,510,0.5230769230769231,2.0
100,150,120,120,100,90,680,0.6493506493506493,75,90,50,110,80,95,500,0.7985611510791367,1.0
65,90,122,58,75,84,494,0.71875,60,110,70,60,60,100,460,0.8461538461538461,0.0
35,55,35,30,30,35,220,0.23684210526315788,60,100,115,70,85,90,520,0.7557251908396947,1.0
40,65,95,60,45,35,340,0.13986013986013987,95,125,79,60,100,81,540,0.6165413533834586,1.0
80,92,65,65,80,68,450,0.4824561403508772,70,84,70,65,70,51,410,0.2949640287769784,4.0
55,40,40,65,45,35,280,0.16428571428571428,65,55,115,100,40,60,435,0.3798449612403101,0.5
55,66,44,44,56,85,350,0.6888888888888889,68,85,65,165,135,100,618,0.8083333333333333,1.0
79,100,80,110,90,121,580,0.968,74,48,76,83,81,104,466,0.7322834645669292,1.0
50,150,50,150,50,150,600,0.9339622641509434,45,30,35,20,20,45,195,0.14782608695652175,1.0
55,55,85,65,85,35,380,0.2014388489208633,73,95,62,85,65,85,465,0.6666666666666666,1.0
70,150,140,65,100,75,600,0.55,60,60,60,85,85,85,435,0.631578947368421,0.5
60,60,60,60,60,60,360,0.38095238095238093,104,91,63,91,73,68,490,0.5118110236220472,1.0
30,105,90,25,25,50,325,0.2773722627737226,75,65,55,65,55,69,384,0.43548387096774194,1.0
75,95,122,58,75,69,494,0.5725806451612904,50,20,40,20,40,20,190,0.0962962962962963,0.0
100,100,100,100,100,100,600,0.8758169934640523,71,82,64,64,59,112,452,0.9327731092436975,1.0
91,134,95,100,100,80,600,0.6304347826086957,41,50,37,50,37,66,281,0.5175438596491229,1.0
90,93,55,70,55,55,418,0.3819444444444444,60,130,80,60,60,70,460,0.5153846153846153,2.0
65,90,65,61,61,100,442,0.8373983739837398,45,30,50,55,65,45,290,0.208,1.0
110,65,75,125,85,30,490,0.15,100,150,120,120,100,90,680,0.6493506493506493,1.0
85,97,66,105,66,65,484,0.47107438016528924,60,75,100,55,80,50,420,0.3088235294117647,2.0
60,100,115,70,85,90,520,0.7557251908396947,65,55,115,100,40,60,435,0.3798449612403101,1.0
55,40,50,65,85,40,335,0.3181818181818182,62,48,54,63,60,68,355,0.5178571428571429,2.0
170,90,45,90,45,60,500,0.427536231884058,65,110,130,60,65,95,525,0.8278145695364238,0.5
75,70,90,70,105,80,490,0.656,70,85,65,105,85,120,530,0.9262295081967213,2.0
75,87,63,87,63,98,473,0.865546218487395,60,60,50,40,50,75,335,0.5882352941176471,1.0
80,105,105,105,105,80,580,0.5939849624060151,10,55,25,35,45,95,265,0.5396825396825397,2.0
45,20,50,60,120,50,345,0.24074074074074073,100,150,90,180,160,90,770,0.7348484848484849,0.5
75,95,60,65,60,115,470,0.8778625954198473,20,10,230,10,230,5,505,0.0,0.5
120,100,85,30,85,45,465,0.22448979591836735,45,63,37,65,55,95,360,0.8055555555555556,1.0
90,92,75,92,85,60,494,0.49586776859504134,95,110,80,70,80,50,485,0.37209302325581395,0.5
65,70,60,65,65,115,440,0.8583333333333333,71,95,85,110,95,79,535,0.664,1.0
25,20,15,105,55,90,310,0.32407407407407407,84,86,88,111,101,60,530,0.4634146341463415,0.5
80,82,100,83,100,80,525,0.6821705426356589,100,128,90,77,77,128,600,0.959349593495935,1.0
105,95,80,40,80,90,490,0.753968253968254,60,150,50,150,50,60,520,0.5,0.0
45,67,60,35,50,63,320,0.5128205128205128,60,62,80,63,80,60,405,0.4336283185840708,0.5
80,75,150,75,150,50,580,0.30973451327433627,64,88,50,88,50,106,446,0.9111111111111111,1.0
79,85,60,55,60,71,410,0.60431654676259,43,70,48,50,60,38,309,0.2391304347826087,0.0
77,59,50,67,63,46,362,0.23140495867768596,79,103,120,135,115,78,630,0.5763888888888888,0.5
55,75,60,75,60,103,428,0.7982456140350878,70,83,50,37,50,60,350,0.3360655737704918,2.0
70,135,105,60,105,20,495,0.5806451612903226,88,107,122,74,75,64,530,0.4596774193548387,1.0
50,65,107,105,107,86,520,0.7313432835820896,100,128,90,77,77,128,600,0.959349593495935,1.0
80,80,80,55,55,90,440,0.6417910447761194,40,55,99,40,79,47,360,0.26262626262626265,1.0
55,68,64,45,55,31,318,0.11666666666666667,95,117,184,44,46,28,514,0.2975206611570248,1.0
105,140,95,55,65,45,505,0.3,104,91,63,91,73,68,490,0.5118110236220472,2.0
91,90,72,90,129,108,580,0.896,80,135,130,95,90,70,600,0.5181818181818182,0.5
68,125,65,65,115,80,518,0.6277372262773723,45,40,60,40,75,50,310,0.2926829268292683,1.0
50,53,48,53,48,64,316,0.46153846153846156,67,125,40,30,30,58,350,0.3431372549019608,0.5
43,70,48,50,60,38,309,0.2391304347826087,85,105,55,85,50,115,495,0.9032258064516129,2.0
65,130,60,95,110,65,525,0.5303030303030303,30,30,30,30,30,30,180,0.12612612612612611,2.0
80,100,123,122,120,80,625,0.56,45,45,55,45,55,63,308,0.4594594594594595,1.0
50,50,120,80,80,30,410,0.07258064516129033,50,105,125,55,95,50,480,0.375886524822695,1.0
82,80,86,85,75,72,480,0.6183206106870229,60,80,95,70,85,50,440,0.2231404958677686,0.5
80,80,50,40,50,25,325,0.176056338028169,35,80,50,50,70,120,405,0.84375,0.5
45,100,135,65,135,45,525,0.29411764705882354,25,20,15,105,55,90,310,0.32407407407407407,2.0
100,100,100,100,100,100,600,0.831858407079646,50,160,110,160,110,110,700,0.8854961832061069,1.0
45,85,70,40,40,60,340,0.5229357798165137,79,105,70,145,80,101,580,0.8608695652173913,0.5
70,90,45,15,45,50,315,0.3629032258064516,40,40,35,50,100,70,335,0.5031847133757962,0.5
70,75,80,135,80,135,575,0.917910447761194,80,120,79,95,79,70,523,0.5833333333333334,0.5
50,65,107,105,107,86,520,0.7758620689655172,50,70,50,50,50,40,310,0.16296296296296298,1.0
95,60,79,100,125,81,540,0.6201550387596899,60,130,80,60,60,70,460,0.5153846153846153,0.5
55,85,55,50,55,60,360,0.4233576642335766,114,85,70,85,80,30,464,0.2066115702479339,2.0
50,65,107,105,107,86,520,0.7272727272727273,70,75,80,135,80,135,575,0.917910447761194,0.25
85,50,95,120,115,80,545,0.5793650793650794,85,90,80,70,80,130,535,0.9262295081967213,0.5
55,50,65,175,95,150,590,0.7818181818181819,60,60,60,105,105,105,495,0.848,1.0
100,90,130,45,65,55,485,0.4253731343283582,55,55,55,85,55,30,335,0.1320754716981132,1.0
60,90,55,90,80,110,485,0.8677685950413223,78,81,71,74,69,126,499,0.9090909090909091,2.0
80,125,75,40,95,85,500,0.6911764705882353,44,38,33,61,43,70,289,0.5267857142857143,2.0
70,80,65,90,65,85,455,0.578125,70,135,105,60,105,20,495,0.5806451612903226,0.25
70,95,125,65,75,45,475,0.33613445378151263,55,85,55,50,55,60,360,0.4233576642335766,2.0
45,95,50,40,50,75,355,0.54,70,50,30,95,135,105,485,0.8040540540540541,2.0
78,84,78,109,85,100,534,0.8620689655172413,65,65,60,130,95,110,525,0.823943661971831,1.0
82,121,119,69,59,71,521,0.5394736842105263,100,70,70,65,65,45,415,0.1897810218978102,1.0
50,53,62,58,63,44,330,0.13709677419354838,100,100,100,100,100,100,600,0.8805970149253731,0.5
66,41,77,61,87,23,355,0.12096774193548387,50,20,40,20,40,20,190,0.0962962962962963,1.0
75,98,63,98,63,101,498,0.849624060150376,95,110,80,70,80,50,485,0.37209302325581395,1.0
90,120,120,60,60,50,500,0.35294117647058826,40,55,30,30,30,85,270,0.688,0.0
106,110,90,154,90,130,680,0.926829268292683,78,130,111,130,85,100,634,0.8561151079136691,1.0
53,51,53,61,56,40,314,0.14285714285714285,20,10,55,15,20,80,200,0.17985611510791366,0.5
74,48,76,83,81,104,466,0.7322834645669292,50,25,28,45,55,15,218,0.0625,1.0
40,30,35,45,40,55,245,0.31496062992125984,90,70,80,70,95,70,475,0.5190839694656488,1.0
40,65,95,60,45,35,340,0.13986013986013987,80,52,50,90,50,89,411,0.6666666666666666,1.0
50,55,50,36,30,43,264,0.2922077922077922,70,105,105,50,40,20,390,0.33587786259541985,0.25
40,55,30,30,30,85,270,0.688,40,35,30,20,20,50,195,0.23423423423423423,2.0
50,52,48,65,50,55,320,0.33098591549295775,70,55,95,95,110,65,490,0.48872180451127817,1.0
55,70,40,60,40,40,305,0.26956521739130435,75,140,65,112,65,110,567,0.9140625,2.0
108,130,95,80,85,102,600,0.7637795275590551,100,103,75,120,75,127,600,0.940677966101695,0.0
100,100,100,100,100,100,600,0.8602941176470589,50,45,45,35,35,50,260,0.23529411764705882,1.0
90,120,75,60,60,45,450,0.29411764705882354,45,50,43,40,38,62,278,0.40441176470588236,1.0
115,140,130,55,55,40,535,0.4519230769230769,70,62,67,55,55,56,365,0.38513513513513514,2.0
65,73,55,47,75,85,400,0.6846846846846847,72,105,115,54,86,68,500,0.5149253731343284,1.0
59,110,150,45,49,35,448,0.3333333333333333,70,55,95,95,110,65,490,0.48872180451127817,2.0
83,106,65,86,65,85,490,0.6640625,45,45,35,20,30,20,195,0.07246376811594203,0.5
60,45,70,45,90,95,405,0.7304964539007093,45,49,49,65,65,45,318,0.2781954887218045,0.5
45,40,60,40,75,50,310,0.2926829268292683,110,85,95,80,95,50,515,0.2713178294573643,1.0
53,51,53,61,56,40,314,0.14285714285714285,126,131,95,131,98,99,680,0.8294573643410853,1.0
74,108,133,83,65,32,495,0.32142857142857145,54,78,103,53,45,22,355,0.23255813953488372,1.0
50,70,50,50,50,40,310,0.16296296296296298,75,75,95,75,95,113,528,0.9015151515151515,0.5
86,92,88,68,75,73,482,0.6835443037974683,70,45,48,60,65,35,323,0.15748031496062992,0.5
86,76,86,116,56,95,515,0.7982456140350878,126,131,95,131,98,99,680,0.8294573643410853,0.5
60,40,50,75,85,95,405,0.6044776119402985,44,48,65,50,64,43,314,0.1623931623931624,2.0
55,50,65,175,95,150,590,0.7818181818181819,63,63,47,41,41,74,329,0.56,0.0
125,170,100,120,90,95,700,0.77,100,100,90,150,140,90,670,0.71875,0.5
50,30,55,65,55,20,275,0.13675213675213677,68,165,95,65,115,110,618,0.8615384615384616,2.0
78,70,61,50,61,100,420,0.8145161290322581,78,130,111,130,85,100,634,0.8561151079136691,1.0
123,77,72,99,92,58,521,0.4621212121212121,90,30,15,40,20,15,210,0.043478260869565216,1.0
46,87,60,30,40,57,320,0.37777777777777777,110,78,73,76,71,60,468,0.3333333333333333,1.0
80,100,200,50,100,50,580,0.3472222222222222,55,81,60,50,70,97,413,0.7214285714285714,1.0
130,85,80,85,95,60,535,0.43884892086330934,64,66,68,81,76,50,405,0.25190839694656486,0.25
100,123,75,57,75,80,510,0.6923076923076923,80,110,60,150,130,70,600,0.5042016806722689,0.0
45,45,35,20,30,20,195,0.07246376811594203,85,135,130,60,80,25,515,0.40540540540540543,1.0
60,60,60,85,85,85,435,0.631578947368421,79,115,70,125,80,111,580,0.8468468468468469,1.0
70,90,110,60,75,95,500,0.7333333333333333,40,80,35,35,45,70,305,0.4661016949152542,0.5
123,100,62,97,81,68,531,0.4806201550387597,65,150,40,15,80,145,495,0.9663865546218487,0.25
60,150,50,150,50,60,520,0.5,150,160,100,95,65,100,670,0.8866666666666667,0.0
67,125,40,30,30,58,350,0.3431372549019608,130,65,60,110,95,65,525,0.5227272727272727,1.0
255,10,10,75,135,55,540,0.3125,62,48,54,63,60,68,355,0.5178571428571429,1.0
75,100,66,60,66,115,482,0.918918918918919,40,60,40,40,40,30,250,0.0948905109489051,1.0
67,58,57,81,67,101,431,0.8790322580645161,45,67,60,35,50,63,320,0.5128205128205128,2.0
50,35,55,25,25,15,205,0.021739130434782608,60,70,105,70,120,75,500,0.5983606557377049,2.0
40,40,50,30,30,30,220,0.0873015873015873,82,80,86,85,75,72,480,0.6183206106870229,1.0
45,30,50,65,50,45,285,0.13821138211382114,89,125,90,115,80,101,600,0.8725490196078431,2.0
60,80,50,40,40,30,300,0.15328467153284672,126,131,95,131,98,99,680,0.8294573643410853,1.0
80,100,200,50,100,50,580,0.3472222222222222,68,75,53,83,113,60,452,0.45384615384615384,1.0
60,65,60,130,75,110,500,0.7719298245614035,45,22,60,27,30,29,213,0.07518796992481203,1.0
40,70,40,35,40,60,285,0.392,30,65,100,45,25,40,305,0.1891891891891892,1.0
71,73,88,120,89,59,500,0.43537414965986393,60,85,49,60,49,60,363,0.4444444444444444,1.0
101,72,72,99,89,29,462,0.1937984496124031,75,38,38,56,56,67,330,0.5263157894736842,1.0
45,22,60,27,30,29,213,0.07518796992481203,60,110,70,60,60,100,460,0.8461538461538461,0.5
40,60,30,31,31,70,262,0.4492753623188406,65,85,70,75,70,40,405,0.203125,0.5
75,80,85,110,90,50,490,0.3548387096774194,65,63,45,45,45,45,308,0.2595419847328244,0.5
100,75,115,90,115,85,580,0.6446280991735537,60,48,45,43,90,42,328,0.21897810218978103,1.0
70,135,105,60,105,20,495,0.5806451612903226,75,95,125,45,75,95,510,0.8257575757575758,0.5
100,150,140,100,90,90,670,0.7969924812030075,38,35,35,65,55,50,278,0.2647058823529412,1.0
100,164,150,95,120,71,700,0.5645161290322581,65,75,90,97,123,44,494,0.1987179487179487,1.0
78,65,68,112,154,75,552,0.628099173553719,60,85,60,85,60,55,405,0.3673469387755102,1.0
50,72,35,35,35,65,292,0.5373134328358209,50,92,108,92,108,35,485,0.2457627118644068,1.0
66,117,70,40,50,67,410,0.4573643410852713,60,75,85,100,85,115,520,0.8992248062015504,1.0
95,109,105,75,85,56,525,0.34513274336283184,50,75,45,40,45,60,315,0.4380165289256198,0.25
62,50,58,73,54,72,369,0.4435483870967742,40,55,30,30,30,60,245,0.43548387096774194,1.0
83,80,80,135,80,121,579,0.9444444444444444,82,80,86,85,75,72,480,0.6183206106870229,1.0
65,50,70,95,80,65,425,0.4262295081967213,43,70,48,50,60,38,309,0.2391304347826087,1.0
50,50,40,30,30,50,250,0.2781954887218045,50,95,95,35,110,70,455,0.5179856115107914,1.0
30,105,90,25,25,50,325,0.2773722627737226,60,85,69,65,79,80,438,0.576,1.0
50,75,75,65,65,50,380,0.4049586776859504,63,120,85,90,55,55,468,0.2809917355371901,0.25
78,84,78,109,85,100,534,0.8620689655172413,70,115,60,115,60,55,475,0.4647887323943662,2.0
80,145,150,105,110,110,700,0.8692307692307693,85,120,70,50,60,100,485,0.8308823529411765,1.0
64,88,50,88,50,106,446,0.9111111111111111,95,110,80,70,80,50,485,0.37209302325581395,1.0
50,47,50,57,50,65,319,0.463768115942029,65,75,90,97,123,44,494,0.1987179487179487,0.25
50,70,100,40,40,30,330,0.2222222222222222,60,85,69,65,79,80,438,0.576,1.0
80,125,75,40,95,85,500,0.6911764705882353,55,112,45,74,45,70,401,0.559322033898305,0.5
89,145,90,105,80,91,600,0.8549618320610687,40,30,50,55,55,100,330,0.584070796460177,1.0
49,49,56,49,61,66,330,0.5190839694656488,50,45,45,35,35,50,260,0.23529411764705882,1.0
49,66,70,44,55,51,335,0.4260869565217391,111,83,68,92,82,39,475,0.1774193548387097,4.0
60,90,70,60,120,40,440,0.27419354838709675,58,64,58,80,65,80,405,0.609271523178808,1.0
80,100,200,50,100,50,580,0.3472222222222222,85,100,122,58,75,54,494,0.3939393939393939,1.0
110,160,110,80,110,100,670,0.8591549295774648,63,60,55,50,50,71,349,0.5289256198347108,1.0
95,135,80,110,80,100,600,0.8248175182481752,62,44,50,44,50,55,305,0.3629032258064516,1.0
40,45,35,40,40,90,290,0.65,50,50,40,50,40,64,294,0.45588235294117646,1.0
85,115,80,105,80,50,515,0.3063063063063063,45,63,37,65,55,95,360,0.8055555555555556,0.5
90,50,34,60,44,70,348,0.6283185840707964,75,125,75,30,75,85,465,0.625,2.0
66,65,48,62,57,52,350,0.36220472440944884,75,75,55,105,85,30,425,0.1619718309859155,0.5
65,60,70,85,75,40,395,0.1796875,60,85,40,30,45,68,328,0.6422018348623854,1.0
103,60,86,60,86,50,445,0.3458646616541353,65,60,110,130,95,65,525,0.47761194029850745,1.0
89,145,90,105,80,91,600,0.8549618320610687,90,120,100,150,120,100,680,0.7718120805369127,1.0
108,130,95,80,85,102,600,0.7637795275590551,50,75,70,35,70,48,348,0.29357798165137616,1.0
90,100,60,90,60,80,480,0.6422764227642277,50,64,50,45,50,41,300,0.22727272727272727,4.0
80,100,70,50,60,45,405,0.25806451612903225,35,55,40,45,40,60,275,0.35714285714285715,1.0
60,90,140,50,50,40,430,0.2535211267605634,71,73,88,120,89,59,500,0.43537414965986393,0.5
25,35,70,95,55,45,325,0.16783216783216784,42,52,67,39,56,50,306,0.2868217054263566,2.0
45,95,50,40,50,75,355,0.54,125,170,100,120,90,95,700,0.77,2.0
90,130,80,65,85,55,505,0.4396551724137931,35,45,160,30,45,70,385,0.48148148148148145,2.0
45,85,70,40,40,60,340,0.5229357798165137,75,125,230,55,95,30,610,0.3448275862068966,0.5
55,84,105,114,75,52,485,0.2890625,55,45,50,45,65,80,340,0.5546218487394958,0.5
35,70,55,45,55,25,285,0.09420289855072464,83,80,75,70,70,101,479,0.8615384615384616,0.25
45,63,37,65,55,95,360,0.8055555555555556,76,48,48,57,62,34,325,0.11688311688311688,2.0
62,50,58,73,54,72,369,0.4435483870967742,54,63,52,83,56,97,405,0.7697841726618705,0.5
90,90,85,125,90,100,580,0.768595041322314,78,81,71,74,69,126,499,0.9090909090909091,2.0
80,70,65,80,120,100,515,0.8034188034188035,70,90,110,60,75,95,500,0.7333333333333333,0.5
60,60,60,60,60,60,360,0.38095238095238093,100,100,100,100,100,100,600,0.8345864661654135,1.0
70,60,70,87,78,85,450,0.6228070175438597,78,70,61,50,61,100,420,0.8145161290322581,1.0
30,105,90,25,25,50,325,0.2773722627737226,100,164,150,95,120,71,700,0.5645161290322581,2.0
60,40,60,95,60,55,370,0.4222222222222222,40,80,35,35,45,70,305,0.4661016949152542,1.0
45,35,45,62,53,35,275,0.11851851851851852,105,95,80,40,80,90,490,0.753968253968254,1.0
30,42,118,42,88,30,350,0.112,20,15,20,10,55,80,200,0.2682926829268293,0.5
35,85,45,35,35,75,310,0.6492537313432836,50,72,35,35,35,65,292,0.5373134328358209,1.0
79,105,70,145,80,101,580,0.8608695652173913,83,80,80,135,80,121,579,0.9444444444444444,2.0
125,130,90,130,90,95,660,0.7734375,95,117,184,44,46,28,514,0.2975206611570248,0.5
55,20,35,20,45,75,250,0.37681159420289856,70,80,102,80,102,40,474,0.2677165354330709,1.0
100,5,5,15,65,30,220,0.07692307692307693,30,45,59,30,39,57,260,0.2803030303030303,1.0
50,65,85,35,35,55,325,0.32575757575757575,95,70,73,95,90,60,483,0.3983739837398374,0.5
60,40,60,95,60,55,370,0.4222222222222222,65,75,105,35,65,85,430,0.6940298507462687,1.0
75,75,60,83,60,60,413,0.39344262295081966,80,92,65,65,80,68,450,0.4824561403508772,0.5
90,95,95,70,90,70,510,0.5230769230769231,65,40,70,80,140,70,465,0.5954198473282443,0.25
70,85,65,105,85,120,530,0.9262295081967213,44,48,65,50,64,43,314,0.1623931623931624,2.0
60,50,70,80,80,140,480,0.8449612403100775,60,100,115,70,85,90,520,0.7557251908396947,1.0
106,130,90,110,154,90,680,0.719626168224299,100,100,125,110,50,50,535,0.384,4.0
100,100,100,100,100,100,600,0.831858407079646,67,57,55,77,55,114,425,0.8879310344827587,0.5
54,45,47,75,98,52,371,0.39669421487603307,46,57,40,40,40,50,273,0.25,0.5
65,40,70,80,140,70,465,0.5954198473282443,75,80,95,90,100,50,490,0.2158273381294964,1.0
35,70,55,45,55,25,285,0.09420289855072464,45,30,40,105,50,20,290,0.031007751937984496,2.0
40,45,65,100,120,90,460,0.5588235294117647,60,55,145,75,150,40,525,0.2,0.25
60,48,45,43,90,42,328,0.21897810218978103,85,100,122,58,75,54,494,0.3939393939393939,1.0
46,87,60,30,40,57,320,0.37777777777777777,50,55,50,36,30,43,264,0.2922077922077922,1.0
85,105,85,40,50,40,405,0.211864406779661,70,145,88,140,70,112,625,0.8888888888888888,2.0
70,90,90,135,90,125,600,0.9401709401709402,40,40,35,50,100,70,335,0.5031847133757962,1.0
35,20,65,40,65,20,245,0.02459016393442623,70,55,55,80,60,45,365,0.2222222222222222,1.0
75,125,230,55,95,30,610,0.3448275862068966,123,100,62,97,81,68,531,0.4806201550387597,0.5
75,123,67,95,85,95,540,0.7642276422764228,45,30,35,20,20,45,195,0.14782608695652175,1.0
55,66,44,44,56,85,350,0.6888888888888889,108,100,121,81,95,95,600,0.7476635514018691,1.0
100,150,110,95,110,70,635,0.5923076923076923,68,85,65,165,135,100,618,0.8083333333333333,1.0
90,120,120,60,60,50,500,0.35294117647058826,35,64,85,74,55,32,345,0.19827586206896552,1.0
30,42,118,42,88,30,350,0.112,90,70,80,70,95,70,475,0.5190839694656488,2.0
67,82,62,46,48,43,348,0.22033898305084745,91,134,95,100,100,80,600,0.6304347826086957,0.5
80,130,100,160,120,110,700,0.8981481481481481,55,85,122,58,75,99,494,0.8099173553719008,1.0
30,30,30,30,30,30,180,0.12612612612612611,90,60,70,75,70,45,410,0.23880597014925373,2.0
150,80,44,90,54,80,498,0.625,45,75,60,40,30,50,300,0.304,1.0
100,103,75,120,75,127,600,0.940677966101695,88,107,122,74,75,64,530,0.4596774193548387,2.0
55,70,40,60,40,40,305,0.26956521739130435,45,100,45,45,45,10,290,0.2949640287769784,2.0
55,40,85,80,105,40,405,0.23622047244094488,89,124,80,55,80,55,483,0.5714285714285714,1.0
75,80,85,110,90,50,490,0.3548387096774194,60,100,85,80,85,100,510,0.7007874015748031,1.0
30,35,30,100,35,80,310,0.4765625,95,100,85,108,70,70,528,0.5652173913043478,1.0
40,27,60,37,50,66,280,0.36220472440944884,75,90,140,60,60,40,465,0.3008130081300813,0.125
85,135,130,60,80,25,515,0.40540540540540543,75,87,63,87,63,98,473,0.865546218487395,2.0
50,72,35,35,35,65,292,0.5373134328358209,60,95,80,60,80,30,405,0.19480519480519481,0.25
70,84,70,65,70,51,410,0.2949640287769784,50,50,77,95,77,91,440,0.5916666666666667,2.0
70,145,88,140,70,112,625,0.8888888888888888,75,80,95,90,100,50,490,0.2158273381294964,1.0
160,110,65,65,110,30,540,0.35714285714285715,150,80,44,90,54,80,498,0.625,0.0
78,70,61,50,61,100,420,0.8145161290322581,110,123,65,100,65,65,528,0.5217391304347826,1.0
30,80,90,55,45,55,355,0.4295774647887324,95,75,180,130,80,30,590,0.13793103448275862,0.5
60,90,140,50,50,40,430,0.2535211267605634,95,23,48,23,48,23,260,0.046153846153846156,1.0
130,85,80,85,95,60,535,0.43884892086330934,130,70,35,70,35,60,400,0.4017857142857143,0.25
100,100,90,150,140,90,670,0.71875,72,95,67,103,71,122,530,0.9606299212598425,0.5
44,38,39,61,79,42,303,0.2251655629139073,70,60,75,110,75,90,480,0.7165354330708661,1.0
55,50,65,175,95,150,590,0.7818181818181819,120,100,85,30,85,45,465,0.22448979591836735,1.0
65,90,115,45,115,58,488,0.5041322314049587,55,95,115,45,45,35,390,0.2116788321167883,2.0
80,135,85,70,95,150,615,0.9844961240310077,130,70,35,70,35,60,400,0.4017857142857143,1.0
83,106,65,86,65,85,490,0.6640625,60,50,70,50,90,65,385,0.39568345323741005,0.125
65,90,120,85,70,60,490,0.43410852713178294,70,80,70,80,70,110,480,0.6594202898550725,0.5
65,85,70,75,70,40,405,0.203125,76,25,45,67,55,24,292,0.0390625,1.0
70,80,50,35,35,35,305,0.14,95,125,79,60,100,81,540,0.6165413533834586,0.5
60,62,63,80,80,60,405,0.38016528925619836,60,85,42,85,42,91,405,0.8227848101265823,0.5
40,70,40,35,40,60,285,0.392,74,48,76,83,81,104,466,0.7322834645669292,0.5
40,35,30,20,20,50,195,0.23423423423423423,150,80,44,90,54,80,498,0.625,0.125
35,55,40,45,40,60,275,0.35714285714285715,72,85,70,65,70,58,420,0.41304347826086957,0.5
40,30,35,50,70,55,280,0.28205128205128205,70,140,70,110,65,105,560,0.95,2.0
50,47,50,57,50,65,319,0.463768115942029,75,89,85,55,65,36,405,0.29545454545454547,1.0
65,60,110,130,95,65,525,0.47761194029850745,63,60,55,50,50,71,349,0.5289256198347108,2.0
70,50,30,95,135,105,485,0.8040540540540541,70,90,70,60,60,70,420,0.6390977443609023,1.0
50,150,50,150,50,150,600,0.9339622641509434,69,69,76,69,86,91,460,0.6554621848739496,1.0
100,70,70,65,65,45,415,0.1897810218978102,35,46,34,35,45,20,215,0.072,1.0
90,132,105,132,105,30,594,0.4246575342465753,65,136,94,54,96,135,580,0.9612403100775194,1.0
50,20,40,20,40,20,190,0.0962962962962963,60,60,60,105,105,105,495,0.848,0.0
50,35,55,25,25,15,205,0.021739130434782608,60,100,85,80,85,100,510,0.7007874015748031,1.0
60,110,70,60,60,100,460,0.8461538461538461,130,85,80,85,95,60,535,0.43884892086330934,1.0
30,40,70,70,25,60,295,0.41353383458646614,75,140,65,112,65,110,567,0.9140625,2.0
45,50,55,75,65,30,320,0.06293706293706294,75,95,67,125,95,83,540,0.7117117117117117,0.5
70,85,65,105,85,120,530,0.9262295081967213,78,84,78,109,85,100,534,0.8646616541353384,0.25
95,65,65,110,130,60,525,0.4016393442622951,70,110,180,60,60,50,530,0.4117647058823529,0.5
80,80,50,40,50,25,325,0.176056338028169,39,52,43,60,50,65,309,0.5041322314049587,1.0
70,40,50,55,50,25,290,0.061068702290076333,91,72,90,129,90,108,580,0.8925619834710744,0.25
70,55,75,45,65,60,370,0.45901639344262296,120,120,120,120,120,120,720,0.9344262295081968,1.0
30,30,42,30,42,70,244,0.4230769230769231,80,70,65,80,120,100,515,0.8034188034188035,0.5
70,55,55,80,60,45,365,0.2222222222222222,100,180,160,150,90,90,770,0.7520661157024794,0.0
90,132,105,132,105,30,594,0.4246575342465753,85,115,80,105,80,50,515,0.3063063063063063,1.0
72,105,115,54,86,68,500,0.5149253731343284,75,98,63,98,63,101,498,0.8091603053435115,0.5
85,56,77,50,77,78,423,0.53125,60,75,100,55,80,50,420,0.3088235294117647,1.0
45,45,35,20,30,20,195,0.07246376811594203,60,52,168,47,138,30,495,0.19834710743801653,0.5
45,40,60,40,75,50,310,0.2926829268292683,75,89,85,55,65,36,405,0.29545454545454547,2.0
70,75,60,105,60,105,475,0.88,58,50,145,95,105,30,483,0.2459016393442623,1.0
75,125,70,125,70,115,580,0.9037037037037037,70,135,105,60,105,20,495,0.5806451612903226,0.5
50,50,95,40,50,35,320,0.20279720279720279,73,76,75,81,100,100,505,0.8110236220472441,2.0
114,85,70,85,80,30,464,0.2066115702479339,95,75,80,100,110,30,490,0.24242424242424243,2.0
60,110,70,60,60,100,460,0.8461538461538461,45,25,50,25,25,35,205,0.13076923076923078,2.0
70,90,90,135,90,125,600,0.9401709401709402,65,150,60,115,60,115,565,0.935251798561151,0.5
77,59,50,67,63,46,362,0.23140495867768596,67,58,57,81,67,101,431,0.8790322580645161,1.0
100,5,5,15,65,30,220,0.07692307692307693,50,48,43,46,41,60,288,0.47297297297297297,1.0
79,103,120,135,115,78,630,0.5763888888888888,80,52,50,90,50,89,411,0.6666666666666666,1.0
103,93,67,71,61,84,479,0.7142857142857143,95,23,48,23,48,23,260,0.046153846153846156,2.0
40,55,80,35,60,30,300,0.15037593984962405,35,85,45,35,35,75,310,0.6492537313432836,1.0
66,117,70,40,50,67,410,0.4573643410852713,85,70,80,97,80,123,535,0.9304347826086956,2.0
150,160,100,95,65,100,670,0.8866666666666667,100,128,90,77,77,128,600,0.959349593495935,1.0
80,160,60,170,130,80,680,0.6180555555555556,65,65,60,110,95,130,525,0.9253731343283582,1.0
70,115,60,115,60,55,475,0.4647887323943662,45,49,65,49,65,45,318,0.275,0.5
80,110,60,150,130,70,600,0.5042016806722689,40,29,45,29,45,36,224,0.14634146341463414,1.0
60,40,60,95,60,55,370,0.4222222222222222,68,90,65,50,55,82,410,0.6165413533834586,0.5
86,92,88,68,75,73,482,0.6835443037974683,40,30,30,40,50,30,220,0.07936507936507936,1.0
59,74,50,35,50,35,303,0.3125,65,90,40,45,80,75,395,0.625,1.0
110,160,110,80,110,100,670,0.8591549295774648,42,52,67,39,56,50,306,0.2868217054263566,0.5
60,55,145,75,150,40,525,0.2,70,110,75,145,85,145,630,0.9444444444444444,1.0
40,35,30,20,20,50,195,0.23423423423423423,95,124,78,69,71,58,495,0.37398373983739835,1.0
90,120,75,60,60,45,450,0.29411764705882354,79,115,70,125,80,111,580,0.864,1.0
40,50,45,70,45,70,320,0.5517241379310345,91,134,95,100,100,80,600,0.6304347826086957,1.0
90,100,90,125,85,90,580,0.7352941176470589,105,30,105,140,105,55,540,0.3524590163934426,0.5
80,130,100,160,120,110,700,0.8981481481481481,100,150,120,120,100,90,680,0.6493506493506493,2.0
75,75,60,83,60,60,413,0.39344262295081966,45,67,60,35,50,63,320,0.5128205128205128,0.5
65,76,84,54,96,105,480,0.9008264462809917,30,42,118,42,88,30,350,0.112,0.25
60,50,40,85,75,95,405,0.7540983606557377,80,70,40,100,60,145,495,0.921875,1.0
82,80,86,85,75,72,480,0.6183206106870229,41,50,37,50,37,66,281,0.5175438596491229,2.0
89,145,90,105,80,91,600,0.8549618320610687,95,109,105,75,85,56,525,0.34513274336283184,1.0
60,130,80,60,60,70,460,0.5153846153846153,70,50,30,95,135,105,485,0.8040540540540541,2.0
70,110,75,145,85,145,630,0.9444444444444444,59,45,40,35,40,31,250,0.14285714285714285,1.0
50,55,50,36,30,43,264,0.2922077922077922,60,70,105,70,120,75,500,0.5983606557377049,1.0
50,65,85,35,35,55,325,0.32575757575757575,99,68,83,72,87,51,460,0.417910447761194,2.0
60,50,100,85,70,65,430,0.47580645161290325,75,89,85,55,65,36,405,0.29545454545454547,1.0
80,80,80,80,80,80,480,0.6015037593984962,75,85,200,55,65,30,510,0.16778523489932887,1.0
60,60,50,40,50,75,335,0.5882352941176471,60,85,60,85,60,55,405,0.3673469387755102,0.5
66,117,70,40,50,67,410,0.4573643410852713,55,66,44,44,56,85,350,0.6888888888888889,1.0
65,60,110,130,95,65,525,0.47761194029850745,70,45,48,60,65,35,323,0.15748031496062992,1.0
120,120,120,120,120,120,720,0.9344262295081968,250,5,5,35,105,50,450,0.15306122448979592,1.0
60,50,100,85,70,65,430,0.47580645161290325,90,75,85,115,90,55,510,0.3445378151260504,0.5
68,125,65,65,115,80,518,0.6277372262773723,41,56,40,62,44,71,314,0.568,1.0
70,45,48,60,65,35,323,0.15748031496062992,95,75,180,130,80,30,590,0.13793103448275862,1.0
38,30,85,55,65,30,303,0.21428571428571427,120,100,85,30,85,45,465,0.22448979591836735,1.0
50,47,50,57,50,65,319,0.463768115942029,40,40,35,50,100,70,335,0.5031847133757962,1.0
76,104,71,104,71,108,534,0.912751677852349,104,91,63,91,73,68,490,0.5118110236220472,2.0
65,125,100,55,70,85,500,0.6532258064516129,31,45,90,30,30,40,266,0.21929824561403508,1.0
70,55,75,45,65,60,370,0.45901639344262296,40,45,40,62,60,60,307,0.33884297520661155,1.0
105,180,100,180,100,115,780,0.9477611940298507,71,73,88,120,89,59,500,0.43537414965986393,1.0
60,45,50,90,80,70,395,0.625,73,95,62,85,65,85,465,0.6666666666666666,1.0
125,170,100,120,90,95,700,0.77,55,84,105,114,75,52,485,0.2890625,0.5
60,85,42,85,42,91,405,0.8227848101265823,43,80,65,50,35,35,308,0.14193548387096774,1.0
70,145,88,140,70,112,625,0.8888888888888888,105,125,100,60,100,100,590,0.8359375,2.0
80,185,115,40,105,75,600,0.6230769230769231,75,75,95,75,95,113,528,0.9015151515151515,2.0
55,65,35,60,30,85,330,0.6126126126126126,50,70,50,50,50,40,310,0.16296296296296298,0.5
109,66,84,81,99,32,471,0.2013888888888889,40,55,99,40,79,47,360,0.26262626262626265,1.0
50,120,53,35,110,87,455,0.640625,39,52,43,60,50,65,309,0.49107142857142855,1.0
74,108,133,83,65,32,495,0.32142857142857145,80,130,100,160,120,110,700,0.8981481481481481,0.5
75,125,70,125,70,115,580,0.9037037037037037,83,80,80,135,80,121,579,0.9444444444444444,1.0
50,53,62,58,63,44,330,0.13709677419354838,85,115,80,105,80,50,515,0.3063063063063063,1.0
60,62,80,63,80,60,405,0.4336283185840708,55,104,105,94,75,52,485,0.36363636363636365,2.0
85,100,122,58,75,54,494,0.3939393939393939,95,110,80,70,80,50,485,0.37209302325581395,1.0
120,100,85,30,85,45,465,0.22448979591836735,90,95,105,165,110,45,610,0.2890625,1.0
64,78,52,78,52,81,405,0.6422764227642277,65,95,100,60,50,50,420,0.34959349593495936,0.5
71,95,85,110,95,79,535,0.664,62,44,50,44,50,55,305,0.3629032258064516,1.0
110,65,105,55,95,80,510,0.6258503401360545,48,72,48,72,48,48,336,0.25984251968503935,2.0
89,125,90,115,80,101,600,0.8725490196078431,40,30,30,55,30,85,270,0.4666666666666667,0.0
50,20,55,25,25,30,205,0.09774436090225563,115,45,20,45,25,20,270,0.11538461538461539,0.5
91,90,129,90,72,108,580,0.9140625,70,150,140,65,100,75,600,0.55,0.5
38,30,85,55,65,30,303,0.21428571428571427,100,100,100,100,100,100,600,0.8778625954198473,2.0
62,73,55,56,52,84,382,0.7244094488188977,50,53,48,53,48,64,316,0.358974358974359,0.5
40,30,35,45,40,55,245,0.31496062992125984,50,64,50,45,50,41,300,0.22727272727272727,0.5
50,85,125,85,115,20,480,0.4306569343065693,89,125,90,115,80,101,600,0.8725490196078431,1.0
60,75,85,100,85,115,520,0.8992248062015504,65,95,100,60,50,50,420,0.34959349593495936,0.5
55,68,64,45,55,31,318,0.11666666666666667,60,40,60,95,60,55,370,0.4222222222222222,0.5
50,35,55,25,25,15,205,0.05263157894736842,35,70,55,45,55,25,285,0.09420289855072464,2.0
60,85,60,85,60,55,405,0.3673469387755102,70,90,110,60,75,95,500,0.7333333333333333,1.0
30,40,55,40,55,60,280,0.3237410071942446,80,105,65,60,75,130,515,0.9645390070921985,1.0
65,130,60,75,60,75,465,0.689922480620155,50,65,107,105,107,86,520,0.7272727272727273,1.0
85,105,100,79,83,78,530,0.5869565217391305,103,60,86,60,86,50,445,0.3458646616541353,1.0
40,35,30,120,70,105,400,0.6692307692307692,30,45,55,70,55,85,340,0.5633802816901409,1.0
95,109,105,75,85,56,525,0.34513274336283184,80,90,80,130,110,110,600,0.856,0.5
75,38,38,56,56,67,330,0.5263157894736842,75,75,95,75,95,113,528,0.9015151515151515,0.25
39,52,43,60,50,65,309,0.49107142857142855,60,40,60,95,60,55,370,0.4222222222222222,0.5
74,100,72,90,72,46,454,0.24561403508771928,100,100,100,100,100,100,600,0.831858407079646,1.0
106,150,70,194,120,140,780,0.952,110,85,95,80,95,50,515,0.2713178294573643,1.0
76,48,48,57,62,34,325,0.11688311688311688,70,90,70,60,60,70,420,0.6390977443609023,1.0
80,82,100,83,100,80,525,0.6821705426356589,70,55,75,45,65,60,370,0.45901639344262296,0.5
95,145,130,120,90,120,700,0.9398496240601504,59,66,70,44,55,41,335,0.25190839694656486,2.0
57,80,91,80,87,75,470,0.5737704918032787,40,45,35,40,40,90,290,0.65,1.0
100,77,77,128,128,90,600,0.6901408450704225,50,160,110,160,110,110,700,0.8854961832061069,0.5
35,35,40,35,55,50,250,0.40336134453781514,65,65,45,75,45,95,390,0.72,0.5
62,55,52,109,94,109,481,0.7833333333333333,95,135,80,110,80,100,600,0.8248175182481752,1.0
50,52,48,65,50,55,320,0.33098591549295775,54,78,103,53,45,22,355,0.23255813953488372,1.0
60,60,60,60,60,60,360,0.38095238095238093,70,80,70,80,70,110,480,0.6594202898550725,0.0
79,85,60,55,60,71,410,0.60431654676259,123,100,62,97,81,68,531,0.4806201550387597,0.5
70,80,65,90,65,85,455,0.578125,106,90,130,90,154,110,680,0.8699186991869918,0.5
78,84,78,109,85,100,534,0.8620689655172413,84,86,88,111,101,60,530,0.4634146341463415,1.0
70,75,80,135,80,135,575,0.917910447761194,100,100,125,110,50,50,535,0.384,0.5
65,90,120,85,70,60,490,0.43410852713178294,45,67,60,35,50,63,320,0.5128205128205128,1.0
70,95,85,55,65,70,440,0.5,78,84,78,109,85,100,534,0.8646616541353384,4.0
60,45,70,75,85,55,390,0.3008130081300813,50,65,107,105,107,86,520,0.7272727272727273,1.0
59,66,70,44,55,41,335,0.25190839694656486,70,70,115,130,90,60,535,0.5338983050847458,0.5
59,74,50,35,50,35,303,0.3125,75,98,63,98,63,101,498,0.849624060150376,1.0
40,30,30,55,30,85,270,0.4666666666666667,60,60,75,60,75,80,410,0.7321428571428571,2.0
85,56,77,50,77,78,423,0.53125,20,15,20,10,55,80,200,0.2682926829268293,1.0
40,70,40,35,40,60,285,0.392,95,65,65,110,130,60,525,0.4016393442622951,0.5
90,100,90,125,85,90,580,0.7352941176470589,70,94,50,94,50,66,424,0.48148148148148145,4.0
67,89,116,79,116,33,500,0.2624113475177305,50,75,45,40,45,60,315,0.4380165289256198,1.0
60,60,60,60,60,60,360,0.38095238095238093,30,30,30,30,30,30,180,0.12612612612612611,1.0
35,35,40,35,55,50,250,0.40336134453781514,80,135,85,70,95,150,615,0.9844961240310077,0.5
72,105,115,54,86,68,500,0.5149253731343284,40,50,45,70,45,70,320,0.5517241379310345,2.0
120,100,85,30,85,45,465,0.22448979591836735,90,75,75,90,100,70,500,0.5462184873949579,1.0
80,95,82,60,82,75,474,0.6,90,132,105,132,105,30,594,0.4246575342465753,2.0
70,60,62,80,82,60,414,0.4375,39,52,43,60,50,65,309,0.49107142857142855,0.5
80,82,83,100,100,80,525,0.6742424242424242,45,95,50,40,50,75,355,0.54,0.5
91,72,90,129,90,108,580,0.8620689655172413,45,100,135,65,135,45,525,0.29411764705882354,0.0
70,130,100,55,80,65,500,0.608,20,10,55,15,20,80,200,0.17985611510791366,0.5
101,72,72,99,89,29,462,0.1937984496124031,70,65,65,55,55,70,380,0.5,1.0
108,100,121,81,95,95,600,0.7476635514018691,55,50,65,175,95,150,590,0.7818181818181819,1.0
65,75,70,95,70,95,470,0.7272727272727273,130,70,35,70,35,60,400,0.4017857142857143,1.0
60,70,65,125,105,90,515,0.6911764705882353,125,170,100,120,90,95,700,0.77,0.5
58,70,45,40,45,42,300,0.25925925925925924,60,60,60,85,85,85,435,0.631578947368421,1.0
70,70,40,60,40,60,340,0.4247787610619469,60,62,63,80,80,60,405,0.38016528925619836,0.25
80,70,40,100,60,145,495,0.921875,50,50,150,50,150,50,500,0.2571428571428571,0.5
40,45,40,62,60,60,307,0.33884297520661155,115,115,85,90,75,100,580,0.8134328358208955,0.5
60,95,80,60,80,30,405,0.19480519480519481,105,105,75,65,100,50,500,0.37593984962406013,0.25
65,130,60,75,60,75,465,0.689922480620155,55,20,35,20,45,75,250,0.37681159420289856,1.0
44,58,44,58,44,61,309,0.41964285714285715,70,60,70,87,78,85,450,0.6228070175438597,2.0
70,130,100,55,80,65,500,0.608,45,60,45,25,45,55,275,0.29,1.0
50,120,53,35,110,87,455,0.640625,65,125,100,55,70,85,500,0.6532258064516129,0.5
55,55,50,45,65,55,325,0.37373737373737376,150,160,100,95,65,100,670,0.8866666666666667,1.0
75,75,130,75,130,95,580,0.7479674796747967,80,100,70,60,70,95,475,0.7416666666666667,1.0
30,56,35,25,35,72,253,0.48148148148148145,50,70,160,70,160,90,600,0.7417218543046358,1.0
80,92,65,65,80,68,450,0.4824561403508772,70,60,125,115,70,55,495,0.35507246376811596,1.0
51,65,65,80,75,59,395,0.4365079365079365,65,90,120,85,70,60,490,0.43410852713178294,1.0
100,100,100,100,100,100,600,0.8778625954198473,55,130,115,50,50,75,475,0.5982142857142857,0.5
61,90,45,50,50,160,456,0.9230769230769231,35,85,45,35,35,75,310,0.6492537313432836,0.5
55,50,45,135,95,120,500,0.7714285714285715,60,60,60,60,60,60,360,0.38095238095238093,1.0
100,123,75,57,75,80,510,0.6923076923076923,120,100,85,30,85,45,465,0.22448979591836735,2.0
105,30,105,140,105,55,540,0.3524590163934426,41,50,37,50,37,66,281,0.5175438596491229,0.0
79,115,70,125,80,111,580,0.8468468468468469,125,58,58,76,76,67,460,0.515625,0.5
50,72,35,35,35,65,292,0.5373134328358209,80,85,95,30,30,25,345,0.2857142857142857,2.0
55,112,45,74,45,70,401,0.559322033898305,65,125,100,60,70,70,490,0.6099290780141844,0.25
130,70,35,70,35,60,400,0.4017857142857143,190,33,58,33,58,33,405,0.13432835820895522,1.0
100,150,120,120,100,90,680,0.6493506493506493,65,125,100,55,70,85,500,0.6532258064516129,1.0
35,70,55,45,55,25,285,0.09420289855072464,60,85,40,30,45,68,328,0.6422018348623854,2.0
65,50,35,115,95,95,455,0.7333333333333333,65,73,55,47,75,85,400,0.6846846846846847,1.0
60,59,85,79,105,36,424,0.16666666666666666,60,40,80,60,45,40,325,0.23529411764705882,2.0
45,63,37,65,55,95,360,0.8055555555555556,62,48,66,59,57,49,341,0.33884297520661155,1.0
55,65,95,95,45,85,440,0.6610169491525424,65,130,60,75,60,75,465,0.689922480620155,1.0
60,62,63,80,80,60,405,0.38016528925619836,85,97,66,105,66,65,484,0.47107438016528924,0.5
62,73,55,56,52,84,382,0.7244094488188977,75,80,55,25,35,35,305,0.18666666666666668,2.0
65,65,60,130,95,110,525,0.823943661971831,82,121,119,69,59,71,521,0.5394736842105263,1.0
65,80,140,40,70,70,465,0.5223880597014925,55,95,115,45,45,35,390,0.2116788321167883,1.0
50,75,70,35,70,48,348,0.29357798165137616,106,130,90,110,154,90,680,0.719626168224299,0.5
60,62,50,62,60,40,334,0.18181818181818182,85,76,64,45,55,90,415,0.6739130434782609,1.0
100,134,110,95,100,61,600,0.4057971014492754,58,109,112,48,48,109,484,0.8805970149253731,1.0
40,40,35,50,100,70,335,0.5031847133757962,40,27,60,37,50,66,280,0.36220472440944884,2.0
90,85,100,95,125,85,580,0.6834532374100719,56,61,65,48,45,38,313,0.17567567567567569,4.0
43,80,65,50,35,35,308,0.14193548387096774,76,65,45,92,42,91,411,0.7449664429530202,1.0
123,77,72,99,92,58,521,0.4621212121212121,90,100,90,125,85,90,580,0.7352941176470589,4.0
90,75,75,90,100,70,500,0.5462184873949579,40,65,95,60,45,35,340,0.13986013986013987,1.0
60,60,40,65,45,35,305,0.15833333333333333,85,135,130,60,80,25,515,0.40540540540540543,1.0
51,65,65,80,75,59,395,0.4365079365079365,78,84,78,109,85,100,534,0.8646616541353384,1.0
80,82,83,100,100,80,525,0.6742424242424242,39,52,43,60,50,65,309,0.5041322314049587,0.5
104,91,63,91,73,68,490,0.5118110236220472,35,45,160,30,45,70,385,0.48148148148148145,0.5
50,53,48,53,48,64,316,0.46153846153846156,25,35,70,95,55,45,325,0.16783216783216784,2.0
54,66,70,44,55,46,335,0.4214876033057851,70,80,65,90,65,85,455,0.578125,0.0
44,48,65,50,64,43,314,0.1623931623931624,110,65,105,55,95,80,510,0.6258503401360545,1.0
60,40,60,95,60,55,370,0.4222222222222222,60,150,50,150,50,60,520,0.5,4.0
40,70,40,35,40,60,285,0.392,73,115,60,60,60,90,458,0.6694915254237288,2.0
58,89,77,45,45,48,362,0.3177570093457944,50,70,50,50,50,40,310,0.16296296296296298,1.0
63,120,85,90,55,55,468,0.2809917355371901,70,110,80,55,80,105,500,0.8794326241134752,1.0
75,85,200,55,65,30,510,0.16778523489932887,70,120,65,45,85,125,510,0.9747899159663865,2.0
40,45,35,65,55,70,310,0.4482758620689655,75,90,90,140,90,115,600,0.9481481481481482,0.5
65,73,55,47,75,85,400,0.6846846846846847,30,80,90,55,45,55,355,0.4295774647887324,1.0
110,80,90,95,90,65,530,0.5033557046979866,55,50,45,135,95,120,500,0.7714285714285715,1.0
105,150,90,150,90,95,680,0.8285714285714286,126,131,95,131,98,99,680,0.8294573643410853,0.0
50,65,45,85,65,95,405,0.7238095238095238,60,75,85,100,85,115,520,0.8992248062015504,2.0
40,30,35,45,40,55,245,0.31496062992125984,70,90,110,60,75,95,500,0.7333333333333333,1.0
67,57,55,77,55,114,425,0.8879310344827587,40,70,40,35,40,60,285,0.392,2.0
50,47,50,57,50,65,319,0.463768115942029,70,83,50,37,50,60,350,0.3360655737704918,1.0
40,29,45,29,45,36,224,0.14634146341463414,90,100,90,125,85,90,580,0.7352941176470589,0.25
64,165,75,93,83,75,555,0.6587301587301587,61,78,95,56,58,57,405,0.40336134453781514,1.0
125,120,90,170,100,95,700,0.78125,70,85,70,60,70,50,405,0.28378378378378377,1.0
125,130,90,130,90,95,660,0.7734375,70,150,140,65,100,75,600,0.55,0.25
60,60,40,65,45,35,305,0.15833333333333333,70,85,70,60,70,50,405,0.28378378378378377,0.5
90,130,80,65,85,55,505,0.4396551724137931,60,75,100,55,80,50,420,0.3088235294117647,1.0
85,76,64,45,55,90,415,0.6739130434782609,37,25,41,25,41,25,194,0.08870967741935484,1.0
105,95,80,40,80,90,490,0.753968253968254,50,50,120,80,80,30,410,0.07258064516129033,0.5
110,65,75,125,85,30,490,0.15,75,98,63,98,63,101,498,0.849624060150376,1.0
65,50,35,115,95,95,455,0.7333333333333333,60,100,89,55,69,112,485,0.9298245614035088,2.0
35,35,40,35,55,50,250,0.40336134453781514,80,135,130,95,90,70,600,0.5181818181818182,0.25
66,117,70,40,50,67,410,0.4573643410852713,85,115,80,105,80,50,515,0.3063063063063063,1.0
78,65,68,112,154,75,552,0.628099173553719,120,120,120,120,120,120,720,0.9344262295081968,1.0
63,120,85,90,55,55,468,0.2809917355371901,45,20,50,60,120,50,345,0.24074074074074073,0.5
60,60,60,105,105,105,495,0.848,78,70,61,50,61,100,420,0.8145161290322581,0.0
45,35,50,70,50,30,280,0.15753424657534246,60,85,42,85,42,91,405,0.8227848101265823,0.5
60,65,80,170,95,130,600,0.8625954198473282,150,120,100,120,100,90,680,0.664179104477612,1.0
89,125,90,115,80,101,600,0.8725490196078431,85,73,70,73,115,67,483,0.5126050420168067,1.0
20,40,15,35,35,60,205,0.34285714285714286,80,160,60,170,130,80,680,0.6180555555555556,1.0
60,75,85,100,85,115,520,0.8992248062015504,1,90,45,30,30,40,236,0.33064516129032256,1.0
45,45,55,45,55,63,308,0.4594594594594595,100,134,110,95,100,61,600,0.4057971014492754,2.0
75,69,72,114,100,104,534,0.8253968253968254,70,145,88,140,70,112,625,0.8888888888888888,1.0
54,45,47,75,98,52,371,0.39669421487603307,100,120,120,150,100,90,680,0.7880794701986755,1.0
60,150,50,150,50,60,520,0.5,60,50,50,60,70,50,340,0.28346456692913385,0.5
61,90,45,50,50,160,456,0.9230769230769231,50,180,20,180,20,150,600,0.9029850746268657,2.0
86,76,86,116,56,95,515,0.7982456140350878,45,55,45,65,45,75,330,0.5692307692307692,0.5
65,85,70,75,70,40,405,0.203125,100,110,90,85,90,60,535,0.47794117647058826,0.0
64,115,65,83,63,65,455,0.5323741007194245,35,46,34,35,45,20,215,0.072,0.0
60,30,30,36,56,50,262,0.32432432432432434,72,95,67,103,71,122,530,0.9606299212598425,1.0
55,35,50,55,110,85,390,0.6277372262773723,65,125,60,95,60,105,510,0.9236641221374046,1.0
45,30,40,105,50,20,290,0.031007751937984496,90,120,75,60,60,45,450,0.29411764705882354,1.0
55,95,55,35,75,115,430,0.9380530973451328,75,87,63,87,63,98,473,0.865546218487395,1.0
55,35,50,55,110,85,390,0.6277372262773723,75,90,90,140,90,115,600,0.9481481481481482,1.0
74,108,133,83,65,32,495,0.32142857142857145,95,95,85,125,65,55,520,0.3894736842105263,0.5
69,69,76,69,86,91,460,0.6554621848739496,20,40,15,35,35,60,205,0.34285714285714286,1.0
90,92,75,92,85,60,494,0.49586776859504134,60,90,140,50,50,40,430,0.2535211267605634,0.5
50,35,55,25,25,15,205,0.05263157894736842,72,95,67,103,71,122,530,0.9606299212598425,2.0
70,65,65,55,55,70,380,0.5,85,80,70,135,75,90,535,0.7006802721088435,1.0
35,55,40,50,50,90,320,0.6838235294117647,80,50,100,100,200,50,580,0.2357142857142857,1.0
75,100,66,60,66,115,482,0.918918918918919,72,105,115,54,86,68,500,0.5149253731343284,0.5
70,70,40,60,40,60,340,0.4247787610619469,30,45,135,45,90,30,375,0.09285714285714286,2.0
80,80,50,40,50,25,325,0.176056338028169,86,92,88,68,75,73,482,0.6835443037974683,1.0
80,52,50,90,50,89,411,0.6666666666666666,150,80,44,90,54,80,498,0.625,0.25
65,65,60,110,95,130,525,0.9253731343283582,65,150,60,115,60,115,565,0.935251798561151,1.0
150,80,44,90,54,80,498,0.625,30,105,90,25,25,50,325,0.2773722627737226,1.0
45,22,60,27,30,29,213,0.07518796992481203,70,84,70,65,70,51,410,0.2949640287769784,1.0
76,25,45,67,55,24,292,0.0390625,95,135,80,110,80,100,600,0.8248175182481752,1.0
80,110,120,130,90,70,600,0.6198347107438017,95,145,130,120,90,120,700,0.9398496240601504,0.25
20,10,230,10,230,5,505,0.0,85,105,55,85,50,115,495,0.9032258064516129,1.0
70,94,50,94,50,66,424,0.48148148148148145,70,20,50,20,50,40,250,0.1557377049180328,0.5
38,36,38,32,36,57,237,0.3893805309734513,95,100,85,108,70,70,528,0.5652173913043478,1.0
103,93,67,71,61,84,479,0.7142857142857143,80,135,130,95,90,70,600,0.5181818181818182,0.0
50,47,50,57,50,65,319,0.463768115942029,90,85,75,115,100,115,580,0.9381443298969072,0.5
55,84,105,114,75,52,485,0.2890625,95,75,110,100,80,30,490,0.15267175572519084,0.5
100,5,5,15,65,30,220,0.07692307692307693,50,60,60,60,60,30,320,0.11290322580645161,1.0
91,90,106,130,106,77,600,0.648854961832061,62,50,58,73,54,72,369,0.4435483870967742,0.25
80,80,80,80,80,80,480,0.6015037593984962,40,30,32,50,52,65,269,0.3671875,0.5
123,100,62,97,81,68,531,0.4806201550387597,126,131,95,131,98,99,680,0.8102189781021898,0.5
30,30,30,30,30,30,180,0.12612612612612611,100,103,75,120,75,127,600,0.940677966101695,0.25
60,65,70,85,75,40,395,0.21705426356589147,82,121,119,69,59,71,521,0.5394736842105263,0.5
85,120,70,50,60,100,485,0.8308823529411765,85,105,100,79,83,78,530,0.5869565217391305,1.0
105,180,100,180,100,115,780,0.9477611940298507,50,20,40,20,40,20,190,0.0962962962962963,0.0
70,83,50,37,50,60,350,0.3360655737704918,65,75,70,95,70,95,470,0.7272727272727273,1.0
67,57,55,77,55,114,425,0.8879310344827587,100,75,115,90,115,85,580,0.6446280991735537,1.0
50,105,125,55,95,50,480,0.375886524822695,110,135,60,50,65,88,508,0.7744360902255639,0.25
75,95,125,45,75,95,510,0.8257575757575758,110,78,73,76,71,60,468,0.3333333333333333,1.0
60,30,30,36,56,50,262,0.32432432432432434,70,80,50,35,35,35,305,0.14,2.0
90,50,34,60,44,70,348,0.6283185840707964,50,65,85,35,35,55,325,0.32575757575757575,1.0
80,100,123,122,120,80,625,0.56,55,40,40,65,45,35,280,0.16428571428571428,1.0
60,95,80,60,80,30,405,0.19480519480519481,120,100,85,30,85,45,465,0.22448979591836735,0.5
75,95,67,125,95,83,540,0.7117117117117117,57,80,91,80,87,75,470,0.5737704918032787,2.0
58,70,45,40,45,42,300,0.25925925925925924,100,150,110,95,110,70,635,0.5923076923076923,1.0
67,82,62,46,48,43,348,0.22033898305084745,40,55,30,30,30,85,270,0.688,1.0
38,30,41,30,41,60,240,0.2897196261682243,55,75,85,25,25,15,280,0.1875,0.5
100,123,75,57,75,80,510,0.6923076923076923,78,92,75,74,63,118,500,0.8842975206611571,2.0
60,90,140,50,50,40,430,0.2535211267605634,90,55,75,60,75,30,385,0.13970588235294118,1.0
59,66,70,44,55,41,335,0.25190839694656486,75,90,50,110,80,95,500,0.7985611510791367,0.25
123,100,62,97,81,68,531,0.4806201550387597,106,130,90,110,154,90,680,0.719626168224299,0.25
106,150,70,194,120,140,780,0.952,25,35,70,95,55,45,325,0.16783216783216784,0.5
80,100,123,122,120,80,625,0.56,60,80,50,40,40,30,300,0.15328467153284672,2.0
60,70,105,70,120,75,500,0.5983606557377049,58,70,45,40,45,42,300,0.25925925925925924,2.0
59,66,70,44,55,41,335,0.25190839694656486,55,68,64,45,55,31,318,0.11666666666666667,0.5
85,105,85,40,50,40,405,0.211864406779661,79,115,70,125,80,111,580,0.864,0.5
250,5,5,35,105,50,450,0.15306122448979592,55,20,35,20,45,75,250,0.37681159420289856,1.0
65,90,40,45,80,75,395,0.625,80,50,100,100,200,50,580,0.2357142857142857,1.0
65,90,65,61,61,100,442,0.8373983739837398,114,85,70,85,80,30,464,0.2066115702479339,2.0
78,84,78,109,85,100,534,0.8646616541353384,65,40,50,125,60,30,370,0.07258064516129033,1.0
40,55,30,30,30,85,270,0.688,105,95,75,85,75,74,509,0.5714285714285714,1.0
40,55,70,45,60,30,300,0.10619469026548672,83,80,75,70,70,101,479,0.8615384615384616,1.0
35,70,55,45,55,25,285,0.09420289855072464,72,95,67,103,71,122,530,0.9606299212598425,4.0
40,65,95,60,45,35,340,0.13986013986013987,75,98,63,98,63,101,498,0.889763779527559,1.0
50,85,125,85,115,20,480,0.4306569343065693,65,125,100,60,70,70,490,0.6099290780141844,0.25
77,85,51,55,51,65,384,0.5163934426229508,78,92,75,74,63,118,500,0.8842975206611571,0.25
60,100,115,70,85,90,520,0.7557251908396947,65,95,75,55,55,85,430,0.6933333333333334,0.5
78,65,68,112,154,75,552,0.628099173553719,70,40,50,55,50,25,290,0.061068702290076333,1.0
70,40,50,55,50,25,290,0.061068702290076333,45,50,45,115,55,95,405,0.6936936936936937,1.0
58,50,145,95,105,30,483,0.2459016393442623,50,53,62,58,63,44,330,0.13709677419354838,1.0
30,40,55,40,55,60,280,0.3237410071942446,79,105,70,145,80,101,580,0.8608695652173913,0.5
50,53,48,53,48,64,316,0.358974358974359,100,100,90,150,140,90,670,0.71875,0.5
67,125,40,30,30,58,350,0.3431372549019608,79,115,70,125,80,111,580,0.8468468468468469,2.0
100,100,100,100,100,100,600,0.831858407079646,54,78,103,53,45,22,355,0.23255813953488372,1.0
65,65,45,75,45,95,390,0.72,40,20,30,40,80,55,265,0.22764227642276422,1.0
100,120,120,150,100,90,680,0.7880794701986755,95,155,109,70,130,81,640,0.6788321167883211,0.5
81,102,77,85,75,85,505,0.5642857142857143,95,65,65,110,130,60,525,0.4016393442622951,2.0
20,40,15,35,35,60,205,0.34285714285714286,46,87,60,30,40,57,320,0.37777777777777777,0.5
60,80,95,70,85,50,440,0.2231404958677686,78,81,71,74,69,126,499,0.9090909090909091,0.5
75,98,63,98,63,101,498,0.8091603053435115,20,15,20,10,55,80,200,0.2682926829268293,2.0
90,55,75,60,75,30,385,0.13970588235294118,61,90,45,50,50,160,456,0.9230769230769231,1.0
114,85,70,85,80,30,464,0.2066115702479339,60,80,110,50,80,45,425,0.2833333333333333,1.0
28,25,25,45,35,40,198,0.16083916083916083,80,100,200,50,100,50,580,0.3472222222222222,1.0
70,80,102,80,102,40,474,0.2677165354330709,50,65,107,105,107,86,520,0.6991150442477876,0.25
85,60,65,135,105,100,550,0.7518248175182481,74,108,133,83,65,32,495,0.32142857142857145,0.25
90,55,75,60,75,30,385,0.13970588235294118,70,55,65,95,85,70,440,0.5307692307692308,0.5
55,55,50,45,65,55,325,0.37373737373737376,54,78,103,53,45,22,355,0.23255813953488372,0.5
40,80,100,30,30,20,300,0.11851851851851852,60,50,50,60,70,50,340,0.28346456692913385,0.5
49,55,42,42,37,85,310,0.6068376068376068,95,85,85,65,65,35,430,0.2571428571428571,1.0
190,33,58,33,58,33,405,0.13432835820895522,75,90,50,110,80,95,500,0.7985611510791367,0.0
60,65,60,130,75,110,500,0.7719298245614035,50,35,55,25,25,15,205,0.05263157894736842,1.0
70,80,102,80,102,40,474,0.2677165354330709,60,50,40,85,75,95,405,0.7540983606557377,0.5
100,50,50,76,96,70,442,0.5,44,38,33,61,43,70,289,0.5267857142857143,0.5
55,45,43,55,43,72,313,0.5853658536585366,60,69,95,69,95,36,424,0.2608695652173913,0.5
100,150,120,120,100,90,680,0.6493506493506493,55,68,64,45,55,31,318,0.11666666666666667,0.5
60,90,55,90,80,110,485,0.8677685950413223,40,40,55,40,70,55,300,0.40939597315436244,0.0
108,112,118,68,72,47,525,0.2916666666666667,45,67,60,35,50,63,320,0.5128205128205128,1.0
40,45,65,100,120,90,460,0.5588235294117647,45,60,30,80,50,65,330,0.4603174603174603,0.0
105,140,95,55,65,45,505,0.3,79,85,60,55,60,71,410,0.60431654676259,2.0
20,25,45,70,90,60,310,0.30833333333333335,72,105,115,54,86,68,500,0.5149253731343284,1.0
70,85,140,85,70,20,470,0.272,70,80,70,80,70,110,480,0.6594202898550725,2.0
40,40,35,50,100,70,335,0.5031847133757962,75,123,67,95,85,95,540,0.7642276422764228,1.0
64,165,75,93,83,75,555,0.6587301587301587,35,80,50,50,70,120,405,0.84375,1.0
91,90,72,90,129,108,580,0.896,60,80,50,40,40,30,300,0.15328467153284672,0.5
90,92,75,92,85,60,494,0.49586776859504134,90,60,60,40,40,40,330,0.29545454545454547,4.0
80,100,200,50,100,50,580,0.3472222222222222,55,70,40,60,40,40,305,0.26956521739130435,2.0
100,103,75,120,75,127,600,0.940677966101695,80,75,150,75,150,50,580,0.30973451327433627,0.25
130,85,80,85,95,60,535,0.43884892086330934,60,59,85,79,105,36,424,0.16666666666666666,1.0
90,110,80,100,80,95,555,0.7982456140350878,95,60,79,100,125,81,540,0.6201550387596899,0.5
80,100,200,50,100,50,580,0.3472222222222222,123,77,72,99,92,58,521,0.4621212121212121,2.0
50,65,107,105,107,86,520,0.6991150442477876,250,5,5,35,105,50,450,0.15306122448979592,1.0
41,64,45,50,50,50,300,0.36752136752136755,120,120,120,120,120,120,720,0.9344262295081968,1.0
80,160,60,170,130,80,680,0.6180555555555556,52,65,55,58,62,60,352,0.4482758620689655,1.0
60,70,105,70,120,75,500,0.5983606557377049,91,129,90,72,90,108,580,0.8536585365853658,2.0
85,120,70,50,60,100,485,0.8308823529411765,40,35,30,20,20,50,195,0.23423423423423423,2.0
45,30,50,65,50,45,285,0.13821138211382114,150,100,120,100,120,90,680,0.6666666666666666,1.0
20,15,20,10,55,80,200,0.2682926829268293,130,65,60,110,95,65,525,0.5227272727272727,0.5
65,90,122,58,75,84,494,0.71875,30,30,42,30,42,70,244,0.4230769230769231,0.25
60,85,60,85,60,55,405,0.3673469387755102,70,95,125,65,75,45,475,0.33613445378151263,1.0
75,125,100,70,80,45,495,0.33035714285714285,70,60,75,110,75,90,480,0.7165354330708661,2.0
40,30,35,45,40,55,245,0.31496062992125984,40,40,55,40,70,55,300,0.40939597315436244,1.0
150,80,44,90,54,80,498,0.625,100,100,125,110,50,50,535,0.384,2.0
70,60,75,110,75,90,480,0.7165354330708661,54,78,103,53,45,22,355,0.23255813953488372,4.0
35,45,160,30,45,70,385,0.48148148148148145,80,80,50,40,50,25,325,0.176056338028169,2.0
48,72,48,72,48,48,336,0.25984251968503935,40,60,40,40,40,30,250,0.0948905109489051,2.0
126,131,95,131,98,99,680,0.8102189781021898,50,85,85,55,55,50,380,0.3902439024390244,0.25
80,105,65,60,75,130,515,0.9645390070921985,103,60,126,80,126,50,545,0.36363636363636365,1.0
61,84,65,70,70,70,420,0.5,60,59,85,79,105,36,424,0.16666666666666666,1.0
60,85,42,85,42,91,405,0.8227848101265823,45,30,50,55,65,45,290,0.208,2.0
70,90,70,60,60,70,420,0.6390977443609023,35,60,44,40,54,55,288,0.366412213740458,1.0
35,55,35,30,30,35,220,0.23684210526315788,30,45,55,70,55,85,340,0.5633802816901409,1.0
80,80,90,110,130,110,600,0.8721804511278195,80,50,100,100,200,50,580,0.2357142857142857,1.0
50,65,45,85,65,95,405,0.7238095238095238,75,125,70,125,70,115,580,0.9037037037037037,1.0
65,155,120,65,90,105,600,0.8677685950413223,95,110,95,40,95,55,490,0.40336134453781514,1.0
60,60,60,35,35,30,280,0.11194029850746269,60,75,85,100,85,115,520,0.8992248062015504,1.0
126,131,95,131,98,99,680,0.8102189781021898,126,131,95,131,98,99,680,0.8294573643410853,0.5
67,57,55,77,55,114,425,0.8879310344827587,75,100,95,40,70,110,490,0.8717948717948718,1.0
79,115,70,125,80,111,580,0.864,40,45,40,62,60,60,307,0.33884297520661155,1.0
70,90,45,15,45,50,315,0.3629032258064516,65,90,115,45,115,58,488,0.5041322314049587,1.0
50,65,64,44,48,43,314,0.2196969696969697,85,76,64,45,55,90,415,0.6739130434782609,1.0
60,79,105,59,85,36,424,0.17054263565891473,60,85,60,85,60,55,405,0.3673469387755102,0.5
80,80,50,40,50,25,325,0.176056338028169,65,80,65,35,65,60,370,0.38405797101449274,1.0
43,30,55,40,65,97,330,0.6030534351145038,45,30,50,55,65,45,290,0.208,1.0
60,80,50,40,40,30,300,0.15328467153284672,59,59,58,90,70,73,409,0.5826086956521739,0.5
30,42,118,42,88,30,350,0.112,78,52,60,63,65,23,341,0.06015037593984962,0.5
90,85,100,95,125,85,580,0.6834532374100719,80,50,100,100,200,50,580,0.2357142857142857,0.5
40,65,95,60,45,35,340,0.13986013986013987,54,63,52,83,56,97,405,0.7697841726618705,1.0
50,50,120,80,80,30,410,0.07258064516129033,45,75,60,40,30,50,300,0.304,0.5
73,100,60,100,60,65,458,0.42657342657342656,79,115,70,125,80,111,580,0.864,1.0
60,40,60,95,60,55,370,0.4222222222222222,100,100,100,100,100,100,600,0.8758169934640523,4.0
68,65,65,125,115,80,518,0.6461538461538462,46,87,60,30,40,57,320,0.37777777777777777,2.0
60,80,95,70,85,50,440,0.2231404958677686,65,75,90,97,123,44,494,0.1987179487179487,1.0
60,40,80,60,45,40,325,0.23529411764705882,100,123,75,57,75,80,510,0.6923076923076923,0.5
75,75,75,125,95,40,485,0.15671641791044777,50,50,40,30,30,50,250,0.2781954887218045,2.0
55,35,50,55,110,85,390,0.6277372262773723,125,170,100,120,90,95,700,0.77,1.0
55,112,45,74,45,70,401,0.559322033898305,70,60,62,80,82,60,414,0.4375,8.0
50,35,55,25,25,15,205,0.05263157894736842,70,140,70,110,65,105,560,0.95,2.0
75,125,75,30,75,85,465,0.625,74,108,133,83,65,32,495,0.32142857142857145,2.0
65,110,130,60,65,95,525,0.8278145695364238,60,82,45,45,45,74,351,0.5752212389380531,2.0
65,130,60,95,110,65,525,0.5303030303030303,86,68,72,109,66,106,507,0.8099173553719008,0.5
80,92,65,65,80,68,450,0.4824561403508772,40,50,90,30,55,65,330,0.44680851063829785,1.0
62,50,58,73,54,72,369,0.4435483870967742,90,100,90,125,85,90,580,0.7352941176470589,0.5
70,120,100,145,105,20,560,0.2824427480916031,62,77,62,50,42,65,358,0.4838709677419355,0.0
78,92,75,74,63,118,500,0.8842975206611571,75,80,60,65,90,102,472,0.8625954198473282,2.0
116,55,85,107,95,29,487,0.06818181818181818,59,59,58,90,70,73,409,0.5826086956521739,1.0
55,75,60,75,60,103,428,0.7982456140350878,59,45,40,35,40,31,250,0.14285714285714285,1.0
40,35,30,20,20,50,195,0.23423423423423423,105,140,55,30,55,95,480,0.8195488721804511,0.5
35,55,35,30,30,35,220,0.23684210526315788,82,80,86,85,75,72,480,0.6183206106870229,0.5
65,83,57,95,85,105,490,0.8914728682170543,70,92,65,80,55,98,460,0.8090909090909091,2.0
70,110,80,55,80,105,500,0.8794326241134752,45,65,34,40,34,45,263,0.2589928057553957,0.5
60,48,45,43,90,42,328,0.21897810218978103,44,58,44,58,44,61,309,0.41964285714285715,1.0
85,80,90,105,95,60,515,0.49074074074074076,101,72,72,99,89,29,462,0.1937984496124031,1.0
49,66,70,44,55,51,335,0.4260869565217391,78,52,60,63,65,23,341,0.06015037593984962,1.0
50,100,150,100,150,50,600,0.37142857142857144,80,100,70,60,70,95,475,0.7416666666666667,1.0
100,100,125,110,50,50,535,0.384,40,30,50,55,55,100,330,0.584070796460177,1.0
55,47,52,40,40,41,275,0.16806722689075632,61,78,95,56,58,57,405,0.40336134453781514,2.0
35,80,50,50,70,120,405,0.84375,90,110,80,100,80,95,555,0.7982456140350878,2.0
125,120,90,170,100,95,700,0.78125,108,100,121,81,95,95,600,0.7476635514018691,8.0
100,75,115,90,115,85,580,0.6446280991735537,50,65,64,44,48,43,314,0.2196969696969697,0.5
60,45,70,45,90,95,405,0.7304964539007093,110,135,60,50,65,88,508,0.7744360902255639,0.0
80,92,65,65,80,68,450,0.4824561403508772,65,150,40,15,80,145,495,0.9663865546218487,1.0
80,135,85,70,95,150,615,0.9844961240310077,56,61,65,48,45,38,313,0.17567567567567569,2.0
65,65,60,110,95,130,525,0.9253731343283582,65,130,60,95,110,65,525,0.5303030303030303,1.0
75,100,66,60,66,115,482,0.918918918918919,50,40,85,40,65,25,305,0.08870967741935484,1.0
100,103,75,120,75,127,600,0.940677966101695,65,100,70,80,80,105,500,0.8666666666666667,0.5
75,75,60,83,60,60,413,0.39344262295081966,75,75,95,75,95,113,528,0.9015151515151515,0.5
64,51,23,51,23,28,240,0.11363636363636363,85,90,80,70,80,130,535,0.9262295081967213,1.0
75,100,95,40,70,110,490,0.8717948717948718,83,80,75,70,70,101,479,0.8615384615384616,1.0
73,76,75,81,100,100,505,0.8110236220472441,95,135,80,110,80,100,600,0.8248175182481752,0.5
58,50,145,95,105,30,483,0.2459016393442623,30,42,118,42,88,30,350,0.112,1.0
45,60,32,50,32,76,295,0.5925925925925926,78,52,60,63,65,23,341,0.06015037593984962,1.0
90,60,60,40,40,40,330,0.29545454545454547,25,35,70,95,55,45,325,0.16783216783216784,4.0
97,165,60,65,50,58,495,0.3902439024390244,55,20,35,20,45,75,250,0.37681159420289856,1.0
59,45,40,35,40,31,250,0.14285714285714285,100,110,90,85,90,60,535,0.47794117647058826,1.0
45,30,40,105,50,20,290,0.031007751937984496,90,120,75,60,60,45,450,0.29411764705882354,1.0
75,98,63,98,63,101,498,0.889763779527559,91,90,129,90,72,108,580,0.9140625,2.0
78,84,78,109,85,100,534,0.8646616541353384,90,30,15,40,20,15,210,0.043478260869565216,1.0
130,85,80,85,95,60,535,0.43884892086330934,63,60,55,50,50,71,349,0.5289256198347108,2.0
71,120,95,120,95,99,600,0.8203125,70,43,53,43,53,40,302,0.19090909090909092,0.5
100,77,77,128,128,90,600,0.6901408450704225,100,150,110,95,110,70,635,0.5923076923076923,2.0
100,150,110,95,110,70,635,0.5923076923076923,70,80,50,35,35,35,305,0.14,1.0
108,100,121,81,95,95,600,0.7476635514018691,250,5,5,35,105,50,450,0.15306122448979592,1.0
65,40,70,80,140,70,465,0.5954198473282443,115,45,20,45,25,20,270,0.11538461538461539,1.0
80,110,60,150,130,70,600,0.5042016806722689,63,63,47,41,41,74,329,0.56,0.0
38,35,40,27,25,35,200,0.08208955223880597,80,100,70,60,70,95,475,0.7416666666666667,2.0
106,190,100,154,100,130,780,0.9259259259259259,100,103,75,120,75,127,600,0.940677966101695,0.5
90,65,65,40,40,15,315,0.19672131147540983,50,65,107,105,107,86,520,0.7313432835820896,0.5
60,62,63,80,80,60,405,0.38016528925619836,82,80,86,85,75,72,480,0.6183206106870229,2.0
20,10,55,15,20,80,200,0.17985611510791366,55,45,43,55,43,72,313,0.5853658536585366,1.0
85,105,100,79,83,78,530,0.5869565217391305,49,55,42,42,37,85,310,0.6068376068376068,1.0
95,155,109,70,130,81,640,0.6788321167883211,40,40,35,50,100,70,335,0.5031847133757962,0.5
41,64,45,50,50,50,300,0.36752136752136755,70,50,30,95,135,105,485,0.8040540540540541,1.0
150,100,120,100,120,90,680,0.6666666666666666,65,60,70,85,75,40,395,0.1796875,0.0
58,64,58,80,65,80,405,0.609271523178808,45,22,60,27,30,29,213,0.07518796992481203,2.0
40,40,50,30,30,30,220,0.0873015873015873,100,134,110,95,100,61,600,0.4057971014492754,2.0
80,82,83,100,100,80,525,0.6742424242424242,108,112,118,68,72,47,525,0.2916666666666667,1.0
104,91,63,91,73,68,490,0.5118110236220472,55,55,85,65,85,35,380,0.2014388489208633,0.5
75,123,67,95,85,95,540,0.7642276422764228,70,50,30,95,135,105,485,0.8040540540540541,1.0
41,64,45,50,50,50,300,0.36752136752136755,90,92,75,92,85,60,494,0.49586776859504134,1.0
90,110,80,100,80,95,555,0.7982456140350878,60,130,80,60,60,70,460,0.5153846153846153,2.0
55,50,65,175,95,150,590,0.7818181818181819,55,81,60,50,70,97,413,0.7214285714285714,1.0
50,105,79,35,110,76,455,0.6214285714285714,35,85,45,35,35,75,310,0.6492537313432836,1.0
75,90,50,110,80,95,500,0.7985611510791367,40,45,35,65,55,70,310,0.4482758620689655,2.0
89,124,80,55,80,55,483,0.5714285714285714,100,70,70,65,65,45,415,0.1897810218978102,0.0
55,85,122,58,75,99,494,0.8099173553719008,95,110,80,70,80,50,485,0.37209302325581395,1.0
35,55,35,30,30,35,220,0.23684210526315788,50,70,100,40,40,30,330,0.2222222222222222,1.0
68,125,65,65,115,80,518,0.6277372262773723,36,50,50,65,60,44,305,0.16363636363636364,2.0
80,160,60,170,130,80,680,0.6180555555555556,95,135,80,110,80,100,600,0.8248175182481752,1.0
75,95,60,65,60,115,470,0.8778625954198473,55,70,45,70,50,60,350,0.45,1.0
50,50,50,50,50,50,300,0.30708661417322836,190,33,58,33,58,33,405,0.13432835820895522,1.0
84,86,88,111,101,60,530,0.4634146341463415,45,25,50,25,25,35,205,0.13076923076923078,1.0
61,72,57,55,55,65,365,0.3984375,60,52,168,47,138,30,495,0.19834710743801653,0.0
20,40,15,35,35,60,205,0.34285714285714286,55,55,85,65,85,35,380,0.2014388489208633,2.0
60,80,110,50,80,45,425,0.2833333333333333,70,83,50,37,50,60,350,0.3360655737704918,0.0
54,78,103,53,45,22,355,0.23255813953488372,110,123,65,100,65,65,528,0.5217391304347826,2.0
25,20,15,105,55,90,310,0.32407407407407407,125,58,58,76,76,67,460,0.515625,1.0
75,90,90,140,90,115,600,0.9481481481481482,65,75,70,95,70,95,470,0.7272727272727273,2.0
44,38,33,61,43,70,289,0.5267857142857143,59,74,50,35,50,35,303,0.3125,0.0
73,100,60,100,60,65,458,0.42657342657342656,85,110,90,45,90,80,500,0.6206896551724138,1.0
20,40,90,30,90,25,295,0.11363636363636363,65,75,105,35,65,85,430,0.6940298507462687,1.0
116,55,85,107,95,29,487,0.06818181818181818,91,72,90,129,90,108,580,0.8925619834710744,1.0
40,70,130,60,130,25,455,0.17355371900826447,30,56,35,25,35,72,253,0.48148148148148145,0.0
70,140,230,60,80,50,630,0.32432432432432434,76,48,48,57,62,34,325,0.11688311688311688,0.5
80,120,130,55,65,45,495,0.37037037037037035,70,95,125,65,75,45,475,0.33613445378151263,2.0
100,164,150,95,120,71,700,0.5645161290322581,76,48,48,57,62,34,325,0.11688311688311688,1.0
60,50,100,85,70,65,430,0.47580645161290325,58,109,112,48,48,109,484,0.8805970149253731,1.0
49,49,56,49,61,66,330,0.5190839694656488,50,65,107,105,107,86,520,0.7758620689655172,0.5
55,50,40,40,40,75,300,0.5945945945945946,48,61,40,61,40,50,300,0.2543859649122807,1.0
50,65,85,35,35,55,325,0.32575757575757575,255,10,10,75,135,55,540,0.3125,1.0
95,125,79,60,100,81,540,0.6165413533834586,100,5,5,15,65,30,220,0.07692307692307693,1.0
55,75,85,25,25,15,280,0.1875,70,110,70,115,70,90,525,0.75,0.25
85,80,70,135,75,90,535,0.7006802721088435,45,45,35,20,30,20,195,0.07246376811594203,1.0
58,50,145,95,105,30,483,0.2459016393442623,70,105,105,50,40,20,390,0.33587786259541985,1.0
50,25,28,45,55,15,218,0.0625,95,109,105,75,85,56,525,0.34513274336283184,1.0
50,95,90,95,90,180,600,0.9172413793103448,120,120,120,120,120,120,720,0.9344262295081968,1.0
61,78,95,56,58,57,405,0.40336134453781514,40,30,35,45,40,55,245,0.31496062992125984,0.25
85,80,70,135,75,90,535,0.7006802721088435,78,65,68,112,154,75,552,0.628099173553719,1.0
65,63,45,45,45,45,308,0.2595419847328244,90,130,80,65,85,55,505,0.4396551724137931,1.0
100,150,90,180,160,90,770,0.7348484848484849,50,160,110,160,110,110,700,0.8854961832061069,2.0
65,75,90,97,123,44,494,0.1987179487179487,90,65,65,40,40,15,315,0.19672131147540983,1.0
44,38,39,61,79,42,303,0.2251655629139073,110,65,105,55,95,80,510,0.6258503401360545,2.0
70,75,60,105,60,105,475,0.88,65,130,60,95,110,65,525,0.5303030303030303,1.0
60,100,85,80,85,100,510,0.7007874015748031,85,110,90,45,90,80,500,0.6206896551724138,2.0
85,76,64,45,55,90,415,0.6739130434782609,65,76,84,54,96,105,480,0.9008264462809917,1.0
70,55,75,45,65,60,370,0.45901639344262296,110,65,75,125,85,30,490,0.15,2.0
30,35,30,100,35,80,310,0.4765625,55,55,55,85,55,30,335,0.1320754716981132,2.0
95,124,78,69,71,58,495,0.37398373983739835,75,95,122,58,75,69,494,0.5725806451612904,0.0
125,170,100,120,90,95,700,0.77,60,50,50,60,70,50,340,0.28346456692913385,1.0
55,35,50,55,110,85,390,0.6277372262773723,60,80,95,70,85,50,440,0.2231404958677686,0.25
73,76,75,81,100,100,505,0.8110236220472441,70,85,140,85,70,20,470,0.272,0.5
100,73,83,73,83,55,467,0.371900826446281,100,90,130,45,65,55,485,0.4253731343283582,0.5
70,80,102,80,102,40,474,0.2677165354330709,70,80,50,35,35,35,305,0.14,1.0
74,108,133,83,65,32,495,0.32142857142857145,53,54,53,37,46,45,288,0.3090909090909091,1.0
73,100,60,100,60,65,458,0.42657342657342656,63,63,47,41,41,74,329,0.56,0.5
75,105,75,105,75,45,480,0.3274336283185841,50,53,48,53,48,64,316,0.46153846153846156,2.0
78,84,78,109,85,100,534,0.8646616541353384,50,85,125,85,115,20,480,0.4306569343065693,1.0
70,43,53,43,53,40,302,0.19090909090909092,30,105,90,25,25,50,325,0.2773722627737226,1.0
80,120,80,120,80,100,580,0.8478260869565217,108,100,121,81,95,95,600,0.7476635514018691,4.0
38,35,35,65,55,50,278,0.2647058823529412,70,135,105,60,105,20,495,0.5806451612903226,0.25
85,80,70,135,75,90,535,0.7006802721088435,68,85,65,165,135,100,618,0.8083333333333333,1.0
82,121,119,69,59,71,521,0.5394736842105263,90,95,95,70,90,70,510,0.5230769230769231,0.5
45,90,20,65,20,65,305,0.5116279069767442,100,103,75,120,75,127,600,0.940677966101695,0.5
75,100,95,40,70,110,490,0.8717948717948718,75,125,230,55,95,30,610,0.3448275862068966,0.5
90,100,60,90,60,80,480,0.6422764227642277,60,90,55,90,80,110,485,0.8677685950413223,1.0
55,81,60,50,70,97,413,0.7214285714285714,60,50,70,80,80,140,480,0.8449612403100775,1.0
85,80,90,105,95,60,515,0.49074074074074076,90,132,105,132,105,30,594,0.4246575342465753,1.0
59,45,40,35,40,31,250,0.14285714285714285,60,70,50,100,50,65,395,0.5217391304347826,1.0
58,64,58,80,65,80,405,0.609271523178808,75,90,140,60,60,40,465,0.3008130081300813,4.0
90,100,70,110,150,80,600,0.6037735849056604,45,40,60,40,75,50,310,0.2926829268292683,1.0
250,5,5,35,105,50,450,0.15306122448979592,60,65,70,85,75,40,395,0.21705426356589147,1.0
79,105,70,145,80,101,580,0.8608695652173913,60,50,50,60,70,50,340,0.28346456692913385,2.0
45,95,50,40,50,75,355,0.54,65,60,110,130,95,65,525,0.47761194029850745,2.0
76,25,45,67,55,24,292,0.0390625,60,50,150,50,150,60,520,0.5206611570247934,0.5
80,160,80,130,80,100,630,0.8455284552845529,45,40,60,40,75,50,310,0.2926829268292683,1.0
75,98,63,98,63,101,498,0.849624060150376,60,50,150,50,150,60,520,0.5206611570247934,1.0
60,40,50,75,85,95,405,0.6044776119402985,60,62,63,80,80,60,405,0.38016528925619836,0.5
60,69,95,69,95,36,424,0.2608695652173913,40,80,35,35,45,70,305,0.4661016949152542,0.5
45,67,60,35,50,63,320,0.5128205128205128,255,10,10,75,135,55,540,0.3125,1.0
70,70,115,130,90,60,535,0.5338983050847458,78,81,71,74,69,126,499,0.9090909090909091,1.0
65,80,65,35,65,60,370,0.38405797101449274,106,190,100,154,100,130,780,0.9259259259259259,1.0
50,53,48,53,48,64,316,0.46153846153846156,150,100,120,100,120,90,680,0.6666666666666666,0.5
65,150,60,115,60,115,565,0.935251798561151,100,123,75,57,75,80,510,0.6923076923076923,1.0
103,60,86,60,86,50,445,0.3458646616541353,70,140,230,60,80,50,630,0.32432432432432434,0.5
45,75,60,40,30,50,300,0.304,75,69,72,114,100,104,534,0.8253968253968254,1.0
70,65,60,90,75,90,450,0.6571428571428571,60,40,60,40,60,35,295,0.18055555555555555,4.0
135,85,40,40,85,5,390,0.6864406779661016,71,73,88,120,89,59,500,0.43537414965986393,1.0
46,87,60,30,40,57,320,0.37777777777777777,50,53,62,58,63,44,330,0.13709677419354838,1.0
78,81,71,74,69,126,499,0.9090909090909091,85,56,77,50,77,78,423,0.53125,1.0
70,55,65,95,85,70,440,0.5307692307692308,105,130,120,45,45,40,485,0.4444444444444444,1.0
45,80,100,35,37,28,325,0.3125,95,155,109,70,130,81,640,0.6788321167883211,0.25
77,120,90,60,90,48,485,0.2785714285714286,50,70,160,70,160,90,600,0.7417218543046358,1.0
85,70,80,97,80,123,535,0.9304347826086956,80,80,80,80,80,80,480,0.6015037593984962,1.0
70,90,90,135,90,125,600,0.9401709401709402,80,100,200,50,100,50,580,0.3472222222222222,1.0
75,125,230,55,95,30,610,0.3448275862068966,80,160,60,170,130,80,680,0.6180555555555556,1.0
65,90,122,58,75,84,494,0.71875,75,90,140,60,60,40,465,0.3008130081300813,0.25
55,66,44,44,56,85,350,0.6888888888888889,76,48,48,57,62,34,325,0.11688311688311688,1.0
50,53,62,58,63,44,330,0.13709677419354838,60,82,45,45,45,74,351,0.5752212389380531,2.0
85,60,65,135,105,100,550,0.7518248175182481,150,160,100,95,65,100,670,0.8866666666666667,1.0
44,75,35,63,33,45,295,0.2647058823529412,60,115,105,65,70,80,495,0.7181818181818181,1.0
80,100,70,60,70,95,475,0.7416666666666667,80,110,60,150,130,70,600,0.5042016806722689,0.0
83,80,80,135,80,121,579,0.9444444444444444,35,80,50,50,70,120,405,0.84375,1.0
70,75,60,105,60,105,475,0.88,54,45,47,75,98,52,371,0.39669421487603307,1.0
70,120,40,95,40,95,460,0.8106060606060606,105,140,95,55,65,45,505,0.3,0.5
95,75,180,130,80,30,590,0.13793103448275862,75,75,130,75,130,95,580,0.7479674796747967,0.5
45,30,35,20,20,45,195,0.14782608695652175,52,65,50,45,50,38,300,0.27419354838709675,2.0
95,109,105,75,85,56,525,0.34513274336283184,80,100,200,50,100,50,580,0.3472222222222222,4.0
65,47,55,73,75,85,400,0.65,40,30,50,55,55,100,330,0.584070796460177,1.0
65,63,45,45,45,45,308,0.2595419847328244,110,123,65,100,65,65,528,0.5217391304347826,0.5
80,120,80,120,80,100,580,0.8478260869565217,70,20,50,20,50,40,250,0.1557377049180328,0.5
50,55,50,36,30,43,264,0.2922077922077922,125,120,90,170,100,95,700,0.78125,1.0
35,40,100,90,55,35,355,0.1796875,85,80,90,105,95,60,515,0.49074074074074076,1.0
90,85,100,95,125,85,580,0.6834532374100719,45,90,20,65,20,65,305,0.5116279069767442,0.5
91,90,106,130,106,77,600,0.648854961832061,70,84,70,65,70,51,410,0.2949640287769784,1.0
50,20,55,25,25,30,205,0.09774436090225563,75,98,63,98,63,101,498,0.889763779527559,0.5
40,50,45,70,45,70,320,0.5517241379310345,64,88,50,88,50,106,446,0.9111111111111111,0.0
55,65,35,60,30,85,330,0.6126126126126126,61,90,45,50,50,160,456,0.9230769230769231,1.0
100,100,125,110,50,50,535,0.384,60,60,40,65,45,35,305,0.15833333333333333,1.0
50,35,55,25,25,15,205,0.021739130434782608,55,35,50,55,110,85,390,0.6277372262773723,0.5
40,50,45,70,45,70,320,0.5517241379310345,76,147,90,60,70,97,540,0.8267716535433071,1.0
60,80,50,40,40,30,300,0.15328467153284672,100,150,90,180,160,90,770,0.7348484848484849,1.0
76,48,48,57,62,34,325,0.11688311688311688,50,35,55,25,25,15,205,0.05263157894736842,1.0
126,131,95,131,98,99,680,0.8294573643410853,78,92,75,74,63,118,500,0.8842975206611571,2.0
78,84,78,109,85,100,534,0.8646616541353384,60,105,60,120,60,105,510,0.8849557522123894,1.0
54,66,70,44,55,46,335,0.4214876033057851,80,45,65,90,110,80,470,0.5462962962962963,2.0
60,62,50,62,60,40,334,0.18181818181818182,50,20,40,20,40,20,190,0.0962962962962963,1.0
65,75,105,35,65,85,430,0.6940298507462687,60,150,50,150,50,60,520,0.5,1.0
38,30,41,30,41,60,240,0.2897196261682243,45,85,50,55,50,65,350,0.5076923076923077,1.0
105,30,105,140,105,55,540,0.3524590163934426,68,75,53,83,113,60,452,0.45384615384615384,0.5
50,65,85,35,35,55,325,0.32575757575757575,70,84,70,65,70,51,410,0.2949640287769784,0.5
62,73,55,56,52,84,382,0.7244094488188977,110,78,73,76,71,60,468,0.3333333333333333,0.5
80,70,40,100,60,145,495,0.921875,50,70,160,70,160,90,600,0.7417218543046358,2.0
70,65,60,90,75,90,450,0.6571428571428571,106,90,130,90,154,110,680,0.8699186991869918,1.0
150,80,44,90,54,80,498,0.625,40,60,40,40,40,30,250,0.0948905109489051,2.0
68,125,65,65,115,80,518,0.6277372262773723,85,100,122,58,75,54,494,0.3939393939393939,0.0
60,75,85,100,85,115,520,0.8992248062015504,70,40,50,55,50,25,290,0.061068702290076333,0.5
84,86,88,111,101,60,530,0.4634146341463415,60,25,35,70,80,60,330,0.3076923076923077,1.0
95,75,80,100,110,30,490,0.24242424242424243,100,110,90,85,90,60,535,0.47794117647058826,2.0
85,80,90,105,95,60,515,0.49074074074074076,100,180,160,150,90,90,770,0.7520661157024794,1.0
60,75,100,55,80,50,420,0.3088235294117647,101,72,72,99,89,29,462,0.1937984496124031,0.5
40,45,35,30,40,55,245,0.3793103448275862,70,140,230,60,80,50,630,0.32432432432432434,0.0
70,100,70,105,75,40,460,0.23214285714285715,45,60,32,50,32,76,295,0.5925925925925926,2.0
100,100,100,100,100,100,600,0.8602941176470589,85,105,55,85,50,115,495,0.9032258064516129,2.0
60,45,50,90,80,70,395,0.625,50,72,35,35,35,65,292,0.5373134328358209,2.0
55,104,105,94,75,52,485,0.36363636363636365,1,90,45,30,30,40,236,0.33064516129032256,1.0
72,58,80,103,80,97,490,0.7171052631578947,50,160,110,160,110,110,700,0.8854961832061069,0.5
70,95,85,55,65,70,440,0.5,35,55,40,50,50,90,320,0.6838235294117647,1.0
91,72,90,129,90,108,580,0.8925619834710744,40,55,30,30,30,60,245,0.43548387096774194,1.0
100,73,83,73,83,55,467,0.371900826446281,70,55,55,80,60,45,365,0.2222222222222222,1.0
103,93,67,71,61,84,479,0.7142857142857143,65,90,65,61,61,100,442,0.8373983739837398,1.0
76,147,90,60,70,97,540,0.8267716535433071,82,80,86,85,75,72,480,0.6183206106870229,0.0
100,150,90,180,160,90,770,0.7348484848484849,80,80,80,80,80,80,480,0.5606060606060606,0.5
55,65,35,60,30,85,330,0.6126126126126126,63,120,85,90,55,55,468,0.2809917355371901,0.5
80,45,65,90,110,80,470,0.5462962962962963,103,60,86,60,86,50,445,0.3458646616541353,1.0
45,55,39,35,39,42,255,0.18518518518518517,50,64,50,45,50,41,300,0.22727272727272727,0.5
70,55,55,80,60,45,365,0.2222222222222222,40,80,100,30,30,20,300,0.11851851851851852,0.0
35,70,55,45,55,25,285,0.09420289855072464,110,160,110,80,110,100,670,0.8591549295774648,1.0
106,90,130,90,154,110,680,0.8699186991869918,65,40,70,80,140,70,465,0.5954198473282443,1.0
61,90,45,50,50,160,456,0.9230769230769231,95,125,79,60,100,81,540,0.6165413533834586,0.5
75,80,70,65,75,90,455,0.7578125,70,135,105,60,105,20,495,0.5806451612903226,0.0
65,75,90,97,123,44,494,0.1987179487179487,67,89,116,79,116,33,500,0.2624113475177305,0.0
85,73,70,73,115,67,483,0.5126050420168067,108,100,121,81,95,95,600,0.7476635514018691,2.0
110,85,95,80,95,50,515,0.2713178294573643,45,60,45,25,45,55,275,0.29,1.0
40,29,45,29,45,36,224,0.14634146341463414,90,90,85,125,90,100,580,0.768595041322314,0.5
60,60,60,85,85,85,435,0.631578947368421,75,100,66,60,66,115,482,0.918918918918919,0.0
45,85,70,40,40,60,340,0.5229357798165137,45,30,15,85,65,65,305,0.36220472440944884,4.0
35,55,40,50,50,90,320,0.6838235294117647,91,90,106,130,106,77,600,0.648854961832061,1.0
70,83,50,37,50,60,350,0.3360655737704918,130,65,60,110,95,65,525,0.5227272727272727,1.0
38,35,35,65,55,50,278,0.2647058823529412,55,47,52,40,40,41,275,0.16806722689075632,1.0
62,44,50,44,50,55,305,0.3629032258064516,100,164,150,95,120,71,700,0.5645161290322581,1.0
75,75,75,125,95,40,485,0.15671641791044777,28,25,25,45,35,40,198,0.16083916083916083,0.5
80,160,60,170,130,80,680,0.6180555555555556,100,100,125,110,50,50,535,0.384,1.0
70,105,105,50,40,20,390,0.33587786259541985,35,45,160,30,45,70,385,0.48148148148148145,0.5
90,95,105,165,110,45,610,0.2890625,50,92,108,92,108,35,485,0.2457627118644068,1.0
64,78,52,78,52,81,405,0.6422764227642277,39,52,43,60,50,65,309,0.49107142857142855,0.5
20,40,90,30,90,25,295,0.11363636363636363,50,65,107,105,107,86,520,0.7272727272727273,1.0
50,50,77,95,77,91,440,0.5916666666666667,120,100,85,30,85,45,465,0.22448979591836735,1.0
54,78,103,53,45,22,355,0.23255813953488372,100,100,80,60,60,50,450,0.3050847457627119,2.0
30,30,30,30,30,30,180,0.12612612612612611,65,125,100,60,70,70,490,0.6099290780141844,0.5
80,100,200,50,100,50,580,0.3472222222222222,105,180,100,180,100,115,780,0.9477611940298507,2.0
50,50,77,95,77,91,440,0.5916666666666667,30,45,55,70,55,85,340,0.5633802816901409,2.0
85,56,77,50,77,78,423,0.53125,65,76,84,54,96,105,480,0.9008264462809917,1.0
60,80,110,50,80,45,425,0.2833333333333333,75,105,75,105,75,45,480,0.3274336283185841,1.0
45,80,100,35,37,28,325,0.3125,90,132,105,132,105,30,594,0.4246575342465753,2.0
45,53,70,40,60,42,310,0.25735294117647056,100,100,80,60,60,50,450,0.3050847457627119,2.0
60,62,50,62,60,40,334,0.18181818181818182,40,40,50,30,30,30,220,0.0873015873015873,1.0
65,60,70,85,75,40,395,0.1796875,72,58,80,103,80,97,490,0.7171052631578947,1.0
45,60,45,25,45,55,275,0.29,95,117,80,65,70,92,519,0.8409090909090909,1.0
106,110,90,154,90,130,680,0.926829268292683,45,30,50,65,50,45,285,0.13821138211382114,0.5
45,45,55,45,55,63,308,0.4594594594594595,130,65,60,110,95,65,525,0.5227272727272727,2.0
55,69,85,32,35,28,304,0.09302325581395349,64,51,23,51,23,28,240,0.11363636363636363,1.0
60,79,105,59,85,36,424,0.17054263565891473,165,75,80,40,45,65,470,0.5151515151515151,1.0
35,70,55,45,55,25,285,0.09420289855072464,70,140,230,60,80,50,630,0.32432432432432434,0.25
105,95,80,40,80,90,490,0.753968253968254,60,52,168,47,138,30,495,0.19834710743801653,0.25
64,115,65,83,63,65,455,0.5323741007194245,67,125,40,30,30,58,350,0.3431372549019608,1.0
78,70,61,50,61,100,420,0.8145161290322581,86,81,97,81,107,43,495,0.203125,0.5
75,38,38,56,56,67,330,0.5263157894736842,78,84,78,109,85,100,534,0.8620689655172413,2.0
30,42,118,42,88,30,350,0.112,86,76,86,116,56,95,515,0.7982456140350878,4.0
150,120,100,120,100,90,680,0.664179104477612,80,50,100,100,200,50,580,0.2357142857142857,1.0
108,100,121,81,95,95,600,0.7476635514018691,60,65,60,130,75,110,500,0.7719298245614035,2.0
65,47,55,73,75,85,400,0.65,50,65,64,44,48,43,314,0.2196969696969697,1.0
62,50,58,73,54,72,369,0.4435483870967742,60,50,70,80,80,140,480,0.8449612403100775,1.0
50,64,50,45,50,41,300,0.22727272727272727,50,92,108,92,108,35,485,0.2457627118644068,1.0
65,95,57,100,85,93,495,0.7441860465116279,104,91,63,91,73,68,490,0.5118110236220472,1.0
75,70,90,70,105,80,490,0.656,50,60,45,100,80,65,400,0.45689655172413796,2.0
90,75,85,115,90,55,510,0.3445378151260504,30,40,55,40,55,60,280,0.3237410071942446,1.0
70,60,125,115,70,55,495,0.35507246376811596,73,95,62,85,65,85,465,0.6666666666666666,1.0
70,140,70,110,65,105,560,0.95,60,85,60,85,60,55,405,0.3673469387755102,1.0
100,120,120,150,100,90,680,0.7880794701986755,55,47,52,40,40,41,275,0.16806722689075632,1.0
60,55,90,145,90,80,520,0.6071428571428571,97,165,60,65,50,58,495,0.3902439024390244,0.5
60,80,95,70,85,50,440,0.2231404958677686,65,90,120,85,70,60,490,0.43410852713178294,1.0
75,98,63,98,63,101,498,0.849624060150376,65,125,100,60,70,70,490,0.6099290780141844,1.0
78,81,71,74,69,126,499,0.9090909090909091,150,120,100,120,100,90,680,0.664179104477612,0.5
43,70,48,50,60,38,309,0.2391304347826087,40,45,65,100,120,90,460,0.5588235294117647,2.0
50,65,107,105,107,86,520,0.7313432835820896,90,100,60,90,60,80,480,0.6422764227642277,0.25
40,40,35,50,100,70,335,0.5031847133757962,65,50,35,115,95,95,455,0.7333333333333333,1.0
50,48,43,46,41,60,288,0.47297297297297297,44,50,91,24,86,10,305,0.1981981981981982,0.5
80,95,82,60,82,75,474,0.6,116,55,85,107,95,29,487,0.06818181818181818,1.0
75,95,125,45,75,95,510,0.8257575757575758,120,70,120,75,130,85,600,0.6694915254237288,1.0
65,85,70,75,70,40,405,0.203125,55,55,85,65,85,35,380,0.2014388489208633,2.0
80,160,80,130,80,100,630,0.8455284552845529,75,125,230,55,95,30,610,0.3448275862068966,4.0
50,45,45,35,35,50,260,0.23529411764705882,38,30,85,55,65,30,303,0.21428571428571427,0.0
49,49,56,49,61,66,330,0.5190839694656488,50,65,107,105,107,86,520,0.6991150442477876,2.0
30,80,90,55,45,55,355,0.4295774647887324,60,85,49,60,49,60,363,0.4444444444444444,1.0
35,35,35,35,35,35,210,0.13385826771653545,65,90,65,61,61,100,442,0.8373983739837398,1.0
91,134,95,100,100,80,600,0.6304347826086957,85,90,80,70,80,130,535,0.9262295081967213,1.0
60,65,60,130,75,110,500,0.7719298245614035,45,60,45,25,45,55,275,0.29,0.0
95,117,184,44,46,28,514,0.2975206611570248,60,85,42,85,42,91,405,0.8227848101265823,2.0
45,30,40,105,50,20,290,0.031007751937984496,50,53,48,53,48,64,316,0.358974358974359,1.0
125,130,90,130,90,95,660,0.7734375,60,100,89,55,69,112,485,0.9298245614035088,1.0
55,45,45,25,25,15,210,0.048,45,85,70,40,40,60,340,0.5229357798165137,2.0
90,132,105,132,105,30,594,0.4246575342465753,75,80,60,65,90,102,472,0.8625954198473282,1.0
60,55,145,75,150,40,525,0.2,50,50,62,40,62,65,329,0.4188034188034188,1.0
90,100,90,125,85,90,580,0.7352941176470589,62,48,66,59,57,49,341,0.33884297520661155,1.0
90,110,80,100,80,95,555,0.7982456140350878,40,30,35,50,70,55,280,0.28205128205128205,2.0
50,80,95,10,45,10,290,0.232,75,65,55,65,55,69,384,0.43548387096774194,0.5
31,45,90,30,30,40,266,0.21929824561403508,46,87,60,30,40,57,320,0.37777777777777777,1.0
110,160,110,80,110,100,670,0.8591549295774648,40,65,40,80,40,65,330,0.5038167938931297,1.0
44,38,33,61,43,70,289,0.5267857142857143,75,98,63,98,63,101,498,0.849624060150376,2.0
100,164,150,95,120,71,700,0.5645161290322581,50,92,108,92,108,35,485,0.2457627118644068,1.0
40,45,40,62,60,60,307,0.33884297520661155,60,85,60,85,60,55,405,0.3673469387755102,0.5
95,135,80,110,80,100,600,0.8248175182481752,40,80,35,35,45,70,305,0.4661016949152542,2.0
38,30,85,55,65,30,303,0.21428571428571427,75,75,60,83,60,60,413,0.39344262295081966,1.0
60,85,60,50,50,125,430,0.9090909090909091,75,87,63,87,63,98,473,0.865546218487395,1.0
55,84,105,114,75,52,485,0.2890625,65,65,65,50,50,90,385,0.72,0.5
125,120,90,170,100,95,700,0.78125,74,100,72,90,72,46,454,0.24561403508771928,2.0
45,25,50,25,25,35,205,0.13076923076923078,60,40,60,40,60,35,295,0.18055555555555555,4.0
150,160,100,95,65,100,670,0.8866666666666667,50,65,107,105,107,86,520,0.6991150442477876,1.0
79,115,70,125,80,111,580,0.8468468468468469,50,95,180,85,45,70,525,0.5298507462686567,1.0
50,72,35,35,35,65,292,0.5373134328358209,53,54,53,37,46,45,288,0.3090909090909091,1.0
70,120,40,95,40,95,460,0.8106060606060606,90,130,80,65,85,55,505,0.4396551724137931,0.5
50,85,125,85,115,20,480,0.4306569343065693,106,130,90,110,154,90,680,0.719626168224299,1.0
90,92,87,75,85,76,505,0.5409836065573771,75,125,100,70,80,45,495,0.33035714285714285,0.5
71,82,64,64,59,112,452,0.9327731092436975,90,120,100,150,120,100,680,0.7718120805369127,1.0
50,53,48,53,48,64,316,0.4076923076923077,62,50,58,73,54,72,369,0.4435483870967742,0.5
70,40,50,55,50,25,290,0.061068702290076333,80,100,123,122,120,80,625,0.56,1.0
45,30,40,105,50,20,290,0.031007751937984496,86,68,72,109,66,106,507,0.8099173553719008,1.0
67,82,62,46,48,43,348,0.22033898305084745,75,100,110,45,55,65,450,0.5333333333333333,1.0
60,60,60,105,105,105,495,0.848,50,70,160,70,160,90,600,0.7417218543046358,2.0
60,50,50,60,70,50,340,0.28346456692913385,46,87,60,30,40,57,320,0.37777777777777777,0.25
57,24,86,24,86,23,300,0.12727272727272726,85,90,80,70,80,130,535,0.9262295081967213,2.0
60,55,50,40,55,45,305,0.22377622377622378,54,78,103,53,45,22,355,0.23255813953488372,0.5
70,150,140,65,100,75,600,0.55,75,95,60,65,60,115,470,0.8778625954198473,1.0
72,58,80,103,80,97,490,0.7171052631578947,55,112,45,74,45,70,401,0.559322033898305,0.5
70,90,90,135,90,125,600,0.9401709401709402,105,105,75,65,100,50,500,0.37593984962406013,1.0
50,35,55,25,25,15,205,0.021739130434782608,45,53,70,40,60,42,310,0.25735294117647056,2.0
58,64,58,80,65,80,405,0.5423728813559322,75,85,200,55,65,30,510,0.16778523489932887,2.0
65,47,55,73,75,85,400,0.65,40,55,99,40,79,47,360,0.26262626262626265,0.5
77,120,90,60,90,48,485,0.2785714285714286,45,49,49,65,65,45,318,0.2781954887218045,1.0
103,60,126,80,126,50,545,0.36363636363636365,123,100,62,97,81,68,531,0.4806201550387597,1.0
70,120,65,45,85,125,510,0.9747899159663865,53,54,53,37,46,45,288,0.3090909090909091,1.0
60,60,60,85,85,85,435,0.631578947368421,70,120,100,145,105,20,560,0.2824427480916031,1.0
70,94,50,94,50,66,424,0.48148148148148145,100,100,100,100,100,100,600,0.8345864661654135,8.0
100,123,75,57,75,80,510,0.6923076923076923,100,150,140,100,90,90,670,0.7969924812030075,1.0
45,35,45,62,53,35,275,0.11851851851851852,60,40,50,75,85,95,405,0.6044776119402985,1.0
103,93,67,71,61,84,479,0.7142857142857143,40,30,50,55,55,100,330,0.584070796460177,1.0
35,55,40,45,40,60,275,0.35714285714285715,55,47,52,40,40,41,275,0.16806722689075632,1.0
86,81,97,81,107,43,495,0.203125,64,88,50,88,50,106,446,0.9111111111111111,1.0
80,100,200,50,100,50,580,0.3472222222222222,80,115,80,65,55,93,488,0.7846153846153846,2.0
55,69,85,32,35,28,304,0.09302325581395349,106,150,70,194,120,140,780,0.952,1.0
60,85,69,65,79,80,438,0.576,50,70,160,70,160,90,600,0.7417218543046358,1.0
38,30,85,55,65,30,303,0.21428571428571427,75,110,110,110,105,80,590,0.656934306569343,1.0
89,125,90,115,80,101,600,0.8725490196078431,65,150,40,15,80,145,495,0.9663865546218487,2.0
110,78,73,76,71,60,468,0.3333333333333333,50,40,85,40,65,25,305,0.08870967741935484,0.5
70,120,100,145,105,20,560,0.2824427480916031,106,130,90,110,154,90,680,0.719626168224299,0.0
90,60,60,40,40,40,330,0.29545454545454547,41,64,45,50,50,50,300,0.36752136752136755,1.0
35,70,55,45,55,25,285,0.09420289855072464,90,65,65,40,40,15,315,0.19672131147540983,4.0
60,130,80,60,60,70,460,0.5153846153846153,78,70,61,50,61,100,420,0.8145161290322581,2.0
73,95,62,85,65,85,465,0.6666666666666666,126,131,95,131,98,99,680,0.8294573643410853,1.0
106,190,100,154,100,130,780,0.9259259259259259,70,55,65,95,85,70,440,0.5307692307692308,0.5
61,72,57,55,55,65,365,0.3984375,75,110,110,110,105,80,590,0.656934306569343,2.0
85,100,122,58,75,54,494,0.3939393939393939,100,73,83,73,83,55,467,0.371900826446281,0.5
40,40,50,30,30,30,220,0.0873015873015873,55,35,50,55,110,85,390,0.6277372262773723,0.25
60,60,60,85,85,85,435,0.631578947368421,49,55,42,42,37,85,310,0.6068376068376068,0.0
75,90,140,60,60,40,465,0.3008130081300813,74,94,131,54,116,20,489,0.4485294117647059,0.5
73,100,60,100,60,65,458,0.42657342657342656,65,50,70,95,80,65,425,0.4262295081967213,1.0
105,140,95,55,65,45,505,0.3,50,65,64,44,48,43,314,0.2196969696969697,1.0
35,80,50,50,70,120,405,0.84375,95,117,184,44,46,28,514,0.2975206611570248,1.0
45,45,55,45,55,63,308,0.4594594594594595,90,93,55,70,55,55,418,0.3819444444444444,0.5
40,45,40,35,35,56,251,0.373015873015873,100,75,115,90,115,85,580,0.6446280991735537,1.0
85,135,130,60,80,25,515,0.40540540540540543,65,65,65,50,50,90,385,0.72,1.0
35,55,40,50,50,90,320,0.6838235294117647,105,180,100,180,100,115,780,0.9477611940298507,1.0
100,100,125,110,50,50,535,0.384,35,55,40,45,40,60,275,0.35714285714285715,1.0
68,90,65,50,55,82,410,0.6165413533834586,75,103,80,70,80,92,500,0.7933884297520661,0.25
40,27,60,37,50,66,280,0.36220472440944884,60,25,35,70,80,60,330,0.3076923076923077,1.0
50,70,100,40,40,30,330,0.2222222222222222,106,150,70,194,120,140,780,0.952,1.0
91,90,106,130,106,77,600,0.648854961832061,20,40,90,30,90,25,295,0.11363636363636363,1.0
38,41,40,50,65,65,299,0.4108527131782946,60,70,50,100,50,65,395,0.5217391304347826,2.0
50,95,90,95,90,180,600,0.9172413793103448,85,120,70,50,60,100,485,0.8308823529411765,1.0
89,124,80,55,80,55,483,0.5714285714285714,50,20,40,20,40,20,190,0.0962962962962963,0.0
45,30,15,85,65,65,305,0.36220472440944884,75,95,95,95,95,85,540,0.6470588235294118,1.0
45,45,35,20,30,20,195,0.07246376811594203,60,48,45,43,90,42,328,0.21897810218978103,2.0
78,52,60,63,65,23,341,0.06015037593984962,20,10,230,10,230,5,505,0.0,1.0
79,105,70,145,80,101,580,0.8608695652173913,95,80,105,40,70,100,490,0.8046875,1.0
44,75,35,63,33,45,295,0.2647058823529412,70,120,40,95,40,95,460,0.8106060606060606,0.5
70,90,110,60,75,95,500,0.7333333333333333,90,85,75,115,100,115,580,0.9381443298969072,1.0
70,45,48,60,65,35,323,0.15748031496062992,50,75,75,65,65,50,380,0.4049586776859504,2.0
150,160,100,95,65,100,670,0.8866666666666667,58,50,145,95,105,30,483,0.2459016393442623,0.0
80,95,82,60,82,75,474,0.6,65,60,110,130,95,65,525,0.47761194029850745,1.0
90,70,80,70,95,70,475,0.5190839694656488,63,60,55,50,50,71,349,0.5289256198347108,2.0
126,131,95,131,98,99,680,0.8102189781021898,60,75,100,55,80,50,420,0.3088235294117647,1.0
55,66,44,44,56,85,350,0.6888888888888889,75,110,110,110,105,80,590,0.656934306569343,1.0
50,65,45,85,65,95,405,0.7238095238095238,50,55,50,36,30,43,264,0.2922077922077922,0.5
90,90,85,125,90,100,580,0.768595041322314,105,180,100,180,100,115,780,0.9477611940298507,1.0
60,70,105,70,120,75,500,0.5983606557377049,40,45,40,35,35,56,251,0.373015873015873,0.0
40,80,100,30,30,20,300,0.11851851851851852,80,80,50,40,50,25,325,0.176056338028169,2.0
95,75,80,100,110,30,490,0.24242424242424243,45,49,49,65,65,45,318,0.2781954887218045,1.0
108,170,115,120,95,92,700,0.7083333333333334,54,66,70,44,55,46,335,0.4214876033057851,0.5
65,90,120,85,70,60,490,0.43410852713178294,85,120,70,50,60,100,485,0.8308823529411765,1.0
35,40,100,90,55,35,355,0.1796875,40,45,35,30,40,55,245,0.3793103448275862,2.0
106,90,130,90,154,110,680,0.8699186991869918,55,65,95,95,45,85,440,0.6610169491525424,1.0
110,160,110,80,110,100,670,0.8591549295774648,75,75,75,125,95,40,485,0.15671641791044777,1.0
45,30,35,20,20,45,195,0.14782608695652175,35,85,45,35,35,75,310,0.6492537313432836,0.5
75,90,50,110,80,95,500,0.7985611510791367,114,85,70,85,80,30,464,0.2066115702479339,2.0
70,40,50,55,50,25,290,0.061068702290076333,71,95,85,110,95,79,535,0.664,0.5
70,55,95,95,110,65,490,0.48872180451127817,83,80,75,70,70,101,479,0.8615384615384616,1.0
60,85,42,85,42,91,405,0.8227848101265823,40,55,80,35,60,30,300,0.15037593984962405,1.0
50,35,55,25,25,15,205,0.021739130434782608,80,80,90,110,130,110,600,0.8721804511278195,2.0
70,105,105,50,40,20,390,0.33587786259541985,60,105,60,120,60,105,510,0.8849557522123894,1.0
50,70,160,70,160,90,600,0.7417218543046358,80,82,100,83,100,80,525,0.6821705426356589,1.0
40,45,40,65,40,65,295,0.5661764705882353,80,145,150,105,110,110,700,0.8692307692307693,1.0
110,85,95,80,95,50,515,0.2713178294573643,59,74,50,35,50,35,303,0.3125,0.0
95,70,73,95,90,60,483,0.3983739837398374,100,100,100,100,100,100,600,0.8778625954198473,0.5
55,95,115,45,45,35,390,0.2116788321167883,57,80,91,80,87,75,470,0.5737704918032787,1.0
50,53,48,53,48,64,316,0.4076923076923077,46,87,60,30,40,57,320,0.37777777777777777,0.5
45,22,60,27,30,29,213,0.07518796992481203,71,82,64,64,59,112,452,0.9327731092436975,1.0
80,70,70,90,100,70,480,0.5609756097560976,50,53,62,58,63,44,330,0.13709677419354838,1.0
35,35,40,35,55,50,250,0.40336134453781514,40,45,35,30,40,55,245,0.3793103448275862,0.25
45,30,40,105,50,20,290,0.031007751937984496,67,57,55,77,55,114,425,0.8879310344827587,0.5
43,80,65,50,35,35,308,0.14193548387096774,60,50,50,60,70,50,340,0.28346456692913385,0.25
80,80,80,80,80,80,480,0.5606060606060606,91,90,129,90,72,108,580,0.9140625,1.0
40,45,40,62,60,60,307,0.33884297520661155,70,150,140,65,100,75,600,0.55,4.0
20,15,20,10,55,80,200,0.2682926829268293,101,72,72,99,89,29,462,0.1937984496124031,1.0
45,85,50,55,50,65,350,0.5076923076923077,50,150,50,150,50,150,600,0.9339622641509434,0.5
71,95,85,110,95,79,535,0.664,46,87,60,30,40,57,320,0.37777777777777777,2.0
71,82,64,64,59,112,452,0.9327731092436975,85,80,70,135,75,90,535,0.7006802721088435,1.0
40,55,30,30,30,60,245,0.43548387096774194,69,69,76,69,86,91,460,0.6554621848739496,1.0
60,85,60,85,60,55,405,0.3673469387755102,68,72,78,38,42,32,330,0.23809523809523808,1.0
70,95,125,65,75,45,475,0.33613445378151263,108,170,115,120,95,92,700,0.7083333333333334,0.5
70,85,70,60,70,50,405,0.28378378378378377,54,63,52,83,56,97,405,0.7697841726618705,0.5
50,65,107,105,107,86,520,0.7313432835820896,65,60,110,130,95,65,525,0.47761194029850745,1.0
106,150,70,194,120,140,780,0.952,67,89,116,79,116,33,500,0.2624113475177305,0.25
45,40,60,40,75,50,310,0.2926829268292683,80,80,90,110,130,110,600,0.8721804511278195,1.0
75,105,75,105,75,45,480,0.3274336283185841,90,75,85,115,90,55,510,0.3445378151260504,1.0
55,50,65,175,95,150,590,0.7818181818181819,60,90,70,60,120,40,440,0.27419354838709675,1.0
65,75,90,97,123,44,494,0.1987179487179487,35,20,65,40,65,20,245,0.02459016393442623,0.0
50,48,43,46,41,60,288,0.47297297297297297,50,65,85,35,35,55,325,0.32575757575757575,2.0
60,85,42,85,42,91,405,0.8227848101265823,43,30,55,40,65,97,330,0.6030534351145038,1.0
58,64,58,80,65,80,405,0.5423728813559322,60,79,105,59,85,36,424,0.17054263565891473,2.0
89,145,90,105,80,91,600,0.8549618320610687,74,108,133,83,65,32,495,0.32142857142857145,1.0
70,85,70,60,70,50,405,0.28378378378378377,55,85,55,50,55,60,360,0.4233576642335766,2.0
40,40,55,40,70,55,300,0.40939597315436244,65,65,45,75,45,95,390,0.72,0.0
60,40,50,75,85,95,405,0.6044776119402985,130,85,80,85,95,60,535,0.43884892086330934,2.0
60,45,50,90,80,70,395,0.625,30,105,90,25,25,50,325,0.2773722627737226,1.0
70,135,105,60,105,20,495,0.5806451612903226,60,95,80,60,80,30,405,0.19480519480519481,2.0
78,104,78,159,115,100,634,0.8444444444444444,75,103,80,70,80,92,500,0.7933884297520661,16.0
50,80,95,10,45,10,290,0.232,126,131,95,131,98,99,680,0.8294573643410853,1.0
55,50,65,175,95,150,590,0.7818181818181819,100,75,115,90,115,85,580,0.6446280991735537,1.0
55,55,55,85,55,30,335,0.1320754716981132,51,65,65,80,75,59,395,0.4365079365079365,1.0
67,89,116,79,116,33,500,0.2624113475177305,70,62,67,55,55,56,365,0.38513513513513514,2.0
64,51,23,51,23,28,240,0.11363636363636363,60,60,60,35,35,30,280,0.11194029850746269,1.0
80,80,80,80,80,80,480,0.6015037593984962,52,65,55,58,62,60,352,0.4482758620689655,2.0
75,98,63,98,63,101,498,0.849624060150376,95,110,80,70,80,50,485,0.37209302325581395,1.0
45,100,45,45,45,10,290,0.2949640287769784,70,90,110,60,75,95,500,0.7333333333333333,2.0
43,30,55,40,65,97,330,0.6030534351145038,65,45,55,45,70,45,325,0.24369747899159663,0.5
55,50,45,135,95,120,500,0.7714285714285715,60,130,80,60,60,70,460,0.5153846153846153,1.0
90,60,60,40,40,40,330,0.29545454545454547,20,25,45,70,90,60,310,0.30833333333333335,1.0
60,62,50,62,60,40,334,0.18181818181818182,63,120,85,90,55,55,468,0.2809917355371901,1.0
45,85,70,40,40,60,340,0.5229357798165137,44,50,91,24,86,10,305,0.1981981981981982,0.5
50,50,95,40,50,35,320,0.20279720279720279,95,80,105,40,70,100,490,0.8046875,1.0
40,45,40,65,40,65,295,0.5661764705882353,95,155,109,70,130,81,640,0.6788321167883211,2.0
70,85,140,85,70,20,470,0.272,100,100,90,150,140,90,670,0.71875,0.5
255,10,10,75,135,55,540,0.3125,130,70,35,70,35,60,400,0.4017857142857143,1.0
60,40,60,40,60,35,295,0.18055555555555555,70,95,125,65,75,45,475,0.33613445378151263,1.0
35,70,55,45,55,25,285,0.09420289855072464,45,50,43,40,38,62,278,0.40441176470588236,0.25
44,48,65,50,64,43,314,0.1623931623931624,70,20,50,20,50,40,250,0.1557377049180328,0.5
90,120,120,60,60,50,500,0.35294117647058826,35,65,35,65,35,65,300,0.46621621621621623,1.0
80,160,60,170,130,80,680,0.6180555555555556,90,120,75,60,60,45,450,0.29411764705882354,0.5
45,100,45,45,45,10,290,0.2949640287769784,50,70,50,50,50,40,310,0.16296296296296298,1.0
55,55,50,45,65,55,325,0.37373737373737376,100,100,100,100,100,100,600,0.8778625954198473,1.0
45,30,40,105,50,20,290,0.031007751937984496,40,45,65,100,120,90,460,0.5588235294117647,0.5
120,120,120,120,120,120,720,0.9344262295081968,65,47,55,73,75,85,400,0.65,1.0
70,55,55,80,60,45,365,0.2222222222222222,60,55,50,40,55,45,305,0.22377622377622378,1.0
70,90,70,60,60,70,420,0.6390977443609023,60,60,50,40,50,75,335,0.5882352941176471,1.0
50,105,125,55,95,50,480,0.375886524822695,45,22,60,27,30,29,213,0.07518796992481203,1.0
35,35,35,35,35,35,210,0.13385826771653545,150,80,44,90,54,80,498,0.625,0.0
45,30,40,105,50,20,290,0.031007751937984496,55,35,50,55,110,85,390,0.6277372262773723,1.0
60,50,70,50,90,65,385,0.39568345323741005,44,38,39,61,79,42,303,0.2251655629139073,1.0
46,87,60,30,40,57,320,0.37777777777777777,50,50,50,50,50,50,300,0.30708661417322836,1.0
67,58,57,81,67,101,431,0.8790322580645161,85,105,100,79,83,78,530,0.5869565217391305,2.0
125,120,90,170,100,95,700,0.78125,60,110,70,60,60,100,460,0.8461538461538461,2.0
38,36,38,32,36,57,237,0.3893805309734513,79,103,120,135,115,78,630,0.5763888888888888,1.0
40,65,95,60,45,35,340,0.13986013986013987,40,30,30,40,50,30,220,0.07936507936507936,2.0
70,65,60,90,75,90,450,0.6571428571428571,110,65,105,55,95,80,510,0.6258503401360545,1.0
130,65,60,110,95,65,525,0.5227272727272727,100,50,80,60,80,50,420,0.34375,0.5
60,82,45,45,45,74,351,0.5752212389380531,60,55,145,75,150,40,525,0.2,4.0
55,45,45,25,25,15,210,0.048,50,70,50,50,50,70,340,0.5645161290322581,1.0
95,155,109,70,130,81,640,0.6788321167883211,85,120,70,50,60,100,485,0.8308823529411765,1.0
50,48,43,46,41,60,288,0.47297297297297297,44,38,33,61,43,70,289,0.5267857142857143,2.0
74,108,133,83,65,32,495,0.32142857142857145,55,50,65,175,95,150,590,0.7818181818181819,1.0
45,53,70,40,60,42,310,0.25735294117647056,70,60,75,110,75,90,480,0.7165354330708661,1.0
45,53,70,40,60,42,310,0.25735294117647056,55,75,85,25,25,15,280,0.1875,2.0
55,75,50,40,40,80,340,0.6302521008403361,60,30,30,36,56,50,262,0.32432432432432434,1.0
91,129,90,72,90,108,580,0.8536585365853658,50,50,150,50,150,50,500,0.2571428571428571,1.0
40,45,35,40,40,90,290,0.65,64,78,52,78,52,81,405,0.6422764227642277,1.0
60,60,50,40,50,75,335,0.5882352941176471,80,100,123,122,120,80,625,0.56,0.25
88,107,122,74,75,64,530,0.4596774193548387,80,75,150,75,150,50,580,0.30973451327433627,1.0
35,85,45,35,35,75,310,0.6492537313432836,50,75,75,65,65,50,380,0.4049586776859504,0.0
80,95,82,60,82,75,474,0.6,104,91,63,91,73,68,490,0.5118110236220472,1.0
49,66,70,44,55,51,335,0.4260869565217391,95,80,105,40,70,100,490,0.8046875,0.0
25,20,15,105,55,90,310,0.32407407407407407,65,60,70,85,75,40,395,0.1796875,1.0
60,45,70,45,90,95,405,0.7304964539007093,90,95,105,165,110,45,610,0.2890625,0.25
58,109,112,48,48,109,484,0.8805970149253731,60,60,60,60,60,60,360,0.38095238095238093,1.0
50,75,75,65,65,50,380,0.4049586776859504,135,85,40,40,85,5,390,0.6864406779661016,0.0
50,45,45,35,35,50,260,0.23529411764705882,45,63,37,65,55,95,360,0.8055555555555556,1.0
43,70,48,50,60,38,309,0.2391304347826087,40,55,80,35,60,30,300,0.15037593984962405,1.0
105,125,100,60,100,100,590,0.8359375,68,65,65,125,115,80,518,0.6461538461538462,1.0
105,95,80,40,80,90,490,0.753968253968254,50,105,79,35,110,76,455,0.6214285714285714,1.0
165,75,80,40,45,65,470,0.5151515151515151,30,40,70,70,25,60,295,0.41353383458646614,0.5
41,64,45,50,50,50,300,0.36752136752136755,55,130,115,50,50,75,475,0.5982142857142857,1.0
60,80,110,50,80,45,425,0.2833333333333333,100,120,100,150,120,90,680,0.728,2.0
95,117,184,44,46,28,514,0.2975206611570248,100,100,90,150,140,90,670,0.71875,0.5
85,120,70,50,60,100,485,0.8308823529411765,70,45,48,60,65,35,323,0.15748031496062992,1.0
91,134,95,100,100,80,600,0.6304347826086957,35,20,65,40,65,20,245,0.02459016393442623,0.0
86,68,72,109,66,106,507,0.8099173553719008,70,60,125,115,70,55,495,0.35507246376811596,0.125
50,50,40,50,40,64,294,0.45588235294117646,60,80,110,50,80,45,425,0.2833333333333333,2.0
90,90,85,125,90,100,580,0.768595041322314,70,135,105,60,105,20,495,0.5806451612903226,1.0
80,120,70,110,70,80,530,0.6422764227642277,103,60,126,80,126,50,545,0.36363636363636365,1.0
100,150,120,120,100,90,680,0.6493506493506493,100,100,80,60,60,50,450,0.3050847457627119,0.0
114,85,70,85,80,30,464,0.2066115702479339,109,66,84,81,99,32,471,0.2013888888888889,1.0
45,75,37,70,55,83,365,0.6183206106870229,65,95,100,60,50,50,420,0.34959349593495936,0.5
100,100,80,60,60,50,450,0.3050847457627119,65,70,60,65,65,115,440,0.8583333333333333,1.0
79,100,80,110,90,121,580,0.968,160,110,65,65,110,30,540,0.35714285714285715,1.0
30,30,30,30,30,30,180,0.12612612612612611,50,50,150,50,150,50,500,0.2571428571428571,2.0
55,55,85,65,85,35,380,0.2014388489208633,97,165,60,65,50,58,495,0.3902439024390244,2.0
58,64,58,80,65,80,405,0.609271523178808,100,150,90,180,160,90,770,0.7348484848484849,0.5
55,85,122,58,75,99,494,0.8099173553719008,60,67,85,77,75,116,480,0.8888888888888888,0.5
63,120,85,90,55,55,468,0.2809917355371901,65,47,55,73,75,85,400,0.65,1.0
90,100,70,110,150,80,600,0.6037735849056604,60,25,35,70,80,60,330,0.3076923076923077,1.0
44,38,39,61,79,42,303,0.2251655629139073,80,135,85,70,95,150,615,0.9844961240310077,1.0
50,75,45,40,45,60,315,0.4380165289256198,75,125,230,55,95,30,610,0.3448275862068966,0.5
95,65,65,110,130,60,525,0.4016393442622951,75,140,65,112,65,110,567,0.9140625,1.0
78,130,111,130,85,100,634,0.8561151079136691,60,70,105,70,120,75,500,0.5983606557377049,1.0
80,52,50,90,50,89,411,0.6666666666666666,130,85,80,85,95,60,535,0.43884892086330934,1.0
44,48,65,50,64,43,314,0.1623931623931624,40,30,30,40,50,30,220,0.07936507936507936,0.25
41,56,40,62,44,71,314,0.568,51,65,65,80,75,59,395,0.4365079365079365,1.0
80,90,80,130,110,110,600,0.856,74,94,131,54,116,20,489,0.4485294117647059,0.25
65,125,100,55,70,85,500,0.6532258064516129,70,84,70,65,70,51,410,0.2949640287769784,1.0
38,35,40,27,25,35,200,0.08208955223880597,70,90,110,60,75,95,500,0.7333333333333333,1.0
95,75,180,130,80,30,590,0.13793103448275862,40,45,40,35,35,56,251,0.373015873015873,1.0
70,60,75,110,75,90,480,0.7165354330708661,95,95,85,125,65,55,520,0.3894736842105263,0.5
55,47,52,40,40,41,275,0.16806722689075632,70,80,65,90,65,85,455,0.578125,1.0
65,63,45,45,45,45,308,0.2595419847328244,70,145,88,140,70,112,625,0.8888888888888888,2.0
40,30,35,45,40,55,245,0.31496062992125984,90,132,105,132,105,30,594,0.4246575342465753,2.0
49,66,70,44,55,51,335,0.4260869565217391,79,100,80,110,90,121,580,0.968,0.5
81,102,77,85,75,85,505,0.5642857142857143,70,60,125,115,70,55,495,0.35507246376811596,1.0
65,70,60,65,65,115,440,0.8583333333333333,58,50,145,95,105,30,483,0.2459016393442623,0.0
60,52,168,47,138,30,495,0.19834710743801653,55,69,85,32,35,28,304,0.09302325581395349,4.0
50,53,62,58,63,44,330,0.13709677419354838,70,95,125,65,75,45,475,0.33613445378151263,2.0
100,110,90,85,90,60,535,0.47794117647058826,78,84,78,109,85,100,534,0.8646616541353384,0.0
65,125,60,95,60,105,510,0.9236641221374046,106,110,90,154,90,130,680,0.926829268292683,0.5
250,5,5,35,105,50,450,0.15306122448979592,60,90,70,60,120,40,440,0.27419354838709675,1.0
83,106,65,86,65,85,490,0.6640625,35,55,40,45,40,60,275,0.35714285714285715,1.0
55,45,45,25,25,15,210,0.048,90,132,105,132,105,30,594,0.4246575342465753,0.25
123,77,72,99,92,58,521,0.4621212121212121,100,100,100,100,100,100,600,0.8805970149253731,0.5
55,50,40,40,40,75,300,0.5945945945945946,35,65,35,65,35,65,300,0.46621621621621623,1.0
80,80,80,55,55,90,440,0.6417910447761194,59,66,70,44,55,41,335,0.25190839694656486,0.0
85,135,130,60,80,25,515,0.40540540540540543,70,85,140,85,70,20,470,0.272,2.0
50,120,53,35,110,87,455,0.640625,60,85,60,85,60,55,405,0.3673469387755102,1.0
100,50,80,60,80,50,420,0.34375,75,38,38,56,56,67,330,0.5263157894736842,0.5
40,45,35,40,40,90,290,0.65,65,50,35,115,95,95,455,0.7333333333333333,1.0
60,65,80,170,95,130,600,0.8625954198473282,50,50,95,40,50,35,320,0.20279720279720279,0.5
77,120,90,60,90,48,485,0.2785714285714286,85,50,95,120,115,80,545,0.5793650793650794,0.0
52,65,50,45,50,38,300,0.27419354838709675,58,50,145,95,105,30,483,0.2459016393442623,2.0
60,82,45,45,45,74,351,0.5752212389380531,92,105,90,125,90,98,600,0.8217054263565892,0.5
85,135,130,60,80,25,515,0.40540540540540543,50,35,55,25,25,15,205,0.021739130434782608,2.0
75,85,200,55,65,30,510,0.16778523489932887,75,70,90,70,105,80,490,0.656,0.0
97,165,60,65,50,58,495,0.3902439024390244,106,150,70,194,120,140,780,0.952,1.0
75,80,85,110,90,50,490,0.3548387096774194,40,55,30,30,30,85,270,0.688,0.5
62,44,50,44,50,55,305,0.3629032258064516,59,63,80,65,80,58,405,0.41843971631205673,0.5
80,70,70,90,100,70,480,0.5609756097560976,45,30,35,20,20,45,195,0.14782608695652175,0.5
50,120,53,35,110,87,455,0.640625,65,130,60,95,110,65,525,0.5303030303030303,1.0
55,50,45,135,95,120,500,0.7714285714285715,50,120,53,35,110,87,455,0.640625,1.0
40,80,100,30,30,20,300,0.11851851851851852,64,115,65,83,63,65,455,0.5323741007194245,1.0
70,85,140,85,70,20,470,0.272,68,90,65,50,55,82,410,0.6165413533834586,0.5
70,140,230,60,80,50,630,0.32432432432432434,74,108,133,83,65,32,495,0.32142857142857145,1.0
91,90,72,90,129,108,580,0.896,70,60,62,80,82,60,414,0.4375,0.0625
60,80,95,70,85,50,440,0.2231404958677686,83,80,80,135,80,121,579,0.9444444444444444,1.0
65,90,122,58,75,84,494,0.71875,100,134,110,95,100,61,600,0.4057971014492754,1.0
90,100,90,125,85,90,580,0.7352941176470589,60,70,105,70,120,75,500,0.5983606557377049,1.0
75,110,110,110,105,80,590,0.656934306569343,60,45,70,75,85,55,390,0.3008130081300813,1.0
165,75,80,40,45,65,470,0.5151515151515151,100,150,120,120,100,90,680,0.6493506493506493,0.5
65,60,70,85,75,40,395,0.1796875,70,115,60,115,60,55,475,0.4647887323943662,1.0
50,20,55,25,25,30,205,0.09774436090225563,50,50,150,50,150,50,500,0.2571428571428571,0.5
30,65,100,45,25,40,305,0.1891891891891892,38,35,40,27,25,35,200,0.08208955223880597,1.0
54,63,52,83,56,97,405,0.7697841726618705,61,72,57,55,55,65,365,0.3984375,1.0
95,145,130,120,90,120,700,0.9398496240601504,60,80,50,40,40,30,300,0.15328467153284672,0.0
45,30,40,105,50,20,290,0.031007751937984496,70,75,80,135,80,135,575,0.917910447761194,1.0
79,100,80,110,90,121,580,0.968,40,70,130,60,130,25,455,0.17355371900826447,1.0
100,120,120,150,100,90,680,0.7880794701986755,49,66,70,44,55,51,335,0.4260869565217391,1.0
30,45,135,45,90,30,375,0.09285714285714286,105,140,95,55,65,45,505,0.3,0.5
75,80,85,110,90,50,490,0.3548387096774194,45,85,50,55,50,65,350,0.5076923076923077,1.0
72,60,30,20,30,25,237,0.11570247933884298,55,65,95,95,45,85,440,0.6610169491525424,1.0
40,55,80,35,60,30,300,0.15037593984962405,55,40,85,80,105,40,405,0.23622047244094488,0.5
75,70,90,70,105,80,490,0.656,100,120,100,150,120,90,680,0.728,2.0
80,110,60,150,130,70,600,0.5042016806722689,91,90,129,90,72,108,580,0.9140625,0.5
65,90,120,85,70,60,490,0.43410852713178294,45,35,45,62,53,35,275,0.11851851851851852,2.0
85,100,122,58,75,54,494,0.3939393939393939,70,65,65,55,55,70,380,0.5,0.0
55,70,40,60,40,40,305,0.26956521739130435,40,55,80,35,60,30,300,0.15037593984962405,0.5
60,80,50,50,50,40,330,0.23853211009174313,82,80,86,85,75,72,480,0.6183206106870229,1.0
40,40,50,30,30,30,220,0.0873015873015873,80,92,65,65,80,68,450,0.4824561403508772,2.0
70,110,80,55,80,105,500,0.8794326241134752,63,120,85,90,55,55,468,0.2809917355371901,2.0
57,80,91,80,87,75,470,0.5737704918032787,190,33,58,33,58,33,405,0.13432835820895522,1.0
60,85,60,85,60,55,405,0.3673469387755102,100,103,75,120,75,127,600,0.940677966101695,1.0
55,95,55,35,75,115,430,0.9380530973451328,120,70,120,75,130,85,600,0.6694915254237288,2.0
35,40,100,90,55,35,355,0.1796875,60,69,95,69,95,36,424,0.2608695652173913,1.0
60,100,85,80,85,100,510,0.7007874015748031,123,77,72,99,92,58,521,0.4621212121212121,4.0
40,35,30,20,20,50,195,0.23423423423423423,60,85,42,85,42,91,405,0.8227848101265823,1.0
45,75,37,70,55,83,365,0.6183206106870229,60,40,60,95,60,55,370,0.4222222222222222,0.5
70,94,50,94,50,66,424,0.48148148148148145,79,100,80,110,90,121,580,0.968,0.5
65,65,60,130,95,110,525,0.823943661971831,80,50,100,100,200,50,580,0.2357142857142857,1.0
55,50,65,175,95,150,590,0.7818181818181819,45,95,50,40,50,75,355,0.54,1.0
78,84,78,109,85,100,534,0.8620689655172413,35,20,65,40,65,20,245,0.02459016393442623,1.0
45,45,35,20,30,20,195,0.07246376811594203,64,66,68,81,76,50,405,0.25190839694656486,1.0
135,85,40,40,85,5,390,0.6864406779661016,80,80,90,110,130,110,600,0.8721804511278195,1.0
58,70,45,40,45,42,300,0.25925925925925924,60,130,80,60,60,70,460,0.5153846153846153,0.5
80,160,60,170,130,80,680,0.6180555555555556,80,160,80,130,80,100,630,0.8455284552845529,0.5
100,110,90,85,90,60,535,0.47794117647058826,80,120,130,55,65,45,495,0.37037037037037035,8.0
65,90,40,45,80,75,395,0.625,50,65,107,105,107,86,520,0.7758620689655172,1.0
67,82,62,46,48,43,348,0.22033898305084745,55,65,35,60,30,85,330,0.6126126126126126,1.0
100,73,83,73,83,55,467,0.371900826446281,75,55,70,55,95,110,460,0.8444444444444444,2.0
90,92,75,92,85,60,494,0.49586776859504134,77,85,51,55,51,65,384,0.5163934426229508,0.5
65,125,100,55,70,85,500,0.6532258064516129,74,48,76,83,81,104,466,0.7322834645669292,2.0
39,52,43,60,50,65,309,0.5041322314049587,65,60,70,85,75,40,395,0.1796875,1.0
55,85,55,50,55,60,360,0.4233576642335766,80,130,100,160,120,110,700,0.8981481481481481,1.0
130,85,80,85,95,60,535,0.43884892086330934,90,120,75,60,60,45,450,0.29411764705882354,1.0
40,20,30,40,80,55,265,0.22764227642276422,100,123,75,57,75,80,510,0.6923076923076923,0.5
70,55,65,95,85,70,440,0.5307692307692308,75,75,60,83,60,60,413,0.39344262295081966,1.0
60,150,50,150,50,60,520,0.5,30,65,100,45,25,40,305,0.1891891891891892,0.5
40,30,30,55,30,85,270,0.4666666666666667,45,49,49,65,65,45,318,0.2781954887218045,1.0
60,85,49,60,49,60,363,0.4444444444444444,55,47,52,40,40,41,275,0.16806722689075632,1.0
30,80,90,55,45,55,355,0.4295774647887324,95,125,79,60,100,81,540,0.6165413533834586,1.0
70,75,60,105,60,105,475,0.88,125,170,100,120,90,95,700,0.77,0.5
56,61,65,48,45,38,313,0.17567567567567569,75,55,70,55,95,110,460,0.8444444444444444,0.25
50,50,95,40,50,35,320,0.20279720279720279,45,35,45,62,53,35,275,0.11851851851851852,0.5
55,50,45,135,95,120,500,0.7714285714285715,95,60,79,100,125,81,540,0.6201550387596899,1.0
50,50,120,80,80,30,410,0.07258064516129033,83,106,65,86,65,85,490,0.6640625,0.5
40,30,35,50,70,55,280,0.28205128205128205,60,105,60,120,60,105,510,0.8849557522123894,1.0
20,40,15,35,35,60,205,0.34285714285714286,95,65,110,60,130,65,525,0.5275590551181102,1.0
40,55,30,30,30,60,245,0.43548387096774194,70,120,65,45,85,125,510,0.9747899159663865,1.0
60,45,70,45,90,95,405,0.7304964539007093,85,50,95,120,115,80,545,0.5793650793650794,2.0
68,75,53,83,113,60,452,0.45384615384615384,79,105,70,145,80,101,580,0.8608695652173913,1.0
40,55,30,30,30,60,245,0.43548387096774194,30,45,55,70,55,85,340,0.5633802816901409,1.0
77,120,90,60,90,48,485,0.2785714285714286,45,75,37,70,55,83,365,0.6183206106870229,1.0
63,120,85,90,55,55,468,0.2809917355371901,42,52,67,39,56,50,306,0.2868217054263566,1.0
40,60,40,40,40,30,250,0.0948905109489051,49,49,56,49,61,66,330,0.5190839694656488,1.0
75,90,90,140,90,115,600,0.9481481481481482,71,120,95,120,95,99,600,0.8203125,4.0
65,90,115,45,115,58,488,0.5041322314049587,75,38,38,56,56,67,330,0.5263157894736842,1.0
28,25,25,45,35,40,198,0.16083916083916083,135,85,40,40,85,5,390,0.6864406779661016,1.0
86,81,97,81,107,43,495,0.203125,70,85,65,105,85,120,530,0.9262295081967213,0.5
50,45,45,35,35,50,260,0.23529411764705882,100,120,100,150,120,90,680,0.728,1.0
57,80,91,80,87,75,470,0.5737704918032787,69,69,76,69,86,91,460,0.6554621848739496,0.5
85,105,85,40,50,40,405,0.211864406779661,50,70,50,50,50,70,340,0.5645161290322581,1.0
90,75,85,115,90,55,510,0.3445378151260504,75,98,63,98,63,101,498,0.849624060150376,2.0
70,43,53,43,53,40,302,0.19090909090909092,50,20,40,20,40,20,190,0.0962962962962963,2.0
45,60,32,50,32,76,295,0.5925925925925926,150,160,100,95,65,100,670,0.8866666666666667,1.0
95,23,48,23,48,23,260,0.046153846153846156,60,85,60,50,50,125,430,0.9090909090909091,1.0
70,55,75,45,65,60,370,0.45901639344262296,160,110,65,65,110,30,540,0.35714285714285715,1.0
50,65,107,105,107,86,520,0.703125,65,110,130,60,65,95,525,0.8278145695364238,1.0
37,25,41,25,41,25,194,0.08870967741935484,100,70,70,65,65,45,415,0.1897810218978102,1.0
75,98,63,98,63,101,498,0.8091603053435115,30,56,35,25,35,72,253,0.48148148148148145,1.0
85,110,76,65,82,56,474,0.3933333333333333,40,60,40,40,40,30,250,0.0948905109489051,0.25
75,100,66,60,66,115,482,0.918918918918919,109,66,84,81,99,32,471,0.2013888888888889,1.0
95,135,80,110,80,100,600,0.8248175182481752,50,48,43,46,41,60,288,0.47297297297297297,1.0
72,85,70,65,70,58,420,0.41304347826086957,100,100,100,100,100,100,600,0.8345864661654135,2.0
70,140,230,60,80,50,630,0.32432432432432434,95,110,80,70,80,50,485,0.37209302325581395,2.0
100,180,160,150,90,90,770,0.7520661157024794,70,92,65,80,55,98,460,0.8090909090909091,0.5
40,45,35,40,40,90,290,0.65,35,70,55,45,55,25,285,0.09420289855072464,1.0
90,75,85,115,90,55,510,0.3445378151260504,45,65,34,40,34,45,263,0.2589928057553957,0.5
78,81,71,74,69,126,499,0.9090909090909091,50,35,55,25,25,15,205,0.05263157894736842,4.0
40,30,30,40,50,30,220,0.07936507936507936,90,100,90,125,85,90,580,0.7352941176470589,0.5
90,85,75,115,100,115,580,0.9381443298969072,65,110,130,60,65,95,525,0.8278145695364238,0.5
65,75,90,97,123,44,494,0.1987179487179487,58,70,45,40,45,42,300,0.25925925925925924,1.0
70,84,70,65,70,51,410,0.2949640287769784,60,75,85,100,85,115,520,0.8992248062015504,1.0
60,85,60,85,60,55,405,0.3673469387755102,90,100,60,90,60,80,480,0.6422764227642277,4.0
72,85,70,65,70,58,420,0.41304347826086957,30,80,90,55,45,55,355,0.4295774647887324,1.0
80,105,105,105,105,80,580,0.5939849624060151,55,66,44,44,56,85,350,0.6888888888888889,1.0
79,115,70,125,80,111,580,0.864,150,120,100,120,100,90,680,0.664179104477612,0.5
43,30,55,40,65,97,330,0.6030534351145038,91,134,95,100,100,80,600,0.6304347826086957,0.5
91,72,90,129,90,108,580,0.8925619834710744,80,70,65,80,120,100,515,0.8034188034188035,0.25
92,105,90,125,90,98,600,0.8217054263565892,60,130,80,60,60,70,460,0.5153846153846153,0.5
60,70,50,100,50,65,395,0.5217391304347826,55,50,65,175,95,150,590,0.7818181818181819,2.0
65,90,50,85,45,55,390,0.371900826446281,105,30,105,140,105,55,540,0.3524590163934426,0.5
95,100,85,108,70,70,528,0.5652173913043478,75,75,75,125,95,40,485,0.15671641791044777,1.0
60,60,60,35,35,30,280,0.11194029850746269,80,160,80,130,80,100,630,0.8455284552845529,1.0
80,70,40,100,60,145,495,0.921875,38,36,38,32,36,57,237,0.3893805309734513,1.0
49,55,42,42,37,85,310,0.6068376068376068,105,180,100,180,100,115,780,0.9477611940298507,1.0
83,80,75,70,70,101,479,0.8615384615384616,125,130,90,130,90,95,660,0.7734375,1.0
80,70,70,90,100,70,480,0.5609756097560976,50,95,90,95,90,180,600,0.9172413793103448,1.0
91,72,90,129,90,108,580,0.8925619834710744,80,85,95,30,30,25,345,0.2857142857142857,8.0
70,135,105,60,105,20,495,0.5806451612903226,45,50,43,40,38,62,278,0.40441176470588236,0.5
62,48,66,59,57,49,341,0.33884297520661155,50,65,45,85,65,95,405,0.7238095238095238,1.0
91,134,95,100,100,80,600,0.6304347826086957,50,35,55,25,25,15,205,0.021739130434782608,2.0
104,91,63,91,73,68,490,0.5118110236220472,62,73,55,56,52,84,382,0.7244094488188977,1.0
45,53,70,40,60,42,310,0.25735294117647056,103,60,86,60,86,50,445,0.3458646616541353,1.0
70,90,45,15,45,50,315,0.3629032258064516,65,95,57,100,85,93,495,0.7441860465116279,0.5
40,45,35,40,40,90,290,0.65,69,55,45,55,55,15,294,0.11666666666666667,1.0
70,20,50,20,50,40,250,0.1557377049180328,106,190,100,154,100,130,780,0.9259259259259259,2.0
60,70,65,125,105,90,515,0.6911764705882353,85,76,64,45,55,90,415,0.6739130434782609,1.0
80,135,85,70,95,150,615,0.9844961240310077,50,85,125,85,115,20,480,0.4306569343065693,1.0
50,95,90,95,90,180,600,0.9172413793103448,40,45,35,65,55,70,310,0.4482758620689655,1.0
60,40,60,40,60,35,295,0.18055555555555555,65,105,60,60,70,95,455,63.0,1.0
75,87,63,87,63,98,473,0.865546218487395,50,85,55,65,65,90,410,0.7478260869565218,2.0
70,145,88,140,70,112,625,0.8888888888888888,60,110,70,60,60,100,460,0.8461538461538461,1.0
135,85,40,40,85,5,390,0.6864406779661016,80,52,50,90,50,89,411,0.6666666666666666,1.0
57,80,91,80,87,75,470,0.5737704918032787,75,75,95,75,95,113,528,0.9015151515151515,1.0
65,70,60,65,65,115,440,0.8583333333333333,85,105,100,79,83,78,530,0.5869565217391305,1.0
65,60,70,85,75,40,395,0.1796875,95,117,184,44,46,28,514,0.2975206611570248,1.0
105,140,55,30,55,95,480,0.8195488721804511,20,10,55,15,20,80,200,0.17985611510791366,0.5
30,40,55,40,55,60,280,0.3237410071942446,80,110,120,130,90,70,600,0.6198347107438017,1.0
95,110,95,40,95,55,490,0.40336134453781514,35,20,65,40,65,20,245,0.02459016393442623,1.0
40,45,65,100,120,90,460,0.5588235294117647,60,65,70,85,75,40,395,0.21705426356589147,1.0
60,110,70,60,60,100,460,0.8461538461538461,80,100,70,60,70,95,475,0.7416666666666667,2.0
50,25,28,45,55,15,218,0.0625,45,50,43,40,38,62,278,0.40441176470588236,1.0
100,100,100,100,100,100,600,0.8345864661654135,110,123,65,100,65,65,528,0.5217391304347826,0.5
62,44,50,44,50,55,305,0.3629032258064516,70,43,53,43,53,40,302,0.19090909090909092,1.0
100,90,130,45,65,55,485,0.4253731343283582,50,47,50,57,50,65,319,0.463768115942029,2.0
50,48,43,46,41,60,288,0.47297297297297297,60,85,42,85,42,91,405,0.8227848101265823,0.0
95,75,80,100,110,30,490,0.24242424242424243,50,35,55,25,25,15,205,0.021739130434782608,1.0
190,33,58,33,58,33,405,0.13432835820895522,71,73,88,120,89,59,500,0.43537414965986393,1.0
60,40,80,60,45,40,325,0.23529411764705882,75,90,90,140,90,115,600,0.9481481481481482,0.0
110,123,65,100,65,65,528,0.5217391304347826,100,100,80,60,60,50,450,0.3050847457627119,4.0
50,80,95,10,45,10,290,0.232,75,98,63,98,63,101,498,0.849624060150376,1.0
41,50,37,50,37,66,281,0.5175438596491229,40,45,40,65,40,65,295,0.5661764705882353,1.0
90,92,87,75,85,76,505,0.5409836065573771,60,150,50,150,50,60,520,0.5,0.0
40,45,35,40,40,90,290,0.65,65,90,115,45,115,58,488,0.5041322314049587,1.0
60,65,60,130,75,110,500,0.7719298245614035,35,85,45,35,35,75,310,0.6492537313432836,0.0
60,62,80,63,80,60,405,0.4336283185840708,109,66,84,81,99,32,471,0.2013888888888889,2.0
250,5,5,35,105,50,450,0.15306122448979592,60,60,60,105,105,105,495,0.848,0.0
59,63,80,65,80,58,405,0.41843971631205673,75,75,130,75,130,95,580,0.7479674796747967,1.0
80,52,50,90,50,89,411,0.6666666666666666,95,117,184,44,46,28,514,0.2975206611570248,1.0
75,95,122,58,75,69,494,0.5725806451612904,75,140,65,112,65,110,567,0.9140625,1.0
40,30,35,45,40,55,245,0.31496062992125984,115,115,85,90,75,100,580,0.8134328358208955,1.0
90,85,75,115,100,115,580,0.9381443298969072,40,45,35,40,40,90,290,0.65,1.0
45,75,37,70,55,83,365,0.6183206106870229,70,55,55,80,60,45,365,0.2222222222222222,1.0
61,84,65,70,70,70,420,0.5,60,60,60,35,35,30,280,0.11194029850746269,1.0
60,69,95,69,95,36,424,0.2608695652173913,100,100,100,100,100,100,600,0.8778625954198473,0.5
90,120,120,60,60,50,500,0.35294117647058826,55,45,43,55,43,72,313,0.5853658536585366,0.0
40,65,40,80,40,65,330,0.5038167938931297,40,60,30,31,31,70,262,0.4492753623188406,1.0
106,90,130,90,154,110,680,0.8699186991869918,60,50,40,85,75,95,405,0.7540983606557377,0.5
44,50,91,24,86,10,305,0.1981981981981982,80,135,85,70,95,150,615,0.9844961240310077,2.0
65,95,100,60,50,50,420,0.34959349593495936,30,40,70,70,25,60,295,0.41353383458646614,1.0
30,40,70,70,25,60,295,0.41353383458646614,30,105,90,25,25,50,325,0.2773722627737226,0.5
45,90,20,65,20,65,305,0.5116279069767442,50,70,50,50,50,70,340,0.5645161290322581,1.0
45,25,50,25,25,35,205,0.13076923076923078,60,45,70,45,90,95,405,0.7304964539007093,1.0
45,55,45,65,45,75,330,0.5692307692307692,45,53,70,40,60,42,310,0.25735294117647056,8.0
83,80,80,135,80,121,579,0.9444444444444444,90,120,100,150,120,100,680,0.7718120805369127,1.0
80,70,40,100,60,145,495,0.921875,74,48,76,83,81,104,466,0.7322834645669292,2.0
69,69,76,69,86,91,460,0.6554621848739496,65,90,50,85,45,55,390,0.371900826446281,0.5
55,50,65,175,95,150,590,0.7818181818181819,80,80,80,80,80,80,480,0.5606060606060606,1.0
37,25,41,25,41,25,194,0.08870967741935484,35,70,55,45,55,25,285,0.09420289855072464,2.0
75,75,60,83,60,60,413,0.39344262295081966,50,30,55,65,55,20,275,0.13675213675213677,2.0
91,72,90,129,90,108,580,0.8620689655172413,75,110,110,110,105,80,590,0.656934306569343,0.25
45,60,40,70,50,45,310,0.2846715328467153,103,60,126,80,126,50,545,0.36363636363636365,1.0
90,120,100,150,120,100,680,0.7718120805369127,75,65,55,65,55,69,384,0.43548387096774194,1.0
45,45,35,20,30,20,195,0.07246376811594203,90,130,80,65,85,55,505,0.4396551724137931,0.5
67,82,62,46,48,43,348,0.22033898305084745,40,80,35,35,45,70,305,0.4661016949152542,1.0
100,100,100,100,100,100,600,0.8345864661654135,45,85,70,40,40,60,340,0.5229357798165137,0.0
80,80,80,80,80,80,480,0.6015037593984962,75,95,122,58,75,69,494,0.5725806451612904,2.0
160,110,65,65,110,30,540,0.35714285714285715,65,50,35,115,95,95,455,0.7333333333333333,1.0
75,95,60,65,60,115,470,0.8778625954198473,75,55,70,55,95,110,460,0.8444444444444444,1.0
75,90,140,60,60,40,465,0.3008130081300813,85,76,64,45,55,90,415,0.6739130434782609,1.0
55,35,50,55,110,85,390,0.6277372262773723,70,45,48,60,65,35,323,0.15748031496062992,0.5
65,50,35,115,95,95,455,0.7333333333333333,77,59,50,67,63,46,362,0.23140495867768596,0.5
90,120,100,150,120,100,680,0.7718120805369127,38,35,35,65,55,50,278,0.2647058823529412,0.0
40,45,65,100,120,90,460,0.5588235294117647,60,48,45,43,90,42,328,0.21897810218978103,0.5
70,90,110,60,75,95,500,0.7333333333333333,89,125,90,115,80,101,600,0.8725490196078431,0.5
50,53,48,53,48,64,316,0.46153846153846156,70,70,115,130,90,60,535,0.5338983050847458,2.0
64,66,68,81,76,50,405,0.25190839694656486,53,51,53,61,56,40,314,0.14285714285714285,0.5
75,75,60,83,60,60,413,0.39344262295081966,80,70,65,80,120,100,515,0.8034188034188035,0.5
35,65,35,65,35,65,300,0.46621621621621623,75,75,60,83,60,60,413,0.39344262295081966,0.5
25,20,15,105,55,90,310,0.32407407407407407,110,130,80,70,60,80,530,0.5862068965517241,2.0
60,62,63,80,80,60,405,0.38016528925619836,50,50,50,50,50,50,300,0.30708661417322836,1.0
116,55,85,107,95,29,487,0.06818181818181818,60,100,115,70,85,90,520,0.7557251908396947,0.5
58,64,58,80,65,80,405,0.5423728813559322,91,72,90,129,90,108,580,0.8925619834710744,0.5
70,150,140,65,100,75,600,0.55,75,80,60,65,90,102,472,0.8625954198473282,1.0
110,160,110,80,110,100,670,0.8591549295774648,85,115,80,105,80,50,515,0.3063063063063063,1.0
55,104,105,94,75,52,485,0.36363636363636365,65,63,45,45,45,45,308,0.2595419847328244,2.0
50,48,43,46,41,60,288,0.47297297297297297,60,55,90,145,90,80,520,0.6071428571428571,4.0
50,50,50,50,50,50,300,0.30708661417322836,40,40,50,30,30,30,220,0.0873015873015873,2.0
50,50,40,30,30,50,250,0.2781954887218045,90,92,87,75,85,76,505,0.5409836065573771,4.0
45,30,50,65,50,45,285,0.13821138211382114,111,83,68,92,82,39,475,0.1774193548387097,2.0
50,75,70,35,70,48,348,0.29357798165137616,40,45,40,35,35,56,251,0.373015873015873,1.0
89,124,80,55,80,55,483,0.5714285714285714,38,30,85,55,65,30,303,0.21428571428571427,2.0
50,180,20,180,20,150,600,0.9029850746268657,90,85,100,95,125,85,580,0.6834532374100719,1.0
70,60,125,115,70,55,495,0.35507246376811596,72,95,67,103,71,122,530,0.9606299212598425,0.5
45,49,65,49,65,45,318,0.275,50,160,110,160,110,110,700,0.8854961832061069,2.0
50,160,110,160,110,110,700,0.8854961832061069,80,120,80,120,80,100,580,0.8478260869565217,2.0
44,48,65,50,64,43,314,0.1623931623931624,90,90,85,125,90,100,580,0.768595041322314,1.0
50,65,85,35,35,55,325,0.32575757575757575,62,77,62,50,42,65,358,0.4838709677419355,1.0
75,80,70,65,75,90,455,0.7578125,30,56,35,25,35,72,253,0.48148148148148145,1.0
58,64,58,80,65,80,405,0.609271523178808,50,75,70,35,70,48,348,0.29357798165137616,1.0
45,60,30,80,50,65,330,0.4603174603174603,43,80,65,50,35,35,308,0.14193548387096774,0.5
65,76,84,54,96,105,480,0.9008264462809917,100,150,110,95,110,70,635,0.5923076923076923,1.0
70,84,70,65,70,51,410,0.2949640287769784,40,30,30,40,50,30,220,0.07936507936507936,0.5
50,65,64,44,48,43,314,0.2196969696969697,100,134,110,95,100,61,600,0.4057971014492754,2.0
30,30,30,30,30,30,180,0.12612612612612611,95,75,80,100,110,30,490,0.24242424242424243,2.0
40,55,80,35,60,30,300,0.15037593984962405,37,25,41,25,41,25,194,0.08870967741935484,1.0
25,20,15,105,55,90,310,0.32407407407407407,80,100,123,122,120,80,625,0.56,2.0
45,55,45,65,45,75,330,0.5692307692307692,100,5,5,15,65,30,220,0.07692307692307693,1.0
83,80,80,135,80,121,579,0.9444444444444444,70,145,88,140,70,112,625,0.8888888888888888,0.5
60,59,85,79,105,36,424,0.16666666666666666,50,70,50,50,50,70,340,0.5645161290322581,1.0
75,70,90,70,105,80,490,0.656,58,109,112,48,48,109,484,0.8805970149253731,0.5
108,170,115,120,95,92,700,0.7083333333333334,60,40,80,60,45,40,325,0.23529411764705882,0.5
75,100,63,80,63,116,497,0.9345794392523364,74,94,131,54,116,20,489,0.4485294117647059,0.5
65,150,60,115,60,115,565,0.935251798561151,62,73,55,56,52,84,382,0.7244094488188977,1.0
40,40,40,70,40,20,250,0.032520325203252036,45,63,37,65,55,95,360,0.8055555555555556,1.0
67,58,57,81,67,101,431,0.8790322580645161,45,60,32,50,32,76,295,0.5925925925925926,0.5
30,45,55,70,55,85,340,0.5633802816901409,53,51,53,61,56,40,314,0.14285714285714285,0.5
89,124,80,55,80,55,483,0.5714285714285714,80,100,70,60,70,95,475,0.7416666666666667,0.0
45,85,50,55,50,65,350,0.5076923076923077,30,45,135,45,90,30,375,0.09285714285714286,2.0
50,50,95,40,50,35,320,0.20279720279720279,64,78,52,78,52,81,405,0.6422764227642277,2.0
60,40,60,40,60,35,295,0.18055555555555555,50,55,50,36,30,43,264,0.2922077922077922,0.5
125,130,90,130,90,95,660,0.7734375,59,110,150,45,49,35,448,0.3333333333333333,0.25
57,24,86,24,86,23,300,0.12727272727272726,45,50,45,115,55,95,405,0.6936936936936937,2.0
55,75,60,75,60,103,428,0.7982456140350878,65,95,57,100,85,93,495,0.7441860465116279,1.0
89,125,90,115,80,101,600,0.8725490196078431,67,82,62,46,48,43,348,0.22033898305084745,2.0
49,49,56,49,61,66,330,0.5190839694656488,64,51,23,51,23,28,240,0.11363636363636363,1.0
40,45,35,30,40,55,245,0.3793103448275862,70,140,70,110,65,105,560,0.95,1.0
40,27,60,37,50,66,280,0.36220472440944884,86,68,72,109,66,106,507,0.8099173553719008,0.25
170,90,45,90,45,60,500,0.427536231884058,80,100,123,122,120,80,625,0.56,0.5
65,125,100,55,70,85,500,0.6532258064516129,70,90,45,15,45,50,315,0.3629032258064516,0.5
45,67,60,35,50,63,320,0.5128205128205128,45,35,50,70,50,30,280,0.15753424657534246,0.5
60,70,65,125,105,90,515,0.6911764705882353,110,65,105,55,95,80,510,0.6258503401360545,0.5
77,120,90,60,90,48,485,0.2785714285714286,100,90,130,45,65,55,485,0.4253731343283582,1.0
80,125,75,40,95,85,500,0.6911764705882353,92,105,90,125,90,98,600,0.8217054263565892,4.0
60,75,85,100,85,115,520,0.8992248062015504,60,85,60,85,60,55,405,0.3673469387755102,2.0
130,70,35,70,35,60,400,0.4017857142857143,80,82,83,100,100,80,525,0.6742424242424242,0.5
100,123,75,57,75,80,510,0.6923076923076923,70,140,230,60,80,50,630,0.32432432432432434,0.25
55,50,45,135,95,120,500,0.7714285714285715,50,35,55,25,25,15,205,0.021739130434782608,1.0
78,81,71,74,69,126,499,0.9090909090909091,75,69,72,114,100,104,534,0.8253968253968254,0.5
65,75,70,95,70,95,470,0.7272727272727273,80,110,120,130,90,70,600,0.6198347107438017,1.0
75,100,95,40,70,110,490,0.8717948717948718,75,125,70,125,70,115,580,0.9037037037037037,1.0
95,135,80,110,80,100,600,0.8248175182481752,76,65,45,92,42,91,411,0.7449664429530202,1.0
60,52,168,47,138,30,495,0.19834710743801653,77,59,50,67,63,46,362,0.23140495867768596,8.0
90,75,75,90,100,70,500,0.5462184873949579,48,61,40,61,40,50,300,0.2543859649122807,1.0
95,155,109,70,130,81,640,0.6788321167883211,67,89,116,79,116,33,500,0.2624113475177305,2.0
63,63,47,41,41,74,329,0.56,70,90,70,60,60,70,420,0.6390977443609023,0.5
90,75,75,90,100,70,500,0.5462184873949579,65,55,115,100,40,60,435,0.3798449612403101,0.5
95,65,65,110,130,60,525,0.4016393442622951,58,50,145,95,105,30,483,0.2459016393442623,1.0
80,135,85,70,95,150,615,0.9844961240310077,65,65,60,130,95,110,525,0.823943661971831,1.0
120,100,85,30,85,45,465,0.22448979591836735,100,110,90,85,90,60,535,0.47794117647058826,1.0
45,49,49,65,65,45,318,0.2781954887218045,60,130,80,60,60,70,460,0.5153846153846153,1.0
60,55,50,40,55,45,305,0.22377622377622378,50,50,77,95,77,91,440,0.5916666666666667,0.25
73,100,60,100,60,65,458,0.42657342657342656,74,108,133,83,65,32,495,0.32142857142857145,0.5
90,100,60,90,60,80,480,0.6422764227642277,60,85,60,50,50,125,430,0.9090909090909091,0.5
40,70,130,60,130,25,455,0.17355371900826447,101,72,72,99,89,29,462,0.1937984496124031,1.0
50,120,53,35,110,87,455,0.640625,85,80,70,135,75,90,535,0.7006802721088435,2.0
91,90,106,130,106,77,600,0.648854961832061,70,120,100,145,105,20,560,0.2824427480916031,0.25
30,40,55,40,55,60,280,0.3237410071942446,70,43,53,43,53,40,302,0.19090909090909092,1.0
70,65,60,90,75,90,450,0.6571428571428571,100,134,110,95,100,61,600,0.4057971014492754,1.0
85,100,122,58,75,54,494,0.3939393939393939,39,52,43,60,50,65,309,0.5041322314049587,0.5
111,83,68,92,82,39,475,0.1774193548387097,35,65,35,65,35,65,300,0.46621621621621623,0.5
54,45,47,75,98,52,371,0.39669421487603307,60,40,80,60,45,40,325,0.23529411764705882,1.0
50,72,35,35,35,65,292,0.5373134328358209,55,20,35,20,45,75,250,0.37681159420289856,1.0
37,25,41,25,41,25,194,0.08870967741935484,100,120,120,150,100,90,680,0.7880794701986755,0.5
54,45,47,75,98,52,371,0.39669421487603307,41,50,37,50,37,66,281,0.5175438596491229,2.0
44,38,39,61,79,42,303,0.2251655629139073,100,100,100,100,100,100,600,0.831858407079646,1.0
105,150,90,150,90,95,680,0.8285714285714286,80,120,70,110,70,80,530,0.6422764227642277,2.0
71,73,88,120,89,59,500,0.43537414965986393,70,80,65,90,65,85,455,0.578125,1.0
58,64,58,80,65,80,405,0.609271523178808,95,100,85,108,70,70,528,0.5652173913043478,0.5
85,120,70,50,60,100,485,0.8308823529411765,38,30,41,30,41,60,240,0.2897196261682243,1.0
70,100,115,30,65,30,410,0.24390243902439024,65,80,80,59,63,58,405,0.4411764705882353,1.0
99,68,83,72,87,51,460,0.417910447761194,40,55,30,30,30,60,245,0.43548387096774194,0.5
100,77,77,128,128,90,600,0.6901408450704225,45,50,55,75,65,30,320,0.06293706293706294,2.0
95,80,105,40,70,100,490,0.8046875,60,40,60,95,60,55,370,0.4222222222222222,0.0
68,85,65,165,135,100,618,0.8083333333333333,70,70,70,70,70,70,420,0.5289256198347108,1.0
50,50,120,80,80,30,410,0.07258064516129033,62,44,50,44,50,55,305,0.3629032258064516,1.0
90,100,90,125,85,90,580,0.7352941176470589,85,56,77,50,77,78,423,0.53125,1.0
65,130,60,75,60,75,465,0.689922480620155,45,30,50,55,65,45,290,0.208,2.0
79,85,60,55,60,71,410,0.60431654676259,70,80,70,80,70,110,480,0.6594202898550725,0.0
105,105,75,65,100,50,500,0.37593984962406013,55,69,85,32,35,28,304,0.09302325581395349,1.0
90,120,75,60,60,45,450,0.29411764705882354,50,65,107,105,107,86,520,0.6991150442477876,0.5
125,130,90,130,90,95,660,0.7734375,60,60,40,65,45,35,305,0.15833333333333333,1.0
77,85,51,55,51,65,384,0.5163934426229508,25,35,70,95,55,45,325,0.16783216783216784,0.5
40,20,30,40,80,55,265,0.22764227642276422,50,30,55,65,55,20,275,0.13675213675213677,0.25
76,104,71,104,71,108,534,0.912751677852349,50,105,125,55,95,50,480,0.375886524822695,2.0
50,50,77,95,77,91,440,0.5916666666666667,90,120,120,60,60,50,500,0.35294117647058826,0.0
50,105,79,35,110,76,455,0.6214285714285714,60,100,115,70,85,90,520,0.7557251908396947,2.0
46,57,40,40,40,50,273,0.25,28,25,25,45,35,40,198,0.16083916083916083,2.0
50,48,43,46,41,60,288,0.47297297297297297,73,115,60,60,60,90,458,0.6694915254237288,1.0
55,40,50,65,85,40,335,0.3181818181818182,100,100,100,100,100,100,600,0.831858407079646,2.0
45,67,60,35,50,63,320,0.5128205128205128,108,100,121,81,95,95,600,0.7476635514018691,1.0
70,43,53,43,53,40,302,0.19090909090909092,108,130,95,80,85,102,600,0.7637795275590551,0.5
40,45,35,40,40,90,290,0.65,110,160,110,80,110,100,670,0.8591549295774648,1.0
40,45,40,35,35,56,251,0.373015873015873,55,75,60,75,60,103,428,0.7982456140350878,0.5
41,50,37,50,37,66,281,0.5175438596491229,75,80,70,65,75,90,455,0.7578125,1.0
45,95,50,40,50,75,355,0.54,76,25,45,67,55,24,292,0.0390625,2.0
90,75,85,115,90,55,510,0.3445378151260504,44,38,33,61,43,70,289,0.5267857142857143,0.5
70,90,70,60,60,70,420,0.6390977443609023,80,80,80,55,55,90,440,0.6417910447761194,1.0
86,68,72,109,66,106,507,0.8099173553719008,55,55,55,85,55,30,335,0.1320754716981132,1.0
90,75,75,90,100,70,500,0.5462184873949579,83,106,65,86,65,85,490,0.6640625,1.0
65,50,70,95,80,65,425,0.4262295081967213,68,85,65,165,135,100,618,0.8083333333333333,0.5
70,120,100,145,105,20,560,0.2824427480916031,49,66,70,44,55,51,335,0.4260869565217391,1.0
38,30,85,55,65,30,303,0.21428571428571427,65,90,115,45,115,58,488,0.5041322314049587,0.5
40,55,70,45,60,30,300,0.10619469026548672,100,120,120,150,100,90,680,0.7880794701986755,0.5
45,30,50,55,65,45,290,0.208,45,30,35,20,20,45,195,0.14782608695652175,1.0
70,50,30,95,135,105,485,0.8040540540540541,65,47,55,73,75,85,400,0.65,1.0
100,100,100,100,100,100,600,0.8758169934640523,86,68,72,109,66,106,507,0.8099173553719008,0.5
79,85,60,55,60,71,410,0.60431654676259,70,110,70,115,70,90,525,0.75,0.5
60,80,50,50,50,40,330,0.23853211009174313,76,65,45,92,42,91,411,0.7449664429530202,1.0
40,55,70,45,60,30,300,0.10619469026548672,75,95,122,58,75,69,494,0.5725806451612904,1.0
35,65,35,65,35,65,300,0.46621621621621623,100,180,160,150,90,90,770,0.7520661157024794,4.0
103,93,67,71,61,84,479,0.7142857142857143,65,65,60,130,95,110,525,0.823943661971831,2.0
95,135,80,110,80,100,600,0.8248175182481752,50,80,95,10,45,10,290,0.232,0.5
105,130,120,45,45,40,485,0.4444444444444444,100,100,100,100,100,100,600,0.831858407079646,1.0
91,90,72,90,129,108,580,0.896,80,80,80,55,55,90,440,0.6417910447761194,2.0
40,55,30,30,30,85,270,0.688,95,145,130,120,90,120,700,0.9398496240601504,1.0
35,45,160,30,45,70,385,0.48148148148148145,35,20,65,40,65,20,245,0.02459016393442623,1.0
90,90,85,125,90,100,580,0.768595041322314,55,40,85,80,105,40,405,0.23622047244094488,2.0
110,78,73,76,71,60,468,0.3333333333333333,90,50,34,60,44,70,348,0.6283185840707964,0.0
30,45,135,45,90,30,375,0.09285714285714286,110,160,110,80,110,100,670,0.8591549295774648,1.0
65,130,60,75,60,75,465,0.689922480620155,65,60,70,85,75,40,395,0.1796875,1.0
70,60,75,110,75,90,480,0.7165354330708661,67,57,55,77,55,114,425,0.8879310344827587,0.5
66,117,70,40,50,67,410,0.4573643410852713,45,35,50,70,50,30,280,0.15753424657534246,1.0
130,65,60,110,95,65,525,0.5227272727272727,123,77,72,99,92,58,521,0.4621212121212121,2.0
60,80,50,40,40,30,300,0.15328467153284672,55,40,40,65,45,35,280,0.16428571428571428,1.0
83,106,65,86,65,85,490,0.6640625,95,110,95,40,95,55,490,0.40336134453781514,2.0
160,110,65,65,110,30,540,0.35714285714285715,55,40,85,80,105,40,405,0.23622047244094488,1.0
80,92,65,65,80,68,450,0.4824561403508772,65,80,80,59,63,58,405,0.4411764705882353,0.5
95,75,80,100,110,30,490,0.24242424242424243,80,100,70,50,60,45,405,0.25806451612903225,1.0
65,73,55,47,75,85,400,0.6846846846846847,75,125,70,125,70,115,580,0.9037037037037037,2.0
45,67,60,35,50,63,320,0.5128205128205128,64,78,52,78,52,81,405,0.6422764227642277,2.0
57,80,91,80,87,75,470,0.5737704918032787,125,120,90,170,100,95,700,0.78125,4.0
95,75,180,130,80,30,590,0.13793103448275862,55,130,115,50,50,75,475,0.5982142857142857,0.5
106,190,100,154,100,130,780,0.9259259259259259,95,135,80,110,80,100,600,0.8248175182481752,0.5
160,110,65,65,110,30,540,0.35714285714285715,60,90,55,90,80,110,485,0.8677685950413223,1.0
60,130,80,60,60,70,460,0.5153846153846153,50,47,50,57,50,65,319,0.463768115942029,0.25
20,15,20,10,55,80,200,0.2682926829268293,40,65,40,80,40,65,330,0.5038167938931297,1.0
63,120,85,90,55,55,468,0.2809917355371901,85,115,80,105,80,50,515,0.3063063063063063,1.0
68,85,65,165,135,100,618,0.8083333333333333,81,102,77,85,75,85,505,0.5642857142857143,2.0
90,30,15,40,20,15,210,0.043478260869565216,100,50,50,76,96,70,442,0.5,1.0
40,45,35,30,40,55,245,0.3793103448275862,78,92,75,74,63,118,500,0.8842975206611571,2.0
60,62,50,62,60,40,334,0.18181818181818182,150,80,44,90,54,80,498,0.625,1.0
95,75,80,100,110,30,490,0.24242424242424243,80,100,70,50,60,45,405,0.25806451612903225,1.0
70,80,102,80,102,40,474,0.2677165354330709,46,57,40,40,40,50,273,0.25,0.5
70,85,70,60,70,50,405,0.28378378378378377,40,30,32,50,52,65,269,0.3671875,0.25
77,120,90,60,90,48,485,0.2785714285714286,80,80,90,110,130,110,600,0.8721804511278195,2.0
50,65,107,105,107,86,520,0.7758620689655172,36,50,50,65,60,44,305,0.16363636363636364,1.0
40,30,35,50,70,55,280,0.28205128205128205,85,73,70,73,115,67,483,0.5126050420168067,1.0
72,58,80,103,80,97,490,0.7171052631578947,59,74,50,35,50,35,303,0.3125,2.0
60,75,100,55,80,50,420,0.3088235294117647,78,84,78,109,85,100,534,0.8646616541353384,0.5
65,125,60,95,60,105,510,0.9236641221374046,65,90,65,61,61,100,442,0.8373983739837398,1.0
70,140,230,60,80,50,630,0.32432432432432434,60,90,70,60,120,40,440,0.27419354838709675,1.0
50,72,35,35,35,65,292,0.5373134328358209,45,50,35,55,75,40,300,0.21367521367521367,1.0
106,90,130,90,154,110,680,0.8699186991869918,91,90,129,90,72,108,580,0.9140625,0.5
62,55,52,109,94,109,481,0.7833333333333333,85,60,65,135,105,100,550,0.7518248175182481,1.0
55,35,50,55,110,85,390,0.6277372262773723,41,56,40,62,44,71,314,0.568,1.0
100,150,140,100,90,90,670,0.7969924812030075,75,98,63,98,63,101,498,0.849624060150376,1.0
86,92,88,68,75,73,482,0.6835443037974683,80,82,100,83,100,80,525,0.6821705426356589,1.0
60,55,90,145,90,80,520,0.6071428571428571,58,89,77,45,45,48,362,0.3177570093457944,0.25
60,62,80,63,80,60,405,0.4336283185840708,79,115,70,125,80,111,580,0.864,0.5
44,38,33,61,43,70,289,0.5267857142857143,70,83,50,37,50,60,350,0.3360655737704918,2.0
60,50,70,80,80,140,480,0.8449612403100775,50,105,125,55,95,50,480,0.375886524822695,1.0
30,45,55,70,55,85,340,0.5633802816901409,60,80,50,40,40,30,300,0.15328467153284672,1.0
55,130,115,50,50,75,475,0.5982142857142857,80,120,130,55,65,45,495,0.37037037037037035,4.0
70,62,67,55,55,56,365,0.38513513513513514,150,120,100,120,100,90,680,0.664179104477612,0.5
61,84,65,70,70,70,420,0.5,72,95,67,103,71,122,530,0.9606299212598425,1.0
60,55,90,145,90,80,520,0.6071428571428571,58,70,45,40,45,42,300,0.25925925925925924,0.5
64,78,52,78,52,81,405,0.6422764227642277,55,81,60,50,70,97,413,0.7214285714285714,2.0
95,117,80,65,70,92,519,0.8409090909090909,65,130,60,95,110,65,525,0.5303030303030303,2.0
56,61,65,48,45,38,313,0.17567567567567569,150,120,100,120,100,90,680,0.664179104477612,0.5
100,100,100,100,100,100,600,0.8758169934640523,95,100,85,108,70,70,528,0.5652173913043478,0.5
70,62,67,55,55,56,365,0.38513513513513514,60,85,40,30,45,68,328,0.6422018348623854,0.5
70,70,115,130,90,60,535,0.5338983050847458,40,55,70,45,60,30,300,0.10619469026548672,0.5
38,35,35,65,55,50,278,0.2647058823529412,90,60,70,75,70,45,410,0.23880597014925373,1.0
70,92,65,80,55,98,460,0.8090909090909091,50,30,55,65,55,20,275,0.13675213675213677,2.0
70,84,70,65,70,51,410,0.2949640287769784,95,110,80,70,80,50,485,0.37209302325581395,2.0
85,105,85,40,50,40,405,0.211864406779661,91,72,90,129,90,108,580,0.8620689655172413,1.0
70,20,50,20,50,40,250,0.1557377049180328,105,95,80,40,80,90,490,0.753968253968254,1.0
60,65,60,130,75,110,500,0.7719298245614035,99,68,83,72,87,51,460,0.417910447761194,2.0
50,47,50,57,50,65,319,0.463768115942029,55,75,50,40,40,80,340,0.6302521008403361,1.0
80,105,105,105,105,80,580,0.5939849624060151,60,55,90,145,90,80,520,0.6071428571428571,1.0
59,59,58,90,70,73,409,0.5826086956521739,70,75,60,105,60,105,475,0.88,1.0
35,20,65,40,65,20,245,0.02459016393442623,95,155,109,70,130,81,640,0.6788321167883211,2.0
58,109,112,48,48,109,484,0.8805970149253731,64,51,23,51,23,28,240,0.11363636363636363,1.0
83,106,65,86,65,85,490,0.6640625,75,125,75,30,75,85,465,0.625,1.0
116,55,85,107,95,29,487,0.06818181818181818,85,110,76,65,82,56,474,0.3933333333333333,1.0
95,75,80,100,110,30,490,0.24242424242424243,65,80,65,35,65,60,370,0.38405797101449274,1.0
65,100,70,80,80,105,500,0.8666666666666667,70,84,70,65,70,51,410,0.2949640287769784,0.5
61,78,95,56,58,57,405,0.40336134453781514,65,90,65,61,61,100,442,0.8373983739837398,0.5
70,92,65,80,55,98,460,0.8090909090909091,55,40,40,65,45,35,280,0.16428571428571428,1.0
85,76,64,45,55,90,415,0.6739130434782609,55,50,40,40,40,75,300,0.5945945945945946,1.0
45,100,45,45,45,10,290,0.2949640287769784,75,70,90,70,105,80,490,0.656,0.0
65,150,60,115,60,115,565,0.935251798561151,70,83,50,37,50,60,350,0.3360655737704918,1.0
50,50,50,50,50,50,300,0.30708661417322836,50,30,55,65,55,20,275,0.13675213675213677,0.5
100,75,115,90,115,85,580,0.6446280991735537,45,60,45,25,45,55,275,0.29,1.0
123,100,62,97,81,68,531,0.4806201550387597,65,90,115,45,115,58,488,0.5041322314049587,1.0
40,70,130,60,130,25,455,0.17355371900826447,48,72,48,72,48,48,336,0.25984251968503935,2.0
80,160,80,130,80,100,630,0.8455284552845529,80,120,130,55,65,45,495,0.37037037037037035,1.0
50,65,45,85,65,95,405,0.7238095238095238,80,105,65,60,75,130,515,0.9645390070921985,1.0
60,85,69,60,69,77,420,0.518796992481203,77,120,90,60,90,48,485,0.2785714285714286,1.0
75,95,95,95,95,85,540,0.6470588235294118,100,110,90,85,90,60,535,0.47794117647058826,1.0
105,95,80,40,80,90,490,0.753968253968254,70,115,60,115,60,55,475,0.4647887323943662,1.0
20,10,55,15,20,80,200,0.17985611510791366,105,180,100,180,100,115,780,0.9477611940298507,0.5
100,150,110,95,110,70,635,0.5923076923076923,75,100,110,45,55,65,450,0.5333333333333333,2.0
105,105,75,65,100,50,500,0.37593984962406013,50,105,125,55,95,50,480,0.375886524822695,0.0
30,45,135,45,90,30,375,0.09285714285714286,50,105,125,55,95,50,480,0.375886524822695,0.5
55,112,45,74,45,70,401,0.559322033898305,70,60,62,80,82,60,414,0.4375,8.0
50,72,35,35,35,65,292,0.5373134328358209,79,103,120,135,115,78,630,0.5763888888888888,1.0
45,20,50,60,120,50,345,0.24074074074074073,45,30,50,65,50,45,285,0.13821138211382114,1.0
35,80,50,50,70,120,405,0.84375,60,79,105,59,85,36,424,0.17054263565891473,0.5
42,52,67,39,56,50,306,0.2868217054263566,58,70,45,40,45,42,300,0.25925925925925924,0.5
50,85,85,55,55,50,380,0.3902439024390244,109,66,84,81,99,32,471,0.2013888888888889,0.5
35,65,35,65,35,65,300,0.46621621621621623,40,55,70,45,60,30,300,0.10619469026548672,1.0
65,47,55,73,75,85,400,0.65,68,125,65,65,115,80,518,0.6277372262773723,1.0
50,65,107,105,107,86,520,0.703125,95,124,78,69,71,58,495,0.37398373983739835,1.0
67,82,62,46,48,43,348,0.22033898305084745,85,135,130,60,80,25,515,0.40540540540540543,2.0
110,85,95,80,95,50,515,0.2713178294573643,75,100,63,80,63,116,497,0.9345794392523364,1.0
75,87,63,87,63,98,473,0.865546218487395,50,60,45,100,80,65,400,0.45689655172413796,1.0
55,75,85,25,25,15,280,0.1875,90,100,70,110,150,80,600,0.6037735849056604,1.0
100,123,75,57,75,80,510,0.6923076923076923,60,60,50,40,50,75,335,0.5882352941176471,2.0
48,72,48,72,48,48,336,0.25984251968503935,43,80,65,50,35,35,308,0.14193548387096774,1.0
60,85,69,65,79,80,438,0.576,90,92,87,75,85,76,505,0.5409836065573771,0.25
51,65,65,80,75,59,395,0.4365079365079365,40,45,40,62,60,60,307,0.33884297520661155,0.5
65,63,45,45,45,45,308,0.2595419847328244,54,66,70,44,55,46,335,0.4214876033057851,2.0
79,100,80,110,90,121,580,0.968,64,66,68,81,76,50,405,0.25190839694656486,1.0
49,66,70,44,55,51,335,0.4260869565217391,50,50,40,30,30,50,250,0.2781954887218045,2.0
60,85,40,30,45,68,328,0.6422018348623854,80,135,85,70,95,150,615,0.9844961240310077,0.0
65,130,60,75,60,75,465,0.689922480620155,104,91,63,91,73,68,490,0.5118110236220472,1.0
75,95,67,125,95,83,540,0.7117117117117117,38,35,35,65,55,50,278,0.2647058823529412,1.0
90,120,75,60,60,45,450,0.29411764705882354,70,45,48,60,65,35,323,0.15748031496062992,1.0
50,50,62,40,62,65,329,0.4188034188034188,70,110,75,145,85,145,630,0.9444444444444444,2.0
50,95,180,85,45,70,525,0.5298507462686567,50,65,64,44,48,43,314,0.2196969696969697,0.25
62,73,55,56,52,84,382,0.7244094488188977,75,95,122,58,75,69,494,0.5725806451612904,4.0
89,145,90,105,80,91,600,0.8549618320610687,30,35,30,100,35,80,310,0.4765625,2.0
106,130,90,110,154,90,680,0.719626168224299,61,78,95,56,58,57,405,0.40336134453781514,4.0
40,45,40,65,40,65,295,0.5661764705882353,53,54,53,37,46,45,288,0.3090909090909091,1.0
105,105,75,65,100,50,500,0.37593984962406013,78,130,111,130,85,100,634,0.8561151079136691,1.0
60,85,69,65,79,80,438,0.576,55,55,85,65,85,35,380,0.2014388489208633,0.5
30,45,59,30,39,57,260,0.2803030303030303,86,92,88,68,75,73,482,0.6835443037974683,4.0
40,20,30,40,80,55,265,0.22764227642276422,30,40,55,40,55,60,280,0.3237410071942446,2.0
55,70,55,40,55,85,360,0.7073170731707317,65,90,122,58,75,84,494,0.71875,0.0
85,110,90,45,90,80,500,0.6206896551724138,70,135,105,60,105,20,495,0.5806451612903226,0.5
44,38,33,61,43,70,289,0.5267857142857143,105,105,75,65,100,50,500,0.37593984962406013,1.0
45,49,49,65,65,45,318,0.2781954887218045,60,90,70,60,120,40,440,0.27419354838709675,1.0
85,70,80,97,80,123,535,0.9304347826086956,104,91,63,91,73,68,490,0.5118110236220472,1.0
80,80,80,80,80,80,480,0.6015037593984962,95,110,80,70,80,50,485,0.37209302325581395,0.5
70,50,30,95,135,105,485,0.8040540540540541,65,80,140,40,70,70,465,0.5223880597014925,1.0
85,110,90,45,90,80,500,0.6206896551724138,65,70,60,65,65,115,440,0.8583333333333333,1.0
90,92,87,75,85,76,505,0.5409836065573771,30,35,30,100,35,80,310,0.4765625,0.5
75,100,66,60,66,115,482,0.918918918918919,45,30,15,85,65,65,305,0.36220472440944884,1.0
55,40,40,65,45,35,280,0.16428571428571428,70,130,100,55,80,65,500,0.608,1.0
101,72,72,99,89,29,462,0.1937984496124031,100,100,100,100,100,100,600,0.8602941176470589,1.0
103,93,67,71,61,84,479,0.7142857142857143,40,45,40,35,35,56,251,0.373015873015873,1.0
62,77,62,50,42,65,358,0.4838709677419355,65,75,105,35,65,85,430,0.6940298507462687,1.0
55,95,55,35,75,115,430,0.9380530973451328,50,65,90,35,35,15,290,0.14678899082568808,1.0
83,80,75,70,70,101,479,0.8615384615384616,60,62,63,80,80,60,405,0.38016528925619836,2.0
46,57,40,40,40,50,273,0.25,75,98,63,98,63,101,498,0.849624060150376,1.0
80,70,70,90,100,70,480,0.5609756097560976,90,100,60,90,60,80,480,0.6422764227642277,0.25
60,60,60,85,85,85,435,0.631578947368421,60,70,65,125,105,90,515,0.6911764705882353,1.0
45,90,20,65,20,65,305,0.5116279069767442,60,80,50,50,50,40,330,0.23853211009174313,1.0
35,55,40,50,50,90,320,0.6838235294117647,70,60,125,115,70,55,495,0.35507246376811596,2.0
76,25,45,67,55,24,292,0.0390625,75,95,60,65,60,115,470,0.8778625954198473,1.0
106,190,100,154,100,130,780,0.9259259259259259,62,77,62,50,42,65,358,0.4838709677419355,1.0
60,85,69,65,79,80,438,0.576,60,52,168,47,138,30,495,0.19834710743801653,0.0
65,150,60,115,60,115,565,0.935251798561151,55,75,50,40,40,80,340,0.6302521008403361,1.0
85,110,76,65,82,56,474,0.3933333333333333,75,75,130,75,130,95,580,0.7479674796747967,2.0
40,70,130,60,130,25,455,0.17355371900826447,36,50,50,65,60,44,305,0.16363636363636364,1.0
100,100,100,100,100,100,600,0.831858407079646,54,63,52,83,56,97,405,0.7697841726618705,1.0
70,55,65,95,85,70,440,0.5307692307692308,50,65,45,85,65,95,405,0.7238095238095238,1.0
45,95,50,40,50,75,355,0.54,20,40,15,35,35,60,205,0.34285714285714286,1.0
50,65,85,35,35,55,325,0.32575757575757575,70,62,67,55,55,56,365,0.38513513513513514,0.5
100,50,80,60,80,50,420,0.34375,130,70,35,70,35,60,400,0.4017857142857143,0.5
30,56,35,25,35,72,253,0.48148148148148145,75,80,70,65,75,90,455,0.7578125,1.0
50,105,79,35,110,76,455,0.6214285714285714,50,50,62,40,62,65,329,0.4188034188034188,0.5
110,65,105,55,95,80,510,0.6258503401360545,60,110,70,60,60,100,460,0.8461538461538461,1.0
70,90,70,60,60,70,420,0.6390977443609023,95,145,130,120,90,120,700,0.9398496240601504,1.0
40,27,60,37,50,66,280,0.36220472440944884,74,108,133,83,65,32,495,0.32142857142857145,4.0
65,40,70,80,140,70,465,0.5954198473282443,40,30,35,50,70,55,280,0.28205128205128205,1.0
40,80,35,35,45,70,305,0.4661016949152542,65,83,57,95,85,105,490,0.8914728682170543,1.0
80,80,80,80,80,80,480,0.6015037593984962,44,48,65,50,64,43,314,0.1623931623931624,0.5
70,80,65,90,65,85,455,0.578125,65,90,122,58,75,84,494,0.71875,0.0
40,55,30,30,30,60,245,0.43548387096774194,90,120,100,150,120,100,680,0.7718120805369127,1.0
71,82,64,64,59,112,452,0.9327731092436975,35,70,55,45,55,25,285,0.09420289855072464,1.0
68,65,65,125,115,80,518,0.6461538461538462,65,90,50,85,45,55,390,0.371900826446281,1.0
45,30,50,55,65,45,290,0.208,60,100,115,70,85,90,520,0.7557251908396947,0.5
100,110,90,85,90,60,535,0.47794117647058826,100,100,100,100,100,100,600,0.8778625954198473,4.0
70,45,48,60,65,35,323,0.15748031496062992,50,55,50,36,30,43,264,0.2922077922077922,1.0
82,80,86,85,75,72,480,0.6183206106870229,75,75,75,125,95,40,485,0.15671641791044777,1.0
80,95,82,60,82,75,474,0.6,81,102,77,85,75,85,505,0.5642857142857143,0.25
50,92,108,92,108,35,485,0.2457627118644068,80,120,70,110,70,80,530,0.6422764227642277,0.5
97,165,60,65,50,58,495,0.3902439024390244,55,50,40,40,40,75,300,0.5945945945945946,1.0
65,155,120,65,90,105,600,0.8677685950413223,80,82,83,100,100,80,525,0.6742424242424242,2.0
91,129,90,72,90,108,580,0.8536585365853658,95,124,78,69,71,58,495,0.37398373983739835,1.0
85,110,76,65,82,56,474,0.3933333333333333,75,38,38,56,56,67,330,0.5263157894736842,2.0
90,100,70,110,150,80,600,0.6037735849056604,60,110,70,60,60,100,460,0.8461538461538461,1.0
45,50,35,55,75,40,300,0.21367521367521367,100,5,5,15,65,30,220,0.07692307692307693,1.0
75,75,75,125,95,40,485,0.15671641791044777,52,65,55,58,62,60,352,0.4482758620689655,1.0
72,85,70,65,70,58,420,0.41304347826086957,80,105,65,60,75,130,515,0.9645390070921985,1.0
80,120,70,110,70,80,530,0.6422764227642277,66,117,70,40,50,67,410,0.4573643410852713,0.5
40,27,60,37,50,66,280,0.36220472440944884,70,115,60,115,60,55,475,0.4647887323943662,1.0
75,100,63,80,63,116,497,0.9345794392523364,44,38,39,61,79,42,303,0.2251655629139073,1.0
58,64,58,80,65,80,405,0.5423728813559322,70,110,75,145,85,145,630,0.9444444444444444,1.0
70,77,60,97,60,108,472,0.8394160583941606,50,50,120,80,80,30,410,0.07258064516129033,0.5
77,120,90,60,90,48,485,0.2785714285714286,70,100,70,105,75,40,460,0.23214285714285715,1.0
60,48,45,43,90,42,328,0.21897810218978103,35,85,45,35,35,75,310,0.6492537313432836,1.0
60,25,35,70,80,60,330,0.3076923076923077,75,140,65,112,65,110,567,0.9140625,1.0
55,85,122,58,75,99,494,0.8099173553719008,50,80,95,10,45,10,290,0.232,2.0
50,65,107,105,107,86,520,0.7272727272727273,70,70,40,60,40,60,340,0.4247787610619469,1.0
70,120,40,95,40,95,460,0.8106060606060606,40,27,60,37,50,66,280,0.36220472440944884,0.25
45,63,37,65,55,95,360,0.8055555555555556,50,50,62,40,62,65,329,0.4188034188034188,1.0
55,55,55,85,55,30,335,0.1320754716981132,100,164,150,95,120,71,700,0.5645161290322581,0.0
30,105,90,25,25,50,325,0.2773722627737226,55,55,85,65,85,35,380,0.2014388489208633,1.0
70,110,80,55,80,105,500,0.8794326241134752,65,45,55,45,70,45,325,0.24369747899159663,1.0
40,40,55,40,70,55,300,0.40939597315436244,100,73,83,73,83,55,467,0.371900826446281,4.0
20,25,45,70,90,60,310,0.30833333333333335,60,85,69,65,79,80,438,0.576,1.0
57,80,91,80,87,75,470,0.5737704918032787,65,40,70,80,140,70,465,0.5954198473282443,0.5
115,115,85,90,75,100,580,0.8134328358208955,60,60,60,85,85,85,435,0.631578947368421,1.0
80,82,78,95,80,85,500,0.6869565217391305,105,140,95,55,65,45,505,0.3,1.0
50,65,107,105,107,86,520,0.7758620689655172,95,145,130,120,90,120,700,0.9398496240601504,0.5
55,50,40,40,40,75,300,0.5945945945945946,50,45,45,35,35,50,260,0.23529411764705882,1.0
50,53,62,58,63,44,330,0.13709677419354838,91,90,129,90,72,108,580,0.9140625,1.0
72,58,80,103,80,97,490,0.7171052631578947,80,100,80,80,80,100,520,0.9051724137931034,2.0
101,72,72,99,89,29,462,0.1937984496124031,35,60,44,40,54,55,288,0.366412213740458,0.5
108,100,121,81,95,95,600,0.7476635514018691,39,52,43,60,50,65,309,0.49107142857142855,2.0
100,70,70,65,65,45,415,0.1897810218978102,91,90,72,90,129,108,580,0.896,1.0
74,108,133,83,65,32,495,0.32142857142857145,55,70,40,60,40,40,305,0.26956521739130435,2.0
86,81,97,81,107,43,495,0.203125,59,63,80,65,80,58,405,0.41843971631205673,2.0
110,65,105,55,95,80,510,0.6258503401360545,57,80,91,80,87,75,470,0.5737704918032787,0.25
58,109,112,48,48,109,484,0.8805970149253731,110,80,90,95,90,65,530,0.5033557046979866,1.0
40,20,30,40,80,55,265,0.22764227642276422,58,50,145,95,105,30,483,0.2459016393442623,0.5
79,115,70,125,80,111,580,0.8468468468468469,60,62,50,62,60,40,334,0.18181818181818182,2.0
71,95,85,110,95,79,535,0.664,55,40,50,65,85,40,335,0.3181818181818182,0.5
66,117,70,40,50,67,410,0.4573643410852713,45,60,32,50,32,76,295,0.5925925925925926,1.0
50,65,107,105,107,86,520,0.7272727272727273,63,120,85,90,55,55,468,0.2809917355371901,2.0
116,55,85,107,95,29,487,0.06818181818181818,58,70,45,40,45,42,300,0.25925925925925924,2.0
50,20,55,25,25,30,205,0.09774436090225563,60,67,85,77,75,116,480,0.8888888888888888,1.0
30,45,59,30,39,57,260,0.2803030303030303,60,50,40,85,75,95,405,0.7540983606557377,1.0
60,60,75,60,75,80,410,0.7321428571428571,38,35,40,27,25,35,200,0.08208955223880597,0.5
90,110,80,100,80,95,555,0.7982456140350878,75,110,110,110,105,80,590,0.656934306569343,0.5
80,100,70,60,70,95,475,0.7416666666666667,58,64,58,80,65,80,405,0.609271523178808,0.5
45,60,45,25,45,55,275,0.29,80,80,80,55,55,90,440,0.6417910447761194,1.0
80,135,130,95,90,70,600,0.5181818181818182,50,45,45,35,35,50,260,0.23529411764705882,1.0
120,70,120,75,130,85,600,0.6694915254237288,45,75,37,70,55,83,365,0.6183206106870229,1.0
100,73,83,73,83,55,467,0.371900826446281,59,66,70,44,55,41,335,0.25190839694656486,1.0
106,190,100,154,100,130,780,0.9259259259259259,103,60,86,60,86,50,445,0.3458646616541353,2.0
103,60,126,80,126,50,545,0.36363636363636365,80,100,123,122,120,80,625,0.56,0.5
108,100,121,81,95,95,600,0.7476635514018691,50,20,55,25,25,30,205,0.09774436090225563,0.5
100,120,120,150,100,90,680,0.7880794701986755,65,75,105,35,65,85,430,0.6940298507462687,1.0
105,105,75,65,100,50,500,0.37593984962406013,80,82,83,100,100,80,525,0.6742424242424242,1.0
95,23,48,23,48,23,260,0.046153846153846156,70,100,115,30,65,30,410,0.24390243902439024,1.0
70,80,50,35,35,35,305,0.14,90,85,100,95,125,85,580,0.6834532374100719,1.0
40,30,35,50,70,55,280,0.28205128205128205,45,30,15,85,65,65,305,0.36220472440944884,1.0
45,100,135,65,135,45,525,0.29411764705882354,50,85,125,85,115,20,480,0.4306569343065693,1.0
79,103,120,135,115,78,630,0.5763888888888888,50,75,35,70,30,40,300,0.21296296296296297,0.5
75,125,230,55,95,30,610,0.3448275862068966,80,145,150,105,110,110,700,0.8692307692307693,1.0
114,85,70,85,80,30,464,0.2066115702479339,55,45,50,45,65,80,340,0.5546218487394958,0.5
70,140,230,60,80,50,630,0.32432432432432434,35,85,45,35,35,75,310,0.6492537313432836,1.0
80,135,85,70,95,150,615,0.9844961240310077,50,53,48,53,48,64,316,0.46153846153846156,2.0
42,52,67,39,56,50,306,0.2868217054263566,105,95,80,40,80,90,490,0.753968253968254,1.0
65,60,70,85,75,40,395,0.1796875,85,60,65,135,105,100,550,0.7518248175182481,1.0
50,65,64,44,48,43,314,0.2196969696969697,150,100,120,100,120,90,680,0.6666666666666666,0.5
45,40,60,40,75,50,310,0.2926829268292683,67,89,116,79,116,33,500,0.2624113475177305,0.25
83,80,75,70,70,101,479,0.8615384615384616,105,125,100,60,100,100,590,0.8359375,1.0
45,20,50,60,120,50,345,0.24074074074074073,40,55,80,35,60,30,300,0.15037593984962405,0.5
50,35,55,25,25,15,205,0.05263157894736842,95,125,79,60,100,81,540,0.6165413533834586,0.5
90,120,75,60,60,45,450,0.29411764705882354,67,125,40,30,30,58,350,0.3431372549019608,1.0
55,104,105,94,75,52,485,0.36363636363636365,44,75,35,63,33,45,295,0.2647058823529412,1.0
40,50,45,70,45,70,320,0.5517241379310345,60,100,115,70,85,90,520,0.7557251908396947,0.25
72,58,80,103,80,97,490,0.7171052631578947,75,75,75,125,95,40,485,0.15671641791044777,0.5
60,50,150,50,150,60,520,0.5206611570247934,68,125,65,65,115,80,518,0.6277372262773723,2.0
75,105,75,105,75,45,480,0.3274336283185841,60,70,105,70,120,75,500,0.5983606557377049,2.0
58,64,58,80,65,80,405,0.609271523178808,84,71,43,71,43,48,360,0.25874125874125875,1.0
65,90,40,45,80,75,395,0.625,50,85,40,85,40,35,335,0.1746031746031746,4.0
68,165,95,65,115,110,618,0.8615384615384616,100,100,100,100,100,100,600,0.8805970149253731,1.0
75,65,55,65,55,69,384,0.43548387096774194,39,52,43,60,50,65,309,0.49107142857142855,4.0
50,50,77,95,77,91,440,0.5916666666666667,65,63,45,45,45,45,308,0.2595419847328244,1.0
48,72,48,72,48,48,336,0.25984251968503935,80,135,130,95,90,70,600,0.5181818181818182,0.25
68,125,65,65,115,80,518,0.6277372262773723,40,40,40,70,40,20,250,0.032520325203252036,1.0
75,38,38,56,56,67,330,0.5263157894736842,75,80,95,90,100,50,490,0.2158273381294964,0.25
90,100,60,90,60,80,480,0.6422764227642277,106,110,90,154,90,130,680,0.926829268292683,2.0
59,110,150,45,49,35,448,0.3333333333333333,48,61,40,61,40,50,300,0.2543859649122807,1.0
90,95,95,70,90,70,510,0.5230769230769231,45,65,34,40,34,45,263,0.2589928057553957,1.0
65,65,60,110,95,130,525,0.9253731343283582,60,85,60,85,60,55,405,0.3673469387755102,1.0
79,85,60,55,60,71,410,0.60431654676259,80,80,80,55,55,90,440,0.6417910447761194,1.0
45,75,37,70,55,83,365,0.6183206106870229,50,50,62,40,62,65,329,0.4188034188034188,1.0
65,50,35,115,95,95,455,0.7333333333333333,70,110,80,55,80,105,500,0.8794326241134752,2.0
95,145,130,120,90,120,700,0.9398496240601504,73,115,60,60,60,90,458,0.6694915254237288,1.0
38,30,85,55,65,30,303,0.21428571428571427,85,80,70,135,75,90,535,0.7006802721088435,0.0
20,25,45,70,90,60,310,0.30833333333333335,52,65,50,45,50,38,300,0.27419354838709675,0.0
80,105,65,60,75,130,515,0.9645390070921985,65,65,65,50,50,90,385,0.72,1.0
75,95,60,65,60,115,470,0.8778625954198473,75,125,70,125,70,115,580,0.9037037037037037,1.0
50,80,95,10,45,10,290,0.232,70,55,75,45,65,60,370,0.45901639344262296,2.0
40,35,30,120,70,105,400,0.6692307692307692,62,77,62,50,42,65,358,0.4838709677419355,1.0
120,100,85,30,85,45,465,0.22448979591836735,78,92,75,74,63,118,500,0.8842975206611571,0.5
60,150,50,150,50,60,520,0.5,80,100,123,122,120,80,625,0.56,1.0
60,55,50,40,55,45,305,0.22377622377622378,105,150,90,150,90,95,680,0.8285714285714286,0.5
35,85,45,35,35,75,310,0.6492537313432836,60,60,60,60,60,60,360,0.38095238095238093,1.0
50,35,55,25,25,15,205,0.021739130434782608,40,80,100,30,30,20,300,0.11851851851851852,1.0
78,52,60,63,65,23,341,0.06015037593984962,50,50,77,95,77,91,440,0.5916666666666667,1.0
75,125,100,70,80,45,495,0.33035714285714285,30,40,70,70,25,60,295,0.41353383458646614,1.0
64,66,68,81,76,50,405,0.25190839694656486,55,70,55,40,55,85,360,0.7073170731707317,1.0
100,50,80,60,80,50,420,0.34375,60,85,40,30,45,68,328,0.6422018348623854,2.0
150,100,120,100,120,90,680,0.6666666666666666,95,124,78,69,71,58,495,0.37398373983739835,0.5
67,58,57,81,67,101,431,0.8790322580645161,75,75,75,125,95,40,485,0.15671641791044777,1.0
50,20,40,20,40,20,190,0.0962962962962963,75,75,55,105,85,30,425,0.1619718309859155,1.0
75,95,60,65,60,115,470,0.8778625954198473,28,25,25,45,35,40,198,0.16083916083916083,1.0
70,70,40,60,40,60,340,0.4247787610619469,66,117,70,40,50,67,410,0.4573643410852713,0.5
67,89,116,79,116,33,500,0.2624113475177305,35,45,160,30,45,70,385,0.48148148148148145,4.0
72,60,30,20,30,25,237,0.11570247933884298,85,80,70,135,75,90,535,0.7006802721088435,2.0
110,135,60,50,65,88,508,0.7744360902255639,63,60,55,50,50,71,349,0.5289256198347108,0.0
110,65,75,125,85,30,490,0.15,50,53,48,53,48,64,316,0.4076923076923077,1.0
105,105,75,65,100,50,500,0.37593984962406013,55,65,95,95,45,85,440,0.6610169491525424,1.0
125,58,58,76,76,67,460,0.515625,60,60,40,65,45,35,305,0.15833333333333333,0.0
45,30,50,65,50,45,285,0.13821138211382114,66,41,77,61,87,23,355,0.12096774193548387,1.0
100,123,75,57,75,80,510,0.6923076923076923,50,53,62,58,63,44,330,0.13709677419354838,1.0
170,90,45,90,45,60,500,0.427536231884058,100,50,50,76,96,70,442,0.5,1.0
62,55,52,109,94,109,481,0.7833333333333333,100,103,75,120,75,127,600,0.940677966101695,1.0
85,97,66,105,66,65,484,0.47107438016528924,55,70,45,70,50,60,350,0.45,0.5
103,60,126,80,126,50,545,0.36363636363636365,125,58,58,76,76,67,460,0.515625,1.0
100,164,150,95,120,71,700,0.5645161290322581,67,58,57,81,67,101,431,0.8790322580645161,0.5
55,85,122,58,75,99,494,0.8099173553719008,72,95,67,103,71,122,530,0.9606299212598425,1.0
86,76,86,116,56,95,515,0.7982456140350878,75,125,75,30,75,85,465,0.625,1.0
50,85,125,85,115,20,480,0.4306569343065693,100,50,80,60,80,50,420,0.34375,0.5
80,120,130,55,65,45,495,0.37037037037037035,45,49,65,49,65,45,318,0.275,0.5
60,60,60,105,105,105,495,0.848,57,80,91,80,87,75,470,0.5737704918032787,1.0
65,150,40,15,80,145,495,0.9663865546218487,55,55,85,65,85,35,380,0.2014388489208633,0.5
92,105,90,125,90,98,600,0.8217054263565892,40,45,40,35,35,56,251,0.373015873015873,1.0
65,80,80,59,63,58,405,0.4411764705882353,38,30,41,30,41,60,240,0.2897196261682243,1.0
20,10,55,15,20,80,200,0.17985611510791366,40,45,35,30,40,55,245,0.3793103448275862,1.0
64,66,68,81,76,50,405,0.25190839694656486,65,40,50,125,60,30,370,0.07258064516129033,1.0
100,100,100,100,100,100,600,0.8805970149253731,55,66,44,44,56,85,350,0.6888888888888889,1.0
49,49,56,49,61,66,330,0.5190839694656488,90,85,75,115,100,115,580,0.9381443298969072,1.0
50,180,20,180,20,150,600,0.9029850746268657,70,90,110,60,75,95,500,0.7333333333333333,0.0
80,120,80,120,80,100,580,0.8478260869565217,100,110,90,85,90,60,535,0.47794117647058826,1.0
75,110,110,110,105,80,590,0.656934306569343,40,20,30,40,80,55,265,0.22764227642276422,1.0
100,150,110,95,110,70,635,0.5923076923076923,95,85,85,65,65,35,430,0.2571428571428571,1.0
40,35,30,20,20,50,195,0.23423423423423423,64,88,50,88,50,106,446,0.9111111111111111,2.0
105,150,90,150,90,95,680,0.8285714285714286,70,105,105,50,40,20,390,0.33587786259541985,0.5
100,100,100,100,100,100,600,0.8602941176470589,68,72,78,38,42,32,330,0.23809523809523808,2.0
100,150,120,120,100,90,680,0.6493506493506493,53,51,53,61,56,40,314,0.14285714285714285,2.0
74,48,76,83,81,104,466,0.7913043478260869,120,100,85,30,85,45,465,0.22448979591836735,1.0
80,120,130,55,65,45,495,0.37037037037037035,100,77,77,128,128,90,600,0.6901408450704225,1.0
40,45,40,62,60,60,307,0.33884297520661155,100,70,70,65,65,45,415,0.1897810218978102,1.0
90,132,105,132,105,30,594,0.4246575342465753,85,135,130,60,80,25,515,0.40540540540540543,2.0
75,69,72,114,100,104,534,0.8253968253968254,45,55,39,35,39,42,255,0.18518518518518517,1.0
46,87,60,30,40,57,320,0.37777777777777777,65,47,55,73,75,85,400,0.65,1.0
50,50,40,50,40,64,294,0.45588235294117646,40,20,30,40,80,55,265,0.22764227642276422,1.0
55,75,60,75,60,103,428,0.7982456140350878,55,50,65,175,95,150,590,0.7818181818181819,1.0
45,67,60,35,50,63,320,0.5128205128205128,70,80,65,90,65,85,455,0.578125,1.0
40,60,40,40,40,30,250,0.0948905109489051,100,120,100,150,120,90,680,0.728,0.5
73,95,62,85,65,85,465,0.6666666666666666,60,65,80,170,95,130,600,0.8625954198473282,0.0
50,85,125,85,115,20,480,0.4306569343065693,90,75,75,90,100,70,500,0.5462184873949579,1.0
90,100,60,90,60,80,480,0.6422764227642277,36,50,50,65,60,44,305,0.16363636363636364,1.0
48,72,48,72,48,48,336,0.25984251968503935,50,53,48,53,48,64,316,0.46153846153846156,1.0
106,90,130,90,154,110,680,0.8699186991869918,115,45,20,45,25,20,270,0.11538461538461539,1.0
89,125,90,115,80,101,600,0.8725490196078431,80,80,80,80,80,80,480,0.5606060606060606,1.0
40,45,35,30,40,55,245,0.3793103448275862,100,100,100,100,100,100,600,0.831858407079646,1.0
106,110,90,154,90,130,680,0.926829268292683,75,100,95,40,70,110,490,0.8717948717948718,1.0
105,180,100,180,100,115,780,0.9477611940298507,45,100,135,65,135,45,525,0.29411764705882354,1.0
42,52,67,39,56,50,306,0.2868217054263566,90,85,100,95,125,85,580,0.6834532374100719,4.0
50,65,107,105,107,86,520,0.703125,50,52,48,65,50,55,320,0.33098591549295775,1.0
75,80,60,65,90,102,472,0.8625954198473282,88,107,122,74,75,64,530,0.4596774193548387,1.0
70,94,50,94,50,66,424,0.48148148148148145,67,58,57,81,67,101,431,0.8790322580645161,0.25
38,30,85,55,65,30,303,0.21428571428571427,55,104,105,94,75,52,485,0.36363636363636365,1.0
60,62,50,62,60,40,334,0.18181818181818182,50,47,50,57,50,65,319,0.463768115942029,0.5
126,131,95,131,98,99,680,0.8294573643410853,95,110,95,40,95,55,490,0.40336134453781514,1.0
84,86,88,111,101,60,530,0.4634146341463415,60,50,40,85,75,95,405,0.7540983606557377,0.5
105,95,80,40,80,90,490,0.753968253968254,80,120,80,120,80,100,580,0.8478260869565217,1.0
108,112,118,68,72,47,525,0.2916666666666667,57,24,86,24,86,23,300,0.12727272727272726,2.0
50,72,35,35,35,65,292,0.5373134328358209,81,102,77,85,75,85,505,0.5642857142857143,2.0
61,90,45,50,50,160,456,0.9230769230769231,95,75,80,100,110,30,490,0.24242424242424243,2.0
79,105,70,145,80,101,580,0.8608695652173913,63,63,47,41,41,74,329,0.56,1.0
90,70,80,70,95,70,475,0.5190839694656488,60,45,50,90,80,70,395,0.625,2.0
65,50,70,95,80,65,425,0.4262295081967213,50,65,45,85,65,95,405,0.7238095238095238,1.0
50,53,48,53,48,64,316,0.4076923076923077,90,100,90,125,85,90,580,0.7352941176470589,0.25
65,55,115,100,40,60,435,0.3798449612403101,53,51,53,61,56,40,314,0.14285714285714285,2.0
111,83,68,92,82,39,475,0.1774193548387097,58,70,45,40,45,42,300,0.25925925925925924,1.0
67,57,55,77,55,114,425,0.8879310344827587,60,65,70,85,75,40,395,0.21705426356589147,4.0
95,65,65,110,130,60,525,0.4016393442622951,97,165,60,65,50,58,495,0.3902439024390244,1.0
58,64,58,80,65,80,405,0.5423728813559322,30,56,35,25,35,72,253,0.48148148148148145,1.0
55,55,50,45,65,55,325,0.37373737373737376,60,90,70,60,120,40,440,0.27419354838709675,1.0
90,70,80,70,95,70,475,0.5190839694656488,65,40,50,125,60,30,370,0.07258064516129033,1.0
100,5,5,15,65,30,220,0.07692307692307693,59,63,80,65,80,58,405,0.41843971631205673,1.0
65,63,45,45,45,45,308,0.2595419847328244,108,130,95,80,85,102,600,0.7637795275590551,0.5
85,90,80,70,80,130,535,0.9262295081967213,80,80,90,110,130,110,600,0.8721804511278195,1.0
115,45,20,45,25,20,270,0.11538461538461539,68,65,65,125,115,80,518,0.6461538461538462,1.0
75,65,55,65,55,69,384,0.43548387096774194,40,55,30,30,30,60,245,0.43548387096774194,0.0
60,62,63,80,80,60,405,0.38016528925619836,40,55,30,30,30,60,245,0.43548387096774194,0.5
65,40,50,125,60,30,370,0.07258064516129033,55,40,40,65,45,35,280,0.16428571428571428,1.0
48,61,40,61,40,50,300,0.2543859649122807,70,145,88,140,70,112,625,0.8888888888888888,0.0
65,60,70,85,75,40,395,0.1796875,75,123,67,95,85,95,540,0.7642276422764228,1.0
65,50,35,115,95,95,455,0.7333333333333333,30,40,70,70,25,60,295,0.41353383458646614,0.5
65,47,55,73,75,85,400,0.65,20,15,20,10,55,80,200,0.2682926829268293,1.0
100,100,90,150,140,90,670,0.71875,55,35,50,55,110,85,390,0.6277372262773723,1.0
55,55,55,85,55,30,335,0.1320754716981132,50,48,43,46,41,60,288,0.47297297297297297,2.0
86,76,86,116,56,95,515,0.7982456140350878,91,90,72,90,129,108,580,0.896,4.0
95,75,80,100,110,30,490,0.24242424242424243,40,35,30,120,70,105,400,0.6692307692307692,0.5
80,110,60,150,130,70,600,0.5042016806722689,50,60,45,100,80,65,400,0.45689655172413796,2.0
46,57,40,40,40,50,273,0.25,58,64,58,80,65,80,405,0.609271523178808,1.0
78,84,78,109,85,100,534,0.8620689655172413,60,50,70,50,90,65,385,0.39568345323741005,2.0
50,85,55,65,65,90,410,0.7478260869565218,80,160,60,170,130,80,680,0.6180555555555556,1.0
80,80,90,110,130,110,600,0.8721804511278195,68,85,65,165,135,100,618,0.8083333333333333,0.0
85,135,130,60,80,25,515,0.40540540540540543,60,85,69,65,79,80,438,0.576,1.0
100,100,100,100,100,100,600,0.8602941176470589,80,100,70,60,70,95,475,0.7416666666666667,0.5
80,160,80,130,80,100,630,0.8455284552845529,70,90,110,60,75,95,500,0.7333333333333333,1.0
70,60,70,87,78,85,450,0.6228070175438597,70,90,70,60,60,70,420,0.6390977443609023,1.0
55,40,50,65,85,40,335,0.3181818181818182,60,59,85,79,105,36,424,0.16666666666666666,0.5
126,131,95,131,98,99,680,0.8102189781021898,60,50,50,60,70,50,340,0.28346456692913385,2.0
65,95,57,100,85,93,495,0.7441860465116279,60,80,50,50,50,40,330,0.23853211009174313,1.0
70,77,60,97,60,108,472,0.8394160583941606,55,95,115,45,45,35,390,0.2116788321167883,0.0
70,80,70,80,70,110,480,0.6594202898550725,85,105,100,79,83,78,530,0.5869565217391305,0.5
70,110,180,60,60,50,530,0.4117647058823529,65,75,70,95,70,95,470,0.7272727272727273,2.0
80,160,80,130,80,100,630,0.8455284552845529,60,62,80,63,80,60,405,0.4336283185840708,2.0
130,70,35,70,35,60,400,0.4017857142857143,50,105,79,35,110,76,455,0.6214285714285714,1.0
67,89,116,79,116,33,500,0.2624113475177305,90,95,105,165,110,45,610,0.2890625,0.5
60,70,50,100,50,65,395,0.5217391304347826,75,110,110,110,105,80,590,0.656934306569343,0.5
90,132,105,132,105,30,594,0.4246575342465753,40,30,35,45,40,55,245,0.31496062992125984,1.0
91,90,106,130,106,77,600,0.648854961832061,111,83,68,92,82,39,475,0.1774193548387097,0.25
30,105,90,25,25,50,325,0.2773722627737226,55,47,52,40,40,41,275,0.16806722689075632,1.0
37,25,41,25,41,25,194,0.08870967741935484,105,130,120,45,45,40,485,0.4444444444444444,1.0
95,75,80,100,110,30,490,0.24242424242424243,80,80,80,80,80,80,480,0.6015037593984962,1.0
114,85,70,85,80,30,464,0.2066115702479339,70,60,70,87,78,85,450,0.6228070175438597,1.0
75,103,80,70,80,92,500,0.7933884297520661,40,29,45,29,45,36,224,0.14634146341463414,0.5
70,60,70,87,78,85,450,0.6228070175438597,65,65,60,110,95,130,525,0.9253731343283582,1.0
60,85,40,30,45,68,328,0.6422018348623854,80,100,200,50,100,50,580,0.3472222222222222,2.0
60,85,69,60,69,77,420,0.518796992481203,60,85,42,85,42,91,405,0.8227848101265823,1.0
80,100,70,50,60,45,405,0.25806451612903225,70,92,65,80,55,98,460,0.8090909090909091,1.0
82,80,86,85,75,72,480,0.6183206106870229,44,58,44,58,44,61,309,0.41964285714285715,0.5
40,30,30,55,30,85,270,0.4666666666666667,56,61,65,48,45,38,313,0.17567567567567569,1.0
30,35,30,100,35,80,310,0.4765625,90,85,100,95,125,85,580,0.6834532374100719,1.0
68,90,65,50,55,82,410,0.6165413533834586,46,57,40,40,40,50,273,0.25,2.0
78,104,78,159,115,100,634,0.8444444444444444,70,150,140,65,100,75,600,0.55,4.0
70,80,102,80,102,40,474,0.2677165354330709,65,75,90,97,123,44,494,0.1987179487179487,0.5
78,92,75,74,63,118,500,0.8842975206611571,50,60,60,60,60,30,320,0.11290322580645161,0.5
100,134,110,95,100,61,600,0.4057971014492754,80,50,100,100,200,50,580,0.2357142857142857,2.0
45,55,45,65,45,75,330,0.5692307692307692,70,70,115,130,90,60,535,0.5338983050847458,0.125
105,95,75,85,75,74,509,0.5714285714285714,65,130,60,75,60,75,465,0.689922480620155,1.0
75,98,63,98,63,101,498,0.8091603053435115,70,83,50,37,50,60,350,0.3360655737704918,0.5
43,80,65,50,35,35,308,0.14193548387096774,60,62,50,62,60,40,334,0.18181818181818182,0.5
40,30,35,45,40,55,245,0.31496062992125984,95,65,65,110,130,60,525,0.4016393442622951,0.0
65,50,35,115,95,95,455,0.7333333333333333,45,75,37,70,55,83,365,0.6183206106870229,0.5
50,72,35,35,35,65,292,0.5373134328358209,40,35,30,120,70,105,400,0.6692307692307692,2.0
40,45,40,62,60,60,307,0.33884297520661155,110,135,60,50,65,88,508,0.7744360902255639,2.0
45,30,50,65,50,45,285,0.13821138211382114,80,120,79,95,79,70,523,0.5833333333333334,1.0
60,85,69,65,79,80,438,0.576,65,60,70,85,75,40,395,0.1796875,1.0
65,125,100,55,70,85,500,0.6532258064516129,40,27,60,37,50,66,280,0.36220472440944884,1.0
106,190,100,154,100,130,780,0.9259259259259259,78,104,78,159,115,100,634,0.8444444444444444,0.5
78,104,78,159,115,100,634,0.8444444444444444,55,75,50,40,40,80,340,0.6302521008403361,1.0
55,85,122,58,75,99,494,0.8099173553719008,63,63,47,41,41,74,329,0.56,0.25
50,92,108,92,108,35,485,0.2457627118644068,60,70,50,100,50,65,395,0.5217391304347826,1.0
76,65,45,92,42,91,411,0.7449664429530202,60,79,105,59,85,36,424,0.17054263565891473,2.0
75,95,95,95,95,85,540,0.6470588235294118,55,50,40,40,40,75,300,0.5945945945945946,1.0
20,10,55,15,20,80,200,0.17985611510791366,55,40,85,80,105,40,405,0.23622047244094488,1.0
50,53,62,58,63,44,330,0.13709677419354838,123,77,72,99,92,58,521,0.4621212121212121,2.0
75,140,65,112,65,110,567,0.9140625,40,45,35,65,55,70,310,0.4482758620689655,2.0
108,170,115,120,95,92,700,0.7083333333333334,60,80,50,50,50,40,330,0.23853211009174313,1.0
101,72,72,99,89,29,462,0.1937984496124031,20,10,230,10,230,5,505,0.0,1.0
70,105,105,50,40,20,390,0.33587786259541985,58,109,112,48,48,109,484,0.8805970149253731,1.0
38,36,38,32,36,57,237,0.3893805309734513,45,22,60,27,30,29,213,0.07518796992481203,1.0
55,104,105,94,75,52,485,0.36363636363636365,45,22,60,27,30,29,213,0.07518796992481203,1.0
150,160,100,95,65,100,670,0.8866666666666667,35,35,35,35,35,35,210,0.13385826771653545,1.0
90,75,85,115,90,55,510,0.3445378151260504,36,50,50,65,60,44,305,0.16363636363636364,1.0
45,100,45,45,45,10,290,0.2949640287769784,41,64,45,50,50,50,300,0.36752136752136755,1.0
60,55,145,75,150,40,525,0.2,40,45,65,100,120,90,460,0.5588235294117647,0.5
80,145,150,105,110,110,700,0.8692307692307693,35,55,40,45,40,60,275,0.35714285714285715,0.5
75,95,122,58,75,69,494,0.5725806451612904,100,120,100,150,120,90,680,0.728,0.25
68,165,95,65,115,110,618,0.8615384615384616,91,129,90,72,90,108,580,0.8536585365853658,2.0
35,60,44,40,54,55,288,0.366412213740458,60,40,80,60,45,40,325,0.23529411764705882,2.0
70,90,70,60,60,70,420,0.6390977443609023,88,107,122,74,75,64,530,0.4596774193548387,0.5
40,30,50,55,55,100,330,0.584070796460177,70,85,70,60,70,50,405,0.28378378378378377,0.0
78,92,75,74,63,118,500,0.8842975206611571,80,82,83,100,100,80,525,0.6742424242424242,1.0
52,65,50,45,50,38,300,0.27419354838709675,125,170,100,120,90,95,700,0.77,2.0
40,30,35,45,40,55,245,0.31496062992125984,50,25,28,45,55,15,218,0.0625,0.0
60,40,60,95,60,55,370,0.4222222222222222,20,40,15,35,35,60,205,0.34285714285714286,1.0
65,90,65,61,61,100,442,0.8373983739837398,50,45,45,35,35,50,260,0.23529411764705882,1.0
80,100,70,50,60,45,405,0.25806451612903225,50,65,107,105,107,86,520,0.7272727272727273,0.5
60,70,65,125,105,90,515,0.6911764705882353,72,105,115,54,86,68,500,0.5149253731343284,2.0
100,75,115,90,115,85,580,0.6446280991735537,55,35,50,55,110,85,390,0.6277372262773723,1.0
110,123,65,100,65,65,528,0.5217391304347826,55,45,50,45,65,80,340,0.5546218487394958,1.0
55,65,95,95,45,85,440,0.6610169491525424,45,35,45,62,53,35,275,0.11851851851851852,0.5
91,134,95,100,100,80,600,0.6304347826086957,85,105,55,85,50,115,495,0.9032258064516129,1.0
28,25,25,45,35,40,198,0.16083916083916083,40,30,30,40,50,30,220,0.07936507936507936,1.0
75,100,63,80,63,116,497,0.9345794392523364,45,50,43,40,38,62,278,0.40441176470588236,2.0
75,100,110,45,55,65,450,0.5333333333333333,65,90,50,85,45,55,390,0.371900826446281,1.0
106,190,100,154,100,130,780,0.9259259259259259,115,140,130,55,55,40,535,0.4519230769230769,4.0
63,60,55,50,50,71,349,0.5289256198347108,120,70,120,75,130,85,600,0.6694915254237288,1.0
125,170,100,120,90,95,700,0.77,81,102,77,85,75,85,505,0.5642857142857143,2.0
54,78,103,53,45,22,355,0.23255813953488372,67,57,55,77,55,114,425,0.8879310344827587,2.0
70,80,102,80,102,40,474,0.2677165354330709,50,105,79,35,110,76,455,0.6214285714285714,1.0
65,60,70,85,75,40,395,0.1796875,85,105,55,85,50,115,495,0.9032258064516129,1.0
50,50,150,50,150,50,500,0.2571428571428571,40,70,130,60,130,25,455,0.17355371900826447,1.0
60,115,105,65,70,80,495,0.7181818181818181,70,140,230,60,80,50,630,0.32432432432432434,0.5
91,90,72,90,129,108,580,0.896,58,64,58,80,65,80,405,0.609271523178808,0.5
75,98,63,98,63,101,498,0.889763779527559,45,95,50,40,50,75,355,0.54,1.0
76,147,90,60,70,97,540,0.8267716535433071,90,92,75,92,85,60,494,0.49586776859504134,1.0
38,36,38,32,36,57,237,0.3893805309734513,55,75,60,75,60,103,428,0.7982456140350878,1.0
110,130,80,70,60,80,530,0.5862068965517241,35,55,35,30,30,35,220,0.23684210526315788,1.0
90,70,80,70,95,70,475,0.5190839694656488,55,70,55,40,55,85,360,0.7073170731707317,1.0
100,120,120,150,100,90,680,0.7880794701986755,40,60,40,40,40,30,250,0.0948905109489051,1.0
95,70,73,95,90,60,483,0.3983739837398374,43,70,48,50,60,38,309,0.2391304347826087,1.0
70,85,140,85,70,20,470,0.272,45,30,35,20,20,45,195,0.14782608695652175,2.0
90,95,105,165,110,45,610,0.2890625,95,110,95,40,95,55,490,0.40336134453781514,1.0
65,47,55,73,75,85,400,0.65,80,80,80,55,55,90,440,0.6417910447761194,1.0
86,68,72,109,66,106,507,0.8099173553719008,65,73,55,47,75,85,400,0.6846846846846847,2.0
45,60,30,80,50,65,330,0.4603174603174603,45,53,70,40,60,42,310,0.25735294117647056,4.0
60,50,150,50,150,60,520,0.5206611570247934,50,50,77,95,77,91,440,0.5916666666666667,1.0
52,65,50,45,50,38,300,0.27419354838709675,44,75,35,63,33,45,295,0.2647058823529412,2.0
35,45,160,30,45,70,385,0.48148148148148145,65,125,100,60,70,70,490,0.6099290780141844,1.0
95,135,80,110,80,100,600,0.8248175182481752,10,55,25,35,45,95,265,0.5396825396825397,1.0
80,70,65,80,120,100,515,0.8034188034188035,70,94,50,94,50,66,424,0.48148148148148145,1.0
20,15,20,10,55,80,200,0.2682926829268293,20,40,15,35,35,60,205,0.34285714285714286,1.0
91,129,90,72,90,108,580,0.8536585365853658,71,82,64,64,59,112,452,0.9327731092436975,2.0
55,55,45,63,45,45,308,0.25,60,67,85,77,75,116,480,0.8888888888888888,0.5
50,30,55,65,55,20,275,0.13675213675213677,55,65,95,95,45,85,440,0.6610169491525424,0.5
60,67,85,77,75,116,480,0.8888888888888888,58,109,112,48,48,109,484,0.8805970149253731,0.125
35,80,50,50,70,120,405,0.84375,70,95,85,55,65,70,440,0.5,2.0
125,120,90,170,100,95,700,0.78125,103,60,126,80,126,50,545,0.36363636363636365,0.0
90,93,55,70,55,55,418,0.3819444444444444,69,55,45,55,55,15,294,0.11666666666666667,1.0
60,59,85,79,105,36,424,0.16666666666666666,35,80,50,50,70,120,405,0.84375,2.0
30,30,30,30,30,30,180,0.12612612612612611,49,55,42,42,37,85,310,0.6068376068376068,1.0
95,23,48,23,48,23,260,0.046153846153846156,60,65,60,130,75,110,500,0.7719298245614035,2.0
100,50,50,76,96,70,442,0.5,30,80,90,55,45,55,355,0.4295774647887324,0.25
50,35,55,25,25,15,205,0.021739130434782608,110,160,110,80,110,100,670,0.8591549295774648,1.0
86,92,88,68,75,73,482,0.6835443037974683,77,59,50,67,63,46,362,0.23140495867768596,1.0
80,100,80,80,80,100,520,0.9051724137931034,45,45,35,20,30,20,195,0.07246376811594203,0.5
85,90,80,70,80,130,535,0.9262295081967213,50,65,90,35,35,15,290,0.14678899082568808,2.0
50,50,95,40,50,35,320,0.20279720279720279,100,5,5,15,65,30,220,0.07692307692307693,1.0
85,60,65,135,105,100,550,0.7518248175182481,64,115,65,83,63,65,455,0.5323741007194245,0.5
50,180,20,180,20,150,600,0.9029850746268657,55,68,64,45,55,31,318,0.11666666666666667,1.0
130,85,80,85,95,60,535,0.43884892086330934,74,108,133,83,65,32,495,0.32142857142857145,0.5
86,92,88,68,75,73,482,0.6835443037974683,40,50,90,30,55,65,330,0.44680851063829785,2.0
35,45,160,30,45,70,385,0.48148148148148145,106,150,70,194,120,140,780,0.952,1.0
35,60,44,40,54,55,288,0.366412213740458,74,94,131,54,116,20,489,0.4485294117647059,0.0
50,65,107,105,107,86,520,0.6991150442477876,125,170,100,120,90,95,700,0.77,0.5
80,135,130,95,90,70,600,0.5181818181818182,80,120,70,110,70,80,530,0.6422764227642277,0.5
44,75,35,63,33,45,295,0.2647058823529412,100,70,70,65,65,45,415,0.1897810218978102,0.0
45,50,43,40,38,62,278,0.40441176470588236,100,164,150,95,120,71,700,0.5645161290322581,0.25
76,48,48,57,62,34,325,0.11688311688311688,160,110,65,65,110,30,540,0.35714285714285715,1.0
75,75,130,75,130,95,580,0.7479674796747967,75,125,230,55,95,30,610,0.3448275862068966,1.0
25,20,15,105,55,90,310,0.32407407407407407,70,130,100,55,80,65,500,0.608,0.5
50,75,45,40,45,60,315,0.4380165289256198,45,35,50,70,50,30,280,0.15753424657534246,2.0
43,70,48,50,60,38,309,0.2391304347826087,70,65,60,90,75,90,450,0.6571428571428571,0.25
100,120,100,150,120,90,680,0.728,80,70,65,80,120,100,515,0.8034188034188035,0.5
70,75,80,135,80,135,575,0.917910447761194,100,164,150,95,120,71,700,0.5645161290322581,1.0
41,50,37,50,37,66,281,0.5175438596491229,65,60,70,85,75,40,395,0.1796875,1.0
56,61,65,48,45,38,313,0.17567567567567569,70,55,55,80,60,45,365,0.2222222222222222,1.0
106,110,90,154,90,130,680,0.926829268292683,60,60,75,60,75,80,410,0.7321428571428571,0.5
40,30,50,55,55,100,330,0.584070796460177,105,30,105,140,105,55,540,0.3524590163934426,1.0
80,85,95,30,30,25,345,0.2857142857142857,110,65,75,125,85,30,490,0.15,1.0
65,65,45,75,45,95,390,0.72,35,20,65,40,65,20,245,0.02459016393442623,0.5
70,110,80,55,80,105,500,0.8794326241134752,100,5,5,15,65,30,220,0.07692307692307693,1.0
105,180,100,180,100,115,780,0.9477611940298507,45,49,49,65,65,45,318,0.2781954887218045,2.0
60,62,80,63,80,60,405,0.4336283185840708,65,80,80,59,63,58,405,0.4411764705882353,2.0
65,63,45,45,45,45,308,0.2595419847328244,75,95,60,65,60,115,470,0.8778625954198473,1.0
65,60,70,85,75,40,395,0.1796875,55,40,85,80,105,40,405,0.23622047244094488,1.0
38,35,40,27,25,35,200,0.08208955223880597,76,65,45,92,42,91,411,0.7449664429530202,0.5
75,75,55,105,85,30,425,0.1619718309859155,74,94,131,54,116,20,489,0.4485294117647059,0.25
80,185,115,40,105,75,600,0.6230769230769231,65,125,60,95,60,105,510,0.9236641221374046,0.5
75,98,63,98,63,101,498,0.8091603053435115,85,97,66,105,66,65,484,0.47107438016528924,0.5
73,100,60,100,60,65,458,0.42657342657342656,80,70,40,100,60,145,495,0.921875,1.0
75,100,95,40,70,110,490,0.8717948717948718,30,56,35,25,35,72,253,0.48148148148148145,1.0
90,70,80,70,95,70,475,0.5190839694656488,90,75,75,90,100,70,500,0.5462184873949579,0.25
40,45,35,40,40,90,290,0.65,70,140,70,110,65,105,560,0.95,1.0
45,100,45,45,45,10,290,0.2949640287769784,116,55,85,107,95,29,487,0.06818181818181818,1.0
75,125,70,125,70,115,580,0.9037037037037037,100,100,90,150,140,90,670,0.71875,1.0
70,40,50,55,50,25,290,0.061068702290076333,91,90,106,130,106,77,600,0.648854961832061,0.5
130,65,60,110,95,65,525,0.5227272727272727,103,93,67,71,61,84,479,0.7142857142857143,1.0
50,53,62,58,63,44,330,0.13709677419354838,75,38,38,56,56,67,330,0.5263157894736842,0.5
85,60,65,135,105,100,550,0.7518248175182481,80,80,50,40,50,25,325,0.176056338028169,0.5
50,25,28,45,55,15,218,0.0625,65,85,70,75,70,40,405,0.203125,1.0
115,140,130,55,55,40,535,0.4519230769230769,30,105,90,25,25,50,325,0.2773722627737226,1.0
100,164,150,95,120,71,700,0.5645161290322581,45,60,32,50,32,76,295,0.5925925925925926,1.0
80,120,70,110,70,80,530,0.6422764227642277,70,140,230,60,80,50,630,0.32432432432432434,4.0
40,70,130,60,130,25,455,0.17355371900826447,55,45,50,45,65,80,340,0.5546218487394958,1.0
45,65,34,40,34,45,263,0.2589928057553957,50,65,85,35,35,55,325,0.32575757575757575,1.0
60,60,40,65,45,35,305,0.15833333333333333,70,150,140,65,100,75,600,0.55,4.0
50,95,90,95,90,180,600,0.9172413793103448,103,93,67,71,61,84,479,0.7142857142857143,0.0
35,55,40,50,50,90,320,0.6838235294117647,75,80,60,65,90,102,472,0.8625954198473282,1.0
30,105,90,25,25,50,325,0.2773722627737226,95,85,85,65,65,35,430,0.2571428571428571,1.0
77,85,51,55,51,65,384,0.5163934426229508,90,100,90,125,85,90,580,0.7352941176470589,0.25
55,45,50,45,65,80,340,0.5546218487394958,70,94,50,94,50,66,424,0.48148148148148145,0.5
80,135,130,95,90,70,600,0.5181818181818182,38,35,35,65,55,50,278,0.2647058823529412,0.25
50,35,55,25,25,15,205,0.05263157894736842,58,50,145,95,105,30,483,0.2459016393442623,0.5
65,80,140,40,70,70,465,0.5223880597014925,85,100,122,58,75,54,494,0.3939393939393939,2.0
75,80,70,65,75,90,455,0.7578125,67,58,57,81,67,101,431,0.8790322580645161,1.0
45,100,135,65,135,45,525,0.29411764705882354,75,85,200,55,65,30,510,0.16778523489932887,1.0
78,84,78,109,85,100,534,0.8646616541353384,95,117,80,65,70,92,519,0.8409090909090909,1.0
100,134,110,95,100,61,600,0.4057971014492754,105,140,55,30,55,95,480,0.8195488721804511,2.0
70,55,75,45,65,60,370,0.45901639344262296,74,94,131,54,116,20,489,0.4485294117647059,1.0
61,90,45,50,50,160,456,0.9230769230769231,110,80,90,95,90,65,530,0.5033557046979866,1.0
40,30,50,55,55,100,330,0.584070796460177,150,100,120,100,120,90,680,0.6666666666666666,0.5
100,100,100,100,100,100,600,0.8345864661654135,30,30,42,30,42,70,244,0.4230769230769231,0.25
70,85,70,60,70,50,405,0.28378378378378377,110,78,73,76,71,60,468,0.3333333333333333,1.0
60,75,100,55,80,50,420,0.3088235294117647,70,80,65,90,65,85,455,0.578125,0.5
50,150,50,150,50,150,600,0.9339622641509434,50,50,50,50,50,50,300,0.30708661417322836,1.0
68,75,53,83,113,60,452,0.45384615384615384,70,140,230,60,80,50,630,0.32432432432432434,0.5
71,73,88,120,89,59,500,0.43537414965986393,60,40,80,60,45,40,325,0.23529411764705882,0.5
82,121,119,69,59,71,521,0.5394736842105263,50,65,45,85,65,95,405,0.7238095238095238,1.0
35,35,35,35,35,35,210,0.13385826771653545,104,91,63,91,73,68,490,0.5118110236220472,2.0
25,35,70,95,55,45,325,0.16783216783216784,50,160,110,160,110,110,700,0.8854961832061069,1.0
90,120,120,60,60,50,500,0.35294117647058826,75,140,65,112,65,110,567,0.9140625,0.0
80,92,65,65,80,68,450,0.4824561403508772,55,70,40,60,40,40,305,0.26956521739130435,1.0
78,130,111,130,85,100,634,0.8561151079136691,38,36,38,32,36,57,237,0.3893805309734513,1.0
80,135,85,70,95,150,615,0.9844961240310077,130,85,80,85,95,60,535,0.43884892086330934,2.0
50,100,150,100,150,50,600,0.37142857142857144,45,22,60,27,30,29,213,0.07518796992481203,2.0
88,107,122,74,75,64,530,0.4596774193548387,60,75,85,100,85,115,520,0.8992248062015504,1.0
72,95,67,103,71,122,530,0.9606299212598425,60,30,30,36,56,50,262,0.32432432432432434,1.0
100,103,75,120,75,127,600,0.940677966101695,85,97,66,105,66,65,484,0.47107438016528924,0.5
80,110,120,130,90,70,600,0.6198347107438017,72,85,70,65,70,58,420,0.41304347826086957,0.25
40,65,95,60,45,35,340,0.13986013986013987,76,147,90,60,70,97,540,0.8267716535433071,1.0
50,75,75,65,65,50,380,0.4049586776859504,110,123,65,100,65,65,528,0.5217391304347826,0.5
70,55,95,95,110,65,490,0.48872180451127817,106,150,70,194,120,140,780,0.952,0.5
75,125,75,30,75,85,465,0.625,95,110,95,40,95,55,490,0.40336134453781514,2.0
35,55,40,50,50,90,320,0.6838235294117647,60,55,145,75,150,40,525,0.2,1.0
80,75,150,75,150,50,580,0.30973451327433627,40,29,45,29,45,36,224,0.14634146341463414,1.0
60,52,168,47,138,30,495,0.19834710743801653,79,100,80,110,90,121,580,0.968,2.0
110,65,105,55,95,80,510,0.6258503401360545,77,120,90,60,90,48,485,0.2785714285714286,1.0
73,76,75,81,100,100,505,0.8110236220472441,40,40,55,40,70,55,300,0.40939597315436244,1.0
55,50,45,135,95,120,500,0.7714285714285715,60,69,95,69,95,36,424,0.2608695652173913,0.5
80,135,85,70,95,150,615,0.9844961240310077,55,40,50,65,85,40,335,0.3181818181818182,1.0
105,30,105,140,105,55,540,0.3524590163934426,50,65,64,44,48,43,314,0.2196969696969697,0.5
30,30,42,30,42,70,244,0.4230769230769231,65,65,60,110,95,130,525,0.9253731343283582,0.5
75,69,72,114,100,104,534,0.8253968253968254,54,66,70,44,55,46,335,0.4214876033057851,2.0
160,110,65,65,110,30,540,0.35714285714285715,79,103,120,135,115,78,630,0.5763888888888888,1.0
85,50,95,120,115,80,545,0.5793650793650794,55,68,64,45,55,31,318,0.11666666666666667,2.0
111,83,68,92,82,39,475,0.1774193548387097,75,123,67,95,85,95,540,0.7642276422764228,2.0
95,85,85,65,65,35,430,0.2571428571428571,30,65,100,45,25,40,305,0.1891891891891892,0.5
65,80,80,59,63,58,405,0.4411764705882353,105,140,95,55,65,45,505,0.3,1.0
115,115,85,90,75,100,580,0.8134328358208955,80,120,80,120,80,100,580,0.8478260869565217,2.0
38,35,35,65,55,50,278,0.2647058823529412,40,70,40,35,40,60,285,0.392,2.0
40,45,35,30,40,55,245,0.3793103448275862,65,47,55,73,75,85,400,0.65,2.0
115,140,130,55,55,40,535,0.4519230769230769,95,80,105,40,70,100,490,0.8046875,1.0
89,124,80,55,80,55,483,0.5714285714285714,75,100,95,40,70,110,490,0.8717948717948718,0.0
83,80,80,135,80,121,579,0.9444444444444444,80,160,60,170,130,80,680,0.6180555555555556,1.0
82,80,86,85,75,72,480,0.6183206106870229,40,30,35,50,70,55,280,0.28205128205128205,0.5
65,95,57,100,85,93,495,0.7441860465116279,75,95,95,95,95,85,540,0.6470588235294118,0.25
100,100,100,100,100,100,600,0.8345864661654135,89,124,80,55,80,55,483,0.5714285714285714,4.0
50,65,107,105,107,86,520,0.7758620689655172,91,72,90,129,90,108,580,0.8620689655172413,1.0
59,45,40,35,40,31,250,0.14285714285714285,110,130,80,70,60,80,530,0.5862068965517241,1.0
83,80,75,70,70,101,479,0.8615384615384616,76,48,48,57,62,34,325,0.11688311688311688,1.0
40,45,40,35,35,56,251,0.373015873015873,65,80,65,35,65,60,370,0.38405797101449274,1.0
45,49,65,49,65,45,318,0.275,80,120,79,95,79,70,523,0.5833333333333334,1.0
60,25,35,70,80,60,330,0.3076923076923077,75,90,50,110,80,95,500,0.7985611510791367,0.0
45,95,50,40,50,75,355,0.54,74,108,133,83,65,32,495,0.32142857142857145,1.0
60,69,95,69,95,36,424,0.2608695652173913,90,85,75,115,100,115,580,0.9381443298969072,0.5
103,60,86,60,86,50,445,0.3458646616541353,20,25,45,70,90,60,310,0.30833333333333335,1.0
55,65,95,95,45,85,440,0.6610169491525424,40,45,35,65,55,70,310,0.4482758620689655,0.5
35,55,35,30,30,35,220,0.23684210526315788,60,60,50,40,50,75,335,0.5882352941176471,1.0
60,100,85,80,85,100,510,0.7007874015748031,50,53,48,53,48,64,316,0.358974358974359,1.0
70,70,70,70,70,70,420,0.5289256198347108,74,100,72,90,72,46,454,0.24561403508771928,1.0
50,65,107,105,107,86,520,0.7272727272727273,77,59,50,67,63,46,362,0.23140495867768596,0.5
45,30,50,55,65,45,290,0.208,55,85,122,58,75,99,494,0.8099173553719008,1.0
40,60,40,40,40,30,250,0.0948905109489051,76,104,71,104,71,108,534,0.912751677852349,0.25
115,140,130,55,55,40,535,0.4519230769230769,55,45,45,25,25,15,210,0.048,0.5
64,115,65,83,63,65,455,0.5323741007194245,60,90,55,90,80,110,485,0.8677685950413223,1.0
106,90,130,90,154,110,680,0.8699186991869918,59,63,80,65,80,58,405,0.41843971631205673,1.0
80,125,75,40,95,85,500,0.6911764705882353,123,77,72,99,92,58,521,0.4621212121212121,4.0
60,65,70,85,75,40,395,0.21705426356589147,68,65,65,125,115,80,518,0.6461538461538462,2.0
70,80,65,90,65,85,455,0.578125,44,38,39,61,79,42,303,0.2251655629139073,1.0
75,95,60,65,60,115,470,0.8778625954198473,80,110,60,150,130,70,600,0.5042016806722689,0.0
25,35,70,95,55,45,325,0.16783216783216784,76,48,48,57,62,34,325,0.11688311688311688,1.0
55,81,60,50,70,97,413,0.7214285714285714,70,80,50,35,35,35,305,0.14,1.0
78,52,60,63,65,23,341,0.06015037593984962,38,35,35,65,55,50,278,0.2647058823529412,1.0
40,45,35,40,40,90,290,0.65,60,25,35,70,80,60,330,0.3076923076923077,1.0
100,100,100,100,100,100,600,0.8345864661654135,77,85,51,55,51,65,384,0.5163934426229508,0.5
59,63,80,65,80,58,405,0.41843971631205673,62,48,66,59,57,49,341,0.33884297520661155,1.0
38,36,38,32,36,57,237,0.3893805309734513,90,85,75,115,100,115,580,0.9381443298969072,1.0
43,80,65,50,35,35,308,0.14193548387096774,65,65,65,50,50,90,385,0.72,0.5
85,60,65,135,105,100,550,0.7518248175182481,70,55,75,45,65,60,370,0.45901639344262296,1.0
100,150,110,95,110,70,635,0.5923076923076923,44,48,65,50,64,43,314,0.1623931623931624,0.5
130,65,60,110,95,65,525,0.5227272727272727,70,60,70,87,78,85,450,0.6228070175438597,0.5
40,50,90,30,55,65,330,0.44680851063829785,62,73,55,56,52,84,382,0.7244094488188977,0.25
55,85,122,58,75,99,494,0.8099173553719008,59,110,150,45,49,35,448,0.3333333333333333,1.0
105,130,120,45,45,40,485,0.4444444444444444,48,72,48,72,48,48,336,0.25984251968503935,1.0
100,73,83,73,83,55,467,0.371900826446281,80,185,115,40,105,75,600,0.6230769230769231,1.0
44,75,35,63,33,45,295,0.2647058823529412,90,90,85,125,90,100,580,0.768595041322314,1.0
55,20,35,20,45,75,250,0.37681159420289856,90,120,75,60,60,45,450,0.29411764705882354,1.0
75,85,200,55,65,30,510,0.16778523489932887,60,40,80,60,45,40,325,0.23529411764705882,0.5
55,50,45,135,95,120,500,0.7714285714285715,40,45,40,62,60,60,307,0.33884297520661155,1.0
40,65,40,80,40,65,330,0.5038167938931297,78,104,78,159,115,100,634,0.8444444444444444,1.0
36,50,50,65,60,44,305,0.16363636363636364,90,65,65,40,40,15,315,0.19672131147540983,0.5
58,89,77,45,45,48,362,0.3177570093457944,106,90,130,90,154,110,680,0.8699186991869918,2.0
60,60,75,60,75,80,410,0.7321428571428571,45,30,50,65,50,45,285,0.13821138211382114,0.25
55,50,45,135,95,120,500,0.7714285714285715,95,145,130,120,90,120,700,0.9398496240601504,1.0
50,80,95,10,45,10,290,0.232,40,55,30,30,30,60,245,0.43548387096774194,2.0
99,68,83,72,87,51,460,0.417910447761194,84,86,88,111,101,60,530,0.4634146341463415,0.5
35,60,44,40,54,55,288,0.366412213740458,90,95,95,70,90,70,510,0.5230769230769231,1.0
60,80,95,70,85,50,440,0.2231404958677686,40,70,130,60,130,25,455,0.17355371900826447,1.0
85,110,90,45,90,80,500,0.6206896551724138,70,140,70,110,65,105,560,0.95,1.0
50,95,180,85,45,70,525,0.5298507462686567,65,40,50,125,60,30,370,0.07258064516129033,1.0
55,55,85,65,85,35,380,0.2014388489208633,75,80,95,90,100,50,490,0.2158273381294964,0.5
80,80,80,80,80,80,480,0.6015037593984962,55,40,40,65,45,35,280,0.16428571428571428,1.0
70,80,65,90,65,85,455,0.578125,45,60,40,70,50,45,310,0.2846715328467153,1.0
59,45,40,35,40,31,250,0.14285714285714285,48,72,48,72,48,48,336,0.25984251968503935,1.0
100,73,83,73,83,55,467,0.371900826446281,80,100,123,122,120,80,625,0.56,1.0
105,180,100,180,100,115,780,0.9477611940298507,58,50,145,95,105,30,483,0.2459016393442623,1.0
46,87,60,30,40,57,320,0.37777777777777777,50,70,160,70,160,90,600,0.7417218543046358,1.0
75,90,90,140,90,115,600,0.9481481481481482,61,84,65,70,70,70,420,0.5,0.5
70,120,40,95,40,95,460,0.8106060606060606,55,50,45,135,95,120,500,0.7714285714285715,2.0
68,72,78,38,42,32,330,0.23809523809523808,40,55,30,30,30,60,245,0.43548387096774194,0.0
110,123,65,100,65,65,528,0.5217391304347826,75,98,63,98,63,101,498,0.889763779527559,0.5
46,57,40,40,40,50,273,0.25,80,80,90,110,130,110,600,0.8721804511278195,1.0
50,60,45,100,80,65,400,0.45689655172413796,65,95,75,55,55,85,430,0.6933333333333334,0.5
60,95,80,60,80,30,405,0.19480519480519481,70,94,50,94,50,66,424,0.48148148148148145,0.125
55,70,40,60,40,40,305,0.26956521739130435,43,80,65,50,35,35,308,0.14193548387096774,0.5
65,75,70,95,70,95,470,0.7272727272727273,70,135,105,60,105,20,495,0.5806451612903226,0.5
40,27,60,37,50,66,280,0.36220472440944884,55,50,45,135,95,120,500,0.7714285714285715,1.0
50,160,110,160,110,110,700,0.8854961832061069,40,40,50,30,30,30,220,0.0873015873015873,1.0
35,20,65,40,65,20,245,0.02459016393442623,40,30,30,40,50,30,220,0.07936507936507936,1.0
60,60,40,65,45,35,305,0.15833333333333333,50,100,150,100,150,50,600,0.37142857142857144,1.0
55,45,43,55,43,72,313,0.5853658536585366,40,70,40,35,40,60,285,0.392,2.0
75,55,70,55,95,110,460,0.8444444444444444,40,35,30,120,70,105,400,0.6692307692307692,1.0
80,80,80,80,80,80,480,0.5606060606060606,60,75,85,100,85,115,520,0.8992248062015504,0.5
50,47,50,57,50,65,319,0.463768115942029,70,95,85,55,65,70,440,0.5,2.0
62,48,66,59,57,49,341,0.33884297520661155,40,40,50,30,30,30,220,0.0873015873015873,1.0
70,110,80,55,80,105,500,0.8794326241134752,68,72,78,38,42,32,330,0.23809523809523808,1.0
84,71,43,71,43,48,360,0.25874125874125875,80,100,70,60,70,95,475,0.7416666666666667,1.0
65,136,94,54,96,135,580,0.9612403100775194,71,120,95,120,95,99,600,0.8203125,0.5
77,59,50,67,63,46,362,0.23140495867768596,55,50,45,135,95,120,500,0.7714285714285715,1.0
77,59,50,67,63,46,362,0.23140495867768596,255,10,10,75,135,55,540,0.3125,1.0
55,55,55,85,55,30,335,0.1320754716981132,65,45,55,45,70,45,325,0.24369747899159663,1.0
70,140,230,60,80,50,630,0.32432432432432434,50,53,48,53,48,64,316,0.4076923076923077,1.0
85,97,66,105,66,65,484,0.47107438016528924,60,50,150,50,150,60,520,0.5206611570247934,2.0
40,45,35,65,55,70,310,0.4482758620689655,80,125,75,40,95,85,500,0.6911764705882353,0.5
65,76,84,54,96,105,480,0.9008264462809917,65,75,105,35,65,85,430,0.6940298507462687,1.0
60,82,45,45,45,74,351,0.5752212389380531,110,160,110,80,110,100,670,0.8591549295774648,1.0
60,115,105,65,70,80,495,0.7181818181818181,95,75,80,100,110,30,490,0.24242424242424243,0.5
65,100,70,80,80,105,500,0.8666666666666667,65,125,100,60,70,70,490,0.6099290780141844,2.0
75,80,85,110,90,50,490,0.3548387096774194,45,45,35,20,30,20,195,0.07246376811594203,0.5
44,75,35,63,33,45,295,0.2647058823529412,20,40,90,30,90,25,295,0.11363636363636363,2.0
60,115,105,65,70,80,495,0.7181818181818181,70,90,70,60,60,70,420,0.6390977443609023,1.0
61,78,95,56,58,57,405,0.40336134453781514,108,112,118,68,72,47,525,0.2916666666666667,2.0
100,123,75,57,75,80,510,0.6923076923076923,70,40,50,55,50,25,290,0.061068702290076333,1.0
55,85,55,50,55,60,360,0.4233576642335766,70,60,125,115,70,55,495,0.35507246376811596,0.25
55,68,64,45,55,31,318,0.11666666666666667,76,65,45,92,42,91,411,0.7449664429530202,0.5
45,60,45,25,45,55,275,0.29,75,95,67,125,95,83,540,0.7117117117117117,1.0
68,75,53,83,113,60,452,0.45384615384615384,80,105,65,60,75,130,515,0.9645390070921985,1.0
60,80,95,70,85,50,440,0.2231404958677686,60,50,50,60,70,50,340,0.28346456692913385,0.5
30,56,35,25,35,72,253,0.48148148148148145,80,160,80,130,80,100,630,0.8455284552845529,1.0
50,52,48,65,50,55,320,0.33098591549295775,95,135,80,110,80,100,600,0.8248175182481752,0.5
130,85,80,85,95,60,535,0.43884892086330934,89,145,90,105,80,91,600,0.8549618320610687,8.0
52,65,50,45,50,38,300,0.27419354838709675,38,36,38,32,36,57,237,0.3893805309734513,1.0
65,73,55,47,75,85,400,0.6846846846846847,60,82,45,45,45,74,351,0.5752212389380531,2.0
30,40,55,40,55,60,280,0.3237410071942446,54,45,47,75,98,52,371,0.39669421487603307,0.5
70,85,70,60,70,50,405,0.28378378378378377,38,36,38,32,36,57,237,0.3893805309734513,1.0
55,47,52,40,40,41,275,0.16806722689075632,60,60,60,85,85,85,435,0.631578947368421,0.5
45,35,50,70,50,30,280,0.15753424657534246,75,75,95,75,95,113,528,0.9015151515151515,0.5
60,45,70,75,85,55,390,0.3008130081300813,30,65,100,45,25,40,305,0.1891891891891892,1.0
50,64,50,45,50,41,300,0.22727272727272727,85,100,122,58,75,54,494,0.3939393939393939,0.5
65,90,120,85,70,60,490,0.43410852713178294,75,75,75,125,95,40,485,0.15671641791044777,1.0
100,75,115,90,115,85,580,0.6446280991735537,70,90,90,135,90,125,600,0.9401709401709402,1.0
89,124,80,55,80,55,483,0.5714285714285714,80,50,100,100,200,50,580,0.2357142857142857,1.0
43,80,65,50,35,35,308,0.14193548387096774,50,55,50,36,30,43,264,0.2922077922077922,1.0
108,112,118,68,72,47,525,0.2916666666666667,86,92,88,68,75,73,482,0.6835443037974683,1.0
83,80,80,135,80,121,579,0.9444444444444444,60,130,80,60,60,70,460,0.5153846153846153,4.0
65,105,60,60,70,95,455,63.0,40,40,50,30,30,30,220,0.0873015873015873,1.0
45,53,70,40,60,42,310,0.25735294117647056,89,124,80,55,80,55,483,0.5714285714285714,1.0
59,59,58,90,70,73,409,0.5826086956521739,70,92,65,80,55,98,460,0.8090909090909091,0.5
60,105,60,120,60,105,510,0.8849557522123894,55,40,50,65,85,40,335,0.3181818181818182,2.0
60,60,50,40,50,75,335,0.5882352941176471,150,100,120,100,120,90,680,0.6666666666666666,0.0
79,103,120,135,115,78,630,0.5763888888888888,70,90,110,60,75,95,500,0.7333333333333333,1.0
50,85,125,85,115,20,480,0.4306569343065693,89,145,90,105,80,91,600,0.8549618320610687,1.0
50,55,50,36,30,43,264,0.2922077922077922,60,59,85,79,105,36,424,0.16666666666666666,4.0
80,145,150,105,110,110,700,0.8692307692307693,55,70,45,70,50,60,350,0.45,0.5
65,76,84,54,96,105,480,0.9008264462809917,50,105,125,55,95,50,480,0.375886524822695,0.5
71,95,85,110,95,79,535,0.664,95,145,130,120,90,120,700,0.9398496240601504,4.0
50,50,40,30,30,50,250,0.2781954887218045,90,93,55,70,55,55,418,0.3819444444444444,1.0
65,65,60,110,95,130,525,0.9253731343283582,40,55,30,30,30,60,245,0.43548387096774194,2.0
54,78,103,53,45,22,355,0.23255813953488372,50,53,48,53,48,64,316,0.4076923076923077,0.5
65,65,60,110,95,130,525,0.9253731343283582,50,53,48,53,48,64,316,0.4076923076923077,0.5
70,55,95,95,110,65,490,0.48872180451127817,80,95,82,60,82,75,474,0.6,2.0
80,85,95,30,30,25,345,0.2857142857142857,126,131,95,131,98,99,680,0.8294573643410853,1.0
90,95,105,165,110,45,610,0.2890625,30,45,59,30,39,57,260,0.2803030303030303,1.0
40,55,99,40,79,47,360,0.26262626262626265,110,80,90,95,90,65,530,0.5033557046979866,1.0
59,45,40,35,40,31,250,0.14285714285714285,45,60,40,70,50,45,310,0.2846715328467153,1.0
75,75,95,75,95,113,528,0.9015151515151515,86,81,97,81,107,43,495,0.203125,1.0
30,42,118,42,88,30,350,0.112,255,10,10,75,135,55,540,0.3125,1.0
95,75,80,100,110,30,490,0.24242424242424243,58,89,77,45,45,48,362,0.3177570093457944,1.0
100,50,50,76,96,70,442,0.5,40,45,35,30,40,55,245,0.3793103448275862,1.0
75,80,70,65,75,90,455,0.7578125,30,40,70,70,25,60,295,0.41353383458646614,1.0
110,65,105,55,95,80,510,0.6258503401360545,45,45,55,45,55,63,308,0.4594594594594595,2.0
90,95,95,70,90,70,510,0.5230769230769231,100,70,70,65,65,45,415,0.1897810218978102,2.0
84,71,43,71,43,48,360,0.25874125874125875,65,75,90,97,123,44,494,0.1987179487179487,1.0
45,50,45,115,55,95,405,0.6936936936936937,85,50,95,120,115,80,545,0.5793650793650794,2.0
65,136,94,54,96,135,580,0.9612403100775194,35,46,34,35,45,20,215,0.072,2.0
40,55,99,40,79,47,360,0.26262626262626265,60,80,50,40,40,30,300,0.15328467153284672,1.0
62,55,52,109,94,109,481,0.7833333333333333,40,70,130,60,130,25,455,0.17355371900826447,0.0
80,110,60,150,130,70,600,0.5042016806722689,85,80,90,105,95,60,515,0.49074074074074076,0.0
100,110,90,85,90,60,535,0.47794117647058826,73,95,62,85,65,85,465,0.6666666666666666,1.0
70,70,70,70,70,70,420,0.5289256198347108,95,110,95,40,95,55,490,0.40336134453781514,1.0
1,90,45,30,30,40,236,0.33064516129032256,60,62,63,80,80,60,405,0.38016528925619836,1.0
50,95,180,85,45,70,525,0.5298507462686567,70,85,140,85,70,20,470,0.272,1.0
35,40,100,90,55,35,355,0.1796875,40,55,30,30,30,60,245,0.43548387096774194,2.0
70,90,90,135,90,125,600,0.9401709401709402,80,135,130,95,90,70,600,0.5181818181818182,2.0
30,40,70,70,25,60,295,0.41353383458646614,62,73,55,56,52,84,382,0.7244094488188977,2.0
80,120,80,120,80,100,580,0.8478260869565217,160,110,65,65,110,30,540,0.35714285714285715,1.0
100,100,80,60,60,50,450,0.3050847457627119,85,100,122,58,75,54,494,0.3939393939393939,1.0
65,65,45,75,45,95,390,0.72,60,40,50,75,85,95,405,0.6044776119402985,0.5
73,100,60,100,60,65,458,0.42657342657342656,75,89,85,55,65,36,405,0.29545454545454547,2.0
66,65,48,62,57,52,350,0.36220472440944884,150,120,100,120,100,90,680,0.664179104477612,0.5
60,80,50,50,50,40,330,0.23853211009174313,70,80,102,80,102,40,474,0.2677165354330709,1.0
100,164,150,95,120,71,700,0.5645161290322581,55,35,50,55,110,85,390,0.6277372262773723,4.0
90,55,75,60,75,30,385,0.13970588235294118,44,48,65,50,64,43,314,0.1623931623931624,1.0
170,90,45,90,45,60,500,0.427536231884058,76,65,45,92,42,91,411,0.7449664429530202,1.0
60,60,60,85,85,85,435,0.631578947368421,65,125,100,55,70,85,500,0.6532258064516129,1.0
80,80,90,110,130,110,600,0.8721804511278195,115,115,85,90,75,100,580,0.8134328358208955,1.0
79,85,60,55,60,71,410,0.60431654676259,50,65,107,105,107,86,520,0.7272727272727273,1.0
100,150,110,95,110,70,635,0.5923076923076923,80,70,70,90,100,70,480,0.5609756097560976,0.125
116,55,85,107,95,29,487,0.06818181818181818,50,60,45,100,80,65,400,0.45689655172413796,2.0
130,65,60,110,95,65,525,0.5227272727272727,54,45,47,75,98,52,371,0.39669421487603307,1.0
67,58,57,81,67,101,431,0.8790322580645161,36,50,50,65,60,44,305,0.16363636363636364,1.0
75,125,75,30,75,85,465,0.625,75,55,70,55,95,110,460,0.8444444444444444,0.5
54,78,103,53,45,22,355,0.23255813953488372,62,44,50,44,50,55,305,0.3629032258064516,1.0
45,95,50,40,50,75,355,0.54,65,125,100,60,70,70,490,0.6099290780141844,0.5
165,75,80,40,45,65,470,0.5151515151515151,45,45,55,45,55,63,308,0.4594594594594595,0.5
100,5,5,15,65,30,220,0.07692307692307693,85,110,90,45,90,80,500,0.6206896551724138,1.0
91,90,129,90,72,108,580,0.9140625,38,30,41,30,41,60,240,0.2897196261682243,2.0
99,68,83,72,87,51,460,0.417910447761194,75,75,60,83,60,60,413,0.39344262295081966,2.0
60,50,150,50,150,60,520,0.5206611570247934,80,52,50,90,50,89,411,0.6666666666666666,1.0
25,20,15,105,55,90,310,0.32407407407407407,64,115,65,83,63,65,455,0.5323741007194245,1.0
70,110,75,145,85,145,630,0.9444444444444444,90,50,34,60,44,70,348,0.6283185840707964,0.5
70,110,180,60,60,50,530,0.4117647058823529,65,136,94,54,96,135,580,0.9612403100775194,0.5
59,63,80,65,80,58,405,0.41843971631205673,55,66,44,44,56,85,350,0.6888888888888889,1.0
70,130,100,55,80,65,500,0.608,50,75,75,65,65,50,380,0.4049586776859504,1.0
65,80,140,40,70,70,465,0.5223880597014925,54,63,52,83,56,97,405,0.7697841726618705,0.5
49,49,56,49,61,66,330,0.5190839694656488,115,140,130,55,55,40,535,0.4519230769230769,4.0
105,140,95,55,65,45,505,0.3,75,85,200,55,65,30,510,0.16778523489932887,2.0
110,80,90,95,90,65,530,0.5033557046979866,108,130,95,80,85,102,600,0.7637795275590551,4.0
44,50,91,24,86,10,305,0.1981981981981982,75,123,67,95,85,95,540,0.7642276422764228,0.5
70,95,125,65,75,45,475,0.33613445378151263,70,62,67,55,55,56,365,0.38513513513513514,0.5
85,56,77,50,77,78,423,0.53125,100,180,160,150,90,90,770,0.7520661157024794,2.0
100,150,110,95,110,70,635,0.5923076923076923,40,45,40,62,60,60,307,0.33884297520661155,4.0
70,80,50,35,35,35,305,0.14,90,75,75,90,100,70,500,0.5462184873949579,1.0
70,85,140,85,70,20,470,0.272,70,77,60,97,60,108,472,0.8394160583941606,2.0
120,100,85,30,85,45,465,0.22448979591836735,103,93,67,71,61,84,479,0.7142857142857143,1.0
67,125,40,30,30,58,350,0.3431372549019608,75,98,63,98,63,101,498,0.889763779527559,2.0
50,50,40,50,40,64,294,0.45588235294117646,80,45,65,90,110,80,470,0.5462962962962963,1.0
59,63,80,65,80,58,405,0.41843971631205673,30,45,55,70,55,85,340,0.5633802816901409,0.5
44,58,44,58,44,61,309,0.41964285714285715,91,129,90,72,90,108,580,0.8536585365853658,0.5
50,20,40,20,40,20,190,0.0962962962962963,100,180,160,150,90,90,770,0.7520661157024794,0.5
105,140,55,30,55,95,480,0.8195488721804511,73,95,62,85,65,85,465,0.6666666666666666,1.0
60,69,95,69,95,36,424,0.2608695652173913,40,35,30,20,20,50,195,0.23423423423423423,0.5
80,100,80,80,80,100,520,0.9051724137931034,65,60,110,130,95,65,525,0.47761194029850745,1.0
65,40,70,80,140,70,465,0.5954198473282443,55,50,65,175,95,150,590,0.7818181818181819,1.0
60,85,40,30,45,68,328,0.6422018348623854,50,100,150,100,150,50,600,0.37142857142857144,2.0
66,65,48,62,57,52,350,0.36220472440944884,45,100,45,45,45,10,290,0.2949640287769784,2.0
68,165,95,65,115,110,618,0.8615384615384616,95,75,80,100,110,30,490,0.24242424242424243,0.25
60,52,168,47,138,30,495,0.19834710743801653,60,90,55,90,80,110,485,0.8677685950413223,0.5
60,40,60,40,60,35,295,0.18055555555555555,60,40,60,95,60,55,370,0.4222222222222222,0.5
95,80,105,40,70,100,490,0.8046875,150,120,100,120,100,90,680,0.664179104477612,0.0
108,100,121,81,95,95,600,0.7476635514018691,85,135,130,60,80,25,515,0.40540540540540543,2.0
68,85,65,165,135,100,618,0.8083333333333333,62,55,52,109,94,109,481,0.7833333333333333,1.0
110,65,75,125,85,30,490,0.15,55,55,45,63,45,45,308,0.25,1.0
103,60,86,60,86,50,445,0.3458646616541353,86,81,97,81,107,43,495,0.203125,0.5
70,110,75,145,85,145,630,0.9444444444444444,64,165,75,93,83,75,555,0.6587301587301587,1.0
50,50,62,40,62,65,329,0.4188034188034188,75,98,63,98,63,101,498,0.849624060150376,1.0
62,50,58,73,54,72,369,0.4435483870967742,55,40,85,80,105,40,405,0.23622047244094488,1.0
150,160,100,95,65,100,670,0.8866666666666667,100,100,125,110,50,50,535,0.384,1.0
110,65,105,55,95,80,510,0.6258503401360545,75,140,65,112,65,110,567,0.9140625,0.5
81,102,77,85,75,85,505,0.5642857142857143,60,80,50,40,40,30,300,0.15328467153284672,2.0
65,65,60,110,95,130,525,0.9253731343283582,38,36,38,32,36,57,237,0.3893805309734513,1.0
60,30,30,36,56,50,262,0.32432432432432434,55,40,50,65,85,40,335,0.3181818181818182,0.0
88,107,122,74,75,64,530,0.4596774193548387,39,52,43,60,50,65,309,0.49107142857142855,0.5
50,65,64,44,48,43,314,0.2196969696969697,75,80,60,65,90,102,472,0.8625954198473282,1.0
90,93,55,70,55,55,418,0.3819444444444444,41,64,45,50,50,50,300,0.36752136752136755,0.5
255,10,10,75,135,55,540,0.3125,73,76,75,81,100,100,505,0.8110236220472441,1.0
20,25,45,70,90,60,310,0.30833333333333335,28,25,25,45,35,40,198,0.16083916083916083,0.5
90,85,75,115,100,115,580,0.9381443298969072,50,105,125,55,95,50,480,0.375886524822695,1.0
70,65,60,90,75,90,450,0.6571428571428571,75,70,90,70,105,80,490,0.656,0.5
50,70,50,50,50,40,310,0.16296296296296298,80,82,100,83,100,80,525,0.6821705426356589,0.5
55,95,115,45,45,35,390,0.2116788321167883,30,65,100,45,25,40,305,0.1891891891891892,1.0
50,53,62,58,63,44,330,0.13709677419354838,65,80,80,59,63,58,405,0.4411764705882353,0.5
74,100,72,90,72,46,454,0.24561403508771928,91,72,90,129,90,108,580,0.8620689655172413,2.0
39,52,43,60,50,65,309,0.5041322314049587,100,123,75,57,75,80,510,0.6923076923076923,1.0
75,55,70,55,95,110,460,0.8444444444444444,58,50,145,95,105,30,483,0.2459016393442623,1.0
110,80,90,95,90,65,530,0.5033557046979866,41,64,45,50,50,50,300,0.36752136752136755,1.0
44,38,33,61,43,70,289,0.5267857142857143,110,65,75,125,85,30,490,0.15,1.0
91,90,72,90,129,108,580,0.896,45,85,50,55,50,65,350,0.5076923076923077,1.0
85,100,122,58,75,54,494,0.3939393939393939,95,70,73,95,90,60,483,0.3983739837398374,1.0
70,84,70,65,70,51,410,0.2949640287769784,85,73,70,73,115,67,483,0.5126050420168067,1.0
62,48,54,63,60,68,355,0.5178571428571429,75,38,38,56,56,67,330,0.5263157894736842,1.0
55,40,40,65,45,35,280,0.16428571428571428,65,125,100,60,70,70,490,0.6099290780141844,1.0
68,90,65,50,55,82,410,0.6165413533834586,80,90,80,130,110,110,600,0.856,2.0
44,50,91,24,86,10,305,0.1981981981981982,89,145,90,105,80,91,600,0.8549618320610687,1.0
95,95,85,125,65,55,520,0.3894736842105263,50,75,70,35,70,48,348,0.29357798165137616,0.0
67,89,116,79,116,33,500,0.2624113475177305,75,125,100,70,80,45,495,0.33035714285714285,2.0
30,40,55,40,55,60,280,0.3237410071942446,65,65,60,130,95,110,525,0.823943661971831,0.25
50,53,62,58,63,44,330,0.13709677419354838,38,41,40,50,65,65,299,0.4108527131782946,2.0
70,80,65,90,65,85,455,0.578125,126,131,95,131,98,99,680,0.8102189781021898,0.0
75,105,75,105,75,45,480,0.3274336283185841,95,70,73,95,90,60,483,0.3983739837398374,1.0
72,105,115,54,86,68,500,0.5149253731343284,45,22,60,27,30,29,213,0.07518796992481203,2.0
43,30,55,40,65,97,330,0.6030534351145038,64,88,50,88,50,106,446,0.9111111111111111,1.0
100,100,125,110,50,50,535,0.384,35,65,35,65,35,65,300,0.46621621621621623,2.0
70,55,65,95,85,70,440,0.5307692307692308,53,54,53,37,46,45,288,0.3090909090909091,0.0
78,104,78,159,115,100,634,0.8444444444444444,50,65,107,105,107,86,520,0.7313432835820896,2.0
70,55,75,45,65,60,370,0.45901639344262296,70,105,105,50,40,20,390,0.33587786259541985,0.5
50,85,55,65,65,90,410,0.7478260869565218,68,85,65,165,135,100,618,0.8083333333333333,1.0
40,60,30,31,31,70,262,0.4492753623188406,85,115,80,105,80,50,515,0.3063063063063063,0.5
70,75,80,135,80,135,575,0.917910447761194,84,71,43,71,43,48,360,0.25874125874125875,1.0
80,82,78,95,80,85,500,0.6869565217391305,60,45,70,45,90,95,405,0.7304964539007093,1.0
50,65,107,105,107,86,520,0.7758620689655172,59,59,58,90,70,73,409,0.5826086956521739,2.0
55,40,85,80,105,40,405,0.23622047244094488,105,140,55,30,55,95,480,0.8195488721804511,0.5
64,88,50,88,50,106,446,0.9111111111111111,72,60,30,20,30,25,237,0.11570247933884298,0.5
75,125,100,70,80,45,495,0.33035714285714285,54,45,47,75,98,52,371,0.39669421487603307,0.5
104,91,63,91,73,68,490,0.5118110236220472,68,75,53,83,113,60,452,0.45384615384615384,1.0
70,90,45,15,45,50,315,0.3629032258064516,70,85,70,60,70,50,405,0.28378378378378377,0.5
80,120,80,120,80,100,580,0.8478260869565217,55,55,50,45,65,55,325,0.37373737373737376,1.0
95,125,79,60,100,81,540,0.6165413533834586,30,80,90,55,45,55,355,0.4295774647887324,0.5
50,95,95,35,110,70,455,0.5179856115107914,50,85,55,65,65,90,410,0.7478260869565218,1.0
100,123,75,57,75,80,510,0.6923076923076923,85,105,55,85,50,115,495,0.9032258064516129,1.0
55,50,40,40,40,75,300,0.5945945945945946,68,75,53,83,113,60,452,0.45384615384615384,1.0
100,164,150,95,120,71,700,0.5645161290322581,75,90,140,60,60,40,465,0.3008130081300813,1.0
30,42,118,42,88,30,350,0.112,78,70,61,50,61,100,420,0.8145161290322581,1.0
58,70,45,40,45,42,300,0.25925925925925924,100,150,120,120,100,90,680,0.6493506493506493,4.0
30,35,30,100,35,80,310,0.4765625,95,23,48,23,48,23,260,0.046153846153846156,2.0
90,50,34,60,44,70,348,0.6283185840707964,90,95,95,70,90,70,510,0.5230769230769231,2.0
80,100,200,50,100,50,580,0.3472222222222222,85,50,95,120,115,80,545,0.5793650793650794,2.0
95,95,85,125,65,55,520,0.3894736842105263,60,45,70,45,90,95,405,0.7304964539007093,1.0
95,23,48,23,48,23,260,0.046153846153846156,55,55,55,85,55,30,335,0.1320754716981132,0.5
50,20,55,25,25,30,205,0.09774436090225563,50,105,125,55,95,50,480,0.375886524822695,0.25
65,95,100,60,50,50,420,0.34959349593495936,85,60,65,135,105,100,550,0.7518248175182481,1.0
83,80,80,135,80,121,579,0.9444444444444444,79,115,70,125,80,111,580,0.864,0.5
90,100,60,90,60,80,480,0.6422764227642277,100,75,115,90,115,85,580,0.6446280991735537,2.0
65,80,140,40,70,70,465,0.5223880597014925,65,95,100,60,50,50,420,0.34959349593495936,1.0
76,104,71,104,71,108,534,0.912751677852349,80,82,100,83,100,80,525,0.6821705426356589,2.0
52,65,55,58,62,60,352,0.4482758620689655,75,80,85,110,90,50,490,0.3548387096774194,2.0
50,70,100,40,40,30,330,0.2222222222222222,46,57,40,40,40,50,273,0.25,1.0
110,80,90,95,90,65,530,0.5033557046979866,75,75,95,75,95,113,528,0.9015151515151515,1.0
78,104,78,159,115,100,634,0.8444444444444444,116,55,85,107,95,29,487,0.06818181818181818,1.0
78,65,68,112,154,75,552,0.628099173553719,150,100,120,100,120,90,680,0.6666666666666666,2.0
55,70,55,40,55,85,360,0.7073170731707317,60,40,50,75,85,95,405,0.6044776119402985,1.0
40,40,55,40,70,55,300,0.40939597315436244,80,110,120,130,90,70,600,0.6198347107438017,2.0
65,75,90,97,123,44,494,0.1987179487179487,59,66,70,44,55,41,335,0.25190839694656486,1.0
44,58,44,58,44,61,309,0.41964285714285715,50,95,90,95,90,180,600,0.9172413793103448,1.0
115,45,20,45,25,20,270,0.11538461538461539,55,85,122,58,75,99,494,0.8099173553719008,0.0
62,73,55,56,52,84,382,0.7244094488188977,40,70,40,35,40,60,285,0.392,2.0
50,100,150,100,150,50,600,0.37142857142857144,95,75,110,100,80,30,490,0.15267175572519084,1.0
65,90,50,85,45,55,390,0.371900826446281,67,58,57,81,67,101,431,0.8790322580645161,2.0
40,30,35,50,70,55,280,0.28205128205128205,64,165,75,93,83,75,555,0.6587301587301587,0.5
45,30,40,105,50,20,290,0.031007751937984496,110,65,75,125,85,30,490,0.15,0.5
60,40,60,95,60,55,370,0.4222222222222222,40,30,32,50,52,65,269,0.3671875,1.0
90,85,100,95,125,85,580,0.6834532374100719,90,85,75,115,100,115,580,0.9381443298969072,0.5
55,70,45,70,50,60,350,0.45,60,85,60,85,60,55,405,0.3673469387755102,0.5
65,76,84,54,96,105,480,0.9008264462809917,100,100,90,150,140,90,670,0.71875,1.0
74,48,76,83,81,104,466,0.7913043478260869,62,48,66,59,57,49,341,0.33884297520661155,1.0
40,55,80,35,60,30,300,0.15037593984962405,73,115,60,60,60,90,458,0.6694915254237288,1.0
60,65,60,130,75,110,500,0.7719298245614035,71,120,95,120,95,99,600,0.8203125,0.0
65,90,115,45,115,58,488,0.5041322314049587,63,120,85,90,55,55,468,0.2809917355371901,1.0
85,70,80,97,80,123,535,0.9304347826086956,80,105,65,60,75,130,515,0.9645390070921985,0.5
120,100,85,30,85,45,465,0.22448979591836735,90,65,65,40,40,15,315,0.19672131147540983,0.5
110,65,75,125,85,30,490,0.15,75,140,65,112,65,110,567,0.9140625,1.0
70,90,70,60,60,70,420,0.6390977443609023,62,44,50,44,50,55,305,0.3629032258064516,1.0
60,115,105,65,70,80,495,0.7181818181818181,70,55,55,80,60,45,365,0.2222222222222222,1.0
45,20,50,60,120,50,345,0.24074074074074073,68,85,65,165,135,100,618,0.8083333333333333,1.0
70,115,60,115,60,55,475,0.4647887323943662,110,85,95,80,95,50,515,0.2713178294573643,1.0
70,55,95,95,110,65,490,0.48872180451127817,60,75,85,100,85,115,520,0.8992248062015504,0.5
45,35,45,62,53,35,275,0.11851851851851852,68,75,53,83,113,60,452,0.45384615384615384,0.5
70,90,70,60,60,70,420,0.6390977443609023,91,90,106,130,106,77,600,0.648854961832061,1.0
65,80,65,35,65,60,370,0.38405797101449274,57,80,91,80,87,75,470,0.5737704918032787,0.5
86,76,86,116,56,95,515,0.7982456140350878,50,95,180,85,45,70,525,0.5298507462686567,1.0
70,62,67,55,55,56,365,0.38513513513513514,55,84,105,114,75,52,485,0.2890625,1.0
70,80,70,80,70,110,480,0.6594202898550725,60,100,115,70,85,90,520,0.7557251908396947,0.5
95,23,48,23,48,23,260,0.046153846153846156,75,110,110,110,105,80,590,0.656934306569343,1.0
40,35,30,20,20,50,195,0.23423423423423423,54,78,103,53,45,22,355,0.23255813953488372,0.5
60,70,65,125,105,90,515,0.6911764705882353,65,40,50,125,60,30,370,0.07258064516129033,1.0
70,110,80,55,80,105,500,0.8794326241134752,60,69,95,69,95,36,424,0.2608695652173913,0.5
76,48,48,57,62,34,325,0.11688311688311688,75,90,90,140,90,115,600,0.9481481481481482,2.0
55,84,105,114,75,52,485,0.2890625,43,80,65,50,35,35,308,0.14193548387096774,0.5
50,92,108,92,108,35,485,0.2457627118644068,45,53,70,40,60,42,310,0.25735294117647056,1.0
75,98,63,98,63,101,498,0.889763779527559,85,135,130,60,80,25,515,0.40540540540540543,0.5
62,50,58,73,54,72,369,0.4435483870967742,30,35,30,100,35,80,310,0.4765625,0.0
50,65,85,35,35,55,325,0.32575757575757575,65,80,80,59,63,58,405,0.4411764705882353,1.0
105,140,55,30,55,95,480,0.8195488721804511,60,85,69,60,69,77,420,0.518796992481203,1.0
70,85,65,105,85,120,530,0.9262295081967213,110,80,90,95,90,65,530,0.5033557046979866,2.0
91,134,95,100,100,80,600,0.6304347826086957,65,65,45,75,45,95,390,0.72,2.0
46,87,60,30,40,57,320,0.37777777777777777,40,65,40,80,40,65,330,0.5038167938931297,1.0
95,145,130,120,90,120,700,0.9398496240601504,75,98,63,98,63,101,498,0.889763779527559,1.0
95,117,80,65,70,92,519,0.8409090909090909,170,90,45,90,45,60,500,0.427536231884058,1.0
60,85,42,85,42,91,405,0.8227848101265823,45,75,37,70,55,83,365,0.6183206106870229,1.0
52,65,55,58,62,60,352,0.4482758620689655,75,75,60,83,60,60,413,0.39344262295081966,1.0
45,80,100,35,37,28,325,0.3125,125,170,100,120,90,95,700,0.77,2.0
85,110,76,65,82,56,474,0.3933333333333333,65,47,55,73,75,85,400,0.65,0.5
50,53,48,53,48,64,316,0.46153846153846156,85,110,90,45,90,80,500,0.6206896551724138,1.0
65,90,50,85,45,55,390,0.371900826446281,60,80,50,50,50,40,330,0.23853211009174313,1.0
110,123,65,100,65,65,528,0.5217391304347826,75,89,85,55,65,36,405,0.29545454545454547,2.0
55,112,45,74,45,70,401,0.559322033898305,45,60,45,25,45,55,275,0.29,1.0
105,105,75,65,100,50,500,0.37593984962406013,70,90,45,15,45,50,315,0.3629032258064516,1.0
65,83,57,95,85,105,490,0.8914728682170543,50,47,50,57,50,65,319,0.463768115942029,0.5
85,135,130,60,80,25,515,0.40540540540540543,53,54,53,37,46,45,288,0.3090909090909091,1.0
110,123,65,100,65,65,528,0.5217391304347826,110,130,80,70,60,80,530,0.5862068965517241,4.0
100,100,100,100,100,100,600,0.8758169934640523,52,65,50,45,50,38,300,0.27419354838709675,0.0
100,150,120,120,100,90,680,0.6493506493506493,130,85,80,85,95,60,535,0.43884892086330934,2.0
109,66,84,81,99,32,471,0.2013888888888889,60,85,40,30,45,68,328,0.6422018348623854,0.0
90,60,70,75,70,45,410,0.23880597014925373,80,110,60,150,130,70,600,0.5042016806722689,1.0
45,55,39,35,39,42,255,0.18518518518518517,70,140,70,110,65,105,560,0.95,1.0
60,75,85,100,85,115,520,0.8992248062015504,54,78,103,53,45,22,355,0.23255813953488372,1.0
45,85,50,55,50,65,350,0.5076923076923077,95,23,48,23,48,23,260,0.046153846153846156,0.5
81,102,77,85,75,85,505,0.5642857142857143,70,60,70,87,78,85,450,0.6228070175438597,1.0
35,55,40,50,50,90,320,0.6838235294117647,40,80,35,35,45,70,305,0.4661016949152542,1.0
105,125,100,60,100,100,590,0.8359375,75,123,67,95,85,95,540,0.7642276422764228,1.0
95,23,48,23,48,23,260,0.046153846153846156,70,95,85,55,65,70,440,0.5,0.5
41,56,40,62,44,71,314,0.568,78,81,71,74,69,126,499,0.9090909090909091,2.0
65,95,75,55,55,85,430,0.6933333333333334,79,100,80,110,90,121,580,0.968,1.0
70,60,75,110,75,90,480,0.7165354330708661,20,15,20,10,55,80,200,0.2682926829268293,2.0
30,45,59,30,39,57,260,0.2803030303030303,55,63,90,50,80,42,380,0.21138211382113822,4.0
60,62,80,63,80,60,405,0.4336283185840708,37,25,41,25,41,25,194,0.08870967741935484,0.5
60,62,63,80,80,60,405,0.38016528925619836,105,105,75,65,100,50,500,0.37593984962406013,0.25
60,85,49,60,49,60,363,0.4444444444444444,75,100,110,45,55,65,450,0.5333333333333333,0.0
70,85,70,60,70,50,405,0.28378378378378377,80,160,80,130,80,100,630,0.8455284552845529,4.0
35,60,44,40,54,55,288,0.366412213740458,70,77,60,97,60,108,472,0.8394160583941606,1.0
80,135,85,70,95,150,615,0.9844961240310077,80,82,78,95,80,85,500,0.6869565217391305,1.0
55,130,115,50,50,75,475,0.5982142857142857,45,55,39,35,39,42,255,0.18518518518518517,1.0
85,105,85,40,50,40,405,0.211864406779661,51,65,65,80,75,59,395,0.4365079365079365,2.0
60,59,85,79,105,36,424,0.16666666666666666,60,85,60,85,60,55,405,0.3673469387755102,0.125
114,85,70,85,80,30,464,0.2066115702479339,62,73,55,56,52,84,382,0.7244094488188977,0.25
45,20,50,60,120,50,345,0.24074074074074073,60,40,80,60,45,40,325,0.23529411764705882,1.0
82,121,119,69,59,71,521,0.5394736842105263,85,60,65,135,105,100,550,0.7518248175182481,4.0
40,80,100,30,30,20,300,0.11851851851851852,50,70,50,50,50,40,310,0.16296296296296298,1.0
65,90,115,45,115,58,488,0.5041322314049587,80,70,70,90,100,70,480,0.5609756097560976,1.0
35,85,45,35,35,75,310,0.6492537313432836,30,45,135,45,90,30,375,0.09285714285714286,0.25
70,90,110,60,75,95,500,0.7333333333333333,91,90,129,90,72,108,580,0.9140625,0.0
80,82,100,83,100,80,525,0.6821705426356589,70,120,65,45,85,125,510,0.9747899159663865,1.0
65,100,70,80,80,105,500,0.8666666666666667,55,63,90,50,80,42,380,0.21138211382113822,4.0
135,85,40,40,85,5,390,0.6864406779661016,85,115,80,105,80,50,515,0.3063063063063063,1.0
40,30,32,50,52,65,269,0.3671875,60,100,89,55,69,112,485,0.9298245614035088,0.5
95,124,78,69,71,58,495,0.37398373983739835,95,80,105,40,70,100,490,0.8046875,2.0
66,117,70,40,50,67,410,0.4573643410852713,130,85,80,85,95,60,535,0.43884892086330934,1.0
41,50,37,50,37,66,281,0.5175438596491229,65,110,130,60,65,95,525,0.8278145695364238,1.0
62,48,66,59,57,49,341,0.33884297520661155,50,92,108,92,108,35,485,0.2457627118644068,2.0
44,38,39,61,79,42,303,0.2251655629139073,86,92,88,68,75,73,482,0.6835443037974683,2.0
70,77,60,97,60,108,472,0.8394160583941606,60,30,30,36,56,50,262,0.32432432432432434,1.0
44,75,35,63,33,45,295,0.2647058823529412,58,109,112,48,48,109,484,0.8805970149253731,1.0
30,45,59,30,39,57,260,0.2803030303030303,40,45,40,65,40,65,295,0.5661764705882353,1.0
50,65,107,105,107,86,520,0.7272727272727273,105,105,75,65,100,50,500,0.37593984962406013,1.0
100,100,100,100,100,100,600,0.8345864661654135,126,131,95,131,98,99,680,0.8294573643410853,1.0
86,92,88,68,75,73,482,0.6835443037974683,55,47,52,40,40,41,275,0.16806722689075632,2.0
80,130,100,160,120,110,700,0.8981481481481481,60,85,60,50,50,125,430,0.9090909090909091,1.0
65,76,84,54,96,105,480,0.9008264462809917,60,100,85,80,85,100,510,0.7007874015748031,1.0
80,82,78,95,80,85,500,0.6869565217391305,85,110,90,45,90,80,500,0.6206896551724138,1.0
60,150,50,150,50,60,520,0.5,75,70,90,70,105,80,490,0.656,1.0
72,60,30,20,30,25,237,0.11570247933884298,90,120,120,60,60,50,500,0.35294117647058826,1.0
61,78,95,56,58,57,405,0.40336134453781514,60,90,140,50,50,40,430,0.2535211267605634,1.0
40,35,30,120,70,105,400,0.6692307692307692,62,50,58,73,54,72,369,0.4435483870967742,1.0
64,165,75,93,83,75,555,0.6587301587301587,116,55,85,107,95,29,487,0.06818181818181818,2.0
108,130,95,80,85,102,600,0.7637795275590551,50,65,45,85,65,95,405,0.7238095238095238,0.5
59,63,80,65,80,58,405,0.41843971631205673,45,85,70,40,40,60,340,0.5229357798165137,1.0
40,55,80,35,60,30,300,0.15037593984962405,50,20,40,20,40,20,190,0.0962962962962963,0.5
85,73,70,73,115,67,483,0.5126050420168067,60,60,60,60,60,60,360,0.38095238095238093,1.0
65,125,100,55,70,85,500,0.6532258064516129,60,60,40,65,45,35,305,0.15833333333333333,0.5
80,120,79,95,79,70,523,0.5833333333333334,40,65,40,80,40,65,330,0.5038167938931297,1.0
120,100,85,30,85,45,465,0.22448979591836735,55,40,50,65,85,40,335,0.3181818181818182,0.0
95,100,85,108,70,70,528,0.5652173913043478,65,75,90,97,123,44,494,0.1987179487179487,0.5
55,104,105,94,75,52,485,0.36363636363636365,45,30,50,55,65,45,290,0.208,1.0
100,120,120,150,100,90,680,0.7880794701986755,75,65,55,65,55,69,384,0.43548387096774194,0.5
70,60,75,110,75,90,480,0.7165354330708661,90,30,15,40,20,15,210,0.043478260869565216,1.0
60,59,85,79,105,36,424,0.16666666666666666,85,100,122,58,75,54,494,0.3939393939393939,0.5
70,145,88,140,70,112,625,0.8888888888888888,76,65,45,92,42,91,411,0.7449664429530202,1.0
70,110,70,115,70,90,525,0.75,75,100,110,45,55,65,450,0.5333333333333333,1.0
59,59,58,90,70,73,409,0.5826086956521739,80,185,115,40,105,75,600,0.6230769230769231,2.0
55,50,45,135,95,120,500,0.7714285714285715,61,72,57,55,55,65,365,0.3984375,2.0
84,86,88,111,101,60,530,0.4634146341463415,28,25,25,45,35,40,198,0.16083916083916083,0.5
70,65,60,90,75,90,450,0.6571428571428571,60,40,80,60,45,40,325,0.23529411764705882,8.0
50,50,120,80,80,30,410,0.07258064516129033,68,72,78,38,42,32,330,0.23809523809523808,0.5
35,85,45,35,35,75,310,0.6492537313432836,70,90,110,60,75,95,500,0.7333333333333333,1.0
65,150,60,115,60,115,565,0.935251798561151,105,180,100,180,100,115,780,0.9477611940298507,1.0
45,75,37,70,55,83,365,0.6183206106870229,55,70,55,40,55,85,360,0.7073170731707317,1.0
48,72,48,72,48,48,336,0.25984251968503935,89,125,90,115,80,101,600,0.8725490196078431,2.0
65,60,110,130,95,65,525,0.47761194029850745,70,95,125,65,75,45,475,0.33613445378151263,1.0
38,30,85,55,65,30,303,0.21428571428571427,82,80,86,85,75,72,480,0.6183206106870229,1.0
25,35,70,95,55,45,325,0.16783216783216784,45,55,39,35,39,42,255,0.18518518518518517,1.0
55,66,44,44,56,85,350,0.6888888888888889,90,132,105,132,105,30,594,0.4246575342465753,1.0
79,103,120,135,115,78,630,0.5763888888888888,65,95,75,55,55,85,430,0.6933333333333334,0.5
46,57,40,40,40,50,273,0.25,65,40,70,80,140,70,465,0.5954198473282443,1.0
116,55,85,107,95,29,487,0.06818181818181818,103,60,86,60,86,50,445,0.3458646616541353,1.0
75,100,66,60,66,115,482,0.918918918918919,50,65,90,35,35,15,290,0.14678899082568808,1.0
70,80,50,35,35,35,305,0.14,85,105,100,79,83,78,530,0.5869565217391305,1.0
95,117,80,65,70,92,519,0.8409090909090909,50,65,64,44,48,43,314,0.2196969696969697,1.0
95,125,79,60,100,81,540,0.6165413533834586,76,147,90,60,70,97,540,0.8267716535433071,0.5
64,51,23,51,23,28,240,0.11363636363636363,50,150,50,150,50,150,600,0.9339622641509434,1.0
68,75,53,83,113,60,452,0.45384615384615384,45,100,45,45,45,10,290,0.2949640287769784,1.0
65,65,60,130,95,110,525,0.823943661971831,45,20,50,60,120,50,345,0.24074074074074073,1.0
65,150,60,115,60,115,565,0.935251798561151,35,45,160,30,45,70,385,0.48148148148148145,1.0
65,155,120,65,90,105,600,0.8677685950413223,120,100,85,30,85,45,465,0.22448979591836735,1.0
62,55,52,109,94,109,481,0.7833333333333333,50,20,55,25,25,30,205,0.09774436090225563,1.0
80,135,85,70,95,150,615,0.9844961240310077,20,10,230,10,230,5,505,0.0,2.0
75,75,95,75,95,113,528,0.9015151515151515,79,85,60,55,60,71,410,0.60431654676259,2.0
85,80,70,135,75,90,535,0.7006802721088435,95,75,110,100,80,30,490,0.15267175572519084,1.0
40,70,130,60,130,25,455,0.17355371900826447,50,35,55,25,25,15,205,0.021739130434782608,1.0
55,55,55,85,55,30,335,0.1320754716981132,100,100,100,100,100,100,600,0.8805970149253731,1.0
95,75,180,130,80,30,590,0.13793103448275862,60,105,60,120,60,105,510,0.8849557522123894,0.0
90,65,65,40,40,15,315,0.19672131147540983,28,25,25,45,35,40,198,0.16083916083916083,0.5
70,110,70,115,70,90,525,0.75,40,45,65,100,120,90,460,0.5588235294117647,0.125
50,47,50,57,50,65,319,0.463768115942029,100,90,130,45,65,55,485,0.4253731343283582,2.0
50,35,55,25,25,15,205,0.05263157894736842,40,45,40,62,60,60,307,0.33884297520661155,0.5
60,52,168,47,138,30,495,0.19834710743801653,120,100,85,30,85,45,465,0.22448979591836735,0.5
55,20,35,20,45,75,250,0.37681159420289856,91,129,90,72,90,108,580,0.8536585365853658,0.5
45,30,50,65,50,45,285,0.13821138211382114,65,90,115,45,115,58,488,0.5041322314049587,0.0
50,20,55,25,25,30,205,0.09774436090225563,43,80,65,50,35,35,308,0.14193548387096774,1.0
20,10,230,10,230,5,505,0.0,100,150,110,95,110,70,635,0.5923076923076923,0.5
40,40,40,70,40,20,250,0.032520325203252036,80,52,50,90,50,89,411,0.6666666666666666,2.0
70,100,115,30,65,30,410,0.24390243902439024,80,80,80,80,80,80,480,0.5606060606060606,1.0
78,130,111,130,85,100,634,0.8561151079136691,50,75,70,35,70,48,348,0.29357798165137616,1.0
40,45,35,40,40,90,290,0.65,62,44,50,44,50,55,305,0.3629032258064516,1.0
41,50,37,50,37,66,281,0.5175438596491229,50,120,53,35,110,87,455,0.640625,0.5
61,78,95,56,58,57,405,0.40336134453781514,75,105,75,105,75,45,480,0.3274336283185841,2.0
60,70,50,100,50,65,395,0.5217391304347826,85,110,76,65,82,56,474,0.3933333333333333,2.0
90,50,34,60,44,70,348,0.6283185840707964,60,55,50,40,55,45,305,0.22377622377622378,2.0
65,50,70,95,80,65,425,0.4262295081967213,45,50,55,75,65,30,320,0.06293706293706294,2.0
60,50,40,85,75,95,405,0.7540983606557377,60,105,60,120,60,105,510,0.8849557522123894,1.0
45,95,50,40,50,75,355,0.54,50,53,62,58,63,44,330,0.13709677419354838,1.0
70,45,48,60,65,35,323,0.15748031496062992,45,75,60,40,30,50,300,0.304,2.0
95,117,80,65,70,92,519,0.8409090909090909,30,45,59,30,39,57,260,0.2803030303030303,1.0
60,150,50,150,50,60,520,0.5,65,80,80,59,63,58,405,0.4411764705882353,0.5
75,90,90,140,90,115,600,0.9481481481481482,80,82,78,95,80,85,500,0.6869565217391305,0.5
45,25,50,25,25,35,205,0.13076923076923078,45,100,135,65,135,45,525,0.29411764705882354,0.25
65,47,55,73,75,85,400,0.65,120,70,120,75,130,85,600,0.6694915254237288,2.0
50,53,48,53,48,64,316,0.4076923076923077,85,120,70,50,60,100,485,0.8308823529411765,0.5
97,165,60,65,50,58,495,0.3902439024390244,250,5,5,35,105,50,450,0.15306122448979592,1.0
67,89,116,79,116,33,500,0.2624113475177305,65,50,70,95,80,65,425,0.4262295081967213,0.5
35,55,40,45,40,60,275,0.35714285714285715,90,92,87,75,85,76,505,0.5409836065573771,0.0
41,56,40,62,44,71,314,0.568,43,80,65,50,35,35,308,0.14193548387096774,0.5
45,50,45,115,55,95,405,0.6936936936936937,85,56,77,50,77,78,423,0.53125,0.0
40,30,35,45,40,55,245,0.31496062992125984,150,80,44,90,54,80,498,0.625,1.0
40,80,35,35,45,70,305,0.4661016949152542,68,85,65,165,135,100,618,0.8083333333333333,0.25
50,60,45,100,80,65,400,0.45689655172413796,110,80,90,95,90,65,530,0.5033557046979866,2.0
40,40,55,40,70,55,300,0.40939597315436244,50,50,95,40,50,35,320,0.20279720279720279,2.0
100,103,75,120,75,127,600,0.940677966101695,65,50,35,115,95,95,455,0.7333333333333333,1.0
100,180,160,150,90,90,770,0.7520661157024794,70,140,70,110,65,105,560,0.95,0.5
86,81,97,81,107,43,495,0.203125,72,58,80,103,80,97,490,0.7171052631578947,1.0
54,45,47,75,98,52,371,0.39669421487603307,59,66,70,44,55,41,335,0.25190839694656486,1.0
35,55,40,50,50,90,320,0.6838235294117647,38,36,38,32,36,57,237,0.3893805309734513,1.0
60,100,89,55,69,112,485,0.9298245614035088,31,45,90,30,30,40,266,0.21929824561403508,0.5
50,65,90,35,35,15,290,0.14678899082568808,75,125,230,55,95,30,610,0.3448275862068966,0.5
78,65,68,112,154,75,552,0.628099173553719,106,190,100,154,100,130,780,0.9259259259259259,2.0
125,120,90,170,100,95,700,0.78125,60,50,70,50,90,65,385,0.39568345323741005,1.0
59,66,70,44,55,41,335,0.25190839694656486,67,82,62,46,48,43,348,0.22033898305084745,1.0
40,40,50,30,30,30,220,0.0873015873015873,54,45,47,75,98,52,371,0.39669421487603307,1.0
45,50,55,75,65,30,320,0.06293706293706294,60,85,60,50,50,125,430,0.9090909090909091,0.5
55,84,105,114,75,52,485,0.2890625,50,30,55,65,55,20,275,0.13675213675213677,2.0
85,76,64,45,55,90,415,0.6739130434782609,38,36,38,32,36,57,237,0.3893805309734513,1.0
100,90,130,45,65,55,485,0.4253731343283582,80,82,83,100,100,80,525,0.6742424242424242,0.5
51,65,65,80,75,59,395,0.4365079365079365,60,90,140,50,50,40,430,0.2535211267605634,0.5
55,20,35,20,45,75,250,0.37681159420289856,100,100,100,100,100,100,600,0.8805970149253731,1.0
80,80,80,55,55,90,440,0.6417910447761194,70,60,62,80,82,60,414,0.4375,1.0
50,20,55,25,25,30,205,0.09774436090225563,51,65,65,80,75,59,395,0.4365079365079365,1.0
100,90,130,45,65,55,485,0.4253731343283582,40,30,30,40,50,30,220,0.07936507936507936,0.25
55,66,44,44,56,85,350,0.6888888888888889,35,64,85,74,55,32,345,0.19827586206896552,1.0
90,70,80,70,95,70,475,0.5190839694656488,100,128,90,77,77,128,600,0.959349593495935,1.0
105,150,90,150,90,95,680,0.8285714285714286,60,85,69,65,79,80,438,0.576,1.0
46,57,40,40,40,50,273,0.25,63,63,47,41,41,74,329,0.56,0.5
70,94,50,94,50,66,424,0.48148148148148145,80,82,83,100,100,80,525,0.6742424242424242,2.0
35,55,40,45,40,60,275,0.35714285714285715,68,72,78,38,42,32,330,0.23809523809523808,0.0
72,58,80,103,80,97,490,0.7171052631578947,62,73,55,56,52,84,382,0.7244094488188977,1.0
70,90,45,15,45,50,315,0.3629032258064516,50,70,100,40,40,30,330,0.2222222222222222,1.0
40,40,50,30,30,30,220,0.0873015873015873,95,135,80,110,80,100,600,0.8248175182481752,0.25
75,90,50,110,80,95,500,0.7985611510791367,95,125,79,60,100,81,540,0.6165413533834586,0.5
55,68,64,45,55,31,318,0.11666666666666667,55,65,35,60,30,85,330,0.6126126126126126,2.0
50,48,43,46,41,60,288,0.47297297297297297,70,80,50,35,35,35,305,0.14,1.0
72,95,67,103,71,122,530,0.9606299212598425,60,65,80,170,95,130,600,0.8625954198473282,2.0
75,80,85,110,90,50,490,0.3548387096774194,35,60,44,40,54,55,288,0.366412213740458,0.25
50,95,180,85,45,70,525,0.5298507462686567,100,100,100,100,100,100,600,0.8758169934640523,0.5
110,130,80,70,60,80,530,0.5862068965517241,60,80,95,70,85,50,440,0.2231404958677686,1.0
250,5,5,35,105,50,450,0.15306122448979592,60,60,60,105,105,105,495,0.848,0.0
106,130,90,110,154,90,680,0.719626168224299,85,56,77,50,77,78,423,0.53125,1.0
60,65,70,85,75,40,395,0.21705426356589147,55,70,45,70,50,60,350,0.45,0.5
64,115,65,83,63,65,455,0.5323741007194245,103,60,86,60,86,50,445,0.3458646616541353,0.0
40,40,50,30,30,30,220,0.0873015873015873,60,75,85,100,85,115,520,0.8992248062015504,2.0
65,70,60,65,65,115,440,0.8583333333333333,20,10,230,10,230,5,505,0.0,0.5
108,100,121,81,95,95,600,0.7476635514018691,60,85,42,85,42,91,405,0.8227848101265823,0.0
60,75,85,100,85,115,520,0.8992248062015504,55,84,105,114,75,52,485,0.2890625,0.5
85,105,55,85,50,115,495,0.9032258064516129,73,100,60,100,60,65,458,0.42657342657342656,1.0
40,45,65,100,120,90,460,0.5588235294117647,100,100,100,100,100,100,600,0.8602941176470589,1.0
68,85,65,165,135,100,618,0.8083333333333333,45,100,45,45,45,10,290,0.2949640287769784,2.0
65,76,84,54,96,105,480,0.9008264462809917,45,55,39,35,39,42,255,0.18518518518518517,1.0
70,75,80,135,80,135,575,0.917910447761194,67,58,57,81,67,101,431,0.8790322580645161,0.5
35,80,50,50,70,120,405,0.84375,74,48,76,83,81,104,466,0.7913043478260869,1.0
106,90,130,90,154,110,680,0.8699186991869918,130,65,60,110,95,65,525,0.5227272727272727,1.0
63,60,55,50,50,71,349,0.5289256198347108,38,35,35,65,55,50,278,0.2647058823529412,1.0
100,90,130,45,65,55,485,0.4253731343283582,75,75,95,75,95,113,528,0.9015151515151515,0.5
45,30,15,85,65,65,305,0.36220472440944884,20,40,90,30,90,25,295,0.11363636363636363,1.0
67,57,55,77,55,114,425,0.8879310344827587,80,82,100,83,100,80,525,0.6821705426356589,2.0
60,50,40,85,75,95,405,0.7540983606557377,190,33,58,33,58,33,405,0.13432835820895522,1.0
65,125,60,95,60,105,510,0.9236641221374046,58,64,58,80,65,80,405,0.609271523178808,1.0
79,100,80,110,90,121,580,0.968,45,45,35,20,30,20,195,0.07246376811594203,2.0
100,100,100,100,100,100,600,0.8602941176470589,55,47,52,40,40,41,275,0.16806722689075632,0.5
90,95,95,70,90,70,510,0.5230769230769231,50,65,107,105,107,86,520,0.703125,2.0
95,155,109,70,130,81,640,0.6788321167883211,30,45,135,45,90,30,375,0.09285714285714286,2.0
40,55,30,30,30,85,270,0.688,105,105,75,65,100,50,500,0.37593984962406013,1.0
85,135,130,60,80,25,515,0.40540540540540543,109,66,84,81,99,32,471,0.2013888888888889,0.5
50,65,85,35,35,55,325,0.32575757575757575,25,35,70,95,55,45,325,0.16783216783216784,0.25
60,45,70,75,85,55,390,0.3008130081300813,65,75,90,97,123,44,494,0.1987179487179487,2.0
40,55,70,45,60,30,300,0.10619469026548672,45,100,135,65,135,45,525,0.29411764705882354,1.0
68,90,65,50,55,82,410,0.6165413533834586,100,164,150,95,120,71,700,0.5645161290322581,2.0
83,80,80,135,80,121,579,0.9444444444444444,40,27,60,37,50,66,280,0.36220472440944884,2.0
85,70,80,97,80,123,535,0.9304347826086956,70,110,70,115,70,90,525,0.75,0.5
70,85,65,105,85,120,530,0.9262295081967213,60,62,80,63,80,60,405,0.4336283185840708,0.5
50,95,180,85,45,70,525,0.5298507462686567,70,80,102,80,102,40,474,0.2677165354330709,2.0
85,76,64,45,55,90,415,0.6739130434782609,85,56,77,50,77,78,423,0.53125,1.0
50,95,95,35,110,70,455,0.5179856115107914,37,25,41,25,41,25,194,0.08870967741935484,0.5
40,55,80,35,60,30,300,0.15037593984962405,30,56,35,25,35,72,253,0.48148148148148145,1.0
50,75,75,65,65,50,380,0.4049586776859504,35,45,160,30,45,70,385,0.48148148148148145,1.0
75,110,110,110,105,80,590,0.656934306569343,60,45,50,90,80,70,395,0.625,1.0
30,65,100,45,25,40,305,0.1891891891891892,75,38,38,56,56,67,330,0.5263157894736842,0.5
40,40,50,30,30,30,220,0.0873015873015873,70,70,40,60,40,60,340,0.4247787610619469,0.5
70,40,50,55,50,25,290,0.061068702290076333,20,10,55,15,20,80,200,0.17985611510791366,0.25
50,47,50,57,50,65,319,0.463768115942029,59,59,58,90,70,73,409,0.5826086956521739,0.5
60,95,80,60,80,30,405,0.19480519480519481,45,49,65,49,65,45,318,0.275,1.0
44,48,65,50,64,43,314,0.1623931623931624,60,60,75,60,75,80,410,0.7321428571428571,1.0
55,69,85,32,35,28,304,0.09302325581395349,126,131,95,131,98,99,680,0.8102189781021898,2.0
250,5,5,35,105,50,450,0.15306122448979592,75,75,130,75,130,95,580,0.7479674796747967,1.0
72,60,30,20,30,25,237,0.11570247933884298,30,56,35,25,35,72,253,0.48148148148148145,2.0
49,49,56,49,61,66,330,0.5190839694656488,44,48,65,50,64,43,314,0.1623931623931624,0.5
50,35,55,25,25,15,205,0.021739130434782608,80,45,65,90,110,80,470,0.5462962962962963,2.0
80,110,120,130,90,70,600,0.6198347107438017,59,74,50,35,50,35,303,0.3125,2.0
150,160,100,95,65,100,670,0.8866666666666667,95,109,105,75,85,56,525,0.34513274336283184,1.0
60,59,85,79,105,36,424,0.16666666666666666,130,85,80,85,95,60,535,0.43884892086330934,2.0
50,65,107,105,107,86,520,0.6991150442477876,103,60,86,60,86,50,445,0.3458646616541353,1.0
40,30,30,55,30,85,270,0.4666666666666667,60,45,70,75,85,55,390,0.3008130081300813,1.0
125,170,100,120,90,95,700,0.77,52,65,50,45,50,38,300,0.27419354838709675,4.0
70,60,62,80,82,60,414,0.4375,80,100,123,122,120,80,625,0.56,2.0
45,55,45,65,45,75,330,0.5692307692307692,40,40,35,50,100,70,335,0.5031847133757962,0.5
45,55,45,65,45,75,330,0.5692307692307692,50,35,55,25,25,15,205,0.021739130434782608,2.0
50,80,95,10,45,10,290,0.232,50,60,45,100,80,65,400,0.45689655172413796,1.0
65,40,70,80,140,70,465,0.5954198473282443,70,120,100,145,105,20,560,0.2824427480916031,4.0
50,60,45,100,80,65,400,0.45689655172413796,90,85,100,95,125,85,580,0.6834532374100719,0.5
64,115,65,83,63,65,455,0.5323741007194245,60,80,50,40,40,30,300,0.15328467153284672,1.0
60,75,100,55,80,50,420,0.3088235294117647,68,75,53,83,113,60,452,0.45384615384615384,1.0
70,120,65,45,85,125,510,0.9747899159663865,86,68,72,109,66,106,507,0.8099173553719008,0.5
70,145,88,140,70,112,625,0.8888888888888888,90,120,100,150,120,100,680,0.7718120805369127,0.5
50,52,48,65,50,55,320,0.33098591549295775,64,78,52,78,52,81,405,0.6422764227642277,2.0
80,75,150,75,150,50,580,0.30973451327433627,126,131,95,131,98,99,680,0.8102189781021898,1.0
70,60,125,115,70,55,495,0.35507246376811596,75,123,67,95,85,95,540,0.7642276422764228,1.0
85,110,90,45,90,80,500,0.6206896551724138,90,92,75,92,85,60,494,0.49586776859504134,1.0
45,50,35,55,75,40,300,0.21367521367521367,60,110,70,60,60,100,460,0.8461538461538461,1.0
59,74,50,35,50,35,303,0.3125,64,165,75,93,83,75,555,0.6587301587301587,2.0
79,103,120,135,115,78,630,0.5763888888888888,60,115,105,65,70,80,495,0.7181818181818181,1.0
70,84,70,65,70,51,410,0.2949640287769784,150,120,100,120,100,90,680,0.664179104477612,1.0
90,60,70,75,70,45,410,0.23880597014925373,92,105,90,125,90,98,600,0.8217054263565892,1.0
55,112,45,74,45,70,401,0.559322033898305,60,110,70,60,60,100,460,0.8461538461538461,2.0
108,100,121,81,95,95,600,0.7476635514018691,97,165,60,65,50,58,495,0.3902439024390244,2.0
78,84,78,109,85,100,534,0.8646616541353384,50,85,85,55,55,50,380,0.3902439024390244,1.0
55,40,50,65,85,40,335,0.3181818181818182,95,117,80,65,70,92,519,0.8409090909090909,1.0
40,55,99,40,79,47,360,0.26262626262626265,20,10,55,15,20,80,200,0.17985611510791366,1.0
40,20,30,40,80,55,265,0.22764227642276422,50,80,95,10,45,10,290,0.232,0.5
75,69,72,114,100,104,534,0.8253968253968254,90,92,87,75,85,76,505,0.5409836065573771,4.0
100,100,90,150,140,90,670,0.71875,65,65,60,130,95,110,525,0.823943661971831,1.0
115,115,85,90,75,100,580,0.8134328358208955,60,50,40,85,75,95,405,0.7540983606557377,1.0
38,41,40,50,65,65,299,0.4108527131782946,64,165,75,93,83,75,555,0.6587301587301587,1.0
50,50,40,30,30,50,250,0.2781954887218045,78,81,71,74,69,126,499,0.9090909090909091,0.0
100,100,80,60,60,50,450,0.3050847457627119,70,80,102,80,102,40,474,0.2677165354330709,0.0
35,35,35,35,35,35,210,0.13385826771653545,70,70,40,60,40,60,340,0.4247787610619469,2.0
80,125,75,40,95,85,500,0.6911764705882353,43,70,48,50,60,38,309,0.2391304347826087,0.0
69,55,45,55,55,15,294,0.11666666666666667,35,46,34,35,45,20,215,0.072,1.0
68,165,95,65,115,110,618,0.8615384615384616,50,47,50,57,50,65,319,0.463768115942029,0.5
56,61,65,48,45,38,313,0.17567567567567569,60,60,75,60,75,80,410,0.7321428571428571,1.0
35,64,85,74,55,32,345,0.19827586206896552,62,44,50,44,50,55,305,0.3629032258064516,0.5
40,55,30,30,30,85,270,0.688,55,20,35,20,45,75,250,0.37681159420289856,1.0
59,45,40,35,40,31,250,0.14285714285714285,100,77,77,128,128,90,600,0.6901408450704225,1.0
30,45,59,30,39,57,260,0.2803030303030303,68,65,65,125,115,80,518,0.6461538461538462,2.0
90,85,100,95,125,85,580,0.6834532374100719,40,45,35,65,55,70,310,0.4482758620689655,4.0
135,85,40,40,85,5,390,0.6864406779661016,108,130,95,80,85,102,600,0.7637795275590551,1.0
80,90,80,130,110,110,600,0.856,250,5,5,35,105,50,450,0.15306122448979592,1.0
80,100,80,80,80,100,520,0.9051724137931034,80,80,80,55,55,90,440,0.6417910447761194,1.0
45,60,45,25,45,55,275,0.29,50,45,45,35,35,50,260,0.23529411764705882,1.0
60,50,50,60,70,50,340,0.28346456692913385,50,48,43,46,41,60,288,0.47297297297297297,4.0
70,55,55,80,60,45,365,0.2222222222222222,74,108,133,83,65,32,495,0.32142857142857145,2.0
85,50,95,120,115,80,545,0.5793650793650794,70,55,75,45,65,60,370,0.45901639344262296,2.0
91,72,90,129,90,108,580,0.8925619834710744,76,25,45,67,55,24,292,0.0390625,0.5
70,90,70,60,60,70,420,0.6390977443609023,30,45,135,45,90,30,375,0.09285714285714286,1.0
76,104,71,104,71,108,534,0.912751677852349,60,115,105,65,70,80,495,0.7181818181818181,0.5
90,55,75,60,75,30,385,0.13970588235294118,55,75,85,25,25,15,280,0.1875,0.5
60,90,70,60,120,40,440,0.27419354838709675,62,44,50,44,50,55,305,0.3629032258064516,1.0
110,85,95,80,95,50,515,0.2713178294573643,60,69,95,69,95,36,424,0.2608695652173913,0.5
40,55,30,30,30,60,245,0.43548387096774194,40,80,100,30,30,20,300,0.11851851851851852,0.25
70,60,75,110,75,90,480,0.7165354330708661,86,68,72,109,66,106,507,0.8099173553719008,0.5
60,85,69,65,79,80,438,0.576,72,58,80,103,80,97,490,0.7171052631578947,1.0
60,62,80,63,80,60,405,0.4336283185840708,50,105,125,55,95,50,480,0.375886524822695,0.5
100,180,160,150,90,90,770,0.7520661157024794,78,70,61,50,61,100,420,0.8145161290322581,1.0
85,50,95,120,115,80,545,0.5793650793650794,74,48,76,83,81,104,466,0.7913043478260869,1.0
60,70,65,125,105,90,515,0.6911764705882353,80,115,80,65,55,93,488,0.7846153846153846,0.5
65,65,60,130,95,110,525,0.823943661971831,103,60,126,80,126,50,545,0.36363636363636365,1.0
65,80,80,59,63,58,405,0.4411764705882353,70,140,70,110,65,105,560,0.95,0.5
45,53,70,40,60,42,310,0.25735294117647056,60,25,35,70,80,60,330,0.3076923076923077,2.0
79,103,120,135,115,78,630,0.5763888888888888,77,85,51,55,51,65,384,0.5163934426229508,1.0
30,30,42,30,42,70,244,0.4230769230769231,65,73,55,47,75,85,400,0.6846846846846847,2.0
57,24,86,24,86,23,300,0.12727272727272726,60,100,115,70,85,90,520,0.7557251908396947,0.25
75,80,85,110,90,50,490,0.3548387096774194,60,40,60,95,60,55,370,0.4222222222222222,0.25
60,60,60,105,105,105,495,0.848,50,64,50,45,50,41,300,0.22727272727272727,1.0
45,50,43,40,38,62,278,0.40441176470588236,54,78,103,53,45,22,355,0.23255813953488372,0.25
105,180,100,180,100,115,780,0.9477611940298507,70,140,230,60,80,50,630,0.32432432432432434,0.25
70,120,100,145,105,20,560,0.2824427480916031,80,52,50,90,50,89,411,0.6666666666666666,0.0
66,65,48,62,57,52,350,0.36220472440944884,40,45,40,65,40,65,295,0.5661764705882353,1.0
90,120,100,150,120,100,680,0.7718120805369127,60,60,40,65,45,35,305,0.15833333333333333,4.0
150,120,100,120,100,90,680,0.664179104477612,55,66,44,44,56,85,350,0.6888888888888889,0.0
100,100,100,100,100,100,600,0.8602941176470589,46,87,60,30,40,57,320,0.37777777777777777,0.5
60,70,105,70,120,75,500,0.5983606557377049,50,53,62,58,63,44,330,0.13709677419354838,1.0
60,80,95,70,85,50,440,0.2231404958677686,60,62,63,80,80,60,405,0.38016528925619836,1.0
80,110,120,130,90,70,600,0.6198347107438017,67,82,62,46,48,43,348,0.22033898305084745,1.0
50,105,79,35,110,76,455,0.6214285714285714,95,80,105,40,70,100,490,0.8046875,2.0
70,77,60,97,60,108,472,0.8394160583941606,45,60,45,25,45,55,275,0.29,1.0
40,55,70,45,60,30,300,0.10619469026548672,43,70,48,50,60,38,309,0.2391304347826087,1.0
86,81,97,81,107,43,495,0.203125,95,23,48,23,48,23,260,0.046153846153846156,1.0
31,45,90,30,30,40,266,0.21929824561403508,45,85,70,40,40,60,340,0.5229357798165137,2.0
45,100,45,45,45,10,290,0.2949640287769784,80,100,80,80,80,100,520,0.9051724137931034,1.0
45,50,43,40,38,62,278,0.40441176470588236,101,72,72,99,89,29,462,0.1937984496124031,1.0
100,128,90,77,77,128,600,0.959349593495935,40,45,40,62,60,60,307,0.33884297520661155,1.0
50,65,107,105,107,86,520,0.7272727272727273,85,50,95,120,115,80,545,0.5793650793650794,2.0
40,55,70,45,60,30,300,0.10619469026548672,100,120,100,150,120,90,680,0.728,0.5
44,58,44,58,44,61,309,0.41964285714285715,130,70,35,70,35,60,400,0.4017857142857143,0.5
100,77,77,128,128,90,600,0.6901408450704225,50,75,45,40,45,60,315,0.4380165289256198,1.0
55,55,55,85,55,30,335,0.1320754716981132,64,66,68,81,76,50,405,0.25190839694656486,1.0
55,65,95,95,45,85,440,0.6610169491525424,45,49,49,65,65,45,318,0.2781954887218045,0.5
75,90,140,60,60,40,465,0.3008130081300813,165,75,80,40,45,65,470,0.5151515151515151,0.5
50,48,43,46,41,60,288,0.47297297297297297,75,125,75,30,75,85,465,0.625,1.0
75,123,67,95,85,95,540,0.7642276422764228,70,55,95,95,110,65,490,0.48872180451127817,1.0
86,92,88,68,75,73,482,0.6835443037974683,45,60,45,25,45,55,275,0.29,1.0
45,30,35,20,20,45,195,0.14782608695652175,103,93,67,71,61,84,479,0.7142857142857143,1.0
105,140,95,55,65,45,505,0.3,75,80,70,65,75,90,455,0.7578125,0.25
86,76,86,116,56,95,515,0.7982456140350878,60,65,70,85,75,40,395,0.21705426356589147,2.0
50,150,50,150,50,150,600,0.9339622641509434,45,67,60,35,50,63,320,0.5128205128205128,1.0
61,72,57,55,55,65,365,0.3984375,50,95,95,35,110,70,455,0.5179856115107914,1.0
50,65,107,105,107,86,520,0.7758620689655172,35,64,85,74,55,32,345,0.19827586206896552,1.0
65,150,60,115,60,115,565,0.935251798561151,65,85,70,75,70,40,405,0.203125,1.0
95,85,85,65,65,35,430,0.2571428571428571,55,84,105,114,75,52,485,0.2890625,0.5
60,70,65,125,105,90,515,0.6911764705882353,45,100,135,65,135,45,525,0.29411764705882354,0.5
78,52,60,63,65,23,341,0.06015037593984962,45,85,70,40,40,60,340,0.5229357798165137,1.0
70,110,80,55,80,105,500,0.8794326241134752,100,73,83,73,83,55,467,0.371900826446281,0.5
105,125,100,60,100,100,590,0.8359375,74,108,133,83,65,32,495,0.32142857142857145,0.5
45,67,60,35,50,63,320,0.5128205128205128,71,120,95,120,95,99,600,0.8203125,1.0
65,65,60,130,95,110,525,0.823943661971831,50,105,79,35,110,76,455,0.6214285714285714,1.0
40,55,99,40,79,47,360,0.26262626262626265,20,10,230,10,230,5,505,0.0,0.5
40,65,95,60,45,35,340,0.13986013986013987,55,69,85,32,35,28,304,0.09302325581395349,1.0
100,134,110,95,100,61,600,0.4057971014492754,60,85,60,85,60,55,405,0.3673469387755102,0.5
80,80,80,80,80,80,480,0.5606060606060606,85,110,76,65,82,56,474,0.3933333333333333,0.5
80,70,65,80,120,100,515,0.8034188034188035,45,60,32,50,32,76,295,0.5925925925925926,1.0
60,90,70,60,120,40,440,0.27419354838709675,60,69,95,69,95,36,424,0.2608695652173913,0.5
64,66,68,81,76,50,405,0.25190839694656486,126,131,95,131,98,99,680,0.8102189781021898,1.0
70,105,105,50,40,20,390,0.33587786259541985,105,130,120,45,45,40,485,0.4444444444444444,0.5
86,68,72,109,66,106,507,0.8099173553719008,70,75,80,135,80,135,575,0.917910447761194,1.0
50,75,35,70,30,40,300,0.21296296296296297,45,50,45,115,55,95,405,0.6936936936936937,0.125
85,56,77,50,77,78,423,0.53125,130,85,80,85,95,60,535,0.43884892086330934,1.0
75,85,200,55,65,30,510,0.16778523489932887,55,66,44,44,56,85,350,0.6888888888888889,1.0
85,105,85,40,50,40,405,0.211864406779661,100,123,75,57,75,80,510,0.6923076923076923,1.0
78,70,61,50,61,100,420,0.8145161290322581,100,100,80,60,60,50,450,0.3050847457627119,1.0
95,125,79,60,100,81,540,0.6165413533834586,67,57,55,77,55,114,425,0.8879310344827587,1.0
95,80,105,40,70,100,490,0.8046875,45,35,45,62,53,35,275,0.11851851851851852,1.0
64,88,50,88,50,106,446,0.9111111111111111,85,80,70,135,75,90,535,0.7006802721088435,1.0
95,75,80,100,110,30,490,0.24242424242424243,30,80,90,55,45,55,355,0.4295774647887324,1.0
100,110,90,85,90,60,535,0.47794117647058826,60,50,40,85,75,95,405,0.7540983606557377,2.0
40,29,45,29,45,36,224,0.14634146341463414,85,115,80,105,80,50,515,0.3063063063063063,1.0
77,85,51,55,51,65,384,0.5163934426229508,60,75,100,55,80,50,420,0.3088235294117647,1.0
60,85,42,85,42,91,405,0.8227848101265823,90,50,34,60,44,70,348,0.6283185840707964,2.0
30,30,42,30,42,70,244,0.4230769230769231,69,69,76,69,86,91,460,0.6554621848739496,1.0
95,75,180,130,80,30,590,0.13793103448275862,90,132,105,132,105,30,594,0.4246575342465753,0.5
100,100,100,100,100,100,600,0.831858407079646,30,30,42,30,42,70,244,0.4230769230769231,1.0
85,76,64,45,55,90,415,0.6739130434782609,50,75,75,65,65,50,380,0.4049586776859504,0.0
70,85,140,85,70,20,470,0.272,60,55,50,40,55,45,305,0.22377622377622378,2.0
45,55,45,65,45,75,330,0.5692307692307692,60,60,60,35,35,30,280,0.11194029850746269,1.0
85,135,130,60,80,25,515,0.40540540540540543,105,140,55,30,55,95,480,0.8195488721804511,2.0
106,110,90,154,90,130,680,0.926829268292683,60,85,69,60,69,77,420,0.518796992481203,1.0
84,86,88,111,101,60,530,0.4634146341463415,80,100,70,50,60,45,405,0.25806451612903225,1.0
55,40,50,65,85,40,335,0.3181818181818182,40,45,35,30,40,55,245,0.3793103448275862,1.0
60,90,70,60,120,40,440,0.27419354838709675,105,95,75,85,75,74,509,0.5714285714285714,1.0
80,45,65,90,110,80,470,0.5462962962962963,70,60,125,115,70,55,495,0.35507246376811596,1.0
35,35,40,35,55,50,250,0.40336134453781514,78,52,60,63,65,23,341,0.06015037593984962,1.0
62,44,50,44,50,55,305,0.3629032258064516,100,100,100,100,100,100,600,0.8805970149253731,0.5
81,102,77,85,75,85,505,0.5642857142857143,100,103,75,120,75,127,600,0.940677966101695,0.0
120,70,120,75,130,85,600,0.6694915254237288,55,65,95,95,45,85,440,0.6610169491525424,1.0
53,51,53,61,56,40,314,0.14285714285714285,35,55,40,45,40,60,275,0.35714285714285715,1.0
85,105,100,79,83,78,530,0.5869565217391305,60,80,50,50,50,40,330,0.23853211009174313,1.0
55,63,90,50,80,42,380,0.21138211382113822,80,120,79,95,79,70,523,0.5833333333333334,1.0
60,50,70,80,80,140,480,0.8449612403100775,70,110,80,55,80,105,500,0.8794326241134752,2.0
59,74,50,35,50,35,303,0.3125,70,75,80,135,80,135,575,0.917910447761194,2.0
160,110,65,65,110,30,540,0.35714285714285715,100,150,140,100,90,90,670,0.7969924812030075,1.0
50,65,85,35,35,55,325,0.32575757575757575,50,52,48,65,50,55,320,0.33098591549295775,1.0
70,55,55,80,60,45,365,0.2222222222222222,100,100,100,100,100,100,600,0.831858407079646,1.0
65,75,90,97,123,44,494,0.1987179487179487,38,35,40,27,25,35,200,0.08208955223880597,1.0
50,70,160,70,160,90,600,0.7417218543046358,78,70,61,50,61,100,420,0.8145161290322581,1.0
50,60,45,100,80,65,400,0.45689655172413796,78,81,71,74,69,126,499,0.9090909090909091,0.25
35,40,100,90,55,35,355,0.1796875,75,125,70,125,70,115,580,0.9037037037037037,1.0
55,45,50,45,65,80,340,0.5546218487394958,75,55,70,55,95,110,460,0.8444444444444444,0.5
38,35,35,65,55,50,278,0.2647058823529412,70,20,50,20,50,40,250,0.1557377049180328,1.0
74,94,131,54,116,20,489,0.4485294117647059,92,105,90,125,90,98,600,0.8217054263565892,0.5
111,83,68,92,82,39,475,0.1774193548387097,95,65,65,110,130,60,525,0.4016393442622951,1.0
70,120,65,45,85,125,510,0.9747899159663865,53,51,53,61,56,40,314,0.14285714285714285,0.5
80,82,100,83,100,80,525,0.6821705426356589,60,69,95,69,95,36,424,0.2608695652173913,0.25
50,75,35,70,30,40,300,0.21296296296296297,45,49,49,65,65,45,318,0.2781954887218045,0.25
40,80,35,35,45,70,305,0.4661016949152542,65,65,65,50,50,90,385,0.72,1.0
80,100,70,60,70,95,475,0.7416666666666667,80,100,200,50,100,50,580,0.3472222222222222,1.0
65,105,60,60,70,95,455,63.0,58,64,58,80,65,80,405,0.5423728813559322,1.0
75,140,65,112,65,110,567,0.9140625,60,52,168,47,138,30,495,0.19834710743801653,0.125
52,65,55,58,62,60,352,0.4482758620689655,80,70,65,80,120,100,515,0.8034188034188035,1.0
75,95,95,95,95,85,540,0.6470588235294118,80,95,82,60,82,75,474,0.6,1.0
100,70,70,65,65,45,415,0.1897810218978102,95,135,80,110,80,100,600,0.8248175182481752,1.0
60,62,80,63,80,60,405,0.4336283185840708,91,90,72,90,129,108,580,0.896,0.5
60,65,60,130,75,110,500,0.7719298245614035,78,84,78,109,85,100,534,0.8646616541353384,1.0
126,131,95,131,98,99,680,0.8294573643410853,50,45,45,35,35,50,260,0.23529411764705882,1.0
76,104,71,104,71,108,534,0.912751677852349,65,40,70,80,140,70,465,0.5954198473282443,0.25
115,45,20,45,25,20,270,0.11538461538461539,80,120,130,55,65,45,495,0.37037037037037035,0.5
35,80,50,50,70,120,405,0.84375,49,55,42,42,37,85,310,0.6068376068376068,1.0
35,20,65,40,65,20,245,0.02459016393442623,54,66,70,44,55,46,335,0.4214876033057851,1.0
95,124,78,69,71,58,495,0.37398373983739835,150,120,100,120,100,90,680,0.664179104477612,0.0
58,50,145,95,105,30,483,0.2459016393442623,68,165,95,65,115,110,618,0.8615384615384616,2.0
72,85,70,65,70,58,420,0.41304347826086957,110,123,65,100,65,65,528,0.5217391304347826,0.5
65,65,45,75,45,95,390,0.72,60,100,89,55,69,112,485,0.9298245614035088,1.0
70,85,70,60,70,50,405,0.28378378378378377,30,45,135,45,90,30,375,0.09285714285714286,4.0
20,10,230,10,230,5,505,0.0,75,90,90,140,90,115,600,0.9481481481481482,2.0
60,85,60,85,60,55,405,0.3673469387755102,70,140,70,110,65,105,560,0.95,1.0
60,40,60,40,60,35,295,0.18055555555555555,80,82,83,100,100,80,525,0.6742424242424242,0.25
90,60,70,75,70,45,410,0.23880597014925373,60,50,50,60,70,50,340,0.28346456692913385,0.25
44,58,44,58,44,61,309,0.41964285714285715,110,65,105,55,95,80,510,0.6258503401360545,1.0
50,50,77,95,77,91,440,0.5916666666666667,95,80,105,40,70,100,490,0.8046875,0.0
60,45,70,75,85,55,390,0.3008130081300813,60,65,70,85,75,40,395,0.21705426356589147,2.0
55,55,85,65,85,35,380,0.2014388489208633,106,110,90,154,90,130,680,0.926829268292683,1.0
30,30,42,30,42,70,244,0.4230769230769231,97,165,60,65,50,58,495,0.3902439024390244,0.5
80,80,50,40,50,25,325,0.176056338028169,70,70,115,130,90,60,535,0.5338983050847458,0.0
100,70,70,65,65,45,415,0.1897810218978102,75,100,66,60,66,115,482,0.918918918918919,1.0
71,73,88,120,89,59,500,0.43537414965986393,60,80,50,40,40,30,300,0.15328467153284672,1.0
80,82,83,100,100,80,525,0.6742424242424242,65,75,90,97,123,44,494,0.1987179487179487,0.125
60,60,75,60,75,80,410,0.7321428571428571,95,95,85,125,65,55,520,0.3894736842105263,0.25
40,55,30,30,30,85,270,0.688,80,160,80,130,80,100,630,0.8455284552845529,2.0
44,75,35,63,33,45,295,0.2647058823529412,55,55,85,65,85,35,380,0.2014388489208633,1.0
40,45,40,65,40,65,295,0.5661764705882353,75,95,122,58,75,69,494,0.5725806451612904,0.5
50,95,180,85,45,70,525,0.5298507462686567,255,10,10,75,135,55,540,0.3125,1.0
65,60,70,85,75,40,395,0.1796875,40,65,40,80,40,65,330,0.5038167938931297,1.0
100,150,140,100,90,90,670,0.7969924812030075,105,95,80,40,80,90,490,0.753968253968254,1.0
55,70,45,70,50,60,350,0.45,50,60,60,60,60,30,320,0.11290322580645161,0.5
86,81,97,81,107,43,495,0.203125,95,110,80,70,80,50,485,0.37209302325581395,2.0
42,52,67,39,56,50,306,0.2868217054263566,40,35,30,120,70,105,400,0.6692307692307692,1.0
75,103,80,70,80,92,500,0.7933884297520661,40,80,100,30,30,20,300,0.11851851851851852,4.0
60,82,45,45,45,74,351,0.5752212389380531,70,140,70,110,65,105,560,0.95,0.5
80,80,50,40,50,25,325,0.176056338028169,83,80,80,135,80,121,579,0.9444444444444444,1.0
76,65,45,92,42,91,411,0.7449664429530202,38,30,85,55,65,30,303,0.21428571428571427,0.0
90,50,34,60,44,70,348,0.6283185840707964,75,75,75,125,95,40,485,0.15671641791044777,2.0
60,55,90,145,90,80,520,0.6071428571428571,95,23,48,23,48,23,260,0.046153846153846156,2.0
50,53,48,53,48,64,316,0.4076923076923077,40,27,60,37,50,66,280,0.36220472440944884,0.5
54,45,47,75,98,52,371,0.39669421487603307,110,78,73,76,71,60,468,0.3333333333333333,1.0
115,45,20,45,25,20,270,0.11538461538461539,70,70,40,60,40,60,340,0.4247787610619469,2.0
150,160,100,95,65,100,670,0.8866666666666667,40,20,30,40,80,55,265,0.22764227642276422,1.0
38,41,40,50,65,65,299,0.4108527131782946,80,100,80,80,80,100,520,0.9051724137931034,0.5
20,25,45,70,90,60,310,0.30833333333333335,60,59,85,79,105,36,424,0.16666666666666666,1.0
60,105,60,120,60,105,510,0.8849557522123894,65,80,65,35,65,60,370,0.38405797101449274,1.0
55,75,60,75,60,103,428,0.7982456140350878,65,50,35,115,95,95,455,0.7333333333333333,1.0
75,125,100,70,80,45,495,0.33035714285714285,55,69,85,32,35,28,304,0.09302325581395349,2.0
80,100,70,60,70,95,475,0.7416666666666667,60,59,85,79,105,36,424,0.16666666666666666,0.25
91,129,90,72,90,108,580,0.8536585365853658,100,120,120,150,100,90,680,0.7880794701986755,1.0
90,130,80,65,85,55,505,0.4396551724137931,45,85,70,40,40,60,340,0.5229357798165137,4.0
95,109,105,75,85,56,525,0.34513274336283184,105,95,75,85,75,74,509,0.5714285714285714,4.0
78,84,78,109,85,100,534,0.8620689655172413,55,130,115,50,50,75,475,0.5982142857142857,0.5
41,64,45,50,50,50,300,0.36752136752136755,60,55,90,145,90,80,520,0.6071428571428571,1.0
89,124,80,55,80,55,483,0.5714285714285714,82,80,86,85,75,72,480,0.6183206106870229,1.0
60,60,60,85,85,85,435,0.631578947368421,72,58,80,103,80,97,490,0.7171052631578947,2.0
45,90,20,65,20,65,305,0.5116279069767442,65,90,40,45,80,75,395,0.625,1.0
100,70,70,65,65,45,415,0.1897810218978102,40,40,40,70,40,20,250,0.032520325203252036,1.0
68,125,65,65,115,80,518,0.6277372262773723,45,55,45,65,45,75,330,0.5692307692307692,1.0
100,110,90,85,90,60,535,0.47794117647058826,55,55,55,85,55,30,335,0.1320754716981132,1.0
91,90,72,90,129,108,580,0.896,55,35,50,55,110,85,390,0.6277372262773723,0.0625
60,45,50,90,80,70,395,0.625,80,100,70,50,60,45,405,0.25806451612903225,1.0
90,120,100,150,120,100,680,0.7718120805369127,65,155,120,65,90,105,600,0.8677685950413223,1.0
60,90,70,60,120,40,440,0.27419354838709675,35,35,40,35,55,50,250,0.40336134453781514,1.0
49,66,70,44,55,51,335,0.4260869565217391,75,80,95,90,100,50,490,0.2158273381294964,0.5
49,49,56,49,61,66,330,0.5190839694656488,65,95,100,60,50,50,420,0.34959349593495936,0.5
63,63,47,41,41,74,329,0.56,50,72,35,35,35,65,292,0.5373134328358209,0.25
50,40,85,40,65,25,305,0.08870967741935484,70,50,30,95,135,105,485,0.8040540540540541,1.0
50,35,55,25,25,15,205,0.05263157894736842,40,40,35,50,100,70,335,0.5031847133757962,0.5
80,82,78,95,80,85,500,0.6869565217391305,65,90,65,61,61,100,442,0.8373983739837398,1.0
80,130,100,160,120,110,700,0.8981481481481481,90,55,75,60,75,30,385,0.13970588235294118,1.0
60,55,145,75,150,40,525,0.2,64,88,50,88,50,106,446,0.9111111111111111,1.0
86,92,88,68,75,73,482,0.6835443037974683,130,65,60,110,95,65,525,0.5227272727272727,1.0
40,55,70,45,60,30,300,0.10619469026548672,65,90,115,45,115,58,488,0.5041322314049587,1.0
75,95,60,65,60,115,470,0.8778625954198473,44,58,44,58,44,61,309,0.41964285714285715,1.0
44,58,44,58,44,61,309,0.41964285714285715,52,65,50,45,50,38,300,0.27419354838709675,0.5
80,115,80,65,55,93,488,0.7846153846153846,95,135,80,110,80,100,600,0.8248175182481752,1.0
80,110,120,130,90,70,600,0.6198347107438017,90,120,75,60,60,45,450,0.29411764705882354,1.0
115,45,20,45,25,20,270,0.11538461538461539,58,64,58,80,65,80,405,0.5423728813559322,0.5
90,120,120,60,60,50,500,0.35294117647058826,90,92,87,75,85,76,505,0.5409836065573771,2.0
70,100,70,105,75,40,460,0.23214285714285715,62,48,54,63,60,68,355,0.5178571428571429,1.0
50,85,85,55,55,50,380,0.3902439024390244,65,80,140,40,70,70,465,0.5223880597014925,0.25
109,66,84,81,99,32,471,0.2013888888888889,20,15,20,10,55,80,200,0.2682926829268293,2.0
39,52,43,60,50,65,309,0.5041322314049587,60,75,100,55,80,50,420,0.3088235294117647,2.0
70,85,65,105,85,120,530,0.9262295081967213,106,110,90,154,90,130,680,0.926829268292683,1.0
108,170,115,120,95,92,700,0.7083333333333334,76,48,48,57,62,34,325,0.11688311688311688,1.0
110,80,90,95,90,65,530,0.5033557046979866,50,53,48,53,48,64,316,0.4076923076923077,1.0
78,130,111,130,85,100,634,0.8561151079136691,40,45,40,62,60,60,307,0.33884297520661155,0.5
70,140,230,60,80,50,630,0.32432432432432434,70,84,70,65,70,51,410,0.2949640287769784,2.0
79,85,60,55,60,71,410,0.60431654676259,20,15,20,10,55,80,200,0.2682926829268293,0.5
83,106,65,86,65,85,490,0.6640625,40,60,40,40,40,30,250,0.0948905109489051,0.125
115,45,20,45,25,20,270,0.11538461538461539,50,53,48,53,48,64,316,0.358974358974359,1.0
150,120,100,120,100,90,680,0.664179104477612,60,50,40,85,75,95,405,0.7540983606557377,1.0
106,190,100,154,100,130,780,0.9259259259259259,85,50,95,120,115,80,545,0.5793650793650794,0.25
70,60,75,110,75,90,480,0.7165354330708661,44,58,44,58,44,61,309,0.41964285714285715,0.5
45,75,37,70,55,83,365,0.6183206106870229,60,50,70,80,80,140,480,0.8449612403100775,1.0
65,65,45,75,45,95,390,0.72,75,80,60,65,90,102,472,0.8625954198473282,1.0
65,130,60,75,60,75,465,0.689922480620155,50,70,50,50,50,40,310,0.16296296296296298,1.0
65,65,65,50,50,90,385,0.72,50,45,45,35,35,50,260,0.23529411764705882,1.0
80,125,75,40,95,85,500,0.6911764705882353,80,90,80,130,110,110,600,0.856,1.0
75,87,63,87,63,98,473,0.865546218487395,65,130,60,75,60,75,465,0.689922480620155,1.0
58,50,145,95,105,30,483,0.2459016393442623,40,80,100,30,30,20,300,0.11851851851851852,1.0
45,60,32,50,32,76,295,0.5925925925925926,20,15,20,10,55,80,200,0.2682926829268293,2.0
65,150,60,115,60,115,565,0.935251798561151,90,30,15,40,20,15,210,0.043478260869565216,0.5
68,65,65,125,115,80,518,0.6461538461538462,75,95,60,65,60,115,470,0.8778625954198473,1.0
103,60,126,80,126,50,545,0.36363636363636365,42,52,67,39,56,50,306,0.2868217054263566,0.5
55,65,95,95,45,85,440,0.6610169491525424,170,90,45,90,45,60,500,0.427536231884058,0.5
90,92,75,92,85,60,494,0.49586776859504134,75,55,70,55,95,110,460,0.8444444444444444,1.0
95,95,85,125,65,55,520,0.3894736842105263,100,90,130,45,65,55,485,0.4253731343283582,4.0
50,50,40,50,40,64,294,0.45588235294117646,68,165,95,65,115,110,618,0.8615384615384616,1.0
60,95,80,60,80,30,405,0.19480519480519481,74,48,76,83,81,104,466,0.7322834645669292,2.0
30,56,35,25,35,72,253,0.48148148148148145,90,75,85,115,90,55,510,0.3445378151260504,1.0
60,45,70,75,85,55,390,0.3008130081300813,90,95,95,70,90,70,510,0.5230769230769231,1.0
55,85,122,58,75,99,494,0.8099173553719008,70,92,65,80,55,98,460,0.8090909090909091,2.0
80,145,150,105,110,110,700,0.8692307692307693,115,115,85,90,75,100,580,0.8134328358208955,0.5
82,80,86,85,75,72,480,0.6183206106870229,64,78,52,78,52,81,405,0.6422764227642277,1.0
95,70,73,95,90,60,483,0.3983739837398374,55,45,50,45,65,80,340,0.5546218487394958,1.0
69,55,45,55,55,15,294,0.11666666666666667,115,45,20,45,25,20,270,0.11538461538461539,2.0
65,90,50,85,45,55,390,0.371900826446281,100,164,150,95,120,71,700,0.5645161290322581,1.0
30,45,135,45,90,30,375,0.09285714285714286,50,180,20,180,20,150,600,0.9029850746268657,1.0
80,100,200,50,100,50,580,0.3472222222222222,70,80,102,80,102,40,474,0.2677165354330709,4.0
85,115,80,105,80,50,515,0.3063063063063063,60,75,85,100,85,115,520,0.8992248062015504,2.0
61,90,45,50,50,160,456,0.9230769230769231,70,105,105,50,40,20,390,0.33587786259541985,0.5
66,65,48,62,57,52,350,0.36220472440944884,50,70,50,50,50,40,310,0.16296296296296298,2.0
70,120,100,145,105,20,560,0.2824427480916031,95,75,110,100,80,30,490,0.15267175572519084,0.5
60,25,35,70,80,60,330,0.3076923076923077,125,130,90,130,90,95,660,0.7734375,1.0
60,60,60,105,105,105,495,0.848,71,73,88,120,89,59,500,0.43537414965986393,1.0
80,130,100,160,120,110,700,0.8981481481481481,50,95,95,35,110,70,455,0.5179856115107914,1.0
65,70,60,65,65,115,440,0.8583333333333333,40,45,40,65,40,65,295,0.5661764705882353,1.0
45,100,45,45,45,10,290,0.2949640287769784,55,75,85,25,25,15,280,0.1875,2.0
68,125,65,65,115,80,518,0.6277372262773723,55,104,105,94,75,52,485,0.36363636363636365,1.0
100,77,77,128,128,90,600,0.6901408450704225,58,109,112,48,48,109,484,0.8805970149253731,0.25
90,85,100,95,125,85,580,0.6834532374100719,60,75,85,100,85,115,520,0.8992248062015504,0.5
55,55,55,85,55,30,335,0.1320754716981132,51,65,65,80,75,59,395,0.4365079365079365,1.0
53,54,53,37,46,45,288,0.3090909090909091,40,35,30,120,70,105,400,0.6692307692307692,1.0
55,70,55,40,55,85,360,0.7073170731707317,70,94,50,94,50,66,424,0.48148148148148145,1.0
78,130,111,130,85,100,634,0.8561151079136691,80,82,78,95,80,85,500,0.6869565217391305,0.5
38,35,40,27,25,35,200,0.08208955223880597,50,75,45,40,45,60,315,0.4380165289256198,1.0
75,95,122,58,75,69,494,0.5725806451612904,78,92,75,74,63,118,500,0.8842975206611571,0.5
105,150,90,150,90,95,680,0.8285714285714286,80,85,95,30,30,25,345,0.2857142857142857,0.5
85,110,90,45,90,80,500,0.6206896551724138,70,110,75,145,85,145,630,0.9444444444444444,1.0
40,60,30,31,31,70,262,0.4492753623188406,70,50,30,95,135,105,485,0.8040540540540541,1.0
150,120,100,120,100,90,680,0.664179104477612,77,120,90,60,90,48,485,0.2785714285714286,2.0
66,41,77,61,87,23,355,0.12096774193548387,45,75,37,70,55,83,365,0.6183206106870229,1.0
100,103,75,120,75,127,600,0.940677966101695,55,70,55,40,55,85,360,0.7073170731707317,1.0
60,110,70,60,60,100,460,0.8461538461538461,60,65,70,85,75,40,395,0.21705426356589147,2.0
45,67,60,35,50,63,320,0.5128205128205128,40,65,40,80,40,65,330,0.5038167938931297,1.0
55,47,52,40,40,41,275,0.16806722689075632,70,80,65,90,65,85,455,0.578125,1.0
125,120,90,170,100,95,700,0.78125,115,140,130,55,55,40,535,0.4519230769230769,2.0
30,30,42,30,42,70,244,0.4230769230769231,45,30,50,55,65,45,290,0.208,2.0
70,115,60,115,60,55,475,0.4647887323943662,101,72,72,99,89,29,462,0.1937984496124031,0.5
55,81,60,50,70,97,413,0.7214285714285714,80,100,80,80,80,100,520,0.9051724137931034,1.0
65,130,60,95,110,65,525,0.5303030303030303,80,82,100,83,100,80,525,0.6821705426356589,2.0
59,110,150,45,49,35,448,0.3333333333333333,45,100,135,65,135,45,525,0.29411764705882354,2.0
79,115,70,125,80,111,580,0.864,67,125,40,30,30,58,350,0.3431372549019608,0.5
65,95,57,100,85,93,495,0.7441860465116279,170,90,45,90,45,60,500,0.427536231884058,0.5
40,60,30,31,31,70,262,0.4492753623188406,80,100,200,50,100,50,580,0.3472222222222222,0.25
60,69,95,69,95,36,424,0.2608695652173913,50,160,110,160,110,110,700,0.8854961832061069,0.5
20,10,55,15,20,80,200,0.17985611510791366,80,100,70,50,60,45,405,0.25806451612903225,1.0
100,70,70,65,65,45,415,0.1897810218978102,71,95,85,110,95,79,535,0.664,1.0
81,102,77,85,75,85,505,0.5642857142857143,44,38,39,61,79,42,303,0.2251655629139073,2.0
79,115,70,125,80,111,580,0.864,63,120,85,90,55,55,468,0.2809917355371901,2.0
60,48,45,43,90,42,328,0.21897810218978103,90,60,60,40,40,40,330,0.29545454545454547,2.0
55,75,85,25,25,15,280,0.1875,130,70,35,70,35,60,400,0.4017857142857143,1.0
70,105,105,50,40,20,390,0.33587786259541985,100,150,90,180,160,90,770,0.7348484848484849,1.0
80,100,123,122,120,80,625,0.56,126,131,95,131,98,99,680,0.8102189781021898,0.5
45,67,60,35,50,63,320,0.5128205128205128,45,49,65,49,65,45,318,0.275,0.5
45,50,43,40,38,62,278,0.40441176470588236,90,120,120,60,60,50,500,0.35294117647058826,1.0
70,100,70,105,75,40,460,0.23214285714285715,110,85,95,80,95,50,515,0.2713178294573643,1.0
75,100,63,80,63,116,497,0.9345794392523364,80,135,85,70,95,150,615,0.9844961240310077,2.0
70,120,65,45,85,125,510,0.9747899159663865,60,40,50,75,85,95,405,0.6044776119402985,1.0
55,130,115,50,50,75,475,0.5982142857142857,90,100,70,110,150,80,600,0.6037735849056604,0.5
70,135,105,60,105,20,495,0.5806451612903226,59,45,40,35,40,31,250,0.14285714285714285,1.0
68,65,65,125,115,80,518,0.6461538461538462,100,110,90,85,90,60,535,0.47794117647058826,2.0
76,48,48,57,62,34,325,0.11688311688311688,115,140,130,55,55,40,535,0.4519230769230769,4.0
100,100,100,100,100,100,600,0.831858407079646,55,55,45,63,45,45,308,0.25,1.0
114,85,70,85,80,30,464,0.2066115702479339,45,55,45,65,45,75,330,0.5692307692307692,0.5
80,120,80,120,80,100,580,0.8478260869565217,20,10,230,10,230,5,505,0.0,1.0
50,50,77,95,77,91,440,0.5916666666666667,40,55,80,35,60,30,300,0.15037593984962405,2.0
44,38,33,61,43,70,289,0.5267857142857143,58,89,77,45,45,48,362,0.3177570093457944,0.25
61,78,95,56,58,57,405,0.40336134453781514,65,45,55,45,70,45,325,0.24369747899159663,2.0
50,25,28,45,55,15,218,0.0625,100,100,100,100,100,100,600,0.8602941176470589,1.0
50,48,43,46,41,60,288,0.47297297297297297,71,120,95,120,95,99,600,0.8203125,1.0
84,86,88,111,101,60,530,0.4634146341463415,84,71,43,71,43,48,360,0.25874125874125875,1.0
40,40,35,50,100,70,335,0.5031847133757962,45,100,135,65,135,45,525,0.29411764705882354,0.5
71,73,88,120,89,59,500,0.43537414965986393,116,55,85,107,95,29,487,0.06818181818181818,1.0
75,95,60,65,60,115,470,0.8778625954198473,55,81,60,50,70,97,413,0.7214285714285714,1.0
65,75,90,97,123,44,494,0.1987179487179487,83,80,75,70,70,101,479,0.8615384615384616,1.0
64,51,23,51,23,28,240,0.11363636363636363,80,105,65,60,75,130,515,0.9645390070921985,0.5
45,100,135,65,135,45,525,0.29411764705882354,70,110,75,145,85,145,630,0.9444444444444444,1.0
103,60,126,80,126,50,545,0.36363636363636365,45,30,40,105,50,20,290,0.031007751937984496,1.0
70,80,50,35,35,35,305,0.14,70,95,85,55,65,70,440,0.5,1.0
55,47,52,40,40,41,275,0.16806722689075632,70,60,70,87,78,85,450,0.6228070175438597,2.0
65,90,120,85,70,60,490,0.43410852713178294,120,70,120,75,130,85,600,0.6694915254237288,1.0
60,62,50,62,60,40,334,0.18181818181818182,125,58,58,76,76,67,460,0.515625,1.0
115,140,130,55,55,40,535,0.4519230769230769,70,60,62,80,82,60,414,0.4375,0.0
70,65,60,90,75,90,450,0.6571428571428571,60,100,89,55,69,112,485,0.9298245614035088,0.25
80,120,80,120,80,100,580,0.8478260869565217,55,50,65,175,95,150,590,0.7818181818181819,1.0
78,84,78,109,85,100,534,0.8620689655172413,70,80,102,80,102,40,474,0.2677165354330709,2.0
60,60,75,60,75,80,410,0.7321428571428571,55,81,60,50,70,97,413,0.7214285714285714,2.0
90,100,90,125,85,90,580,0.7352941176470589,55,75,60,75,60,103,428,0.7982456140350878,0.5
50,50,120,80,80,30,410,0.07258064516129033,68,90,65,50,55,82,410,0.6165413533834586,0.25
45,75,60,40,30,50,300,0.304,60,115,105,65,70,80,495,0.7181818181818181,1.0
50,75,35,70,30,40,300,0.21296296296296297,50,40,85,40,65,25,305,0.08870967741935484,0.5
50,50,150,50,150,50,500,0.2571428571428571,77,85,51,55,51,65,384,0.5163934426229508,2.0
90,55,75,60,75,30,385,0.13970588235294118,69,55,45,55,55,15,294,0.11666666666666667,1.0
30,30,42,30,42,70,244,0.4230769230769231,74,48,76,83,81,104,466,0.7322834645669292,2.0
50,50,62,40,62,65,329,0.4188034188034188,55,55,55,85,55,30,335,0.1320754716981132,1.0
115,115,85,90,75,100,580,0.8134328358208955,60,45,50,90,80,70,395,0.625,2.0
45,20,50,60,120,50,345,0.24074074074074073,20,40,15,35,35,60,205,0.34285714285714286,0.5
55,65,35,60,30,85,330,0.6126126126126126,40,30,30,55,30,85,270,0.4666666666666667,0.5
80,92,65,65,80,68,450,0.4824561403508772,91,134,95,100,100,80,600,0.6304347826086957,0.5
35,80,50,50,70,120,405,0.84375,75,125,230,55,95,30,610,0.3448275862068966,2.0
55,55,55,85,55,30,335,0.1320754716981132,59,63,80,65,80,58,405,0.41843971631205673,1.0
63,60,55,50,50,71,349,0.5289256198347108,95,85,85,65,65,35,430,0.2571428571428571,1.0
63,60,55,50,50,71,349,0.5289256198347108,91,90,129,90,72,108,580,0.9140625,0.5
60,62,80,63,80,60,405,0.4336283185840708,75,85,200,55,65,30,510,0.16778523489932887,1.0
80,125,75,40,95,85,500,0.6911764705882353,45,60,32,50,32,76,295,0.5925925925925926,1.0
55,104,105,94,75,52,485,0.36363636363636365,1,90,45,30,30,40,236,0.33064516129032256,1.0
60,45,70,75,85,55,390,0.3008130081300813,55,65,35,60,30,85,330,0.6126126126126126,1.0
65,75,70,95,70,95,470,0.7272727272727273,75,98,63,98,63,101,498,0.889763779527559,1.0
60,40,60,40,60,35,295,0.18055555555555555,66,65,48,62,57,52,350,0.36220472440944884,0.5
60,85,69,65,79,80,438,0.576,60,65,80,170,95,130,600,0.8625954198473282,0.25
60,85,69,60,69,77,420,0.518796992481203,75,75,55,105,85,30,425,0.1619718309859155,1.0
50,95,90,95,90,180,600,0.9172413793103448,46,87,60,30,40,57,320,0.37777777777777777,1.0
50,52,48,65,50,55,320,0.33098591549295775,35,55,35,30,30,35,220,0.23684210526315788,1.0
44,38,33,61,43,70,289,0.5267857142857143,100,100,100,100,100,100,600,0.8345864661654135,0.5
70,140,70,110,65,105,560,0.95,65,80,140,40,70,70,465,0.5223880597014925,1.0
70,77,60,97,60,108,472,0.8394160583941606,50,70,100,40,40,30,330,0.2222222222222222,0.5
45,60,32,50,32,76,295,0.5925925925925926,30,42,118,42,88,30,350,0.112,1.0
83,106,65,86,65,85,490,0.6640625,85,110,90,45,90,80,500,0.6206896551724138,2.0
100,50,50,76,96,70,442,0.5,91,129,90,72,90,108,580,0.8536585365853658,0.5
35,55,40,45,40,60,275,0.35714285714285715,60,90,55,90,80,110,485,0.8677685950413223,0.5
75,90,90,140,90,115,600,0.9481481481481482,60,115,105,65,70,80,495,0.7181818181818181,0.25
82,121,119,69,59,71,521,0.5394736842105263,35,20,65,40,65,20,245,0.02459016393442623,0.0
60,62,80,63,80,60,405,0.4336283185840708,40,40,50,30,30,30,220,0.0873015873015873,0.5
95,80,105,40,70,100,490,0.8046875,80,92,65,65,80,68,450,0.4824561403508772,1.0
65,55,115,100,40,60,435,0.3798449612403101,58,70,45,40,45,42,300,0.25925925925925924,1.0
89,125,90,115,80,101,600,0.8725490196078431,55,69,85,32,35,28,304,0.09302325581395349,1.0
45,49,49,65,65,45,318,0.2781954887218045,79,105,70,145,80,101,580,0.8608695652173913,0.5
100,110,90,85,90,60,535,0.47794117647058826,60,69,95,69,95,36,424,0.2608695652173913,1.0
190,33,58,33,58,33,405,0.13432835820895522,130,85,80,85,95,60,535,0.43884892086330934,1.0
90,75,75,90,100,70,500,0.5462184873949579,79,103,120,135,115,78,630,0.5763888888888888,0.5
90,60,60,40,40,40,330,0.29545454545454547,25,20,15,105,55,90,310,0.32407407407407407,1.0
70,60,70,87,78,85,450,0.6228070175438597,50,47,50,57,50,65,319,0.463768115942029,0.5
75,125,75,30,75,85,465,0.625,80,135,85,70,95,150,615,0.9844961240310077,1.0
85,70,80,97,80,123,535,0.9304347826086956,111,83,68,92,82,39,475,0.1774193548387097,1.0
55,75,60,75,60,103,428,0.7982456140350878,51,65,65,80,75,59,395,0.4365079365079365,1.0
78,92,75,74,63,118,500,0.8842975206611571,40,50,45,70,45,70,320,0.5517241379310345,0.25
40,65,95,60,45,35,340,0.13986013986013987,89,145,90,105,80,91,600,0.8549618320610687,0.5
78,84,78,109,85,100,534,0.8646616541353384,101,72,72,99,89,29,462,0.1937984496124031,1.0
49,49,56,49,61,66,330,0.5190839694656488,80,100,70,60,70,95,475,0.7416666666666667,0.5
68,165,95,65,115,110,618,0.8615384615384616,80,70,40,100,60,145,495,0.921875,0.5
64,78,52,78,52,81,405,0.6422764227642277,95,95,85,125,65,55,520,0.3894736842105263,1.0
105,140,95,55,65,45,505,0.3,60,60,50,40,50,75,335,0.5882352941176471,2.0
62,55,52,109,94,109,481,0.7833333333333333,55,95,55,35,75,115,430,0.9380530973451328,1.0
60,90,140,50,50,40,430,0.2535211267605634,45,55,45,65,45,75,330,0.5692307692307692,8.0
50,65,107,105,107,86,520,0.7758620689655172,40,40,35,50,100,70,335,0.5031847133757962,1.0
120,120,120,120,120,120,720,0.9344262295081968,45,85,50,55,50,65,350,0.5076923076923077,1.0
75,103,80,70,80,92,500,0.7933884297520661,60,50,150,50,150,60,520,0.5206611570247934,0.125
106,190,100,154,100,130,780,0.9259259259259259,60,40,80,60,45,40,325,0.23529411764705882,0.25
91,90,106,130,106,77,600,0.648854961832061,65,110,130,60,65,95,525,0.8278145695364238,2.0
90,93,55,70,55,55,418,0.3819444444444444,65,80,65,35,65,60,370,0.38405797101449274,2.0
55,55,85,65,85,35,380,0.2014388489208633,90,60,60,40,40,40,330,0.29545454545454547,1.0
60,50,100,85,70,65,430,0.47580645161290325,95,80,105,40,70,100,490,0.8046875,1.0
71,95,85,110,95,79,535,0.664,68,65,65,125,115,80,518,0.6461538461538462,1.0
74,48,76,83,81,104,466,0.7322834645669292,108,130,95,80,85,102,600,0.7637795275590551,2.0
95,75,80,100,110,30,490,0.24242424242424243,45,30,50,65,50,45,285,0.13821138211382114,0.5
60,65,70,85,75,40,395,0.21705426356589147,70,90,90,135,90,125,600,0.9401709401709402,1.0
70,85,70,60,70,50,405,0.28378378378378377,40,55,80,35,60,30,300,0.15037593984962405,2.0
44,50,91,24,86,10,305,0.1981981981981982,70,60,62,80,82,60,414,0.4375,0.25
64,66,68,81,76,50,405,0.25190839694656486,75,95,67,125,95,83,540,0.7117117117117117,2.0
59,59,58,90,70,73,409,0.5826086956521739,39,52,43,60,50,65,309,0.5041322314049587,0.5
100,50,80,60,80,50,420,0.34375,65,130,60,75,60,75,465,0.689922480620155,2.0
70,55,75,45,65,60,370,0.45901639344262296,75,55,70,55,95,110,460,0.8444444444444444,2.0
70,94,50,94,50,66,424,0.48148148148148145,45,75,60,40,30,50,300,0.304,1.0
60,60,75,60,75,80,410,0.7321428571428571,75,125,230,55,95,30,610,0.3448275862068966,2.0
70,60,62,80,82,60,414,0.4375,75,100,110,45,55,65,450,0.5333333333333333,1.0
95,135,80,110,80,100,600,0.8248175182481752,75,100,63,80,63,116,497,0.9345794392523364,0.5
75,105,75,105,75,45,480,0.3274336283185841,91,90,72,90,129,108,580,0.896,0.5
85,90,80,70,80,130,535,0.9262295081967213,75,75,60,83,60,60,413,0.39344262295081966,1.0
160,110,65,65,110,30,540,0.35714285714285715,50,105,79,35,110,76,455,0.6214285714285714,1.0
85,105,85,40,50,40,405,0.211864406779661,75,105,75,105,75,45,480,0.3274336283185841,1.0
150,80,44,90,54,80,498,0.625,80,82,78,95,80,85,500,0.6869565217391305,1.0
70,77,60,97,60,108,472,0.8394160583941606,55,112,45,74,45,70,401,0.559322033898305,1.0
100,180,160,150,90,90,770,0.7520661157024794,68,125,65,65,115,80,518,0.6277372262773723,1.0
72,95,67,103,71,122,530,0.9606299212598425,55,40,40,65,45,35,280,0.16428571428571428,1.0
100,100,100,100,100,100,600,0.8345864661654135,50,50,40,30,30,50,250,0.2781954887218045,4.0
76,104,71,104,71,108,534,0.912751677852349,40,45,35,30,40,55,245,0.3793103448275862,0.25
50,75,70,35,70,48,348,0.29357798165137616,60,40,60,40,60,35,295,0.18055555555555555,1.0
60,82,45,45,45,74,351,0.5752212389380531,125,130,90,130,90,95,660,0.7734375,1.0
75,38,38,56,56,67,330,0.5263157894736842,70,150,140,65,100,75,600,0.55,1.0
55,75,50,40,40,80,340,0.6302521008403361,80,100,200,50,100,50,580,0.3472222222222222,0.25
123,77,72,99,92,58,521,0.4621212121212121,75,95,122,58,75,69,494,0.5725806451612904,2.0
30,30,30,30,30,30,180,0.12612612612612611,110,130,80,70,60,80,530,0.5862068965517241,2.0
40,45,35,30,40,55,245,0.3793103448275862,55,65,95,95,45,85,440,0.6610169491525424,1.0
70,95,125,65,75,45,475,0.33613445378151263,85,105,85,40,50,40,405,0.211864406779661,0.25
90,30,15,40,20,15,210,0.043478260869565216,60,60,75,60,75,80,410,0.7321428571428571,2.0
60,60,40,65,45,35,305,0.15833333333333333,85,80,70,135,75,90,535,0.7006802721088435,1.0
65,90,65,61,61,100,442,0.8373983739837398,150,120,100,120,100,90,680,0.664179104477612,0.0
106,130,90,110,154,90,680,0.719626168224299,30,35,30,100,35,80,310,0.4765625,1.0
40,60,40,40,40,30,250,0.0948905109489051,103,60,86,60,86,50,445,0.3458646616541353,1.0
60,95,80,60,80,30,405,0.19480519480519481,108,130,95,80,85,102,600,0.7637795275590551,1.0
70,20,50,20,50,40,250,0.1557377049180328,80,130,100,160,120,110,700,0.8981481481481481,1.0
75,80,85,110,90,50,490,0.3548387096774194,190,33,58,33,58,33,405,0.13432835820895522,1.0
78,70,61,50,61,100,420,0.8145161290322581,50,120,53,35,110,87,455,0.640625,1.0
79,115,70,125,80,111,580,0.8468468468468469,100,50,80,60,80,50,420,0.34375,1.0
50,85,40,85,40,35,335,0.1746031746031746,60,50,150,50,150,60,520,0.5206611570247934,0.5
50,47,50,57,50,65,319,0.463768115942029,55,55,55,85,55,30,335,0.1320754716981132,2.0
90,30,15,40,20,15,210,0.043478260869565216,50,75,70,35,70,48,348,0.29357798165137616,4.0
64,66,68,81,76,50,405,0.25190839694656486,54,45,47,75,98,52,371,0.39669421487603307,1.0
60,67,85,77,75,116,480,0.8888888888888888,70,85,140,85,70,20,470,0.272,0.25
90,60,70,75,70,45,410,0.23880597014925373,59,66,70,44,55,41,335,0.25190839694656486,1.0
125,120,90,170,100,95,700,0.78125,75,100,63,80,63,116,497,0.9345794392523364,1.0
30,45,135,45,90,30,375,0.09285714285714286,55,95,55,35,75,115,430,0.9380530973451328,2.0
86,68,72,109,66,106,507,0.8099173553719008,38,36,38,32,36,57,237,0.3893805309734513,1.0
60,80,110,50,80,45,425,0.2833333333333333,55,69,85,32,35,28,304,0.09302325581395349,1.0
85,110,90,45,90,80,500,0.6206896551724138,51,65,65,80,75,59,395,0.4365079365079365,1.0
60,60,50,40,50,75,335,0.5882352941176471,108,130,95,80,85,102,600,0.7637795275590551,1.0
80,110,120,130,90,70,600,0.6198347107438017,40,35,30,120,70,105,400,0.6692307692307692,1.0
79,103,120,135,115,78,630,0.5763888888888888,100,77,77,128,128,90,600,0.6901408450704225,1.0
75,98,63,98,63,101,498,0.849624060150376,50,50,77,95,77,91,440,0.5916666666666667,1.0
100,100,125,110,50,50,535,0.384,35,85,45,35,35,75,310,0.6492537313432836,0.5
255,10,10,75,135,55,540,0.3125,150,120,100,120,100,90,680,0.664179104477612,0.0
62,50,58,73,54,72,369,0.4435483870967742,60,100,89,55,69,112,485,0.9298245614035088,2.0
60,80,50,40,40,30,300,0.15328467153284672,35,35,40,35,55,50,250,0.40336134453781514,1.0
70,85,140,85,70,20,470,0.272,85,80,70,135,75,90,535,0.7006802721088435,1.0
35,55,40,45,40,60,275,0.35714285714285715,74,94,131,54,116,20,489,0.4485294117647059,0.5
50,85,125,85,115,20,480,0.4306569343065693,55,70,40,60,40,40,305,0.26956521739130435,1.0
65,75,70,95,70,95,470,0.7272727272727273,100,73,83,73,83,55,467,0.371900826446281,2.0
100,5,5,15,65,30,220,0.07692307692307693,80,105,105,105,105,80,580,0.5939849624060151,1.0
50,70,100,40,40,30,330,0.2222222222222222,65,83,57,95,85,105,490,0.8914728682170543,0.5
85,80,70,135,75,90,535,0.7006802721088435,91,129,90,72,90,108,580,0.8536585365853658,0.5
100,150,140,100,90,90,670,0.7969924812030075,55,45,45,25,25,15,210,0.048,1.0
55,75,60,75,60,103,428,0.7982456140350878,35,35,40,35,55,50,250,0.40336134453781514,2.0
60,45,70,75,85,55,390,0.3008130081300813,125,170,100,120,90,95,700,0.77,1.0
130,65,60,110,95,65,525,0.5227272727272727,60,45,70,45,90,95,405,0.7304964539007093,1.0
73,95,62,85,65,85,465,0.6666666666666666,40,65,95,60,45,35,340,0.13986013986013987,1.0
65,155,120,65,90,105,600,0.8677685950413223,70,20,50,20,50,40,250,0.1557377049180328,0.5
95,23,48,23,48,23,260,0.046153846153846156,60,70,105,70,120,75,500,0.5983606557377049,1.0
92,105,90,125,90,98,600,0.8217054263565892,91,72,90,129,90,108,580,0.8620689655172413,0.5
110,80,90,95,90,65,530,0.5033557046979866,65,95,57,100,85,93,495,0.7441860465116279,1.0
60,80,110,50,80,45,425,0.2833333333333333,76,147,90,60,70,97,540,0.8267716535433071,1.0
95,145,130,120,90,120,700,0.9398496240601504,85,135,130,60,80,25,515,0.40540540540540543,0.5
95,70,73,95,90,60,483,0.3983739837398374,72,105,115,54,86,68,500,0.5149253731343284,1.0
76,25,45,67,55,24,292,0.0390625,150,100,120,100,120,90,680,0.6666666666666666,1.0
80,92,65,65,80,68,450,0.4824561403508772,35,55,40,50,50,90,320,0.6838235294117647,1.0
50,53,48,53,48,64,316,0.4076923076923077,45,75,37,70,55,83,365,0.6183206106870229,0.5
70,92,65,80,55,98,460,0.8090909090909091,70,80,70,80,70,110,480,0.6594202898550725,1.0
60,75,100,55,80,50,420,0.3088235294117647,40,30,35,45,40,55,245,0.31496062992125984,1.0
50,50,120,80,80,30,410,0.07258064516129033,55,75,85,25,25,15,280,0.1875,0.5
55,81,60,50,70,97,413,0.7214285714285714,30,105,90,25,25,50,325,0.2773722627737226,1.0
105,140,95,55,65,45,505,0.3,103,60,86,60,86,50,445,0.3458646616541353,2.0
65,45,55,45,70,45,325,0.24369747899159663,95,23,48,23,48,23,260,0.046153846153846156,1.0
75,75,130,75,130,95,580,0.7479674796747967,50,95,90,95,90,180,600,0.9172413793103448,0.5
45,63,37,65,55,95,360,0.8055555555555556,80,145,150,105,110,110,700,0.8692307692307693,1.0
45,30,15,85,65,65,305,0.36220472440944884,65,83,57,95,85,105,490,0.8914728682170543,1.0
40,70,130,60,130,25,455,0.17355371900826447,65,125,100,55,70,85,500,0.6532258064516129,1.0
80,95,82,60,82,75,474,0.6,105,140,55,30,55,95,480,0.8195488721804511,1.0
68,165,95,65,115,110,618,0.8615384615384616,55,45,43,55,43,72,313,0.5853658536585366,0.125
65,50,35,115,95,95,455,0.7333333333333333,50,70,100,40,40,30,330,0.2222222222222222,0.25
76,25,45,67,55,24,292,0.0390625,60,75,100,55,80,50,420,0.3088235294117647,0.25
45,60,32,50,32,76,295,0.5925925925925926,50,65,45,85,65,95,405,0.7238095238095238,0.5
40,80,100,30,30,20,300,0.11851851851851852,70,77,60,97,60,108,472,0.8394160583941606,2.0
80,100,80,80,80,100,520,0.9051724137931034,40,70,130,60,130,25,455,0.17355371900826447,1.0
89,124,80,55,80,55,483,0.5714285714285714,100,100,125,110,50,50,535,0.384,0.5
78,65,68,112,154,75,552,0.628099173553719,55,40,40,65,45,35,280,0.16428571428571428,1.0
50,75,75,65,65,50,380,0.4049586776859504,50,105,79,35,110,76,455,0.6214285714285714,0.5
45,60,40,70,50,45,310,0.2846715328467153,80,115,80,65,55,93,488,0.7846153846153846,1.0
79,115,70,125,80,111,580,0.864,70,135,105,60,105,20,495,0.5806451612903226,1.0
110,123,65,100,65,65,528,0.5217391304347826,71,95,85,110,95,79,535,0.664,4.0
39,52,43,60,50,65,309,0.5041322314049587,90,30,15,40,20,15,210,0.043478260869565216,1.0
78,130,111,130,85,100,634,0.8561151079136691,36,50,50,65,60,44,305,0.16363636363636364,2.0
50,60,60,60,60,30,320,0.11290322580645161,65,73,55,47,75,85,400,0.6846846846846847,1.0
105,125,100,60,100,100,590,0.8359375,30,40,55,40,55,60,280,0.3237410071942446,1.0
72,95,67,103,71,122,530,0.9606299212598425,64,78,52,78,52,81,405,0.6422764227642277,1.0
70,60,75,110,75,90,480,0.7165354330708661,70,110,75,145,85,145,630,0.9444444444444444,0.25
65,50,35,115,95,95,455,0.7333333333333333,31,45,90,30,30,40,266,0.21929824561403508,4.0
80,82,83,100,100,80,525,0.6742424242424242,70,85,70,60,70,50,405,0.28378378378378377,2.0
65,40,70,80,140,70,465,0.5954198473282443,60,40,60,40,60,35,295,0.18055555555555555,1.0
85,80,90,105,95,60,515,0.49074074074074076,100,70,70,65,65,45,415,0.1897810218978102,1.0
55,95,115,45,45,35,390,0.2116788321167883,60,45,50,90,80,70,395,0.625,0.0
60,105,60,120,60,105,510,0.8849557522123894,60,90,140,50,50,40,430,0.2535211267605634,1.0
90,100,90,125,85,90,580,0.7352941176470589,50,95,95,35,110,70,455,0.5179856115107914,2.0
60,59,85,79,105,36,424,0.16666666666666666,75,80,60,65,90,102,472,0.8625954198473282,1.0
65,75,70,95,70,95,470,0.7272727272727273,45,100,135,65,135,45,525,0.29411764705882354,1.0
70,65,65,55,55,70,380,0.5,45,30,50,55,65,45,290,0.208,1.0
120,70,120,75,130,85,600,0.6694915254237288,105,130,120,45,45,40,485,0.4444444444444444,2.0
50,65,64,44,48,43,314,0.2196969696969697,115,45,20,45,25,20,270,0.11538461538461539,1.0
70,80,102,80,102,40,474,0.2677165354330709,91,90,129,90,72,108,580,0.9140625,0.25
62,73,55,56,52,84,382,0.7244094488188977,120,100,85,30,85,45,465,0.22448979591836735,2.0
45,45,55,45,55,63,308,0.4594594594594595,65,65,60,130,95,110,525,0.823943661971831,1.0
79,100,80,110,90,121,580,0.968,74,48,76,83,81,104,466,0.7322834645669292,1.0
86,76,86,116,56,95,515,0.7982456140350878,50,20,55,25,25,30,205,0.09774436090225563,2.0
85,80,90,105,95,60,515,0.49074074074074076,75,75,75,125,95,40,485,0.15671641791044777,1.0
62,77,62,50,42,65,358,0.4838709677419355,90,130,80,65,85,55,505,0.4396551724137931,2.0
99,68,83,72,87,51,460,0.417910447761194,68,65,65,125,115,80,518,0.6461538461538462,1.0
103,60,126,80,126,50,545,0.36363636363636365,80,80,80,80,80,80,480,0.5606060606060606,1.0
30,30,30,30,30,30,180,0.12612612612612611,100,5,5,15,65,30,220,0.07692307692307693,1.0
10,55,25,35,45,95,265,0.5396825396825397,104,91,63,91,73,68,490,0.5118110236220472,1.0
50,180,20,180,20,150,600,0.9029850746268657,45,80,100,35,37,28,325,0.3125,0.5
64,165,75,93,83,75,555,0.6587301587301587,68,72,78,38,42,32,330,0.23809523809523808,1.0
77,59,50,67,63,46,362,0.23140495867768596,90,95,95,70,90,70,510,0.5230769230769231,0.25
50,105,79,35,110,76,455,0.6214285714285714,55,40,50,65,85,40,335,0.3181818181818182,0.0
75,140,65,112,65,110,567,0.9140625,50,50,40,50,40,64,294,0.45588235294117646,1.0
100,150,140,100,90,90,670,0.7969924812030075,73,76,75,81,100,100,505,0.8110236220472441,2.0
70,62,67,55,55,56,365,0.38513513513513514,135,85,40,40,85,5,390,0.6864406779661016,1.0
45,50,43,40,38,62,278,0.40441176470588236,46,57,40,40,40,50,273,0.25,1.0
64,51,23,51,23,28,240,0.11363636363636363,40,30,50,55,55,100,330,0.584070796460177,1.0
75,100,95,40,70,110,490,0.8717948717948718,60,95,80,60,80,30,405,0.19480519480519481,1.0
40,35,30,20,20,50,195,0.23423423423423423,62,55,52,109,94,109,481,0.7833333333333333,1.0
55,55,50,45,65,55,325,0.37373737373737376,91,90,106,130,106,77,600,0.648854961832061,0.5
65,80,80,59,63,58,405,0.4411764705882353,43,70,48,50,60,38,309,0.2391304347826087,0.5
48,72,48,72,48,48,336,0.25984251968503935,76,48,48,57,62,34,325,0.11688311688311688,1.0
40,45,40,35,35,56,251,0.373015873015873,79,85,60,55,60,71,410,0.60431654676259,1.0
89,145,90,105,80,91,600,0.8549618320610687,45,30,40,105,50,20,290,0.031007751937984496,1.0
45,45,35,20,30,20,195,0.07246376811594203,69,69,76,69,86,91,460,0.6554621848739496,1.0
71,95,85,110,95,79,535,0.664,86,92,88,68,75,73,482,0.6835443037974683,1.0
77,59,50,67,63,46,362,0.23140495867768596,20,10,55,15,20,80,200,0.17985611510791366,0.5
86,81,97,81,107,43,495,0.203125,80,100,70,50,60,45,405,0.25806451612903225,0.5
60,80,50,50,50,40,330,0.23853211009174313,65,83,57,95,85,105,490,0.8914728682170543,1.0
91,90,106,130,106,77,600,0.648854961832061,70,80,70,80,70,110,480,0.6594202898550725,4.0
45,45,35,20,30,20,195,0.07246376811594203,45,25,50,25,25,35,205,0.13076923076923078,0.5
40,40,50,30,30,30,220,0.0873015873015873,50,48,43,46,41,60,288,0.47297297297297297,4.0
75,140,65,112,65,110,567,0.9140625,70,110,70,115,70,90,525,0.75,0.25
115,45,20,45,25,20,270,0.11538461538461539,40,55,70,45,60,30,300,0.10619469026548672,0.25
50,65,107,105,107,86,520,0.703125,78,92,75,74,63,118,500,0.8842975206611571,4.0
69,69,76,69,86,91,460,0.6554621848739496,55,63,90,50,80,42,380,0.21138211382113822,0.5
55,40,85,80,105,40,405,0.23622047244094488,70,70,70,70,70,70,420,0.5289256198347108,1.0
70,60,125,115,70,55,495,0.35507246376811596,75,98,63,98,63,101,498,0.889763779527559,4.0
45,85,50,55,50,65,350,0.5076923076923077,85,105,85,40,50,40,405,0.211864406779661,1.0
73,95,62,85,65,85,465,0.6666666666666666,83,80,75,70,70,101,479,0.8615384615384616,1.0
50,50,40,30,30,50,250,0.2781954887218045,70,45,48,60,65,35,323,0.15748031496062992,1.0
78,130,111,130,85,100,634,0.8561151079136691,75,90,50,110,80,95,500,0.7985611510791367,0.5
30,45,55,70,55,85,340,0.5633802816901409,60,50,70,80,80,140,480,0.8449612403100775,1.0
65,40,50,125,60,30,370,0.07258064516129033,37,25,41,25,41,25,194,0.08870967741935484,1.0
80,75,150,75,150,50,580,0.30973451327433627,90,50,34,60,44,70,348,0.6283185840707964,1.0
59,59,58,90,70,73,409,0.5826086956521739,59,74,50,35,50,35,303,0.3125,1.0
104,91,63,91,73,68,490,0.5118110236220472,100,50,50,76,96,70,442,0.5,1.0
80,135,130,95,90,70,600,0.5181818181818182,68,75,53,83,113,60,452,0.45384615384615384,1.0
54,66,70,44,55,46,335,0.4214876033057851,65,50,70,95,80,65,425,0.4262295081967213,2.0
80,80,90,110,130,110,600,0.8721804511278195,50,53,62,58,63,44,330,0.13709677419354838,1.0
35,60,44,40,54,55,288,0.366412213740458,48,72,48,72,48,48,336,0.25984251968503935,1.0
40,60,40,40,40,30,250,0.0948905109489051,75,95,122,58,75,69,494,0.5725806451612904,1.0
65,90,50,85,45,55,390,0.371900826446281,95,85,85,65,65,35,430,0.2571428571428571,2.0
40,80,35,35,45,70,305,0.4661016949152542,40,65,40,80,40,65,330,0.5038167938931297,2.0
68,165,95,65,115,110,618,0.8615384615384616,50,65,64,44,48,43,314,0.2196969696969697,1.0
35,35,35,35,35,35,210,0.13385826771653545,60,70,50,100,50,65,395,0.5217391304347826,0.25
35,46,34,35,45,20,215,0.072,125,130,90,130,90,95,660,0.7734375,1.0
105,105,75,65,100,50,500,0.37593984962406013,35,46,34,35,45,20,215,0.072,1.0
70,75,60,105,60,105,475,0.88,65,80,140,40,70,70,465,0.5223880597014925,2.0
50,25,28,45,55,15,218,0.0625,55,40,85,80,105,40,405,0.23622047244094488,1.0
40,27,60,37,50,66,280,0.36220472440944884,75,110,110,110,105,80,590,0.656934306569343,1.0
105,140,55,30,55,95,480,0.8195488721804511,54,78,103,53,45,22,355,0.23255813953488372,0.25
75,95,125,45,75,95,510,0.8257575757575758,85,73,70,73,115,67,483,0.5126050420168067,1.0
45,80,100,35,37,28,325,0.3125,30,105,90,25,25,50,325,0.2773722627737226,0.5
55,84,105,114,75,52,485,0.2890625,83,106,65,86,65,85,490,0.6640625,1.0
70,83,50,37,50,60,350,0.3360655737704918,70,75,60,105,60,105,475,0.88,0.5
126,131,95,131,98,99,680,0.8102189781021898,250,5,5,35,105,50,450,0.15306122448979592,1.0
60,67,85,77,75,116,480,0.8888888888888888,40,45,35,30,40,55,245,0.3793103448275862,0.125
60,95,80,60,80,30,405,0.19480519480519481,115,45,20,45,25,20,270,0.11538461538461539,0.5
75,87,63,87,63,98,473,0.865546218487395,59,45,40,35,40,31,250,0.14285714285714285,1.0
70,110,180,60,60,50,530,0.4117647058823529,40,45,35,40,40,90,290,0.65,1.0
76,65,45,92,42,91,411,0.7449664429530202,39,52,43,60,50,65,309,0.5041322314049587,1.0
99,68,83,72,87,51,460,0.417910447761194,50,65,107,105,107,86,520,0.7758620689655172,1.0
65,65,45,75,45,95,390,0.72,70,105,105,50,40,20,390,0.33587786259541985,0.5
95,109,105,75,85,56,525,0.34513274336283184,100,100,100,100,100,100,600,0.8345864661654135,0.25
62,73,55,56,52,84,382,0.7244094488188977,35,46,34,35,45,20,215,0.072,1.0
76,25,45,67,55,24,292,0.0390625,45,75,37,70,55,83,365,0.6183206106870229,1.0
71,120,95,120,95,99,600,0.8203125,65,40,50,125,60,30,370,0.07258064516129033,2.0
67,57,55,77,55,114,425,0.8879310344827587,40,45,40,65,40,65,295,0.5661764705882353,0.5
55,40,50,65,85,40,335,0.3181818181818182,80,52,50,90,50,89,411,0.6666666666666666,1.0
70,110,80,55,80,105,500,0.8794326241134752,80,160,60,170,130,80,680,0.6180555555555556,4.0
45,85,50,55,50,65,350,0.5076923076923077,65,75,90,97,123,44,494,0.1987179487179487,0.5
95,110,95,40,95,55,490,0.40336134453781514,80,70,65,80,120,100,515,0.8034188034188035,1.0
55,55,50,45,65,55,325,0.37373737373737376,75,55,70,55,95,110,460,0.8444444444444444,1.0
45,90,20,65,20,65,305,0.5116279069767442,89,124,80,55,80,55,483,0.5714285714285714,4.0
70,80,70,80,70,110,480,0.6594202898550725,70,85,65,105,85,120,530,0.9262295081967213,2.0
100,120,120,150,100,90,680,0.7880794701986755,50,50,40,30,30,50,250,0.2781954887218045,2.0
80,100,80,80,80,100,520,0.9051724137931034,76,48,48,57,62,34,325,0.11688311688311688,1.0
83,106,65,86,65,85,490,0.6640625,48,61,40,61,40,50,300,0.2543859649122807,0.25
40,30,30,55,30,85,270,0.4666666666666667,55,85,55,50,55,60,360,0.4233576642335766,4.0
48,61,40,61,40,50,300,0.2543859649122807,40,60,40,40,40,30,250,0.0948905109489051,0.125
60,60,50,40,50,75,335,0.5882352941176471,100,134,110,95,100,61,600,0.4057971014492754,1.0
55,70,45,70,50,60,350,0.45,50,50,40,50,40,64,294,0.45588235294117646,0.5
95,109,105,75,85,56,525,0.34513274336283184,82,121,119,69,59,71,521,0.5394736842105263,2.0
100,100,100,100,100,100,600,0.8758169934640523,69,69,76,69,86,91,460,0.6554621848739496,0.5
67,58,57,81,67,101,431,0.8790322580645161,100,150,120,120,100,90,680,0.6493506493506493,0.5
80,80,80,80,80,80,480,0.6015037593984962,80,82,83,100,100,80,525,0.6742424242424242,2.0
40,45,40,35,35,56,251,0.373015873015873,106,90,130,90,154,110,680,0.8699186991869918,1.0
130,85,80,85,95,60,535,0.43884892086330934,68,65,65,125,115,80,518,0.6461538461538462,1.0
90,95,105,165,110,45,610,0.2890625,80,160,60,170,130,80,680,0.6180555555555556,1.0
30,56,35,25,35,72,253,0.48148148148148145,65,70,60,65,65,115,440,0.8583333333333333,1.0
55,70,45,70,50,60,350,0.45,39,52,43,60,50,65,309,0.49107142857142855,0.5
108,112,118,68,72,47,525,0.2916666666666667,85,60,65,135,105,100,550,0.7518248175182481,1.0
75,55,70,55,95,110,460,0.8444444444444444,75,75,95,75,95,113,528,0.9015151515151515,1.0
35,65,35,65,35,65,300,0.46621621621621623,60,95,80,60,80,30,405,0.19480519480519481,0.5
75,87,63,87,63,98,473,0.865546218487395,95,70,73,95,90,60,483,0.3983739837398374,1.0
80,160,80,130,80,100,630,0.8455284552845529,90,60,70,75,70,45,410,0.23880597014925373,2.0
60,85,69,60,69,77,420,0.518796992481203,75,110,110,110,105,80,590,0.656934306569343,1.0
83,106,65,86,65,85,490,0.6640625,50,65,64,44,48,43,314,0.2196969696969697,1.0
70,83,50,37,50,60,350,0.3360655737704918,55,50,65,175,95,150,590,0.7818181818181819,1.0
44,75,35,63,33,45,295,0.2647058823529412,75,75,75,125,95,40,485,0.15671641791044777,2.0
95,75,110,100,80,30,490,0.15267175572519084,80,160,60,170,130,80,680,0.6180555555555556,0.0
100,73,83,73,83,55,467,0.371900826446281,65,75,90,97,123,44,494,0.1987179487179487,0.5
75,65,55,65,55,69,384,0.43548387096774194,60,80,95,70,85,50,440,0.2231404958677686,2.0
90,95,95,70,90,70,510,0.5230769230769231,95,100,85,108,70,70,528,0.5652173913043478,0.5
65,136,94,54,96,135,580,0.9612403100775194,95,145,130,120,90,120,700,0.9398496240601504,0.5
65,90,65,61,61,100,442,0.8373983739837398,60,40,60,40,60,35,295,0.18055555555555555,2.0
60,90,140,50,50,40,430,0.2535211267605634,105,95,75,85,75,74,509,0.5714285714285714,0.25
60,90,55,90,80,110,485,0.8677685950413223,75,75,130,75,130,95,580,0.7479674796747967,1.0
65,90,122,58,75,84,494,0.71875,45,25,50,25,25,35,205,0.13076923076923078,0.25
78,52,60,63,65,23,341,0.06015037593984962,50,180,20,180,20,150,600,0.9029850746268657,1.0
61,90,45,50,50,160,456,0.9230769230769231,80,85,95,30,30,25,345,0.2857142857142857,0.5
60,60,75,60,75,80,410,0.7321428571428571,106,190,100,154,100,130,780,0.9259259259259259,0.25
84,71,43,71,43,48,360,0.25874125874125875,100,150,90,180,160,90,770,0.7348484848484849,1.0
64,165,75,93,83,75,555,0.6587301587301587,45,100,45,45,45,10,290,0.2949640287769784,1.0
45,60,40,70,50,45,310,0.2846715328467153,70,70,40,60,40,60,340,0.4247787610619469,2.0
60,50,70,80,80,140,480,0.8449612403100775,83,106,65,86,65,85,490,0.6640625,1.0
90,85,100,95,125,85,580,0.6834532374100719,45,45,55,45,55,63,308,0.4594594594594595,4.0
60,100,85,80,85,100,510,0.7007874015748031,91,129,90,72,90,108,580,0.8536585365853658,2.0
100,73,83,73,83,55,467,0.371900826446281,67,57,55,77,55,114,425,0.8879310344827587,1.0
30,42,118,42,88,30,350,0.112,80,135,85,70,95,150,615,0.9844961240310077,4.0
50,95,90,95,90,180,600,0.9172413793103448,40,35,30,120,70,105,400,0.6692307692307692,0.5
73,76,75,81,100,100,505,0.8110236220472441,50,35,55,25,25,15,205,0.05263157894736842,2.0
45,35,45,62,53,35,275,0.11851851851851852,67,125,40,30,30,58,350,0.3431372549019608,2.0
90,100,60,90,60,80,480,0.6422764227642277,80,70,65,80,120,100,515,0.8034188034188035,1.0
90,120,75,60,60,45,450,0.29411764705882354,50,25,28,45,55,15,218,0.0625,1.0
62,48,54,63,60,68,355,0.5178571428571429,60,65,80,170,95,130,600,0.8625954198473282,2.0
65,150,60,115,60,115,565,0.935251798561151,55,81,60,50,70,97,413,0.7214285714285714,1.0
60,50,40,85,75,95,405,0.7540983606557377,90,55,75,60,75,30,385,0.13970588235294118,1.0
90,95,95,70,90,70,510,0.5230769230769231,100,120,120,150,100,90,680,0.7880794701986755,1.0
43,80,65,50,35,35,308,0.14193548387096774,65,100,70,80,80,105,500,0.8666666666666667,2.0
95,100,85,108,70,70,528,0.5652173913043478,80,90,80,130,110,110,600,0.856,0.5
70,105,105,50,40,20,390,0.33587786259541985,65,125,100,55,70,85,500,0.6532258064516129,2.0
85,73,70,73,115,67,483,0.5126050420168067,100,150,120,120,100,90,680,0.6493506493506493,1.0
60,100,115,70,85,90,520,0.7557251908396947,73,95,62,85,65,85,465,0.6666666666666666,1.0
95,75,180,130,80,30,590,0.13793103448275862,80,52,50,90,50,89,411,0.6666666666666666,1.0
100,100,80,60,60,50,450,0.3050847457627119,55,66,44,44,56,85,350,0.6888888888888889,1.0
82,121,119,69,59,71,521,0.5394736842105263,70,65,60,90,75,90,450,0.6571428571428571,2.0
78,130,111,130,85,100,634,0.8561151079136691,55,75,50,40,40,80,340,0.6302521008403361,1.0
60,70,65,125,105,90,515,0.6911764705882353,65,75,105,35,65,85,430,0.6940298507462687,0.5
80,100,123,122,120,80,625,0.56,65,130,60,75,60,75,465,0.689922480620155,1.0
70,80,102,80,102,40,474,0.2677165354330709,45,50,43,40,38,62,278,0.40441176470588236,0.5
90,55,75,60,75,30,385,0.13970588235294118,45,50,35,55,75,40,300,0.21367521367521367,1.0
50,48,43,46,41,60,288,0.47297297297297297,70,55,95,95,110,65,490,0.48872180451127817,1.0
65,50,70,95,80,65,425,0.4262295081967213,62,77,62,50,42,65,358,0.4838709677419355,1.0
65,80,65,35,65,60,370,0.38405797101449274,65,150,60,115,60,115,565,0.935251798561151,1.0
55,50,45,135,95,120,500,0.7714285714285715,90,90,85,125,90,100,580,0.768595041322314,1.0
110,135,60,50,65,88,508,0.7744360902255639,85,73,70,73,115,67,483,0.5126050420168067,1.0
50,53,62,58,63,44,330,0.13709677419354838,75,69,72,114,100,104,534,0.8253968253968254,2.0
30,105,90,25,25,50,325,0.2773722627737226,70,100,115,30,65,30,410,0.24390243902439024,2.0
70,65,65,55,55,70,380,0.5,60,65,80,170,95,130,600,0.8625954198473282,0.0
65,150,40,15,80,145,495,0.9663865546218487,75,75,75,125,95,40,485,0.15671641791044777,2.0
65,75,105,35,65,85,430,0.6940298507462687,1,90,45,30,30,40,236,0.33064516129032256,1.0
45,55,39,35,39,42,255,0.18518518518518517,84,71,43,71,43,48,360,0.25874125874125875,1.0
84,86,88,111,101,60,530,0.4634146341463415,110,80,90,95,90,65,530,0.5033557046979866,0.5
55,50,45,135,95,120,500,0.7714285714285715,95,110,95,40,95,55,490,0.40336134453781514,1.0
255,10,10,75,135,55,540,0.3125,55,35,50,55,110,85,390,0.6277372262773723,1.0
90,93,55,70,55,55,418,0.3819444444444444,60,60,60,35,35,30,280,0.11194029850746269,2.0
70,105,105,50,40,20,390,0.33587786259541985,63,63,47,41,41,74,329,0.56,1.0
111,83,68,92,82,39,475,0.1774193548387097,60,30,30,36,56,50,262,0.32432432432432434,0.0
50,60,60,60,60,30,320,0.11290322580645161,68,90,65,50,55,82,410,0.6165413533834586,0.5
60,52,168,47,138,30,495,0.19834710743801653,60,62,50,62,60,40,334,0.18181818181818182,4.0
75,125,75,30,75,85,465,0.625,80,100,200,50,100,50,580,0.3472222222222222,2.0
65,65,45,75,45,95,390,0.72,90,93,55,70,55,55,418,0.3819444444444444,0.5
85,60,65,135,105,100,550,0.7518248175182481,55,75,85,25,25,15,280,0.1875,0.5
45,40,60,40,75,50,310,0.2926829268292683,85,80,70,135,75,90,535,0.7006802721088435,1.0
70,77,60,97,60,108,472,0.8394160583941606,60,115,105,65,70,80,495,0.7181818181818181,2.0
70,95,125,65,75,45,475,0.33613445378151263,50,72,35,35,35,65,292,0.5373134328358209,1.0
88,107,122,74,75,64,530,0.4596774193548387,54,63,52,83,56,97,405,0.7697841726618705,2.0
75,98,63,98,63,101,498,0.849624060150376,45,100,45,45,45,10,290,0.2949640287769784,2.0
80,70,70,90,100,70,480,0.5609756097560976,50,40,85,40,65,25,305,0.08870967741935484,0.5
76,104,71,104,71,108,534,0.912751677852349,10,55,25,35,45,95,265,0.5396825396825397,1.0
85,60,65,135,105,100,550,0.7518248175182481,40,29,45,29,45,36,224,0.14634146341463414,2.0
80,95,82,60,82,75,474,0.6,70,84,70,65,70,51,410,0.2949640287769784,0.25
70,60,70,87,78,85,450,0.6228070175438597,80,80,50,40,50,25,325,0.176056338028169,0.5
55,70,40,60,40,40,305,0.26956521739130435,63,60,55,50,50,71,349,0.5289256198347108,2.0
55,69,85,32,35,28,304,0.09302325581395349,79,100,80,110,90,121,580,0.968,2.0
60,55,90,145,90,80,520,0.6071428571428571,65,125,60,95,60,105,510,0.9236641221374046,1.0
72,105,115,54,86,68,500,0.5149253731343284,75,75,60,83,60,60,413,0.39344262295081966,0.5
45,67,60,35,50,63,320,0.5128205128205128,28,25,25,45,35,40,198,0.16083916083916083,1.0
85,100,122,58,75,54,494,0.3939393939393939,50,50,77,95,77,91,440,0.5916666666666667,2.0
109,66,84,81,99,32,471,0.2013888888888889,68,75,53,83,113,60,452,0.45384615384615384,0.5
50,20,40,20,40,20,190,0.0962962962962963,55,104,105,94,75,52,485,0.36363636363636365,1.0
40,65,40,80,40,65,330,0.5038167938931297,60,50,50,60,70,50,340,0.28346456692913385,1.0
126,131,95,131,98,99,680,0.8102189781021898,95,65,110,60,130,65,525,0.5275590551181102,0.5
115,140,130,55,55,40,535,0.4519230769230769,20,25,45,70,90,60,310,0.30833333333333335,1.0
70,90,70,60,60,70,420,0.6390977443609023,55,45,43,55,43,72,313,0.5853658536585366,2.0
130,65,60,110,95,65,525,0.5227272727272727,40,55,99,40,79,47,360,0.26262626262626265,1.0
100,77,77,128,128,90,600,0.6901408450704225,40,65,40,80,40,65,330,0.5038167938931297,0.0
40,45,35,65,55,70,310,0.4482758620689655,110,130,80,70,60,80,530,0.5862068965517241,2.0
40,45,35,40,40,90,290,0.65,40,20,30,40,80,55,265,0.22764227642276422,1.0
95,23,48,23,48,23,260,0.046153846153846156,70,80,70,80,70,110,480,0.6594202898550725,1.0
37,25,41,25,41,25,194,0.08870967741935484,70,45,48,60,65,35,323,0.15748031496062992,0.5
79,105,70,145,80,101,580,0.8608695652173913,70,65,60,90,75,90,450,0.6571428571428571,2.0
65,95,75,55,55,85,430,0.6933333333333334,56,61,65,48,45,38,313,0.17567567567567569,1.0
56,61,65,48,45,38,313,0.17567567567567569,80,80,90,110,130,110,600,0.8721804511278195,0.5
30,65,100,45,25,40,305,0.1891891891891892,70,140,230,60,80,50,630,0.32432432432432434,1.0
43,30,55,40,65,97,330,0.6030534351145038,78,81,71,74,69,126,499,0.9090909090909091,2.0
79,105,70,145,80,101,580,0.8608695652173913,150,80,44,90,54,80,498,0.625,2.0
85,115,80,105,80,50,515,0.3063063063063063,85,80,70,135,75,90,535,0.7006802721088435,1.0
105,125,100,60,100,100,590,0.8359375,64,165,75,93,83,75,555,0.6587301587301587,0.0
35,70,55,45,55,25,285,0.09420289855072464,80,80,80,55,55,90,440,0.6417910447761194,1.0
30,45,135,45,90,30,375,0.09285714285714286,70,55,75,45,65,60,370,0.45901639344262296,2.0
65,75,90,97,123,44,494,0.1987179487179487,80,75,150,75,150,50,580,0.30973451327433627,0.0
62,48,66,59,57,49,341,0.33884297520661155,68,165,95,65,115,110,618,0.8615384615384616,2.0
50,70,160,70,160,90,600,0.7417218543046358,60,48,45,43,90,42,328,0.21897810218978103,0.5
80,185,115,40,105,75,600,0.6230769230769231,65,75,70,95,70,95,470,0.7272727272727273,0.25
100,90,130,45,65,55,485,0.4253731343283582,75,80,55,25,35,35,305,0.18666666666666668,0.5
80,100,70,60,70,95,475,0.7416666666666667,91,90,129,90,72,108,580,0.9140625,0.25
55,75,85,25,25,15,280,0.1875,1,90,45,30,30,40,236,0.33064516129032256,2.0
75,80,60,65,90,102,472,0.8625954198473282,55,66,44,44,56,85,350,0.6888888888888889,1.0
35,60,44,40,54,55,288,0.366412213740458,108,170,115,120,95,92,700,0.7083333333333334,0.5
70,100,70,105,75,40,460,0.23214285714285715,108,170,115,120,95,92,700,0.7083333333333334,0.5
80,145,150,105,110,110,700,0.8692307692307693,45,25,50,25,25,35,205,0.13076923076923078,2.0
30,45,59,30,39,57,260,0.2803030303030303,110,160,110,80,110,100,670,0.8591549295774648,1.0
78,92,75,74,63,118,500,0.8842975206611571,104,91,63,91,73,68,490,0.5118110236220472,2.0
73,115,60,60,60,90,458,0.6694915254237288,50,65,45,85,65,95,405,0.7238095238095238,1.0
50,120,53,35,110,87,455,0.640625,60,100,115,70,85,90,520,0.7557251908396947,2.0
59,66,70,44,55,41,335,0.25190839694656486,45,53,70,40,60,42,310,0.25735294117647056,0.25
50,40,85,40,65,25,305,0.08870967741935484,45,63,37,65,55,95,360,0.8055555555555556,1.0
51,65,65,80,75,59,395,0.4365079365079365,60,90,55,90,80,110,485,0.8677685950413223,1.0
45,55,39,35,39,42,255,0.18518518518518517,50,85,85,55,55,50,380,0.3902439024390244,0.5
70,60,125,115,70,55,495,0.35507246376811596,45,60,32,50,32,76,295,0.5925925925925926,1.0
105,95,80,40,80,90,490,0.753968253968254,55,81,60,50,70,97,413,0.7214285714285714,1.0
45,40,60,40,75,50,310,0.2926829268292683,75,123,67,95,85,95,540,0.7642276422764228,0.5
60,130,80,60,60,70,460,0.5153846153846153,78,104,78,159,115,100,634,0.8444444444444444,0.125
55,66,44,44,56,85,350,0.6888888888888889,90,60,70,75,70,45,410,0.23880597014925373,1.0
48,72,48,72,48,48,336,0.25984251968503935,95,65,110,60,130,65,525,0.5275590551181102,0.0
64,78,52,78,52,81,405,0.6422764227642277,41,64,45,50,50,50,300,0.36752136752136755,0.5
55,85,55,50,55,60,360,0.4233576642335766,60,62,50,62,60,40,334,0.18181818181818182,8.0
65,95,57,100,85,93,495,0.7441860465116279,70,105,105,50,40,20,390,0.33587786259541985,0.5
45,75,60,40,30,50,300,0.304,65,90,122,58,75,84,494,0.71875,1.0
45,67,60,35,50,63,320,0.5128205128205128,80,75,150,75,150,50,580,0.30973451327433627,1.0
55,55,85,65,85,35,380,0.2014388489208633,65,90,65,61,61,100,442,0.8373983739837398,2.0
75,80,70,65,75,90,455,0.7578125,86,68,72,109,66,106,507,0.8099173553719008,1.0
70,90,90,135,90,125,600,0.9401709401709402,59,74,50,35,50,35,303,0.3125,2.0
20,25,45,70,90,60,310,0.30833333333333335,75,80,55,25,35,35,305,0.18666666666666668,2.0
72,58,80,103,80,97,490,0.7171052631578947,95,155,109,70,130,81,640,0.6788321167883211,0.0
66,41,77,61,87,23,355,0.12096774193548387,85,105,100,79,83,78,530,0.5869565217391305,2.0
80,80,80,80,80,80,480,0.6015037593984962,89,125,90,115,80,101,600,0.8725490196078431,4.0
40,70,40,35,40,60,285,0.392,65,105,60,60,70,95,455,63.0,1.0
55,75,60,75,60,103,428,0.7982456140350878,38,35,35,65,55,50,278,0.2647058823529412,1.0
82,80,86,85,75,72,480,0.6183206106870229,60,90,70,60,120,40,440,0.27419354838709675,1.0
100,100,100,100,100,100,600,0.831858407079646,75,80,60,65,90,102,472,0.8625954198473282,1.0
60,50,100,85,70,65,430,0.47580645161290325,100,180,160,150,90,90,770,0.7520661157024794,4.0
65,95,75,55,55,85,430,0.6933333333333334,43,30,55,40,65,97,330,0.6030534351145038,0.5
70,92,65,80,55,98,460,0.8090909090909091,65,80,140,40,70,70,465,0.5223880597014925,1.0
105,150,90,150,90,95,680,0.8285714285714286,25,20,15,105,55,90,310,0.32407407407407407,1.0
135,85,40,40,85,5,390,0.6864406779661016,103,60,86,60,86,50,445,0.3458646616541353,1.0
45,25,50,25,25,35,205,0.13076923076923078,40,45,35,65,55,70,310,0.4482758620689655,4.0
50,20,40,20,40,20,190,0.0962962962962963,70,80,50,35,35,35,305,0.14,2.0
50,105,125,55,95,50,480,0.375886524822695,79,105,70,145,80,101,580,0.8608695652173913,0.5
60,30,30,36,56,50,262,0.32432432432432434,50,75,75,65,65,50,380,0.4049586776859504,0.0
75,95,60,65,60,115,470,0.8778625954198473,40,30,35,45,40,55,245,0.31496062992125984,1.0
75,90,90,140,90,115,600,0.9481481481481482,83,106,65,86,65,85,490,0.6640625,0.5
30,80,90,55,45,55,355,0.4295774647887324,100,75,115,90,115,85,580,0.6446280991735537,0.5
62,44,50,44,50,55,305,0.3629032258064516,65,130,60,75,60,75,465,0.689922480620155,1.0
80,52,50,90,50,89,411,0.6666666666666666,55,81,60,50,70,97,413,0.7214285714285714,1.0
40,30,50,55,55,100,330,0.584070796460177,60,40,80,60,45,40,325,0.23529411764705882,0.5
65,90,40,45,80,75,395,0.625,50,95,90,95,90,180,600,0.9172413793103448,2.0
83,80,75,70,70,101,479,0.8615384615384616,50,105,125,55,95,50,480,0.375886524822695,0.25
38,35,40,27,25,35,200,0.08208955223880597,85,105,100,79,83,78,530,0.5869565217391305,1.0
90,60,60,40,40,40,330,0.29545454545454547,59,63,80,65,80,58,405,0.41843971631205673,1.0
64,115,65,83,63,65,455,0.5323741007194245,59,66,70,44,55,41,335,0.25190839694656486,2.0
108,100,121,81,95,95,600,0.7476635514018691,75,55,70,55,95,110,460,0.8444444444444444,0.0
50,75,45,40,45,60,315,0.4380165289256198,106,130,90,110,154,90,680,0.719626168224299,0.25
40,30,35,50,70,55,280,0.28205128205128205,75,90,90,140,90,115,600,0.9481481481481482,0.5
60,60,50,40,50,75,335,0.5882352941176471,40,35,30,20,20,50,195,0.23423423423423423,0.25
80,100,200,50,100,50,580,0.3472222222222222,60,67,85,77,75,116,480,0.8888888888888888,1.0
25,35,70,95,55,45,325,0.16783216783216784,170,90,45,90,45,60,500,0.427536231884058,1.0
60,80,110,50,80,45,425,0.2833333333333333,90,130,80,65,85,55,505,0.4396551724137931,1.0
55,130,115,50,50,75,475,0.5982142857142857,60,85,60,50,50,125,430,0.9090909090909091,1.0
50,70,160,70,160,90,600,0.7417218543046358,80,80,80,80,80,80,480,0.6015037593984962,1.0
100,73,83,73,83,55,467,0.371900826446281,75,75,130,75,130,95,580,0.7479674796747967,1.0
71,82,64,64,59,112,452,0.9327731092436975,100,123,75,57,75,80,510,0.6923076923076923,1.0
75,98,63,98,63,101,498,0.889763779527559,65,75,90,97,123,44,494,0.1987179487179487,0.5
50,48,43,46,41,60,288,0.47297297297297297,30,45,59,30,39,57,260,0.2803030303030303,1.0
35,80,50,50,70,120,405,0.84375,40,40,35,50,100,70,335,0.5031847133757962,2.0
65,130,60,95,110,65,525,0.5303030303030303,64,165,75,93,83,75,555,0.6587301587301587,1.0
100,100,100,100,100,100,600,0.8758169934640523,46,87,60,30,40,57,320,0.37777777777777777,1.0
74,48,76,83,81,104,466,0.7322834645669292,70,40,50,55,50,25,290,0.061068702290076333,1.0
50,65,45,85,65,95,405,0.7238095238095238,80,82,78,95,80,85,500,0.6869565217391305,2.0
79,85,60,55,60,71,410,0.60431654676259,111,83,68,92,82,39,475,0.1774193548387097,1.0
55,55,50,45,65,55,325,0.37373737373737376,75,90,50,110,80,95,500,0.7985611510791367,1.0
80,80,50,40,50,25,325,0.176056338028169,99,68,83,72,87,51,460,0.417910447761194,2.0
71,82,64,64,59,112,452,0.9327731092436975,90,70,80,70,95,70,475,0.5190839694656488,1.0
50,70,50,50,50,40,310,0.16296296296296298,30,45,59,30,39,57,260,0.2803030303030303,1.0
65,76,84,54,96,105,480,0.9008264462809917,50,70,100,40,40,30,330,0.2222222222222222,0.25
109,66,84,81,99,32,471,0.2013888888888889,79,115,70,125,80,111,580,0.864,0.0
108,130,95,80,85,102,600,0.7637795275590551,68,165,95,65,115,110,618,0.8615384615384616,1.0
55,50,40,40,40,75,300,0.5945945945945946,30,30,30,30,30,30,180,0.12612612612612611,1.0
80,135,85,70,95,150,615,0.9844961240310077,45,30,15,85,65,65,305,0.36220472440944884,2.0
75,100,110,45,55,65,450,0.5333333333333333,70,40,50,55,50,25,290,0.061068702290076333,1.0
30,65,100,45,25,40,305,0.1891891891891892,50,105,125,55,95,50,480,0.375886524822695,1.0
60,40,50,75,85,95,405,0.6044776119402985,75,87,63,87,63,98,473,0.865546218487395,4.0
55,95,55,35,75,115,430,0.9380530973451328,50,45,45,35,35,50,260,0.23529411764705882,1.0
80,100,123,122,120,80,625,0.56,80,82,83,100,100,80,525,0.6742424242424242,0.25
80,80,90,110,130,110,600,0.8721804511278195,64,88,50,88,50,106,446,0.9111111111111111,0.0
45,49,65,49,65,45,318,0.275,75,90,140,60,60,40,465,0.3008130081300813,0.25
48,61,40,61,40,50,300,0.2543859649122807,60,60,60,35,35,30,280,0.11194029850746269,2.0
70,130,100,55,80,65,500,0.608,135,85,40,40,85,5,390,0.6864406779661016,1.0
40,40,55,40,70,55,300,0.40939597315436244,90,75,85,115,90,55,510,0.3445378151260504,2.0
80,100,70,50,60,45,405,0.25806451612903225,70,140,70,110,65,105,560,0.95,2.0
114,85,70,85,80,30,464,0.2066115702479339,80,80,50,40,50,25,325,0.176056338028169,0.25
106,110,90,154,90,130,680,0.926829268292683,80,105,65,60,75,130,515,0.9645390070921985,1.0
50,65,107,105,107,86,520,0.7272727272727273,60,75,100,55,80,50,420,0.3088235294117647,0.5
114,85,70,85,80,30,464,0.2066115702479339,75,75,60,83,60,60,413,0.39344262295081966,2.0
45,50,55,75,65,30,320,0.06293706293706294,80,82,100,83,100,80,525,0.6821705426356589,1.0
100,100,125,110,50,50,535,0.384,40,45,35,40,40,90,290,0.65,1.0
80,82,100,83,100,80,525,0.6821705426356589,38,35,40,27,25,35,200,0.08208955223880597,0.5
50,65,107,105,107,86,520,0.7758620689655172,70,85,70,60,70,50,405,0.28378378378378377,0.0
110,130,80,70,60,80,530,0.5862068965517241,95,109,105,75,85,56,525,0.34513274336283184,2.0
105,140,95,55,65,45,505,0.3,50,70,160,70,160,90,600,0.7417218543046358,0.5
60,62,80,63,80,60,405,0.4336283185840708,40,30,30,55,30,85,270,0.4666666666666667,1.0
60,69,95,69,95,36,424,0.2608695652173913,75,75,55,105,85,30,425,0.1619718309859155,2.0
50,180,20,180,20,150,600,0.9029850746268657,70,120,65,45,85,125,510,0.9747899159663865,0.0
75,95,67,125,95,83,540,0.7117117117117117,78,84,78,109,85,100,534,0.8646616541353384,0.5
42,52,67,39,56,50,306,0.2868217054263566,65,55,115,100,40,60,435,0.3798449612403101,0.5
65,95,57,100,85,93,495,0.7441860465116279,58,64,58,80,65,80,405,0.609271523178808,0.5
70,110,180,60,60,50,530,0.4117647058823529,73,100,60,100,60,65,458,0.42657342657342656,1.0
59,66,70,44,55,41,335,0.25190839694656486,60,70,50,100,50,65,395,0.5217391304347826,0.25
54,78,103,53,45,22,355,0.23255813953488372,78,104,78,159,115,100,634,0.8444444444444444,8.0
85,60,65,135,105,100,550,0.7518248175182481,50,95,180,85,45,70,525,0.5298507462686567,1.0
60,75,85,100,85,115,520,0.8992248062015504,75,90,140,60,60,40,465,0.3008130081300813,0.5
90,70,80,70,95,70,475,0.5190839694656488,91,72,90,129,90,108,580,0.8620689655172413,0.25
68,85,65,165,135,100,618,0.8083333333333333,65,60,70,85,75,40,395,0.1796875,1.0
60,40,50,75,85,95,405,0.6044776119402985,70,80,50,35,35,35,305,0.14,1.0
84,71,43,71,43,48,360,0.25874125874125875,75,90,90,140,90,115,600,0.9481481481481482,1.0
60,60,60,85,85,85,435,0.631578947368421,61,90,45,50,50,160,456,0.9230769230769231,1.0
65,75,90,97,123,44,494,0.1987179487179487,53,51,53,61,56,40,314,0.14285714285714285,1.0
150,160,100,95,65,100,670,0.8866666666666667,40,70,130,60,130,25,455,0.17355371900826447,0.0
80,135,130,95,90,70,600,0.5181818181818182,58,50,145,95,105,30,483,0.2459016393442623,1.0
60,85,49,60,49,60,363,0.4444444444444444,95,135,80,110,80,100,600,0.8248175182481752,1.0
85,76,64,45,55,90,415,0.6739130434782609,83,80,80,135,80,121,579,0.9444444444444444,1.0
40,27,60,37,50,66,280,0.36220472440944884,70,150,140,65,100,75,600,0.55,0.125
40,30,30,55,30,85,270,0.4666666666666667,95,75,80,100,110,30,490,0.24242424242424243,0.5
40,30,35,50,70,55,280,0.28205128205128205,91,90,106,130,106,77,600,0.648854961832061,0.0
65,76,84,54,96,105,480,0.9008264462809917,75,75,55,105,85,30,425,0.1619718309859155,1.0
75,100,95,40,70,110,490,0.8717948717948718,80,90,80,130,110,110,600,0.856,1.0
100,75,115,90,115,85,580,0.6446280991735537,60,60,40,65,45,35,305,0.15833333333333333,4.0
70,60,62,80,82,60,414,0.4375,60,115,105,65,70,80,495,0.7181818181818181,0.5
90,50,34,60,44,70,348,0.6283185840707964,105,125,100,60,100,100,590,0.8359375,0.0
85,110,90,45,90,80,500,0.6206896551724138,80,130,100,160,120,110,700,0.8981481481481481,1.0
60,85,40,30,45,68,328,0.6422018348623854,90,65,65,40,40,15,315,0.19672131147540983,1.0
45,85,50,55,50,65,350,0.5076923076923077,85,110,90,45,90,80,500,0.6206896551724138,2.0
75,75,60,83,60,60,413,0.39344262295081966,45,30,15,85,65,65,305,0.36220472440944884,1.0
10,55,25,35,45,95,265,0.5396825396825397,91,90,106,130,106,77,600,0.648854961832061,4.0
45,55,39,35,39,42,255,0.18518518518518517,60,80,50,40,40,30,300,0.15328467153284672,1.0
60,50,70,50,90,65,385,0.39568345323741005,80,80,90,110,130,110,600,0.8721804511278195,2.0
76,147,90,60,70,97,540,0.8267716535433071,55,70,55,40,55,85,360,0.7073170731707317,1.0
60,90,70,60,120,40,440,0.27419354838709675,41,64,45,50,50,50,300,0.36752136752136755,1.0
45,63,37,65,55,95,360,0.8055555555555556,67,89,116,79,116,33,500,0.2624113475177305,1.0
66,65,48,62,57,52,350,0.36220472440944884,55,40,40,65,45,35,280,0.16428571428571428,1.0
60,100,89,55,69,112,485,0.9298245614035088,60,62,80,63,80,60,405,0.4336283185840708,4.0
60,85,69,65,79,80,438,0.576,60,80,95,70,85,50,440,0.2231404958677686,0.0
65,65,45,75,45,95,390,0.72,80,80,80,80,80,80,480,0.6015037593984962,1.0
50,50,150,50,150,50,500,0.2571428571428571,65,130,60,95,110,65,525,0.5303030303030303,1.0
84,71,43,71,43,48,360,0.25874125874125875,50,65,107,105,107,86,520,0.703125,1.0
65,65,65,50,50,90,385,0.72,49,66,70,44,55,51,335,0.4260869565217391,0.5
80,82,83,100,100,80,525,0.6742424242424242,50,65,64,44,48,43,314,0.2196969696969697,2.0
60,50,70,80,80,140,480,0.8449612403100775,80,82,83,100,100,80,525,0.6742424242424242,0.5
60,80,50,50,50,40,330,0.23853211009174313,30,45,135,45,90,30,375,0.09285714285714286,0.5
100,110,90,85,90,60,535,0.47794117647058826,150,80,44,90,54,80,498,0.625,0.0
50,75,75,65,65,50,380,0.4049586776859504,91,90,106,130,106,77,600,0.648854961832061,1.0
110,85,95,80,95,50,515,0.2713178294573643,50,120,53,35,110,87,455,0.640625,1.0
58,64,58,80,65,80,405,0.5423728813559322,65,65,45,75,45,95,390,0.72,2.0
75,100,63,80,63,116,497,0.9345794392523364,30,35,30,100,35,80,310,0.4765625,1.0
90,85,100,95,125,85,580,0.6834532374100719,40,45,35,40,40,90,290,0.65,1.0
50,35,55,25,25,15,205,0.021739130434782608,90,60,60,40,40,40,330,0.29545454545454547,1.0
70,60,125,115,70,55,495,0.35507246376811596,70,60,75,110,75,90,480,0.7165354330708661,0.5
90,100,90,125,85,90,580,0.7352941176470589,90,120,75,60,60,45,450,0.29411764705882354,1.0
43,80,65,50,35,35,308,0.14193548387096774,75,125,70,125,70,115,580,0.9037037037037037,1.0
65,90,115,45,115,58,488,0.5041322314049587,60,55,50,40,55,45,305,0.22377622377622378,0.25
60,50,150,50,150,60,520,0.5206611570247934,100,123,75,57,75,80,510,0.6923076923076923,0.0
95,100,85,108,70,70,528,0.5652173913043478,35,55,40,50,50,90,320,0.6838235294117647,1.0
50,60,60,60,60,30,320,0.11290322580645161,60,45,70,75,85,55,390,0.3008130081300813,1.0
55,40,85,80,105,40,405,0.23622047244094488,95,75,80,100,110,30,490,0.24242424242424243,1.0
40,80,35,35,45,70,305,0.4661016949152542,75,100,66,60,66,115,482,0.918918918918919,2.0
70,62,67,55,55,56,365,0.38513513513513514,48,72,48,72,48,48,336,0.25984251968503935,1.0
65,50,70,95,80,65,425,0.4262295081967213,46,87,60,30,40,57,320,0.37777777777777777,1.0
100,50,80,60,80,50,420,0.34375,35,35,40,35,55,50,250,0.40336134453781514,0.5
80,82,78,95,80,85,500,0.6869565217391305,65,80,140,40,70,70,465,0.5223880597014925,1.0
115,45,20,45,25,20,270,0.11538461538461539,60,62,50,62,60,40,334,0.18181818181818182,1.0
40,65,95,60,45,35,340,0.13986013986013987,80,120,80,120,80,100,580,0.8478260869565217,1.0
66,117,70,40,50,67,410,0.4573643410852713,110,85,95,80,95,50,515,0.2713178294573643,1.0
80,115,80,65,55,93,488,0.7846153846153846,38,30,41,30,41,60,240,0.2897196261682243,1.0
78,65,68,112,154,75,552,0.628099173553719,55,63,90,50,80,42,380,0.21138211382113822,1.0
120,100,85,30,85,45,465,0.22448979591836735,35,85,45,35,35,75,310,0.6492537313432836,1.0
40,70,40,35,40,60,285,0.392,60,60,75,60,75,80,410,0.7321428571428571,0.5
35,55,35,30,30,35,220,0.23684210526315788,50,65,64,44,48,43,314,0.2196969696969697,1.0
75,90,140,60,60,40,465,0.3008130081300813,50,64,50,45,50,41,300,0.22727272727272727,2.0
35,80,50,50,70,120,405,0.84375,35,85,45,35,35,75,310,0.6492537313432836,0.0
38,30,41,30,41,60,240,0.2897196261682243,55,81,60,50,70,97,413,0.7214285714285714,1.0
60,52,168,47,138,30,495,0.19834710743801653,65,90,50,85,45,55,390,0.371900826446281,1.0
100,70,70,65,65,45,415,0.1897810218978102,69,55,45,55,55,15,294,0.11666666666666667,1.0
85,110,90,45,90,80,500,0.6206896551724138,70,80,102,80,102,40,474,0.2677165354330709,1.0
45,53,70,40,60,42,310,0.25735294117647056,55,75,85,25,25,15,280,0.1875,2.0
97,165,60,65,50,58,495,0.3902439024390244,70,94,50,94,50,66,424,0.48148148148148145,4.0
125,120,90,170,100,95,700,0.78125,75,80,55,25,35,35,305,0.18666666666666668,1.0
64,88,50,88,50,106,446,0.9111111111111111,75,55,70,55,95,110,460,0.8444444444444444,1.0
101,72,72,99,89,29,462,0.1937984496124031,39,52,43,60,50,65,309,0.49107142857142855,0.5
84,71,43,71,43,48,360,0.25874125874125875,35,55,40,50,50,90,320,0.6838235294117647,1.0
83,80,75,70,70,101,479,0.8615384615384616,105,105,75,65,100,50,500,0.37593984962406013,1.0
150,80,44,90,54,80,498,0.625,40,30,30,55,30,85,270,0.4666666666666667,1.0
45,60,45,25,45,55,275,0.29,50,50,40,50,40,64,294,0.45588235294117646,1.0
58,70,45,40,45,42,300,0.25925925925925924,60,80,110,50,80,45,425,0.2833333333333333,1.0
45,20,50,60,120,50,345,0.24074074074074073,85,90,80,70,80,130,535,0.9262295081967213,1.0
50,53,48,53,48,64,316,0.46153846153846156,103,93,67,71,61,84,479,0.7142857142857143,1.0
76,48,48,57,62,34,325,0.11688311688311688,70,110,75,145,85,145,630,0.9444444444444444,0.25
80,100,200,50,100,50,580,0.3472222222222222,72,58,80,103,80,97,490,0.7171052631578947,2.0
103,60,126,80,126,50,545,0.36363636363636365,75,80,55,25,35,35,305,0.18666666666666668,2.0
50,65,90,35,35,15,290,0.14678899082568808,66,41,77,61,87,23,355,0.12096774193548387,2.0
50,105,79,35,110,76,455,0.6214285714285714,60,85,69,65,79,80,438,0.576,0.5
76,25,45,67,55,24,292,0.0390625,85,105,85,40,50,40,405,0.211864406779661,1.0
75,98,63,98,63,101,498,0.889763779527559,68,90,65,50,55,82,410,0.6165413533834586,0.5
80,120,79,95,79,70,523,0.5833333333333334,40,80,35,35,45,70,305,0.4661016949152542,1.0
30,40,70,70,25,60,295,0.41353383458646614,108,130,95,80,85,102,600,0.7637795275590551,1.0
70,80,50,35,35,35,305,0.14,80,80,80,80,80,80,480,0.6015037593984962,2.0
90,50,34,60,44,70,348,0.6283185840707964,76,65,45,92,42,91,411,0.7449664429530202,0.0
73,95,62,85,65,85,465,0.6666666666666666,95,124,78,69,71,58,495,0.37398373983739835,1.0
65,73,55,47,75,85,400,0.6846846846846847,95,110,80,70,80,50,485,0.37209302325581395,1.0
59,63,80,65,80,58,405,0.41843971631205673,60,60,60,35,35,30,280,0.11194029850746269,1.0
55,84,105,114,75,52,485,0.2890625,100,123,75,57,75,80,510,0.6923076923076923,1.0
65,125,100,60,70,70,490,0.6099290780141844,90,95,105,165,110,45,610,0.2890625,0.5
100,120,100,150,120,90,680,0.728,54,78,103,53,45,22,355,0.23255813953488372,0.25
76,48,48,57,62,34,325,0.11688311688311688,80,80,80,55,55,90,440,0.6417910447761194,1.0
95,100,85,108,70,70,528,0.5652173913043478,76,104,71,104,71,108,534,0.912751677852349,2.0
60,40,50,75,85,95,405,0.6044776119402985,85,100,122,58,75,54,494,0.3939393939393939,0.5
45,100,135,65,135,45,525,0.29411764705882354,250,5,5,35,105,50,450,0.15306122448979592,0.0
97,165,60,65,50,58,495,0.3902439024390244,64,66,68,81,76,50,405,0.25190839694656486,1.0
40,35,30,20,20,50,195,0.23423423423423423,75,80,60,65,90,102,472,0.8625954198473282,1.0
62,55,52,109,94,109,481,0.7833333333333333,40,45,40,35,35,56,251,0.373015873015873,2.0
55,70,45,70,50,60,350,0.45,52,65,55,58,62,60,352,0.4482758620689655,1.0
30,35,30,100,35,80,310,0.4765625,60,85,40,30,45,68,328,0.6422018348623854,0.5
70,40,50,55,50,25,290,0.061068702290076333,50,120,53,35,110,87,455,0.640625,1.0
73,100,60,100,60,65,458,0.42657342657342656,60,40,60,95,60,55,370,0.4222222222222222,0.5
50,75,45,40,45,60,315,0.4380165289256198,108,170,115,120,95,92,700,0.7083333333333334,1.0
65,65,45,75,45,95,390,0.72,103,60,86,60,86,50,445,0.3458646616541353,1.0
64,88,50,88,50,106,446,0.9111111111111111,20,40,90,30,90,25,295,0.11363636363636363,2.0
40,70,130,60,130,25,455,0.17355371900826447,75,87,63,87,63,98,473,0.865546218487395,1.0
126,131,95,131,98,99,680,0.8102189781021898,85,80,90,105,95,60,515,0.49074074074074076,1.0
45,60,40,70,50,45,310,0.2846715328467153,48,61,40,61,40,50,300,0.2543859649122807,1.0
63,60,55,50,50,71,349,0.5289256198347108,75,70,90,70,105,80,490,0.656,1.0
77,85,51,55,51,65,384,0.5163934426229508,120,70,120,75,130,85,600,0.6694915254237288,2.0
45,63,37,65,55,95,360,0.8055555555555556,100,128,90,77,77,128,600,0.959349593495935,1.0
80,90,80,130,110,110,600,0.856,10,55,25,35,45,95,265,0.5396825396825397,2.0
60,95,80,60,80,30,405,0.19480519480519481,69,69,76,69,86,91,460,0.6554621848739496,2.0
111,83,68,92,82,39,475,0.1774193548387097,35,35,40,35,55,50,250,0.40336134453781514,0.0
50,65,45,85,65,95,405,0.7238095238095238,20,40,15,35,35,60,205,0.34285714285714286,1.0
65,85,70,75,70,40,405,0.203125,74,94,131,54,116,20,489,0.4485294117647059,0.5
40,30,35,50,70,55,280,0.28205128205128205,65,75,90,97,123,44,494,0.1987179487179487,0.125
65,105,60,60,70,95,455,63.0,100,100,100,100,100,100,600,0.8758169934640523,1.0
70,130,100,55,80,65,500,0.608,70,60,70,87,78,85,450,0.6228070175438597,2.0
57,24,86,24,86,23,300,0.12727272727272726,72,105,115,54,86,68,500,0.5149253731343284,1.0
50,70,160,70,160,90,600,0.7417218543046358,95,75,110,100,80,30,490,0.15267175572519084,0.5
60,69,95,69,95,36,424,0.2608695652173913,65,83,57,95,85,105,490,0.8914728682170543,0.5
115,45,20,45,25,20,270,0.11538461538461539,50,20,55,25,25,30,205,0.09774436090225563,1.0
80,120,130,55,65,45,495,0.37037037037037035,106,110,90,154,90,130,680,0.926829268292683,1.0
78,81,71,74,69,126,499,0.9090909090909091,75,80,55,25,35,35,305,0.18666666666666668,2.0
73,100,60,100,60,65,458,0.42657342657342656,72,95,67,103,71,122,530,0.9606299212598425,1.0
100,150,90,180,160,90,770,0.7348484848484849,110,160,110,80,110,100,670,0.8591549295774648,1.0
60,62,63,80,80,60,405,0.38016528925619836,38,41,40,50,65,65,299,0.4108527131782946,0.5
150,120,100,120,100,90,680,0.664179104477612,80,160,80,130,80,100,630,0.8455284552845529,1.0
45,30,50,65,50,45,285,0.13821138211382114,65,130,60,75,60,75,465,0.689922480620155,0.0
78,84,78,109,85,100,534,0.8646616541353384,100,100,100,100,100,100,600,0.8602941176470589,4.0
71,120,95,120,95,99,600,0.8203125,100,50,50,76,96,70,442,0.5,0.5
40,30,32,50,52,65,269,0.3671875,95,155,109,70,130,81,640,0.6788321167883211,1.0
82,121,119,69,59,71,521,0.5394736842105263,73,100,60,100,60,65,458,0.42657342657342656,1.0
44,75,35,63,33,45,295,0.2647058823529412,108,130,95,80,85,102,600,0.7637795275590551,1.0
42,52,67,39,56,50,306,0.2868217054263566,85,73,70,73,115,67,483,0.5126050420168067,1.0
77,59,50,67,63,46,362,0.23140495867768596,85,100,122,58,75,54,494,0.3939393939393939,2.0
75,125,70,125,70,115,580,0.9037037037037037,59,45,40,35,40,31,250,0.14285714285714285,1.0
80,85,95,30,30,25,345,0.2857142857142857,150,100,120,100,120,90,680,0.6666666666666666,1.0
60,40,60,95,60,55,370,0.4222222222222222,60,60,60,105,105,105,495,0.848,2.0
75,123,67,95,85,95,540,0.7642276422764228,120,120,120,120,120,120,720,0.9344262295081968,1.0
91,134,95,100,100,80,600,0.6304347826086957,78,84,78,109,85,100,534,0.8646616541353384,1.0
40,30,35,50,70,55,280,0.28205128205128205,100,100,100,100,100,100,600,0.8778625954198473,0.5
50,45,45,35,35,50,260,0.23529411764705882,44,38,39,61,79,42,303,0.2251655629139073,1.0
65,47,55,73,75,85,400,0.65,1,90,45,30,30,40,236,0.33064516129032256,0.5
150,80,44,90,54,80,498,0.625,35,70,55,45,55,25,285,0.09420289855072464,4.0
30,30,30,30,30,30,180,0.12612612612612611,95,135,80,110,80,100,600,0.8248175182481752,0.25
190,33,58,33,58,33,405,0.13432835820895522,50,20,55,25,25,30,205,0.09774436090225563,1.0
60,85,69,65,79,80,438,0.576,100,120,120,150,100,90,680,0.7880794701986755,0.0
67,58,57,81,67,101,431,0.8790322580645161,38,30,85,55,65,30,303,0.21428571428571427,1.0
65,90,65,61,61,100,442,0.8373983739837398,89,145,90,105,80,91,600,0.8549618320610687,1.0
60,70,65,125,105,90,515,0.6911764705882353,75,80,70,65,75,90,455,0.7578125,0.125
45,20,50,60,120,50,345,0.24074074074074073,67,125,40,30,30,58,350,0.3431372549019608,1.0
80,80,80,55,55,90,440,0.6417910447761194,38,30,85,55,65,30,303,0.21428571428571427,0.0
40,80,35,35,45,70,305,0.4661016949152542,60,100,115,70,85,90,520,0.7557251908396947,2.0
65,90,40,45,80,75,395,0.625,73,100,60,100,60,65,458,0.42657342657342656,0.25
50,53,48,53,48,64,316,0.358974358974359,60,105,60,120,60,105,510,0.8849557522123894,1.0
50,75,75,65,65,50,380,0.4049586776859504,123,77,72,99,92,58,521,0.4621212121212121,1.0
70,45,48,60,65,35,323,0.15748031496062992,83,80,80,135,80,121,579,0.9444444444444444,1.0
50,65,107,105,107,86,520,0.7313432835820896,40,55,30,30,30,85,270,0.688,1.0
50,75,70,35,70,48,348,0.29357798165137616,48,61,40,61,40,50,300,0.2543859649122807,0.25
45,30,15,85,65,65,305,0.36220472440944884,83,106,65,86,65,85,490,0.6640625,2.0
80,50,100,100,200,50,580,0.2357142857142857,57,80,91,80,87,75,470,0.5737704918032787,0.5
44,75,35,63,33,45,295,0.2647058823529412,45,85,70,40,40,60,340,0.5229357798165137,0.5
45,75,60,40,30,50,300,0.304,90,30,15,40,20,15,210,0.043478260869565216,0.0
60,95,80,60,80,30,405,0.19480519480519481,75,95,125,45,75,95,510,0.8257575757575758,0.5
95,60,79,100,125,81,540,0.6201550387596899,50,60,60,60,60,30,320,0.11290322580645161,0.5
65,90,50,85,45,55,390,0.371900826446281,100,50,50,76,96,70,442,0.5,0.5
65,45,55,45,70,45,325,0.24369747899159663,35,45,160,30,45,70,385,0.48148148148148145,4.0
70,92,65,80,55,98,460,0.8090909090909091,70,110,75,145,85,145,630,0.9444444444444444,0.25
45,90,20,65,20,65,305,0.5116279069767442,65,75,70,95,70,95,470,0.7272727272727273,2.0
70,120,65,45,85,125,510,0.9747899159663865,30,40,70,70,25,60,295,0.41353383458646614,0.5
78,70,61,50,61,100,420,0.8145161290322581,70,60,70,87,78,85,450,0.6228070175438597,1.0
35,20,65,40,65,20,245,0.02459016393442623,55,65,35,60,30,85,330,0.6126126126126126,1.0
45,30,35,20,20,45,195,0.14782608695652175,45,50,55,75,65,30,320,0.06293706293706294,1.0
101,72,72,99,89,29,462,0.1937984496124031,44,38,33,61,43,70,289,0.5267857142857143,1.0
120,70,120,75,130,85,600,0.6694915254237288,60,80,110,50,80,45,425,0.2833333333333333,2.0
55,75,60,75,60,103,428,0.7982456140350878,75,75,130,75,130,95,580,0.7479674796747967,1.0
85,50,95,120,115,80,545,0.5793650793650794,35,80,50,50,70,120,405,0.84375,1.0
28,25,25,45,35,40,198,0.16083916083916083,80,75,150,75,150,50,580,0.30973451327433627,0.25
65,47,55,73,75,85,400,0.65,70,120,40,95,40,95,460,0.8106060606060606,2.0
60,50,50,60,70,50,340,0.28346456692913385,78,104,78,159,115,100,634,0.8444444444444444,0.5
80,145,150,105,110,110,700,0.8692307692307693,95,70,73,95,90,60,483,0.3983739837398374,0.5
79,115,70,125,80,111,580,0.864,70,50,30,95,135,105,485,0.8040540540540541,1.0
150,120,100,120,100,90,680,0.664179104477612,40,55,80,35,60,30,300,0.15037593984962405,1.0
72,60,30,20,30,25,237,0.11570247933884298,35,46,34,35,45,20,215,0.072,2.0
68,72,78,38,42,32,330,0.23809523809523808,65,90,50,85,45,55,390,0.371900826446281,1.0
44,38,33,61,43,70,289,0.5267857142857143,86,76,86,116,56,95,515,0.7982456140350878,2.0
80,115,80,65,55,93,488,0.7846153846153846,60,40,50,75,85,95,405,0.6044776119402985,0.5
28,25,25,45,35,40,198,0.16083916083916083,20,40,90,30,90,25,295,0.11363636363636363,1.0
90,110,80,100,80,95,555,0.7982456140350878,86,81,97,81,107,43,495,0.203125,1.0
50,150,50,150,50,150,600,0.9339622641509434,110,85,95,80,95,50,515,0.2713178294573643,1.0
130,70,35,70,35,60,400,0.4017857142857143,70,150,140,65,100,75,600,0.55,1.0
40,45,40,62,60,60,307,0.33884297520661155,80,110,120,130,90,70,600,0.6198347107438017,0.25
65,90,122,58,75,84,494,0.71875,66,65,48,62,57,52,350,0.36220472440944884,0.5
35,64,85,74,55,32,345,0.19827586206896552,50,95,90,95,90,180,600,0.9172413793103448,1.0
95,60,79,100,125,81,540,0.6201550387596899,78,52,60,63,65,23,341,0.06015037593984962,1.0
65,40,50,125,60,30,370,0.07258064516129033,106,150,70,194,120,140,780,0.952,0.5
95,117,184,44,46,28,514,0.2975206611570248,110,65,105,55,95,80,510,0.6258503401360545,2.0
54,45,47,75,98,52,371,0.39669421487603307,70,110,75,145,85,145,630,0.9444444444444444,2.0
75,65,55,65,55,69,384,0.43548387096774194,44,75,35,63,33,45,295,0.2647058823529412,1.0
45,60,40,70,50,45,310,0.2846715328467153,65,50,35,115,95,95,455,0.7333333333333333,2.0
20,10,230,10,230,5,505,0.0,71,82,64,64,59,112,452,0.9327731092436975,1.0
51,65,65,80,75,59,395,0.4365079365079365,68,85,65,165,135,100,618,0.8083333333333333,1.0
80,115,80,65,55,93,488,0.7846153846153846,44,38,39,61,79,42,303,0.2251655629139073,1.0
100,73,83,73,83,55,467,0.371900826446281,60,80,50,40,40,30,300,0.15328467153284672,2.0
91,90,129,90,72,108,580,0.9140625,55,40,50,65,85,40,335,0.3181818181818182,0.0
60,80,110,50,80,45,425,0.2833333333333333,40,30,35,50,70,55,280,0.28205128205128205,1.0
40,70,40,35,40,60,285,0.392,100,73,83,73,83,55,467,0.371900826446281,0.5
60,80,50,50,50,40,330,0.23853211009174313,66,117,70,40,50,67,410,0.4573643410852713,1.0
43,30,55,40,65,97,330,0.6030534351145038,75,100,63,80,63,116,497,0.9345794392523364,1.0
70,115,60,115,60,55,475,0.4647887323943662,45,50,45,115,55,95,405,0.6936936936936937,1.0
91,90,129,90,72,108,580,0.9140625,55,65,35,60,30,85,330,0.6126126126126126,0.5
75,100,95,40,70,110,490,0.8717948717948718,79,115,70,125,80,111,580,0.864,1.0
40,60,40,40,40,30,250,0.0948905109489051,40,30,30,40,50,30,220,0.07936507936507936,4.0
60,67,85,77,75,116,480,0.8888888888888888,45,49,65,49,65,45,318,0.275,0.5
40,55,80,35,60,30,300,0.15037593984962405,86,81,97,81,107,43,495,0.203125,2.0
75,95,125,45,75,95,510,0.8257575757575758,60,70,105,70,120,75,500,0.5983606557377049,1.0
55,40,50,65,85,40,335,0.3181818181818182,80,100,123,122,120,80,625,0.56,0.5
255,10,10,75,135,55,540,0.3125,100,150,110,95,110,70,635,0.5923076923076923,1.0
50,75,75,65,65,50,380,0.4049586776859504,70,100,70,105,75,40,460,0.23214285714285715,1.0
65,90,115,45,115,58,488,0.5041322314049587,100,100,100,100,100,100,600,0.831858407079646,1.0
40,65,95,60,45,35,340,0.13986013986013987,114,85,70,85,80,30,464,0.2066115702479339,1.0
58,50,145,95,105,30,483,0.2459016393442623,71,95,85,110,95,79,535,0.664,1.0
70,55,95,95,110,65,490,0.48872180451127817,70,80,65,90,65,85,455,0.578125,0.5
70,65,65,55,55,70,380,0.5,120,100,85,30,85,45,465,0.22448979591836735,1.0
45,50,55,75,65,30,320,0.06293706293706294,55,50,65,175,95,150,590,0.7818181818181819,1.0
64,88,50,88,50,106,446,0.9111111111111111,50,65,107,105,107,86,520,0.703125,1.0
55,45,43,55,43,72,313,0.5853658536585366,91,72,90,129,90,108,580,0.8925619834710744,2.0
80,82,83,100,100,80,525,0.6742424242424242,60,95,80,60,80,30,405,0.19480519480519481,0.5
71,73,88,120,89,59,500,0.43537414965986393,54,63,52,83,56,97,405,0.7697841726618705,0.5
75,125,230,55,95,30,610,0.3448275862068966,54,63,52,83,56,97,405,0.7697841726618705,0.5
75,70,90,70,105,80,490,0.656,55,63,90,50,80,42,380,0.21138211382113822,4.0
110,80,90,95,90,65,530,0.5033557046979866,30,45,59,30,39,57,260,0.2803030303030303,1.0
70,65,60,90,75,90,450,0.6571428571428571,95,135,80,110,80,100,600,0.8248175182481752,0.5
75,69,72,114,100,104,534,0.8253968253968254,170,90,45,90,45,60,500,0.427536231884058,0.5
90,93,55,70,55,55,418,0.3819444444444444,74,100,72,90,72,46,454,0.24561403508771928,2.0
44,48,65,50,64,43,314,0.1623931623931624,60,50,70,50,90,65,385,0.39568345323741005,1.0
43,70,48,50,60,38,309,0.2391304347826087,70,90,110,60,75,95,500,0.7333333333333333,0.25
30,40,55,40,55,60,280,0.3237410071942446,100,50,50,76,96,70,442,0.5,1.0
85,105,55,85,50,115,495,0.9032258064516129,85,60,65,135,105,100,550,0.7518248175182481,2.0
75,105,75,105,75,45,480,0.3274336283185841,80,70,70,90,100,70,480,0.5609756097560976,0.25
50,45,45,35,35,50,260,0.23529411764705882,55,70,55,40,55,85,360,0.7073170731707317,1.0
85,60,65,135,105,100,550,0.7518248175182481,70,84,70,65,70,51,410,0.2949640287769784,0.5
59,63,80,65,80,58,405,0.41843971631205673,50,80,95,10,45,10,290,0.232,2.0
115,140,130,55,55,40,535,0.4519230769230769,61,78,95,56,58,57,405,0.40336134453781514,0.5
80,120,79,95,79,70,523,0.5833333333333334,105,150,90,150,90,95,680,0.8285714285714286,1.0
64,51,23,51,23,28,240,0.11363636363636363,60,40,80,60,45,40,325,0.23529411764705882,1.0
50,150,50,150,50,150,600,0.9339622641509434,50,65,107,105,107,86,520,0.6991150442477876,1.0
50,85,40,85,40,35,335,0.1746031746031746,65,80,140,40,70,70,465,0.5223880597014925,0.25
65,60,70,85,75,40,395,0.1796875,50,105,79,35,110,76,455,0.6214285714285714,1.0
95,110,95,40,95,55,490,0.40336134453781514,50,53,48,53,48,64,316,0.358974358974359,1.0
62,77,62,50,42,65,358,0.4838709677419355,120,70,120,75,130,85,600,0.6694915254237288,1.0
100,100,100,100,100,100,600,0.8778625954198473,45,65,34,40,34,45,263,0.2589928057553957,1.0
75,90,50,110,80,95,500,0.7985611510791367,55,50,40,40,40,75,300,0.5945945945945946,1.0
105,95,80,40,80,90,490,0.753968253968254,1,90,45,30,30,40,236,0.33064516129032256,0.0
70,60,125,115,70,55,495,0.35507246376811596,72,60,30,20,30,25,237,0.11570247933884298,0.5
100,128,90,77,77,128,600,0.959349593495935,65,130,60,75,60,75,465,0.689922480620155,2.0
20,15,20,10,55,80,200,0.2682926829268293,40,70,130,60,130,25,455,0.17355371900826447,1.0
103,60,86,60,86,50,445,0.3458646616541353,55,40,40,65,45,35,280,0.16428571428571428,1.0
105,140,95,55,65,45,505,0.3,20,40,15,35,35,60,205,0.34285714285714286,1.0
90,60,60,40,40,40,330,0.29545454545454547,50,85,55,65,65,90,410,0.7478260869565218,2.0
50,95,90,95,90,180,600,0.9172413793103448,95,23,48,23,48,23,260,0.046153846153846156,0.5
110,123,65,100,65,65,528,0.5217391304347826,45,45,55,45,55,63,308,0.4594594594594595,2.0
90,92,75,92,85,60,494,0.49586776859504134,64,165,75,93,83,75,555,0.6587301587301587,1.0
45,65,34,40,34,45,263,0.2589928057553957,45,50,43,40,38,62,278,0.40441176470588236,2.0
80,82,83,100,100,80,525,0.6742424242424242,75,95,125,45,75,95,510,0.8257575757575758,0.5
40,65,40,80,40,65,330,0.5038167938931297,68,75,53,83,113,60,452,0.45384615384615384,1.0
55,81,60,50,70,97,413,0.7214285714285714,44,75,35,63,33,45,295,0.2647058823529412,0.0
50,50,40,50,40,64,294,0.45588235294117646,78,84,78,109,85,100,534,0.8620689655172413,2.0
54,45,47,75,98,52,371,0.39669421487603307,85,73,70,73,115,67,483,0.5126050420168067,1.0
70,120,100,145,105,20,560,0.2824427480916031,40,70,40,35,40,60,285,0.392,1.0
60,50,50,60,70,50,340,0.28346456692913385,36,50,50,65,60,44,305,0.16363636363636364,1.0
74,108,133,83,65,32,495,0.32142857142857145,55,85,122,58,75,99,494,0.8099173553719008,0.5
40,50,45,70,45,70,320,0.5517241379310345,70,110,80,55,80,105,500,0.8794326241134752,2.0
45,50,55,75,65,30,320,0.06293706293706294,75,90,90,140,90,115,600,0.9481481481481482,0.5
60,30,30,36,56,50,262,0.32432432432432434,106,190,100,154,100,130,780,0.9259259259259259,2.0
80,85,95,30,30,25,345,0.2857142857142857,90,90,85,125,90,100,580,0.768595041322314,0.0
60,50,70,80,80,140,480,0.8449612403100775,50,45,45,35,35,50,260,0.23529411764705882,1.0
67,82,62,46,48,43,348,0.22033898305084745,100,100,125,110,50,50,535,0.384,1.0
60,60,40,65,45,35,305,0.15833333333333333,50,50,62,40,62,65,329,0.4188034188034188,2.0
70,20,50,20,50,40,250,0.1557377049180328,75,90,50,110,80,95,500,0.7985611510791367,2.0
45,45,55,45,55,63,308,0.4594594594594595,50,35,55,25,25,15,205,0.021739130434782608,0.5
60,80,50,40,40,30,300,0.15328467153284672,35,40,100,90,55,35,355,0.1796875,1.0
120,100,85,30,85,45,465,0.22448979591836735,60,80,110,50,80,45,425,0.2833333333333333,1.0
55,85,55,50,55,60,360,0.4233576642335766,40,65,40,80,40,65,330,0.5038167938931297,2.0
64,78,52,78,52,81,405,0.6422764227642277,125,170,100,120,90,95,700,0.77,2.0
90,132,105,132,105,30,594,0.4246575342465753,86,68,72,109,66,106,507,0.8099173553719008,0.25
43,30,55,40,65,97,330,0.6030534351145038,90,120,100,150,120,100,680,0.7718120805369127,0.25
45,100,135,65,135,45,525,0.29411764705882354,68,125,65,65,115,80,518,0.6277372262773723,2.0
75,89,85,55,65,36,405,0.29545454545454547,40,70,130,60,130,25,455,0.17355371900826447,1.0
95,85,85,65,65,35,430,0.2571428571428571,72,105,115,54,86,68,500,0.5149253731343284,2.0
110,85,95,80,95,50,515,0.2713178294573643,56,61,65,48,45,38,313,0.17567567567567569,1.0
70,60,75,110,75,90,480,0.7165354330708661,65,70,60,65,65,115,440,0.8583333333333333,1.0
55,95,115,45,45,35,390,0.2116788321167883,85,80,70,135,75,90,535,0.7006802721088435,1.0
116,55,85,107,95,29,487,0.06818181818181818,60,40,60,95,60,55,370,0.4222222222222222,1.0
60,50,40,85,75,95,405,0.7540983606557377,40,45,40,35,35,56,251,0.373015873015873,2.0
70,20,50,20,50,40,250,0.1557377049180328,40,45,40,35,35,56,251,0.373015873015873,1.0
71,120,95,120,95,99,600,0.8203125,75,100,63,80,63,116,497,0.9345794392523364,0.5
60,50,150,50,150,60,520,0.5206611570247934,106,150,70,194,120,140,780,0.952,2.0
100,100,100,100,100,100,600,0.8758169934640523,61,84,65,70,70,70,420,0.5,1.0
95,145,130,120,90,120,700,0.9398496240601504,45,95,50,40,50,75,355,0.54,1.0
40,35,30,20,20,50,195,0.23423423423423423,90,93,55,70,55,55,418,0.3819444444444444,0.25
100,100,80,60,60,50,450,0.3050847457627119,80,100,70,50,60,45,405,0.25806451612903225,1.0
80,115,80,65,55,93,488,0.7846153846153846,81,102,77,85,75,85,505,0.5642857142857143,1.0
45,50,35,55,75,40,300,0.21367521367521367,60,40,60,95,60,55,370,0.4222222222222222,1.0
65,70,60,65,65,115,440,0.8583333333333333,71,82,64,64,59,112,452,0.9327731092436975,1.0
80,75,150,75,150,50,580,0.30973451327433627,75,125,230,55,95,30,610,0.3448275862068966,0.5
80,145,150,105,110,110,700,0.8692307692307693,50,50,40,50,40,64,294,0.45588235294117646,0.5
80,95,82,60,82,75,474,0.6,126,131,95,131,98,99,680,0.8102189781021898,1.0
80,160,60,170,130,80,680,0.6180555555555556,40,45,40,62,60,60,307,0.33884297520661155,1.0
50,53,48,53,48,64,316,0.46153846153846156,70,90,90,135,90,125,600,0.9401709401709402,1.0
35,20,65,40,65,20,245,0.02459016393442623,91,72,90,129,90,108,580,0.8925619834710744,2.0
31,45,90,30,30,40,266,0.21929824561403508,65,125,100,55,70,85,500,0.6532258064516129,0.5
50,100,150,100,150,50,600,0.37142857142857144,50,52,48,65,50,55,320,0.33098591549295775,1.0
55,40,50,65,85,40,335,0.3181818181818182,55,55,85,65,85,35,380,0.2014388489208633,1.0
63,63,47,41,41,74,329,0.56,68,90,65,50,55,82,410,0.6165413533834586,0.5
50,70,160,70,160,90,600,0.7417218543046358,59,45,40,35,40,31,250,0.14285714285714285,1.0
78,70,61,50,61,100,420,0.8145161290322581,65,65,45,75,45,95,390,0.72,1.0
80,110,60,150,130,70,600,0.5042016806722689,50,55,50,36,30,43,264,0.2922077922077922,0.0
68,65,65,125,115,80,518,0.6461538461538462,83,106,65,86,65,85,490,0.6640625,2.0
62,77,62,50,42,65,358,0.4838709677419355,68,165,95,65,115,110,618,0.8615384615384616,2.0
40,30,35,50,70,55,280,0.28205128205128205,75,95,122,58,75,69,494,0.5725806451612904,0.5
100,150,90,180,160,90,770,0.7348484848484849,75,90,140,60,60,40,465,0.3008130081300813,1.0
60,90,140,50,50,40,430,0.2535211267605634,91,90,106,130,106,77,600,0.648854961832061,0.25
67,89,116,79,116,33,500,0.2624113475177305,50,50,120,80,80,30,410,0.07258064516129033,1.0
75,75,55,105,85,30,425,0.1619718309859155,70,90,45,15,45,50,315,0.3629032258064516,0.5
100,100,100,100,100,100,600,0.831858407079646,45,45,55,45,55,63,308,0.4594594594594595,1.0
90,95,105,165,110,45,610,0.2890625,45,67,60,35,50,63,320,0.5128205128205128,2.0
100,100,100,100,100,100,600,0.831858407079646,54,78,103,53,45,22,355,0.23255813953488372,1.0
55,45,43,55,43,72,313,0.5853658536585366,45,60,40,70,50,45,310,0.2846715328467153,1.0
50,160,110,160,110,110,700,0.8854961832061069,84,86,88,111,101,60,530,0.4634146341463415,0.25
50,70,50,50,50,70,340,0.5645161290322581,35,45,160,30,45,70,385,0.48148148148148145,2.0
40,30,35,45,40,55,245,0.31496062992125984,64,88,50,88,50,106,446,0.9111111111111111,1.0
60,80,50,50,50,40,330,0.23853211009174313,58,89,77,45,45,48,362,0.3177570093457944,0.5
20,40,15,35,35,60,205,0.34285714285714286,78,70,61,50,61,100,420,0.8145161290322581,1.0
75,80,85,110,90,50,490,0.3548387096774194,110,85,95,80,95,50,515,0.2713178294573643,1.0
55,50,65,175,95,150,590,0.7818181818181819,78,70,61,50,61,100,420,0.8145161290322581,1.0
70,90,110,60,75,95,500,0.7333333333333333,75,110,110,110,105,80,590,0.656934306569343,1.0
60,85,60,85,60,55,405,0.3673469387755102,85,90,80,70,80,130,535,0.9262295081967213,0.25
50,50,77,95,77,91,440,0.5916666666666667,84,71,43,71,43,48,360,0.25874125874125875,0.0
20,40,15,35,35,60,205,0.34285714285714286,75,80,95,90,100,50,490,0.2158273381294964,0.5
80,95,82,60,82,75,474,0.6,35,65,35,65,35,65,300,0.46621621621621623,1.0
30,45,135,45,90,30,375,0.09285714285714286,115,45,20,45,25,20,270,0.11538461538461539,1.0
80,105,105,105,105,80,580,0.5939849624060151,55,75,50,40,40,80,340,0.6302521008403361,1.0
80,100,200,50,100,50,580,0.3472222222222222,45,67,60,35,50,63,320,0.5128205128205128,1.0
105,130,120,45,45,40,485,0.4444444444444444,70,60,70,87,78,85,450,0.6228070175438597,0.5
100,75,115,90,115,85,580,0.6446280991735537,65,95,75,55,55,85,430,0.6933333333333334,0.5
105,180,100,180,100,115,780,0.9477611940298507,50,25,28,45,55,15,218,0.0625,0.0
55,75,85,25,25,15,280,0.1875,61,78,95,56,58,57,405,0.40336134453781514,1.0
82,121,119,69,59,71,521,0.5394736842105263,75,69,72,114,100,104,534,0.8253968253968254,2.0
44,50,91,24,86,10,305,0.1981981981981982,80,115,80,65,55,93,488,0.7846153846153846,0.5
70,50,30,95,135,105,485,0.8040540540540541,65,125,100,60,70,70,490,0.6099290780141844,0.5
80,185,115,40,105,75,600,0.6230769230769231,80,100,70,50,60,45,405,0.25806451612903225,0.5
150,80,44,90,54,80,498,0.625,70,70,40,60,40,60,340,0.4247787610619469,1.0
54,66,70,44,55,46,335,0.4214876033057851,49,66,70,44,55,51,335,0.4260869565217391,1.0
60,100,85,80,85,100,510,0.7007874015748031,40,40,50,30,30,30,220,0.0873015873015873,1.0
100,120,120,150,100,90,680,0.7880794701986755,61,90,45,50,50,160,456,0.9230769230769231,1.0
50,53,48,53,48,64,316,0.358974358974359,58,64,58,80,65,80,405,0.609271523178808,2.0
64,115,65,83,63,65,455,0.5323741007194245,60,90,70,60,120,40,440,0.27419354838709675,0.0
75,125,70,125,70,115,580,0.9037037037037037,40,70,130,60,130,25,455,0.17355371900826447,1.0
67,58,57,81,67,101,431,0.8790322580645161,71,82,64,64,59,112,452,0.9327731092436975,1.0
90,92,87,75,85,76,505,0.5409836065573771,80,70,65,80,120,100,515,0.8034188034188035,1.0
65,95,57,100,85,93,495,0.7441860465116279,40,60,40,40,40,30,250,0.0948905109489051,2.0
80,100,70,50,60,45,405,0.25806451612903225,50,95,95,35,110,70,455,0.5179856115107914,1.0
100,100,80,60,60,50,450,0.3050847457627119,60,80,110,50,80,45,425,0.2833333333333333,2.0
80,130,100,160,120,110,700,0.8981481481481481,255,10,10,75,135,55,540,0.3125,1.0
60,45,50,90,80,70,395,0.625,123,100,62,97,81,68,531,0.4806201550387597,4.0
38,35,35,65,55,50,278,0.2647058823529412,80,145,150,105,110,110,700,0.8692307692307693,0.125
50,105,79,35,110,76,455,0.6214285714285714,50,65,107,105,107,86,520,0.703125,2.0
55,68,64,45,55,31,318,0.11666666666666667,80,110,120,130,90,70,600,0.6198347107438017,1.0
60,70,50,100,50,65,395,0.5217391304347826,40,55,99,40,79,47,360,0.26262626262626265,1.0
50,70,100,40,40,30,330,0.2222222222222222,75,80,55,25,35,35,305,0.18666666666666668,0.5
45,49,49,65,65,45,318,0.2781954887218045,60,100,85,80,85,100,510,0.7007874015748031,1.0
75,75,60,83,60,60,413,0.39344262295081966,75,98,63,98,63,101,498,0.889763779527559,2.0
62,44,50,44,50,55,305,0.3629032258064516,75,80,95,90,100,50,490,0.2158273381294964,1.0
62,77,62,50,42,65,358,0.4838709677419355,100,150,90,180,160,90,770,0.7348484848484849,1.0
70,75,60,105,60,105,475,0.88,55,55,50,45,65,55,325,0.37373737373737376,1.0
72,95,67,103,71,122,530,0.9606299212598425,70,135,105,60,105,20,495,0.5806451612903226,1.0
100,70,70,65,65,45,415,0.1897810218978102,78,130,111,130,85,100,634,0.8561151079136691,1.0
110,160,110,80,110,100,670,0.8591549295774648,60,80,95,70,85,50,440,0.2231404958677686,0.5
35,45,160,30,45,70,385,0.48148148148148145,70,120,40,95,40,95,460,0.8106060606060606,1.0
78,130,111,130,85,100,634,0.8561151079136691,71,73,88,120,89,59,500,0.43537414965986393,0.5
104,91,63,91,73,68,490,0.5118110236220472,55,45,43,55,43,72,313,0.5853658536585366,1.0
75,95,125,45,75,95,510,0.8257575757575758,42,52,67,39,56,50,306,0.2868217054263566,1.0
83,80,80,135,80,121,579,0.9444444444444444,100,70,70,65,65,45,415,0.1897810218978102,1.0
35,35,40,35,55,50,250,0.40336134453781514,60,90,140,50,50,40,430,0.2535211267605634,0.25
89,125,90,115,80,101,600,0.8725490196078431,46,57,40,40,40,50,273,0.25,2.0
50,53,48,53,48,64,316,0.4076923076923077,64,165,75,93,83,75,555,0.6587301587301587,1.0
78,130,111,130,85,100,634,0.8561151079136691,111,83,68,92,82,39,475,0.1774193548387097,0.5
55,45,45,25,25,15,210,0.048,35,35,35,35,35,35,210,0.13385826771653545,1.0
64,51,23,51,23,28,240,0.11363636363636363,90,132,105,132,105,30,594,0.4246575342465753,1.0
65,63,45,45,45,45,308,0.2595419847328244,86,76,86,116,56,95,515,0.7982456140350878,2.0
65,90,115,45,115,58,488,0.5041322314049587,66,65,48,62,57,52,350,0.36220472440944884,1.0
65,70,60,65,65,115,440,0.8583333333333333,50,65,107,105,107,86,520,0.7313432835820896,1.0
50,75,70,35,70,48,348,0.29357798165137616,59,66,70,44,55,41,335,0.25190839694656486,0.0
61,78,95,56,58,57,405,0.40336134453781514,60,40,60,95,60,55,370,0.4222222222222222,0.5
40,30,35,50,70,55,280,0.28205128205128205,70,70,115,130,90,60,535,0.5338983050847458,0.0
35,45,160,30,45,70,385,0.48148148148148145,75,89,85,55,65,36,405,0.29545454545454547,0.5
75,125,100,70,80,45,495,0.33035714285714285,70,80,50,35,35,35,305,0.14,0.25
83,80,75,70,70,101,479,0.8615384615384616,55,70,40,60,40,40,305,0.26956521739130435,1.0
55,40,85,80,105,40,405,0.23622047244094488,100,134,110,95,100,61,600,0.4057971014492754,1.0
95,75,110,100,80,30,490,0.15267175572519084,70,70,115,130,90,60,535,0.5338983050847458,0.5
77,120,90,60,90,48,485,0.2785714285714286,40,40,40,70,40,20,250,0.032520325203252036,1.0
50,50,120,80,80,30,410,0.07258064516129033,62,50,58,73,54,72,369,0.4435483870967742,1.0
60,115,105,65,70,80,495,0.7181818181818181,78,52,60,63,65,23,341,0.06015037593984962,1.0
54,78,103,53,45,22,355,0.23255813953488372,125,130,90,130,90,95,660,0.7734375,1.0
60,48,45,43,90,42,328,0.21897810218978103,95,60,79,100,125,81,540,0.6201550387596899,1.0
95,75,180,130,80,30,590,0.13793103448275862,31,45,90,30,30,40,266,0.21929824561403508,4.0
60,75,85,100,85,115,520,0.8992248062015504,70,120,65,45,85,125,510,0.9747899159663865,0.0
70,77,60,97,60,108,472,0.8394160583941606,40,60,30,31,31,70,262,0.4492753623188406,1.0
165,75,80,40,45,65,470,0.5151515151515151,75,89,85,55,65,36,405,0.29545454545454547,0.5
45,35,45,62,53,35,275,0.11851851851851852,85,97,66,105,66,65,484,0.47107438016528924,0.5
116,55,85,107,95,29,487,0.06818181818181818,84,86,88,111,101,60,530,0.4634146341463415,0.5
100,100,90,150,140,90,670,0.71875,80,80,50,40,50,25,325,0.176056338028169,1.0
58,64,58,80,65,80,405,0.609271523178808,86,92,88,68,75,73,482,0.6835443037974683,1.0
56,61,65,48,45,38,313,0.17567567567567569,60,50,70,50,90,65,385,0.39568345323741005,0.25
36,50,50,65,60,44,305,0.16363636363636364,55,50,45,135,95,120,500,0.7714285714285715,1.0
70,80,65,90,65,85,455,0.578125,50,65,107,105,107,86,520,0.7313432835820896,1.0
55,50,45,135,95,120,500,0.7714285714285715,67,82,62,46,48,43,348,0.22033898305084745,1.0
50,65,85,35,35,55,325,0.32575757575757575,38,36,38,32,36,57,237,0.3893805309734513,1.0
70,95,85,55,65,70,440,0.5,55,75,85,25,25,15,280,0.1875,1.0
71,95,85,110,95,79,535,0.664,79,105,70,145,80,101,580,0.8608695652173913,2.0
75,75,55,105,85,30,425,0.1619718309859155,30,35,30,100,35,80,310,0.4765625,0.5
65,95,75,55,55,85,430,0.6933333333333334,50,65,107,105,107,86,520,0.6991150442477876,2.0
60,60,60,85,85,85,435,0.631578947368421,45,67,60,35,50,63,320,0.5128205128205128,1.0
41,64,45,50,50,50,300,0.36752136752136755,30,80,90,55,45,55,355,0.4295774647887324,1.0
126,131,95,131,98,99,680,0.8294573643410853,50,105,79,35,110,76,455,0.6214285714285714,2.0
50,65,45,85,65,95,405,0.7238095238095238,70,140,230,60,80,50,630,0.32432432432432434,0.5
85,60,65,135,105,100,550,0.7518248175182481,85,100,122,58,75,54,494,0.3939393939393939,2.0
60,65,80,170,95,130,600,0.8625954198473282,80,45,65,90,110,80,470,0.5462962962962963,2.0
72,60,30,20,30,25,237,0.11570247933884298,50,72,35,35,35,65,292,0.5373134328358209,2.0
57,24,86,24,86,23,300,0.12727272727272726,70,100,115,30,65,30,410,0.24390243902439024,2.0
44,38,33,61,43,70,289,0.5267857142857143,40,50,90,30,55,65,330,0.44680851063829785,1.0
38,36,38,32,36,57,237,0.3893805309734513,40,45,35,30,40,55,245,0.3793103448275862,1.0
60,69,95,69,95,36,424,0.2608695652173913,40,45,65,100,120,90,460,0.5588235294117647,0.5
65,40,70,80,140,70,465,0.5954198473282443,70,84,70,65,70,51,410,0.2949640287769784,2.0
73,100,60,100,60,65,458,0.42657342657342656,40,65,40,80,40,65,330,0.5038167938931297,1.0
61,84,65,70,70,70,420,0.5,38,36,38,32,36,57,237,0.3893805309734513,1.0
78,104,78,159,115,100,634,0.8444444444444444,55,95,115,45,45,35,390,0.2116788321167883,0.25
70,45,48,60,65,35,323,0.15748031496062992,76,48,48,57,62,34,325,0.11688311688311688,1.0
77,59,50,67,63,46,362,0.23140495867768596,60,62,63,80,80,60,405,0.38016528925619836,2.0
43,30,55,40,65,97,330,0.6030534351145038,71,82,64,64,59,112,452,0.9327731092436975,1.0
90,93,55,70,55,55,418,0.3819444444444444,65,90,120,85,70,60,490,0.43410852713178294,0.5
70,80,65,90,65,85,455,0.578125,95,110,80,70,80,50,485,0.37209302325581395,1.0
85,50,95,120,115,80,545,0.5793650793650794,85,90,80,70,80,130,535,0.9262295081967213,0.5
85,120,70,50,60,100,485,0.8308823529411765,125,58,58,76,76,67,460,0.515625,0.5
50,45,45,35,35,50,260,0.23529411764705882,68,90,65,50,55,82,410,0.6165413533834586,1.0
108,100,121,81,95,95,600,0.7476635514018691,55,95,55,35,75,115,430,0.9380530973451328,1.0
50,160,110,160,110,110,700,0.8854961832061069,35,35,35,35,35,35,210,0.13385826771653545,1.0
75,125,75,30,75,85,465,0.625,45,22,60,27,30,29,213,0.07518796992481203,0.5
70,60,62,80,82,60,414,0.4375,59,74,50,35,50,35,303,0.3125,0.5
70,77,60,97,60,108,472,0.8394160583941606,70,120,100,145,105,20,560,0.2824427480916031,0.0
65,85,70,75,70,40,405,0.203125,76,147,90,60,70,97,540,0.8267716535433071,0.5
36,50,50,65,60,44,305,0.16363636363636364,39,52,43,60,50,65,309,0.49107142857142855,0.5
40,65,95,60,45,35,340,0.13986013986013987,80,80,80,55,55,90,440,0.6417910447761194,1.0
45,95,50,40,50,75,355,0.54,45,50,55,75,65,30,320,0.06293706293706294,1.0
40,50,90,30,55,65,330,0.44680851063829785,54,63,52,83,56,97,405,0.7697841726618705,1.0
70,80,65,90,65,85,455,0.578125,90,70,80,70,95,70,475,0.5190839694656488,1.0
50,95,180,85,45,70,525,0.5298507462686567,45,30,40,105,50,20,290,0.031007751937984496,1.0
85,115,80,105,80,50,515,0.3063063063063063,75,89,85,55,65,36,405,0.29545454545454547,0.5
60,50,70,80,80,140,480,0.8449612403100775,75,125,230,55,95,30,610,0.3448275862068966,0.0
72,95,67,103,71,122,530,0.9606299212598425,50,40,85,40,65,25,305,0.08870967741935484,1.0
60,82,45,45,45,74,351,0.5752212389380531,55,40,50,65,85,40,335,0.3181818181818182,2.0
60,80,50,40,40,30,300,0.15328467153284672,75,80,85,110,90,50,490,0.3548387096774194,0.5
90,60,70,75,70,45,410,0.23880597014925373,75,85,200,55,65,30,510,0.16778523489932887,2.0
45,60,32,50,32,76,295,0.5925925925925926,63,63,47,41,41,74,329,0.56,1.0
75,75,55,105,85,30,425,0.1619718309859155,45,25,50,25,25,35,205,0.13076923076923078,0.25
110,160,110,80,110,100,670,0.8591549295774648,75,95,67,125,95,83,540,0.7117117117117117,1.0
50,70,160,70,160,90,600,0.7417218543046358,45,45,55,45,55,63,308,0.4594594594594595,1.0
49,55,42,42,37,85,310,0.6068376068376068,90,100,60,90,60,80,480,0.6422764227642277,1.0
50,160,110,160,110,110,700,0.8854961832061069,60,45,70,75,85,55,390,0.3008130081300813,1.0
84,71,43,71,43,48,360,0.25874125874125875,73,100,60,100,60,65,458,0.42657342657342656,1.0
85,97,66,105,66,65,484,0.47107438016528924,80,85,95,30,30,25,345,0.2857142857142857,0.5
45,55,39,35,39,42,255,0.18518518518518517,37,25,41,25,41,25,194,0.08870967741935484,1.0
30,40,70,70,25,60,295,0.41353383458646614,103,60,126,80,126,50,545,0.36363636363636365,1.0
70,55,95,95,110,65,490,0.48872180451127817,105,95,80,40,80,90,490,0.753968253968254,1.0
60,100,85,80,85,100,510,0.7007874015748031,50,92,108,92,108,35,485,0.2457627118644068,0.0
110,65,75,125,85,30,490,0.15,43,70,48,50,60,38,309,0.2391304347826087,1.0
70,55,95,95,110,65,490,0.48872180451127817,62,50,58,73,54,72,369,0.4435483870967742,1.0
77,120,90,60,90,48,485,0.2785714285714286,55,40,40,65,45,35,280,0.16428571428571428,1.0
43,70,48,50,60,38,309,0.2391304347826087,70,60,75,110,75,90,480,0.7165354330708661,0.5
79,100,80,110,90,121,580,0.968,50,50,62,40,62,65,329,0.4188034188034188,1.0
63,120,85,90,55,55,468,0.2809917355371901,120,70,120,75,130,85,600,0.6694915254237288,2.0
60,40,60,95,60,55,370,0.4222222222222222,67,89,116,79,116,33,500,0.2624113475177305,4.0
60,50,100,85,70,65,430,0.47580645161290325,80,100,200,50,100,50,580,0.3472222222222222,1.0
95,124,78,69,71,58,495,0.37398373983739835,76,104,71,104,71,108,534,0.912751677852349,0.5
55,47,52,40,40,41,275,0.16806722689075632,50,50,77,95,77,91,440,0.5916666666666667,0.5
67,89,116,79,116,33,500,0.2624113475177305,70,75,60,105,60,105,475,0.88,0.5
40,30,35,50,70,55,280,0.28205128205128205,80,100,80,80,80,100,520,0.9051724137931034,0.5
95,110,95,40,95,55,490,0.40336134453781514,70,140,70,110,65,105,560,0.95,1.0
80,125,75,40,95,85,500,0.6911764705882353,50,105,125,55,95,50,480,0.375886524822695,0.25
30,45,59,30,39,57,260,0.2803030303030303,100,164,150,95,120,71,700,0.5645161290322581,1.0
80,160,80,130,80,100,630,0.8455284552845529,135,85,40,40,85,5,390,0.6864406779661016,2.0
50,80,95,10,45,10,290,0.232,100,120,100,150,120,90,680,0.728,2.0
40,30,50,55,55,100,330,0.584070796460177,75,125,70,125,70,115,580,0.9037037037037037,1.0
100,120,120,150,100,90,680,0.7880794701986755,75,38,38,56,56,67,330,0.5263157894736842,0.25
68,65,65,125,115,80,518,0.6461538461538462,70,80,50,35,35,35,305,0.14,2.0
40,65,95,60,45,35,340,0.13986013986013987,90,100,70,110,150,80,600,0.6037735849056604,1.0
45,75,37,70,55,83,365,0.6183206106870229,95,65,65,110,130,60,525,0.4016393442622951,1.0
100,100,100,100,100,100,600,0.8602941176470589,65,95,57,100,85,93,495,0.7441860465116279,0.5
70,140,70,110,65,105,560,0.95,80,115,80,65,55,93,488,0.7846153846153846,1.0
72,58,80,103,80,97,490,0.7171052631578947,55,130,115,50,50,75,475,0.5982142857142857,1.0
50,180,20,180,20,150,600,0.9029850746268657,40,65,40,80,40,65,330,0.5038167938931297,0.0
75,90,90,140,90,115,600,0.9481481481481482,60,130,80,60,60,70,460,0.5153846153846153,1.0
99,68,83,72,87,51,460,0.417910447761194,50,50,62,40,62,65,329,0.4188034188034188,0.5
65,65,60,130,95,110,525,0.823943661971831,70,90,70,60,60,70,420,0.6390977443609023,0.0
80,130,100,160,120,110,700,0.8981481481481481,70,120,100,145,105,20,560,0.2824427480916031,2.0
59,66,70,44,55,41,335,0.25190839694656486,60,60,60,85,85,85,435,0.631578947368421,2.0
70,70,70,70,70,70,420,0.5289256198347108,85,60,65,135,105,100,550,0.7518248175182481,1.0
30,65,100,45,25,40,305,0.1891891891891892,70,110,180,60,60,50,530,0.4117647058823529,2.0
40,40,40,70,40,20,250,0.032520325203252036,80,80,50,40,50,25,325,0.176056338028169,1.0
100,75,115,90,115,85,580,0.6446280991735537,75,75,130,75,130,95,580,0.7479674796747967,1.0
50,65,107,105,107,86,520,0.703125,70,40,50,55,50,25,290,0.061068702290076333,0.5
54,63,52,83,56,97,405,0.7697841726618705,45,35,45,62,53,35,275,0.11851851851851852,0.5
91,129,90,72,90,108,580,0.8536585365853658,95,117,80,65,70,92,519,0.8409090909090909,1.0
80,130,100,160,120,110,700,0.8981481481481481,64,165,75,93,83,75,555,0.6587301587301587,1.0
80,80,80,80,80,80,480,0.6015037593984962,75,80,95,90,100,50,490,0.2158273381294964,2.0
80,125,75,40,95,85,500,0.6911764705882353,75,75,95,75,95,113,528,0.9015151515151515,2.0
106,90,130,90,154,110,680,0.8699186991869918,45,50,45,115,55,95,405,0.6936936936936937,2.0
54,45,47,75,98,52,371,0.39669421487603307,60,90,140,50,50,40,430,0.2535211267605634,0.5
50,105,79,35,110,76,455,0.6214285714285714,59,110,150,45,49,35,448,0.3333333333333333,0.0
65,75,90,97,123,44,494,0.1987179487179487,66,117,70,40,50,67,410,0.4573643410852713,2.0
165,75,80,40,45,65,470,0.5151515151515151,100,100,100,100,100,100,600,0.8805970149253731,0.5
76,65,45,92,42,91,411,0.7449664429530202,130,85,80,85,95,60,535,0.43884892086330934,1.0
90,70,80,70,95,70,475,0.5190839694656488,80,80,80,80,80,80,480,0.6015037593984962,0.5
90,95,95,70,90,70,510,0.5230769230769231,40,60,30,31,31,70,262,0.4492753623188406,1.0
54,78,103,53,45,22,355,0.23255813953488372,46,87,60,30,40,57,320,0.37777777777777777,0.5
60,50,50,60,70,50,340,0.28346456692913385,80,160,60,170,130,80,680,0.6180555555555556,1.0
100,73,83,73,83,55,467,0.371900826446281,74,94,131,54,116,20,489,0.4485294117647059,0.0
60,40,60,95,60,55,370,0.4222222222222222,40,45,35,65,55,70,310,0.4482758620689655,2.0
65,70,60,65,65,115,440,0.8583333333333333,50,50,62,40,62,65,329,0.4188034188034188,1.0
55,112,45,74,45,70,401,0.559322033898305,77,85,51,55,51,65,384,0.5163934426229508,4.0
60,90,140,50,50,40,430,0.2535211267605634,64,51,23,51,23,28,240,0.11363636363636363,1.0
60,45,70,45,90,95,405,0.7304964539007093,75,98,63,98,63,101,498,0.8091603053435115,0.5
75,103,80,70,80,92,500,0.7933884297520661,100,150,90,180,160,90,770,0.7348484848484849,2.0
69,69,76,69,86,91,460,0.6554621848739496,60,55,50,40,55,45,305,0.22377622377622378,1.0
255,10,10,75,135,55,540,0.3125,70,77,60,97,60,108,472,0.8394160583941606,1.0
78,130,111,130,85,100,634,0.8561151079136691,77,85,51,55,51,65,384,0.5163934426229508,2.0
100,100,80,60,60,50,450,0.3050847457627119,85,105,85,40,50,40,405,0.211864406779661,1.0
78,84,78,109,85,100,534,0.8620689655172413,50,50,40,50,40,64,294,0.45588235294117646,0.5
75,103,80,70,80,92,500,0.7933884297520661,55,50,45,135,95,120,500,0.7714285714285715,2.0
49,55,42,42,37,85,310,0.6068376068376068,75,98,63,98,63,101,498,0.849624060150376,1.0
79,115,70,125,80,111,580,0.864,90,65,65,40,40,15,315,0.19672131147540983,2.0
20,15,20,10,55,80,200,0.2682926829268293,45,49,49,65,65,45,318,0.2781954887218045,0.5
75,65,55,65,55,69,384,0.43548387096774194,70,65,65,55,55,70,380,0.5,1.0
40,20,30,40,80,55,265,0.22764227642276422,103,60,86,60,86,50,445,0.3458646616541353,1.0
95,60,79,100,125,81,540,0.6201550387596899,90,110,80,100,80,95,555,0.7982456140350878,2.0
44,58,44,58,44,61,309,0.41964285714285715,110,80,90,95,90,65,530,0.5033557046979866,1.0
50,65,107,105,107,86,520,0.703125,60,100,89,55,69,112,485,0.9298245614035088,1.0
50,95,90,95,90,180,600,0.9172413793103448,60,85,69,65,79,80,438,0.576,2.0
95,100,85,108,70,70,528,0.5652173913043478,45,65,34,40,34,45,263,0.2589928057553957,1.0
50,65,107,105,107,86,520,0.7758620689655172,60,90,140,50,50,40,430,0.2535211267605634,2.0
95,65,110,60,130,65,525,0.5275590551181102,55,65,35,60,30,85,330,0.6126126126126126,1.0
35,20,65,40,65,20,245,0.02459016393442623,190,33,58,33,58,33,405,0.13432835820895522,1.0
60,85,49,60,49,60,363,0.4444444444444444,100,100,90,150,140,90,670,0.71875,2.0
55,84,105,114,75,52,485,0.2890625,85,120,70,50,60,100,485,0.8308823529411765,1.0
65,75,70,95,70,95,470,0.7272727272727273,70,90,110,60,75,95,500,0.7333333333333333,0.0
91,72,90,129,90,108,580,0.8620689655172413,85,90,80,70,80,130,535,0.9262295081967213,0.25
35,35,35,35,35,35,210,0.13385826771653545,79,103,120,135,115,78,630,0.5763888888888888,1.0
45,30,40,105,50,20,290,0.031007751937984496,70,100,70,105,75,40,460,0.23214285714285715,2.0
80,80,80,80,80,80,480,0.5606060606060606,50,55,50,36,30,43,264,0.2922077922077922,1.0
65,65,65,50,50,90,385,0.72,84,86,88,111,101,60,530,0.4634146341463415,0.5
65,150,60,115,60,115,565,0.935251798561151,65,100,70,80,80,105,500,0.8666666666666667,1.0
70,90,90,135,90,125,600,0.9401709401709402,80,120,79,95,79,70,523,0.5833333333333334,1.0
38,30,41,30,41,60,240,0.2897196261682243,80,115,80,65,55,93,488,0.7846153846153846,1.0
45,45,55,45,55,63,308,0.4594594594594595,115,45,20,45,25,20,270,0.11538461538461539,1.0
55,104,105,94,75,52,485,0.36363636363636365,70,77,60,97,60,108,472,0.8394160583941606,1.0
80,100,123,122,120,80,625,0.56,68,85,65,165,135,100,618,0.8083333333333333,2.0
69,69,76,69,86,91,460,0.6554621848739496,105,140,55,30,55,95,480,0.8195488721804511,2.0
64,51,23,51,23,28,240,0.11363636363636363,50,70,50,50,50,70,340,0.5645161290322581,1.0
70,135,105,60,105,20,495,0.5806451612903226,75,103,80,70,80,92,500,0.7933884297520661,2.0
38,41,40,50,65,65,299,0.4108527131782946,45,45,35,20,30,20,195,0.07246376811594203,2.0
60,80,50,40,40,30,300,0.15328467153284672,70,40,50,55,50,25,290,0.061068702290076333,1.0
59,45,40,35,40,31,250,0.14285714285714285,80,80,90,110,130,110,600,0.8721804511278195,1.0
80,70,40,100,60,145,495,0.921875,125,170,100,120,90,95,700,0.77,1.0
65,50,35,115,95,95,455,0.7333333333333333,60,40,50,75,85,95,405,0.6044776119402985,1.0
105,180,100,180,100,115,780,0.9477611940298507,44,75,35,63,33,45,295,0.2647058823529412,1.0
45,100,45,45,45,10,290,0.2949640287769784,80,110,120,130,90,70,600,0.6198347107438017,2.0
46,87,60,30,40,57,320,0.37777777777777777,70,60,62,80,82,60,414,0.4375,1.0
90,100,60,90,60,80,480,0.6422764227642277,62,44,50,44,50,55,305,0.3629032258064516,1.0
80,105,65,60,75,130,515,0.9645390070921985,50,95,95,35,110,70,455,0.5179856115107914,1.0
70,110,80,55,80,105,500,0.8794326241134752,90,90,85,125,90,100,580,0.768595041322314,0.25
130,70,35,70,35,60,400,0.4017857142857143,30,45,55,70,55,85,340,0.5633802816901409,0.5
79,100,80,110,90,121,580,0.968,55,35,50,55,110,85,390,0.6277372262773723,2.0
60,80,110,50,80,45,425,0.2833333333333333,60,50,40,85,75,95,405,0.7540983606557377,2.0
68,125,65,65,115,80,518,0.6277372262773723,91,72,90,129,90,108,580,0.8620689655172413,1.0
60,62,63,80,80,60,405,0.38016528925619836,85,105,85,40,50,40,405,0.211864406779661,1.0
60,50,50,60,70,50,340,0.28346456692913385,85,80,70,135,75,90,535,0.7006802721088435,1.0
103,60,126,80,126,50,545,0.36363636363636365,50,35,55,25,25,15,205,0.05263157894736842,1.0
59,74,50,35,50,35,303,0.3125,64,165,75,93,83,75,555,0.6587301587301587,2.0
80,92,65,65,80,68,450,0.4824561403508772,40,30,50,55,55,100,330,0.584070796460177,1.0
76,104,71,104,71,108,534,0.912751677852349,65,95,57,100,85,93,495,0.7441860465116279,0.5
106,90,130,90,154,110,680,0.8699186991869918,95,125,79,60,100,81,540,0.6165413533834586,1.0
70,120,65,45,85,125,510,0.9747899159663865,60,69,95,69,95,36,424,0.2608695652173913,0.5
90,60,60,40,40,40,330,0.29545454545454547,40,55,80,35,60,30,300,0.15037593984962405,2.0
50,75,70,35,70,48,348,0.29357798165137616,70,90,90,135,90,125,600,0.9401709401709402,1.0
50,105,125,55,95,50,480,0.375886524822695,52,65,50,45,50,38,300,0.27419354838709675,4.0
80,70,40,100,60,145,495,0.921875,110,85,95,80,95,50,515,0.2713178294573643,1.0
75,75,55,105,85,30,425,0.1619718309859155,80,80,80,80,80,80,480,0.6015037593984962,1.0
60,85,69,65,79,80,438,0.576,70,110,80,55,80,105,500,0.8794326241134752,1.0
30,40,55,40,55,60,280,0.3237410071942446,104,91,63,91,73,68,490,0.5118110236220472,2.0
74,100,72,90,72,46,454,0.24561403508771928,40,20,30,40,80,55,265,0.22764227642276422,0.25
50,85,55,65,65,90,410,0.7478260869565218,100,50,50,76,96,70,442,0.5,1.0
30,30,30,30,30,30,180,0.12612612612612611,65,150,40,15,80,145,495,0.9663865546218487,0.25
86,76,86,116,56,95,515,0.7982456140350878,95,60,79,100,125,81,540,0.6201550387596899,1.0
60,65,60,130,75,110,500,0.7719298245614035,59,63,80,65,80,58,405,0.41843971631205673,1.0
95,155,109,70,130,81,640,0.6788321167883211,78,130,111,130,85,100,634,0.8561151079136691,1.0
95,80,105,40,70,100,490,0.8046875,45,50,45,115,55,95,405,0.6936936936936937,0.0
75,75,95,75,95,113,528,0.9015151515151515,66,65,48,62,57,52,350,0.36220472440944884,0.5
78,130,111,130,85,100,634,0.8561151079136691,65,55,115,100,40,60,435,0.3798449612403101,2.0
51,65,65,80,75,59,395,0.4365079365079365,80,135,130,95,90,70,600,0.5181818181818182,0.5
50,50,50,50,50,50,300,0.30708661417322836,85,80,90,105,95,60,515,0.49074074074074076,1.0
70,95,125,65,75,45,475,0.33613445378151263,91,129,90,72,90,108,580,0.8536585365853658,0.25
80,80,80,55,55,90,440,0.6417910447761194,50,50,50,50,50,50,300,0.30708661417322836,1.0
65,75,105,35,65,85,430,0.6940298507462687,103,60,86,60,86,50,445,0.3458646616541353,1.0
50,92,108,92,108,35,485,0.2457627118644068,116,55,85,107,95,29,487,0.06818181818181818,4.0
50,50,120,80,80,30,410,0.07258064516129033,50,50,40,50,40,64,294,0.45588235294117646,0.5
65,63,45,45,45,45,308,0.2595419847328244,50,70,50,50,50,40,310,0.16296296296296298,0.5
20,10,55,15,20,80,200,0.17985611510791366,91,134,95,100,100,80,600,0.6304347826086957,0.5
10,55,25,35,45,95,265,0.5396825396825397,80,185,115,40,105,75,600,0.6230769230769231,0.5
76,25,45,67,55,24,292,0.0390625,45,80,100,35,37,28,325,0.3125,0.5
45,35,45,62,53,35,275,0.11851851851851852,70,95,85,55,65,70,440,0.5,2.0
95,85,85,65,65,35,430,0.2571428571428571,52,65,55,58,62,60,352,0.4482758620689655,0.0
70,110,70,115,70,90,525,0.75,70,20,50,20,50,40,250,0.1557377049180328,0.125
115,115,85,90,75,100,580,0.8134328358208955,75,95,95,95,95,85,540,0.6470588235294118,0.25
45,49,49,65,65,45,318,0.2781954887218045,74,100,72,90,72,46,454,0.24561403508771928,1.0
50,35,55,25,25,15,205,0.021739130434782608,68,65,65,125,115,80,518,0.6461538461538462,1.0
255,10,10,75,135,55,540,0.3125,40,40,40,70,40,20,250,0.032520325203252036,1.0
50,65,90,35,35,15,290,0.14678899082568808,100,73,83,73,83,55,467,0.371900826446281,0.5
58,109,112,48,48,109,484,0.8805970149253731,80,75,150,75,150,50,580,0.30973451327433627,0.25
35,45,160,30,45,70,385,0.48148148148148145,72,95,67,103,71,122,530,0.9606299212598425,1.0
100,103,75,120,75,127,600,0.940677966101695,45,22,60,27,30,29,213,0.07518796992481203,1.0
80,120,70,110,70,80,530,0.6422764227642277,65,125,100,55,70,85,500,0.6532258064516129,1.0
78,84,78,109,85,100,534,0.8646616541353384,45,35,50,70,50,30,280,0.15753424657534246,4.0
100,100,125,110,50,50,535,0.384,50,45,45,35,35,50,260,0.23529411764705882,1.0
57,80,91,80,87,75,470,0.5737704918032787,74,108,133,83,65,32,495,0.32142857142857145,1.0
95,75,180,130,80,30,590,0.13793103448275862,70,70,70,70,70,70,420,0.5289256198347108,1.0
60,62,50,62,60,40,334,0.18181818181818182,78,70,61,50,61,100,420,0.8145161290322581,1.0
103,93,67,71,61,84,479,0.7142857142857143,86,68,72,109,66,106,507,0.8099173553719008,1.0
35,35,40,35,55,50,250,0.40336134453781514,105,130,120,45,45,40,485,0.4444444444444444,2.0
45,30,35,20,20,45,195,0.14782608695652175,90,85,75,115,100,115,580,0.9381443298969072,1.0
95,80,105,40,70,100,490,0.8046875,105,150,90,150,90,95,680,0.8285714285714286,1.0
45,80,100,35,37,28,325,0.3125,80,115,80,65,55,93,488,0.7846153846153846,0.0
100,100,80,60,60,50,450,0.3050847457627119,70,94,50,94,50,66,424,0.48148148148148145,0.0
80,100,70,50,60,45,405,0.25806451612903225,75,125,70,125,70,115,580,0.9037037037037037,0.5
90,50,34,60,44,70,348,0.6283185840707964,95,109,105,75,85,56,525,0.34513274336283184,2.0
82,80,86,85,75,72,480,0.6183206106870229,57,24,86,24,86,23,300,0.12727272727272726,0.5
65,90,120,85,70,60,490,0.43410852713178294,50,70,160,70,160,90,600,0.7417218543046358,1.0
72,60,30,20,30,25,237,0.11570247933884298,60,70,65,125,105,90,515,0.6911764705882353,0.5
80,45,65,90,110,80,470,0.5462962962962963,80,145,150,105,110,110,700,0.8692307692307693,0.25
65,90,120,85,70,60,490,0.43410852713178294,60,45,70,45,90,95,405,0.7304964539007093,1.0
10,55,25,35,45,95,265,0.5396825396825397,95,80,105,40,70,100,490,0.8046875,1.0
61,72,57,55,55,65,365,0.3984375,69,55,45,55,55,15,294,0.11666666666666667,1.0
50,160,110,160,110,110,700,0.8854961832061069,79,103,120,135,115,78,630,0.5763888888888888,1.0
40,30,50,55,55,100,330,0.584070796460177,108,100,121,81,95,95,600,0.7476635514018691,0.0
70,105,105,50,40,20,390,0.33587786259541985,50,95,95,35,110,70,455,0.5179856115107914,0.5
108,170,115,120,95,92,700,0.7083333333333334,69,69,76,69,86,91,460,0.6554621848739496,1.0
65,60,110,130,95,65,525,0.47761194029850745,60,85,60,85,60,55,405,0.3673469387755102,0.5
60,75,100,55,80,50,420,0.3088235294117647,108,170,115,120,95,92,700,0.7083333333333334,2.0
85,97,66,105,66,65,484,0.47107438016528924,30,40,55,40,55,60,280,0.3237410071942446,1.0
44,38,39,61,79,42,303,0.2251655629139073,60,70,50,100,50,65,395,0.5217391304347826,1.0
60,62,50,62,60,40,334,0.18181818181818182,70,60,62,80,82,60,414,0.4375,0.5
90,130,80,65,85,55,505,0.4396551724137931,78,130,111,130,85,100,634,0.8561151079136691,1.0
62,55,52,109,94,109,481,0.7833333333333333,100,150,90,180,160,90,770,0.7348484848484849,2.0
50,52,48,65,50,55,320,0.33098591549295775,60,100,115,70,85,90,520,0.7557251908396947,1.0
80,115,80,65,55,93,488,0.7846153846153846,65,40,50,125,60,30,370,0.07258064516129033,1.0
70,70,115,130,90,60,535,0.5338983050847458,90,92,75,92,85,60,494,0.49586776859504134,1.0
75,98,63,98,63,101,498,0.849624060150376,40,30,50,55,55,100,330,0.584070796460177,1.0
95,75,110,100,80,30,490,0.15267175572519084,110,65,75,125,85,30,490,0.15,0.5
83,106,65,86,65,85,490,0.6640625,80,80,50,40,50,25,325,0.176056338028169,0.25
75,95,60,65,60,115,470,0.8778625954198473,75,95,95,95,95,85,540,0.6470588235294118,1.0
86,76,86,116,56,95,515,0.7982456140350878,110,65,105,55,95,80,510,0.6258503401360545,1.0
75,75,95,75,95,113,528,0.9015151515151515,80,100,123,122,120,80,625,0.56,0.25
100,100,125,110,50,50,535,0.384,90,132,105,132,105,30,594,0.4246575342465753,0.5
55,75,85,25,25,15,280,0.1875,108,170,115,120,95,92,700,0.7083333333333334,0.5
30,45,59,30,39,57,260,0.2803030303030303,95,85,85,65,65,35,430,0.2571428571428571,0.5
60,70,50,100,50,65,395,0.5217391304347826,60,130,80,60,60,70,460,0.5153846153846153,4.0
90,100,90,125,85,90,580,0.7352941176470589,40,30,35,50,70,55,280,0.28205128205128205,4.0
80,100,200,50,100,50,580,0.3472222222222222,40,40,55,40,70,55,300,0.40939597315436244,0.5
75,90,140,60,60,40,465,0.3008130081300813,50,100,150,100,150,50,600,0.37142857142857144,0.5
44,58,44,58,44,61,309,0.41964285714285715,50,70,50,50,50,40,310,0.16296296296296298,0.5
81,102,77,85,75,85,505,0.5642857142857143,90,120,75,60,60,45,450,0.29411764705882354,2.0
45,49,65,49,65,45,318,0.275,75,90,50,110,80,95,500,0.7985611510791367,0.5
55,66,44,44,56,85,350,0.6888888888888889,58,70,45,40,45,42,300,0.25925925925925924,1.0
45,50,55,75,65,30,320,0.06293706293706294,35,64,85,74,55,32,345,0.19827586206896552,2.0
50,50,62,40,62,65,329,0.4188034188034188,95,100,85,108,70,70,528,0.5652173913043478,1.0
55,50,45,135,95,120,500,0.7714285714285715,44,50,91,24,86,10,305,0.1981981981981982,0.5
85,73,70,73,115,67,483,0.5126050420168067,63,63,47,41,41,74,329,0.56,0.0
65,75,70,95,70,95,470,0.7272727272727273,78,52,60,63,65,23,341,0.06015037593984962,1.0
116,55,85,107,95,29,487,0.06818181818181818,108,170,115,120,95,92,700,0.7083333333333334,2.0
40,35,30,20,20,50,195,0.23423423423423423,50,53,48,53,48,64,316,0.46153846153846156,0.5
90,60,70,75,70,45,410,0.23880597014925373,80,160,60,170,130,80,680,0.6180555555555556,1.0
110,130,80,70,60,80,530,0.5862068965517241,55,45,45,25,25,15,210,0.048,1.0
83,106,65,86,65,85,490,0.6640625,45,95,50,40,50,75,355,0.54,0.5
70,92,65,80,55,98,460,0.8090909090909091,120,70,120,75,130,85,600,0.6694915254237288,1.0
40,40,55,40,70,55,300,0.40939597315436244,70,62,67,55,55,56,365,0.38513513513513514,4.0
1,90,45,30,30,40,236,0.33064516129032256,45,75,37,70,55,83,365,0.6183206106870229,0.5
68,165,95,65,115,110,618,0.8615384615384616,106,130,90,110,154,90,680,0.719626168224299,0.5
90,85,75,115,100,115,580,0.9381443298969072,65,130,60,95,110,65,525,0.5303030303030303,1.0
45,40,60,40,75,50,310,0.2926829268292683,72,60,30,20,30,25,237,0.11570247933884298,2.0
90,100,70,110,150,80,600,0.6037735849056604,88,107,122,74,75,64,530,0.4596774193548387,1.0
60,55,90,145,90,80,520,0.6071428571428571,70,92,65,80,55,98,460,0.8090909090909091,0.5
45,30,50,65,50,45,285,0.13821138211382114,125,120,90,170,100,95,700,0.78125,1.0
80,75,150,75,150,50,580,0.30973451327433627,90,75,75,90,100,70,500,0.5462184873949579,0.5
51,65,65,80,75,59,395,0.4365079365079365,40,30,30,40,50,30,220,0.07936507936507936,1.0
60,59,85,79,105,36,424,0.16666666666666666,70,92,65,80,55,98,460,0.8090909090909091,2.0
100,123,75,57,75,80,510,0.6923076923076923,70,60,62,80,82,60,414,0.4375,2.0
58,109,112,48,48,109,484,0.8805970149253731,57,80,91,80,87,75,470,0.5737704918032787,0.0625
64,88,50,88,50,106,446,0.9111111111111111,68,125,65,65,115,80,518,0.6277372262773723,1.0
50,85,40,85,40,35,335,0.1746031746031746,70,80,50,35,35,35,305,0.14,1.0
80,120,70,110,70,80,530,0.6422764227642277,255,10,10,75,135,55,540,0.3125,2.0
57,80,91,80,87,75,470,0.5737704918032787,30,45,135,45,90,30,375,0.09285714285714286,2.0
60,30,30,36,56,50,262,0.32432432432432434,65,75,70,95,70,95,470,0.7272727272727273,1.0
80,80,50,40,50,25,325,0.176056338028169,85,90,80,70,80,130,535,0.9262295081967213,0.5
60,50,40,85,75,95,405,0.7540983606557377,50,52,48,65,50,55,320,0.33098591549295775,2.0
55,40,40,65,45,35,280,0.16428571428571428,50,50,62,40,62,65,329,0.4188034188034188,1.0
79,115,70,125,80,111,580,0.8468468468468469,106,90,130,90,154,110,680,0.8699186991869918,1.0
50,52,48,65,50,55,320,0.33098591549295775,80,75,150,75,150,50,580,0.30973451327433627,1.0
60,65,60,130,75,110,500,0.7719298245614035,89,124,80,55,80,55,483,0.5714285714285714,0.5
95,75,80,100,110,30,490,0.24242424242424243,85,70,80,97,80,123,535,0.9304347826086956,0.5
65,40,70,80,140,70,465,0.5954198473282443,73,100,60,100,60,65,458,0.42657342657342656,1.0
60,70,105,70,120,75,500,0.5983606557377049,35,55,40,50,50,90,320,0.6838235294117647,2.0
45,30,35,20,20,45,195,0.14782608695652175,80,82,100,83,100,80,525,0.6821705426356589,2.0
65,75,90,97,123,44,494,0.1987179487179487,40,45,35,40,40,90,290,0.65,1.0
75,125,100,70,80,45,495,0.33035714285714285,80,185,115,40,105,75,600,0.6230769230769231,0.5
90,50,34,60,44,70,348,0.6283185840707964,56,61,65,48,45,38,313,0.17567567567567569,2.0
60,115,105,65,70,80,495,0.7181818181818181,72,58,80,103,80,97,490,0.7171052631578947,2.0
80,50,100,100,200,50,580,0.2357142857142857,50,50,50,50,50,50,300,0.30708661417322836,0.5
75,70,90,70,105,80,490,0.656,70,94,50,94,50,66,424,0.48148148148148145,2.0
38,36,38,32,36,57,237,0.3893805309734513,50,85,125,85,115,20,480,0.4306569343065693,0.0
50,75,70,35,70,48,348,0.29357798165137616,95,80,105,40,70,100,490,0.8046875,2.0
60,50,50,60,70,50,340,0.28346456692913385,80,80,90,110,130,110,600,0.8721804511278195,0.25
75,89,85,55,65,36,405,0.29545454545454547,40,45,65,100,120,90,460,0.5588235294117647,1.0
40,55,30,30,30,85,270,0.688,110,65,105,55,95,80,510,0.6258503401360545,1.0
70,120,100,145,105,20,560,0.2824427480916031,70,100,115,30,65,30,410,0.24390243902439024,1.0
78,70,61,50,61,100,420,0.8145161290322581,70,85,65,105,85,120,530,0.9262295081967213,1.0
85,50,95,120,115,80,545,0.5793650793650794,95,117,80,65,70,92,519,0.8409090909090909,2.0
58,64,58,80,65,80,405,0.5423728813559322,50,65,90,35,35,15,290,0.14678899082568808,2.0
60,45,50,90,80,70,395,0.625,60,60,60,105,105,105,495,0.848,0.5
75,69,72,114,100,104,534,0.8253968253968254,60,75,100,55,80,50,420,0.3088235294117647,0.5
65,55,115,100,40,60,435,0.3798449612403101,75,80,85,110,90,50,490,0.3548387096774194,0.25
75,98,63,98,63,101,498,0.8091603053435115,103,60,86,60,86,50,445,0.3458646616541353,1.0
101,72,72,99,89,29,462,0.1937984496124031,55,70,55,40,55,85,360,0.7073170731707317,1.0
20,25,45,70,90,60,310,0.30833333333333335,59,45,40,35,40,31,250,0.14285714285714285,1.0
100,120,100,150,120,90,680,0.728,55,45,50,45,65,80,340,0.5546218487394958,2.0
50,65,45,85,65,95,405,0.7238095238095238,70,80,70,80,70,110,480,0.6594202898550725,1.0
67,58,57,81,67,101,431,0.8790322580645161,60,30,30,36,56,50,262,0.32432432432432434,2.0
83,80,75,70,70,101,479,0.8615384615384616,45,60,45,25,45,55,275,0.29,1.0
55,55,85,65,85,35,380,0.2014388489208633,37,25,41,25,41,25,194,0.08870967741935484,2.0
95,85,85,65,65,35,430,0.2571428571428571,84,86,88,111,101,60,530,0.4634146341463415,1.0
45,53,70,40,60,42,310,0.25735294117647056,95,80,105,40,70,100,490,0.8046875,1.0
30,56,35,25,35,72,253,0.48148148148148145,64,51,23,51,23,28,240,0.11363636363636363,1.0
65,90,120,85,70,60,490,0.43410852713178294,70,60,125,115,70,55,495,0.35507246376811596,0.5
50,50,62,40,62,65,329,0.4188034188034188,40,45,40,62,60,60,307,0.33884297520661155,1.0
65,150,60,115,60,115,565,0.935251798561151,61,78,95,56,58,57,405,0.40336134453781514,1.0
40,45,35,30,40,55,245,0.3793103448275862,50,95,180,85,45,70,525,0.5298507462686567,1.0
46,87,60,30,40,57,320,0.37777777777777777,30,40,70,70,25,60,295,0.41353383458646614,1.0
50,65,107,105,107,86,520,0.7272727272727273,60,65,70,85,75,40,395,0.21705426356589147,1.0
55,50,40,40,40,75,300,0.5945945945945946,50,40,85,40,65,25,305,0.08870967741935484,1.0
65,47,55,73,75,85,400,0.65,55,45,43,55,43,72,313,0.5853658536585366,1.0
90,120,120,60,60,50,500,0.35294117647058826,70,75,80,135,80,135,575,0.917910447761194,2.0
60,65,80,170,95,130,600,0.8625954198473282,60,90,55,90,80,110,485,0.8677685950413223,1.0
55,45,50,45,65,80,340,0.5546218487394958,60,70,50,100,50,65,395,0.5217391304347826,0.5
50,92,108,92,108,35,485,0.2457627118644068,50,65,107,105,107,86,520,0.7313432835820896,1.0
95,75,180,130,80,30,590,0.13793103448275862,41,64,45,50,50,50,300,0.36752136752136755,0.5
35,46,34,35,45,20,215,0.072,70,80,50,35,35,35,305,0.14,1.0
64,165,75,93,83,75,555,0.6587301587301587,55,45,43,55,43,72,313,0.5853658536585366,2.0
71,73,88,120,89,59,500,0.43537414965986393,45,75,37,70,55,83,365,0.6183206106870229,2.0
35,40,100,90,55,35,355,0.1796875,103,60,86,60,86,50,445,0.3458646616541353,1.0
52,65,50,45,50,38,300,0.27419354838709675,50,48,43,46,41,60,288,0.47297297297297297,1.0
80,135,130,95,90,70,600,0.5181818181818182,50,64,50,45,50,41,300,0.22727272727272727,4.0
38,30,41,30,41,60,240,0.2897196261682243,90,93,55,70,55,55,418,0.3819444444444444,1.0
65,130,60,75,60,75,465,0.689922480620155,60,45,70,45,90,95,405,0.7304964539007093,1.0
50,70,50,50,50,70,340,0.5645161290322581,95,117,184,44,46,28,514,0.2975206611570248,1.0
30,56,35,25,35,72,253,0.48148148148148145,85,115,80,105,80,50,515,0.3063063063063063,1.0
85,100,122,58,75,54,494,0.3939393939393939,70,70,115,130,90,60,535,0.5338983050847458,0.5
60,48,45,43,90,42,328,0.21897810218978103,85,120,70,50,60,100,485,0.8308823529411765,1.0
53,51,53,61,56,40,314,0.14285714285714285,30,105,90,25,25,50,325,0.2773722627737226,0.5
60,62,80,63,80,60,405,0.4336283185840708,65,60,70,85,75,40,395,0.1796875,1.0
170,90,45,90,45,60,500,0.427536231884058,92,105,90,125,90,98,600,0.8217054263565892,0.5
65,80,80,59,63,58,405,0.4411764705882353,43,80,65,50,35,35,308,0.14193548387096774,0.5
35,45,160,30,45,70,385,0.48148148148148145,90,60,60,40,40,40,330,0.29545454545454547,0.5
65,40,50,125,60,30,370,0.07258064516129033,45,49,65,49,65,45,318,0.275,1.0
50,65,107,105,107,86,520,0.7272727272727273,60,50,40,85,75,95,405,0.7540983606557377,0.25
80,52,50,90,50,89,411,0.6666666666666666,50,65,90,35,35,15,290,0.14678899082568808,2.0
75,80,70,65,75,90,455,0.7578125,91,134,95,100,100,80,600,0.6304347826086957,1.0
80,80,50,40,50,25,325,0.176056338028169,85,100,122,58,75,54,494,0.3939393939393939,1.0
95,135,80,110,80,100,600,0.8248175182481752,70,100,115,30,65,30,410,0.24390243902439024,0.5
85,70,80,97,80,123,535,0.9304347826086956,58,50,145,95,105,30,483,0.2459016393442623,1.0
82,121,119,69,59,71,521,0.5394736842105263,50,72,35,35,35,65,292,0.5373134328358209,0.5
80,185,115,40,105,75,600,0.6230769230769231,68,65,65,125,115,80,518,0.6461538461538462,0.25
78,104,78,159,115,100,634,0.8444444444444444,60,70,65,125,105,90,515,0.6911764705882353,4.0
105,130,120,45,45,40,485,0.4444444444444444,60,85,60,85,60,55,405,0.3673469387755102,2.0
65,75,70,95,70,95,470,0.7272727272727273,80,80,80,80,80,80,480,0.6015037593984962,1.0
40,35,30,20,20,50,195,0.23423423423423423,90,120,75,60,60,45,450,0.29411764705882354,1.0
40,40,35,50,100,70,335,0.5031847133757962,65,85,70,75,70,40,405,0.203125,1.0
95,80,105,40,70,100,490,0.8046875,150,160,100,95,65,100,670,0.8866666666666667,1.0
80,105,65,60,75,130,515,0.9645390070921985,35,46,34,35,45,20,215,0.072,1.0
86,81,97,81,107,43,495,0.203125,40,40,50,30,30,30,220,0.0873015873015873,0.5
70,75,80,135,80,135,575,0.917910447761194,80,50,100,100,200,50,580,0.2357142857142857,1.0
43,30,55,40,65,97,330,0.6030534351145038,68,90,65,50,55,82,410,0.6165413533834586,1.0
100,180,160,150,90,90,770,0.7520661157024794,70,50,30,95,135,105,485,0.8040540540540541,2.0
60,110,70,60,60,100,460,0.8461538461538461,90,65,65,40,40,15,315,0.19672131147540983,1.0
115,115,85,90,75,100,580,0.8134328358208955,57,24,86,24,86,23,300,0.12727272727272726,2.0
77,120,90,60,90,48,485,0.2785714285714286,60,70,105,70,120,75,500,0.5983606557377049,1.0
50,70,160,70,160,90,600,0.7417218543046358,80,80,80,80,80,80,480,0.5606060606060606,1.0
65,50,70,95,80,65,425,0.4262295081967213,50,65,107,105,107,86,520,0.7313432835820896,1.0
90,93,55,70,55,55,418,0.3819444444444444,50,48,43,46,41,60,288,0.47297297297297297,0.5
35,70,55,45,55,25,285,0.09420289855072464,65,150,40,15,80,145,495,0.9663865546218487,0.125
100,164,150,95,120,71,700,0.5645161290322581,70,75,80,135,80,135,575,0.917910447761194,1.0
65,90,115,45,115,58,488,0.5041322314049587,95,75,80,100,110,30,490,0.24242424242424243,1.0
30,40,70,70,25,60,295,0.41353383458646614,54,63,52,83,56,97,405,0.7697841726618705,0.5
45,50,55,75,65,30,320,0.06293706293706294,45,35,45,62,53,35,275,0.11851851851851852,1.0
30,35,30,100,35,80,310,0.4765625,35,40,100,90,55,35,355,0.1796875,0.5
85,110,76,65,82,56,474,0.3933333333333333,100,100,100,100,100,100,600,0.8778625954198473,1.0
70,70,40,60,40,60,340,0.4247787610619469,70,80,50,35,35,35,305,0.14,0.5
105,140,95,55,65,45,505,0.3,72,58,80,103,80,97,490,0.7171052631578947,0.25
45,60,40,70,50,45,310,0.2846715328467153,50,160,110,160,110,110,700,0.8854961832061069,0.5
75,95,122,58,75,69,494,0.5725806451612904,89,124,80,55,80,55,483,0.5714285714285714,4.0
100,100,100,100,100,100,600,0.8778625954198473,130,85,80,85,95,60,535,0.43884892086330934,1.0
70,55,75,45,65,60,370,0.45901639344262296,40,65,95,60,45,35,340,0.13986013986013987,1.0
50,35,55,25,25,15,205,0.021739130434782608,40,45,35,30,40,55,245,0.3793103448275862,0.25
65,100,70,80,80,105,500,0.8666666666666667,91,134,95,100,100,80,600,0.6304347826086957,0.5
77,85,51,55,51,65,384,0.5163934426229508,50,64,50,45,50,41,300,0.22727272727272727,1.0
85,135,130,60,80,25,515,0.40540540540540543,80,90,80,130,110,110,600,0.856,1.0
54,78,103,53,45,22,355,0.23255813953488372,70,45,48,60,65,35,323,0.15748031496062992,1.0
70,75,60,105,60,105,475,0.88,35,45,160,30,45,70,385,0.48148148148148145,0.0
64,51,23,51,23,28,240,0.11363636363636363,60,59,85,79,105,36,424,0.16666666666666666,1.0
78,84,78,109,85,100,534,0.8646616541353384,60,95,80,60,80,30,405,0.19480519480519481,16.0
55,95,55,35,75,115,430,0.9380530973451328,57,24,86,24,86,23,300,0.12727272727272726,1.0
44,38,39,61,79,42,303,0.2251655629139073,75,87,63,87,63,98,473,0.865546218487395,1.0
91,90,129,90,72,108,580,0.9140625,74,94,131,54,116,20,489,0.4485294117647059,1.0
95,117,184,44,46,28,514,0.2975206611570248,45,30,50,65,50,45,285,0.13821138211382114,1.0
101,72,72,99,89,29,462,0.1937984496124031,74,94,131,54,116,20,489,0.4485294117647059,0.5
110,85,95,80,95,50,515,0.2713178294573643,75,90,140,60,60,40,465,0.3008130081300813,0.5
60,50,50,60,70,50,340,0.28346456692913385,70,110,75,145,85,145,630,0.9444444444444444,0.0625
115,45,20,45,25,20,270,0.11538461538461539,60,95,80,60,80,30,405,0.19480519480519481,1.0
45,45,55,45,55,63,308,0.4594594594594595,90,120,75,60,60,45,450,0.29411764705882354,1.0
100,150,110,95,110,70,635,0.5923076923076923,85,110,90,45,90,80,500,0.6206896551724138,1.0
130,85,80,85,95,60,535,0.43884892086330934,65,65,65,50,50,90,385,0.72,0.25
62,50,58,73,54,72,369,0.4435483870967742,76,147,90,60,70,97,540,0.8267716535433071,0.5
50,52,48,65,50,55,320,0.33098591549295775,45,40,60,40,75,50,310,0.2926829268292683,1.0
56,61,65,48,45,38,313,0.17567567567567569,75,75,95,75,95,113,528,0.9015151515151515,0.5
70,55,75,45,65,60,370,0.45901639344262296,50,50,50,50,50,50,300,0.30708661417322836,1.0
79,100,80,110,90,121,580,0.968,65,150,60,115,60,115,565,0.935251798561151,1.0
38,35,35,65,55,50,278,0.2647058823529412,35,64,85,74,55,32,345,0.19827586206896552,1.0
85,105,100,79,83,78,530,0.5869565217391305,80,80,80,80,80,80,480,0.5606060606060606,0.5
55,20,35,20,45,75,250,0.37681159420289856,89,125,90,115,80,101,600,0.8725490196078431,1.0
75,125,70,125,70,115,580,0.9037037037037037,50,50,77,95,77,91,440,0.5916666666666667,1.0
85,76,64,45,55,90,415,0.6739130434782609,45,67,60,35,50,63,320,0.5128205128205128,1.0
70,62,67,55,55,56,365,0.38513513513513514,160,110,65,65,110,30,540,0.35714285714285715,1.0
80,145,150,105,110,110,700,0.8692307692307693,51,65,65,80,75,59,395,0.4365079365079365,2.0
85,115,80,105,80,50,515,0.3063063063063063,60,65,60,130,75,110,500,0.7719298245614035,1.0
105,125,100,60,100,100,590,0.8359375,75,125,100,70,80,45,495,0.33035714285714285,0.5
60,40,60,40,60,35,295,0.18055555555555555,90,95,95,70,90,70,510,0.5230769230769231,2.0
70,110,70,115,70,90,525,0.75,91,72,90,129,90,108,580,0.8620689655172413,0.5
91,129,90,72,90,108,580,0.8536585365853658,83,80,75,70,70,101,479,0.8615384615384616,2.0
45,30,35,20,20,45,195,0.14782608695652175,80,82,100,83,100,80,525,0.6821705426356589,2.0
58,64,58,80,65,80,405,0.5423728813559322,90,100,60,90,60,80,480,0.6422764227642277,2.0
60,45,50,90,80,70,395,0.625,100,180,160,150,90,90,770,0.7520661157024794,0.5
81,102,77,85,75,85,505,0.5642857142857143,58,70,45,40,45,42,300,0.25925925925925924,0.5
75,123,67,95,85,95,540,0.7642276422764228,85,105,55,85,50,115,495,0.9032258064516129,2.0
75,55,70,55,95,110,460,0.8444444444444444,76,104,71,104,71,108,534,0.912751677852349,1.0
62,77,62,50,42,65,358,0.4838709677419355,60,45,70,75,85,55,390,0.3008130081300813,1.0
72,58,80,103,80,97,490,0.7171052631578947,80,120,80,120,80,100,580,0.8478260869565217,1.0
80,100,200,50,100,50,580,0.3472222222222222,60,80,50,40,40,30,300,0.15328467153284672,1.0
68,125,65,65,115,80,518,0.6277372262773723,108,130,95,80,85,102,600,0.7637795275590551,2.0
74,100,72,90,72,46,454,0.24561403508771928,80,70,40,100,60,145,495,0.921875,0.5
40,50,45,70,45,70,320,0.5517241379310345,75,80,60,65,90,102,472,0.8625954198473282,1.0
80,82,100,83,100,80,525,0.6821705426356589,100,100,80,60,60,50,450,0.3050847457627119,2.0
90,95,95,70,90,70,510,0.5230769230769231,76,104,71,104,71,108,534,0.912751677852349,2.0
100,150,120,120,100,90,680,0.6493506493506493,65,110,130,60,65,95,525,0.8278145695364238,0.5
65,95,100,60,50,50,420,0.34959349593495936,41,56,40,62,44,71,314,0.568,1.0
59,45,40,35,40,31,250,0.14285714285714285,40,55,70,45,60,30,300,0.10619469026548672,0.5
75,80,95,90,100,50,490,0.2158273381294964,80,70,70,90,100,70,480,0.5609756097560976,1.0
49,49,56,49,61,66,330,0.5190839694656488,50,65,90,35,35,15,290,0.14678899082568808,1.0
35,55,40,45,40,60,275,0.35714285714285715,135,85,40,40,85,5,390,0.6864406779661016,1.0
59,110,150,45,49,35,448,0.3333333333333333,60,130,80,60,60,70,460,0.5153846153846153,1.0
43,70,48,50,60,38,309,0.2391304347826087,45,100,135,65,135,45,525,0.29411764705882354,2.0
42,52,67,39,56,50,306,0.2868217054263566,55,75,50,40,40,80,340,0.6302521008403361,2.0
63,120,85,90,55,55,468,0.2809917355371901,40,70,40,35,40,60,285,0.392,0.5
55,63,90,50,80,42,380,0.21138211382113822,61,90,45,50,50,160,456,0.9230769230769231,0.125
41,50,37,50,37,66,281,0.5175438596491229,73,95,62,85,65,85,465,0.6666666666666666,1.0
60,25,35,70,80,60,330,0.3076923076923077,74,48,76,83,81,104,466,0.7322834645669292,0.5
85,105,85,40,50,40,405,0.211864406779661,90,92,75,92,85,60,494,0.49586776859504134,2.0
123,77,72,99,92,58,521,0.4621212121212121,75,125,75,30,75,85,465,0.625,0.5
50,65,107,105,107,86,520,0.703125,40,30,30,40,50,30,220,0.07936507936507936,1.0
56,61,65,48,45,38,313,0.17567567567567569,65,100,70,80,80,105,500,0.8666666666666667,0.5
75,90,50,110,80,95,500,0.7985611510791367,69,55,45,55,55,15,294,0.11666666666666667,2.0
30,30,42,30,42,70,244,0.4230769230769231,70,95,125,65,75,45,475,0.33613445378151263,1.0
75,105,75,105,75,45,480,0.3274336283185841,85,60,65,135,105,100,550,0.7518248175182481,2.0
30,45,55,70,55,85,340,0.5633802816901409,55,55,45,63,45,45,308,0.25,0.5
70,70,70,70,70,70,420,0.5289256198347108,75,100,66,60,66,115,482,0.918918918918919,1.0
50,160,110,160,110,110,700,0.8854961832061069,68,75,53,83,113,60,452,0.45384615384615384,2.0
80,160,60,170,130,80,680,0.6180555555555556,100,100,100,100,100,100,600,0.8758169934640523,0.5
86,68,72,109,66,106,507,0.8099173553719008,30,80,90,55,45,55,355,0.4295774647887324,0.125
90,92,75,92,85,60,494,0.49586776859504134,91,90,72,90,129,108,580,0.896,1.0
60,65,70,85,75,40,395,0.21705426356589147,100,150,120,120,100,90,680,0.6493506493506493,0.5
110,130,80,70,60,80,530,0.5862068965517241,58,109,112,48,48,109,484,0.8805970149253731,0.5
60,79,105,59,85,36,424,0.17054263565891473,45,67,60,35,50,63,320,0.5128205128205128,1.0
35,35,35,35,35,35,210,0.13385826771653545,65,125,60,95,60,105,510,0.9236641221374046,1.0
130,65,60,110,95,65,525,0.5227272727272727,60,130,80,60,60,70,460,0.5153846153846153,0.5
95,110,95,40,95,55,490,0.40336134453781514,165,75,80,40,45,65,470,0.5151515151515151,1.0
40,45,35,30,40,55,245,0.3793103448275862,55,84,105,114,75,52,485,0.2890625,1.0
38,30,41,30,41,60,240,0.2897196261682243,45,45,35,20,30,20,195,0.07246376811594203,1.0
70,43,53,43,53,40,302,0.19090909090909092,95,135,80,110,80,100,600,0.8248175182481752,1.0
250,5,5,35,105,50,450,0.15306122448979592,65,63,45,45,45,45,308,0.2595419847328244,1.0
58,64,58,80,65,80,405,0.5423728813559322,30,45,59,30,39,57,260,0.2803030303030303,2.0
50,72,35,35,35,65,292,0.5373134328358209,50,70,50,50,50,40,310,0.16296296296296298,1.0
45,60,40,70,50,45,310,0.2846715328467153,55,69,85,32,35,28,304,0.09302325581395349,2.0
37,25,41,25,41,25,194,0.08870967741935484,72,58,80,103,80,97,490,0.7171052631578947,1.0
65,65,45,75,45,95,390,0.72,45,45,35,20,30,20,195,0.07246376811594203,2.0
70,110,70,115,70,90,525,0.75,74,100,72,90,72,46,454,0.24561403508771928,1.0
60,60,75,60,75,80,410,0.7321428571428571,75,75,130,75,130,95,580,0.7479674796747967,0.25
95,110,95,40,95,55,490,0.40336134453781514,50,75,75,65,65,50,380,0.4049586776859504,0.0
100,50,50,76,96,70,442,0.5,70,65,65,55,55,70,380,0.5,1.0
100,100,100,100,100,100,600,0.8805970149253731,85,100,122,58,75,54,494,0.3939393939393939,0.5
38,41,40,50,65,65,299,0.4108527131782946,53,51,53,61,56,40,314,0.14285714285714285,0.5
60,90,140,50,50,40,430,0.2535211267605634,70,43,53,43,53,40,302,0.19090909090909092,1.0
78,81,71,74,69,126,499,0.9090909090909091,40,40,55,40,70,55,300,0.40939597315436244,1.0
62,50,58,73,54,72,369,0.4435483870967742,75,110,110,110,105,80,590,0.656934306569343,0.5
110,65,105,55,95,80,510,0.6258503401360545,50,52,48,65,50,55,320,0.33098591549295775,1.0
100,103,75,120,75,127,600,0.940677966101695,75,75,60,83,60,60,413,0.39344262295081966,2.0
69,69,76,69,86,91,460,0.6554621848739496,85,105,55,85,50,115,495,0.9032258064516129,0.5
50,25,28,45,55,15,218,0.0625,72,95,67,103,71,122,530,0.9606299212598425,2.0
70,150,140,65,100,75,600,0.55,70,100,115,30,65,30,410,0.24390243902439024,2.0
55,104,105,94,75,52,485,0.36363636363636365,59,66,70,44,55,41,335,0.25190839694656486,0.5
50,65,107,105,107,86,520,0.7313432835820896,55,75,50,40,40,80,340,0.6302521008403361,1.0
39,52,43,60,50,65,309,0.49107142857142855,78,92,75,74,63,118,500,0.8842975206611571,1.0
38,35,40,27,25,35,200,0.08208955223880597,44,58,44,58,44,61,309,0.41964285714285715,0.5
50,50,62,40,62,65,329,0.4188034188034188,45,20,50,60,120,50,345,0.24074074074074073,1.0
50,50,150,50,150,50,500,0.2571428571428571,60,85,49,60,49,60,363,0.4444444444444444,1.0
50,65,85,35,35,55,325,0.32575757575757575,45,85,50,55,50,65,350,0.5076923076923077,0.25
50,150,50,150,50,150,600,0.9339622641509434,75,98,63,98,63,101,498,0.8091603053435115,1.0
84,86,88,111,101,60,530,0.4634146341463415,120,100,85,30,85,45,465,0.22448979591836735,1.0
70,70,115,130,90,60,535,0.5338983050847458,50,85,55,65,65,90,410,0.7478260869565218,0.5
55,45,43,55,43,72,313,0.5853658536585366,65,60,110,130,95,65,525,0.47761194029850745,1.0
65,75,105,35,65,85,430,0.6940298507462687,60,55,145,75,150,40,525,0.2,1.0
60,85,60,50,50,125,430,0.9090909090909091,55,20,35,20,45,75,250,0.37681159420289856,1.0
20,10,230,10,230,5,505,0.0,45,30,50,55,65,45,290,0.208,2.0
40,60,30,31,31,70,262,0.4492753623188406,75,103,80,70,80,92,500,0.7933884297520661,4.0
130,85,80,85,95,60,535,0.43884892086330934,73,95,62,85,65,85,465,0.6666666666666666,1.0
55,20,35,20,45,75,250,0.37681159420289856,73,100,60,100,60,65,458,0.42657342657342656,1.0
80,82,78,95,80,85,500,0.6869565217391305,110,80,90,95,90,65,530,0.5033557046979866,0.5
67,57,55,77,55,114,425,0.8879310344827587,55,40,40,65,45,35,280,0.16428571428571428,0.5
70,105,105,50,40,20,390,0.33587786259541985,60,50,70,80,80,140,480,0.8449612403100775,1.0
35,55,40,45,40,60,275,0.35714285714285715,70,85,70,60,70,50,405,0.28378378378378377,0.0
43,70,48,50,60,38,309,0.2391304347826087,50,95,95,35,110,70,455,0.5179856115107914,1.0
45,45,35,20,30,20,195,0.07246376811594203,60,62,63,80,80,60,405,0.38016528925619836,1.0
75,95,67,125,95,83,540,0.7117117117117117,103,60,86,60,86,50,445,0.3458646616541353,1.0
108,112,118,68,72,47,525,0.2916666666666667,100,100,90,150,140,90,670,0.71875,1.0
40,70,40,35,40,60,285,0.392,58,109,112,48,48,109,484,0.8805970149253731,1.0
55,85,122,58,75,99,494,0.8099173553719008,45,55,39,35,39,42,255,0.18518518518518517,0.0
100,120,100,150,120,90,680,0.728,95,60,79,100,125,81,540,0.6201550387596899,0.5
48,72,48,72,48,48,336,0.25984251968503935,90,30,15,40,20,15,210,0.043478260869565216,1.0
105,180,100,180,100,115,780,0.9477611940298507,75,95,122,58,75,69,494,0.5725806451612904,2.0
62,48,66,59,57,49,341,0.33884297520661155,55,70,45,70,50,60,350,0.45,0.5
45,30,15,85,65,65,305,0.36220472440944884,70,55,65,95,85,70,440,0.5307692307692308,0.5
80,120,130,55,65,45,495,0.37037037037037035,45,50,35,55,75,40,300,0.21367521367521367,1.0
40,55,30,30,30,60,245,0.43548387096774194,65,136,94,54,96,135,580,0.9612403100775194,2.0
55,95,55,35,75,115,430,0.9380530973451328,60,90,140,50,50,40,430,0.2535211267605634,0.5
65,125,60,95,60,105,510,0.9236641221374046,80,100,123,122,120,80,625,0.56,0.5
37,25,41,25,41,25,194,0.08870967741935484,78,84,78,109,85,100,534,0.8620689655172413,0.5
95,145,130,120,90,120,700,0.9398496240601504,45,60,30,80,50,65,330,0.4603174603174603,1.0
45,50,45,115,55,95,405,0.6936936936936937,50,50,40,50,40,64,294,0.45588235294117646,1.0
40,50,90,30,55,65,330,0.44680851063829785,70,85,70,60,70,50,405,0.28378378378378377,0.5
60,50,50,60,70,50,340,0.28346456692913385,35,55,40,50,50,90,320,0.6838235294117647,1.0
55,40,40,65,45,35,280,0.16428571428571428,45,45,35,20,30,20,195,0.07246376811594203,1.0
70,95,125,65,75,45,475,0.33613445378151263,105,180,100,180,100,115,780,0.9477611940298507,1.0
38,35,35,65,55,50,278,0.2647058823529412,60,85,60,50,50,125,430,0.9090909090909091,1.0
60,65,60,130,75,110,500,0.7719298245614035,71,73,88,120,89,59,500,0.43537414965986393,1.0
86,76,86,116,56,95,515,0.7982456140350878,68,125,65,65,115,80,518,0.6277372262773723,2.0
50,70,100,40,40,30,330,0.2222222222222222,55,50,45,135,95,120,500,0.7714285714285715,1.0
95,110,80,70,80,50,485,0.37209302325581395,60,60,40,65,45,35,305,0.15833333333333333,1.0
55,55,85,65,85,35,380,0.2014388489208633,44,38,33,61,43,70,289,0.5267857142857143,1.0
20,25,45,70,90,60,310,0.30833333333333335,83,106,65,86,65,85,490,0.6640625,2.0
75,98,63,98,63,101,498,0.8091603053435115,100,75,115,90,115,85,580,0.6446280991735537,2.0
100,100,125,110,50,50,535,0.384,65,90,122,58,75,84,494,0.71875,0.5
65,95,57,100,85,93,495,0.7441860465116279,61,72,57,55,55,65,365,0.3984375,1.0
74,48,76,83,81,104,466,0.7913043478260869,55,20,35,20,45,75,250,0.37681159420289856,1.0
60,85,69,65,79,80,438,0.576,108,112,118,68,72,47,525,0.2916666666666667,0.5
79,103,120,135,115,78,630,0.5763888888888888,40,40,40,70,40,20,250,0.032520325203252036,2.0
60,60,75,60,75,80,410,0.7321428571428571,78,52,60,63,65,23,341,0.06015037593984962,0.5
115,115,85,90,75,100,580,0.8134328358208955,70,40,50,55,50,25,290,0.061068702290076333,1.0
60,85,69,60,69,77,420,0.518796992481203,65,125,100,55,70,85,500,0.6532258064516129,1.0
35,65,35,65,35,65,300,0.46621621621621623,89,124,80,55,80,55,483,0.5714285714285714,2.0
78,84,78,109,85,100,534,0.8620689655172413,90,100,60,90,60,80,480,0.6422764227642277,2.0
60,85,42,85,42,91,405,0.8227848101265823,95,117,80,65,70,92,519,0.8409090909090909,0.5
45,75,37,70,55,83,365,0.6183206106870229,85,105,85,40,50,40,405,0.211864406779661,1.0
75,95,60,65,60,115,470,0.8778625954198473,70,135,105,60,105,20,495,0.5806451612903226,0.5
40,55,80,35,60,30,300,0.15037593984962405,50,100,150,100,150,50,600,0.37142857142857144,1.0
60,62,80,63,80,60,405,0.4336283185840708,89,124,80,55,80,55,483,0.5714285714285714,2.0
68,72,78,38,42,32,330,0.23809523809523808,62,48,54,63,60,68,355,0.5178571428571429,1.0
95,65,110,60,130,65,525,0.5275590551181102,110,65,75,125,85,30,490,0.15,2.0
25,35,70,95,55,45,325,0.16783216783216784,40,55,30,30,30,60,245,0.43548387096774194,2.0
60,95,80,60,80,30,405,0.19480519480519481,150,80,44,90,54,80,498,0.625,0.125
90,100,70,110,150,80,600,0.6037735849056604,54,63,52,83,56,97,405,0.7697841726618705,1.0
70,140,230,60,80,50,630,0.32432432432432434,55,68,64,45,55,31,318,0.11666666666666667,1.0
75,95,95,95,95,85,540,0.6470588235294118,61,78,95,56,58,57,405,0.40336134453781514,0.5
60,75,100,55,80,50,420,0.3088235294117647,75,90,140,60,60,40,465,0.3008130081300813,0.25
80,110,120,130,90,70,600,0.6198347107438017,70,100,115,30,65,30,410,0.24390243902439024,1.0
40,50,90,30,55,65,330,0.44680851063829785,83,106,65,86,65,85,490,0.6640625,0.125
70,55,65,95,85,70,440,0.5307692307692308,45,55,45,65,45,75,330,0.5692307692307692,4.0
40,50,45,70,45,70,320,0.5517241379310345,40,60,30,31,31,70,262,0.4492753623188406,1.0
60,60,60,85,85,85,435,0.631578947368421,69,69,76,69,86,91,460,0.6554621848739496,1.0
95,110,80,70,80,50,485,0.37209302325581395,110,135,60,50,65,88,508,0.7744360902255639,1.0
84,71,43,71,43,48,360,0.25874125874125875,130,85,80,85,95,60,535,0.43884892086330934,1.0
30,45,55,70,55,85,340,0.5633802816901409,82,121,119,69,59,71,521,0.5394736842105263,1.0
60,150,50,150,50,60,520,0.5,65,105,60,60,70,95,455,63.0,1.0
170,90,45,90,45,60,500,0.427536231884058,70,55,55,80,60,45,365,0.2222222222222222,1.0
58,109,112,48,48,109,484,0.8805970149253731,90,55,75,60,75,30,385,0.13970588235294118,1.0
75,80,55,25,35,35,305,0.18666666666666668,75,100,63,80,63,116,497,0.9345794392523364,1.0
101,72,72,99,89,29,462,0.1937984496124031,45,35,45,62,53,35,275,0.11851851851851852,1.0
91,72,90,129,90,108,580,0.8620689655172413,50,60,45,100,80,65,400,0.45689655172413796,0.25
70,94,50,94,50,66,424,0.48148148148148145,60,70,105,70,120,75,500,0.5983606557377049,2.0
75,100,63,80,63,116,497,0.9345794392523364,65,40,50,125,60,30,370,0.07258064516129033,1.0
20,10,230,10,230,5,505,0.0,55,50,65,175,95,150,590,0.7818181818181819,2.0
75,125,100,70,80,45,495,0.33035714285714285,25,35,70,95,55,45,325,0.16783216783216784,0.25
165,75,80,40,45,65,470,0.5151515151515151,30,80,90,55,45,55,355,0.4295774647887324,1.0
76,65,45,92,42,91,411,0.7449664429530202,55,69,85,32,35,28,304,0.09302325581395349,1.0
68,90,65,50,55,82,410,0.6165413533834586,74,100,72,90,72,46,454,0.24561403508771928,0.5
60,45,50,90,80,70,395,0.625,70,80,50,35,35,35,305,0.14,1.0
40,40,55,40,70,55,300,0.40939597315436244,70,55,55,80,60,45,365,0.2222222222222222,2.0
70,40,50,55,50,25,290,0.061068702290076333,105,130,120,45,45,40,485,0.4444444444444444,8.0
55,81,60,50,70,97,413,0.7214285714285714,58,64,58,80,65,80,405,0.609271523178808,1.0
70,60,75,110,75,90,480,0.7165354330708661,60,40,50,75,85,95,405,0.6044776119402985,1.0
45,30,50,65,50,45,285,0.13821138211382114,71,120,95,120,95,99,600,0.8203125,0.5
60,90,70,60,120,40,440,0.27419354838709675,45,49,65,49,65,45,318,0.275,1.0
20,25,45,70,90,60,310,0.30833333333333335,90,120,100,150,120,100,680,0.7718120805369127,2.0
103,60,86,60,86,50,445,0.3458646616541353,101,72,72,99,89,29,462,0.1937984496124031,1.0
20,10,55,15,20,80,200,0.17985611510791366,50,92,108,92,108,35,485,0.2457627118644068,1.0
65,60,70,85,75,40,395,0.1796875,45,20,50,60,120,50,345,0.24074074074074073,1.0
75,75,130,75,130,95,580,0.7479674796747967,55,40,40,65,45,35,280,0.16428571428571428,1.0
68,165,95,65,115,110,618,0.8615384615384616,100,120,120,150,100,90,680,0.7880794701986755,1.0
75,75,55,105,85,30,425,0.1619718309859155,70,83,50,37,50,60,350,0.3360655737704918,0.5
115,45,20,45,25,20,270,0.11538461538461539,78,70,61,50,61,100,420,0.8145161290322581,1.0
45,50,35,55,75,40,300,0.21367521367521367,90,110,80,100,80,95,555,0.7982456140350878,1.0
65,76,84,54,96,105,480,0.9008264462809917,80,80,50,40,50,25,325,0.176056338028169,1.0
50,64,50,45,50,41,300,0.22727272727272727,110,65,105,55,95,80,510,0.6258503401360545,0.0
100,128,90,77,77,128,600,0.959349593495935,85,50,95,120,115,80,545,0.5793650793650794,0.25
74,108,133,83,65,32,495,0.32142857142857145,80,95,82,60,82,75,474,0.6,1.0
35,60,44,40,54,55,288,0.366412213740458,60,67,85,77,75,116,480,0.8888888888888888,4.0
61,84,65,70,70,70,420,0.5,70,135,105,60,105,20,495,0.5806451612903226,0.5
80,135,85,70,95,150,615,0.9844961240310077,38,41,40,50,65,65,299,0.4108527131782946,2.0
40,30,30,40,50,30,220,0.07936507936507936,70,130,100,55,80,65,500,0.608,0.25
35,64,85,74,55,32,345,0.19827586206896552,70,110,70,115,70,90,525,0.75,1.0
80,185,115,40,105,75,600,0.6230769230769231,250,5,5,35,105,50,450,0.15306122448979592,2.0
65,45,55,45,70,45,325,0.24369747899159663,45,49,49,65,65,45,318,0.2781954887218045,0.5
62,50,58,73,54,72,369,0.4435483870967742,66,65,48,62,57,52,350,0.36220472440944884,2.0
65,95,75,55,55,85,430,0.6933333333333334,65,80,80,59,63,58,405,0.4411764705882353,0.5
70,90,110,60,75,95,500,0.7333333333333333,85,73,70,73,115,67,483,0.5126050420168067,2.0
60,95,80,60,80,30,405,0.19480519480519481,110,135,60,50,65,88,508,0.7744360902255639,0.5
50,53,48,53,48,64,316,0.358974358974359,78,84,78,109,85,100,534,0.8646616541353384,2.0
80,100,80,80,80,100,520,0.9051724137931034,60,80,110,50,80,45,425,0.2833333333333333,1.0
57,80,91,80,87,75,470,0.5737704918032787,30,45,59,30,39,57,260,0.2803030303030303,0.5
63,63,47,41,41,74,329,0.56,80,82,78,95,80,85,500,0.6869565217391305,1.0
75,95,122,58,75,69,494,0.5725806451612904,80,110,60,150,130,70,600,0.5042016806722689,4.0
95,117,80,65,70,92,519,0.8409090909090909,60,90,55,90,80,110,485,0.8677685950413223,2.0
70,80,70,80,70,110,480,0.6594202898550725,50,30,55,65,55,20,275,0.13675213675213677,1.0
66,65,48,62,57,52,350,0.36220472440944884,50,70,50,50,50,40,310,0.16296296296296298,2.0
50,70,100,40,40,30,330,0.2222222222222222,50,95,180,85,45,70,525,0.5298507462686567,2.0
65,55,115,100,40,60,435,0.3798449612403101,40,35,30,120,70,105,400,0.6692307692307692,1.0
40,40,55,40,70,55,300,0.40939597315436244,52,65,50,45,50,38,300,0.27419354838709675,0.0
45,75,37,70,55,83,365,0.6183206106870229,70,77,60,97,60,108,472,0.8394160583941606,2.0
55,66,44,44,56,85,350,0.6888888888888889,110,78,73,76,71,60,468,0.3333333333333333,1.0
80,90,80,130,110,110,600,0.856,75,89,85,55,65,36,405,0.29545454545454547,1.0
55,40,85,80,105,40,405,0.23622047244094488,80,80,90,110,130,110,600,0.8721804511278195,2.0
50,65,45,85,65,95,405,0.7238095238095238,64,66,68,81,76,50,405,0.25190839694656486,2.0
85,73,70,73,115,67,483,0.5126050420168067,62,77,62,50,42,65,358,0.4838709677419355,1.0
30,45,59,30,39,57,260,0.2803030303030303,114,85,70,85,80,30,464,0.2066115702479339,1.0
120,120,120,120,120,120,720,0.9344262295081968,67,125,40,30,30,58,350,0.3431372549019608,0.5
60,50,70,80,80,140,480,0.8449612403100775,60,62,63,80,80,60,405,0.38016528925619836,0.5
60,62,50,62,60,40,334,0.18181818181818182,70,135,105,60,105,20,495,0.5806451612903226,0.125
80,75,150,75,150,50,580,0.30973451327433627,70,75,60,105,60,105,475,0.88,0.5
80,100,70,60,70,95,475,0.7416666666666667,130,65,60,110,95,65,525,0.5227272727272727,2.0
60,48,45,43,90,42,328,0.21897810218978103,75,80,55,25,35,35,305,0.18666666666666668,1.0
67,58,57,81,67,101,431,0.8790322580645161,95,124,78,69,71,58,495,0.37398373983739835,4.0
50,53,62,58,63,44,330,0.13709677419354838,60,62,63,80,80,60,405,0.38016528925619836,0.5
55,81,60,50,70,97,413,0.7214285714285714,60,50,70,50,90,65,385,0.39568345323741005,1.0
100,100,100,100,100,100,600,0.831858407079646,150,120,100,120,100,90,680,0.664179104477612,1.0
103,93,67,71,61,84,479,0.7142857142857143,90,132,105,132,105,30,594,0.4246575342465753,2.0
50,85,55,65,65,90,410,0.7478260869565218,70,90,90,135,90,125,600,0.9401709401709402,1.0
65,125,100,55,70,85,500,0.6532258064516129,43,80,65,50,35,35,308,0.14193548387096774,1.0
85,100,122,58,75,54,494,0.3939393939393939,99,68,83,72,87,51,460,0.417910447761194,0.25
55,55,55,85,55,30,335,0.1320754716981132,58,50,145,95,105,30,483,0.2459016393442623,1.0
62,77,62,50,42,65,358,0.4838709677419355,20,40,90,30,90,25,295,0.11363636363636363,0.0
90,60,60,40,40,40,330,0.29545454545454547,66,41,77,61,87,23,355,0.12096774193548387,1.0
58,109,112,48,48,109,484,0.8805970149253731,45,85,50,55,50,65,350,0.5076923076923077,0.5
91,72,90,129,90,108,580,0.8620689655172413,55,55,85,65,85,35,380,0.2014388489208633,2.0
79,105,70,145,80,101,580,0.8608695652173913,70,65,65,55,55,70,380,0.5,1.0
60,50,70,80,80,140,480,0.8449612403100775,50,50,120,80,80,30,410,0.07258064516129033,1.0
73,100,60,100,60,65,458,0.42657342657342656,104,91,63,91,73,68,490,0.5118110236220472,1.0
60,50,50,60,70,50,340,0.28346456692913385,55,55,85,65,85,35,380,0.2014388489208633,4.0
80,70,40,100,60,145,495,0.921875,105,140,95,55,65,45,505,0.3,0.5
78,70,61,50,61,100,420,0.8145161290322581,40,35,30,120,70,105,400,0.6692307692307692,1.0
70,110,70,115,70,90,525,0.75,30,105,90,25,25,50,325,0.2773722627737226,0.5
65,60,70,85,75,40,395,0.1796875,50,47,50,57,50,65,319,0.463768115942029,1.0
65,80,65,35,65,60,370,0.38405797101449274,80,100,80,80,80,100,520,0.9051724137931034,1.0
72,105,115,54,86,68,500,0.5149253731343284,50,64,50,45,50,41,300,0.22727272727272727,2.0
75,75,95,75,95,113,528,0.9015151515151515,60,110,70,60,60,100,460,0.8461538461538461,0.5
90,90,85,125,90,100,580,0.768595041322314,70,60,125,115,70,55,495,0.35507246376811596,1.0
63,63,47,41,41,74,329,0.56,60,75,100,55,80,50,420,0.3088235294117647,0.0
51,65,65,80,75,59,395,0.4365079365079365,60,80,50,40,40,30,300,0.15328467153284672,1.0
90,60,60,40,40,40,330,0.29545454545454547,85,97,66,105,66,65,484,0.47107438016528924,2.0
55,85,122,58,75,99,494,0.8099173553719008,60,90,55,90,80,110,485,0.8677685950413223,1.0
55,69,85,32,35,28,304,0.09302325581395349,50,70,100,40,40,30,330,0.2222222222222222,0.5
55,35,50,55,110,85,390,0.6277372262773723,85,90,80,70,80,130,535,0.9262295081967213,0.25
60,85,60,50,50,125,430,0.9090909090909091,35,45,160,30,45,70,385,0.48148148148148145,0.25
90,93,55,70,55,55,418,0.3819444444444444,50,95,180,85,45,70,525,0.5298507462686567,2.0
50,20,55,25,25,30,205,0.09774436090225563,20,25,45,70,90,60,310,0.30833333333333335,1.0
80,160,80,130,80,100,630,0.8455284552845529,95,110,95,40,95,55,490,0.40336134453781514,2.0
45,100,135,65,135,45,525,0.29411764705882354,95,23,48,23,48,23,260,0.046153846153846156,2.0
50,95,95,35,110,70,455,0.5179856115107914,50,50,95,40,50,35,320,0.20279720279720279,1.0
90,132,105,132,105,30,594,0.4246575342465753,68,72,78,38,42,32,330,0.23809523809523808,4.0
60,40,60,95,60,55,370,0.4222222222222222,75,95,125,45,75,95,510,0.8257575757575758,1.0
70,80,102,80,102,40,474,0.2677165354330709,86,92,88,68,75,73,482,0.6835443037974683,4.0
40,45,35,40,40,90,290,0.65,75,123,67,95,85,95,540,0.7642276422764228,1.0
45,85,70,40,40,60,340,0.5229357798165137,85,105,55,85,50,115,495,0.9032258064516129,0.5
65,90,50,85,45,55,390,0.371900826446281,74,94,131,54,116,20,489,0.4485294117647059,0.0
110,78,73,76,71,60,468,0.3333333333333333,70,80,65,90,65,85,455,0.578125,1.0
50,53,48,53,48,64,316,0.46153846153846156,45,60,32,50,32,76,295,0.5925925925925926,1.0
60,40,60,40,60,35,295,0.18055555555555555,1,90,45,30,30,40,236,0.33064516129032256,0.5
45,60,32,50,32,76,295,0.5925925925925926,45,30,15,85,65,65,305,0.36220472440944884,1.0
250,5,5,35,105,50,450,0.15306122448979592,50,64,50,45,50,41,300,0.22727272727272727,0.5
85,70,80,97,80,123,535,0.9304347826086956,85,56,77,50,77,78,423,0.53125,1.0
52,65,50,45,50,38,300,0.27419354838709675,70,90,45,15,45,50,315,0.3629032258064516,1.0
110,65,75,125,85,30,490,0.15,70,80,102,80,102,40,474,0.2677165354330709,1.0
58,89,77,45,45,48,362,0.3177570093457944,90,92,87,75,85,76,505,0.5409836065573771,0.5
89,125,90,115,80,101,600,0.8725490196078431,91,72,90,129,90,108,580,0.8925619834710744,2.0
90,92,87,75,85,76,505,0.5409836065573771,55,85,122,58,75,99,494,0.8099173553719008,0.5
91,90,106,130,106,77,600,0.648854961832061,75,103,80,70,80,92,500,0.7933884297520661,4.0
105,125,100,60,100,100,590,0.8359375,65,150,60,115,60,115,565,0.935251798561151,1.0
50,40,85,40,65,25,305,0.08870967741935484,65,80,140,40,70,70,465,0.5223880597014925,0.25
80,70,65,80,120,100,515,0.8034188034188035,80,120,79,95,79,70,523,0.5833333333333334,1.0
60,45,70,45,90,95,405,0.7304964539007093,40,45,65,100,120,90,460,0.5588235294117647,1.0
40,30,32,50,52,65,269,0.3671875,100,100,100,100,100,100,600,0.8778625954198473,2.0
70,80,102,80,102,40,474,0.2677165354330709,55,95,55,35,75,115,430,0.9380530973451328,2.0
65,90,50,85,45,55,390,0.371900826446281,59,45,40,35,40,31,250,0.14285714285714285,1.0
108,170,115,120,95,92,700,0.7083333333333334,100,100,100,100,100,100,600,0.831858407079646,1.0
90,130,80,65,85,55,505,0.4396551724137931,65,90,122,58,75,84,494,0.71875,0.0
50,53,48,53,48,64,316,0.46153846153846156,60,52,168,47,138,30,495,0.19834710743801653,1.0
58,50,145,95,105,30,483,0.2459016393442623,115,115,85,90,75,100,580,0.8134328358208955,1.0
55,35,50,55,110,85,390,0.6277372262773723,31,45,90,30,30,40,266,0.21929824561403508,2.0
45,45,55,45,55,63,308,0.4594594594594595,95,65,110,60,130,65,525,0.5275590551181102,1.0
75,140,65,112,65,110,567,0.9140625,70,85,65,105,85,120,530,0.9262295081967213,2.0
60,60,60,35,35,30,280,0.11194029850746269,95,75,80,100,110,30,490,0.24242424242424243,1.0
70,100,115,30,65,30,410,0.24390243902439024,65,83,57,95,85,105,490,0.8914728682170543,1.0
49,66,70,44,55,51,335,0.4260869565217391,55,95,55,35,75,115,430,0.9380530973451328,0.5
100,100,125,110,50,50,535,0.384,70,90,90,135,90,125,600,0.9401709401709402,1.0
38,41,40,50,65,65,299,0.4108527131782946,95,110,80,70,80,50,485,0.37209302325581395,2.0
90,50,34,60,44,70,348,0.6283185840707964,106,90,130,90,154,110,680,0.8699186991869918,2.0
30,80,90,55,45,55,355,0.4295774647887324,64,88,50,88,50,106,446,0.9111111111111111,1.0
55,130,115,50,50,75,475,0.5982142857142857,80,75,150,75,150,50,580,0.30973451327433627,1.0
100,150,120,120,100,90,680,0.6493506493506493,56,61,65,48,45,38,313,0.17567567567567569,0.5
59,110,150,45,49,35,448,0.3333333333333333,70,110,75,145,85,145,630,0.9444444444444444,1.0
65,150,60,115,60,115,565,0.935251798561151,55,55,85,65,85,35,380,0.2014388489208633,1.0
65,65,65,50,50,90,385,0.72,106,130,90,110,154,90,680,0.719626168224299,2.0
40,70,130,60,130,25,455,0.17355371900826447,70,140,230,60,80,50,630,0.32432432432432434,1.0
95,125,79,60,100,81,540,0.6165413533834586,88,107,122,74,75,64,530,0.4596774193548387,2.0
60,59,85,79,105,36,424,0.16666666666666666,80,80,90,110,130,110,600,0.8721804511278195,1.0
45,30,40,105,50,20,290,0.031007751937984496,65,40,70,80,140,70,465,0.5954198473282443,1.0
78,70,61,50,61,100,420,0.8145161290322581,90,90,85,125,90,100,580,0.768595041322314,1.0
38,30,41,30,41,60,240,0.2897196261682243,100,100,100,100,100,100,600,0.8778625954198473,1.0
65,85,70,75,70,40,405,0.203125,80,82,100,83,100,80,525,0.6821705426356589,0.5
40,80,100,30,30,20,300,0.11851851851851852,45,85,70,40,40,60,340,0.5229357798165137,1.0
75,110,110,110,105,80,590,0.656934306569343,45,50,43,40,38,62,278,0.40441176470588236,1.0
70,85,70,60,70,50,405,0.28378378378378377,45,30,15,85,65,65,305,0.36220472440944884,1.0
86,76,86,116,56,95,515,0.7982456140350878,76,25,45,67,55,24,292,0.0390625,2.0
52,65,55,58,62,60,352,0.4482758620689655,58,70,45,40,45,42,300,0.25925925925925924,1.0
75,100,63,80,63,116,497,0.9345794392523364,65,125,100,60,70,70,490,0.6099290780141844,1.0
65,90,40,45,80,75,395,0.625,45,30,40,105,50,20,290,0.031007751937984496,2.0
75,100,66,60,66,115,482,0.918918918918919,85,60,65,135,105,100,550,0.7518248175182481,1.0
50,20,55,25,25,30,205,0.09774436090225563,65,55,115,100,40,60,435,0.3798449612403101,2.0
20,15,20,10,55,80,200,0.2682926829268293,70,105,105,50,40,20,390,0.33587786259541985,2.0
45,49,49,65,65,45,318,0.2781954887218045,50,65,107,105,107,86,520,0.6991150442477876,0.5
75,80,70,65,75,90,455,0.7578125,55,130,115,50,50,75,475,0.5982142857142857,1.0
65,73,55,47,75,85,400,0.6846846846846847,80,85,95,30,30,25,345,0.2857142857142857,1.0
75,125,100,70,80,45,495,0.33035714285714285,36,50,50,65,60,44,305,0.16363636363636364,2.0
55,65,95,95,45,85,440,0.6610169491525424,72,95,67,103,71,122,530,0.9606299212598425,0.5
85,105,100,79,83,78,530,0.5869565217391305,65,95,75,55,55,85,430,0.6933333333333334,0.5
60,80,95,70,85,50,440,0.2231404958677686,80,82,83,100,100,80,525,0.6742424242424242,1.0
50,53,48,53,48,64,316,0.46153846153846156,50,72,35,35,35,65,292,0.5373134328358209,1.0
66,117,70,40,50,67,410,0.4573643410852713,67,57,55,77,55,114,425,0.8879310344827587,1.0
82,121,119,69,59,71,521,0.5394736842105263,70,60,62,80,82,60,414,0.4375,4.0
80,125,75,40,95,85,500,0.6911764705882353,60,62,80,63,80,60,405,0.4336283185840708,2.0
100,100,100,100,100,100,600,0.8758169934640523,70,120,40,95,40,95,460,0.8106060606060606,0.0
95,110,95,40,95,55,490,0.40336134453781514,78,92,75,74,63,118,500,0.8842975206611571,1.0
90,60,60,40,40,40,330,0.29545454545454547,95,75,180,130,80,30,590,0.13793103448275862,1.0
45,100,135,65,135,45,525,0.29411764705882354,40,30,35,45,40,55,245,0.31496062992125984,1.0
49,49,56,49,61,66,330,0.5190839694656488,100,100,100,100,100,100,600,0.8805970149253731,0.5
40,45,35,40,40,90,290,0.65,60,59,85,79,105,36,424,0.16666666666666666,1.0
50,65,107,105,107,86,520,0.703125,71,120,95,120,95,99,600,0.8203125,0.5
65,90,50,85,45,55,390,0.371900826446281,75,95,125,45,75,95,510,0.8257575757575758,0.5
75,75,55,105,85,30,425,0.1619718309859155,77,59,50,67,63,46,362,0.23140495867768596,2.0
61,78,95,56,58,57,405,0.40336134453781514,90,100,90,125,85,90,580,0.7352941176470589,0.25
59,59,58,90,70,73,409,0.5826086956521739,40,45,40,65,40,65,295,0.5661764705882353,1.0
58,64,58,80,65,80,405,0.609271523178808,35,35,35,35,35,35,210,0.13385826771653545,1.0
85,97,66,105,66,65,484,0.47107438016528924,80,125,75,40,95,85,500,0.6911764705882353,2.0
60,85,49,60,49,60,363,0.4444444444444444,64,88,50,88,50,106,446,0.9111111111111111,1.0
50,53,48,53,48,64,316,0.358974358974359,64,78,52,78,52,81,405,0.6422764227642277,2.0
95,80,105,40,70,100,490,0.8046875,82,121,119,69,59,71,521,0.5394736842105263,0.5
130,65,60,110,95,65,525,0.5227272727272727,80,115,80,65,55,93,488,0.7846153846153846,1.0
40,40,40,70,40,20,250,0.032520325203252036,74,100,72,90,72,46,454,0.24561403508771928,2.0
45,60,30,80,50,65,330,0.4603174603174603,70,50,30,95,135,105,485,0.8040540540540541,2.0
85,135,130,60,80,25,515,0.40540540540540543,40,55,80,35,60,30,300,0.15037593984962405,0.5
62,50,58,73,54,72,369,0.4435483870967742,65,47,55,73,75,85,400,0.65,2.0
65,90,122,58,75,84,494,0.71875,75,55,70,55,95,110,460,0.8444444444444444,0.25
50,105,125,55,95,50,480,0.375886524822695,70,40,50,55,50,25,290,0.061068702290076333,1.0
100,70,70,65,65,45,415,0.1897810218978102,85,115,80,105,80,50,515,0.3063063063063063,1.0
44,75,35,63,33,45,295,0.2647058823529412,40,55,30,30,30,85,270,0.688,0.0
190,33,58,33,58,33,405,0.13432835820895522,65,80,80,59,63,58,405,0.4411764705882353,1.0
30,35,30,100,35,80,310,0.4765625,60,30,30,36,56,50,262,0.32432432432432434,0.0
10,55,25,35,45,95,265,0.5396825396825397,80,120,70,110,70,80,530,0.6422764227642277,2.0
74,100,72,90,72,46,454,0.24561403508771928,55,55,45,63,45,45,308,0.25,2.0
30,30,30,30,30,30,180,0.12612612612612611,70,55,65,95,85,70,440,0.5307692307692308,2.0
60,50,70,50,90,65,385,0.39568345323741005,60,80,50,40,40,30,300,0.15328467153284672,1.0
105,30,105,140,105,55,540,0.3524590163934426,50,53,48,53,48,64,316,0.4076923076923077,2.0
68,85,65,165,135,100,618,0.8083333333333333,40,80,35,35,45,70,305,0.4661016949152542,2.0
65,90,50,85,45,55,390,0.371900826446281,49,55,42,42,37,85,310,0.6068376068376068,1.0
52,65,50,45,50,38,300,0.27419354838709675,80,95,82,60,82,75,474,0.6,1.0
61,78,95,56,58,57,405,0.40336134453781514,40,60,40,40,40,30,250,0.0948905109489051,0.25
63,60,55,50,50,71,349,0.5289256198347108,40,30,35,50,70,55,280,0.28205128205128205,2.0
105,105,75,65,100,50,500,0.37593984962406013,80,80,50,40,50,25,325,0.176056338028169,0.5
55,55,55,85,55,30,335,0.1320754716981132,66,41,77,61,87,23,355,0.12096774193548387,1.0
100,134,110,95,100,61,600,0.4057971014492754,55,50,45,135,95,120,500,0.7714285714285715,2.0
60,70,65,125,105,90,515,0.6911764705882353,75,75,75,125,95,40,485,0.15671641791044777,1.0
130,85,80,85,95,60,535,0.43884892086330934,105,30,105,140,105,55,540,0.3524590163934426,1.0
65,125,100,55,70,85,500,0.6532258064516129,70,55,65,95,85,70,440,0.5307692307692308,2.0
60,55,50,40,55,45,305,0.22377622377622378,65,110,130,60,65,95,525,0.8278145695364238,4.0
66,65,48,62,57,52,350,0.36220472440944884,75,85,200,55,65,30,510,0.16778523489932887,1.0
44,38,33,61,43,70,289,0.5267857142857143,46,57,40,40,40,50,273,0.25,1.0
43,80,65,50,35,35,308,0.14193548387096774,30,40,55,40,55,60,280,0.3237410071942446,1.0
60,55,50,40,55,45,305,0.22377622377622378,55,85,55,50,55,60,360,0.4233576642335766,0.5
95,75,110,100,80,30,490,0.15267175572519084,62,48,54,63,60,68,355,0.5178571428571429,0.5
45,63,37,65,55,95,360,0.8055555555555556,60,40,60,40,60,35,295,0.18055555555555555,0.5
95,117,184,44,46,28,514,0.2975206611570248,35,45,160,30,45,70,385,0.48148148148148145,2.0
70,77,60,97,60,108,472,0.8394160583941606,65,90,50,85,45,55,390,0.371900826446281,0.5
30,30,30,30,30,30,180,0.12612612612612611,100,150,110,95,110,70,635,0.5923076923076923,4.0
91,134,95,100,100,80,600,0.6304347826086957,85,110,76,65,82,56,474,0.3933333333333333,2.0
50,70,50,50,50,40,310,0.16296296296296298,75,100,66,60,66,115,482,0.918918918918919,1.0
64,88,50,88,50,106,446,0.9111111111111111,110,78,73,76,71,60,468,0.3333333333333333,1.0
30,105,90,25,25,50,325,0.2773722627737226,68,72,78,38,42,32,330,0.23809523809523808,2.0
86,76,86,116,56,95,515,0.7982456140350878,65,90,40,45,80,75,395,0.625,1.0
100,120,100,150,120,90,680,0.728,62,44,50,44,50,55,305,0.3629032258064516,0.5
80,70,70,90,100,70,480,0.5609756097560976,80,82,100,83,100,80,525,0.6821705426356589,0.25
79,115,70,125,80,111,580,0.864,125,130,90,130,90,95,660,0.7734375,0.5
55,55,55,85,55,30,335,0.1320754716981132,45,49,49,65,65,45,318,0.2781954887218045,2.0
90,50,34,60,44,70,348,0.6283185840707964,70,50,30,95,135,105,485,0.8040540540540541,1.0
40,50,45,70,45,70,320,0.5517241379310345,49,49,56,49,61,66,330,0.5190839694656488,1.0
65,75,70,95,70,95,470,0.7272727272727273,70,110,70,115,70,90,525,0.75,0.5
55,55,55,85,55,30,335,0.1320754716981132,60,40,60,95,60,55,370,0.4222222222222222,1.0
50,85,125,85,115,20,480,0.4306569343065693,78,84,78,109,85,100,534,0.8620689655172413,1.0
70,140,230,60,80,50,630,0.32432432432432434,68,125,65,65,115,80,518,0.6277372262773723,1.0
89,145,90,105,80,91,600,0.8549618320610687,50,50,62,40,62,65,329,0.4188034188034188,2.0
68,125,65,65,115,80,518,0.6277372262773723,50,53,48,53,48,64,316,0.4076923076923077,1.0
75,98,63,98,63,101,498,0.849624060150376,100,77,77,128,128,90,600,0.6901408450704225,1.0
60,50,150,50,150,60,520,0.5206611570247934,61,90,45,50,50,160,456,0.9230769230769231,1.0
60,65,60,130,75,110,500,0.7719298245614035,55,45,43,55,43,72,313,0.5853658536585366,2.0
60,40,60,95,60,55,370,0.4222222222222222,58,64,58,80,65,80,405,0.609271523178808,0.5
85,56,77,50,77,78,423,0.53125,85,97,66,105,66,65,484,0.47107438016528924,2.0
44,58,44,58,44,61,309,0.41964285714285715,40,35,30,120,70,105,400,0.6692307692307692,1.0
70,100,115,30,65,30,410,0.24390243902439024,65,40,50,125,60,30,370,0.07258064516129033,1.0
50,45,45,35,35,50,260,0.23529411764705882,90,100,60,90,60,80,480,0.6422764227642277,1.0
50,60,60,60,60,30,320,0.11290322580645161,95,75,80,100,110,30,490,0.24242424242424243,0.5
60,50,50,60,70,50,340,0.28346456692913385,43,30,55,40,65,97,330,0.6030534351145038,1.0
70,145,88,140,70,112,625,0.8888888888888888,40,65,95,60,45,35,340,0.13986013986013987,0.5
50,120,53,35,110,87,455,0.640625,100,100,100,100,100,100,600,0.8778625954198473,0.5
44,58,44,58,44,61,309,0.41964285714285715,74,48,76,83,81,104,466,0.7322834645669292,1.0
55,85,122,58,75,99,494,0.8099173553719008,60,55,90,145,90,80,520,0.6071428571428571,1.0
68,165,95,65,115,110,618,0.8615384615384616,50,55,50,36,30,43,264,0.2922077922077922,1.0
100,100,80,60,60,50,450,0.3050847457627119,68,65,65,125,115,80,518,0.6461538461538462,1.0
108,112,118,68,72,47,525,0.2916666666666667,100,123,75,57,75,80,510,0.6923076923076923,0.0
75,125,230,55,95,30,610,0.3448275862068966,70,80,50,35,35,35,305,0.14,1.0
40,45,40,62,60,60,307,0.33884297520661155,30,40,70,70,25,60,295,0.41353383458646614,0.5
75,125,100,70,80,45,495,0.33035714285714285,37,25,41,25,41,25,194,0.08870967741935484,2.0
40,40,35,50,100,70,335,0.5031847133757962,100,150,90,180,160,90,770,0.7348484848484849,0.5
45,45,35,20,30,20,195,0.07246376811594203,66,117,70,40,50,67,410,0.4573643410852713,1.0
64,115,65,83,63,65,455,0.5323741007194245,123,77,72,99,92,58,521,0.4621212121212121,1.0
55,63,90,50,80,42,380,0.21138211382113822,43,70,48,50,60,38,309,0.2391304347826087,0.5
65,65,65,50,50,90,385,0.72,71,73,88,120,89,59,500,0.43537414965986393,0.5
90,60,60,40,40,40,330,0.29545454545454547,80,105,105,105,105,80,580,0.5939849624060151,1.0
30,80,90,55,45,55,355,0.4295774647887324,60,50,70,50,90,65,385,0.39568345323741005,2.0
70,60,70,87,78,85,450,0.6228070175438597,108,112,118,68,72,47,525,0.2916666666666667,2.0
110,85,95,80,95,50,515,0.2713178294573643,125,58,58,76,76,67,460,0.515625,1.0
72,58,80,103,80,97,490,0.7171052631578947,150,100,120,100,120,90,680,0.6666666666666666,1.0
80,90,80,130,110,110,600,0.856,70,120,65,45,85,125,510,0.9747899159663865,0.0
35,35,35,35,35,35,210,0.13385826771653545,70,90,70,60,60,70,420,0.6390977443609023,2.0
60,110,70,60,60,100,460,0.8461538461538461,50,30,55,65,55,20,275,0.13675213675213677,0.0
110,78,73,76,71,60,468,0.3333333333333333,45,95,50,40,50,75,355,0.54,2.0
100,100,100,100,100,100,600,0.8778625954198473,95,70,73,95,90,60,483,0.3983739837398374,1.0
60,70,105,70,120,75,500,0.5983606557377049,75,103,80,70,80,92,500,0.7933884297520661,0.25
90,95,95,70,90,70,510,0.5230769230769231,100,128,90,77,77,128,600,0.959349593495935,2.0
120,120,120,120,120,120,720,0.9344262295081968,40,55,80,35,60,30,300,0.15037593984962405,0.5
105,150,90,150,90,95,680,0.8285714285714286,54,78,103,53,45,22,355,0.23255813953488372,0.5
75,90,140,60,60,40,465,0.3008130081300813,95,100,85,108,70,70,528,0.5652173913043478,0.5
20,10,55,15,20,80,200,0.17985611510791366,45,49,49,65,65,45,318,0.2781954887218045,0.5
70,55,95,95,110,65,490,0.48872180451127817,90,30,15,40,20,15,210,0.043478260869565216,1.0
43,80,65,50,35,35,308,0.14193548387096774,50,35,55,25,25,15,205,0.05263157894736842,1.0
80,130,100,160,120,110,700,0.8981481481481481,101,72,72,99,89,29,462,0.1937984496124031,0.0
72,58,80,103,80,97,490,0.7171052631578947,60,95,80,60,80,30,405,0.19480519480519481,4.0
105,140,55,30,55,95,480,0.8195488721804511,70,55,65,95,85,70,440,0.5307692307692308,0.5
38,30,41,30,41,60,240,0.2897196261682243,20,15,20,10,55,80,200,0.2682926829268293,1.0
50,60,45,100,80,65,400,0.45689655172413796,65,75,105,35,65,85,430,0.6940298507462687,0.5
255,10,10,75,135,55,540,0.3125,82,80,86,85,75,72,480,0.6183206106870229,1.0
110,135,60,50,65,88,508,0.7744360902255639,165,75,80,40,45,65,470,0.5151515151515151,0.5
160,110,65,65,110,30,540,0.35714285714285715,75,105,75,105,75,45,480,0.3274336283185841,1.0
65,65,65,50,50,90,385,0.72,70,70,40,60,40,60,340,0.4247787610619469,0.5
60,105,60,120,60,105,510,0.8849557522123894,69,69,76,69,86,91,460,0.6554621848739496,1.0
56,61,65,48,45,38,313,0.17567567567567569,78,81,71,74,69,126,499,0.9090909090909091,0.25
45,80,100,35,37,28,325,0.3125,65,83,57,95,85,105,490,0.8914728682170543,0.5
160,110,65,65,110,30,540,0.35714285714285715,40,20,30,40,80,55,265,0.22764227642276422,1.0
95,70,73,95,90,60,483,0.3983739837398374,50,40,85,40,65,25,305,0.08870967741935484,1.0
80,70,40,100,60,145,495,0.921875,70,110,75,145,85,145,630,0.9444444444444444,2.0
123,100,62,97,81,68,531,0.4806201550387597,75,125,230,55,95,30,610,0.3448275862068966,1.0
80,100,200,50,100,50,580,0.3472222222222222,60,90,55,90,80,110,485,0.8677685950413223,1.0
45,49,49,65,65,45,318,0.2781954887218045,75,98,63,98,63,101,498,0.8091603053435115,1.0
61,72,57,55,55,65,365,0.3984375,110,135,60,50,65,88,508,0.7744360902255639,0.0
45,30,15,85,65,65,305,0.36220472440944884,70,80,65,90,65,85,455,0.578125,0.5
75,89,85,55,65,36,405,0.29545454545454547,50,160,110,160,110,110,700,0.8854961832061069,2.0
76,65,45,92,42,91,411,0.7449664429530202,70,84,70,65,70,51,410,0.2949640287769784,0.25
30,45,59,30,39,57,260,0.2803030303030303,40,55,70,45,60,30,300,0.10619469026548672,0.0
95,65,65,110,130,60,525,0.4016393442622951,75,95,125,45,75,95,510,0.8257575757575758,1.0
20,40,15,35,35,60,205,0.34285714285714286,70,110,75,145,85,145,630,0.9444444444444444,0.25
50,50,40,50,40,64,294,0.45588235294117646,55,95,55,35,75,115,430,0.9380530973451328,1.0
28,25,25,45,35,40,198,0.16083916083916083,68,72,78,38,42,32,330,0.23809523809523808,2.0
116,55,85,107,95,29,487,0.06818181818181818,80,130,100,160,120,110,700,0.8981481481481481,0.5
70,85,140,85,70,20,470,0.272,75,98,63,98,63,101,498,0.889763779527559,0.5
65,80,140,40,70,70,465,0.5223880597014925,53,54,53,37,46,45,288,0.3090909090909091,1.0
50,20,40,20,40,20,190,0.0962962962962963,80,120,79,95,79,70,523,0.5833333333333334,1.0
60,90,55,90,80,110,485,0.8677685950413223,65,65,60,130,95,110,525,0.823943661971831,1.0
25,35,70,95,55,45,325,0.16783216783216784,45,30,50,65,50,45,285,0.13821138211382114,1.0
69,69,76,69,86,91,460,0.6554621848739496,65,65,60,110,95,130,525,0.9253731343283582,1.0
100,123,75,57,75,80,510,0.6923076923076923,100,5,5,15,65,30,220,0.07692307692307693,1.0
66,41,77,61,87,23,355,0.12096774193548387,50,80,95,10,45,10,290,0.232,2.0
45,30,50,55,65,45,290,0.208,65,45,55,45,70,45,325,0.24369747899159663,1.0
52,65,50,45,50,38,300,0.27419354838709675,95,117,184,44,46,28,514,0.2975206611570248,1.0
45,45,55,45,55,63,308,0.4594594594594595,50,65,107,105,107,86,520,0.7313432835820896,0.5
60,65,80,170,95,130,600,0.8625954198473282,70,50,30,95,135,105,485,0.8040540540540541,1.0
50,65,107,105,107,86,520,0.6991150442477876,36,50,50,65,60,44,305,0.16363636363636364,2.0
90,70,80,70,95,70,475,0.5190839694656488,75,125,230,55,95,30,610,0.3448275862068966,2.0
108,170,115,120,95,92,700,0.7083333333333334,80,82,100,83,100,80,525,0.6821705426356589,0.5
95,95,85,125,65,55,520,0.3894736842105263,79,105,70,145,80,101,580,0.8608695652173913,0.5
70,70,115,130,90,60,535,0.5338983050847458,50,55,50,36,30,43,264,0.2922077922077922,2.0
82,121,119,69,59,71,521,0.5394736842105263,109,66,84,81,99,32,471,0.2013888888888889,0.5
41,64,45,50,50,50,300,0.36752136752136755,101,72,72,99,89,29,462,0.1937984496124031,0.0
50,65,45,85,65,95,405,0.7238095238095238,45,95,50,40,50,75,355,0.54,1.0
64,115,65,83,63,65,455,0.5323741007194245,39,52,43,60,50,65,309,0.5041322314049587,1.0
70,50,30,95,135,105,485,0.8040540540540541,70,55,65,95,85,70,440,0.5307692307692308,1.0
70,140,70,110,65,105,560,0.95,58,70,45,40,45,42,300,0.25925925925925924,1.0
75,125,230,55,95,30,610,0.3448275862068966,65,80,80,59,63,58,405,0.4411764705882353,0.5
90,85,100,95,125,85,580,0.6834532374100719,90,85,75,115,100,115,580,0.9381443298969072,0.5
100,50,50,76,96,70,442,0.5,55,95,55,35,75,115,430,0.9380530973451328,1.0
255,10,10,75,135,55,540,0.3125,70,84,70,65,70,51,410,0.2949640287769784,0.5
75,105,75,105,75,45,480,0.3274336283185841,50,20,55,25,25,30,205,0.09774436090225563,1.0
80,120,70,110,70,80,530,0.6422764227642277,60,85,42,85,42,91,405,0.8227848101265823,1.0
80,120,130,55,65,45,495,0.37037037037037035,60,60,40,65,45,35,305,0.15833333333333333,2.0
65,75,90,97,123,44,494,0.1987179487179487,109,66,84,81,99,32,471,0.2013888888888889,0.5
80,110,120,130,90,70,600,0.6198347107438017,75,100,66,60,66,115,482,0.918918918918919,1.0
90,92,87,75,85,76,505,0.5409836065573771,55,45,50,45,65,80,340,0.5546218487394958,0.0
65,125,60,95,60,105,510,0.9236641221374046,75,75,75,125,95,40,485,0.15671641791044777,0.5
150,100,120,100,120,90,680,0.6666666666666666,70,60,125,115,70,55,495,0.35507246376811596,1.0
106,130,90,110,154,90,680,0.719626168224299,30,40,70,70,25,60,295,0.41353383458646614,0.5
75,125,75,30,75,85,465,0.625,58,64,58,80,65,80,405,0.609271523178808,1.0
125,130,90,130,90,95,660,0.7734375,80,100,123,122,120,80,625,0.56,2.0
100,75,115,90,115,85,580,0.6446280991735537,85,80,70,135,75,90,535,0.7006802721088435,1.0
64,66,68,81,76,50,405,0.25190839694656486,55,45,43,55,43,72,313,0.5853658536585366,1.0
60,79,105,59,85,36,424,0.17054263565891473,55,104,105,94,75,52,485,0.36363636363636365,1.0
68,165,95,65,115,110,618,0.8615384615384616,85,76,64,45,55,90,415,0.6739130434782609,2.0
100,77,77,128,128,90,600,0.6901408450704225,100,164,150,95,120,71,700,0.5645161290322581,0.0
150,80,44,90,54,80,498,0.625,160,110,65,65,110,30,540,0.35714285714285715,0.0
45,60,45,25,45,55,275,0.29,40,45,35,30,40,55,245,0.3793103448275862,1.0
65,100,70,80,80,105,500,0.8666666666666667,60,50,150,50,150,60,520,0.5206611570247934,2.0
70,130,100,55,80,65,500,0.608,85,60,65,135,105,100,550,0.7518248175182481,0.25
45,80,100,35,37,28,325,0.3125,40,30,30,55,30,85,270,0.4666666666666667,0.5
35,80,50,50,70,120,405,0.84375,30,45,135,45,90,30,375,0.09285714285714286,2.0
65,150,40,15,80,145,495,0.9663865546218487,65,45,55,45,70,45,325,0.24369747899159663,1.0
60,60,50,40,50,75,335,0.5882352941176471,74,100,72,90,72,46,454,0.24561403508771928,0.5
60,85,69,65,79,80,438,0.576,75,75,55,105,85,30,425,0.1619718309859155,2.0
50,64,50,45,50,41,300,0.22727272727272727,95,135,80,110,80,100,600,0.8248175182481752,0.0
35,85,45,35,35,75,310,0.6492537313432836,71,82,64,64,59,112,452,0.9327731092436975,1.0
58,109,112,48,48,109,484,0.8805970149253731,70,60,62,80,82,60,414,0.4375,0.5
80,50,100,100,200,50,580,0.2357142857142857,60,100,115,70,85,90,520,0.7557251908396947,0.5
70,95,125,65,75,45,475,0.33613445378151263,45,67,60,35,50,63,320,0.5128205128205128,1.0
100,70,70,65,65,45,415,0.1897810218978102,90,50,34,60,44,70,348,0.6283185840707964,0.0
60,60,60,60,60,60,360,0.38095238095238093,95,110,80,70,80,50,485,0.37209302325581395,1.0
55,85,55,50,55,60,360,0.4233576642335766,70,55,65,95,85,70,440,0.5307692307692308,1.0
77,85,51,55,51,65,384,0.5163934426229508,60,60,75,60,75,80,410,0.7321428571428571,1.0
64,88,50,88,50,106,446,0.9111111111111111,38,35,40,27,25,35,200,0.08208955223880597,1.0
30,30,30,30,30,30,180,0.12612612612612611,86,68,72,109,66,106,507,0.8099173553719008,0.5
65,95,100,60,50,50,420,0.34959349593495936,60,60,50,40,50,75,335,0.5882352941176471,1.0
80,135,85,70,95,150,615,0.9844961240310077,60,75,100,55,80,50,420,0.3088235294117647,0.25
106,90,130,90,154,110,680,0.8699186991869918,45,67,60,35,50,63,320,0.5128205128205128,1.0
65,50,35,115,95,95,455,0.7333333333333333,90,120,100,150,120,100,680,0.7718120805369127,1.0
60,90,140,50,50,40,430,0.2535211267605634,85,80,90,105,95,60,515,0.49074074074074076,1.0
70,80,102,80,102,40,474,0.2677165354330709,165,75,80,40,45,65,470,0.5151515151515151,1.0
50,50,77,95,77,91,440,0.5916666666666667,70,20,50,20,50,40,250,0.1557377049180328,2.0
75,38,38,56,56,67,330,0.5263157894736842,100,100,100,100,100,100,600,0.8758169934640523,1.0
100,110,90,85,90,60,535,0.47794117647058826,35,46,34,35,45,20,215,0.072,1.0
55,40,85,80,105,40,405,0.23622047244094488,45,50,43,40,38,62,278,0.40441176470588236,1.0
80,120,130,55,65,45,495,0.37037037037037035,75,95,60,65,60,115,470,0.8778625954198473,1.0
65,60,70,85,75,40,395,0.1796875,91,90,129,90,72,108,580,0.9140625,0.5
130,85,80,85,95,60,535,0.43884892086330934,54,45,47,75,98,52,371,0.39669421487603307,1.0
76,104,71,104,71,108,534,0.912751677852349,95,100,85,108,70,70,528,0.5652173913043478,0.5
150,120,100,120,100,90,680,0.664179104477612,68,72,78,38,42,32,330,0.23809523809523808,1.0
70,100,115,30,65,30,410,0.24390243902439024,70,83,50,37,50,60,350,0.3360655737704918,2.0
100,100,90,150,140,90,670,0.71875,70,105,105,50,40,20,390,0.33587786259541985,2.0
100,100,100,100,100,100,600,0.8602941176470589,105,125,100,60,100,100,590,0.8359375,1.0
35,64,85,74,55,32,345,0.19827586206896552,75,100,66,60,66,115,482,0.918918918918919,1.0
40,45,40,35,35,56,251,0.373015873015873,70,70,70,70,70,70,420,0.5289256198347108,1.0
42,52,67,39,56,50,306,0.2868217054263566,80,120,130,55,65,45,495,0.37037037037037035,2.0
80,135,85,70,95,150,615,0.9844961240310077,90,92,75,92,85,60,494,0.49586776859504134,4.0
80,130,100,160,120,110,700,0.8981481481481481,49,55,42,42,37,85,310,0.6068376068376068,1.0
95,60,79,100,125,81,540,0.6201550387596899,38,35,35,65,55,50,278,0.2647058823529412,1.0
75,125,230,55,95,30,610,0.3448275862068966,85,105,85,40,50,40,405,0.211864406779661,1.0
60,105,60,120,60,105,510,0.8849557522123894,85,105,100,79,83,78,530,0.5869565217391305,1.0
73,76,75,81,100,100,505,0.8110236220472441,50,55,50,36,30,43,264,0.2922077922077922,1.0
100,150,120,120,100,90,680,0.6493506493506493,67,57,55,77,55,114,425,0.8879310344827587,2.0
65,95,57,100,85,93,495,0.7441860465116279,123,100,62,97,81,68,531,0.4806201550387597,2.0
84,86,88,111,101,60,530,0.4634146341463415,80,115,80,65,55,93,488,0.7846153846153846,1.0
78,81,71,74,69,126,499,0.9090909090909091,50,35,55,25,25,15,205,0.021739130434782608,4.0
50,20,40,20,40,20,190,0.0962962962962963,55,50,40,40,40,75,300,0.5945945945945946,1.0
44,38,39,61,79,42,303,0.2251655629139073,135,85,40,40,85,5,390,0.6864406779661016,1.0
59,45,40,35,40,31,250,0.14285714285714285,73,76,75,81,100,100,505,0.8110236220472441,1.0
40,30,35,45,40,55,245,0.31496062992125984,50,65,90,35,35,15,290,0.14678899082568808,2.0
75,100,63,80,63,116,497,0.9345794392523364,60,62,63,80,80,60,405,0.38016528925619836,0.5
60,100,115,70,85,90,520,0.7557251908396947,90,50,34,60,44,70,348,0.6283185840707964,1.0
104,91,63,91,73,68,490,0.5118110236220472,70,65,65,55,55,70,380,0.5,1.0
70,110,180,60,60,50,530,0.4117647058823529,45,49,65,49,65,45,318,0.275,1.0
85,97,66,105,66,65,484,0.47107438016528924,65,40,70,80,140,70,465,0.5954198473282443,0.5
53,51,53,61,56,40,314,0.14285714285714285,35,85,45,35,35,75,310,0.6492537313432836,1.0
80,52,50,90,50,89,411,0.6666666666666666,91,72,90,129,90,108,580,0.8925619834710744,1.0
45,55,39,35,39,42,255,0.18518518518518517,65,50,70,95,80,65,425,0.4262295081967213,1.0
80,82,78,95,80,85,500,0.6869565217391305,74,108,133,83,65,32,495,0.32142857142857145,1.0
28,25,25,45,35,40,198,0.16083916083916083,100,150,120,120,100,90,680,0.6493506493506493,2.0
45,60,30,80,50,65,330,0.4603174603174603,109,66,84,81,99,32,471,0.2013888888888889,1.0
75,65,55,65,55,69,384,0.43548387096774194,43,30,55,40,65,97,330,0.6030534351145038,0.5
80,120,70,110,70,80,530,0.6422764227642277,35,64,85,74,55,32,345,0.19827586206896552,0.5
70,83,50,37,50,60,350,0.3360655737704918,60,115,105,65,70,80,495,0.7181818181818181,0.25
60,69,95,69,95,36,424,0.2608695652173913,45,40,60,40,75,50,310,0.2926829268292683,0.5
65,150,40,15,80,145,495,0.9663865546218487,100,50,50,76,96,70,442,0.5,0.5
100,120,100,150,120,90,680,0.728,100,100,90,150,140,90,670,0.71875,0.5
65,80,65,35,65,60,370,0.38405797101449274,60,85,60,50,50,125,430,0.9090909090909091,1.0
75,85,200,55,65,30,510,0.16778523489932887,60,70,50,100,50,65,395,0.5217391304347826,0.0
80,82,78,95,80,85,500,0.6869565217391305,50,50,95,40,50,35,320,0.20279720279720279,2.0
50,60,45,100,80,65,400,0.45689655172413796,60,65,60,130,75,110,500,0.7719298245614035,0.125
39,52,43,60,50,65,309,0.5041322314049587,62,44,50,44,50,55,305,0.3629032258064516,0.5
95,100,85,108,70,70,528,0.5652173913043478,75,80,85,110,90,50,490,0.3548387096774194,0.5
55,95,115,45,45,35,390,0.2116788321167883,20,40,15,35,35,60,205,0.34285714285714286,2.0
67,125,40,30,30,58,350,0.3431372549019608,65,75,105,35,65,85,430,0.6940298507462687,1.0
53,54,53,37,46,45,288,0.3090909090909091,43,30,55,40,65,97,330,0.6030534351145038,1.0
63,60,55,50,50,71,349,0.5289256198347108,65,50,35,115,95,95,455,0.7333333333333333,1.0
74,108,133,83,65,32,495,0.32142857142857145,60,30,30,36,56,50,262,0.32432432432432434,2.0
59,66,70,44,55,41,335,0.25190839694656486,35,20,65,40,65,20,245,0.02459016393442623,1.0
78,52,60,63,65,23,341,0.06015037593984962,50,70,50,50,50,40,310,0.16296296296296298,1.0
64,115,65,83,63,65,455,0.5323741007194245,45,30,50,65,50,45,285,0.13821138211382114,2.0
65,65,60,110,95,130,525,0.9253731343283582,100,150,90,180,160,90,770,0.7348484848484849,2.0
79,85,60,55,60,71,410,0.60431654676259,45,60,30,80,50,65,330,0.4603174603174603,2.0
75,90,50,110,80,95,500,0.7985611510791367,74,48,76,83,81,104,466,0.7322834645669292,2.0
70,120,65,45,85,125,510,0.9747899159663865,85,90,80,70,80,130,535,0.9262295081967213,2.0
60,60,50,40,50,75,335,0.5882352941176471,84,86,88,111,101,60,530,0.4634146341463415,0.5
105,150,90,150,90,95,680,0.8285714285714286,90,120,100,150,120,100,680,0.7718120805369127,2.0
70,110,70,115,70,90,525,0.75,65,75,90,97,123,44,494,0.1987179487179487,0.5
40,65,95,60,45,35,340,0.13986013986013987,80,80,80,80,80,80,480,0.6015037593984962,1.0
65,65,60,110,95,130,525,0.9253731343283582,45,55,45,65,45,75,330,0.5692307692307692,2.0
80,52,50,90,50,89,411,0.6666666666666666,90,110,80,100,80,95,555,0.7982456140350878,0.5
100,123,75,57,75,80,510,0.6923076923076923,88,107,122,74,75,64,530,0.4596774193548387,4.0
80,80,80,80,80,80,480,0.6015037593984962,85,50,95,120,115,80,545,0.5793650793650794,2.0
90,55,75,60,75,30,385,0.13970588235294118,91,72,90,129,90,108,580,0.8620689655172413,1.0
40,45,35,65,55,70,310,0.4482758620689655,50,105,125,55,95,50,480,0.375886524822695,0.5
53,54,53,37,46,45,288,0.3090909090909091,76,25,45,67,55,24,292,0.0390625,1.0
89,145,90,105,80,91,600,0.8549618320610687,75,90,50,110,80,95,500,0.7985611510791367,2.0
78,70,61,50,61,100,420,0.8145161290322581,75,95,125,45,75,95,510,0.8257575757575758,1.0
76,147,90,60,70,97,540,0.8267716535433071,40,45,40,62,60,60,307,0.33884297520661155,1.0
100,150,110,95,110,70,635,0.5923076923076923,38,30,85,55,65,30,303,0.21428571428571427,1.0
75,80,55,25,35,35,305,0.18666666666666668,54,45,47,75,98,52,371,0.39669421487603307,0.5
30,40,55,40,55,60,280,0.3237410071942446,75,103,80,70,80,92,500,0.7933884297520661,0.5
50,65,107,105,107,86,520,0.6991150442477876,67,89,116,79,116,33,500,0.2624113475177305,2.0
50,65,90,35,35,15,290,0.14678899082568808,60,95,80,60,80,30,405,0.19480519480519481,2.0
60,90,55,90,80,110,485,0.8677685950413223,40,70,40,35,40,60,285,0.392,1.0
40,40,40,70,40,20,250,0.032520325203252036,95,117,80,65,70,92,519,0.8409090909090909,1.0
75,98,63,98,63,101,498,0.8091603053435115,79,105,70,145,80,101,580,0.8608695652173913,0.5
40,55,99,40,79,47,360,0.26262626262626265,60,150,50,150,50,60,520,0.5,0.0
64,51,23,51,23,28,240,0.11363636363636363,30,40,55,40,55,60,280,0.3237410071942446,1.0
30,65,100,45,25,40,305,0.1891891891891892,55,85,55,50,55,60,360,0.4233576642335766,2.0
85,135,130,60,80,25,515,0.40540540540540543,80,75,150,75,150,50,580,0.30973451327433627,0.5
100,100,90,150,140,90,670,0.71875,100,150,140,100,90,90,670,0.7969924812030075,2.0
100,100,100,100,100,100,600,0.8805970149253731,67,125,40,30,30,58,350,0.3431372549019608,2.0
35,45,160,30,45,70,385,0.48148148148148145,105,95,80,40,80,90,490,0.753968253968254,1.0
60,70,50,100,50,65,395,0.5217391304347826,40,55,30,30,30,85,270,0.688,0.5
55,55,55,85,55,30,335,0.1320754716981132,60,95,80,60,80,30,405,0.19480519480519481,1.0
90,75,85,115,90,55,510,0.3445378151260504,50,45,45,35,35,50,260,0.23529411764705882,1.0
55,20,35,20,45,75,250,0.37681159420289856,58,50,145,95,105,30,483,0.2459016393442623,0.0
35,40,100,90,55,35,355,0.1796875,45,25,50,25,25,35,205,0.13076923076923078,2.0
35,40,100,90,55,35,355,0.1796875,125,170,100,120,90,95,700,0.77,1.0
60,62,63,80,80,60,405,0.38016528925619836,60,85,49,60,49,60,363,0.4444444444444444,1.0
45,95,50,40,50,75,355,0.54,65,90,115,45,115,58,488,0.5041322314049587,0.5
61,84,65,70,70,70,420,0.5,30,45,55,70,55,85,340,0.5633802816901409,1.0
90,70,80,70,95,70,475,0.5190839694656488,50,30,55,65,55,20,275,0.13675213675213677,1.0
35,40,100,90,55,35,355,0.1796875,125,120,90,170,100,95,700,0.78125,1.0
85,105,55,85,50,115,495,0.9032258064516129,35,40,100,90,55,35,355,0.1796875,1.0
55,50,45,135,95,120,500,0.7714285714285715,90,100,70,110,150,80,600,0.6037735849056604,1.0
90,92,87,75,85,76,505,0.5409836065573771,30,45,59,30,39,57,260,0.2803030303030303,0.5
50,70,160,70,160,90,600,0.7417218543046358,80,185,115,40,105,75,600,0.6230769230769231,1.0
91,129,90,72,90,108,580,0.8536585365853658,55,63,90,50,80,42,380,0.21138211382113822,1.0
60,25,35,70,80,60,330,0.3076923076923077,80,82,78,95,80,85,500,0.6869565217391305,1.0
58,64,58,80,65,80,405,0.609271523178808,75,95,122,58,75,69,494,0.5725806451612904,2.0
73,95,62,85,65,85,465,0.6666666666666666,60,95,80,60,80,30,405,0.19480519480519481,1.0
50,50,40,30,30,50,250,0.2781954887218045,60,85,69,65,79,80,438,0.576,2.0
1,90,45,30,30,40,236,0.33064516129032256,70,60,75,110,75,90,480,0.7165354330708661,2.0
95,70,73,95,90,60,483,0.3983739837398374,100,134,110,95,100,61,600,0.4057971014492754,2.0
100,123,75,57,75,80,510,0.6923076923076923,40,80,100,30,30,20,300,0.11851851851851852,0.25
110,78,73,76,71,60,468,0.3333333333333333,45,30,50,65,50,45,285,0.13821138211382114,1.0
71,95,85,110,95,79,535,0.664,72,105,115,54,86,68,500,0.5149253731343284,0.5
75,100,95,40,70,110,490,0.8717948717948718,64,115,65,83,63,65,455,0.5323741007194245,0.0
70,70,115,130,90,60,535,0.5338983050847458,44,38,33,61,43,70,289,0.5267857142857143,0.25
40,70,130,60,130,25,455,0.17355371900826447,85,105,100,79,83,78,530,0.5869565217391305,1.0
50,95,90,95,90,180,600,0.9172413793103448,80,82,83,100,100,80,525,0.6742424242424242,2.0
50,65,107,105,107,86,520,0.703125,65,90,122,58,75,84,494,0.71875,1.0
50,150,50,150,50,150,600,0.9339622641509434,70,65,65,55,55,70,380,0.5,1.0
75,125,70,125,70,115,580,0.9037037037037037,50,65,85,35,35,55,325,0.32575757575757575,1.0
92,105,90,125,90,98,600,0.8217054263565892,49,55,42,42,37,85,310,0.6068376068376068,1.0
60,110,70,60,60,100,460,0.8461538461538461,76,104,71,104,71,108,534,0.912751677852349,2.0
30,40,55,40,55,60,280,0.3237410071942446,70,110,180,60,60,50,530,0.4117647058823529,2.0
75,87,63,87,63,98,473,0.865546218487395,110,80,90,95,90,65,530,0.5033557046979866,0.5
100,75,115,90,115,85,580,0.6446280991735537,76,48,48,57,62,34,325,0.11688311688311688,0.5
45,30,50,65,50,45,285,0.13821138211382114,82,121,119,69,59,71,521,0.5394736842105263,1.0
83,106,65,86,65,85,490,0.6640625,40,60,30,31,31,70,262,0.4492753623188406,1.0
75,125,70,125,70,115,580,0.9037037037037037,100,100,90,150,140,90,670,0.71875,1.0
50,64,50,45,50,41,300,0.22727272727272727,45,45,55,45,55,63,308,0.4594594594594595,0.5
44,75,35,63,33,45,295,0.2647058823529412,91,90,106,130,106,77,600,0.648854961832061,1.0
105,180,100,180,100,115,780,0.9477611940298507,91,72,90,129,90,108,580,0.8620689655172413,2.0
91,129,90,72,90,108,580,0.8536585365853658,90,120,100,150,120,100,680,0.7718120805369127,1.0
38,41,40,50,65,65,299,0.4108527131782946,90,85,75,115,100,115,580,0.9381443298969072,1.0
40,20,30,40,80,55,265,0.22764227642276422,35,35,35,35,35,35,210,0.13385826771653545,1.0
40,55,30,30,30,60,245,0.43548387096774194,100,100,125,110,50,50,535,0.384,2.0
30,45,55,70,55,85,340,0.5633802816901409,70,70,115,130,90,60,535,0.5338983050847458,1.0
80,185,115,40,105,75,600,0.6230769230769231,50,50,95,40,50,35,320,0.20279720279720279,1.0
65,136,94,54,96,135,580,0.9612403100775194,35,40,100,90,55,35,355,0.1796875,1.0
73,76,75,81,100,100,505,0.8110236220472441,35,85,45,35,35,75,310,0.6492537313432836,1.0
45,60,32,50,32,76,295,0.5925925925925926,78,81,71,74,69,126,499,0.9090909090909091,2.0
50,65,85,35,35,55,325,0.32575757575757575,65,155,120,65,90,105,600,0.8677685950413223,2.0
60,85,69,60,69,77,420,0.518796992481203,85,135,130,60,80,25,515,0.40540540540540543,0.5
80,52,50,90,50,89,411,0.6666666666666666,55,75,50,40,40,80,340,0.6302521008403361,0.5
74,108,133,83,65,32,495,0.32142857142857145,50,150,50,150,50,150,600,0.9339622641509434,1.0
45,22,60,27,30,29,213,0.07518796992481203,91,134,95,100,100,80,600,0.6304347826086957,0.5
80,135,130,95,90,70,600,0.5181818181818182,116,55,85,107,95,29,487,0.06818181818181818,0.5
50,105,79,35,110,76,455,0.6214285714285714,61,84,65,70,70,70,420,0.5,1.0
30,40,70,70,25,60,295,0.41353383458646614,39,52,43,60,50,65,309,0.5041322314049587,2.0
40,40,50,30,30,30,220,0.0873015873015873,45,30,40,105,50,20,290,0.031007751937984496,1.0
75,85,200,55,65,30,510,0.16778523489932887,45,100,135,65,135,45,525,0.29411764705882354,1.0
60,25,35,70,80,60,330,0.3076923076923077,45,60,40,70,50,45,310,0.2846715328467153,1.0
45,75,60,40,30,50,300,0.304,79,115,70,125,80,111,580,0.8468468468468469,1.0
68,125,65,65,115,80,518,0.6277372262773723,70,85,140,85,70,20,470,0.272,1.0
75,95,67,125,95,83,540,0.7117117117117117,50,47,50,57,50,65,319,0.463768115942029,2.0
100,50,50,76,96,70,442,0.5,78,92,75,74,63,118,500,0.8842975206611571,2.0
80,85,95,30,30,25,345,0.2857142857142857,101,72,72,99,89,29,462,0.1937984496124031,1.0
35,64,85,74,55,32,345,0.19827586206896552,75,100,66,60,66,115,482,0.918918918918919,1.0
70,80,65,90,65,85,455,0.578125,35,64,85,74,55,32,345,0.19827586206896552,1.0
65,95,100,60,50,50,420,0.34959349593495936,68,75,53,83,113,60,452,0.45384615384615384,2.0
70,80,50,35,35,35,305,0.14,65,40,70,80,140,70,465,0.5954198473282443,0.5
60,30,30,36,56,50,262,0.32432432432432434,75,125,230,55,95,30,610,0.3448275862068966,0.25
91,72,90,129,90,108,580,0.8925619834710744,70,120,100,145,105,20,560,0.2824427480916031,4.0
90,70,80,70,95,70,475,0.5190839694656488,79,85,60,55,60,71,410,0.60431654676259,0.25
75,123,67,95,85,95,540,0.7642276422764228,55,65,35,60,30,85,330,0.6126126126126126,2.0
70,94,50,94,50,66,424,0.48148148148148145,60,60,50,40,50,75,335,0.5882352941176471,4.0
64,165,75,93,83,75,555,0.6587301587301587,35,35,40,35,55,50,250,0.40336134453781514,1.0
100,100,100,100,100,100,600,0.8345864661654135,40,50,90,30,55,65,330,0.44680851063829785,0.5
44,50,91,24,86,10,305,0.1981981981981982,70,70,40,60,40,60,340,0.4247787610619469,0.5
40,45,65,100,120,90,460,0.5588235294117647,65,90,122,58,75,84,494,0.71875,1.0
95,70,73,95,90,60,483,0.3983739837398374,150,160,100,95,65,100,670,0.8866666666666667,1.0
20,40,90,30,90,25,295,0.11363636363636363,80,80,80,80,80,80,480,0.6015037593984962,1.0
103,93,67,71,61,84,479,0.7142857142857143,55,70,55,40,55,85,360,0.7073170731707317,1.0
83,80,80,135,80,121,579,0.9444444444444444,84,71,43,71,43,48,360,0.25874125874125875,1.0
86,92,88,68,75,73,482,0.6835443037974683,75,75,75,125,95,40,485,0.15671641791044777,1.0
92,105,90,125,90,98,600,0.8217054263565892,60,90,55,90,80,110,485,0.8677685950413223,1.0
80,160,80,130,80,100,630,0.8455284552845529,45,60,30,80,50,65,330,0.4603174603174603,1.0
77,85,51,55,51,65,384,0.5163934426229508,55,45,50,45,65,80,340,0.5546218487394958,1.0
75,95,95,95,95,85,540,0.6470588235294118,50,180,20,180,20,150,600,0.9029850746268657,1.0
80,185,115,40,105,75,600,0.6230769230769231,83,80,80,135,80,121,579,0.9444444444444444,0.5
75,38,38,56,56,67,330,0.5263157894736842,100,100,100,100,100,100,600,0.8758169934640523,1.0
65,75,70,95,70,95,470,0.7272727272727273,90,70,80,70,95,70,475,0.5190839694656488,1.0
65,125,100,55,70,85,500,0.6532258064516129,50,65,107,105,107,86,520,0.7313432835820896,2.0
44,58,44,58,44,61,309,0.41964285714285715,88,107,122,74,75,64,530,0.4596774193548387,2.0
45,55,45,65,45,75,330,0.5692307692307692,110,135,60,50,65,88,508,0.7744360902255639,0.5
105,140,95,55,65,45,505,0.3,80,185,115,40,105,75,600,0.6230769230769231,0.5
75,103,80,70,80,92,500,0.7933884297520661,30,42,118,42,88,30,350,0.112,0.5
45,60,32,50,32,76,295,0.5925925925925926,60,105,60,120,60,105,510,0.8849557522123894,1.0
90,75,85,115,90,55,510,0.3445378151260504,40,35,30,120,70,105,400,0.6692307692307692,1.0
67,89,116,79,116,33,500,0.2624113475177305,70,130,100,55,80,65,500,0.608,0.25
80,70,65,80,120,100,515,0.8034188034188035,82,80,86,85,75,72,480,0.6183206106870229,2.0
95,109,105,75,85,56,525,0.34513274336283184,125,58,58,76,76,67,460,0.515625,4.0
75,95,95,95,95,85,540,0.6470588235294118,82,80,86,85,75,72,480,0.6183206106870229,0.0
30,80,90,55,45,55,355,0.4295774647887324,60,55,90,145,90,80,520,0.6071428571428571,4.0
80,100,200,50,100,50,580,0.3472222222222222,75,90,50,110,80,95,500,0.7985611510791367,2.0
85,105,85,40,50,40,405,0.211864406779661,170,90,45,90,45,60,500,0.427536231884058,1.0
70,77,60,97,60,108,472,0.8394160583941606,40,45,35,40,40,90,290,0.65,1.0
95,117,184,44,46,28,514,0.2975206611570248,50,70,50,50,50,40,310,0.16296296296296298,0.5
85,56,77,50,77,78,423,0.53125,105,150,90,150,90,95,680,0.8285714285714286,0.0
46,57,40,40,40,50,273,0.25,20,10,55,15,20,80,200,0.17985611510791366,1.0
60,62,63,80,80,60,405,0.38016528925619836,72,58,80,103,80,97,490,0.7171052631578947,0.5
126,131,95,131,98,99,680,0.8294573643410853,73,100,60,100,60,65,458,0.42657342657342656,0.5
90,100,90,125,85,90,580,0.7352941176470589,65,83,57,95,85,105,490,0.8914728682170543,0.5
60,50,70,80,80,140,480,0.8449612403100775,78,92,75,74,63,118,500,0.8842975206611571,2.0
100,100,80,60,60,50,450,0.3050847457627119,95,125,79,60,100,81,540,0.6165413533834586,0.0
70,120,65,45,85,125,510,0.9747899159663865,55,81,60,50,70,97,413,0.7214285714285714,1.0
76,104,71,104,71,108,534,0.912751677852349,75,100,66,60,66,115,482,0.918918918918919,2.0
45,80,100,35,37,28,325,0.3125,75,38,38,56,56,67,330,0.5263157894736842,0.25
85,50,95,120,115,80,545,0.5793650793650794,80,100,70,50,60,45,405,0.25806451612903225,4.0
30,45,59,30,39,57,260,0.2803030303030303,60,50,50,60,70,50,340,0.28346456692913385,4.0
35,46,34,35,45,20,215,0.072,76,147,90,60,70,97,540,0.8267716535433071,1.0
65,110,130,60,65,95,525,0.8278145695364238,55,40,85,80,105,40,405,0.23622047244094488,0.5
100,100,100,100,100,100,600,0.831858407079646,55,81,60,50,70,97,413,0.7214285714285714,1.0
62,73,55,56,52,84,382,0.7244094488188977,60,55,50,40,55,45,305,0.22377622377622378,4.0
92,105,90,125,90,98,600,0.8217054263565892,55,20,35,20,45,75,250,0.37681159420289856,1.0
30,30,42,30,42,70,244,0.4230769230769231,35,55,40,50,50,90,320,0.6838235294117647,0.5
50,48,43,46,41,60,288,0.47297297297297297,83,106,65,86,65,85,490,0.6640625,2.0
70,75,60,105,60,105,475,0.88,60,79,105,59,85,36,424,0.17054263565891473,0.0
105,105,75,65,100,50,500,0.37593984962406013,60,70,65,125,105,90,515,0.6911764705882353,1.0
45,50,43,40,38,62,278,0.40441176470588236,150,160,100,95,65,100,670,0.8866666666666667,1.0
40,55,99,40,79,47,360,0.26262626262626265,86,92,88,68,75,73,482,0.6835443037974683,4.0
50,65,107,105,107,86,520,0.7272727272727273,69,55,45,55,55,15,294,0.11666666666666667,1.0
95,110,80,70,80,50,485,0.37209302325581395,130,85,80,85,95,60,535,0.43884892086330934,0.25
60,45,70,45,90,95,405,0.7304964539007093,25,35,70,95,55,45,325,0.16783216783216784,0.5
95,145,130,120,90,120,700,0.9398496240601504,65,75,90,97,123,44,494,0.1987179487179487,2.0
100,77,77,128,128,90,600,0.6901408450704225,65,80,140,40,70,70,465,0.5223880597014925,0.25
70,84,70,65,70,51,410,0.2949640287769784,60,40,60,95,60,55,370,0.4222222222222222,4.0
65,45,55,45,70,45,325,0.24369747899159663,45,60,40,70,50,45,310,0.2846715328467153,2.0
58,109,112,48,48,109,484,0.8805970149253731,70,85,65,105,85,120,530,0.9262295081967213,2.0
82,80,86,85,75,72,480,0.6183206106870229,40,55,30,30,30,60,245,0.43548387096774194,1.0
53,51,53,61,56,40,314,0.14285714285714285,1,90,45,30,30,40,236,0.33064516129032256,1.0
100,77,77,128,128,90,600,0.6901408450704225,65,80,140,40,70,70,465,0.5223880597014925,0.25
65,40,50,125,60,30,370,0.07258064516129033,74,100,72,90,72,46,454,0.24561403508771928,1.0
55,65,35,60,30,85,330,0.6126126126126126,126,131,95,131,98,99,680,0.8102189781021898,1.0
55,85,55,50,55,60,360,0.4233576642335766,100,100,100,100,100,100,600,0.8345864661654135,8.0
75,75,75,125,95,40,485,0.15671641791044777,80,125,75,40,95,85,500,0.6911764705882353,1.0
85,135,130,60,80,25,515,0.40540540540540543,80,80,80,55,55,90,440,0.6417910447761194,1.0
67,89,116,79,116,33,500,0.2624113475177305,45,60,45,25,45,55,275,0.29,1.0
95,70,73,95,90,60,483,0.3983739837398374,70,95,125,65,75,45,475,0.33613445378151263,1.0
60,75,85,100,85,115,520,0.8992248062015504,55,81,60,50,70,97,413,0.7214285714285714,1.0
75,69,72,114,100,104,534,0.8253968253968254,66,41,77,61,87,23,355,0.12096774193548387,1.0
60,80,110,50,80,45,425,0.2833333333333333,72,95,67,103,71,122,530,0.9606299212598425,1.0
40,50,90,30,55,65,330,0.44680851063829785,60,40,60,40,60,35,295,0.18055555555555555,4.0
55,55,50,45,65,55,325,0.37373737373737376,75,110,110,110,105,80,590,0.656934306569343,1.0
45,75,60,40,30,50,300,0.304,55,130,115,50,50,75,475,0.5982142857142857,1.0
130,65,60,110,95,65,525,0.5227272727272727,76,25,45,67,55,24,292,0.0390625,1.0
88,107,122,74,75,64,530,0.4596774193548387,39,52,43,60,50,65,309,0.5041322314049587,0.5
60,100,115,70,85,90,520,0.7557251908396947,55,66,44,44,56,85,350,0.6888888888888889,1.0
68,165,95,65,115,110,618,0.8615384615384616,85,60,65,135,105,100,550,0.7518248175182481,0.5
30,80,90,55,45,55,355,0.4295774647887324,79,103,120,135,115,78,630,0.5763888888888888,0.5
55,40,50,65,85,40,335,0.3181818181818182,50,65,90,35,35,15,290,0.14678899082568808,1.0
130,85,80,85,95,60,535,0.43884892086330934,50,50,95,40,50,35,320,0.20279720279720279,4.0
57,80,91,80,87,75,470,0.5737704918032787,110,78,73,76,71,60,468,0.3333333333333333,0.5
75,55,70,55,95,110,460,0.8444444444444444,75,80,60,65,90,102,472,0.8625954198473282,1.0
75,65,55,65,55,69,384,0.43548387096774194,80,70,70,90,100,70,480,0.5609756097560976,0.125
100,150,90,180,160,90,770,0.7348484848484849,80,95,82,60,82,75,474,0.6,1.0
125,58,58,76,76,67,460,0.515625,50,35,55,25,25,15,205,0.05263157894736842,1.0
74,108,133,83,65,32,495,0.32142857142857145,70,150,140,65,100,75,600,0.55,1.0
80,80,50,40,50,25,325,0.176056338028169,36,50,50,65,60,44,305,0.16363636363636364,1.0
59,110,150,45,49,35,448,0.3333333333333333,35,60,44,40,54,55,288,0.366412213740458,1.0
105,130,120,45,45,40,485,0.4444444444444444,66,65,48,62,57,52,350,0.36220472440944884,0.5
65,90,50,85,45,55,390,0.371900826446281,45,75,37,70,55,83,365,0.6183206106870229,0.5
61,72,57,55,55,65,365,0.3984375,65,95,75,55,55,85,430,0.6933333333333334,0.5
65,90,40,45,80,75,395,0.625,55,70,55,40,55,85,360,0.7073170731707317,1.0
78,130,111,130,85,100,634,0.8561151079136691,165,75,80,40,45,65,470,0.5151515151515151,0.5
90,95,105,165,110,45,610,0.2890625,120,100,85,30,85,45,465,0.22448979591836735,1.0
65,125,60,95,60,105,510,0.9236641221374046,40,65,95,60,45,35,340,0.13986013986013987,0.5
50,150,50,150,50,150,600,0.9339622641509434,60,90,70,60,120,40,440,0.27419354838709675,1.0
55,45,45,25,25,15,210,0.048,60,62,80,63,80,60,405,0.4336283185840708,0.25
100,100,100,100,100,100,600,0.8758169934640523,105,95,75,85,75,74,509,0.5714285714285714,1.0
60,80,50,50,50,40,330,0.23853211009174313,64,88,50,88,50,106,446,0.9111111111111111,1.0
120,120,120,120,120,120,720,0.9344262295081968,50,100,150,100,150,50,600,0.37142857142857144,0.5
75,69,72,114,100,104,534,0.8253968253968254,100,123,75,57,75,80,510,0.6923076923076923,1.0
100,73,83,73,83,55,467,0.371900826446281,50,70,100,40,40,30,330,0.2222222222222222,0.0
65,125,100,55,70,85,500,0.6532258064516129,74,94,131,54,116,20,489,0.4485294117647059,1.0
70,120,65,45,85,125,510,0.9747899159663865,60,80,95,70,85,50,440,0.2231404958677686,0.5
250,5,5,35,105,50,450,0.15306122448979592,60,40,60,40,60,35,295,0.18055555555555555,1.0
101,72,72,99,89,29,462,0.1937984496124031,44,38,33,61,43,70,289,0.5267857142857143,1.0
63,120,85,90,55,55,468,0.2809917355371901,80,52,50,90,50,89,411,0.6666666666666666,1.0
67,58,57,81,67,101,431,0.8790322580645161,55,45,50,45,65,80,340,0.5546218487394958,1.0
74,108,133,83,65,32,495,0.32142857142857145,50,48,43,46,41,60,288,0.47297297297297297,0.5
56,61,65,48,45,38,313,0.17567567567567569,50,65,45,85,65,95,405,0.7238095238095238,0.5
40,30,35,45,40,55,245,0.31496062992125984,75,100,95,40,70,110,490,0.8717948717948718,1.0
110,65,75,125,85,30,490,0.15,45,75,37,70,55,83,365,0.6183206106870229,1.0
75,95,125,45,75,95,510,0.8257575757575758,50,50,150,50,150,50,500,0.2571428571428571,1.0
65,47,55,73,75,85,400,0.65,37,25,41,25,41,25,194,0.08870967741935484,1.0
70,92,65,80,55,98,460,0.8090909090909091,45,65,34,40,34,45,263,0.2589928057553957,1.0
58,70,45,40,45,42,300,0.25925925925925924,57,24,86,24,86,23,300,0.12727272727272726,1.0
85,80,90,105,95,60,515,0.49074074074074076,45,60,40,70,50,45,310,0.2846715328467153,1.0
100,73,83,73,83,55,467,0.371900826446281,55,70,55,40,55,85,360,0.7073170731707317,1.0
60,80,50,40,40,30,300,0.15328467153284672,50,50,40,50,40,64,294,0.45588235294117646,1.0
80,105,105,105,105,80,580,0.5939849624060151,67,57,55,77,55,114,425,0.8879310344827587,0.5
25,35,70,95,55,45,325,0.16783216783216784,50,85,55,65,65,90,410,0.7478260869565218,0.5
45,85,70,40,40,60,340,0.5229357798165137,55,35,50,55,110,85,390,0.6277372262773723,1.0
80,80,80,80,80,80,480,0.5606060606060606,95,60,79,100,125,81,540,0.6201550387596899,0.5
75,69,72,114,100,104,534,0.8253968253968254,90,50,34,60,44,70,348,0.6283185840707964,1.0
80,160,80,130,80,100,630,0.8455284552845529,170,90,45,90,45,60,500,0.427536231884058,0.5
100,150,110,95,110,70,635,0.5923076923076923,60,50,150,50,150,60,520,0.5206611570247934,2.0
75,95,60,65,60,115,470,0.8778625954198473,100,103,75,120,75,127,600,0.940677966101695,1.0
70,55,75,45,65,60,370,0.45901639344262296,100,100,100,100,100,100,600,0.8805970149253731,1.0
110,123,65,100,65,65,528,0.5217391304347826,60,55,50,40,55,45,305,0.22377622377622378,0.5
40,65,40,80,40,65,330,0.5038167938931297,150,160,100,95,65,100,670,0.8866666666666667,1.0
75,95,122,58,75,69,494,0.5725806451612904,40,65,40,80,40,65,330,0.5038167938931297,0.5
75,100,66,60,66,115,482,0.918918918918919,40,65,40,80,40,65,330,0.5038167938931297,1.0
108,100,121,81,95,95,600,0.7476635514018691,95,23,48,23,48,23,260,0.046153846153846156,1.0
55,70,45,70,50,60,350,0.45,65,95,100,60,50,50,420,0.34959349593495936,0.5
65,76,84,54,96,105,480,0.9008264462809917,70,83,50,37,50,60,350,0.3360655737704918,1.0
40,80,100,30,30,20,300,0.11851851851851852,85,50,95,120,115,80,545,0.5793650793650794,0.0
70,110,75,145,85,145,630,0.9444444444444444,85,60,65,135,105,100,550,0.7518248175182481,0.25
108,170,115,120,95,92,700,0.7083333333333334,75,103,80,70,80,92,500,0.7933884297520661,0.25
75,95,60,65,60,115,470,0.8778625954198473,170,90,45,90,45,60,500,0.427536231884058,1.0
60,60,60,85,85,85,435,0.631578947368421,60,85,42,85,42,91,405,0.8227848101265823,0.5
95,23,48,23,48,23,260,0.046153846153846156,165,75,80,40,45,65,470,0.5151515151515151,1.0
72,85,70,65,70,58,420,0.41304347826086957,60,60,75,60,75,80,410,0.7321428571428571,1.0
78,70,61,50,61,100,420,0.8145161290322581,60,85,60,85,60,55,405,0.3673469387755102,1.0
95,117,80,65,70,92,519,0.8409090909090909,60,80,95,70,85,50,440,0.2231404958677686,2.0
100,128,90,77,77,128,600,0.959349593495935,70,75,80,135,80,135,575,0.917910447761194,1.0
100,90,130,45,65,55,485,0.4253731343283582,100,77,77,128,128,90,600,0.6901408450704225,1.0
89,125,90,115,80,101,600,0.8725490196078431,110,65,75,125,85,30,490,0.15,1.0
55,68,64,45,55,31,318,0.11666666666666667,60,50,70,50,90,65,385,0.39568345323741005,0.25
60,40,50,75,85,95,405,0.6044776119402985,65,80,140,40,70,70,465,0.5223880597014925,2.0
55,75,60,75,60,103,428,0.7982456140350878,70,43,53,43,53,40,302,0.19090909090909092,1.0
44,38,39,61,79,42,303,0.2251655629139073,74,108,133,83,65,32,495,0.32142857142857145,1.0
67,89,116,79,116,33,500,0.2624113475177305,110,135,60,50,65,88,508,0.7744360902255639,0.5
108,170,115,120,95,92,700,0.7083333333333334,65,83,57,95,85,105,490,0.8914728682170543,2.0
45,75,60,40,30,50,300,0.304,78,130,111,130,85,100,634,0.8561151079136691,2.0
75,125,70,125,70,115,580,0.9037037037037037,75,70,90,70,105,80,490,0.656,1.0
45,49,49,65,65,45,318,0.2781954887218045,75,38,38,56,56,67,330,0.5263157894736842,2.0
72,105,115,54,86,68,500,0.5149253731343284,50,70,160,70,160,90,600,0.7417218543046358,1.0
80,80,80,80,80,80,480,0.6015037593984962,95,110,95,40,95,55,490,0.40336134453781514,1.0
70,45,48,60,65,35,323,0.15748031496062992,105,140,95,55,65,45,505,0.3,2.0
70,40,50,55,50,25,290,0.061068702290076333,91,72,90,129,90,108,580,0.8620689655172413,0.25
65,90,122,58,75,84,494,0.71875,30,30,42,30,42,70,244,0.4230769230769231,0.25
70,60,70,87,78,85,450,0.6228070175438597,40,40,40,70,40,20,250,0.032520325203252036,0.5
70,80,65,90,65,85,455,0.578125,100,100,100,100,100,100,600,0.8778625954198473,0.5
120,70,120,75,130,85,600,0.6694915254237288,92,105,90,125,90,98,600,0.8217054263565892,0.0
40,80,100,30,30,20,300,0.11851851851851852,30,45,135,45,90,30,375,0.09285714285714286,2.0
80,105,105,105,105,80,580,0.5939849624060151,65,90,120,85,70,60,490,0.43410852713178294,2.0
106,110,90,154,90,130,680,0.926829268292683,60,45,50,90,80,70,395,0.625,1.0
58,89,77,45,45,48,362,0.3177570093457944,80,45,65,90,110,80,470,0.5462962962962963,1.0
110,135,60,50,65,88,508,0.7744360902255639,70,43,53,43,53,40,302,0.19090909090909092,2.0
60,85,60,50,50,125,430,0.9090909090909091,75,125,70,125,70,115,580,0.9037037037037037,1.0
40,55,70,45,60,30,300,0.10619469026548672,250,5,5,35,105,50,450,0.15306122448979592,1.0
65,50,35,115,95,95,455,0.7333333333333333,77,59,50,67,63,46,362,0.23140495867768596,0.5
52,65,55,58,62,60,352,0.4482758620689655,45,75,60,40,30,50,300,0.304,1.0
55,55,55,85,55,30,335,0.1320754716981132,85,90,80,70,80,130,535,0.9262295081967213,2.0
95,85,85,65,65,35,430,0.2571428571428571,250,5,5,35,105,50,450,0.15306122448979592,1.0
91,129,90,72,90,108,580,0.8536585365853658,10,55,25,35,45,95,265,0.5396825396825397,0.5
60,79,105,59,85,36,424,0.17054263565891473,40,45,65,100,120,90,460,0.5588235294117647,1.0
80,120,130,55,65,45,495,0.37037037037037035,60,85,60,50,50,125,430,0.9090909090909091,0.0
50,85,40,85,40,35,335,0.1746031746031746,60,40,60,95,60,55,370,0.4222222222222222,0.5
50,95,90,95,90,180,600,0.9172413793103448,60,25,35,70,80,60,330,0.3076923076923077,0.5
55,50,65,175,95,150,590,0.7818181818181819,65,75,70,95,70,95,470,0.7272727272727273,0.5
55,63,90,50,80,42,380,0.21138211382113822,31,45,90,30,30,40,266,0.21929824561403508,1.0
100,73,83,73,83,55,467,0.371900826446281,75,110,110,110,105,80,590,0.656934306569343,2.0
38,36,38,32,36,57,237,0.3893805309734513,60,100,89,55,69,112,485,0.9298245614035088,1.0
75,80,70,65,75,90,455,0.7578125,55,45,50,45,65,80,340,0.5546218487394958,4.0
90,130,80,65,85,55,505,0.4396551724137931,78,84,78,109,85,100,534,0.8646616541353384,0.5
70,110,80,55,80,105,500,0.8794326241134752,70,140,70,110,65,105,560,0.95,2.0
49,55,42,42,37,85,310,0.6068376068376068,50,105,125,55,95,50,480,0.375886524822695,0.5
40,65,95,60,45,35,340,0.13986013986013987,45,50,43,40,38,62,278,0.40441176470588236,1.0
60,60,60,85,85,85,435,0.631578947368421,65,130,60,95,110,65,525,0.5303030303030303,1.0
59,45,40,35,40,31,250,0.14285714285714285,90,85,75,115,100,115,580,0.9381443298969072,1.0
55,75,85,25,25,15,280,0.1875,60,62,80,63,80,60,405,0.4336283185840708,1.0
91,72,90,129,90,108,580,0.8620689655172413,70,115,60,115,60,55,475,0.4647887323943662,1.0
85,105,55,85,50,115,495,0.9032258064516129,130,85,80,85,95,60,535,0.43884892086330934,0.5
80,160,80,130,80,100,630,0.8455284552845529,60,69,95,69,95,36,424,0.2608695652173913,4.0
75,125,70,125,70,115,580,0.9037037037037037,40,60,30,31,31,70,262,0.4492753623188406,1.0
80,115,80,65,55,93,488,0.7846153846153846,70,94,50,94,50,66,424,0.48148148148148145,2.0
50,50,120,80,80,30,410,0.07258064516129033,90,100,60,90,60,80,480,0.6422764227642277,2.0
99,68,83,72,87,51,460,0.417910447761194,45,55,39,35,39,42,255,0.18518518518518517,1.0
130,85,80,85,95,60,535,0.43884892086330934,45,35,50,70,50,30,280,0.15753424657534246,1.0
50,40,85,40,65,25,305,0.08870967741935484,74,94,131,54,116,20,489,0.4485294117647059,1.0
80,80,50,40,50,25,325,0.176056338028169,70,130,100,55,80,65,500,0.608,0.0
90,100,90,125,85,90,580,0.7352941176470589,85,115,80,105,80,50,515,0.3063063063063063,0.5
109,66,84,81,99,32,471,0.2013888888888889,90,132,105,132,105,30,594,0.4246575342465753,0.25
70,80,50,35,35,35,305,0.14,60,30,30,36,56,50,262,0.32432432432432434,1.0
49,49,56,49,61,66,330,0.5190839694656488,73,115,60,60,60,90,458,0.6694915254237288,1.0
60,50,70,80,80,140,480,0.8449612403100775,100,100,90,150,140,90,670,0.71875,2.0
85,73,70,73,115,67,483,0.5126050420168067,60,55,50,40,55,45,305,0.22377622377622378,2.0
50,95,180,85,45,70,525,0.5298507462686567,20,10,55,15,20,80,200,0.17985611510791366,0.25
85,80,70,135,75,90,535,0.7006802721088435,75,80,85,110,90,50,490,0.3548387096774194,1.0
70,90,45,15,45,50,315,0.3629032258064516,58,64,58,80,65,80,405,0.609271523178808,0.5
30,65,100,45,25,40,305,0.1891891891891892,60,130,80,60,60,70,460,0.5153846153846153,0.5
30,35,30,100,35,80,310,0.4765625,65,60,70,85,75,40,395,0.1796875,0.0
75,75,95,75,95,113,528,0.9015151515151515,50,75,70,35,70,48,348,0.29357798165137616,1.0
85,97,66,105,66,65,484,0.47107438016528924,85,105,85,40,50,40,405,0.211864406779661,1.0
103,60,126,80,126,50,545,0.36363636363636365,80,80,90,110,130,110,600,0.8721804511278195,2.0
55,75,85,25,25,15,280,0.1875,60,80,50,40,40,30,300,0.15328467153284672,1.0
35,55,35,30,30,35,220,0.23684210526315788,50,85,125,85,115,20,480,0.4306569343065693,1.0
70,40,50,55,50,25,290,0.061068702290076333,80,70,40,100,60,145,495,0.921875,1.0
60,40,60,40,60,35,295,0.18055555555555555,50,25,28,45,55,15,218,0.0625,1.0
105,30,105,140,105,55,540,0.3524590163934426,86,76,86,116,56,95,515,0.7982456140350878,2.0
35,35,35,35,35,35,210,0.13385826771653545,65,80,65,35,65,60,370,0.38405797101449274,2.0
95,65,65,110,130,60,525,0.4016393442622951,74,48,76,83,81,104,466,0.7913043478260869,1.0
42,52,67,39,56,50,306,0.2868217054263566,78,84,78,109,85,100,534,0.8646616541353384,8.0
80,120,130,55,65,45,495,0.37037037037037035,95,65,65,110,130,60,525,0.4016393442622951,1.0
115,115,85,90,75,100,580,0.8134328358208955,83,80,75,70,70,101,479,0.8615384615384616,1.0
80,82,100,83,100,80,525,0.6821705426356589,53,51,53,61,56,40,314,0.14285714285714285,2.0
100,50,50,76,96,70,442,0.5,115,140,130,55,55,40,535,0.4519230769230769,0.25
60,62,63,80,80,60,405,0.38016528925619836,60,100,89,55,69,112,485,0.9298245614035088,0.125
60,100,85,80,85,100,510,0.7007874015748031,65,65,60,130,95,110,525,0.823943661971831,0.25
80,82,83,100,100,80,525,0.6742424242424242,73,76,75,81,100,100,505,0.8110236220472441,0.5
55,75,50,40,40,80,340,0.6302521008403361,70,80,50,35,35,35,305,0.14,2.0
75,80,85,110,90,50,490,0.3548387096774194,85,50,95,120,115,80,545,0.5793650793650794,1.0
65,150,40,15,80,145,495,0.9663865546218487,82,80,86,85,75,72,480,0.6183206106870229,1.0
70,110,80,55,80,105,500,0.8794326241134752,64,88,50,88,50,106,446,0.9111111111111111,2.0
60,70,50,100,50,65,395,0.5217391304347826,62,50,58,73,54,72,369,0.4435483870967742,0.5
50,70,160,70,160,90,600,0.7417218543046358,90,75,85,115,90,55,510,0.3445378151260504,1.0
45,30,50,65,50,45,285,0.13821138211382114,80,70,70,90,100,70,480,0.5609756097560976,1.0
40,29,45,29,45,36,224,0.14634146341463414,50,48,43,46,41,60,288,0.47297297297297297,1.0
79,105,70,145,80,101,580,0.8608695652173913,50,70,160,70,160,90,600,0.7417218543046358,1.0
90,92,87,75,85,76,505,0.5409836065573771,60,70,65,125,105,90,515,0.6911764705882353,1.0
75,125,70,125,70,115,580,0.9037037037037037,95,65,110,60,130,65,525,0.5275590551181102,0.0
95,65,110,60,130,65,525,0.5275590551181102,95,125,79,60,100,81,540,0.6165413533834586,1.0
64,88,50,88,50,106,446,0.9111111111111111,65,83,57,95,85,105,490,0.8914728682170543,1.0
65,45,55,45,70,45,325,0.24369747899159663,20,15,20,10,55,80,200,0.2682926829268293,0.5
70,50,30,95,135,105,485,0.8040540540540541,60,85,60,85,60,55,405,0.3673469387755102,0.5
65,136,94,54,96,135,580,0.9612403100775194,83,80,75,70,70,101,479,0.8615384615384616,1.0
68,75,53,83,113,60,452,0.45384615384615384,110,65,105,55,95,80,510,0.6258503401360545,1.0
97,165,60,65,50,58,495,0.3902439024390244,65,75,90,97,123,44,494,0.1987179487179487,1.0
70,85,70,60,70,50,405,0.28378378378378377,59,74,50,35,50,35,303,0.3125,2.0
68,72,78,38,42,32,330,0.23809523809523808,35,55,40,50,50,90,320,0.6838235294117647,2.0
80,90,80,130,110,110,600,0.856,55,69,85,32,35,28,304,0.09302325581395349,1.0
53,51,53,61,56,40,314,0.14285714285714285,100,150,110,95,110,70,635,0.5923076923076923,1.0
50,20,55,25,25,30,205,0.09774436090225563,75,69,72,114,100,104,534,0.8253968253968254,1.0
55,55,85,65,85,35,380,0.2014388489208633,70,70,70,70,70,70,420,0.5289256198347108,1.0
40,65,40,80,40,65,330,0.5038167938931297,67,89,116,79,116,33,500,0.2624113475177305,2.0
55,95,55,35,75,115,430,0.9380530973451328,70,20,50,20,50,40,250,0.1557377049180328,0.25
95,70,73,95,90,60,483,0.3983739837398374,55,50,40,40,40,75,300,0.5945945945945946,1.0
60,69,95,69,95,36,424,0.2608695652173913,75,110,110,110,105,80,590,0.656934306569343,0.25
70,120,40,95,40,95,460,0.8106060606060606,79,105,70,145,80,101,580,0.8608695652173913,1.0
20,40,90,30,90,25,295,0.11363636363636363,60,82,45,45,45,74,351,0.5752212389380531,0.5
70,120,100,145,105,20,560,0.2824427480916031,41,64,45,50,50,50,300,0.36752136752136755,0.5
45,53,70,40,60,42,310,0.25735294117647056,88,107,122,74,75,64,530,0.4596774193548387,0.5
41,56,40,62,44,71,314,0.568,70,75,60,105,60,105,475,0.88,1.0
64,78,52,78,52,81,405,0.6422764227642277,110,123,65,100,65,65,528,0.5217391304347826,0.5
45,90,20,65,20,65,305,0.5116279069767442,85,135,130,60,80,25,515,0.40540540540540543,2.0
60,25,35,70,80,60,330,0.3076923076923077,45,55,45,65,45,75,330,0.5692307692307692,1.0
50,160,110,160,110,110,700,0.8854961832061069,70,110,75,145,85,145,630,0.9444444444444444,2.0
75,65,55,65,55,69,384,0.43548387096774194,52,65,50,45,50,38,300,0.27419354838709675,0.5
85,110,90,45,90,80,500,0.6206896551724138,10,55,25,35,45,95,265,0.5396825396825397,1.0
60,150,50,150,50,60,520,0.5,40,55,80,35,60,30,300,0.15037593984962405,1.0
80,160,80,130,80,100,630,0.8455284552845529,60,45,50,90,80,70,395,0.625,0.5
60,60,60,105,105,105,495,0.848,45,100,45,45,45,10,290,0.2949640287769784,1.0
74,108,133,83,65,32,495,0.32142857142857145,74,48,76,83,81,104,466,0.7913043478260869,1.0
65,47,55,73,75,85,400,0.65,81,102,77,85,75,85,505,0.5642857142857143,0.5
79,105,70,145,80,101,580,0.8608695652173913,72,85,70,65,70,58,420,0.41304347826086957,0.5
60,105,60,120,60,105,510,0.8849557522123894,20,10,230,10,230,5,505,0.0,1.0
70,110,75,145,85,145,630,0.9444444444444444,60,85,69,60,69,77,420,0.518796992481203,1.0
100,150,140,100,90,90,670,0.7969924812030075,95,65,65,110,130,60,525,0.4016393442622951,1.0
78,84,78,109,85,100,534,0.8646616541353384,65,80,80,59,63,58,405,0.4411764705882353,0.5
60,55,145,75,150,40,525,0.2,55,85,122,58,75,99,494,0.8099173553719008,1.0
70,90,110,60,75,95,500,0.7333333333333333,55,35,50,55,110,85,390,0.6277372262773723,1.0
50,95,90,95,90,180,600,0.9172413793103448,75,95,95,95,95,85,540,0.6470588235294118,1.0
60,60,60,105,105,105,495,0.848,75,80,55,25,35,35,305,0.18666666666666668,1.0
86,81,97,81,107,43,495,0.203125,95,110,80,70,80,50,485,0.37209302325581395,2.0
91,134,95,100,100,80,600,0.6304347826086957,125,120,90,170,100,95,700,0.78125,2.0
100,128,90,77,77,128,600,0.959349593495935,50,53,48,53,48,64,316,0.358974358974359,1.0
30,45,55,70,55,85,340,0.5633802816901409,70,55,65,95,85,70,440,0.5307692307692308,2.0
50,53,48,53,48,64,316,0.46153846153846156,70,55,55,80,60,45,365,0.2222222222222222,1.0
65,75,70,95,70,95,470,0.7272727272727273,60,60,60,60,60,60,360,0.38095238095238093,1.0
65,100,70,80,80,105,500,0.8666666666666667,45,55,45,65,45,75,330,0.5692307692307692,2.0
50,50,77,95,77,91,440,0.5916666666666667,70,70,70,70,70,70,420,0.5289256198347108,0.0
60,48,45,43,90,42,328,0.21897810218978103,62,50,58,73,54,72,369,0.4435483870967742,1.0
46,87,60,30,40,57,320,0.37777777777777777,40,55,30,30,30,85,270,0.688,1.0
116,55,85,107,95,29,487,0.06818181818181818,60,50,50,60,70,50,340,0.28346456692913385,1.0
30,40,70,70,25,60,295,0.41353383458646614,60,55,145,75,150,40,525,0.2,2.0
110,123,65,100,65,65,528,0.5217391304347826,30,35,30,100,35,80,310,0.4765625,0.0
80,135,130,95,90,70,600,0.5181818181818182,55,63,90,50,80,42,380,0.21138211382113822,1.0
79,100,80,110,90,121,580,0.968,100,100,100,100,100,100,600,0.8602941176470589,2.0
45,30,50,65,50,45,285,0.13821138211382114,75,103,80,70,80,92,500,0.7933884297520661,1.0
35,55,40,50,50,90,320,0.6838235294117647,78,65,68,112,154,75,552,0.628099173553719,1.0
45,50,45,115,55,95,405,0.6936936936936937,45,60,32,50,32,76,295,0.5925925925925926,1.0
55,55,55,85,55,30,335,0.1320754716981132,53,51,53,61,56,40,314,0.14285714285714285,1.0
85,60,65,135,105,100,550,0.7518248175182481,45,25,50,25,25,35,205,0.13076923076923078,1.0
80,100,80,80,80,100,520,0.9051724137931034,60,85,69,65,79,80,438,0.576,2.0
65,90,40,45,80,75,395,0.625,86,81,97,81,107,43,495,0.203125,2.0
41,64,45,50,50,50,300,0.36752136752136755,80,100,123,122,120,80,625,0.56,1.0
70,130,100,55,80,65,500,0.608,90,90,85,125,90,100,580,0.768595041322314,0.25
40,45,40,35,35,56,251,0.373015873015873,90,60,70,75,70,45,410,0.23880597014925373,1.0
130,85,80,85,95,60,535,0.43884892086330934,100,120,120,150,100,90,680,0.7880794701986755,0.5
45,55,39,35,39,42,255,0.18518518518518517,79,115,70,125,80,111,580,0.8468468468468469,1.0
85,110,76,65,82,56,474,0.3933333333333333,100,120,120,150,100,90,680,0.7880794701986755,0.25
50,50,95,40,50,35,320,0.20279720279720279,50,85,85,55,55,50,380,0.3902439024390244,2.0
85,105,85,40,50,40,405,0.211864406779661,150,80,44,90,54,80,498,0.625,0.0
70,60,125,115,70,55,495,0.35507246376811596,55,70,55,40,55,85,360,0.7073170731707317,1.0
91,72,90,129,90,108,580,0.8925619834710744,105,30,105,140,105,55,540,0.3524590163934426,1.0
64,115,65,83,63,65,455,0.5323741007194245,55,104,105,94,75,52,485,0.36363636363636365,1.0
50,75,70,35,70,48,348,0.29357798165137616,50,50,150,50,150,50,500,0.2571428571428571,0.5
75,80,60,65,90,102,472,0.8625954198473282,101,72,72,99,89,29,462,0.1937984496124031,1.0
39,52,43,60,50,65,309,0.5041322314049587,75,80,85,110,90,50,490,0.3548387096774194,2.0
78,130,111,130,85,100,634,0.8561151079136691,90,75,75,90,100,70,500,0.5462184873949579,0.5
65,105,60,60,70,95,455,63.0,91,90,72,90,129,108,580,0.896,1.0
65,63,45,45,45,45,308,0.2595419847328244,109,66,84,81,99,32,471,0.2013888888888889,1.0
40,35,30,20,20,50,195,0.23423423423423423,95,23,48,23,48,23,260,0.046153846153846156,2.0
35,64,85,74,55,32,345,0.19827586206896552,45,30,40,105,50,20,290,0.031007751937984496,1.0
56,61,65,48,45,38,313,0.17567567567567569,70,43,53,43,53,40,302,0.19090909090909092,0.5
50,75,75,65,65,50,380,0.4049586776859504,35,46,34,35,45,20,215,0.072,0.0
68,90,65,50,55,82,410,0.6165413533834586,20,10,230,10,230,5,505,0.0,1.0
60,70,105,70,120,75,500,0.5983606557377049,77,120,90,60,90,48,485,0.2785714285714286,1.0
60,30,30,36,56,50,262,0.32432432432432434,88,107,122,74,75,64,530,0.4596774193548387,4.0
78,84,78,109,85,100,534,0.8620689655172413,40,45,65,100,120,90,460,0.5588235294117647,1.0
50,48,43,46,41,60,288,0.47297297297297297,70,85,65,105,85,120,530,0.9262295081967213,0.25
100,150,90,180,160,90,770,0.7348484848484849,100,150,110,95,110,70,635,0.5923076923076923,1.0
85,105,55,85,50,115,495,0.9032258064516129,55,65,35,60,30,85,330,0.6126126126126126,0.5
70,70,115,130,90,60,535,0.5338983050847458,79,85,60,55,60,71,410,0.60431654676259,1.0
54,45,47,75,98,52,371,0.39669421487603307,45,35,50,70,50,30,280,0.15753424657534246,1.0
66,117,70,40,50,67,410,0.4573643410852713,45,49,49,65,65,45,318,0.2781954887218045,1.0
43,70,48,50,60,38,309,0.2391304347826087,70,120,40,95,40,95,460,0.8106060606060606,1.0
130,70,35,70,35,60,400,0.4017857142857143,50,52,48,65,50,55,320,0.33098591549295775,0.5
135,85,40,40,85,5,390,0.6864406779661016,44,50,91,24,86,10,305,0.1981981981981982,0.5
40,55,70,45,60,30,300,0.10619469026548672,40,65,40,80,40,65,330,0.5038167938931297,1.0
60,55,90,145,90,80,520,0.6071428571428571,50,47,50,57,50,65,319,0.463768115942029,2.0
58,64,58,80,65,80,405,0.609271523178808,126,131,95,131,98,99,680,0.8294573643410853,1.0
50,150,50,150,50,150,600,0.9339622641509434,60,45,70,75,85,55,390,0.3008130081300813,0.5
101,72,72,99,89,29,462,0.1937984496124031,70,90,45,15,45,50,315,0.3629032258064516,0.5
70,130,100,55,80,65,500,0.608,45,25,50,25,25,35,205,0.13076923076923078,0.5
50,70,50,50,50,70,340,0.5645161290322581,70,80,65,90,65,85,455,0.578125,1.0
116,55,85,107,95,29,487,0.06818181818181818,50,70,50,50,50,70,340,0.5645161290322581,2.0
86,81,97,81,107,43,495,0.203125,30,40,70,70,25,60,295,0.41353383458646614,2.0
68,125,65,65,115,80,518,0.6277372262773723,68,65,65,125,115,80,518,0.6461538461538462,0.125
95,65,110,60,130,65,525,0.5275590551181102,38,36,38,32,36,57,237,0.3893805309734513,1.0
55,70,45,70,50,60,350,0.45,73,115,60,60,60,90,458,0.6694915254237288,1.0
78,81,71,74,69,126,499,0.9090909090909091,40,50,90,30,55,65,330,0.44680851063829785,4.0
60,82,45,45,45,74,351,0.5752212389380531,85,105,55,85,50,115,495,0.9032258064516129,1.0
160,110,65,65,110,30,540,0.35714285714285715,79,105,70,145,80,101,580,0.8608695652173913,1.0
130,65,60,110,95,65,525,0.5227272727272727,70,120,65,45,85,125,510,0.9747899159663865,1.0
85,110,76,65,82,56,474,0.3933333333333333,30,105,90,25,25,50,325,0.2773722627737226,2.0
170,90,45,90,45,60,500,0.427536231884058,50,53,48,53,48,64,316,0.4076923076923077,0.5
45,40,60,40,75,50,310,0.2926829268292683,60,75,100,55,80,50,420,0.3088235294117647,0.25
80,100,70,60,70,95,475,0.7416666666666667,99,68,83,72,87,51,460,0.417910447761194,0.25
100,100,100,100,100,100,600,0.8758169934640523,80,120,79,95,79,70,523,0.5833333333333334,0.5
105,95,80,40,80,90,490,0.753968253968254,105,30,105,140,105,55,540,0.3524590163934426,1.0
60,60,75,60,75,80,410,0.7321428571428571,80,125,75,40,95,85,500,0.6911764705882353,0.5
40,27,60,37,50,66,280,0.36220472440944884,40,35,30,120,70,105,400,0.6692307692307692,1.0
80,70,70,90,100,70,480,0.5609756097560976,65,95,57,100,85,93,495,0.7441860465116279,1.0
62,73,55,56,52,84,382,0.7244094488188977,35,35,40,35,55,50,250,0.40336134453781514,4.0
70,60,75,110,75,90,480,0.7165354330708661,50,65,107,105,107,86,520,0.6991150442477876,0.5
70,70,115,130,90,60,535,0.5338983050847458,106,110,90,154,90,130,680,0.926829268292683,1.0
60,82,45,45,45,74,351,0.5752212389380531,65,65,65,50,50,90,385,0.72,1.0
95,23,48,23,48,23,260,0.046153846153846156,70,135,105,60,105,20,495,0.5806451612903226,0.5
55,70,55,40,55,85,360,0.7073170731707317,50,75,35,70,30,40,300,0.21296296296296297,1.0
54,45,47,75,98,52,371,0.39669421487603307,30,45,135,45,90,30,375,0.09285714285714286,1.0
71,82,64,64,59,112,452,0.9327731092436975,125,58,58,76,76,67,460,0.515625,1.0
50,105,79,35,110,76,455,0.6214285714285714,45,50,43,40,38,62,278,0.40441176470588236,1.0
50,35,55,25,25,15,205,0.021739130434782608,62,50,58,73,54,72,369,0.4435483870967742,0.5
60,45,70,45,90,95,405,0.7304964539007093,45,75,37,70,55,83,365,0.6183206106870229,1.0
80,160,60,170,130,80,680,0.6180555555555556,70,65,60,90,75,90,450,0.6571428571428571,2.0
65,125,100,60,70,70,490,0.6099290780141844,65,65,60,130,95,110,525,0.823943661971831,2.0
75,89,85,55,65,36,405,0.29545454545454547,82,80,86,85,75,72,480,0.6183206106870229,1.0
60,60,60,105,105,105,495,0.848,40,45,40,62,60,60,307,0.33884297520661155,1.0
55,50,65,175,95,150,590,0.7818181818181819,90,132,105,132,105,30,594,0.4246575342465753,1.0
50,100,150,100,150,50,600,0.37142857142857144,83,106,65,86,65,85,490,0.6640625,0.5
65,90,65,61,61,100,442,0.8373983739837398,50,85,85,55,55,50,380,0.3902439024390244,0.25
95,65,65,110,130,60,525,0.4016393442622951,55,55,85,65,85,35,380,0.2014388489208633,1.0
89,145,90,105,80,91,600,0.8549618320610687,65,65,60,110,95,130,525,0.9253731343283582,1.0
60,65,80,170,95,130,600,0.8625954198473282,1,90,45,30,30,40,236,0.33064516129032256,1.0
35,35,35,35,35,35,210,0.13385826771653545,72,58,80,103,80,97,490,0.7171052631578947,0.25
108,170,115,120,95,92,700,0.7083333333333334,65,95,75,55,55,85,430,0.6933333333333334,2.0
45,85,50,55,50,65,350,0.5076923076923077,64,115,65,83,63,65,455,0.5323741007194245,0.0
55,75,85,25,25,15,280,0.1875,50,50,40,30,30,50,250,0.2781954887218045,1.0
90,120,75,60,60,45,450,0.29411764705882354,40,30,35,45,40,55,245,0.31496062992125984,2.0
83,80,80,135,80,121,579,0.9444444444444444,80,90,80,130,110,110,600,0.856,1.0
90,110,80,100,80,95,555,0.7982456140350878,85,110,76,65,82,56,474,0.3933333333333333,2.0
55,55,45,63,45,45,308,0.25,35,46,34,35,45,20,215,0.072,1.0
160,110,65,65,110,30,540,0.35714285714285715,90,92,75,92,85,60,494,0.49586776859504134,1.0
70,115,60,115,60,55,475,0.4647887323943662,44,38,39,61,79,42,303,0.2251655629139073,0.5
50,75,75,65,65,50,380,0.4049586776859504,80,135,85,70,95,150,615,0.9844961240310077,1.0
50,35,55,25,25,15,205,0.05263157894736842,40,40,35,50,100,70,335,0.5031847133757962,0.5
105,30,105,140,105,55,540,0.3524590163934426,55,35,50,55,110,85,390,0.6277372262773723,2.0
90,92,87,75,85,76,505,0.5409836065573771,43,70,48,50,60,38,309,0.2391304347826087,0.5
50,30,55,65,55,20,275,0.13675213675213677,80,70,40,100,60,145,495,0.921875,2.0
60,90,55,90,80,110,485,0.8677685950413223,40,45,35,40,40,90,290,0.65,1.0
61,90,45,50,50,160,456,0.9230769230769231,60,60,50,40,50,75,335,0.5882352941176471,4.0
73,76,75,81,100,100,505,0.8110236220472441,80,185,115,40,105,75,600,0.6230769230769231,2.0
70,105,105,50,40,20,390,0.33587786259541985,90,100,90,125,85,90,580,0.7352941176470589,4.0
65,100,70,80,80,105,500,0.8666666666666667,30,40,55,40,55,60,280,0.3237410071942446,1.0
62,55,52,109,94,109,481,0.7833333333333333,72,58,80,103,80,97,490,0.7171052631578947,2.0
70,90,45,15,45,50,315,0.3629032258064516,55,45,45,25,25,15,210,0.048,0.5
61,90,45,50,50,160,456,0.9230769230769231,110,135,60,50,65,88,508,0.7744360902255639,0.25
70,70,115,130,90,60,535,0.5338983050847458,100,100,100,100,100,100,600,0.8345864661654135,0.5
67,58,57,81,67,101,431,0.8790322580645161,45,85,50,55,50,65,350,0.5076923076923077,2.0
90,92,87,75,85,76,505,0.5409836065573771,50,65,64,44,48,43,314,0.2196969696969697,1.0
65,70,60,65,65,115,440,0.8583333333333333,30,30,42,30,42,70,244,0.4230769230769231,1.0
50,85,125,85,115,20,480,0.4306569343065693,65,150,60,115,60,115,565,0.935251798561151,0.25
95,155,109,70,130,81,640,0.6788321167883211,60,50,50,60,70,50,340,0.28346456692913385,0.25
65,50,35,115,95,95,455,0.7333333333333333,60,62,63,80,80,60,405,0.38016528925619836,4.0
75,123,67,95,85,95,540,0.7642276422764228,40,50,90,30,55,65,330,0.44680851063829785,1.0
80,82,100,83,100,80,525,0.6821705426356589,100,100,100,100,100,100,600,0.8778625954198473,0.5
84,71,43,71,43,48,360,0.25874125874125875,45,30,50,65,50,45,285,0.13821138211382114,1.0
40,45,40,35,35,56,251,0.373015873015873,55,63,90,50,80,42,380,0.21138211382113822,4.0
35,20,65,40,65,20,245,0.02459016393442623,80,105,65,60,75,130,515,0.9645390070921985,1.0
41,56,40,62,44,71,314,0.568,58,70,45,40,45,42,300,0.25925925925925924,1.0
80,100,123,122,120,80,625,0.56,90,130,80,65,85,55,505,0.4396551724137931,1.0
50,25,28,45,55,15,218,0.0625,126,131,95,131,98,99,680,0.8294573643410853,1.0
40,50,45,70,45,70,320,0.5517241379310345,63,60,55,50,50,71,349,0.5289256198347108,1.0
20,10,55,15,20,80,200,0.17985611510791366,45,85,50,55,50,65,350,0.5076923076923077,1.0
30,45,55,70,55,85,340,0.5633802816901409,55,47,52,40,40,41,275,0.16806722689075632,1.0
37,25,41,25,41,25,194,0.08870967741935484,75,125,100,70,80,45,495,0.33035714285714285,1.0
30,40,70,70,25,60,295,0.41353383458646614,72,105,115,54,86,68,500,0.5149253731343284,1.0
55,55,55,85,55,30,335,0.1320754716981132,71,120,95,120,95,99,600,0.8203125,0.5
50,65,107,105,107,86,520,0.7758620689655172,60,65,80,170,95,130,600,0.8625954198473282,1.0
100,100,125,110,50,50,535,0.384,72,85,70,65,70,58,420,0.41304347826086957,0.5
88,107,122,74,75,64,530,0.4596774193548387,60,60,60,85,85,85,435,0.631578947368421,0.0
64,88,50,88,50,106,446,0.9111111111111111,60,80,110,50,80,45,425,0.2833333333333333,1.0
80,120,70,110,70,80,530,0.6422764227642277,40,65,95,60,45,35,340,0.13986013986013987,0.5
50,65,64,44,48,43,314,0.2196969696969697,125,120,90,170,100,95,700,0.78125,0.5
75,100,66,60,66,115,482,0.918918918918919,170,90,45,90,45,60,500,0.427536231884058,1.0
65,125,100,55,70,85,500,0.6532258064516129,89,124,80,55,80,55,483,0.5714285714285714,0.5
70,90,70,60,60,70,420,0.6390977443609023,40,40,55,40,70,55,300,0.40939597315436244,2.0
83,106,65,86,65,85,490,0.6640625,62,44,50,44,50,55,305,0.3629032258064516,0.5
70,120,65,45,85,125,510,0.9747899159663865,20,10,55,15,20,80,200,0.17985611510791366,0.5
68,125,65,65,115,80,518,0.6277372262773723,50,50,77,95,77,91,440,0.5916666666666667,0.0
70,135,105,60,105,20,495,0.5806451612903226,90,100,90,125,85,90,580,0.7352941176470589,0.125
50,80,95,10,45,10,290,0.232,69,55,45,55,55,15,294,0.11666666666666667,1.0
70,90,70,60,60,70,420,0.6390977443609023,50,65,64,44,48,43,314,0.2196969696969697,1.0
65,100,70,80,80,105,500,0.8666666666666667,45,75,37,70,55,83,365,0.6183206106870229,0.5
65,130,60,95,110,65,525,0.5303030303030303,85,73,70,73,115,67,483,0.5126050420168067,1.0
90,60,70,75,70,45,410,0.23880597014925373,40,29,45,29,45,36,224,0.14634146341463414,1.0
55,85,55,50,55,60,360,0.4233576642335766,65,65,60,110,95,130,525,0.9253731343283582,1.0
106,110,90,154,90,130,680,0.926829268292683,50,20,55,25,25,30,205,0.09774436090225563,1.0
68,125,65,65,115,80,518,0.6277372262773723,60,80,110,50,80,45,425,0.2833333333333333,2.0
76,147,90,60,70,97,540,0.8267716535433071,40,30,35,45,40,55,245,0.31496062992125984,2.0
45,95,50,40,50,75,355,0.54,74,108,133,83,65,32,495,0.32142857142857145,1.0
60,50,70,80,80,140,480,0.8449612403100775,76,147,90,60,70,97,540,0.8267716535433071,0.5
72,58,80,103,80,97,490,0.7171052631578947,105,180,100,180,100,115,780,0.9477611940298507,1.0
38,41,40,50,65,65,299,0.4108527131782946,75,87,63,87,63,98,473,0.865546218487395,0.5
64,66,68,81,76,50,405,0.25190839694656486,60,60,50,40,50,75,335,0.5882352941176471,0.5
50,85,85,55,55,50,380,0.3902439024390244,45,35,50,70,50,30,280,0.15753424657534246,1.0
110,65,75,125,85,30,490,0.15,65,75,105,35,65,85,430,0.6940298507462687,2.0
70,80,70,80,70,110,480,0.6594202898550725,65,150,40,15,80,145,495,0.9663865546218487,1.0
45,55,39,35,39,42,255,0.18518518518518517,65,73,55,47,75,85,400,0.6846846846846847,1.0
72,60,30,20,30,25,237,0.11570247933884298,45,45,35,20,30,20,195,0.07246376811594203,0.5
75,75,60,83,60,60,413,0.39344262295081966,55,45,43,55,43,72,313,0.5853658536585366,1.0
55,63,90,50,80,42,380,0.21138211382113822,90,130,80,65,85,55,505,0.4396551724137931,0.5
55,63,90,50,80,42,380,0.21138211382113822,63,63,47,41,41,74,329,0.56,0.5
50,53,48,53,48,64,316,0.358974358974359,80,80,50,40,50,25,325,0.176056338028169,1.0
110,78,73,76,71,60,468,0.3333333333333333,90,30,15,40,20,15,210,0.043478260869565216,1.0
70,85,140,85,70,20,470,0.272,30,35,30,100,35,80,310,0.4765625,1.0
72,105,115,54,86,68,500,0.5149253731343284,45,30,50,55,65,45,290,0.208,1.0
60,85,60,85,60,55,405,0.3673469387755102,70,105,105,50,40,20,390,0.33587786259541985,1.0
45,50,45,115,55,95,405,0.6936936936936937,77,85,51,55,51,65,384,0.5163934426229508,1.0
75,55,70,55,95,110,460,0.8444444444444444,65,65,60,130,95,110,525,0.823943661971831,1.0
40,45,40,65,40,65,295,0.5661764705882353,45,49,65,49,65,45,318,0.275,0.5
40,45,35,40,40,90,290,0.65,50,30,55,65,55,20,275,0.13675213675213677,0.0
85,90,80,70,80,130,535,0.9262295081967213,60,50,150,50,150,60,520,0.5206611570247934,0.0
55,112,45,74,45,70,401,0.559322033898305,38,35,40,27,25,35,200,0.08208955223880597,4.0
85,100,122,58,75,54,494,0.3939393939393939,70,110,70,115,70,90,525,0.75,0.5
50,20,40,20,40,20,190,0.0962962962962963,1,90,45,30,30,40,236,0.33064516129032256,0.0
37,25,41,25,41,25,194,0.08870967741935484,20,15,20,10,55,80,200,0.2682926829268293,1.0
60,85,69,60,69,77,420,0.518796992481203,95,75,110,100,80,30,490,0.15267175572519084,1.0
62,50,58,73,54,72,369,0.4435483870967742,35,60,44,40,54,55,288,0.366412213740458,1.0
64,51,23,51,23,28,240,0.11363636363636363,50,70,160,70,160,90,600,0.7417218543046358,1.0
35,65,35,65,35,65,300,0.46621621621621623,90,60,70,75,70,45,410,0.23880597014925373,0.5
40,50,90,30,55,65,330,0.44680851063829785,85,50,95,120,115,80,545,0.5793650793650794,0.5
69,69,76,69,86,91,460,0.6554621848739496,60,80,110,50,80,45,425,0.2833333333333333,2.0
45,50,35,55,75,40,300,0.21367521367521367,50,64,50,45,50,41,300,0.22727272727272727,1.0
70,140,70,110,65,105,560,0.95,70,90,90,135,90,125,600,0.9401709401709402,0.5
55,84,105,114,75,52,485,0.2890625,106,190,100,154,100,130,780,0.9259259259259259,1.0
60,55,50,40,55,45,305,0.22377622377622378,123,77,72,99,92,58,521,0.4621212121212121,0.5
83,106,65,86,65,85,490,0.6640625,78,81,71,74,69,126,499,0.9090909090909091,0.5
91,129,90,72,90,108,580,0.8536585365853658,75,38,38,56,56,67,330,0.5263157894736842,1.0
109,66,84,81,99,32,471,0.2013888888888889,70,75,60,105,60,105,475,0.88,1.0
165,75,80,40,45,65,470,0.5151515151515151,42,52,67,39,56,50,306,0.2868217054263566,1.0
49,66,70,44,55,51,335,0.4260869565217391,40,40,50,30,30,30,220,0.0873015873015873,0.5
95,70,73,95,90,60,483,0.3983739837398374,85,60,65,135,105,100,550,0.7518248175182481,0.5
60,75,100,55,80,50,420,0.3088235294117647,45,45,35,20,30,20,195,0.07246376811594203,1.0
90,95,95,70,90,70,510,0.5230769230769231,91,72,90,129,90,108,580,0.8925619834710744,0.5
78,84,78,109,85,100,534,0.8620689655172413,60,85,69,60,69,77,420,0.518796992481203,1.0
120,120,120,120,120,120,720,0.9344262295081968,90,70,80,70,95,70,475,0.5190839694656488,1.0
65,155,120,65,90,105,600,0.8677685950413223,40,40,35,50,100,70,335,0.5031847133757962,0.5
40,70,130,60,130,25,455,0.17355371900826447,60,70,50,100,50,65,395,0.5217391304347826,1.0
50,85,125,85,115,20,480,0.4306569343065693,50,100,150,100,150,50,600,0.37142857142857144,0.5
70,55,65,95,85,70,440,0.5307692307692308,100,150,140,100,90,90,670,0.7969924812030075,1.0
106,110,90,154,90,130,680,0.926829268292683,60,90,140,50,50,40,430,0.2535211267605634,0.5
50,70,100,40,40,30,330,0.2222222222222222,123,77,72,99,92,58,521,0.4621212121212121,8.0
50,40,85,40,65,25,305,0.08870967741935484,73,100,60,100,60,65,458,0.42657342657342656,0.5
109,66,84,81,99,32,471,0.2013888888888889,45,55,45,65,45,75,330,0.5692307692307692,0.0
66,41,77,61,87,23,355,0.12096774193548387,60,45,70,45,90,95,405,0.7304964539007093,1.0
35,65,35,65,35,65,300,0.46621621621621623,80,70,70,90,100,70,480,0.5609756097560976,0.25
85,60,65,135,105,100,550,0.7518248175182481,60,59,85,79,105,36,424,0.16666666666666666,8.0
95,100,85,108,70,70,528,0.5652173913043478,68,165,95,65,115,110,618,0.8615384615384616,1.0
70,70,115,130,90,60,535,0.5338983050847458,79,115,70,125,80,111,580,0.864,0.5
78,92,75,74,63,118,500,0.8842975206611571,65,130,60,95,110,65,525,0.5303030303030303,1.0
80,160,80,130,80,100,630,0.8455284552845529,30,40,55,40,55,60,280,0.3237410071942446,0.5
65,130,60,75,60,75,465,0.689922480620155,30,45,59,30,39,57,260,0.2803030303030303,1.0
60,70,105,70,120,75,500,0.5983606557377049,35,46,34,35,45,20,215,0.072,1.0
74,94,131,54,116,20,489,0.4485294117647059,91,72,90,129,90,108,580,0.8925619834710744,1.0
50,20,40,20,40,20,190,0.0962962962962963,44,48,65,50,64,43,314,0.1623931623931624,1.0
43,80,65,50,35,35,308,0.14193548387096774,40,65,40,80,40,65,330,0.5038167938931297,1.0
60,70,105,70,120,75,500,0.5983606557377049,70,85,65,105,85,120,530,0.9262295081967213,0.5
50,20,55,25,25,30,205,0.09774436090225563,100,110,90,85,90,60,535,0.47794117647058826,1.0
40,35,30,20,20,50,195,0.23423423423423423,90,110,80,100,80,95,555,0.7982456140350878,0.5
50,47,50,57,50,65,319,0.463768115942029,80,82,78,95,80,85,500,0.6869565217391305,2.0
150,160,100,95,65,100,670,0.8866666666666667,50,53,48,53,48,64,316,0.358974358974359,1.0
35,80,50,50,70,120,405,0.84375,135,85,40,40,85,5,390,0.6864406779661016,1.0
50,60,45,100,80,65,400,0.45689655172413796,75,90,50,110,80,95,500,0.7985611510791367,0.5
40,70,40,35,40,60,285,0.392,130,65,60,110,95,65,525,0.5227272727272727,1.0
110,85,95,80,95,50,515,0.2713178294573643,80,85,95,30,30,25,345,0.2857142857142857,0.5
250,5,5,35,105,50,450,0.15306122448979592,44,48,65,50,64,43,314,0.1623931623931624,1.0
91,129,90,72,90,108,580,0.8536585365853658,56,61,65,48,45,38,313,0.17567567567567569,1.0
111,83,68,92,82,39,475,0.1774193548387097,64,115,65,83,63,65,455,0.5323741007194245,1.0
88,107,122,74,75,64,530,0.4596774193548387,65,83,57,95,85,105,490,0.8914728682170543,1.0
100,110,90,85,90,60,535,0.47794117647058826,60,60,75,60,75,80,410,0.7321428571428571,1.0
79,100,80,110,90,121,580,0.968,46,87,60,30,40,57,320,0.37777777777777777,1.0
95,155,109,70,130,81,640,0.6788321167883211,40,30,35,45,40,55,245,0.31496062992125984,0.5
60,25,35,70,80,60,330,0.3076923076923077,50,150,50,150,50,150,600,0.9339622641509434,0.5
50,65,107,105,107,86,520,0.7313432835820896,68,75,53,83,113,60,452,0.45384615384615384,0.25
20,40,90,30,90,25,295,0.11363636363636363,65,75,105,35,65,85,430,0.6940298507462687,1.0
38,41,40,50,65,65,299,0.4108527131782946,89,124,80,55,80,55,483,0.5714285714285714,1.0
60,90,140,50,50,40,430,0.2535211267605634,25,35,70,95,55,45,325,0.16783216783216784,0.125
80,160,60,170,130,80,680,0.6180555555555556,40,30,30,40,50,30,220,0.07936507936507936,1.0
70,110,180,60,60,50,530,0.4117647058823529,65,136,94,54,96,135,580,0.9612403100775194,0.5
70,115,60,115,60,55,475,0.4647887323943662,125,58,58,76,76,67,460,0.515625,2.0
45,60,32,50,32,76,295,0.5925925925925926,76,25,45,67,55,24,292,0.0390625,1.0
45,100,45,45,45,10,290,0.2949640287769784,43,70,48,50,60,38,309,0.2391304347826087,0.5
35,70,55,45,55,25,285,0.09420289855072464,60,50,100,85,70,65,430,0.47580645161290325,0.5
68,72,78,38,42,32,330,0.23809523809523808,67,82,62,46,48,43,348,0.22033898305084745,1.0
80,75,150,75,150,50,580,0.30973451327433627,86,81,97,81,107,43,495,0.203125,2.0
50,65,85,35,35,55,325,0.32575757575757575,50,60,45,100,80,65,400,0.45689655172413796,1.0
35,60,44,40,54,55,288,0.366412213740458,30,35,30,100,35,80,310,0.4765625,0.25
64,51,23,51,23,28,240,0.11363636363636363,50,85,55,65,65,90,410,0.7478260869565218,1.0
65,73,55,47,75,85,400,0.6846846846846847,70,84,70,65,70,51,410,0.2949640287769784,1.0
45,50,35,55,75,40,300,0.21367521367521367,70,120,65,45,85,125,510,0.9747899159663865,1.0
50,53,48,53,48,64,316,0.46153846153846156,91,72,90,129,90,108,580,0.8620689655172413,0.5
54,63,52,83,56,97,405,0.7697841726618705,60,65,70,85,75,40,395,0.21705426356589147,0.5
45,80,100,35,37,28,325,0.3125,82,80,86,85,75,72,480,0.6183206106870229,0.5
100,77,77,128,128,90,600,0.6901408450704225,120,120,120,120,120,120,720,0.9344262295081968,1.0
70,140,230,60,80,50,630,0.32432432432432434,60,90,55,90,80,110,485,0.8677685950413223,0.5
60,60,60,105,105,105,495,0.848,50,100,150,100,150,50,600,0.37142857142857144,1.0
50,50,77,95,77,91,440,0.5916666666666667,70,50,30,95,135,105,485,0.8040540540540541,1.0
37,25,41,25,41,25,194,0.08870967741935484,62,77,62,50,42,65,358,0.4838709677419355,0.5
72,58,80,103,80,97,490,0.7171052631578947,70,100,115,30,65,30,410,0.24390243902439024,0.5
72,60,30,20,30,25,237,0.11570247933884298,75,95,60,65,60,115,470,0.8778625954198473,2.0
40,80,100,30,30,20,300,0.11851851851851852,44,38,39,61,79,42,303,0.2251655629139073,1.0
80,130,100,160,120,110,700,0.8981481481481481,99,68,83,72,87,51,460,0.417910447761194,1.0
74,108,133,83,65,32,495,0.32142857142857145,70,110,70,115,70,90,525,0.75,0.25
90,75,85,115,90,55,510,0.3445378151260504,50,50,150,50,150,50,500,0.2571428571428571,1.0
50,105,125,55,95,50,480,0.375886524822695,55,66,44,44,56,85,350,0.6888888888888889,1.0
35,40,100,90,55,35,355,0.1796875,50,70,50,50,50,40,310,0.16296296296296298,0.5
125,58,58,76,76,67,460,0.515625,100,150,140,100,90,90,670,0.7969924812030075,0.0
90,95,105,165,110,45,610,0.2890625,45,50,55,75,65,30,320,0.06293706293706294,0.5
70,55,95,95,110,65,490,0.48872180451127817,150,100,120,100,120,90,680,0.6666666666666666,1.0
60,130,80,60,60,70,460,0.5153846153846153,78,84,78,109,85,100,534,0.8646616541353384,0.125
78,52,60,63,65,23,341,0.06015037593984962,50,75,45,40,45,60,315,0.4380165289256198,1.0
85,135,130,60,80,25,515,0.40540540540540543,95,23,48,23,48,23,260,0.046153846153846156,1.0
45,90,20,65,20,65,305,0.5116279069767442,75,105,75,105,75,45,480,0.3274336283185841,0.5
60,90,55,90,80,110,485,0.8677685950413223,75,100,66,60,66,115,482,0.918918918918919,1.0
50,65,107,105,107,86,520,0.703125,50,50,40,30,30,50,250,0.2781954887218045,0.0
90,100,60,90,60,80,480,0.6422764227642277,60,50,150,50,150,60,520,0.5206611570247934,1.0
126,131,95,131,98,99,680,0.8294573643410853,91,90,106,130,106,77,600,0.648854961832061,0.25
20,10,55,15,20,80,200,0.17985611510791366,86,81,97,81,107,43,495,0.203125,1.0
50,70,50,50,50,70,340,0.5645161290322581,100,110,90,85,90,60,535,0.47794117647058826,1.0
70,95,125,65,75,45,475,0.33613445378151263,65,150,60,115,60,115,565,0.935251798561151,2.0
73,100,60,100,60,65,458,0.42657342657342656,64,66,68,81,76,50,405,0.25190839694656486,1.0
45,80,100,35,37,28,325,0.3125,66,65,48,62,57,52,350,0.36220472440944884,1.0
45,85,50,55,50,65,350,0.5076923076923077,50,50,95,40,50,35,320,0.20279720279720279,1.0
60,60,60,105,105,105,495,0.848,70,60,70,87,78,85,450,0.6228070175438597,1.0
60,62,63,80,80,60,405,0.38016528925619836,83,106,65,86,65,85,490,0.6640625,0.25
78,130,111,130,85,100,634,0.8561151079136691,60,82,45,45,45,74,351,0.5752212389380531,1.0
55,50,45,135,95,120,500,0.7714285714285715,115,115,85,90,75,100,580,0.8134328358208955,1.0
40,55,30,30,30,60,245,0.43548387096774194,91,90,129,90,72,108,580,0.9140625,0.5
50,40,85,40,65,25,305,0.08870967741935484,106,190,100,154,100,130,780,0.9259259259259259,1.0
59,59,58,90,70,73,409,0.5826086956521739,95,65,65,110,130,60,525,0.4016393442622951,1.0
65,50,70,95,80,65,425,0.4262295081967213,70,105,105,50,40,20,390,0.33587786259541985,1.0
95,75,80,100,110,30,490,0.24242424242424243,40,30,35,45,40,55,245,0.31496062992125984,0.5
104,91,63,91,73,68,490,0.5118110236220472,55,45,43,55,43,72,313,0.5853658536585366,1.0
80,100,70,50,60,45,405,0.25806451612903225,65,70,60,65,65,115,440,0.8583333333333333,2.0
45,40,60,40,75,50,310,0.2926829268292683,100,100,100,100,100,100,600,0.8758169934640523,0.25
50,50,95,40,50,35,320,0.20279720279720279,78,52,60,63,65,23,341,0.06015037593984962,1.0
68,125,65,65,115,80,518,0.6277372262773723,91,90,72,90,129,108,580,0.896,1.0
50,85,125,85,115,20,480,0.4306569343065693,65,65,60,130,95,110,525,0.823943661971831,4.0
50,25,28,45,55,15,218,0.0625,45,20,50,60,120,50,345,0.24074074074074073,1.0
62,44,50,44,50,55,305,0.3629032258064516,45,55,39,35,39,42,255,0.18518518518518517,1.0
80,70,40,100,60,145,495,0.921875,55,55,85,65,85,35,380,0.2014388489208633,1.0
44,58,44,58,44,61,309,0.41964285714285715,80,105,105,105,105,80,580,0.5939849624060151,1.0
101,72,72,99,89,29,462,0.1937984496124031,65,65,45,75,45,95,390,0.72,1.0
70,80,70,80,70,110,480,0.6594202898550725,65,73,55,47,75,85,400,0.6846846846846847,1.0
70,80,65,90,65,85,455,0.578125,90,75,75,90,100,70,500,0.5462184873949579,1.0
20,25,45,70,90,60,310,0.30833333333333335,89,145,90,105,80,91,600,0.8549618320610687,2.0
60,60,60,105,105,105,495,0.848,60,95,80,60,80,30,405,0.19480519480519481,1.0
58,109,112,48,48,109,484,0.8805970149253731,70,120,40,95,40,95,460,0.8106060606060606,1.0
40,80,100,30,30,20,300,0.11851851851851852,75,90,50,110,80,95,500,0.7985611510791367,4.0
90,100,90,125,85,90,580,0.7352941176470589,70,80,65,90,65,85,455,0.578125,1.0
95,100,85,108,70,70,528,0.5652173913043478,50,35,55,25,25,15,205,0.05263157894736842,1.0
95,135,80,110,80,100,600,0.8248175182481752,78,65,68,112,154,75,552,0.628099173553719,0.0
30,80,90,55,45,55,355,0.4295774647887324,50,65,107,105,107,86,520,0.7313432835820896,0.5
50,180,20,180,20,150,600,0.9029850746268657,59,63,80,65,80,58,405,0.41843971631205673,1.0
90,120,100,150,120,100,680,0.7718120805369127,55,95,55,35,75,115,430,0.9380530973451328,1.0
60,85,49,60,49,60,363,0.4444444444444444,60,95,80,60,80,30,405,0.19480519480519481,0.5
60,45,70,45,90,95,405,0.7304964539007093,70,90,70,60,60,70,420,0.6390977443609023,1.0
59,59,58,90,70,73,409,0.5826086956521739,60,110,70,60,60,100,460,0.8461538461538461,1.0
61,84,65,70,70,70,420,0.5,53,54,53,37,46,45,288,0.3090909090909091,1.0
85,105,55,85,50,115,495,0.9032258064516129,77,85,51,55,51,65,384,0.5163934426229508,1.0
64,165,75,93,83,75,555,0.6587301587301587,60,69,95,69,95,36,424,0.2608695652173913,1.0
106,90,130,90,154,110,680,0.8699186991869918,125,170,100,120,90,95,700,0.77,1.0
55,70,45,70,50,60,350,0.45,35,55,40,50,50,90,320,0.6838235294117647,1.0
35,45,160,30,45,70,385,0.48148148148148145,103,93,67,71,61,84,479,0.7142857142857143,2.0
50,64,50,45,50,41,300,0.22727272727272727,59,66,70,44,55,41,335,0.25190839694656486,0.5
110,135,60,50,65,88,508,0.7744360902255639,58,109,112,48,48,109,484,0.8805970149253731,0.5
78,52,60,63,65,23,341,0.06015037593984962,126,131,95,131,98,99,680,0.8294573643410853,1.0
45,30,50,55,65,45,290,0.208,111,83,68,92,82,39,475,0.1774193548387097,2.0
65,125,60,95,60,105,510,0.9236641221374046,100,100,100,100,100,100,600,0.8778625954198473,0.5
101,72,72,99,89,29,462,0.1937984496124031,45,30,50,55,65,45,290,0.208,1.0
40,29,45,29,45,36,224,0.14634146341463414,65,130,60,95,110,65,525,0.5303030303030303,0.5
45,75,37,70,55,83,365,0.6183206106870229,70,62,67,55,55,56,365,0.38513513513513514,1.0
55,35,50,55,110,85,390,0.6277372262773723,75,90,140,60,60,40,465,0.3008130081300813,0.5
80,50,100,100,200,50,580,0.2357142857142857,130,85,80,85,95,60,535,0.43884892086330934,0.25
45,20,50,60,120,50,345,0.24074074074074073,61,84,65,70,70,70,420,0.5,0.5
70,145,88,140,70,112,625,0.8888888888888888,60,52,168,47,138,30,495,0.19834710743801653,4.0
44,75,35,63,33,45,295,0.2647058823529412,40,30,32,50,52,65,269,0.3671875,1.0
125,58,58,76,76,67,460,0.515625,95,23,48,23,48,23,260,0.046153846153846156,1.0
80,70,65,80,120,100,515,0.8034188034188035,55,75,60,75,60,103,428,0.7982456140350878,1.0
90,50,34,60,44,70,348,0.6283185840707964,95,65,65,110,130,60,525,0.4016393442622951,1.0
130,85,80,85,95,60,535,0.43884892086330934,75,95,125,45,75,95,510,0.8257575757575758,8.0
70,65,65,55,55,70,380,0.5,45,63,37,65,55,95,360,0.8055555555555556,1.0
42,52,67,39,56,50,306,0.2868217054263566,55,40,50,65,85,40,335,0.3181818181818182,0.5
115,115,85,90,75,100,580,0.8134328358208955,85,97,66,105,66,65,484,0.47107438016528924,0.5
105,105,75,65,100,50,500,0.37593984962406013,40,40,50,30,30,30,220,0.0873015873015873,2.0
65,85,70,75,70,40,405,0.203125,65,73,55,47,75,85,400,0.6846846846846847,1.0
60,85,69,60,69,77,420,0.518796992481203,70,65,60,90,75,90,450,0.6571428571428571,1.0
50,65,90,35,35,15,290,0.14678899082568808,39,52,43,60,50,65,309,0.5041322314049587,0.5
41,64,45,50,50,50,300,0.36752136752136755,85,100,122,58,75,54,494,0.3939393939393939,1.0
60,50,150,50,150,60,520,0.5206611570247934,86,76,86,116,56,95,515,0.7982456140350878,1.0
44,38,39,61,79,42,303,0.2251655629139073,70,135,105,60,105,20,495,0.5806451612903226,0.5
48,72,48,72,48,48,336,0.25984251968503935,70,150,140,65,100,75,600,0.55,0.5
80,75,150,75,150,50,580,0.30973451327433627,55,50,40,40,40,75,300,0.5945945945945946,1.0
100,180,160,150,90,90,770,0.7520661157024794,43,30,55,40,65,97,330,0.6030534351145038,0.5
40,30,35,50,70,55,280,0.28205128205128205,78,81,71,74,69,126,499,0.9090909090909091,0.25
75,65,55,65,55,69,384,0.43548387096774194,10,55,25,35,45,95,265,0.5396825396825397,2.0
45,25,50,25,25,35,205,0.13076923076923078,70,85,70,60,70,50,405,0.28378378378378377,0.5
82,121,119,69,59,71,521,0.5394736842105263,80,80,80,80,80,80,480,0.5606060606060606,1.0
50,65,107,105,107,86,520,0.7272727272727273,20,40,15,35,35,60,205,0.34285714285714286,0.25
40,55,30,30,30,60,245,0.43548387096774194,40,45,35,40,40,90,290,0.65,1.0
70,70,115,130,90,60,535,0.5338983050847458,50,25,28,45,55,15,218,0.0625,0.5
85,105,100,79,83,78,530,0.5869565217391305,40,55,70,45,60,30,300,0.10619469026548672,1.0
28,25,25,45,35,40,198,0.16083916083916083,65,155,120,65,90,105,600,0.8677685950413223,1.0
41,56,40,62,44,71,314,0.568,65,80,140,40,70,70,465,0.5223880597014925,1.0
85,110,76,65,82,56,474,0.3933333333333333,75,123,67,95,85,95,540,0.7642276422764228,1.0
60,150,50,150,50,60,520,0.5,65,45,55,45,70,45,325,0.24369747899159663,0.5
60,65,80,170,95,130,600,0.8625954198473282,65,85,70,75,70,40,405,0.203125,1.0
60,70,65,125,105,90,515,0.6911764705882353,45,50,43,40,38,62,278,0.40441176470588236,0.5
40,40,55,40,70,55,300,0.40939597315436244,70,85,70,60,70,50,405,0.28378378378378377,2.0
30,30,30,30,30,30,180,0.12612612612612611,50,65,107,105,107,86,520,0.6991150442477876,0.5
60,50,100,85,70,65,430,0.47580645161290325,50,65,45,85,65,95,405,0.7238095238095238,1.0
78,84,78,109,85,100,534,0.8620689655172413,60,110,70,60,60,100,460,0.8461538461538461,1.0
55,55,50,45,65,55,325,0.37373737373737376,60,150,50,150,50,60,520,0.5,0.0
105,30,105,140,105,55,540,0.3524590163934426,50,64,50,45,50,41,300,0.22727272727272727,1.0
45,45,55,45,55,63,308,0.4594594594594595,50,65,64,44,48,43,314,0.2196969696969697,2.0
70,95,125,65,75,45,475,0.33613445378151263,88,107,122,74,75,64,530,0.4596774193548387,0.5
90,75,85,115,90,55,510,0.3445378151260504,100,150,90,180,160,90,770,0.7348484848484849,2.0
70,145,88,140,70,112,625,0.8888888888888888,50,55,50,36,30,43,264,0.2922077922077922,1.0
55,65,95,95,45,85,440,0.6610169491525424,250,5,5,35,105,50,450,0.15306122448979592,1.0
80,100,70,60,70,95,475,0.7416666666666667,50,65,85,35,35,55,325,0.32575757575757575,0.5
65,105,60,60,70,95,455,63.0,103,60,86,60,86,50,445,0.3458646616541353,2.0
75,90,140,60,60,40,465,0.3008130081300813,75,70,90,70,105,80,490,0.656,0.5
78,81,71,74,69,126,499,0.9090909090909091,40,27,60,37,50,66,280,0.36220472440944884,4.0
50,120,53,35,110,87,455,0.640625,59,59,58,90,70,73,409,0.5826086956521739,1.0
70,95,85,55,65,70,440,0.5,60,70,105,70,120,75,500,0.5983606557377049,0.5
64,115,65,83,63,65,455,0.5323741007194245,40,50,90,30,55,65,330,0.44680851063829785,1.0
65,65,60,110,95,130,525,0.9253731343283582,85,50,95,120,115,80,545,0.5793650793650794,2.0
85,97,66,105,66,65,484,0.47107438016528924,62,44,50,44,50,55,305,0.3629032258064516,0.5
75,55,70,55,95,110,460,0.8444444444444444,66,117,70,40,50,67,410,0.4573643410852713,0.5
45,75,60,40,30,50,300,0.304,70,50,30,95,135,105,485,0.8040540540540541,1.0
45,22,60,27,30,29,213,0.07518796992481203,38,30,85,55,65,30,303,0.21428571428571427,0.5
90,93,55,70,55,55,418,0.3819444444444444,60,60,60,60,60,60,360,0.38095238095238093,2.0
85,80,90,105,95,60,515,0.49074074074074076,70,80,50,35,35,35,305,0.14,1.0
55,47,52,40,40,41,275,0.16806722689075632,75,125,100,70,80,45,495,0.33035714285714285,0.5
95,117,184,44,46,28,514,0.2975206611570248,111,83,68,92,82,39,475,0.1774193548387097,1.0
80,100,80,80,80,100,520,0.9051724137931034,45,85,70,40,40,60,340,0.5229357798165137,1.0
106,190,100,154,100,130,780,0.9259259259259259,74,108,133,83,65,32,495,0.32142857142857145,2.0
90,92,75,92,85,60,494,0.49586776859504134,70,62,67,55,55,56,365,0.38513513513513514,0.5
100,120,120,150,100,90,680,0.7880794701986755,90,120,75,60,60,45,450,0.29411764705882354,0.0
40,29,45,29,45,36,224,0.14634146341463414,50,50,77,95,77,91,440,0.5916666666666667,0.5
45,100,45,45,45,10,290,0.2949640287769784,50,72,35,35,35,65,292,0.5373134328358209,1.0
60,82,45,45,45,74,351,0.5752212389380531,70,145,88,140,70,112,625,0.8888888888888888,1.0
70,60,62,80,82,60,414,0.4375,63,120,85,90,55,55,468,0.2809917355371901,2.0
80,135,130,95,90,70,600,0.5181818181818182,60,40,60,95,60,55,370,0.4222222222222222,0.5
75,100,95,40,70,110,490,0.8717948717948718,60,50,40,85,75,95,405,0.7540983606557377,1.0
65,75,70,95,70,95,470,0.7272727272727273,85,120,70,50,60,100,485,0.8308823529411765,1.0
45,85,70,40,40,60,340,0.5229357798165137,90,50,34,60,44,70,348,0.6283185840707964,2.0
65,65,65,50,50,90,385,0.72,80,45,65,90,110,80,470,0.5462962962962963,1.0
40,35,30,120,70,105,400,0.6692307692307692,70,85,65,105,85,120,530,0.9262295081967213,1.0
65,40,50,125,60,30,370,0.07258064516129033,75,89,85,55,65,36,405,0.29545454545454547,1.0
60,67,85,77,75,116,480,0.8888888888888888,80,75,150,75,150,50,580,0.30973451327433627,0.25
80,100,70,60,70,95,475,0.7416666666666667,90,120,75,60,60,45,450,0.29411764705882354,1.0
80,105,65,60,75,130,515,0.9645390070921985,80,160,60,170,130,80,680,0.6180555555555556,1.0
65,85,70,75,70,40,405,0.203125,72,85,70,65,70,58,420,0.41304347826086957,0.5
80,120,80,120,80,100,580,0.8478260869565217,35,35,35,35,35,35,210,0.13385826771653545,1.0
70,62,67,55,55,56,365,0.38513513513513514,68,85,65,165,135,100,618,0.8083333333333333,2.0
60,105,60,120,60,105,510,0.8849557522123894,50,50,77,95,77,91,440,0.5916666666666667,2.0
100,134,110,95,100,61,600,0.4057971014492754,90,100,90,125,85,90,580,0.7352941176470589,4.0
95,145,130,120,90,120,700,0.9398496240601504,59,66,70,44,55,41,335,0.25190839694656486,2.0
50,105,79,35,110,76,455,0.6214285714285714,41,56,40,62,44,71,314,0.568,1.0
40,30,35,50,70,55,280,0.28205128205128205,50,20,40,20,40,20,190,0.0962962962962963,2.0
91,129,90,72,90,108,580,0.8536585365853658,65,65,45,75,45,95,390,0.72,1.0
85,73,70,73,115,67,483,0.5126050420168067,103,60,126,80,126,50,545,0.36363636363636365,1.0
60,40,50,75,85,95,405,0.6044776119402985,70,94,50,94,50,66,424,0.48148148148148145,2.0
40,30,30,40,50,30,220,0.07936507936507936,67,125,40,30,30,58,350,0.3431372549019608,4.0
50,65,45,85,65,95,405,0.7238095238095238,95,117,184,44,46,28,514,0.2975206611570248,1.0
40,45,40,62,60,60,307,0.33884297520661155,90,100,70,110,150,80,600,0.6037735849056604,0.5
65,47,55,73,75,85,400,0.65,60,40,80,60,45,40,325,0.23529411764705882,4.0
105,180,100,180,100,115,780,0.9477611940298507,70,110,180,60,60,50,530,0.4117647058823529,0.125
60,60,40,65,45,35,305,0.15833333333333333,40,55,99,40,79,47,360,0.26262626262626265,2.0
45,55,39,35,39,42,255,0.18518518518518517,70,55,55,80,60,45,365,0.2222222222222222,1.0
50,45,45,35,35,50,260,0.23529411764705882,70,110,75,145,85,145,630,0.9444444444444444,1.0
54,45,47,75,98,52,371,0.39669421487603307,55,75,50,40,40,80,340,0.6302521008403361,1.0
105,150,90,150,90,95,680,0.8285714285714286,80,105,65,60,75,130,515,0.9645390070921985,0.5
80,80,50,40,50,25,325,0.176056338028169,65,50,35,115,95,95,455,0.7333333333333333,1.0
40,55,80,35,60,30,300,0.15037593984962405,45,30,50,65,50,45,285,0.13821138211382114,0.5
55,75,85,25,25,15,280,0.1875,41,56,40,62,44,71,314,0.568,1.0
75,110,110,110,105,80,590,0.656934306569343,50,20,40,20,40,20,190,0.0962962962962963,0.0
50,85,125,85,115,20,480,0.4306569343065693,100,110,90,85,90,60,535,0.47794117647058826,1.0
67,82,62,46,48,43,348,0.22033898305084745,35,45,160,30,45,70,385,0.48148148148148145,2.0
40,45,35,30,40,55,245,0.3793103448275862,45,45,35,20,30,20,195,0.07246376811594203,2.0
95,80,105,40,70,100,490,0.8046875,85,70,80,97,80,123,535,0.9304347826086956,1.0
55,55,55,85,55,30,335,0.1320754716981132,59,63,80,65,80,58,405,0.41843971631205673,1.0
78,84,78,109,85,100,534,0.8620689655172413,30,65,100,45,25,40,305,0.1891891891891892,0.5
95,110,80,70,80,50,485,0.37209302325581395,75,95,67,125,95,83,540,0.7117117117117117,0.5
86,92,88,68,75,73,482,0.6835443037974683,50,30,55,65,55,20,275,0.13675213675213677,2.0
45,35,45,62,53,35,275,0.11851851851851852,65,130,60,75,60,75,465,0.689922480620155,1.0
95,155,109,70,130,81,640,0.6788321167883211,65,80,80,59,63,58,405,0.4411764705882353,0.5
65,90,50,85,45,55,390,0.371900826446281,79,115,70,125,80,111,580,0.864,0.5
50,105,79,35,110,76,455,0.6214285714285714,66,41,77,61,87,23,355,0.12096774193548387,2.0
110,130,80,70,60,80,530,0.5862068965517241,53,54,53,37,46,45,288,0.3090909090909091,1.0
50,85,40,85,40,35,335,0.1746031746031746,123,77,72,99,92,58,521,0.4621212121212121,2.0
75,98,63,98,63,101,498,0.8091603053435115,60,90,55,90,80,110,485,0.8677685950413223,1.0
62,55,52,109,94,109,481,0.7833333333333333,75,98,63,98,63,101,498,0.8091603053435115,0.5
30,30,42,30,42,70,244,0.4230769230769231,110,65,75,125,85,30,490,0.15,2.0
20,40,90,30,90,25,295,0.11363636363636363,85,105,100,79,83,78,530,0.5869565217391305,1.0
109,66,84,81,99,32,471,0.2013888888888889,45,50,55,75,65,30,320,0.06293706293706294,0.5
70,60,75,110,75,90,480,0.7165354330708661,60,45,70,75,85,55,390,0.3008130081300813,1.0
108,130,95,80,85,102,600,0.7637795275590551,70,84,70,65,70,51,410,0.2949640287769784,2.0
60,80,50,40,40,30,300,0.15328467153284672,60,65,80,170,95,130,600,0.8625954198473282,0.5
95,60,79,100,125,81,540,0.6201550387596899,55,85,55,50,55,60,360,0.4233576642335766,2.0
75,87,63,87,63,98,473,0.865546218487395,38,35,35,65,55,50,278,0.2647058823529412,1.0
75,80,95,90,100,50,490,0.2158273381294964,85,100,122,58,75,54,494,0.3939393939393939,0.5
95,155,109,70,130,81,640,0.6788321167883211,59,110,150,45,49,35,448,0.3333333333333333,2.0
75,95,95,95,95,85,540,0.6470588235294118,38,35,35,65,55,50,278,0.2647058823529412,0.0
61,78,95,56,58,57,405,0.40336134453781514,110,160,110,80,110,100,670,0.8591549295774648,1.0
100,164,150,95,120,71,700,0.5645161290322581,30,56,35,25,35,72,253,0.48148148148148145,1.0
71,73,88,120,89,59,500,0.43537414965986393,85,100,122,58,75,54,494,0.3939393939393939,0.5
78,104,78,159,115,100,634,0.8444444444444444,50,50,77,95,77,91,440,0.5916666666666667,0.5
40,20,30,40,80,55,265,0.22764227642276422,40,70,130,60,130,25,455,0.17355371900826447,0.5
100,134,110,95,100,61,600,0.4057971014492754,64,51,23,51,23,28,240,0.11363636363636363,1.0
90,120,120,60,60,50,500,0.35294117647058826,49,55,42,42,37,85,310,0.6068376068376068,1.0
60,90,140,50,50,40,430,0.2535211267605634,60,60,40,65,45,35,305,0.15833333333333333,0.5
65,80,80,59,63,58,405,0.4411764705882353,65,65,60,130,95,110,525,0.823943661971831,1.0
65,45,55,45,70,45,325,0.24369747899159663,50,85,55,65,65,90,410,0.7478260869565218,2.0
60,110,70,60,60,100,460,0.8461538461538461,106,130,90,110,154,90,680,0.719626168224299,1.0
60,69,95,69,95,36,424,0.2608695652173913,50,80,95,10,45,10,290,0.232,2.0
95,95,85,125,65,55,520,0.3894736842105263,100,164,150,95,120,71,700,0.5645161290322581,0.0
62,50,58,73,54,72,369,0.4435483870967742,95,145,130,120,90,120,700,0.9398496240601504,0.5
110,160,110,80,110,100,670,0.8591549295774648,60,85,69,60,69,77,420,0.518796992481203,1.0
60,50,40,85,75,95,405,0.7540983606557377,55,69,85,32,35,28,304,0.09302325581395349,1.0
55,66,44,44,56,85,350,0.6888888888888889,70,90,110,60,75,95,500,0.7333333333333333,1.0
60,85,69,60,69,77,420,0.518796992481203,80,105,65,60,75,130,515,0.9645390070921985,0.5
30,45,59,30,39,57,260,0.2803030303030303,70,50,30,95,135,105,485,0.8040540540540541,1.0
95,65,65,110,130,60,525,0.4016393442622951,70,60,62,80,82,60,414,0.4375,1.0
38,41,40,50,65,65,299,0.4108527131782946,20,10,230,10,230,5,505,0.0,1.0
125,120,90,170,100,95,700,0.78125,80,120,70,110,70,80,530,0.6422764227642277,0.5
44,58,44,58,44,61,309,0.41964285714285715,95,80,105,40,70,100,490,0.8046875,1.0
55,50,65,175,95,150,590,0.7818181818181819,30,42,118,42,88,30,350,0.112,0.5
45,85,70,40,40,60,340,0.5229357798165137,70,45,48,60,65,35,323,0.15748031496062992,0.25
39,52,43,60,50,65,309,0.49107142857142855,60,60,40,65,45,35,305,0.15833333333333333,0.5
40,45,35,65,55,70,310,0.4482758620689655,53,54,53,37,46,45,288,0.3090909090909091,1.0
45,95,50,40,50,75,355,0.54,60,40,60,40,60,35,295,0.18055555555555555,2.0
85,100,122,58,75,54,494,0.3939393939393939,50,53,62,58,63,44,330,0.13709677419354838,2.0
60,85,42,85,42,91,405,0.8227848101265823,58,109,112,48,48,109,484,0.8805970149253731,1.0
90,90,85,125,90,100,580,0.768595041322314,60,60,60,60,60,60,360,0.38095238095238093,1.0
60,50,70,50,90,65,385,0.39568345323741005,100,120,120,150,100,90,680,0.7880794701986755,0.0
35,46,34,35,45,20,215,0.072,58,50,145,95,105,30,483,0.2459016393442623,0.0
65,110,130,60,65,95,525,0.8278145695364238,80,92,65,65,80,68,450,0.4824561403508772,2.0
126,131,95,131,98,99,680,0.8294573643410853,45,40,60,40,75,50,310,0.2926829268292683,1.0
61,78,95,56,58,57,405,0.40336134453781514,50,60,45,100,80,65,400,0.45689655172413796,0.25
250,5,5,35,105,50,450,0.15306122448979592,106,90,130,90,154,110,680,0.8699186991869918,1.0
50,100,150,100,150,50,600,0.37142857142857144,50,65,64,44,48,43,314,0.2196969696969697,1.0
100,150,120,120,100,90,680,0.6493506493506493,110,160,110,80,110,100,670,0.8591549295774648,1.0
60,95,80,60,80,30,405,0.19480519480519481,50,160,110,160,110,110,700,0.8854961832061069,1.0
60,75,100,55,80,50,420,0.3088235294117647,75,123,67,95,85,95,540,0.7642276422764228,0.5
95,110,80,70,80,50,485,0.37209302325581395,70,80,102,80,102,40,474,0.2677165354330709,2.0
50,47,50,57,50,65,319,0.463768115942029,35,65,35,65,35,65,300,0.46621621621621623,2.0
40,80,100,30,30,20,300,0.11851851851851852,89,124,80,55,80,55,483,0.5714285714285714,0.5
105,125,100,60,100,100,590,0.8359375,45,60,45,25,45,55,275,0.29,1.0
60,110,70,60,60,100,460,0.8461538461538461,61,90,45,50,50,160,456,0.9230769230769231,2.0
70,130,100,55,80,65,500,0.608,125,130,90,130,90,95,660,0.7734375,2.0
35,46,34,35,45,20,215,0.072,45,30,15,85,65,65,305,0.36220472440944884,1.0
40,80,100,30,30,20,300,0.11851851851851852,71,95,85,110,95,79,535,0.664,2.0
73,100,60,100,60,65,458,0.42657342657342656,75,100,110,45,55,65,450,0.5333333333333333,0.5
60,60,60,105,105,105,495,0.848,50,65,107,105,107,86,520,0.7313432835820896,1.0
60,40,60,40,60,35,295,0.18055555555555555,55,85,122,58,75,99,494,0.8099173553719008,0.5
95,117,184,44,46,28,514,0.2975206611570248,35,40,100,90,55,35,355,0.1796875,0.5
60,40,50,75,85,95,405,0.6044776119402985,50,95,90,95,90,180,600,0.9172413793103448,1.0
65,73,55,47,75,85,400,0.6846846846846847,60,80,50,50,50,40,330,0.23853211009174313,1.0
95,75,110,100,80,30,490,0.15267175572519084,75,75,75,125,95,40,485,0.15671641791044777,0.5
66,117,70,40,50,67,410,0.4573643410852713,80,95,82,60,82,75,474,0.6,1.0
110,123,65,100,65,65,528,0.5217391304347826,125,58,58,76,76,67,460,0.515625,0.5
55,50,65,175,95,150,590,0.7818181818181819,75,95,67,125,95,83,540,0.7117117117117117,1.0
85,105,100,79,83,78,530,0.5869565217391305,65,63,45,45,45,45,308,0.2595419847328244,2.0
100,90,130,45,65,55,485,0.4253731343283582,95,117,184,44,46,28,514,0.2975206611570248,2.0
80,130,100,160,120,110,700,0.8981481481481481,100,50,80,60,80,50,420,0.34375,0.0
45,53,70,40,60,42,310,0.25735294117647056,36,50,50,65,60,44,305,0.16363636363636364,1.0
50,35,55,25,25,15,205,0.021739130434782608,80,82,78,95,80,85,500,0.6869565217391305,1.0
1,90,45,30,30,40,236,0.33064516129032256,31,45,90,30,30,40,266,0.21929824561403508,1.0
123,100,62,97,81,68,531,0.4806201550387597,90,120,100,150,120,100,680,0.7718120805369127,1.0
80,115,80,65,55,93,488,0.7846153846153846,65,136,94,54,96,135,580,0.9612403100775194,2.0
35,60,44,40,54,55,288,0.366412213740458,90,85,75,115,100,115,580,0.9381443298969072,1.0
95,117,80,65,70,92,519,0.8409090909090909,89,145,90,105,80,91,600,0.8549618320610687,0.0
65,105,60,60,70,95,455,63.0,86,92,88,68,75,73,482,0.6835443037974683,1.0
80,50,100,100,200,50,580,0.2357142857142857,60,79,105,59,85,36,424,0.17054263565891473,2.0
60,80,95,70,85,50,440,0.2231404958677686,60,50,150,50,150,60,520,0.5206611570247934,0.5
35,65,35,65,35,65,300,0.46621621621621623,85,70,80,97,80,123,535,0.9304347826086956,0.5
35,55,40,50,50,90,320,0.6838235294117647,40,30,35,50,70,55,280,0.28205128205128205,0.5
255,10,10,75,135,55,540,0.3125,77,120,90,60,90,48,485,0.2785714285714286,1.0
45,25,50,25,25,35,205,0.13076923076923078,123,100,62,97,81,68,531,0.4806201550387597,4.0
64,165,75,93,83,75,555,0.6587301587301587,80,82,83,100,100,80,525,0.6742424242424242,1.0
95,75,80,100,110,30,490,0.24242424242424243,67,57,55,77,55,114,425,0.8879310344827587,0.5
55,45,50,45,65,80,340,0.5546218487394958,64,115,65,83,63,65,455,0.5323741007194245,1.0
60,50,70,80,80,140,480,0.8449612403100775,44,50,91,24,86,10,305,0.1981981981981982,0.5
65,83,57,95,85,105,490,0.8914728682170543,28,25,25,45,35,40,198,0.16083916083916083,1.0
100,70,70,65,65,45,415,0.1897810218978102,45,50,55,75,65,30,320,0.06293706293706294,1.0
30,45,59,30,39,57,260,0.2803030303030303,65,65,45,75,45,95,390,0.72,0.5
90,60,60,40,40,40,330,0.29545454545454547,30,45,135,45,90,30,375,0.09285714285714286,2.0
45,40,60,40,75,50,310,0.2926829268292683,95,109,105,75,85,56,525,0.34513274336283184,2.0
67,125,40,30,30,58,350,0.3431372549019608,70,60,70,87,78,85,450,0.6228070175438597,1.0
72,85,70,65,70,58,420,0.41304347826086957,126,131,95,131,98,99,680,0.8102189781021898,0.5
90,85,75,115,100,115,580,0.9381443298969072,31,45,90,30,30,40,266,0.21929824561403508,0.0
55,75,50,40,40,80,340,0.6302521008403361,50,150,50,150,50,150,600,0.9339622641509434,1.0
100,120,120,150,100,90,680,0.7880794701986755,65,50,70,95,80,65,425,0.4262295081967213,1.0
38,30,41,30,41,60,240,0.2897196261682243,80,135,85,70,95,150,615,0.9844961240310077,0.5
85,110,76,65,82,56,474,0.3933333333333333,50,50,50,50,50,50,300,0.30708661417322836,1.0
70,120,40,95,40,95,460,0.8106060606060606,70,55,95,95,110,65,490,0.48872180451127817,2.0
55,47,52,40,40,41,275,0.16806722689075632,35,45,160,30,45,70,385,0.48148148148148145,0.25
150,160,100,95,65,100,670,0.8866666666666667,62,55,52,109,94,109,481,0.7833333333333333,1.0
55,50,65,175,95,150,590,0.7818181818181819,89,124,80,55,80,55,483,0.5714285714285714,2.0
20,10,230,10,230,5,505,0.0,55,70,40,60,40,40,305,0.26956521739130435,2.0
60,70,65,125,105,90,515,0.6911764705882353,85,80,90,105,95,60,515,0.49074074074074076,1.0
95,23,48,23,48,23,260,0.046153846153846156,73,100,60,100,60,65,458,0.42657342657342656,2.0
100,103,75,120,75,127,600,0.940677966101695,60,50,70,50,90,65,385,0.39568345323741005,0.5
105,140,95,55,65,45,505,0.3,45,60,40,70,50,45,310,0.2846715328467153,1.0
40,40,35,50,100,70,335,0.5031847133757962,77,85,51,55,51,65,384,0.5163934426229508,1.0
72,58,80,103,80,97,490,0.7171052631578947,82,80,86,85,75,72,480,0.6183206106870229,1.0
79,105,70,145,80,101,580,0.8608695652173913,95,85,85,65,65,35,430,0.2571428571428571,0.0
79,85,60,55,60,71,410,0.60431654676259,67,89,116,79,116,33,500,0.2624113475177305,0.5
73,115,60,60,60,90,458,0.6694915254237288,160,110,65,65,110,30,540,0.35714285714285715,1.0
90,75,75,90,100,70,500,0.5462184873949579,20,15,20,10,55,80,200,0.2682926829268293,0.5
65,75,105,35,65,85,430,0.6940298507462687,45,25,50,25,25,35,205,0.13076923076923078,2.0
68,90,65,50,55,82,410,0.6165413533834586,105,95,80,40,80,90,490,0.753968253968254,1.0
65,150,60,115,60,115,565,0.935251798561151,110,85,95,80,95,50,515,0.2713178294573643,1.0
55,69,85,32,35,28,304,0.09302325581395349,55,45,50,45,65,80,340,0.5546218487394958,4.0
80,115,80,65,55,93,488,0.7846153846153846,105,140,95,55,65,45,505,0.3,2.0
83,80,80,135,80,121,579,0.9444444444444444,35,64,85,74,55,32,345,0.19827586206896552,1.0
35,65,35,65,35,65,300,0.46621621621621623,90,92,75,92,85,60,494,0.49586776859504134,0.5
100,100,100,100,100,100,600,0.8602941176470589,60,79,105,59,85,36,424,0.17054263565891473,1.0
45,20,50,60,120,50,345,0.24074074074074073,55,85,55,50,55,60,360,0.4233576642335766,4.0
59,59,58,90,70,73,409,0.5826086956521739,40,70,130,60,130,25,455,0.17355371900826447,1.0
65,90,50,85,45,55,390,0.371900826446281,90,100,60,90,60,80,480,0.6422764227642277,1.0
100,100,100,100,100,100,600,0.831858407079646,20,15,20,10,55,80,200,0.2682926829268293,1.0
75,65,55,65,55,69,384,0.43548387096774194,50,20,40,20,40,20,190,0.0962962962962963,1.0
100,164,150,95,120,71,700,0.5645161290322581,20,40,15,35,35,60,205,0.34285714285714286,1.0
68,85,65,165,135,100,618,0.8083333333333333,97,165,60,65,50,58,495,0.3902439024390244,1.0
80,100,70,50,60,45,405,0.25806451612903225,58,64,58,80,65,80,405,0.609271523178808,1.0
80,82,78,95,80,85,500,0.6869565217391305,80,100,123,122,120,80,625,0.56,0.5
55,95,115,45,45,35,390,0.2116788321167883,60,95,80,60,80,30,405,0.19480519480519481,0.5
60,40,60,95,60,55,370,0.4222222222222222,30,40,70,70,25,60,295,0.41353383458646614,0.5
85,97,66,105,66,65,484,0.47107438016528924,65,55,115,100,40,60,435,0.3798449612403101,2.0
79,105,70,145,80,101,580,0.8608695652173913,20,10,230,10,230,5,505,0.0,1.0
95,117,184,44,46,28,514,0.2975206611570248,68,165,95,65,115,110,618,0.8615384615384616,1.0
64,88,50,88,50,106,446,0.9111111111111111,71,73,88,120,89,59,500,0.43537414965986393,1.0
70,110,80,55,80,105,500,0.8794326241134752,40,55,30,30,30,60,245,0.43548387096774194,0.5
50,47,50,57,50,65,319,0.463768115942029,40,65,95,60,45,35,340,0.13986013986013987,0.5
75,100,66,60,66,115,482,0.918918918918919,60,79,105,59,85,36,424,0.17054263565891473,1.0
80,80,50,40,50,25,325,0.176056338028169,75,80,85,110,90,50,490,0.3548387096774194,1.0
63,120,85,90,55,55,468,0.2809917355371901,10,55,25,35,45,95,265,0.5396825396825397,2.0
60,130,80,60,60,70,460,0.5153846153846153,80,120,80,120,80,100,580,0.8478260869565217,2.0
50,35,55,25,25,15,205,0.021739130434782608,65,50,70,95,80,65,425,0.4262295081967213,2.0
109,66,84,81,99,32,471,0.2013888888888889,95,145,130,120,90,120,700,0.9398496240601504,0.0
100,50,80,60,80,50,420,0.34375,60,60,50,40,50,75,335,0.5882352941176471,0.5
35,20,65,40,65,20,245,0.02459016393442623,75,90,90,140,90,115,600,0.9481481481481482,1.0
50,70,100,40,40,30,330,0.2222222222222222,55,75,50,40,40,80,340,0.6302521008403361,2.0
50,50,150,50,150,50,500,0.2571428571428571,70,60,62,80,82,60,414,0.4375,4.0
65,150,60,115,60,115,565,0.935251798561151,50,50,62,40,62,65,329,0.4188034188034188,1.0
60,40,80,60,45,40,325,0.23529411764705882,40,40,40,70,40,20,250,0.032520325203252036,0.5
35,35,35,35,35,35,210,0.13385826771653545,56,61,65,48,45,38,313,0.17567567567567569,1.0
50,95,95,35,110,70,455,0.5179856115107914,68,165,95,65,115,110,618,0.8615384615384616,0.5
60,65,80,170,95,130,600,0.8625954198473282,45,60,32,50,32,76,295,0.5925925925925926,1.0
80,135,130,95,90,70,600,0.5181818181818182,116,55,85,107,95,29,487,0.06818181818181818,0.5
35,80,50,50,70,120,405,0.84375,35,85,45,35,35,75,310,0.6492537313432836,0.0
110,135,60,50,65,88,508,0.7744360902255639,38,30,41,30,41,60,240,0.2897196261682243,1.0
65,55,115,100,40,60,435,0.3798449612403101,70,110,80,55,80,105,500,0.8794326241134752,0.25
70,90,70,60,60,70,420,0.6390977443609023,40,45,40,35,35,56,251,0.373015873015873,1.0
75,90,140,60,60,40,465,0.3008130081300813,60,62,80,63,80,60,405,0.4336283185840708,2.0
115,45,20,45,25,20,270,0.11538461538461539,97,165,60,65,50,58,495,0.3902439024390244,0.5
42,52,67,39,56,50,306,0.2868217054263566,65,47,55,73,75,85,400,0.65,2.0
50,92,108,92,108,35,485,0.2457627118644068,51,65,65,80,75,59,395,0.4365079365079365,1.0
65,90,120,85,70,60,490,0.43410852713178294,40,60,40,40,40,30,250,0.0948905109489051,0.5
30,40,70,70,25,60,295,0.41353383458646614,60,70,50,100,50,65,395,0.5217391304347826,1.0
39,52,43,60,50,65,309,0.5041322314049587,40,45,40,62,60,60,307,0.33884297520661155,0.5
73,76,75,81,100,100,505,0.8110236220472441,90,75,85,115,90,55,510,0.3445378151260504,1.0
75,75,60,83,60,60,413,0.39344262295081966,65,90,40,45,80,75,395,0.625,1.0
83,80,75,70,70,101,479,0.8615384615384616,55,68,64,45,55,31,318,0.11666666666666667,2.0
75,125,100,70,80,45,495,0.33035714285714285,78,130,111,130,85,100,634,0.8561151079136691,1.0
61,84,65,70,70,70,420,0.5,60,67,85,77,75,116,480,0.8888888888888888,0.0
95,124,78,69,71,58,495,0.37398373983739835,50,65,107,105,107,86,520,0.7758620689655172,1.0
50,50,40,30,30,50,250,0.2781954887218045,100,100,90,150,140,90,670,0.71875,0.5
49,49,56,49,61,66,330,0.5190839694656488,55,95,55,35,75,115,430,0.9380530973451328,1.0
100,100,80,60,60,50,450,0.3050847457627119,71,82,64,64,59,112,452,0.9327731092436975,1.0
70,60,75,110,75,90,480,0.7165354330708661,40,30,32,50,52,65,269,0.3671875,1.0
40,40,50,30,30,30,220,0.0873015873015873,70,85,65,105,85,120,530,0.9262295081967213,0.5
90,60,60,40,40,40,330,0.29545454545454547,70,100,115,30,65,30,410,0.24390243902439024,2.0
50,65,107,105,107,86,520,0.7313432835820896,65,50,70,95,80,65,425,0.4262295081967213,1.0
70,95,85,55,65,70,440,0.5,65,130,60,75,60,75,465,0.689922480620155,0.0
60,50,40,85,75,95,405,0.7540983606557377,50,105,125,55,95,50,480,0.375886524822695,1.0
85,60,65,135,105,100,550,0.7518248175182481,101,72,72,99,89,29,462,0.1937984496124031,0.5
50,80,95,10,45,10,290,0.232,60,50,70,80,80,140,480,0.8449612403100775,1.0
45,60,30,80,50,65,330,0.4603174603174603,55,55,50,45,65,55,325,0.37373737373737376,1.0
65,105,60,60,70,95,455,63.0,108,130,95,80,85,102,600,0.7637795275590551,1.0
50,50,40,50,40,64,294,0.45588235294117646,125,130,90,130,90,95,660,0.7734375,0.5
83,106,65,86,65,85,490,0.6640625,40,55,30,30,30,60,245,0.43548387096774194,1.0
50,50,77,95,77,91,440,0.5916666666666667,75,123,67,95,85,95,540,0.7642276422764228,0.5
100,150,120,120,100,90,680,0.6493506493506493,55,40,85,80,105,40,405,0.23622047244094488,0.0
40,70,130,60,130,25,455,0.17355371900826447,75,125,70,125,70,115,580,0.9037037037037037,2.0
55,70,55,40,55,85,360,0.7073170731707317,65,60,70,85,75,40,395,0.1796875,1.0
150,120,100,120,100,90,680,0.664179104477612,60,79,105,59,85,36,424,0.17054263565891473,1.0
65,65,60,130,95,110,525,0.823943661971831,35,85,45,35,35,75,310,0.6492537313432836,1.0
43,70,48,50,60,38,309,0.2391304347826087,90,55,75,60,75,30,385,0.13970588235294118,0.0
65,63,45,45,45,45,308,0.2595419847328244,73,100,60,100,60,65,458,0.42657342657342656,1.0
60,80,50,40,40,30,300,0.15328467153284672,64,165,75,93,83,75,555,0.6587301587301587,1.0
100,150,120,120,100,90,680,0.6493506493506493,50,105,125,55,95,50,480,0.375886524822695,0.0
75,75,95,75,95,113,528,0.9015151515151515,50,92,108,92,108,35,485,0.2457627118644068,1.0
20,15,20,10,55,80,200,0.2682926829268293,79,100,80,110,90,121,580,0.968,1.0
41,50,37,50,37,66,281,0.5175438596491229,40,30,35,45,40,55,245,0.31496062992125984,1.0
76,147,90,60,70,97,540,0.8267716535433071,39,52,43,60,50,65,309,0.49107142857142855,1.0
50,50,77,95,77,91,440,0.5916666666666667,71,82,64,64,59,112,452,0.9327731092436975,0.0
65,90,50,85,45,55,390,0.371900826446281,55,55,55,85,55,30,335,0.1320754716981132,1.0
60,80,50,40,40,30,300,0.15328467153284672,45,45,35,20,30,20,195,0.07246376811594203,1.0
50,48,43,46,41,60,288,0.47297297297297297,30,30,42,30,42,70,244,0.4230769230769231,0.0
45,25,50,25,25,35,205,0.13076923076923078,106,150,70,194,120,140,780,0.952,2.0
40,45,40,35,35,56,251,0.373015873015873,65,50,70,95,80,65,425,0.4262295081967213,1.0
80,82,100,83,100,80,525,0.6821705426356589,90,110,80,100,80,95,555,0.7982456140350878,0.5
75,100,66,60,66,115,482,0.918918918918919,30,30,42,30,42,70,244,0.4230769230769231,1.0
80,160,60,170,130,80,680,0.6180555555555556,60,50,100,85,70,65,430,0.47580645161290325,1.0
60,70,65,125,105,90,515,0.6911764705882353,75,70,90,70,105,80,490,0.656,0.25
109,66,84,81,99,32,471,0.2013888888888889,70,50,30,95,135,105,485,0.8040540540540541,1.0
58,109,112,48,48,109,484,0.8805970149253731,40,65,40,80,40,65,330,0.5038167938931297,2.0
65,75,90,97,123,44,494,0.1987179487179487,44,50,91,24,86,10,305,0.1981981981981982,0.0
50,20,55,25,25,30,205,0.09774436090225563,82,121,119,69,59,71,521,0.5394736842105263,1.0
40,35,30,20,20,50,195,0.23423423423423423,65,105,60,60,70,95,455,63.0,0.5
50,65,107,105,107,86,520,0.7272727272727273,61,78,95,56,58,57,405,0.40336134453781514,1.0
70,85,65,105,85,120,530,0.9262295081967213,60,65,60,130,75,110,500,0.7719298245614035,0.5
100,100,80,60,60,50,450,0.3050847457627119,91,90,129,90,72,108,580,0.9140625,1.0
55,84,105,114,75,52,485,0.2890625,40,45,35,40,40,90,290,0.65,1.0
70,105,105,50,40,20,390,0.33587786259541985,50,52,48,65,50,55,320,0.33098591549295775,1.0
55,66,44,44,56,85,350,0.6888888888888889,65,45,55,45,70,45,325,0.24369747899159663,1.0
58,109,112,48,48,109,484,0.8805970149253731,60,40,60,95,60,55,370,0.4222222222222222,0.125
45,22,60,27,30,29,213,0.07518796992481203,75,69,72,114,100,104,534,0.8253968253968254,1.0
76,25,45,67,55,24,292,0.0390625,65,65,45,75,45,95,390,0.72,1.0
100,50,50,76,96,70,442,0.5,91,90,72,90,129,108,580,0.896,4.0
60,48,45,43,90,42,328,0.21897810218978103,50,105,79,35,110,76,455,0.6214285714285714,1.0
108,130,95,80,85,102,600,0.7637795275590551,80,110,60,150,130,70,600,0.5042016806722689,1.0
70,85,140,85,70,20,470,0.272,75,100,63,80,63,116,497,0.9345794392523364,1.0
78,52,60,63,65,23,341,0.06015037593984962,60,45,70,45,90,95,405,0.7304964539007093,1.0
83,106,65,86,65,85,490,0.6640625,45,50,45,115,55,95,405,0.6936936936936937,0.0
125,58,58,76,76,67,460,0.515625,45,50,55,75,65,30,320,0.06293706293706294,0.25
80,82,83,100,100,80,525,0.6742424242424242,75,90,50,110,80,95,500,0.7985611510791367,0.5
60,40,50,75,85,95,405,0.6044776119402985,35,45,160,30,45,70,385,0.48148148148148145,0.0
86,92,88,68,75,73,482,0.6835443037974683,90,120,120,60,60,50,500,0.35294117647058826,2.0
110,135,60,50,65,88,508,0.7744360902255639,65,65,60,130,95,110,525,0.823943661971831,1.0
70,120,40,95,40,95,460,0.8106060606060606,120,100,85,30,85,45,465,0.22448979591836735,0.5
75,75,55,105,85,30,425,0.1619718309859155,70,55,95,95,110,65,490,0.48872180451127817,1.0
45,45,35,20,30,20,195,0.07246376811594203,65,130,60,95,110,65,525,0.5303030303030303,0.5
108,130,95,80,85,102,600,0.7637795275590551,95,60,79,100,125,81,540,0.6201550387596899,1.0
100,128,90,77,77,128,600,0.959349593495935,55,75,60,75,60,103,428,0.7982456140350878,0.5
100,100,100,100,100,100,600,0.8805970149253731,103,60,86,60,86,50,445,0.3458646616541353,1.0
60,60,60,35,35,30,280,0.11194029850746269,55,104,105,94,75,52,485,0.36363636363636365,1.0
100,134,110,95,100,61,600,0.4057971014492754,85,50,95,120,115,80,545,0.5793650793650794,1.0
105,30,105,140,105,55,540,0.3524590163934426,108,130,95,80,85,102,600,0.7637795275590551,1.0
75,69,72,114,100,104,534,0.8253968253968254,65,100,70,80,80,105,500,0.8666666666666667,0.5
65,125,100,55,70,85,500,0.6532258064516129,60,85,69,65,79,80,438,0.576,0.5
60,62,63,80,80,60,405,0.38016528925619836,60,95,80,60,80,30,405,0.19480519480519481,0.5
50,60,60,60,60,30,320,0.11290322580645161,100,120,100,150,120,90,680,0.728,1.0
48,72,48,72,48,48,336,0.25984251968503935,89,124,80,55,80,55,483,0.5714285714285714,2.0
55,45,45,25,25,15,210,0.048,55,69,85,32,35,28,304,0.09302325581395349,1.0
75,105,75,105,75,45,480,0.3274336283185841,55,45,50,45,65,80,340,0.5546218487394958,0.5
60,85,60,85,60,55,405,0.3673469387755102,70,85,140,85,70,20,470,0.272,0.5
70,110,70,115,70,90,525,0.75,58,50,145,95,105,30,483,0.2459016393442623,0.0
75,80,60,65,90,102,472,0.8625954198473282,105,125,100,60,100,100,590,0.8359375,1.0
70,77,60,97,60,108,472,0.8394160583941606,65,85,70,75,70,40,405,0.203125,0.5
68,125,65,65,115,80,518,0.6277372262773723,70,100,115,30,65,30,410,0.24390243902439024,2.0
79,103,120,135,115,78,630,0.5763888888888888,55,50,40,40,40,75,300,0.5945945945945946,1.0
70,80,50,35,35,35,305,0.14,60,55,50,40,55,45,305,0.22377622377622378,0.25
70,83,50,37,50,60,350,0.3360655737704918,105,125,100,60,100,100,590,0.8359375,1.0
90,75,75,90,100,70,500,0.5462184873949579,69,69,76,69,86,91,460,0.6554621848739496,0.5
70,120,100,145,105,20,560,0.2824427480916031,80,105,105,105,105,80,580,0.5939849624060151,1.0
55,95,115,45,45,35,390,0.2116788321167883,86,92,88,68,75,73,482,0.6835443037974683,1.0
65,90,40,45,80,75,395,0.625,60,50,50,60,70,50,340,0.28346456692913385,4.0
90,90,85,125,90,100,580,0.768595041322314,85,115,80,105,80,50,515,0.3063063063063063,0.25
38,35,35,65,55,50,278,0.2647058823529412,92,105,90,125,90,98,600,0.8217054263565892,0.0
50,150,50,150,50,150,600,0.9339622641509434,50,65,107,105,107,86,520,0.703125,1.0
160,110,65,65,110,30,540,0.35714285714285715,70,94,50,94,50,66,424,0.48148148148148145,1.0
60,70,50,100,50,65,395,0.5217391304347826,70,110,75,145,85,145,630,0.9444444444444444,4.0
60,150,50,150,50,60,520,0.5,103,93,67,71,61,84,479,0.7142857142857143,0.5
45,22,60,27,30,29,213,0.07518796992481203,62,50,58,73,54,72,369,0.4435483870967742,0.5
65,80,65,35,65,60,370,0.38405797101449274,77,85,51,55,51,65,384,0.5163934426229508,1.0
77,59,50,67,63,46,362,0.23140495867768596,40,40,35,50,100,70,335,0.5031847133757962,0.5
67,58,57,81,67,101,431,0.8790322580645161,40,40,35,50,100,70,335,0.5031847133757962,1.0
40,40,50,30,30,30,220,0.0873015873015873,70,145,88,140,70,112,625,0.8888888888888888,0.5
106,150,70,194,120,140,780,0.952,45,50,55,75,65,30,320,0.06293706293706294,2.0
85,70,80,97,80,123,535,0.9304347826086956,30,40,70,70,25,60,295,0.41353383458646614,1.0
54,63,52,83,56,97,405,0.7697841726618705,62,73,55,56,52,84,382,0.7244094488188977,2.0
40,55,30,30,30,60,245,0.43548387096774194,71,82,64,64,59,112,452,0.9327731092436975,1.0
45,35,50,70,50,30,280,0.15753424657534246,100,150,110,95,110,70,635,0.5923076923076923,4.0
20,40,90,30,90,25,295,0.11363636363636363,75,80,70,65,75,90,455,0.7578125,1.0
81,102,77,85,75,85,505,0.5642857142857143,55,75,60,75,60,103,428,0.7982456140350878,0.0
80,80,80,80,80,80,480,0.6015037593984962,65,105,60,60,70,95,455,63.0,1.0
90,75,85,115,90,55,510,0.3445378151260504,70,95,125,65,75,45,475,0.33613445378151263,1.0
45,63,37,65,55,95,360,0.8055555555555556,45,30,35,20,20,45,195,0.14782608695652175,1.0
70,60,62,80,82,60,414,0.4375,70,80,50,35,35,35,305,0.14,1.0
80,105,65,60,75,130,515,0.9645390070921985,100,120,100,150,120,90,680,0.728,2.0
95,95,85,125,65,55,520,0.3894736842105263,80,70,65,80,120,100,515,0.8034188034188035,2.0
62,50,58,73,54,72,369,0.4435483870967742,45,55,45,65,45,75,330,0.5692307692307692,2.0
44,38,33,61,43,70,289,0.5267857142857143,61,72,57,55,55,65,365,0.3984375,1.0
100,123,75,57,75,80,510,0.6923076923076923,80,110,120,130,90,70,600,0.6198347107438017,1.0
55,69,85,32,35,28,304,0.09302325581395349,75,125,230,55,95,30,610,0.3448275862068966,1.0
95,110,95,40,95,55,490,0.40336134453781514,70,120,100,145,105,20,560,0.2824427480916031,1.0
70,140,70,110,65,105,560,0.95,100,77,77,128,128,90,600,0.6901408450704225,2.0
65,65,65,50,50,90,385,0.72,60,80,50,50,50,40,330,0.23853211009174313,1.0
62,73,55,56,52,84,382,0.7244094488188977,45,63,37,65,55,95,360,0.8055555555555556,0.5
35,40,100,90,55,35,355,0.1796875,90,60,60,40,40,40,330,0.29545454545454547,1.0
85,100,122,58,75,54,494,0.3939393939393939,80,82,78,95,80,85,500,0.6869565217391305,2.0
81,102,77,85,75,85,505,0.5642857142857143,116,55,85,107,95,29,487,0.06818181818181818,1.0
90,55,75,60,75,30,385,0.13970588235294118,75,69,72,114,100,104,534,0.8253968253968254,1.0
44,48,65,50,64,43,314,0.1623931623931624,50,85,125,85,115,20,480,0.4306569343065693,1.0
190,33,58,33,58,33,405,0.13432835820895522,125,130,90,130,90,95,660,0.7734375,1.0
48,72,48,72,48,48,336,0.25984251968503935,100,100,100,100,100,100,600,0.8602941176470589,1.0
45,63,37,65,55,95,360,0.8055555555555556,55,45,50,45,65,80,340,0.5546218487394958,1.0
75,75,75,125,95,40,485,0.15671641791044777,60,60,60,60,60,60,360,0.38095238095238093,1.0
65,150,60,115,60,115,565,0.935251798561151,106,90,130,90,154,110,680,0.8699186991869918,2.0
76,25,45,67,55,24,292,0.0390625,75,89,85,55,65,36,405,0.29545454545454547,1.0
86,81,97,81,107,43,495,0.203125,126,131,95,131,98,99,680,0.8294573643410853,1.0
115,115,85,90,75,100,580,0.8134328358208955,71,82,64,64,59,112,452,0.9327731092436975,1.0
69,69,76,69,86,91,460,0.6554621848739496,70,60,125,115,70,55,495,0.35507246376811596,1.0
80,75,150,75,150,50,580,0.30973451327433627,90,50,34,60,44,70,348,0.6283185840707964,1.0
60,95,80,60,80,30,405,0.19480519480519481,85,73,70,73,115,67,483,0.5126050420168067,2.0
100,128,90,77,77,128,600,0.959349593495935,45,85,50,55,50,65,350,0.5076923076923077,1.0
100,50,50,76,96,70,442,0.5,40,40,40,70,40,20,250,0.032520325203252036,1.0
50,48,43,46,41,60,288,0.47297297297297297,105,105,75,65,100,50,500,0.37593984962406013,2.0
75,90,50,110,80,95,500,0.7985611510791367,60,50,150,50,150,60,520,0.5206611570247934,4.0
95,125,79,60,100,81,540,0.6165413533834586,75,75,55,105,85,30,425,0.1619718309859155,1.0
70,80,70,80,70,110,480,0.6594202898550725,75,80,85,110,90,50,490,0.3548387096774194,2.0
80,145,150,105,110,110,700,0.8692307692307693,60,70,65,125,105,90,515,0.6911764705882353,2.0
50,48,43,46,41,60,288,0.47297297297297297,60,90,55,90,80,110,485,0.8677685950413223,2.0
80,125,75,40,95,85,500,0.6911764705882353,55,81,60,50,70,97,413,0.7214285714285714,2.0
70,135,105,60,105,20,495,0.5806451612903226,69,55,45,55,55,15,294,0.11666666666666667,1.0
30,40,55,40,55,60,280,0.3237410071942446,60,50,50,60,70,50,340,0.28346456692913385,1.0
105,140,55,30,55,95,480,0.8195488721804511,58,64,58,80,65,80,405,0.609271523178808,0.5
45,30,50,55,65,45,290,0.208,20,40,90,30,90,25,295,0.11363636363636363,1.0
75,95,67,125,95,83,540,0.7117117117117117,79,103,120,135,115,78,630,0.5763888888888888,0.5
40,45,65,100,120,90,460,0.5588235294117647,55,35,50,55,110,85,390,0.6277372262773723,1.0
60,52,168,47,138,30,495,0.19834710743801653,60,60,60,60,60,60,360,0.38095238095238093,1.0
55,50,65,175,95,150,590,0.7818181818181819,35,80,50,50,70,120,405,0.84375,2.0
55,85,122,58,75,99,494,0.8099173553719008,75,95,122,58,75,69,494,0.5725806451612904,1.0
40,45,40,62,60,60,307,0.33884297520661155,55,66,44,44,56,85,350,0.6888888888888889,1.0
60,62,80,63,80,60,405,0.4336283185840708,90,100,70,110,150,80,600,0.6037735849056604,0.5
80,100,80,80,80,100,520,0.9051724137931034,80,95,82,60,82,75,474,0.6,2.0
75,38,38,56,56,67,330,0.5263157894736842,55,85,55,50,55,60,360,0.4233576642335766,2.0
55,55,55,85,55,30,335,0.1320754716981132,91,72,90,129,90,108,580,0.8620689655172413,1.0
70,55,55,80,60,45,365,0.2222222222222222,75,95,95,95,95,85,540,0.6470588235294118,1.0
31,45,90,30,30,40,266,0.21929824561403508,37,25,41,25,41,25,194,0.08870967741935484,0.5
99,68,83,72,87,51,460,0.417910447761194,67,82,62,46,48,43,348,0.22033898305084745,2.0
65,130,60,75,60,75,465,0.689922480620155,90,60,60,40,40,40,330,0.29545454545454547,1.0
30,35,30,100,35,80,310,0.4765625,100,150,140,100,90,90,670,0.7969924812030075,0.5
79,103,120,135,115,78,630,0.5763888888888888,45,60,40,70,50,45,310,0.2846715328467153,2.0
50,65,107,105,107,86,520,0.7272727272727273,91,72,90,129,90,108,580,0.8620689655172413,4.0
40,55,30,30,30,60,245,0.43548387096774194,70,115,60,115,60,55,475,0.4647887323943662,2.0
72,60,30,20,30,25,237,0.11570247933884298,50,70,160,70,160,90,600,0.7417218543046358,0.5
60,85,60,50,50,125,430,0.9090909090909091,97,165,60,65,50,58,495,0.3902439024390244,0.25
35,60,44,40,54,55,288,0.366412213740458,80,100,70,50,60,45,405,0.25806451612903225,1.0
75,80,55,25,35,35,305,0.18666666666666668,66,117,70,40,50,67,410,0.4573643410852713,1.0
40,60,30,31,31,70,262,0.4492753623188406,60,48,45,43,90,42,328,0.21897810218978103,1.0
120,70,120,75,130,85,600,0.6694915254237288,100,100,125,110,50,50,535,0.384,1.0
75,98,63,98,63,101,498,0.889763779527559,45,50,35,55,75,40,300,0.21367521367521367,0.5
74,48,76,83,81,104,466,0.7913043478260869,60,50,100,85,70,65,430,0.47580645161290325,1.0
75,110,110,110,105,80,590,0.656934306569343,50,65,64,44,48,43,314,0.2196969696969697,1.0
90,100,60,90,60,80,480,0.6422764227642277,100,70,70,65,65,45,415,0.1897810218978102,1.0
105,150,90,150,90,95,680,0.8285714285714286,72,95,67,103,71,122,530,0.9606299212598425,1.0
59,110,150,45,49,35,448,0.3333333333333333,75,90,50,110,80,95,500,0.7985611510791367,0.25
50,25,28,45,55,15,218,0.0625,76,65,45,92,42,91,411,0.7449664429530202,1.0
70,70,40,60,40,60,340,0.4247787610619469,80,95,82,60,82,75,474,0.6,0.5
45,60,40,70,50,45,310,0.2846715328467153,45,100,135,65,135,45,525,0.29411764705882354,1.0
62,44,50,44,50,55,305,0.3629032258064516,95,23,48,23,48,23,260,0.046153846153846156,1.0
35,80,50,50,70,120,405,0.84375,50,50,77,95,77,91,440,0.5916666666666667,2.0
79,115,70,125,80,111,580,0.8468468468468469,90,100,60,90,60,80,480,0.6422764227642277,2.0
90,120,120,60,60,50,500,0.35294117647058826,45,50,55,75,65,30,320,0.06293706293706294,1.0
25,35,70,95,55,45,325,0.16783216783216784,55,55,45,63,45,45,308,0.25,1.0
60,50,50,60,70,50,340,0.28346456692913385,70,115,60,115,60,55,475,0.4647887323943662,0.25
91,72,90,129,90,108,580,0.8925619834710744,75,95,60,65,60,115,470,0.8778625954198473,2.0
70,45,48,60,65,35,323,0.15748031496062992,46,57,40,40,40,50,273,0.25,0.5
100,150,110,95,110,70,635,0.5923076923076923,70,95,125,65,75,45,475,0.33613445378151263,2.0
65,55,115,100,40,60,435,0.3798449612403101,60,70,65,125,105,90,515,0.6911764705882353,0.25
100,50,50,76,96,70,442,0.5,65,40,50,125,60,30,370,0.07258064516129033,1.0
95,117,184,44,46,28,514,0.2975206611570248,55,50,65,175,95,150,590,0.7818181818181819,1.0
95,80,105,40,70,100,490,0.8046875,100,50,50,76,96,70,442,0.5,1.0
45,85,50,55,50,65,350,0.5076923076923077,105,140,95,55,65,45,505,0.3,1.0
60,50,70,80,80,140,480,0.8449612403100775,80,50,100,100,200,50,580,0.2357142857142857,1.0
70,94,50,94,50,66,424,0.48148148148148145,80,120,79,95,79,70,523,0.5833333333333334,0.5
95,117,184,44,46,28,514,0.2975206611570248,95,65,65,110,130,60,525,0.4016393442622951,1.0
100,110,90,85,90,60,535,0.47794117647058826,64,165,75,93,83,75,555,0.6587301587301587,1.0
55,55,50,45,65,55,325,0.37373737373737376,70,60,70,87,78,85,450,0.6228070175438597,1.0
125,170,100,120,90,95,700,0.77,45,67,60,35,50,63,320,0.5128205128205128,0.5
68,72,78,38,42,32,330,0.23809523809523808,91,72,90,129,90,108,580,0.8620689655172413,1.0
65,90,122,58,75,84,494,0.71875,70,20,50,20,50,40,250,0.1557377049180328,2.0
130,70,35,70,35,60,400,0.4017857142857143,45,49,65,49,65,45,318,0.275,0.5
85,56,77,50,77,78,423,0.53125,55,70,40,60,40,40,305,0.26956521739130435,1.0
30,40,55,40,55,60,280,0.3237410071942446,35,55,40,45,40,60,275,0.35714285714285715,1.0
50,64,50,45,50,41,300,0.22727272727272727,45,60,30,80,50,65,330,0.4603174603174603,4.0
75,100,63,80,63,116,497,0.9345794392523364,70,95,125,65,75,45,475,0.33613445378151263,1.0
30,45,55,70,55,85,340,0.5633802816901409,64,66,68,81,76,50,405,0.25190839694656486,0.5
50,180,20,180,20,150,600,0.9029850746268657,65,130,60,95,110,65,525,0.5303030303030303,1.0
50,65,107,105,107,86,520,0.7272727272727273,60,80,110,50,80,45,425,0.2833333333333333,0.0
50,65,45,85,65,95,405,0.7238095238095238,40,30,30,55,30,85,270,0.4666666666666667,1.0
40,60,40,40,40,30,250,0.0948905109489051,64,165,75,93,83,75,555,0.6587301587301587,0.25
60,60,50,40,50,75,335,0.5882352941176471,85,90,80,70,80,130,535,0.9262295081967213,0.25
95,65,65,110,130,60,525,0.4016393442622951,55,63,90,50,80,42,380,0.21138211382113822,1.0
70,110,70,115,70,90,525,0.75,49,49,56,49,61,66,330,0.5190839694656488,0.5
95,125,79,60,100,81,540,0.6165413533834586,45,100,135,65,135,45,525,0.29411764705882354,1.0
20,15,20,10,55,80,200,0.2682926829268293,55,130,115,50,50,75,475,0.5982142857142857,0.5
75,75,130,75,130,95,580,0.7479674796747967,90,120,120,60,60,50,500,0.35294117647058826,2.0
85,60,65,135,105,100,550,0.7518248175182481,40,60,30,31,31,70,262,0.4492753623188406,0.5
106,110,90,154,90,130,680,0.926829268292683,50,50,77,95,77,91,440,0.5916666666666667,1.0
45,60,32,50,32,76,295,0.5925925925925926,75,95,122,58,75,69,494,0.5725806451612904,0.5
60,60,60,35,35,30,280,0.11194029850746269,70,70,70,70,70,70,420,0.5289256198347108,1.0
60,45,70,45,90,95,405,0.7304964539007093,77,120,90,60,90,48,485,0.2785714285714286,0.5
30,56,35,25,35,72,253,0.48148148148148145,60,80,110,50,80,45,425,0.2833333333333333,1.0
70,105,105,50,40,20,390,0.33587786259541985,50,45,45,35,35,50,260,0.23529411764705882,1.0
70,100,115,30,65,30,410,0.24390243902439024,95,155,109,70,130,81,640,0.6788321167883211,1.0
54,63,52,83,56,97,405,0.7697841726618705,50,50,95,40,50,35,320,0.20279720279720279,2.0
67,58,57,81,67,101,431,0.8790322580645161,54,78,103,53,45,22,355,0.23255813953488372,2.0
54,78,103,53,45,22,355,0.23255813953488372,55,40,40,65,45,35,280,0.16428571428571428,1.0
38,35,35,65,55,50,278,0.2647058823529412,45,90,20,65,20,65,305,0.5116279069767442,0.0
40,30,35,50,70,55,280,0.28205128205128205,80,120,79,95,79,70,523,0.5833333333333334,1.0
65,73,55,47,75,85,400,0.6846846846846847,50,95,95,35,110,70,455,0.5179856115107914,0.5
50,50,40,30,30,50,250,0.2781954887218045,65,80,140,40,70,70,465,0.5223880597014925,0.0
64,51,23,51,23,28,240,0.11363636363636363,100,180,160,150,90,90,770,0.7520661157024794,1.0
25,35,70,95,55,45,325,0.16783216783216784,44,75,35,63,33,45,295,0.2647058823529412,1.0
40,30,35,45,40,55,245,0.31496062992125984,45,50,43,40,38,62,278,0.40441176470588236,1.0
75,90,90,140,90,115,600,0.9481481481481482,50,180,20,180,20,150,600,0.9029850746268657,2.0
40,70,40,35,40,60,285,0.392,62,55,52,109,94,109,481,0.7833333333333333,2.0
60,110,70,60,60,100,460,0.8461538461538461,50,50,40,50,40,64,294,0.45588235294117646,1.0
45,22,60,27,30,29,213,0.07518796992481203,71,120,95,120,95,99,600,0.8203125,0.5
65,95,57,100,85,93,495,0.7441860465116279,80,145,150,105,110,110,700,0.8692307692307693,2.0
50,65,107,105,107,86,520,0.703125,70,55,95,95,110,65,490,0.48872180451127817,1.0
60,30,30,36,56,50,262,0.32432432432432434,60,85,69,60,69,77,420,0.518796992481203,1.0
100,5,5,15,65,30,220,0.07692307692307693,54,78,103,53,45,22,355,0.23255813953488372,0.5
45,50,55,75,65,30,320,0.06293706293706294,70,83,50,37,50,60,350,0.3360655737704918,0.5
40,30,30,40,50,30,220,0.07936507936507936,95,85,85,65,65,35,430,0.2571428571428571,4.0
40,55,30,30,30,60,245,0.43548387096774194,45,80,100,35,37,28,325,0.3125,0.0
62,44,50,44,50,55,305,0.3629032258064516,55,55,50,45,65,55,325,0.37373737373737376,1.0
108,112,118,68,72,47,525,0.2916666666666667,60,70,65,125,105,90,515,0.6911764705882353,1.0
72,58,80,103,80,97,490,0.7171052631578947,70,70,40,60,40,60,340,0.4247787610619469,0.0
50,64,50,45,50,41,300,0.22727272727272727,75,140,65,112,65,110,567,0.9140625,0.0
58,50,145,95,105,30,483,0.2459016393442623,70,120,40,95,40,95,460,0.8106060606060606,0.5
75,70,90,70,105,80,490,0.656,70,120,100,145,105,20,560,0.2824427480916031,1.0
100,180,160,150,90,90,770,0.7520661157024794,38,41,40,50,65,65,299,0.4108527131782946,1.0
42,52,67,39,56,50,306,0.2868217054263566,75,69,72,114,100,104,534,0.8253968253968254,4.0
68,165,95,65,115,110,618,0.8615384615384616,70,55,55,80,60,45,365,0.2222222222222222,1.0
70,94,50,94,50,66,424,0.48148148148148145,85,105,55,85,50,115,495,0.9032258064516129,1.0
90,65,65,40,40,15,315,0.19672131147540983,43,30,55,40,65,97,330,0.6030534351145038,0.5
75,75,55,105,85,30,425,0.1619718309859155,84,86,88,111,101,60,530,0.4634146341463415,1.0
45,30,40,105,50,20,290,0.031007751937984496,20,25,45,70,90,60,310,0.30833333333333335,0.5
60,75,85,100,85,115,520,0.8992248062015504,45,20,50,60,120,50,345,0.24074074074074073,0.5
50,20,40,20,40,20,190,0.0962962962962963,88,107,122,74,75,64,530,0.4596774193548387,2.0
50,100,150,100,150,50,600,0.37142857142857144,64,88,50,88,50,106,446,0.9111111111111111,2.0
60,85,69,60,69,77,420,0.518796992481203,60,100,89,55,69,112,485,0.9298245614035088,1.0
59,45,40,35,40,31,250,0.14285714285714285,45,25,50,25,25,35,205,0.13076923076923078,1.0
50,50,120,80,80,30,410,0.07258064516129033,60,90,140,50,50,40,430,0.2535211267605634,0.5
85,50,95,120,115,80,545,0.5793650793650794,50,160,110,160,110,110,700,0.8854961832061069,0.5
105,140,55,30,55,95,480,0.8195488721804511,85,60,65,135,105,100,550,0.7518248175182481,1.0
130,65,60,110,95,65,525,0.5227272727272727,45,22,60,27,30,29,213,0.07518796992481203,1.0
50,65,107,105,107,86,520,0.6991150442477876,100,100,100,100,100,100,600,0.8758169934640523,2.0
57,24,86,24,86,23,300,0.12727272727272726,91,129,90,72,90,108,580,0.8536585365853658,2.0
85,56,77,50,77,78,423,0.53125,65,65,60,110,95,130,525,0.9253731343283582,2.0
75,80,55,25,35,35,305,0.18666666666666668,65,155,120,65,90,105,600,0.8677685950413223,0.25
66,117,70,40,50,67,410,0.4573643410852713,190,33,58,33,58,33,405,0.13432835820895522,1.0
45,40,60,40,75,50,310,0.2926829268292683,76,147,90,60,70,97,540,0.8267716535433071,1.0
65,80,65,35,65,60,370,0.38405797101449274,40,30,35,50,70,55,280,0.28205128205128205,1.0
80,80,80,55,55,90,440,0.6417910447761194,50,95,95,35,110,70,455,0.5179856115107914,1.0
70,105,105,50,40,20,390,0.33587786259541985,50,85,125,85,115,20,480,0.4306569343065693,1.0
45,60,40,70,50,45,310,0.2846715328467153,110,123,65,100,65,65,528,0.5217391304347826,0.5
40,30,32,50,52,65,269,0.3671875,106,90,130,90,154,110,680,0.8699186991869918,1.0
40,45,40,65,40,65,295,0.5661764705882353,45,63,37,65,55,95,360,0.8055555555555556,0.5
50,55,50,36,30,43,264,0.2922077922077922,58,64,58,80,65,80,405,0.5423728813559322,1.0
50,50,50,50,50,50,300,0.30708661417322836,60,85,60,85,60,55,405,0.3673469387755102,0.5
91,134,95,100,100,80,600,0.6304347826086957,80,92,65,65,80,68,450,0.4824561403508772,1.0
100,100,125,110,50,50,535,0.384,30,45,55,70,55,85,340,0.5633802816901409,2.0
80,90,80,130,110,110,600,0.856,126,131,95,131,98,99,680,0.8294573643410853,0.0
50,95,95,35,110,70,455,0.5179856115107914,50,70,50,50,50,70,340,0.5645161290322581,1.0
60,130,80,60,60,70,460,0.5153846153846153,60,65,70,85,75,40,395,0.21705426356589147,0.125
45,49,49,65,65,45,318,0.2781954887218045,91,134,95,100,100,80,600,0.6304347826086957,0.25
74,48,76,83,81,104,466,0.7913043478260869,65,95,75,55,55,85,430,0.6933333333333334,2.0
86,76,86,116,56,95,515,0.7982456140350878,70,55,65,95,85,70,440,0.5307692307692308,1.0
60,62,80,63,80,60,405,0.4336283185840708,50,48,43,46,41,60,288,0.47297297297297297,4.0
35,70,55,45,55,25,285,0.09420289855072464,40,80,35,35,45,70,305,0.4661016949152542,0.5
58,70,45,40,45,42,300,0.25925925925925924,60,110,70,60,60,100,460,0.8461538461538461,0.0
100,100,125,110,50,50,535,0.384,45,45,35,20,30,20,195,0.07246376811594203,0.5
76,104,71,104,71,108,534,0.912751677852349,100,150,110,95,110,70,635,0.5923076923076923,0.5
74,100,72,90,72,46,454,0.24561403508771928,20,40,15,35,35,60,205,0.34285714285714286,1.0
60,60,75,60,75,80,410,0.7321428571428571,80,125,75,40,95,85,500,0.6911764705882353,0.5
106,110,90,154,90,130,680,0.926829268292683,50,20,55,25,25,30,205,0.09774436090225563,1.0
100,150,120,120,100,90,680,0.6493506493506493,80,100,70,50,60,45,405,0.25806451612903225,1.0
31,45,90,30,30,40,266,0.21929824561403508,111,83,68,92,82,39,475,0.1774193548387097,1.0
125,130,90,130,90,95,660,0.7734375,65,76,84,54,96,105,480,0.9008264462809917,1.0
76,65,45,92,42,91,411,0.7449664429530202,71,95,85,110,95,79,535,0.664,1.0
115,140,130,55,55,40,535,0.4519230769230769,100,100,100,100,100,100,600,0.8602941176470589,0.5
50,50,95,40,50,35,320,0.20279720279720279,82,80,86,85,75,72,480,0.6183206106870229,1.0
70,115,60,115,60,55,475,0.4647887323943662,80,80,80,80,80,80,480,0.5606060606060606,2.0
65,95,75,55,55,85,430,0.6933333333333334,50,85,55,65,65,90,410,0.7478260869565218,2.0
70,135,105,60,105,20,495,0.5806451612903226,105,105,75,65,100,50,500,0.37593984962406013,0.5
55,75,85,25,25,15,280,0.1875,60,48,45,43,90,42,328,0.21897810218978103,1.0
90,55,75,60,75,30,385,0.13970588235294118,45,35,50,70,50,30,280,0.15753424657534246,1.0
60,59,85,79,105,36,424,0.16666666666666666,77,120,90,60,90,48,485,0.2785714285714286,0.5
50,105,125,55,95,50,480,0.375886524822695,80,105,65,60,75,130,515,0.9645390070921985,2.0
36,50,50,65,60,44,305,0.16363636363636364,255,10,10,75,135,55,540,0.3125,1.0
55,112,45,74,45,70,401,0.559322033898305,65,90,40,45,80,75,395,0.625,4.0
103,60,126,80,126,50,545,0.36363636363636365,80,135,85,70,95,150,615,0.9844961240310077,0.5
40,80,100,30,30,20,300,0.11851851851851852,84,71,43,71,43,48,360,0.25874125874125875,1.0
95,145,130,120,90,120,700,0.9398496240601504,82,121,119,69,59,71,521,0.5394736842105263,1.0
38,30,41,30,41,60,240,0.2897196261682243,110,78,73,76,71,60,468,0.3333333333333333,1.0
120,70,120,75,130,85,600,0.6694915254237288,55,75,50,40,40,80,340,0.6302521008403361,1.0
60,52,168,47,138,30,495,0.19834710743801653,70,85,140,85,70,20,470,0.272,1.0
79,100,80,110,90,121,580,0.968,75,70,90,70,105,80,490,0.656,1.0
61,84,65,70,70,70,420,0.5,79,115,70,125,80,111,580,0.864,1.0
58,70,45,40,45,42,300,0.25925925925925924,65,60,110,130,95,65,525,0.47761194029850745,1.0
76,104,71,104,71,108,534,0.912751677852349,65,70,60,65,65,115,440,0.8583333333333333,2.0
75,95,60,65,60,115,470,0.8778625954198473,70,77,60,97,60,108,472,0.8394160583941606,1.0
60,65,70,85,75,40,395,0.21705426356589147,70,60,70,87,78,85,450,0.6228070175438597,1.0
103,93,67,71,61,84,479,0.7142857142857143,123,77,72,99,92,58,521,0.4621212121212121,0.5
75,55,70,55,95,110,460,0.8444444444444444,75,125,75,30,75,85,465,0.625,2.0
75,123,67,95,85,95,540,0.7642276422764228,79,100,80,110,90,121,580,0.968,2.0
80,95,82,60,82,75,474,0.6,106,190,100,154,100,130,780,0.9259259259259259,1.0
78,70,61,50,61,100,420,0.8145161290322581,45,75,60,40,30,50,300,0.304,1.0
35,55,35,30,30,35,220,0.23684210526315788,40,40,50,30,30,30,220,0.0873015873015873,1.0
25,20,15,105,55,90,310,0.32407407407407407,45,20,50,60,120,50,345,0.24074074074074073,1.0
55,45,50,45,65,80,340,0.5546218487394958,70,90,90,135,90,125,600,0.9401709401709402,1.0
49,49,56,49,61,66,330,0.5190839694656488,76,48,48,57,62,34,325,0.11688311688311688,0.5
57,80,91,80,87,75,470,0.5737704918032787,65,45,55,45,70,45,325,0.24369747899159663,0.5
50,70,50,50,50,70,340,0.5645161290322581,45,85,70,40,40,60,340,0.5229357798165137,1.0
60,60,60,105,105,105,495,0.848,70,60,75,110,75,90,480,0.7165354330708661,1.0
72,60,30,20,30,25,237,0.11570247933884298,100,100,100,100,100,100,600,0.8758169934640523,1.0
95,155,109,70,130,81,640,0.6788321167883211,67,82,62,46,48,43,348,0.22033898305084745,0.5
62,77,62,50,42,65,358,0.4838709677419355,70,80,102,80,102,40,474,0.2677165354330709,2.0
100,120,120,150,100,90,680,0.7880794701986755,80,50,100,100,200,50,580,0.2357142857142857,2.0
103,93,67,71,61,84,479,0.7142857142857143,70,150,140,65,100,75,600,0.55,0.0
40,30,35,50,70,55,280,0.28205128205128205,45,45,35,20,30,20,195,0.07246376811594203,0.5
75,123,67,95,85,95,540,0.7642276422764228,10,55,25,35,45,95,265,0.5396825396825397,0.0
115,115,85,90,75,100,580,0.8134328358208955,40,45,40,35,35,56,251,0.373015873015873,1.0
60,100,89,55,69,112,485,0.9298245614035088,65,63,45,45,45,45,308,0.2595419847328244,0.5
92,105,90,125,90,98,600,0.8217054263565892,70,20,50,20,50,40,250,0.1557377049180328,0.0
65,125,100,55,70,85,500,0.6532258064516129,65,75,70,95,70,95,470,0.7272727272727273,1.0
95,75,110,100,80,30,490,0.15267175572519084,45,20,50,60,120,50,345,0.24074074074074073,0.5
45,63,37,65,55,95,360,0.8055555555555556,55,70,55,40,55,85,360,0.7073170731707317,1.0
65,60,110,130,95,65,525,0.47761194029850745,91,90,106,130,106,77,600,0.648854961832061,0.25
80,82,83,100,100,80,525,0.6742424242424242,89,124,80,55,80,55,483,0.5714285714285714,0.5
40,55,30,30,30,60,245,0.43548387096774194,110,130,80,70,60,80,530,0.5862068965517241,1.0
60,85,40,30,45,68,328,0.6422018348623854,65,80,80,59,63,58,405,0.4411764705882353,1.0
104,91,63,91,73,68,490,0.5118110236220472,115,45,20,45,25,20,270,0.11538461538461539,1.0
65,130,60,75,60,75,465,0.689922480620155,50,180,20,180,20,150,600,0.9029850746268657,2.0
65,90,65,61,61,100,442,0.8373983739837398,37,25,41,25,41,25,194,0.08870967741935484,2.0
85,76,64,45,55,90,415,0.6739130434782609,60,150,50,150,50,60,520,0.5,0.0
60,75,85,100,85,115,520,0.8992248062015504,85,80,70,135,75,90,535,0.7006802721088435,1.0
90,95,105,165,110,45,610,0.2890625,60,60,40,65,45,35,305,0.15833333333333333,0.0
70,120,100,145,105,20,560,0.2824427480916031,80,145,150,105,110,110,700,0.8692307692307693,4.0
40,40,55,40,70,55,300,0.40939597315436244,75,75,130,75,130,95,580,0.7479674796747967,0.5
59,59,58,90,70,73,409,0.5826086956521739,90,85,75,115,100,115,580,0.9381443298969072,1.0
44,75,35,63,33,45,295,0.2647058823529412,60,55,50,40,55,45,305,0.22377622377622378,1.0
55,65,35,60,30,85,330,0.6126126126126126,125,120,90,170,100,95,700,0.78125,0.5
65,80,65,35,65,60,370,0.38405797101449274,65,65,60,130,95,110,525,0.823943661971831,1.0
67,125,40,30,30,58,350,0.3431372549019608,95,23,48,23,48,23,260,0.046153846153846156,1.0
45,60,45,25,45,55,275,0.29,75,75,55,105,85,30,425,0.1619718309859155,1.0
55,70,55,40,55,85,360,0.7073170731707317,60,45,70,75,85,55,390,0.3008130081300813,1.0
80,110,120,130,90,70,600,0.6198347107438017,60,55,50,40,55,45,305,0.22377622377622378,2.0
60,50,50,60,70,50,340,0.28346456692913385,40,50,90,30,55,65,330,0.44680851063829785,0.25
65,65,45,75,45,95,390,0.72,79,100,80,110,90,121,580,0.968,0.5
65,55,115,100,40,60,435,0.3798449612403101,55,85,55,50,55,60,360,0.4233576642335766,0.25
59,110,150,45,49,35,448,0.3333333333333333,66,65,48,62,57,52,350,0.36220472440944884,1.0
85,80,70,135,75,90,535,0.7006802721088435,75,87,63,87,63,98,473,0.865546218487395,1.0
60,55,90,145,90,80,520,0.6071428571428571,40,45,35,30,40,55,245,0.3793103448275862,1.0
95,80,105,40,70,100,490,0.8046875,83,80,80,135,80,121,579,0.9444444444444444,1.0
40,55,30,30,30,60,245,0.43548387096774194,30,80,90,55,45,55,355,0.4295774647887324,0.25
100,73,83,73,83,55,467,0.371900826446281,70,55,95,95,110,65,490,0.48872180451127817,1.0
75,87,63,87,63,98,473,0.865546218487395,70,70,115,130,90,60,535,0.5338983050847458,0.25
70,115,60,115,60,55,475,0.4647887323943662,25,35,70,95,55,45,325,0.16783216783216784,0.5
73,95,62,85,65,85,465,0.6666666666666666,50,70,50,50,50,40,310,0.16296296296296298,1.0
106,130,90,110,154,90,680,0.719626168224299,55,45,43,55,43,72,313,0.5853658536585366,1.0
50,95,180,85,45,70,525,0.5298507462686567,108,130,95,80,85,102,600,0.7637795275590551,4.0
50,53,62,58,63,44,330,0.13709677419354838,55,40,50,65,85,40,335,0.3181818181818182,0.5
70,140,230,60,80,50,630,0.32432432432432434,40,55,70,45,60,30,300,0.10619469026548672,0.5
75,95,95,95,95,85,540,0.6470588235294118,75,89,85,55,65,36,405,0.29545454545454547,0.5
70,80,65,90,65,85,455,0.578125,75,87,63,87,63,98,473,0.865546218487395,1.0
65,63,45,45,45,45,308,0.2595419847328244,80,105,105,105,105,80,580,0.5939849624060151,1.0
65,90,50,85,45,55,390,0.371900826446281,70,55,95,95,110,65,490,0.48872180451127817,1.0
80,90,80,130,110,110,600,0.856,55,68,64,45,55,31,318,0.11666666666666667,1.0
76,104,71,104,71,108,534,0.912751677852349,60,82,45,45,45,74,351,0.5752212389380531,2.0
60,59,85,79,105,36,424,0.16666666666666666,46,87,60,30,40,57,320,0.37777777777777777,0.5
80,80,80,80,80,80,480,0.5606060606060606,75,95,95,95,95,85,540,0.6470588235294118,0.25
130,65,60,110,95,65,525,0.5227272727272727,50,65,107,105,107,86,520,0.7272727272727273,1.0
60,60,50,40,50,75,335,0.5882352941176471,80,80,90,110,130,110,600,0.8721804511278195,0.5
30,65,100,45,25,40,305,0.1891891891891892,38,35,40,27,25,35,200,0.08208955223880597,1.0
75,100,66,60,66,115,482,0.918918918918919,65,90,120,85,70,60,490,0.43410852713178294,1.0
1,90,45,30,30,40,236,0.33064516129032256,65,65,45,75,45,95,390,0.72,0.5
65,50,70,95,80,65,425,0.4262295081967213,38,35,35,65,55,50,278,0.2647058823529412,0.5
40,30,30,40,50,30,220,0.07936507936507936,71,73,88,120,89,59,500,0.43537414965986393,1.0
50,30,55,65,55,20,275,0.13675213675213677,54,66,70,44,55,46,335,0.4214876033057851,4.0
44,38,39,61,79,42,303,0.2251655629139073,50,180,20,180,20,150,600,0.9029850746268657,1.0
70,110,80,55,80,105,500,0.8794326241134752,105,180,100,180,100,115,780,0.9477611940298507,0.5
30,45,55,70,55,85,340,0.5633802816901409,80,80,80,80,80,80,480,0.6015037593984962,1.0
60,60,40,65,45,35,305,0.15833333333333333,75,95,67,125,95,83,540,0.7117117117117117,1.0
73,95,62,85,65,85,465,0.6666666666666666,90,85,100,95,125,85,580,0.6834532374100719,1.0
50,20,40,20,40,20,190,0.0962962962962963,25,20,15,105,55,90,310,0.32407407407407407,1.0
67,57,55,77,55,114,425,0.8879310344827587,75,75,130,75,130,95,580,0.7479674796747967,0.5
255,10,10,75,135,55,540,0.3125,50,65,107,105,107,86,520,0.7758620689655172,1.0
85,50,95,120,115,80,545,0.5793650793650794,50,65,107,105,107,86,520,0.7758620689655172,0.5
40,80,35,35,45,70,305,0.4661016949152542,30,35,30,100,35,80,310,0.4765625,0.0
75,90,50,110,80,95,500,0.7985611510791367,109,66,84,81,99,32,471,0.2013888888888889,1.0
110,130,80,70,60,80,530,0.5862068965517241,255,10,10,75,135,55,540,0.3125,1.0
55,95,55,35,75,115,430,0.9380530973451328,40,20,30,40,80,55,265,0.22764227642276422,2.0
1,90,45,30,30,40,236,0.33064516129032256,82,121,119,69,59,71,521,0.5394736842105263,1.0
75,89,85,55,65,36,405,0.29545454545454547,85,80,70,135,75,90,535,0.7006802721088435,1.0
91,134,95,100,100,80,600,0.6304347826086957,80,82,100,83,100,80,525,0.6821705426356589,2.0
75,98,63,98,63,101,498,0.889763779527559,100,5,5,15,65,30,220,0.07692307692307693,1.0
45,25,50,25,25,35,205,0.13076923076923078,45,45,35,20,30,20,195,0.07246376811594203,1.0
75,100,63,80,63,116,497,0.9345794392523364,50,45,45,35,35,50,260,0.23529411764705882,1.0
78,70,61,50,61,100,420,0.8145161290322581,110,65,105,55,95,80,510,0.6258503401360545,1.0
100,120,120,150,100,90,680,0.7880794701986755,45,65,34,40,34,45,263,0.2589928057553957,0.5
50,47,50,57,50,65,319,0.463768115942029,60,85,69,65,79,80,438,0.576,0.5
75,80,95,90,100,50,490,0.2158273381294964,81,102,77,85,75,85,505,0.5642857142857143,1.0
50,60,45,100,80,65,400,0.45689655172413796,50,160,110,160,110,110,700,0.8854961832061069,2.0
35,45,160,30,45,70,385,0.48148148148148145,103,60,126,80,126,50,545,0.36363636363636365,1.0
80,90,80,130,110,110,600,0.856,55,95,115,45,45,35,390,0.2116788321167883,2.0
70,50,30,95,135,105,485,0.8040540540540541,55,55,55,85,55,30,335,0.1320754716981132,1.0
40,55,80,35,60,30,300,0.15037593984962405,85,70,80,97,80,123,535,0.9304347826086956,1.0
76,147,90,60,70,97,540,0.8267716535433071,78,84,78,109,85,100,534,0.8620689655172413,1.0
82,80,86,85,75,72,480,0.6183206106870229,45,63,37,65,55,95,360,0.8055555555555556,1.0
40,45,35,65,55,70,310,0.4482758620689655,91,72,90,129,90,108,580,0.8925619834710744,2.0
95,80,105,40,70,100,490,0.8046875,35,65,35,65,35,65,300,0.46621621621621623,1.0
50,20,40,20,40,20,190,0.0962962962962963,65,65,45,75,45,95,390,0.72,1.0
56,61,65,48,45,38,313,0.17567567567567569,43,80,65,50,35,35,308,0.14193548387096774,2.0
65,150,40,15,80,145,495,0.9663865546218487,55,65,35,60,30,85,330,0.6126126126126126,1.0
40,27,60,37,50,66,280,0.36220472440944884,80,75,150,75,150,50,580,0.30973451327433627,0.25
70,140,70,110,65,105,560,0.95,35,55,40,45,40,60,275,0.35714285714285715,1.0
59,63,80,65,80,58,405,0.41843971631205673,67,125,40,30,30,58,350,0.3431372549019608,2.0
70,83,50,37,50,60,350,0.3360655737704918,50,50,50,50,50,50,300,0.30708661417322836,1.0
70,70,115,130,90,60,535,0.5338983050847458,70,150,140,65,100,75,600,0.55,0.5
58,50,145,95,105,30,483,0.2459016393442623,90,92,87,75,85,76,505,0.5409836065573771,1.0
74,48,76,83,81,104,466,0.7913043478260869,55,45,50,45,65,80,340,0.5546218487394958,1.0
40,30,35,45,40,55,245,0.31496062992125984,125,120,90,170,100,95,700,0.78125,2.0
55,45,43,55,43,72,313,0.5853658536585366,35,80,50,50,70,120,405,0.84375,2.0
42,52,67,39,56,50,306,0.2868217054263566,30,30,42,30,42,70,244,0.4230769230769231,4.0
74,108,133,83,65,32,495,0.32142857142857145,60,82,45,45,45,74,351,0.5752212389380531,1.0
50,45,45,35,35,50,260,0.23529411764705882,35,35,40,35,55,50,250,0.40336134453781514,1.0
50,85,85,55,55,50,380,0.3902439024390244,150,80,44,90,54,80,498,0.625,1.0
100,100,100,100,100,100,600,0.8345864661654135,55,104,105,94,75,52,485,0.36363636363636365,2.0
40,50,90,30,55,65,330,0.44680851063829785,130,85,80,85,95,60,535,0.43884892086330934,1.0
55,45,45,25,25,15,210,0.048,55,70,55,40,55,85,360,0.7073170731707317,1.0
40,70,40,35,40,60,285,0.392,70,135,105,60,105,20,495,0.5806451612903226,1.0
50,50,150,50,150,50,500,0.2571428571428571,35,85,45,35,35,75,310,0.6492537313432836,2.0
45,95,50,40,50,75,355,0.54,48,61,40,61,40,50,300,0.2543859649122807,0.125
80,160,60,170,130,80,680,0.6180555555555556,100,100,100,100,100,100,600,0.8805970149253731,1.0
60,55,145,75,150,40,525,0.2,50,64,50,45,50,41,300,0.22727272727272727,1.0
90,30,15,40,20,15,210,0.043478260869565216,110,85,95,80,95,50,515,0.2713178294573643,1.0
70,150,140,65,100,75,600,0.55,40,50,90,30,55,65,330,0.44680851063829785,0.5
50,70,50,50,50,70,340,0.5645161290322581,40,70,130,60,130,25,455,0.17355371900826447,1.0
40,29,45,29,45,36,224,0.14634146341463414,100,100,100,100,100,100,600,0.8345864661654135,4.0
74,94,131,54,116,20,489,0.4485294117647059,50,53,62,58,63,44,330,0.13709677419354838,1.0
50,48,43,46,41,60,288,0.47297297297297297,106,150,70,194,120,140,780,0.952,1.0
104,91,63,91,73,68,490,0.5118110236220472,80,135,130,95,90,70,600,0.5181818181818182,0.5
45,35,50,70,50,30,280,0.15753424657534246,83,106,65,86,65,85,490,0.6640625,0.5
50,70,160,70,160,90,600,0.7417218543046358,100,134,110,95,100,61,600,0.4057971014492754,0.0
70,90,110,60,75,95,500,0.7333333333333333,76,104,71,104,71,108,534,0.912751677852349,0.5
55,70,40,60,40,40,305,0.26956521739130435,50,47,50,57,50,65,319,0.463768115942029,1.0
90,70,80,70,95,70,475,0.5190839694656488,67,57,55,77,55,114,425,0.8879310344827587,2.0
55,75,60,75,60,103,428,0.7982456140350878,40,35,30,20,20,50,195,0.23423423423423423,2.0
50,60,60,60,60,30,320,0.11290322580645161,70,70,40,60,40,60,340,0.4247787610619469,1.0
100,5,5,15,65,30,220,0.07692307692307693,63,60,55,50,50,71,349,0.5289256198347108,1.0
44,38,33,61,43,70,289,0.5267857142857143,78,81,71,74,69,126,499,0.9090909090909091,2.0
82,121,119,69,59,71,521,0.5394736842105263,40,45,40,62,60,60,307,0.33884297520661155,2.0
55,40,85,80,105,40,405,0.23622047244094488,90,130,80,65,85,55,505,0.4396551724137931,4.0
160,110,65,65,110,30,540,0.35714285714285715,45,60,32,50,32,76,295,0.5925925925925926,1.0
35,55,40,50,50,90,320,0.6838235294117647,95,117,184,44,46,28,514,0.2975206611570248,1.0
105,125,100,60,100,100,590,0.8359375,38,35,40,27,25,35,200,0.08208955223880597,1.0
85,50,95,120,115,80,545,0.5793650793650794,54,78,103,53,45,22,355,0.23255813953488372,0.5
68,85,65,165,135,100,618,0.8083333333333333,78,104,78,159,115,100,634,0.8444444444444444,0.5
100,150,140,100,90,90,670,0.7969924812030075,70,85,140,85,70,20,470,0.272,2.0
60,85,60,85,60,55,405,0.3673469387755102,85,120,70,50,60,100,485,0.8308823529411765,1.0
63,60,55,50,50,71,349,0.5289256198347108,75,95,122,58,75,69,494,0.5725806451612904,0.0
30,45,135,45,90,30,375,0.09285714285714286,110,80,90,95,90,65,530,0.5033557046979866,2.0
103,60,86,60,86,50,445,0.3458646616541353,88,107,122,74,75,64,530,0.4596774193548387,1.0
65,55,115,100,40,60,435,0.3798449612403101,100,100,125,110,50,50,535,0.384,0.5
42,52,67,39,56,50,306,0.2868217054263566,48,72,48,72,48,48,336,0.25984251968503935,1.0
63,120,85,90,55,55,468,0.2809917355371901,69,69,76,69,86,91,460,0.6554621848739496,0.5
55,81,60,50,70,97,413,0.7214285714285714,110,65,75,125,85,30,490,0.15,1.0
59,45,40,35,40,31,250,0.14285714285714285,45,30,50,65,50,45,285,0.13821138211382114,1.0
40,30,35,45,40,55,245,0.31496062992125984,40,40,35,50,100,70,335,0.5031847133757962,1.0
60,69,95,69,95,36,424,0.2608695652173913,100,100,90,150,140,90,670,0.71875,0.5
59,63,80,65,80,58,405,0.41843971631205673,60,79,105,59,85,36,424,0.17054263565891473,2.0
60,55,90,145,90,80,520,0.6071428571428571,80,100,200,50,100,50,580,0.3472222222222222,0.5
64,51,23,51,23,28,240,0.11363636363636363,80,130,100,160,120,110,700,0.8981481481481481,1.0
50,105,79,35,110,76,455,0.6214285714285714,35,64,85,74,55,32,345,0.19827586206896552,1.0
123,100,62,97,81,68,531,0.4806201550387597,44,50,91,24,86,10,305,0.1981981981981982,0.25
70,100,70,105,75,40,460,0.23214285714285715,90,60,70,75,70,45,410,0.23880597014925373,1.0
45,40,60,40,75,50,310,0.2926829268292683,70,120,40,95,40,95,460,0.8106060606060606,1.0
50,53,48,53,48,64,316,0.4076923076923077,100,100,90,150,140,90,670,0.71875,2.0
44,38,33,61,43,70,289,0.5267857142857143,45,60,40,70,50,45,310,0.2846715328467153,1.0
100,103,75,120,75,127,600,0.940677966101695,80,80,90,110,130,110,600,0.8721804511278195,0.5
44,38,39,61,79,42,303,0.2251655629139073,55,47,52,40,40,41,275,0.16806722689075632,0.5
78,52,60,63,65,23,341,0.06015037593984962,50,85,85,55,55,50,380,0.3902439024390244,0.5
50,50,50,50,50,50,300,0.30708661417322836,55,55,55,85,55,30,335,0.1320754716981132,1.0
67,89,116,79,116,33,500,0.2624113475177305,150,100,120,100,120,90,680,0.6666666666666666,1.0
78,130,111,130,85,100,634,0.8561151079136691,65,110,130,60,65,95,525,0.8278145695364238,2.0
40,45,40,62,60,60,307,0.33884297520661155,60,45,50,90,80,70,395,0.625,2.0
38,36,38,32,36,57,237,0.3893805309734513,55,55,45,63,45,45,308,0.25,1.0
95,60,79,100,125,81,540,0.6201550387596899,105,140,95,55,65,45,505,0.3,1.0
55,75,60,75,60,103,428,0.7982456140350878,95,95,85,125,65,55,520,0.3894736842105263,1.0
45,75,60,40,30,50,300,0.304,60,69,95,69,95,36,424,0.2608695652173913,0.5
36,50,50,65,60,44,305,0.16363636363636364,70,140,70,110,65,105,560,0.95,0.5
45,75,37,70,55,83,365,0.6183206106870229,55,50,45,135,95,120,500,0.7714285714285715,1.0
80,70,40,100,60,145,495,0.921875,85,105,100,79,83,78,530,0.5869565217391305,1.0
65,80,80,59,63,58,405,0.4411764705882353,67,125,40,30,30,58,350,0.3431372549019608,2.0
55,70,45,70,50,60,350,0.45,25,35,70,95,55,45,325,0.16783216783216784,2.0
50,85,125,85,115,20,480,0.4306569343065693,55,66,44,44,56,85,350,0.6888888888888889,0.0
75,123,67,95,85,95,540,0.7642276422764228,60,30,30,36,56,50,262,0.32432432432432434,2.0
70,92,65,80,55,98,460,0.8090909090909091,40,70,130,60,130,25,455,0.17355371900826447,1.0
70,60,125,115,70,55,495,0.35507246376811596,60,65,80,170,95,130,600,0.8625954198473282,1.0
70,55,75,45,65,60,370,0.45901639344262296,60,70,50,100,50,65,395,0.5217391304347826,2.0
38,35,35,65,55,50,278,0.2647058823529412,50,20,55,25,25,30,205,0.09774436090225563,1.0
60,50,150,50,150,60,520,0.5206611570247934,60,55,50,40,55,45,305,0.22377622377622378,1.0
45,30,50,65,50,45,285,0.13821138211382114,55,68,64,45,55,31,318,0.11666666666666667,1.0
55,45,50,45,65,80,340,0.5546218487394958,40,27,60,37,50,66,280,0.36220472440944884,1.0
60,70,65,125,105,90,515,0.6911764705882353,30,105,90,25,25,50,325,0.2773722627737226,2.0
50,53,48,53,48,64,316,0.358974358974359,40,30,30,55,30,85,270,0.4666666666666667,0.5
65,150,40,15,80,145,495,0.9663865546218487,50,50,77,95,77,91,440,0.5916666666666667,0.25
49,55,42,42,37,85,310,0.6068376068376068,70,145,88,140,70,112,625,0.8888888888888888,0.5
80,110,120,130,90,70,600,0.6198347107438017,111,83,68,92,82,39,475,0.1774193548387097,0.5
70,70,115,130,90,60,535,0.5338983050847458,85,56,77,50,77,78,423,0.53125,0.0
91,90,129,90,72,108,580,0.9140625,50,35,55,25,25,15,205,0.05263157894736842,0.5
43,80,65,50,35,35,308,0.14193548387096774,72,105,115,54,86,68,500,0.5149253731343284,1.0
70,80,70,80,70,110,480,0.6594202898550725,85,110,90,45,90,80,500,0.6206896551724138,0.0
79,100,80,110,90,121,580,0.968,95,155,109,70,130,81,640,0.6788321167883211,1.0
85,76,64,45,55,90,415,0.6739130434782609,55,75,85,25,25,15,280,0.1875,0.5
60,60,60,85,85,85,435,0.631578947368421,70,90,90,135,90,125,600,0.9401709401709402,0.5
65,65,60,110,95,130,525,0.9253731343283582,78,130,111,130,85,100,634,0.8561151079136691,0.5
55,55,50,45,65,55,325,0.37373737373737376,38,35,35,65,55,50,278,0.2647058823529412,1.0
50,95,95,35,110,70,455,0.5179856115107914,74,48,76,83,81,104,466,0.7913043478260869,0.5
73,115,60,60,60,90,458,0.6694915254237288,100,128,90,77,77,128,600,0.959349593495935,1.0
60,150,50,150,50,60,520,0.5,35,35,40,35,55,50,250,0.40336134453781514,1.0
83,106,65,86,65,85,490,0.6640625,70,55,65,95,85,70,440,0.5307692307692308,0.5
60,110,70,60,60,100,460,0.8461538461538461,103,93,67,71,61,84,479,0.7142857142857143,1.0
35,46,34,35,45,20,215,0.072,80,135,85,70,95,150,615,0.9844961240310077,0.5
70,110,70,115,70,90,525,0.75,35,60,44,40,54,55,288,0.366412213740458,0.5
70,43,53,43,53,40,302,0.19090909090909092,95,80,105,40,70,100,490,0.8046875,1.0
40,40,35,50,100,70,335,0.5031847133757962,50,85,125,85,115,20,480,0.4306569343065693,0.5
65,105,60,60,70,95,455,63.0,60,50,40,85,75,95,405,0.7540983606557377,1.0
65,60,70,85,75,40,395,0.1796875,71,73,88,120,89,59,500,0.43537414965986393,1.0
50,65,45,85,65,95,405,0.7238095238095238,45,60,32,50,32,76,295,0.5925925925925926,1.0
40,40,35,50,100,70,335,0.5031847133757962,95,125,79,60,100,81,540,0.6165413533834586,0.5
67,125,40,30,30,58,350,0.3431372549019608,65,40,50,125,60,30,370,0.07258064516129033,1.0
70,110,80,55,80,105,500,0.8794326241134752,55,112,45,74,45,70,401,0.559322033898305,0.25
50,65,107,105,107,86,520,0.7758620689655172,54,45,47,75,98,52,371,0.39669421487603307,1.0
65,70,60,65,65,115,440,0.8583333333333333,105,140,95,55,65,45,505,0.3,1.0
65,60,70,85,75,40,395,0.1796875,75,90,140,60,60,40,465,0.3008130081300813,0.5
54,63,52,83,56,97,405,0.7697841726618705,45,50,35,55,75,40,300,0.21367521367521367,0.5
104,91,63,91,73,68,490,0.5118110236220472,91,90,106,130,106,77,600,0.648854961832061,0.5
89,124,80,55,80,55,483,0.5714285714285714,25,35,70,95,55,45,325,0.16783216783216784,4.0
85,105,100,79,83,78,530,0.5869565217391305,70,94,50,94,50,66,424,0.48148148148148145,1.0
90,92,75,92,85,60,494,0.49586776859504134,170,90,45,90,45,60,500,0.427536231884058,1.0
125,120,90,170,100,95,700,0.78125,60,100,89,55,69,112,485,0.9298245614035088,1.0
60,50,150,50,150,60,520,0.5206611570247934,62,50,58,73,54,72,369,0.4435483870967742,0.0
30,56,35,25,35,72,253,0.48148148148148145,45,90,20,65,20,65,305,0.5116279069767442,1.0
75,95,67,125,95,83,540,0.7117117117117117,38,41,40,50,65,65,299,0.4108527131782946,0.5
85,90,80,70,80,130,535,0.9262295081967213,85,110,90,45,90,80,500,0.6206896551724138,1.0
75,75,130,75,130,95,580,0.7479674796747967,75,123,67,95,85,95,540,0.7642276422764228,1.0
50,47,50,57,50,65,319,0.463768115942029,35,64,85,74,55,32,345,0.19827586206896552,2.0
100,150,140,100,90,90,670,0.7969924812030075,80,105,65,60,75,130,515,0.9645390070921985,0.0
60,85,69,65,79,80,438,0.576,65,105,60,60,70,95,455,63.0,1.0
78,70,61,50,61,100,420,0.8145161290322581,60,105,60,120,60,105,510,0.8849557522123894,1.0
85,100,122,58,75,54,494,0.3939393939393939,65,83,57,95,85,105,490,0.8914728682170543,1.0
60,50,100,85,70,65,430,0.47580645161290325,73,100,60,100,60,65,458,0.42657342657342656,1.0
60,30,30,36,56,50,262,0.32432432432432434,50,95,180,85,45,70,525,0.5298507462686567,1.0
80,160,80,130,80,100,630,0.8455284552845529,70,60,62,80,82,60,414,0.4375,0.5
67,125,40,30,30,58,350,0.3431372549019608,70,60,75,110,75,90,480,0.7165354330708661,1.0
103,93,67,71,61,84,479,0.7142857142857143,50,95,180,85,45,70,525,0.5298507462686567,1.0
69,69,76,69,86,91,460,0.6554621848739496,65,95,57,100,85,93,495,0.7441860465116279,2.0
45,22,60,27,30,29,213,0.07518796992481203,41,64,45,50,50,50,300,0.36752136752136755,1.0
73,76,75,81,100,100,505,0.8110236220472441,60,40,80,60,45,40,325,0.23529411764705882,2.0
50,35,55,25,25,15,205,0.05263157894736842,65,80,140,40,70,70,465,0.5223880597014925,0.25
55,81,60,50,70,97,413,0.7214285714285714,40,55,80,35,60,30,300,0.15037593984962405,0.5
90,92,75,92,85,60,494,0.49586776859504134,70,115,60,115,60,55,475,0.4647887323943662,1.0
50,92,108,92,108,35,485,0.2457627118644068,40,55,80,35,60,30,300,0.15037593984962405,4.0
50,85,40,85,40,35,335,0.1746031746031746,40,40,40,70,40,20,250,0.032520325203252036,0.5
75,85,200,55,65,30,510,0.16778523489932887,78,84,78,109,85,100,534,0.8646616541353384,0.0
50,65,85,35,35,55,325,0.32575757575757575,55,40,50,65,85,40,335,0.3181818181818182,0.5
50,30,55,65,55,20,275,0.13675213675213677,75,95,60,65,60,115,470,0.8778625954198473,0.0
100,77,77,128,128,90,600,0.6901408450704225,31,45,90,30,30,40,266,0.21929824561403508,2.0
80,145,150,105,110,110,700,0.8692307692307693,82,121,119,69,59,71,521,0.5394736842105263,2.0
55,40,40,65,45,35,280,0.16428571428571428,70,90,90,135,90,125,600,0.9401709401709402,1.0
115,45,20,45,25,20,270,0.11538461538461539,80,80,90,110,130,110,600,0.8721804511278195,2.0
45,55,45,65,45,75,330,0.5692307692307692,59,45,40,35,40,31,250,0.14285714285714285,1.0
85,110,76,65,82,56,474,0.3933333333333333,55,35,50,55,110,85,390,0.6277372262773723,0.25
38,35,35,65,55,50,278,0.2647058823529412,130,65,60,110,95,65,525,0.5227272727272727,1.0
45,55,45,65,45,75,330,0.5692307692307692,80,45,65,90,110,80,470,0.5462962962962963,1.0
108,130,95,80,85,102,600,0.7637795275590551,75,85,200,55,65,30,510,0.16778523489932887,1.0
80,80,80,80,80,80,480,0.5606060606060606,20,40,15,35,35,60,205,0.34285714285714286,1.0
68,72,78,38,42,32,330,0.23809523809523808,80,120,79,95,79,70,523,0.5833333333333334,2.0
60,85,42,85,42,91,405,0.8227848101265823,91,90,129,90,72,108,580,0.9140625,0.5
45,45,55,45,55,63,308,0.4594594594594595,72,58,80,103,80,97,490,0.7171052631578947,0.5
116,55,85,107,95,29,487,0.06818181818181818,75,89,85,55,65,36,405,0.29545454545454547,1.0
64,115,65,83,63,65,455,0.5323741007194245,50,50,40,30,30,50,250,0.2781954887218045,1.0
75,100,110,45,55,65,450,0.5333333333333333,85,80,70,135,75,90,535,0.7006802721088435,1.0
75,110,110,110,105,80,590,0.656934306569343,25,35,70,95,55,45,325,0.16783216783216784,0.25
60,90,55,90,80,110,485,0.8677685950413223,73,95,62,85,65,85,465,0.6666666666666666,1.0
75,80,60,65,90,102,472,0.8625954198473282,70,62,67,55,55,56,365,0.38513513513513514,1.0
50,50,95,40,50,35,320,0.20279720279720279,62,55,52,109,94,109,481,0.7833333333333333,2.0
70,110,70,115,70,90,525,0.75,80,110,120,130,90,70,600,0.6198347107438017,0.25
45,75,37,70,55,83,365,0.6183206106870229,80,80,80,80,80,80,480,0.5606060606060606,0.5
60,50,50,60,70,50,340,0.28346456692913385,60,52,168,47,138,30,495,0.19834710743801653,2.0
65,125,100,60,70,70,490,0.6099290780141844,45,35,50,70,50,30,280,0.15753424657534246,1.0
78,130,111,130,85,100,634,0.8561151079136691,80,105,65,60,75,130,515,0.9645390070921985,0.5
64,51,23,51,23,28,240,0.11363636363636363,90,70,80,70,95,70,475,0.5190839694656488,1.0
59,110,150,45,49,35,448,0.3333333333333333,80,80,50,40,50,25,325,0.176056338028169,1.0
100,120,120,150,100,90,680,0.7880794701986755,62,48,66,59,57,49,341,0.33884297520661155,0.0
55,45,43,55,43,72,313,0.5853658536585366,100,120,120,150,100,90,680,0.7880794701986755,0.25
50,50,77,95,77,91,440,0.5916666666666667,106,190,100,154,100,130,780,0.9259259259259259,2.0
40,27,60,37,50,66,280,0.36220472440944884,65,40,50,125,60,30,370,0.07258064516129033,1.0
83,80,80,135,80,121,579,0.9444444444444444,38,35,35,65,55,50,278,0.2647058823529412,1.0
75,80,70,65,75,90,455,0.7578125,50,72,35,35,35,65,292,0.5373134328358209,0.5
64,78,52,78,52,81,405,0.6422764227642277,50,60,45,100,80,65,400,0.45689655172413796,1.0
50,105,125,55,95,50,480,0.375886524822695,67,89,116,79,116,33,500,0.2624113475177305,0.25
74,48,76,83,81,104,466,0.7322834645669292,45,60,45,25,45,55,275,0.29,1.0
78,81,71,74,69,126,499,0.9090909090909091,70,60,62,80,82,60,414,0.4375,4.0
55,45,45,25,25,15,210,0.048,38,30,85,55,65,30,303,0.21428571428571427,1.0
60,85,42,85,42,91,405,0.8227848101265823,80,100,70,60,70,95,475,0.7416666666666667,2.0
75,38,38,56,56,67,330,0.5263157894736842,48,61,40,61,40,50,300,0.2543859649122807,1.0
60,65,80,170,95,130,600,0.8625954198473282,35,85,45,35,35,75,310,0.6492537313432836,0.0
60,85,69,60,69,77,420,0.518796992481203,40,35,30,20,20,50,195,0.23423423423423423,1.0
85,105,55,85,50,115,495,0.9032258064516129,100,100,100,100,100,100,600,0.831858407079646,1.0
65,47,55,73,75,85,400,0.65,70,145,88,140,70,112,625,0.8888888888888888,0.25
78,70,61,50,61,100,420,0.8145161290322581,110,85,95,80,95,50,515,0.2713178294573643,1.0
106,190,100,154,100,130,780,0.9259259259259259,40,40,40,70,40,20,250,0.032520325203252036,1.0
85,76,64,45,55,90,415,0.6739130434782609,30,65,100,45,25,40,305,0.1891891891891892,1.0
70,80,102,80,102,40,474,0.2677165354330709,90,93,55,70,55,55,418,0.3819444444444444,0.5
41,50,37,50,37,66,281,0.5175438596491229,40,27,60,37,50,66,280,0.36220472440944884,0.5
60,60,50,40,50,75,335,0.5882352941176471,91,90,129,90,72,108,580,0.9140625,0.25
75,80,70,65,75,90,455,0.7578125,95,155,109,70,130,81,640,0.6788321167883211,1.0
100,134,110,95,100,61,600,0.4057971014492754,50,50,95,40,50,35,320,0.20279720279720279,0.5
80,105,105,105,105,80,580,0.5939849624060151,106,130,90,110,154,90,680,0.719626168224299,1.0
50,95,95,35,110,70,455,0.5179856115107914,40,80,35,35,45,70,305,0.4661016949152542,1.0
80,160,80,130,80,100,630,0.8455284552845529,65,55,115,100,40,60,435,0.3798449612403101,2.0
50,70,50,50,50,40,310,0.16296296296296298,80,80,80,80,80,80,480,0.6015037593984962,1.0
85,50,95,120,115,80,545,0.5793650793650794,70,110,70,115,70,90,525,0.75,1.0
80,120,70,110,70,80,530,0.6422764227642277,65,65,60,110,95,130,525,0.9253731343283582,1.0
50,35,55,25,25,15,205,0.021739130434782608,38,30,41,30,41,60,240,0.2897196261682243,1.0
50,20,40,20,40,20,190,0.0962962962962963,100,180,160,150,90,90,770,0.7520661157024794,0.5
92,105,90,125,90,98,600,0.8217054263565892,55,55,50,45,65,55,325,0.37373737373737376,1.0
70,60,62,80,82,60,414,0.4375,74,108,133,83,65,32,495,0.32142857142857145,0.5
60,40,80,60,45,40,325,0.23529411764705882,70,60,125,115,70,55,495,0.35507246376811596,4.0
65,60,110,130,95,65,525,0.47761194029850745,53,51,53,61,56,40,314,0.14285714285714285,0.5
50,70,100,40,40,30,330,0.2222222222222222,80,70,40,100,60,145,495,0.921875,2.0
58,70,45,40,45,42,300,0.25925925925925924,65,65,65,50,50,90,385,0.72,1.0
90,65,65,40,40,15,315,0.19672131147540983,95,135,80,110,80,100,600,0.8248175182481752,0.5
95,135,80,110,80,100,600,0.8248175182481752,60,85,69,65,79,80,438,0.576,1.0
60,65,70,85,75,40,395,0.21705426356589147,65,65,45,75,45,95,390,0.72,0.25
20,10,230,10,230,5,505,0.0,30,80,90,55,45,55,355,0.4295774647887324,1.0
70,90,110,60,75,95,500,0.7333333333333333,60,50,70,50,90,65,385,0.39568345323741005,0.5
40,30,32,50,52,65,269,0.3671875,44,48,65,50,64,43,314,0.1623931623931624,0.5
70,43,53,43,53,40,302,0.19090909090909092,86,92,88,68,75,73,482,0.6835443037974683,1.0
100,180,160,150,90,90,770,0.7520661157024794,60,50,70,80,80,140,480,0.8449612403100775,2.0
57,80,91,80,87,75,470,0.5737704918032787,35,35,35,35,35,35,210,0.13385826771653545,2.0
65,60,110,130,95,65,525,0.47761194029850745,59,45,40,35,40,31,250,0.14285714285714285,1.0
70,70,115,130,90,60,535,0.5338983050847458,80,70,70,90,100,70,480,0.5609756097560976,0.5
55,55,85,65,85,35,380,0.2014388489208633,125,120,90,170,100,95,700,0.78125,1.0
86,92,88,68,75,73,482,0.6835443037974683,40,45,35,30,40,55,245,0.3793103448275862,2.0
35,55,40,50,50,90,320,0.6838235294117647,85,60,65,135,105,100,550,0.7518248175182481,1.0
70,20,50,20,50,40,250,0.1557377049180328,40,40,55,40,70,55,300,0.40939597315436244,2.0
90,85,100,95,125,85,580,0.6834532374100719,44,48,65,50,64,43,314,0.1623931623931624,0.5
45,65,34,40,34,45,263,0.2589928057553957,30,45,135,45,90,30,375,0.09285714285714286,1.0
95,109,105,75,85,56,525,0.34513274336283184,95,65,65,110,130,60,525,0.4016393442622951,1.0
103,93,67,71,61,84,479,0.7142857142857143,50,105,79,35,110,76,455,0.6214285714285714,0.5
108,112,118,68,72,47,525,0.2916666666666667,60,70,50,100,50,65,395,0.5217391304347826,0.0
70,115,60,115,60,55,475,0.4647887323943662,75,125,100,70,80,45,495,0.33035714285714285,1.0
43,70,48,50,60,38,309,0.2391304347826087,45,75,37,70,55,83,365,0.6183206106870229,0.5
100,134,110,95,100,61,600,0.4057971014492754,70,135,105,60,105,20,495,0.5806451612903226,1.0
40,55,30,30,30,60,245,0.43548387096774194,80,100,200,50,100,50,580,0.3472222222222222,0.25
40,40,55,40,70,55,300,0.40939597315436244,90,92,87,75,85,76,505,0.5409836065573771,8.0
100,110,90,85,90,60,535,0.47794117647058826,80,120,79,95,79,70,523,0.5833333333333334,2.0
35,80,50,50,70,120,405,0.84375,116,55,85,107,95,29,487,0.06818181818181818,1.0
72,85,70,65,70,58,420,0.41304347826086957,75,85,200,55,65,30,510,0.16778523489932887,0.5
74,100,72,90,72,46,454,0.24561403508771928,120,120,120,120,120,120,720,0.9344262295081968,1.0
55,45,50,45,65,80,340,0.5546218487394958,50,20,40,20,40,20,190,0.0962962962962963,1.0
69,55,45,55,55,15,294,0.11666666666666667,100,120,120,150,100,90,680,0.7880794701986755,0.0
100,50,80,60,80,50,420,0.34375,75,80,70,65,75,90,455,0.7578125,0.5
70,135,105,60,105,20,495,0.5806451612903226,45,55,45,65,45,75,330,0.5692307692307692,1.0
38,36,38,32,36,57,237,0.3893805309734513,70,85,65,105,85,120,530,0.9262295081967213,1.0
45,50,35,55,75,40,300,0.21367521367521367,95,75,180,130,80,30,590,0.13793103448275862,1.0
40,35,30,120,70,105,400,0.6692307692307692,62,73,55,56,52,84,382,0.7244094488188977,1.0
85,70,80,97,80,123,535,0.9304347826086956,55,40,50,65,85,40,335,0.3181818181818182,1.0
40,45,65,100,120,90,460,0.5588235294117647,60,69,95,69,95,36,424,0.2608695652173913,0.25
55,50,40,40,40,75,300,0.5945945945945946,70,62,67,55,55,56,365,0.38513513513513514,1.0
80,115,80,65,55,93,488,0.7846153846153846,65,83,57,95,85,105,490,0.8914728682170543,0.5
35,46,34,35,45,20,215,0.072,39,52,43,60,50,65,309,0.5041322314049587,1.0
55,50,65,175,95,150,590,0.7818181818181819,70,130,100,55,80,65,500,0.608,0.5
40,30,30,55,30,85,270,0.4666666666666667,100,180,160,150,90,90,770,0.7520661157024794,4.0
55,70,55,40,55,85,360,0.7073170731707317,40,27,60,37,50,66,280,0.36220472440944884,1.0
46,87,60,30,40,57,320,0.37777777777777777,125,130,90,130,90,95,660,0.7734375,2.0
60,50,50,60,70,50,340,0.28346456692913385,110,65,75,125,85,30,490,0.15,1.0
68,75,53,83,113,60,452,0.45384615384615384,70,145,88,140,70,112,625,0.8888888888888888,0.5
130,65,60,110,95,65,525,0.5227272727272727,55,40,85,80,105,40,405,0.23622047244094488,1.0
108,112,118,68,72,47,525,0.2916666666666667,65,60,110,130,95,65,525,0.47761194029850745,1.0
95,117,80,65,70,92,519,0.8409090909090909,95,65,65,110,130,60,525,0.4016393442622951,0.5
75,90,140,60,60,40,465,0.3008130081300813,45,30,35,20,20,45,195,0.14782608695652175,1.0
85,60,65,135,105,100,550,0.7518248175182481,55,66,44,44,56,85,350,0.6888888888888889,1.0
45,20,50,60,120,50,345,0.24074074074074073,75,98,63,98,63,101,498,0.889763779527559,2.0
45,49,65,49,65,45,318,0.275,70,150,140,65,100,75,600,0.55,0.25
60,45,70,45,90,95,405,0.7304964539007093,79,115,70,125,80,111,580,0.8468468468468469,2.0
35,80,50,50,70,120,405,0.84375,75,98,63,98,63,101,498,0.8091603053435115,0.5
60,55,90,145,90,80,520,0.6071428571428571,50,50,40,50,40,64,294,0.45588235294117646,0.5
40,80,100,30,30,20,300,0.11851851851851852,45,100,135,65,135,45,525,0.29411764705882354,1.0
70,60,75,110,75,90,480,0.7165354330708661,64,51,23,51,23,28,240,0.11363636363636363,1.0
91,72,90,129,90,108,580,0.8925619834710744,95,110,95,40,95,55,490,0.40336134453781514,2.0
70,105,105,50,40,20,390,0.33587786259541985,80,82,83,100,100,80,525,0.6742424242424242,1.0
70,100,115,30,65,30,410,0.24390243902439024,126,131,95,131,98,99,680,0.8102189781021898,2.0
65,95,57,100,85,93,495,0.7441860465116279,40,35,30,20,20,50,195,0.23423423423423423,2.0
65,47,55,73,75,85,400,0.65,60,65,80,170,95,130,600,0.8625954198473282,0.25
65,125,100,60,70,70,490,0.6099290780141844,45,60,32,50,32,76,295,0.5925925925925926,0.5
45,35,45,62,53,35,275,0.11851851851851852,130,70,35,70,35,60,400,0.4017857142857143,2.0
39,52,43,60,50,65,309,0.49107142857142855,40,55,30,30,30,85,270,0.688,1.0
73,115,60,60,60,90,458,0.6694915254237288,86,76,86,116,56,95,515,0.7982456140350878,1.0
50,105,79,35,110,76,455,0.6214285714285714,55,40,50,65,85,40,335,0.3181818181818182,0.0
40,55,30,30,30,60,245,0.43548387096774194,45,67,60,35,50,63,320,0.5128205128205128,1.0
65,100,70,80,80,105,500,0.8666666666666667,100,50,50,76,96,70,442,0.5,1.0
40,70,130,60,130,25,455,0.17355371900826447,20,40,90,30,90,25,295,0.11363636363636363,2.0
76,147,90,60,70,97,540,0.8267716535433071,40,55,80,35,60,30,300,0.15037593984962405,0.5
91,134,95,100,100,80,600,0.6304347826086957,170,90,45,90,45,60,500,0.427536231884058,1.0
95,60,79,100,125,81,540,0.6201550387596899,80,100,80,80,80,100,520,0.9051724137931034,1.0
75,55,70,55,95,110,460,0.8444444444444444,110,80,90,95,90,65,530,0.5033557046979866,2.0
80,120,70,110,70,80,530,0.6422764227642277,91,72,90,129,90,108,580,0.8620689655172413,0.5
44,38,33,61,43,70,289,0.5267857142857143,40,80,35,35,45,70,305,0.4661016949152542,1.0
90,75,75,90,100,70,500,0.5462184873949579,91,129,90,72,90,108,580,0.8536585365853658,2.0
44,38,39,61,79,42,303,0.2251655629139073,90,75,85,115,90,55,510,0.3445378151260504,1.0
55,50,65,175,95,150,590,0.7818181818181819,100,100,100,100,100,100,600,0.8602941176470589,1.0
90,30,15,40,20,15,210,0.043478260869565216,70,140,70,110,65,105,560,0.95,2.0
100,100,100,100,100,100,600,0.8778625954198473,80,82,83,100,100,80,525,0.6742424242424242,4.0
20,25,45,70,90,60,310,0.30833333333333335,45,25,50,25,25,35,205,0.13076923076923078,1.0
55,104,105,94,75,52,485,0.36363636363636365,40,30,35,50,70,55,280,0.28205128205128205,0.5
40,80,100,30,30,20,300,0.11851851851851852,70,84,70,65,70,51,410,0.2949640287769784,1.0
50,80,95,10,45,10,290,0.232,65,73,55,47,75,85,400,0.6846846846846847,2.0
46,57,40,40,40,50,273,0.25,85,90,80,70,80,130,535,0.9262295081967213,0.5
44,75,35,63,33,45,295,0.2647058823529412,60,50,50,60,70,50,340,0.28346456692913385,1.0
123,100,62,97,81,68,531,0.4806201550387597,80,120,79,95,79,70,523,0.5833333333333334,1.0
49,49,56,49,61,66,330,0.5190839694656488,65,90,40,45,80,75,395,0.625,1.0
71,82,64,64,59,112,452,0.9327731092436975,92,105,90,125,90,98,600,0.8217054263565892,1.0
105,180,100,180,100,115,780,0.9477611940298507,55,84,105,114,75,52,485,0.2890625,1.0
55,55,50,45,65,55,325,0.37373737373737376,45,49,65,49,65,45,318,0.275,1.0
68,65,65,125,115,80,518,0.6461538461538462,90,92,75,92,85,60,494,0.49586776859504134,1.0
65,85,70,75,70,40,405,0.203125,55,40,85,80,105,40,405,0.23622047244094488,2.0
70,90,70,60,60,70,420,0.6390977443609023,60,69,95,69,95,36,424,0.2608695652173913,1.0
60,55,90,145,90,80,520,0.6071428571428571,125,170,100,120,90,95,700,0.77,1.0
76,25,45,67,55,24,292,0.0390625,60,45,70,45,90,95,405,0.7304964539007093,1.0
90,130,80,65,85,55,505,0.4396551724137931,100,73,83,73,83,55,467,0.371900826446281,0.5
38,35,40,27,25,35,200,0.08208955223880597,60,50,100,85,70,65,430,0.47580645161290325,0.5
106,110,90,154,90,130,680,0.926829268292683,95,85,85,65,65,35,430,0.2571428571428571,2.0
73,76,75,81,100,100,505,0.8110236220472441,85,115,80,105,80,50,515,0.3063063063063063,1.0
90,120,120,60,60,50,500,0.35294117647058826,80,120,70,110,70,80,530,0.6422764227642277,2.0
30,80,90,55,45,55,355,0.4295774647887324,100,77,77,128,128,90,600,0.6901408450704225,1.0
40,45,65,100,120,90,460,0.5588235294117647,75,69,72,114,100,104,534,0.8253968253968254,0.25
60,55,145,75,150,40,525,0.2,83,106,65,86,65,85,490,0.6640625,0.5
105,95,75,85,75,74,509,0.5714285714285714,60,60,75,60,75,80,410,0.7321428571428571,1.0
100,128,90,77,77,128,600,0.959349593495935,70,43,53,43,53,40,302,0.19090909090909092,0.5
80,70,70,90,100,70,480,0.5609756097560976,28,25,25,45,35,40,198,0.16083916083916083,1.0
62,44,50,44,50,55,305,0.3629032258064516,60,55,145,75,150,40,525,0.2,0.5
38,41,40,50,65,65,299,0.4108527131782946,75,95,95,95,95,85,540,0.6470588235294118,0.25
90,65,65,40,40,15,315,0.19672131147540983,65,90,50,85,45,55,390,0.371900826446281,1.0
106,190,100,154,100,130,780,0.9259259259259259,86,76,86,116,56,95,515,0.7982456140350878,0.25
78,84,78,109,85,100,534,0.8620689655172413,255,10,10,75,135,55,540,0.3125,1.0
45,22,60,27,30,29,213,0.07518796992481203,95,70,73,95,90,60,483,0.3983739837398374,0.5
10,55,25,35,45,95,265,0.5396825396825397,190,33,58,33,58,33,405,0.13432835820895522,1.0
60,80,50,40,40,30,300,0.15328467153284672,90,132,105,132,105,30,594,0.4246575342465753,1.0
65,65,65,50,50,90,385,0.72,90,30,15,40,20,15,210,0.043478260869565216,1.0
70,75,60,105,60,105,475,0.88,91,90,72,90,129,108,580,0.896,0.5
75,90,90,140,90,115,600,0.9481481481481482,91,129,90,72,90,108,580,0.8536585365853658,0.25
55,95,55,35,75,115,430,0.9380530973451328,60,50,70,50,90,65,385,0.39568345323741005,1.0
30,56,35,25,35,72,253,0.48148148148148145,70,85,65,105,85,120,530,0.9262295081967213,1.0
60,75,85,100,85,115,520,0.8992248062015504,109,66,84,81,99,32,471,0.2013888888888889,4.0
85,60,65,135,105,100,550,0.7518248175182481,50,72,35,35,35,65,292,0.5373134328358209,2.0
126,131,95,131,98,99,680,0.8294573643410853,50,75,70,35,70,48,348,0.29357798165137616,4.0
60,50,100,85,70,65,430,0.47580645161290325,30,65,100,45,25,40,305,0.1891891891891892,0.5
70,60,125,115,70,55,495,0.35507246376811596,90,95,105,165,110,45,610,0.2890625,0.5
90,85,100,95,125,85,580,0.6834532374100719,110,130,80,70,60,80,530,0.5862068965517241,1.0
165,75,80,40,45,65,470,0.5151515151515151,50,53,62,58,63,44,330,0.13709677419354838,0.5
130,85,80,85,95,60,535,0.43884892086330934,70,84,70,65,70,51,410,0.2949640287769784,8.0
50,60,45,100,80,65,400,0.45689655172413796,130,85,80,85,95,60,535,0.43884892086330934,2.0
70,90,70,60,60,70,420,0.6390977443609023,39,52,43,60,50,65,309,0.5041322314049587,1.0
64,66,68,81,76,50,405,0.25190839694656486,55,50,40,40,40,75,300,0.5945945945945946,1.0
105,130,120,45,45,40,485,0.4444444444444444,70,120,100,145,105,20,560,0.2824427480916031,2.0
105,150,90,150,90,95,680,0.8285714285714286,50,120,53,35,110,87,455,0.640625,2.0
80,80,90,110,130,110,600,0.8721804511278195,55,55,55,85,55,30,335,0.1320754716981132,0.5
40,40,50,30,30,30,220,0.0873015873015873,60,40,50,75,85,95,405,0.6044776119402985,1.0
80,52,50,90,50,89,411,0.6666666666666666,60,85,42,85,42,91,405,0.8227848101265823,1.0
50,75,35,70,30,40,300,0.21296296296296297,50,85,85,55,55,50,380,0.3902439024390244,0.0
65,85,70,75,70,40,405,0.203125,100,128,90,77,77,128,600,0.959349593495935,1.0
65,95,100,60,50,50,420,0.34959349593495936,55,84,105,114,75,52,485,0.2890625,1.0
68,165,95,65,115,110,618,0.8615384615384616,35,65,35,65,35,65,300,0.46621621621621623,1.0
76,25,45,67,55,24,292,0.0390625,40,45,40,35,35,56,251,0.373015873015873,1.0
80,120,70,110,70,80,530,0.6422764227642277,65,60,110,130,95,65,525,0.47761194029850745,4.0
90,120,120,60,60,50,500,0.35294117647058826,60,95,80,60,80,30,405,0.19480519480519481,0.25
70,60,70,87,78,85,450,0.6228070175438597,126,131,95,131,98,99,680,0.8102189781021898,0.5
70,115,60,115,60,55,475,0.4647887323943662,75,85,200,55,65,30,510,0.16778523489932887,1.0
70,100,115,30,65,30,410,0.24390243902439024,67,58,57,81,67,101,431,0.8790322580645161,1.0
30,42,118,42,88,30,350,0.112,95,100,85,108,70,70,528,0.5652173913043478,0.5
60,85,40,30,45,68,328,0.6422018348623854,60,95,80,60,80,30,405,0.19480519480519481,0.25
45,30,50,55,65,45,290,0.208,95,125,79,60,100,81,540,0.6165413533834586,1.0
70,84,70,65,70,51,410,0.2949640287769784,90,60,60,40,40,40,330,0.29545454545454547,0.5
20,40,15,35,35,60,205,0.34285714285714286,72,60,30,20,30,25,237,0.11570247933884298,1.0
70,120,40,95,40,95,460,0.8106060606060606,63,120,85,90,55,55,468,0.2809917355371901,0.25
70,80,50,35,35,35,305,0.14,65,90,65,61,61,100,442,0.8373983739837398,1.0
80,90,80,130,110,110,600,0.856,55,50,45,135,95,120,500,0.7714285714285715,0.5
60,45,70,75,85,55,390,0.3008130081300813,50,65,64,44,48,43,314,0.2196969696969697,1.0
20,40,15,35,35,60,205,0.34285714285714286,106,90,130,90,154,110,680,0.8699186991869918,2.0
70,92,65,80,55,98,460,0.8090909090909091,62,73,55,56,52,84,382,0.7244094488188977,2.0
75,100,63,80,63,116,497,0.9345794392523364,45,55,45,65,45,75,330,0.5692307692307692,2.0
38,30,85,55,65,30,303,0.21428571428571427,40,45,35,30,40,55,245,0.3793103448275862,1.0
80,115,80,65,55,93,488,0.7846153846153846,30,65,100,45,25,40,305,0.1891891891891892,1.0
70,95,85,55,65,70,440,0.5,80,82,78,95,80,85,500,0.6869565217391305,1.0
65,136,94,54,96,135,580,0.9612403100775194,75,65,55,65,55,69,384,0.43548387096774194,1.0
40,65,40,80,40,65,330,0.5038167938931297,60,65,60,130,75,110,500,0.7719298245614035,2.0
25,20,15,105,55,90,310,0.32407407407407407,73,115,60,60,60,90,458,0.6694915254237288,1.0
65,80,65,35,65,60,370,0.38405797101449274,10,55,25,35,45,95,265,0.5396825396825397,1.0
45,85,70,40,40,60,340,0.5229357798165137,30,45,59,30,39,57,260,0.2803030303030303,1.0
40,40,40,70,40,20,250,0.032520325203252036,100,150,140,100,90,90,670,0.7969924812030075,1.0
60,100,89,55,69,112,485,0.9298245614035088,50,64,50,45,50,41,300,0.22727272727272727,0.25
45,30,50,55,65,45,290,0.208,85,50,95,120,115,80,545,0.5793650793650794,1.0
55,63,90,50,80,42,380,0.21138211382113822,50,65,107,105,107,86,520,0.7758620689655172,2.0
110,65,105,55,95,80,510,0.6258503401360545,79,85,60,55,60,71,410,0.60431654676259,1.0
40,70,130,60,130,25,455,0.17355371900826447,40,29,45,29,45,36,224,0.14634146341463414,1.0
110,130,80,70,60,80,530,0.5862068965517241,75,75,60,83,60,60,413,0.39344262295081966,0.5
60,67,85,77,75,116,480,0.8888888888888888,100,150,120,120,100,90,680,0.6493506493506493,1.0
36,50,50,65,60,44,305,0.16363636363636364,105,30,105,140,105,55,540,0.3524590163934426,0.5
35,85,45,35,35,75,310,0.6492537313432836,126,131,95,131,98,99,680,0.8294573643410853,1.0
60,50,150,50,150,60,520,0.5206611570247934,60,55,50,40,55,45,305,0.22377622377622378,1.0
10,55,25,35,45,95,265,0.5396825396825397,70,115,60,115,60,55,475,0.4647887323943662,0.5
45,50,45,115,55,95,405,0.6936936936936937,108,100,121,81,95,95,600,0.7476635514018691,0.5
65,130,60,95,110,65,525,0.5303030303030303,35,45,160,30,45,70,385,0.48148148148148145,0.5
75,98,63,98,63,101,498,0.8091603053435115,20,15,20,10,55,80,200,0.2682926829268293,2.0
50,50,150,50,150,50,500,0.2571428571428571,75,85,200,55,65,30,510,0.16778523489932887,0.125
79,85,60,55,60,71,410,0.60431654676259,100,50,50,76,96,70,442,0.5,1.0
35,65,35,65,35,65,300,0.46621621621621623,80,185,115,40,105,75,600,0.6230769230769231,1.0
70,50,30,95,135,105,485,0.8040540540540541,65,70,60,65,65,115,440,0.8583333333333333,1.0
65,155,120,65,90,105,600,0.8677685950413223,48,61,40,61,40,50,300,0.2543859649122807,0.5
60,62,63,80,80,60,405,0.38016528925619836,49,49,56,49,61,66,330,0.5190839694656488,2.0
130,65,60,110,95,65,525,0.5227272727272727,110,130,80,70,60,80,530,0.5862068965517241,2.0
100,100,100,100,100,100,600,0.8778625954198473,100,110,90,85,90,60,535,0.47794117647058826,1.0
65,90,40,45,80,75,395,0.625,62,48,66,59,57,49,341,0.33884297520661155,1.0
115,45,20,45,25,20,270,0.11538461538461539,45,85,70,40,40,60,340,0.5229357798165137,0.5
40,55,30,30,30,60,245,0.43548387096774194,30,45,55,70,55,85,340,0.5633802816901409,1.0
43,30,55,40,65,97,330,0.6030534351145038,41,64,45,50,50,50,300,0.36752136752136755,0.5
90,130,80,65,85,55,505,0.4396551724137931,75,90,90,140,90,115,600,0.9481481481481482,2.0
150,160,100,95,65,100,670,0.8866666666666667,50,53,48,53,48,64,316,0.358974358974359,1.0
100,90,130,45,65,55,485,0.4253731343283582,100,100,125,110,50,50,535,0.384,0.5
40,45,40,65,40,65,295,0.5661764705882353,58,70,45,40,45,42,300,0.25925925925925924,0.0
85,76,64,45,55,90,415,0.6739130434782609,76,147,90,60,70,97,540,0.8267716535433071,1.0
81,102,77,85,75,85,505,0.5642857142857143,50,65,107,105,107,86,520,0.7272727272727273,0.0
35,40,100,90,55,35,355,0.1796875,75,100,63,80,63,116,497,0.9345794392523364,1.0
82,80,86,85,75,72,480,0.6183206106870229,55,85,55,50,55,60,360,0.4233576642335766,0.5
77,59,50,67,63,46,362,0.23140495867768596,35,70,55,45,55,25,285,0.09420289855072464,4.0
55,75,60,75,60,103,428,0.7982456140350878,50,53,48,53,48,64,316,0.46153846153846156,1.0
35,80,50,50,70,120,405,0.84375,65,65,45,75,45,95,390,0.72,0.0
65,50,35,115,95,95,455,0.7333333333333333,75,75,60,83,60,60,413,0.39344262295081966,0.5
55,45,43,55,43,72,313,0.5853658536585366,79,115,70,125,80,111,580,0.864,0.5
60,110,70,60,60,100,460,0.8461538461538461,55,75,50,40,40,80,340,0.6302521008403361,1.0
95,70,73,95,90,60,483,0.3983739837398374,41,64,45,50,50,50,300,0.36752136752136755,2.0
55,75,50,40,40,80,340,0.6302521008403361,79,85,60,55,60,71,410,0.60431654676259,1.0
50,65,107,105,107,86,520,0.703125,40,80,100,30,30,20,300,0.11851851851851852,0.0
40,40,50,30,30,30,220,0.0873015873015873,79,100,80,110,90,121,580,0.968,0.5
55,50,40,40,40,75,300,0.5945945945945946,40,45,40,65,40,65,295,0.5661764705882353,1.0
85,73,70,73,115,67,483,0.5126050420168067,55,70,40,60,40,40,305,0.26956521739130435,1.0
60,80,50,50,50,40,330,0.23853211009174313,45,25,50,25,25,35,205,0.13076923076923078,1.0
50,70,100,40,40,30,330,0.2222222222222222,65,95,75,55,55,85,430,0.6933333333333334,0.5
45,45,35,20,30,20,195,0.07246376811594203,120,120,120,120,120,120,720,0.9344262295081968,1.0
45,67,60,35,50,63,320,0.5128205128205128,50,53,48,53,48,64,316,0.4076923076923077,0.5
76,48,48,57,62,34,325,0.11688311688311688,50,65,90,35,35,15,290,0.14678899082568808,1.0
60,55,145,75,150,40,525,0.2,30,65,100,45,25,40,305,0.1891891891891892,0.5
89,125,90,115,80,101,600,0.8725490196078431,70,120,40,95,40,95,460,0.8106060606060606,1.0
50,75,75,65,65,50,380,0.4049586776859504,90,110,80,100,80,95,555,0.7982456140350878,1.0
100,100,80,60,60,50,450,0.3050847457627119,105,140,55,30,55,95,480,0.8195488721804511,1.0
101,72,72,99,89,29,462,0.1937984496124031,60,85,40,30,45,68,328,0.6422018348623854,1.0
95,70,73,95,90,60,483,0.3983739837398374,40,29,45,29,45,36,224,0.14634146341463414,1.0
30,45,55,70,55,85,340,0.5633802816901409,70,120,40,95,40,95,460,0.8106060606060606,0.5
40,27,60,37,50,66,280,0.36220472440944884,39,52,43,60,50,65,309,0.49107142857142855,0.25
60,62,50,62,60,40,334,0.18181818181818182,80,100,200,50,100,50,580,0.3472222222222222,2.0
45,60,32,50,32,76,295,0.5925925925925926,70,95,125,65,75,45,475,0.33613445378151263,1.0
50,180,20,180,20,150,600,0.9029850746268657,38,36,38,32,36,57,237,0.3893805309734513,1.0
20,25,45,70,90,60,310,0.30833333333333335,80,80,50,40,50,25,325,0.176056338028169,1.0
80,120,79,95,79,70,523,0.5833333333333334,50,75,35,70,30,40,300,0.21296296296296297,0.5
45,65,34,40,34,45,263,0.2589928057553957,65,47,55,73,75,85,400,0.65,1.0
70,80,65,90,65,85,455,0.578125,60,70,105,70,120,75,500,0.5983606557377049,1.0
60,95,80,60,80,30,405,0.19480519480519481,85,76,64,45,55,90,415,0.6739130434782609,1.0
45,30,40,105,50,20,290,0.031007751937984496,75,75,55,105,85,30,425,0.1619718309859155,1.0
45,53,70,40,60,42,310,0.25735294117647056,35,60,44,40,54,55,288,0.366412213740458,0.25
71,73,88,120,89,59,500,0.43537414965986393,75,140,65,112,65,110,567,0.9140625,2.0
65,125,100,60,70,70,490,0.6099290780141844,90,75,75,90,100,70,500,0.5462184873949579,0.5
35,65,35,65,35,65,300,0.46621621621621623,165,75,80,40,45,65,470,0.5151515151515151,0.5
35,55,40,50,50,90,320,0.6838235294117647,72,105,115,54,86,68,500,0.5149253731343284,2.0
75,110,110,110,105,80,590,0.656934306569343,35,55,35,30,30,35,220,0.23684210526315788,2.0
45,30,15,85,65,65,305,0.36220472440944884,50,53,48,53,48,64,316,0.358974358974359,0.5
100,100,100,100,100,100,600,0.831858407079646,60,52,168,47,138,30,495,0.19834710743801653,0.5
65,50,35,115,95,95,455,0.7333333333333333,50,95,90,95,90,180,600,0.9172413793103448,0.5
70,90,90,135,90,125,600,0.9401709401709402,65,75,105,35,65,85,430,0.6940298507462687,1.0
110,80,90,95,90,65,530,0.5033557046979866,70,110,80,55,80,105,500,0.8794326241134752,2.0
100,123,75,57,75,80,510,0.6923076923076923,35,65,35,65,35,65,300,0.46621621621621623,1.0
105,130,120,45,45,40,485,0.4444444444444444,80,80,80,55,55,90,440,0.6417910447761194,1.0
60,65,70,85,75,40,395,0.21705426356589147,100,100,100,100,100,100,600,0.8758169934640523,0.0
70,140,230,60,80,50,630,0.32432432432432434,36,50,50,65,60,44,305,0.16363636363636364,2.0
64,88,50,88,50,106,446,0.9111111111111111,40,45,35,40,40,90,290,0.65,1.0
70,80,65,90,65,85,455,0.578125,82,80,86,85,75,72,480,0.6183206106870229,1.0
63,120,85,90,55,55,468,0.2809917355371901,90,100,60,90,60,80,480,0.6422764227642277,0.25
100,100,100,100,100,100,600,0.831858407079646,65,110,130,60,65,95,525,0.8278145695364238,1.0
100,100,100,100,100,100,600,0.8805970149253731,114,85,70,85,80,30,464,0.2066115702479339,0.5
50,55,50,36,30,43,264,0.2922077922077922,45,100,45,45,45,10,290,0.2949640287769784,1.0
60,48,45,43,90,42,328,0.21897810218978103,55,45,43,55,43,72,313,0.5853658536585366,0.5
100,100,125,110,50,50,535,0.384,60,65,70,85,75,40,395,0.21705426356589147,0.25
60,45,70,75,85,55,390,0.3008130081300813,44,58,44,58,44,61,309,0.41964285714285715,1.0
65,90,120,85,70,60,490,0.43410852713178294,70,90,70,60,60,70,420,0.6390977443609023,1.0
110,135,60,50,65,88,508,0.7744360902255639,65,50,35,115,95,95,455,0.7333333333333333,2.0
72,105,115,54,86,68,500,0.5149253731343284,50,120,53,35,110,87,455,0.640625,0.5
50,60,45,100,80,65,400,0.45689655172413796,95,135,80,110,80,100,600,0.8248175182481752,0.25
35,55,40,50,50,90,320,0.6838235294117647,50,85,55,65,65,90,410,0.7478260869565218,1.0
66,41,77,61,87,23,355,0.12096774193548387,130,85,80,85,95,60,535,0.43884892086330934,4.0
85,110,76,65,82,56,474,0.3933333333333333,38,41,40,50,65,65,299,0.4108527131782946,0.5
40,50,90,30,55,65,330,0.44680851063829785,65,75,105,35,65,85,430,0.6940298507462687,0.25
70,55,65,95,85,70,440,0.5307692307692308,75,80,85,110,90,50,490,0.3548387096774194,2.0
50,53,48,53,48,64,316,0.4076923076923077,100,100,100,100,100,100,600,0.8778625954198473,0.5
78,81,71,74,69,126,499,0.9090909090909091,250,5,5,35,105,50,450,0.15306122448979592,1.0
45,63,37,65,55,95,360,0.8055555555555556,79,85,60,55,60,71,410,0.60431654676259,2.0
80,70,70,90,100,70,480,0.5609756097560976,60,110,70,60,60,100,460,0.8461538461538461,0.5
65,65,65,50,50,90,385,0.72,65,150,60,115,60,115,565,0.935251798561151,1.0
65,90,122,58,75,84,494,0.71875,45,53,70,40,60,42,310,0.25735294117647056,0.25
70,135,105,60,105,20,495,0.5806451612903226,38,30,85,55,65,30,303,0.21428571428571427,0.5
50,50,40,30,30,50,250,0.2781954887218045,50,95,95,35,110,70,455,0.5179856115107914,1.0
38,35,40,27,25,35,200,0.08208955223880597,40,45,65,100,120,90,460,0.5588235294117647,1.0
60,70,65,125,105,90,515,0.6911764705882353,70,50,30,95,135,105,485,0.8040540540540541,1.0
60,50,70,80,80,140,480,0.8449612403100775,100,70,70,65,65,45,415,0.1897810218978102,1.0
40,30,30,55,30,85,270,0.4666666666666667,85,73,70,73,115,67,483,0.5126050420168067,1.0
60,95,80,60,80,30,405,0.19480519480519481,60,85,60,85,60,55,405,0.3673469387755102,0.125
70,45,48,60,65,35,323,0.15748031496062992,95,80,105,40,70,100,490,0.8046875,1.0
44,38,33,61,43,70,289,0.5267857142857143,65,65,45,75,45,95,390,0.72,2.0
90,75,85,115,90,55,510,0.3445378151260504,50,70,160,70,160,90,600,0.7417218543046358,1.0
50,95,90,95,90,180,600,0.9172413793103448,80,100,200,50,100,50,580,0.3472222222222222,1.0
83,80,80,135,80,121,579,0.9444444444444444,80,80,80,80,80,80,480,0.5606060606060606,1.0
40,40,55,40,70,55,300,0.40939597315436244,65,63,45,45,45,45,308,0.2595419847328244,2.0
40,60,30,31,31,70,262,0.4492753623188406,110,135,60,50,65,88,508,0.7744360902255639,0.25
70,43,53,43,53,40,302,0.19090909090909092,65,136,94,54,96,135,580,0.9612403100775194,1.0
55,40,50,65,85,40,335,0.3181818181818182,40,70,130,60,130,25,455,0.17355371900826447,2.0
40,50,90,30,55,65,330,0.44680851063829785,50,53,48,53,48,64,316,0.46153846153846156,0.5
80,100,123,122,120,80,625,0.56,79,103,120,135,115,78,630,0.5763888888888888,2.0
70,90,70,60,60,70,420,0.6390977443609023,20,10,55,15,20,80,200,0.17985611510791366,1.0
77,85,51,55,51,65,384,0.5163934426229508,42,52,67,39,56,50,306,0.2868217054263566,1.0
106,90,130,90,154,110,680,0.8699186991869918,50,85,40,85,40,35,335,0.1746031746031746,2.0
55,104,105,94,75,52,485,0.36363636363636365,53,51,53,61,56,40,314,0.14285714285714285,0.5
45,100,45,45,45,10,290,0.2949640287769784,50,35,55,25,25,15,205,0.021739130434782608,0.5
60,40,50,75,85,95,405,0.6044776119402985,108,130,95,80,85,102,600,0.7637795275590551,0.0
55,55,55,85,55,30,335,0.1320754716981132,80,120,70,110,70,80,530,0.6422764227642277,1.0
78,65,68,112,154,75,552,0.628099173553719,65,47,55,73,75,85,400,0.65,1.0
85,97,66,105,66,65,484,0.47107438016528924,60,70,50,100,50,65,395,0.5217391304347826,2.0
55,45,50,45,65,80,340,0.5546218487394958,100,100,100,100,100,100,600,0.8778625954198473,0.5
30,65,100,45,25,40,305,0.1891891891891892,65,60,110,130,95,65,525,0.47761194029850745,1.0
60,80,50,40,40,30,300,0.15328467153284672,35,35,40,35,55,50,250,0.40336134453781514,1.0
48,61,40,61,40,50,300,0.2543859649122807,40,30,50,55,55,100,330,0.584070796460177,1.0
95,60,79,100,125,81,540,0.6201550387596899,55,95,115,45,45,35,390,0.2116788321167883,4.0
55,112,45,74,45,70,401,0.559322033898305,95,124,78,69,71,58,495,0.37398373983739835,1.0
41,64,45,50,50,50,300,0.36752136752136755,40,80,100,30,30,20,300,0.11851851851851852,1.0
78,52,60,63,65,23,341,0.06015037593984962,95,100,85,108,70,70,528,0.5652173913043478,1.0
60,55,50,40,55,45,305,0.22377622377622378,45,35,45,62,53,35,275,0.11851851851851852,4.0
105,140,95,55,65,45,505,0.3,75,98,63,98,63,101,498,0.8091603053435115,1.0
50,65,107,105,107,86,520,0.7272727272727273,70,75,60,105,60,105,475,0.88,0.25
65,65,65,50,50,90,385,0.72,64,78,52,78,52,81,405,0.6422764227642277,2.0
115,140,130,55,55,40,535,0.4519230769230769,30,45,55,70,55,85,340,0.5633802816901409,1.0
58,70,45,40,45,42,300,0.25925925925925924,78,130,111,130,85,100,634,0.8561151079136691,4.0
30,40,70,70,25,60,295,0.41353383458646614,45,100,45,45,45,10,290,0.2949640287769784,2.0
75,98,63,98,63,101,498,0.849624060150376,85,105,55,85,50,115,495,0.9032258064516129,0.5
100,75,115,90,115,85,580,0.6446280991735537,76,25,45,67,55,24,292,0.0390625,1.0
60,55,50,40,55,45,305,0.22377622377622378,110,80,90,95,90,65,530,0.5033557046979866,1.0
59,66,70,44,55,41,335,0.25190839694656486,60,45,50,90,80,70,395,0.625,0.25
99,68,83,72,87,51,460,0.417910447761194,78,84,78,109,85,100,534,0.8620689655172413,0.5
100,128,90,77,77,128,600,0.959349593495935,50,70,100,40,40,30,330,0.2222222222222222,1.0
65,75,70,95,70,95,470,0.7272727272727273,56,61,65,48,45,38,313,0.17567567567567569,2.0
70,110,180,60,60,50,530,0.4117647058823529,65,76,84,54,96,105,480,0.9008264462809917,1.0
108,170,115,120,95,92,700,0.7083333333333334,67,125,40,30,30,58,350,0.3431372549019608,2.0
70,80,70,80,70,110,480,0.6594202898550725,75,55,70,55,95,110,460,0.8444444444444444,4.0
60,65,80,170,95,130,600,0.8625954198473282,80,70,70,90,100,70,480,0.5609756097560976,2.0
95,109,105,75,85,56,525,0.34513274336283184,60,40,60,40,60,35,295,0.18055555555555555,0.25
95,23,48,23,48,23,260,0.046153846153846156,65,80,140,40,70,70,465,0.5223880597014925,0.5
37,25,41,25,41,25,194,0.08870967741935484,20,10,55,15,20,80,200,0.17985611510791366,1.0
45,85,70,40,40,60,340,0.5229357798165137,114,85,70,85,80,30,464,0.2066115702479339,1.0
35,55,35,30,30,35,220,0.23684210526315788,130,65,60,110,95,65,525,0.5227272727272727,1.0
77,120,90,60,90,48,485,0.2785714285714286,41,64,45,50,50,50,300,0.36752136752136755,2.0
59,59,58,90,70,73,409,0.5826086956521739,85,90,80,70,80,130,535,0.9262295081967213,1.0
85,90,80,70,80,130,535,0.9262295081967213,76,65,45,92,42,91,411,0.7449664429530202,1.0
85,110,90,45,90,80,500,0.6206896551724138,60,75,100,55,80,50,420,0.3088235294117647,0.5
95,155,109,70,130,81,640,0.6788321167883211,64,165,75,93,83,75,555,0.6587301587301587,2.0
103,60,126,80,126,50,545,0.36363636363636365,45,50,35,55,75,40,300,0.21367521367521367,2.0
50,85,40,85,40,35,335,0.1746031746031746,79,115,70,125,80,111,580,0.8468468468468469,0.5
60,62,63,80,80,60,405,0.38016528925619836,65,125,100,60,70,70,490,0.6099290780141844,0.0
70,140,70,110,65,105,560,0.95,80,185,115,40,105,75,600,0.6230769230769231,0.5
74,48,76,83,81,104,466,0.7913043478260869,65,65,60,110,95,130,525,0.9253731343283582,1.0
75,100,110,45,55,65,450,0.5333333333333333,50,35,55,25,25,15,205,0.05263157894736842,0.5
35,70,55,45,55,25,285,0.09420289855072464,40,55,30,30,30,85,270,0.688,0.25
40,65,40,80,40,65,330,0.5038167938931297,50,70,160,70,160,90,600,0.7417218543046358,2.0
105,180,100,180,100,115,780,0.9477611940298507,110,130,80,70,60,80,530,0.5862068965517241,1.0
60,75,85,100,85,115,520,0.8992248062015504,70,92,65,80,55,98,460,0.8090909090909091,0.5
105,130,120,45,45,40,485,0.4444444444444444,64,51,23,51,23,28,240,0.11363636363636363,1.0
57,24,86,24,86,23,300,0.12727272727272726,67,82,62,46,48,43,348,0.22033898305084745,1.0
85,73,70,73,115,67,483,0.5126050420168067,40,45,35,30,40,55,245,0.3793103448275862,2.0
69,55,45,55,55,15,294,0.11666666666666667,80,110,60,150,130,70,600,0.5042016806722689,0.5
40,35,30,120,70,105,400,0.6692307692307692,50,85,85,55,55,50,380,0.3902439024390244,0.5
40,50,90,30,55,65,330,0.44680851063829785,90,50,34,60,44,70,348,0.6283185840707964,0.125
120,120,120,120,120,120,720,0.9344262295081968,50,70,50,50,50,40,310,0.16296296296296298,1.0
70,75,80,135,80,135,575,0.917910447761194,95,60,79,100,125,81,540,0.6201550387596899,2.0
90,132,105,132,105,30,594,0.4246575342465753,100,120,120,150,100,90,680,0.7880794701986755,0.25
78,65,68,112,154,75,552,0.628099173553719,103,93,67,71,61,84,479,0.7142857142857143,1.0
70,85,70,60,70,50,405,0.28378378378378377,50,50,77,95,77,91,440,0.5916666666666667,2.0
64,115,65,83,63,65,455,0.5323741007194245,50,65,107,105,107,86,520,0.7758620689655172,1.0
62,77,62,50,42,65,358,0.4838709677419355,64,115,65,83,63,65,455,0.5323741007194245,0.0
95,124,78,69,71,58,495,0.37398373983739835,65,136,94,54,96,135,580,0.9612403100775194,1.0
108,130,95,80,85,102,600,0.7637795275590551,68,90,65,50,55,82,410,0.6165413533834586,2.0
80,92,65,65,80,68,450,0.4824561403508772,60,50,100,85,70,65,430,0.47580645161290325,0.5
72,95,67,103,71,122,530,0.9606299212598425,59,63,80,65,80,58,405,0.41843971631205673,0.5
79,115,70,125,80,111,580,0.864,75,75,95,75,95,113,528,0.9015151515151515,1.0
35,60,44,40,54,55,288,0.366412213740458,65,75,90,97,123,44,494,0.1987179487179487,0.5
75,80,55,25,35,35,305,0.18666666666666668,50,53,48,53,48,64,316,0.4076923076923077,1.0
50,40,85,40,65,25,305,0.08870967741935484,100,100,100,100,100,100,600,0.8758169934640523,1.0
50,85,85,55,55,50,380,0.3902439024390244,60,80,50,40,40,30,300,0.15328467153284672,0.5
30,105,90,25,25,50,325,0.2773722627737226,38,30,41,30,41,60,240,0.2897196261682243,1.0
45,40,60,40,75,50,310,0.2926829268292683,40,60,40,40,40,30,250,0.0948905109489051,2.0
75,90,140,60,60,40,465,0.3008130081300813,65,76,84,54,96,105,480,0.9008264462809917,1.0
60,59,85,79,105,36,424,0.16666666666666666,30,56,35,25,35,72,253,0.48148148148148145,1.0
75,75,55,105,85,30,425,0.1619718309859155,60,40,60,40,60,35,295,0.18055555555555555,0.5
55,69,85,32,35,28,304,0.09302325581395349,80,70,40,100,60,145,495,0.921875,1.0
20,10,55,15,20,80,200,0.17985611510791366,80,160,80,130,80,100,630,0.8455284552845529,2.0
95,100,85,108,70,70,528,0.5652173913043478,76,48,48,57,62,34,325,0.11688311688311688,0.5
78,52,60,63,65,23,341,0.06015037593984962,75,95,122,58,75,69,494,0.5725806451612904,1.0
65,50,35,115,95,95,455,0.7333333333333333,100,120,120,150,100,90,680,0.7880794701986755,0.5
75,85,200,55,65,30,510,0.16778523489932887,70,70,70,70,70,70,420,0.5289256198347108,1.0
80,82,100,83,100,80,525,0.6821705426356589,80,92,65,65,80,68,450,0.4824561403508772,2.0
65,90,115,45,115,58,488,0.5041322314049587,62,50,58,73,54,72,369,0.4435483870967742,2.0
60,65,80,170,95,130,600,0.8625954198473282,55,70,45,70,50,60,350,0.45,1.0
60,50,50,60,70,50,340,0.28346456692913385,40,30,50,55,55,100,330,0.584070796460177,1.0
38,36,38,32,36,57,237,0.3893805309734513,67,57,55,77,55,114,425,0.8879310344827587,1.0
100,70,70,65,65,45,415,0.1897810218978102,59,63,80,65,80,58,405,0.41843971631205673,1.0
40,80,35,35,45,70,305,0.4661016949152542,65,65,45,75,45,95,390,0.72,0.25
95,110,80,70,80,50,485,0.37209302325581395,25,20,15,105,55,90,310,0.32407407407407407,1.0
50,50,95,40,50,35,320,0.20279720279720279,109,66,84,81,99,32,471,0.2013888888888889,2.0
70,20,50,20,50,40,250,0.1557377049180328,60,80,110,50,80,45,425,0.2833333333333333,2.0
65,125,60,95,60,105,510,0.9236641221374046,116,55,85,107,95,29,487,0.06818181818181818,0.5
49,49,56,49,61,66,330,0.5190839694656488,35,60,44,40,54,55,288,0.366412213740458,1.0
116,55,85,107,95,29,487,0.06818181818181818,60,40,80,60,45,40,325,0.23529411764705882,0.5
74,48,76,83,81,104,466,0.7913043478260869,67,58,57,81,67,101,431,0.8790322580645161,1.0
35,55,35,30,30,35,220,0.23684210526315788,100,103,75,120,75,127,600,0.940677966101695,1.0
95,155,109,70,130,81,640,0.6788321167883211,125,120,90,170,100,95,700,0.78125,0.5
45,40,60,40,75,50,310,0.2926829268292683,55,85,122,58,75,99,494,0.8099173553719008,0.0
78,92,75,74,63,118,500,0.8842975206611571,50,40,85,40,65,25,305,0.08870967741935484,1.0
60,80,50,50,50,40,330,0.23853211009174313,95,95,85,125,65,55,520,0.3894736842105263,1.0
59,74,50,35,50,35,303,0.3125,70,80,50,35,35,35,305,0.14,1.0
55,40,40,65,45,35,280,0.16428571428571428,90,55,75,60,75,30,385,0.13970588235294118,1.0
50,85,125,85,115,20,480,0.4306569343065693,105,150,90,150,90,95,680,0.8285714285714286,1.0
60,70,65,125,105,90,515,0.6911764705882353,77,85,51,55,51,65,384,0.5163934426229508,0.5
70,50,30,95,135,105,485,0.8040540540540541,60,52,168,47,138,30,495,0.19834710743801653,0.5
40,45,40,35,35,56,251,0.373015873015873,70,120,40,95,40,95,460,0.8106060606060606,1.0
40,55,30,30,30,60,245,0.43548387096774194,65,155,120,65,90,105,600,0.8677685950413223,2.0
68,75,53,83,113,60,452,0.45384615384615384,45,30,50,65,50,45,285,0.13821138211382114,1.0
30,40,70,70,25,60,295,0.41353383458646614,55,55,85,65,85,35,380,0.2014388489208633,1.0
60,80,95,70,85,50,440,0.2231404958677686,61,90,45,50,50,160,456,0.9230769230769231,1.0
65,65,60,130,95,110,525,0.823943661971831,91,129,90,72,90,108,580,0.8536585365853658,1.0
59,110,150,45,49,35,448,0.3333333333333333,44,58,44,58,44,61,309,0.41964285714285715,0.5
55,40,50,65,85,40,335,0.3181818181818182,85,120,70,50,60,100,485,0.8308823529411765,0.0
75,125,230,55,95,30,610,0.3448275862068966,36,50,50,65,60,44,305,0.16363636363636364,2.0
65,90,120,85,70,60,490,0.43410852713178294,95,80,105,40,70,100,490,0.8046875,1.0
73,100,60,100,60,65,458,0.42657342657342656,35,65,35,65,35,65,300,0.46621621621621623,1.0
60,40,80,60,45,40,325,0.23529411764705882,75,70,90,70,105,80,490,0.656,0.25
70,100,115,30,65,30,410,0.24390243902439024,90,92,75,92,85,60,494,0.49586776859504134,2.0
59,63,80,65,80,58,405,0.41843971631205673,90,120,120,60,60,50,500,0.35294117647058826,2.0
60,79,105,59,85,36,424,0.17054263565891473,100,50,80,60,80,50,420,0.34375,0.5
75,75,75,125,95,40,485,0.15671641791044777,106,190,100,154,100,130,780,0.9259259259259259,0.5
85,110,90,45,90,80,500,0.6206896551724138,75,125,230,55,95,30,610,0.3448275862068966,0.5
123,77,72,99,92,58,521,0.4621212121212121,35,65,35,65,35,65,300,0.46621621621621623,0.5
40,55,80,35,60,30,300,0.15037593984962405,75,98,63,98,63,101,498,0.889763779527559,0.5
50,85,55,65,65,90,410,0.7478260869565218,50,75,45,40,45,60,315,0.4380165289256198,2.0
90,95,105,165,110,45,610,0.2890625,60,40,50,75,85,95,405,0.6044776119402985,0.5
75,70,90,70,105,80,490,0.656,50,92,108,92,108,35,485,0.2457627118644068,1.0
95,125,79,60,100,81,540,0.6165413533834586,65,75,105,35,65,85,430,0.6940298507462687,2.0
75,85,200,55,65,30,510,0.16778523489932887,79,85,60,55,60,71,410,0.60431654676259,0.5
50,70,100,40,40,30,330,0.2222222222222222,70,95,125,65,75,45,475,0.33613445378151263,4.0
75,100,95,40,70,110,490,0.8717948717948718,95,110,95,40,95,55,490,0.40336134453781514,1.0
67,57,55,77,55,114,425,0.8879310344827587,86,81,97,81,107,43,495,0.203125,1.0
54,78,103,53,45,22,355,0.23255813953488372,80,100,80,80,80,100,520,0.9051724137931034,0.5
90,60,60,40,40,40,330,0.29545454545454547,75,80,85,110,90,50,490,0.3548387096774194,1.0
60,59,85,79,105,36,424,0.16666666666666666,65,75,105,35,65,85,430,0.6940298507462687,0.5
38,30,85,55,65,30,303,0.21428571428571427,100,50,80,60,80,50,420,0.34375,1.0
90,60,70,75,70,45,410,0.23880597014925373,85,76,64,45,55,90,415,0.6739130434782609,1.0
110,135,60,50,65,88,508,0.7744360902255639,105,95,80,40,80,90,490,0.753968253968254,1.0
65,95,75,55,55,85,430,0.6933333333333334,60,85,69,65,79,80,438,0.576,0.5
65,65,60,110,95,130,525,0.9253731343283582,65,90,65,61,61,100,442,0.8373983739837398,2.0
90,30,15,40,20,15,210,0.043478260869565216,55,65,95,95,45,85,440,0.6610169491525424,1.0
54,66,70,44,55,46,335,0.4214876033057851,70,110,80,55,80,105,500,0.8794326241134752,0.25
58,70,45,40,45,42,300,0.25925925925925924,80,75,150,75,150,50,580,0.30973451327433627,1.0
1,90,45,30,30,40,236,0.33064516129032256,65,40,70,80,140,70,465,0.5954198473282443,0.5
100,100,100,100,100,100,600,0.831858407079646,80,70,40,100,60,145,495,0.921875,1.0
72,60,30,20,30,25,237,0.11570247933884298,55,104,105,94,75,52,485,0.36363636363636365,1.0
85,105,100,79,83,78,530,0.5869565217391305,69,55,45,55,55,15,294,0.11666666666666667,0.5
60,50,50,60,70,50,340,0.28346456692913385,66,65,48,62,57,52,350,0.36220472440944884,0.25
71,95,85,110,95,79,535,0.664,40,45,40,35,35,56,251,0.373015873015873,2.0
75,125,100,70,80,45,495,0.33035714285714285,70,145,88,140,70,112,625,0.8888888888888888,0.0625
108,130,95,80,85,102,600,0.7637795275590551,76,104,71,104,71,108,534,0.912751677852349,2.0
40,70,130,60,130,25,455,0.17355371900826447,40,29,45,29,45,36,224,0.14634146341463414,1.0
30,40,55,40,55,60,280,0.3237410071942446,50,120,53,35,110,87,455,0.640625,1.0
63,60,55,50,50,71,349,0.5289256198347108,60,60,60,35,35,30,280,0.11194029850746269,1.0
80,105,65,60,75,130,515,0.9645390070921985,35,55,40,45,40,60,275,0.35714285714285715,0.5
80,135,130,95,90,70,600,0.5181818181818182,45,55,39,35,39,42,255,0.18518518518518517,1.0
50,80,95,10,45,10,290,0.232,45,85,50,55,50,65,350,0.5076923076923077,0.5
20,10,55,15,20,80,200,0.17985611510791366,45,20,50,60,120,50,345,0.24074074074074073,0.5
55,95,115,45,45,35,390,0.2116788321167883,63,63,47,41,41,74,329,0.56,2.0
45,45,55,45,55,63,308,0.4594594594594595,80,120,130,55,65,45,495,0.37037037037037035,4.0
50,50,40,50,40,64,294,0.45588235294117646,91,90,72,90,129,108,580,0.896,0.5
86,92,88,68,75,73,482,0.6835443037974683,100,70,70,65,65,45,415,0.1897810218978102,1.0
100,103,75,120,75,127,600,0.940677966101695,125,170,100,120,90,95,700,0.77,0.5
100,180,160,150,90,90,770,0.7520661157024794,74,100,72,90,72,46,454,0.24561403508771928,1.0
80,100,200,50,100,50,580,0.3472222222222222,105,125,100,60,100,100,590,0.8359375,1.0
80,82,100,83,100,80,525,0.6821705426356589,71,73,88,120,89,59,500,0.43537414965986393,2.0
50,50,150,50,150,50,500,0.2571428571428571,60,55,145,75,150,40,525,0.2,0.25
50,50,150,50,150,50,500,0.2571428571428571,90,130,80,65,85,55,505,0.4396551724137931,1.0
70,50,30,95,135,105,485,0.8040540540540541,130,65,60,110,95,65,525,0.5227272727272727,0.5
58,64,58,80,65,80,405,0.5423728813559322,45,100,45,45,45,10,290,0.2949640287769784,1.0
58,64,58,80,65,80,405,0.5423728813559322,80,92,65,65,80,68,450,0.4824561403508772,0.5
70,80,102,80,102,40,474,0.2677165354330709,90,100,60,90,60,80,480,0.6422764227642277,8.0
60,48,45,43,90,42,328,0.21897810218978103,106,110,90,154,90,130,680,0.926829268292683,0.5
80,100,200,50,100,50,580,0.3472222222222222,58,70,45,40,45,42,300,0.25925925925925924,0.5
74,48,76,83,81,104,466,0.7322834645669292,44,75,35,63,33,45,295,0.2647058823529412,1.0
85,73,70,73,115,67,483,0.5126050420168067,50,65,90,35,35,15,290,0.14678899082568808,1.0
70,120,100,145,105,20,560,0.2824427480916031,60,48,45,43,90,42,328,0.21897810218978103,1.0
85,56,77,50,77,78,423,0.53125,20,15,20,10,55,80,200,0.2682926829268293,1.0
45,63,37,65,55,95,360,0.8055555555555556,55,55,50,45,65,55,325,0.37373737373737376,1.0
50,65,64,44,48,43,314,0.2196969696969697,45,85,70,40,40,60,340,0.5229357798165137,1.0
90,55,75,60,75,30,385,0.13970588235294118,70,70,40,60,40,60,340,0.4247787610619469,1.0
75,80,60,65,90,102,472,0.8625954198473282,55,85,55,50,55,60,360,0.4233576642335766,1.0
40,30,32,50,52,65,269,0.3671875,89,145,90,105,80,91,600,0.8549618320610687,1.0
44,38,39,61,79,42,303,0.2251655629139073,45,53,70,40,60,42,310,0.25735294117647056,1.0
85,80,70,135,75,90,535,0.7006802721088435,100,164,150,95,120,71,700,0.5645161290322581,0.5
55,55,55,85,55,30,335,0.1320754716981132,50,35,55,25,25,15,205,0.021739130434782608,1.0
106,190,100,154,100,130,780,0.9259259259259259,79,85,60,55,60,71,410,0.60431654676259,2.0
80,120,130,55,65,45,495,0.37037037037037035,40,30,35,50,70,55,280,0.28205128205128205,1.0
82,121,119,69,59,71,521,0.5394736842105263,60,115,105,65,70,80,495,0.7181818181818181,1.0
10,55,25,35,45,95,265,0.5396825396825397,60,95,80,60,80,30,405,0.19480519480519481,0.25
60,55,145,75,150,40,525,0.2,40,27,60,37,50,66,280,0.36220472440944884,0.5
60,40,60,95,60,55,370,0.4222222222222222,60,62,50,62,60,40,334,0.18181818181818182,4.0
50,50,95,40,50,35,320,0.20279720279720279,70,85,70,60,70,50,405,0.28378378378378377,1.0
71,95,85,110,95,79,535,0.664,50,65,107,105,107,86,520,0.703125,0.5
65,75,105,35,65,85,430,0.6940298507462687,65,85,70,75,70,40,405,0.203125,1.0
90,120,100,150,120,100,680,0.7718120805369127,80,70,40,100,60,145,495,0.921875,1.0
62,73,55,56,52,84,382,0.7244094488188977,76,147,90,60,70,97,540,0.8267716535433071,0.5
75,105,75,105,75,45,480,0.3274336283185841,40,30,30,55,30,85,270,0.4666666666666667,0.5
45,80,100,35,37,28,325,0.3125,40,30,35,45,40,55,245,0.31496062992125984,1.0
62,55,52,109,94,109,481,0.7833333333333333,55,35,50,55,110,85,390,0.6277372262773723,2.0
55,70,45,70,50,60,350,0.45,60,60,60,60,60,60,360,0.38095238095238093,1.0
70,62,67,55,55,56,365,0.38513513513513514,80,120,130,55,65,45,495,0.37037037037037035,0.25
80,80,80,80,80,80,480,0.6015037593984962,75,75,75,125,95,40,485,0.15671641791044777,1.0
59,74,50,35,50,35,303,0.3125,60,50,100,85,70,65,430,0.47580645161290325,0.0
255,10,10,75,135,55,540,0.3125,75,125,100,70,80,45,495,0.33035714285714285,0.5
65,40,70,80,140,70,465,0.5954198473282443,89,125,90,115,80,101,600,0.8725490196078431,2.0
150,100,120,100,120,90,680,0.6666666666666666,75,95,125,45,75,95,510,0.8257575757575758,1.0
65,155,120,65,90,105,600,0.8677685950413223,50,50,40,50,40,64,294,0.45588235294117646,1.0
68,75,53,83,113,60,452,0.45384615384615384,50,35,55,25,25,15,205,0.021739130434782608,1.0
83,80,75,70,70,101,479,0.8615384615384616,30,56,35,25,35,72,253,0.48148148148148145,1.0
110,65,75,125,85,30,490,0.15,60,85,69,60,69,77,420,0.518796992481203,1.0
65,105,60,60,70,95,455,63.0,80,110,120,130,90,70,600,0.6198347107438017,1.0
75,90,90,140,90,115,600,0.9481481481481482,105,140,55,30,55,95,480,0.8195488721804511,0.5
10,55,25,35,45,95,265,0.5396825396825397,90,92,75,92,85,60,494,0.49586776859504134,0.5
73,100,60,100,60,65,458,0.42657342657342656,150,80,44,90,54,80,498,0.625,0.5
50,50,50,50,50,50,300,0.30708661417322836,40,55,70,45,60,30,300,0.10619469026548672,0.5
75,69,72,114,100,104,534,0.8253968253968254,65,85,70,75,70,40,405,0.203125,1.0
50,47,50,57,50,65,319,0.463768115942029,75,95,122,58,75,69,494,0.5725806451612904,0.5
80,80,80,80,80,80,480,0.6015037593984962,45,50,55,75,65,30,320,0.06293706293706294,2.0
115,45,20,45,25,20,270,0.11538461538461539,83,106,65,86,65,85,490,0.6640625,1.0
50,65,45,85,65,95,405,0.7238095238095238,50,35,55,25,25,15,205,0.05263157894736842,0.5
65,130,60,95,110,65,525,0.5303030303030303,40,30,30,40,50,30,220,0.07936507936507936,1.0
90,132,105,132,105,30,594,0.4246575342465753,85,105,100,79,83,78,530,0.5869565217391305,1.0
72,58,80,103,80,97,490,0.7171052631578947,73,76,75,81,100,100,505,0.8110236220472441,1.0
40,40,40,70,40,20,250,0.032520325203252036,70,20,50,20,50,40,250,0.1557377049180328,0.5
35,45,160,30,45,70,385,0.48148148148148145,30,30,42,30,42,70,244,0.4230769230769231,0.0
30,40,55,40,55,60,280,0.3237410071942446,50,55,50,36,30,43,264,0.2922077922077922,1.0
64,51,23,51,23,28,240,0.11363636363636363,45,60,30,80,50,65,330,0.4603174603174603,1.0
70,92,65,80,55,98,460,0.8090909090909091,70,80,70,80,70,110,480,0.6594202898550725,1.0
55,85,122,58,75,99,494,0.8099173553719008,50,50,95,40,50,35,320,0.20279720279720279,2.0
50,105,125,55,95,50,480,0.375886524822695,190,33,58,33,58,33,405,0.13432835820895522,1.0
40,30,35,50,70,55,280,0.28205128205128205,66,65,48,62,57,52,350,0.36220472440944884,1.0
45,55,39,35,39,42,255,0.18518518518518517,80,185,115,40,105,75,600,0.6230769230769231,1.0
62,73,55,56,52,84,382,0.7244094488188977,45,60,45,25,45,55,275,0.29,1.0
50,105,79,35,110,76,455,0.6214285714285714,85,50,95,120,115,80,545,0.5793650793650794,0.25
62,55,52,109,94,109,481,0.7833333333333333,65,136,94,54,96,135,580,0.9612403100775194,1.0
79,100,80,110,90,121,580,0.968,75,80,70,65,75,90,455,0.7578125,1.0
60,85,69,65,79,80,438,0.576,65,90,65,61,61,100,442,0.8373983739837398,1.0
50,50,62,40,62,65,329,0.4188034188034188,85,56,77,50,77,78,423,0.53125,0.5
64,88,50,88,50,106,446,0.9111111111111111,60,59,85,79,105,36,424,0.16666666666666666,1.0
46,57,40,40,40,50,273,0.25,30,65,100,45,25,40,305,0.1891891891891892,1.0
30,65,100,45,25,40,305,0.1891891891891892,65,100,70,80,80,105,500,0.8666666666666667,2.0
85,110,90,45,90,80,500,0.6206896551724138,125,130,90,130,90,95,660,0.7734375,1.0
103,60,86,60,86,50,445,0.3458646616541353,100,73,83,73,83,55,467,0.371900826446281,1.0
106,150,70,194,120,140,780,0.952,75,125,100,70,80,45,495,0.33035714285714285,1.0
40,27,60,37,50,66,280,0.36220472440944884,70,105,105,50,40,20,390,0.33587786259541985,2.0
70,55,65,95,85,70,440,0.5307692307692308,50,53,62,58,63,44,330,0.13709677419354838,1.0
76,25,45,67,55,24,292,0.0390625,75,70,90,70,105,80,490,0.656,1.0
50,105,79,35,110,76,455,0.6214285714285714,130,70,35,70,35,60,400,0.4017857142857143,1.0
70,94,50,94,50,66,424,0.48148148148148145,55,69,85,32,35,28,304,0.09302325581395349,1.0
20,40,15,35,35,60,205,0.34285714285714286,70,45,48,60,65,35,323,0.15748031496062992,1.0
70,110,70,115,70,90,525,0.75,40,40,35,50,100,70,335,0.5031847133757962,0.25
80,80,80,55,55,90,440,0.6417910447761194,52,65,55,58,62,60,352,0.4482758620689655,1.0
40,20,30,40,80,55,265,0.22764227642276422,75,87,63,87,63,98,473,0.865546218487395,0.5
55,75,85,25,25,15,280,0.1875,90,85,100,95,125,85,580,0.6834532374100719,4.0
75,95,67,125,95,83,540,0.7117117117117117,70,70,115,130,90,60,535,0.5338983050847458,2.0
95,75,110,100,80,30,490,0.15267175572519084,75,75,75,125,95,40,485,0.15671641791044777,0.5
30,40,55,40,55,60,280,0.3237410071942446,50,65,107,105,107,86,520,0.7758620689655172,1.0
84,86,88,111,101,60,530,0.4634146341463415,80,100,80,80,80,100,520,0.9051724137931034,1.0
40,30,35,50,70,55,280,0.28205128205128205,20,10,55,15,20,80,200,0.17985611510791366,2.0
51,65,65,80,75,59,395,0.4365079365079365,85,105,85,40,50,40,405,0.211864406779661,1.0
106,90,130,90,154,110,680,0.8699186991869918,70,115,60,115,60,55,475,0.4647887323943662,0.0
90,100,90,125,85,90,580,0.7352941176470589,70,60,75,110,75,90,480,0.7165354330708661,4.0
50,65,45,85,65,95,405,0.7238095238095238,50,45,45,35,35,50,260,0.23529411764705882,1.0
75,75,55,105,85,30,425,0.1619718309859155,80,100,123,122,120,80,625,0.56,0.25
70,90,70,60,60,70,420,0.6390977443609023,65,65,60,130,95,110,525,0.823943661971831,2.0
82,121,119,69,59,71,521,0.5394736842105263,85,90,80,70,80,130,535,0.9262295081967213,2.0
58,109,112,48,48,109,484,0.8805970149253731,45,30,15,85,65,65,305,0.36220472440944884,4.0
55,70,45,70,50,60,350,0.45,45,30,35,20,20,45,195,0.14782608695652175,2.0
75,75,55,105,85,30,425,0.1619718309859155,60,65,80,170,95,130,600,0.8625954198473282,0.5
160,110,65,65,110,30,540,0.35714285714285715,100,150,90,180,160,90,770,0.7348484848484849,1.0
72,95,67,103,71,122,530,0.9606299212598425,30,40,55,40,55,60,280,0.3237410071942446,1.0
71,95,85,110,95,79,535,0.664,61,72,57,55,55,65,365,0.3984375,1.0
120,100,85,30,85,45,465,0.22448979591836735,59,110,150,45,49,35,448,0.3333333333333333,0.0
75,125,75,30,75,85,465,0.625,75,80,60,65,90,102,472,0.8625954198473282,2.0
89,124,80,55,80,55,483,0.5714285714285714,80,80,80,80,80,80,480,0.5606060606060606,1.0
60,150,50,150,50,60,520,0.5,73,95,62,85,65,85,465,0.6666666666666666,0.0
85,100,122,58,75,54,494,0.3939393939393939,30,42,118,42,88,30,350,0.112,1.0
108,112,118,68,72,47,525,0.2916666666666667,65,45,55,45,70,45,325,0.24369747899159663,1.0
58,50,145,95,105,30,483,0.2459016393442623,90,120,75,60,60,45,450,0.29411764705882354,1.0
67,82,62,46,48,43,348,0.22033898305084745,100,100,100,100,100,100,600,0.8602941176470589,1.0
55,68,64,45,55,31,318,0.11666666666666667,90,85,100,95,125,85,580,0.6834532374100719,0.5
65,90,122,58,75,84,494,0.71875,31,45,90,30,30,40,266,0.21929824561403508,1.0
60,90,70,60,120,40,440,0.27419354838709675,70,55,75,45,65,60,370,0.45901639344262296,1.0
95,125,79,60,100,81,540,0.6165413533834586,100,100,100,100,100,100,600,0.8345864661654135,1.0
60,40,60,40,60,35,295,0.18055555555555555,100,128,90,77,77,128,600,0.959349593495935,1.0
95,155,109,70,130,81,640,0.6788321167883211,75,75,60,83,60,60,413,0.39344262295081966,0.5
70,90,110,60,75,95,500,0.7333333333333333,45,22,60,27,30,29,213,0.07518796992481203,1.0
65,150,60,115,60,115,565,0.935251798561151,50,52,48,65,50,55,320,0.33098591549295775,1.0
90,120,100,150,120,100,680,0.7718120805369127,69,69,76,69,86,91,460,0.6554621848739496,0.5
95,109,105,75,85,56,525,0.34513274336283184,75,100,110,45,55,65,450,0.5333333333333333,2.0
80,185,115,40,105,75,600,0.6230769230769231,108,170,115,120,95,92,700,0.7083333333333334,1.0
50,65,107,105,107,86,520,0.7313432835820896,70,60,70,87,78,85,450,0.6228070175438597,0.25
100,100,80,60,60,50,450,0.3050847457627119,70,115,60,115,60,55,475,0.4647887323943662,1.0
105,140,95,55,65,45,505,0.3,86,76,86,116,56,95,515,0.7982456140350878,0.25
75,90,140,60,60,40,465,0.3008130081300813,20,10,55,15,20,80,200,0.17985611510791366,0.5
99,68,83,72,87,51,460,0.417910447761194,54,63,52,83,56,97,405,0.7697841726618705,2.0
70,60,125,115,70,55,495,0.35507246376811596,150,80,44,90,54,80,498,0.625,2.0
28,25,25,45,35,40,198,0.16083916083916083,60,80,50,50,50,40,330,0.23853211009174313,1.0
90,65,65,40,40,15,315,0.19672131147540983,80,185,115,40,105,75,600,0.6230769230769231,1.0
40,40,55,40,70,55,300,0.40939597315436244,60,80,95,70,85,50,440,0.2231404958677686,1.0
108,170,115,120,95,92,700,0.7083333333333334,60,25,35,70,80,60,330,0.3076923076923077,1.0
72,60,30,20,30,25,237,0.11570247933884298,80,82,78,95,80,85,500,0.6869565217391305,1.0
50,30,55,65,55,20,275,0.13675213675213677,45,95,50,40,50,75,355,0.54,1.0
105,140,95,55,65,45,505,0.3,150,160,100,95,65,100,670,0.8866666666666667,2.0
70,120,100,145,105,20,560,0.2824427480916031,62,50,58,73,54,72,369,0.4435483870967742,1.0
64,78,52,78,52,81,405,0.6422764227642277,45,55,39,35,39,42,255,0.18518518518518517,2.0
66,41,77,61,87,23,355,0.12096774193548387,80,82,83,100,100,80,525,0.6742424242424242,0.25
50,35,55,25,25,15,205,0.05263157894736842,55,81,60,50,70,97,413,0.7214285714285714,1.0
45,80,100,35,37,28,325,0.3125,95,85,85,65,65,35,430,0.2571428571428571,0.5
55,66,44,44,56,85,350,0.6888888888888889,60,85,49,60,49,60,363,0.4444444444444444,1.0
106,130,90,110,154,90,680,0.719626168224299,35,55,40,45,40,60,275,0.35714285714285715,0.5
55,45,43,55,43,72,313,0.5853658536585366,45,85,50,55,50,65,350,0.5076923076923077,2.0
50,50,62,40,62,65,329,0.4188034188034188,70,70,70,70,70,70,420,0.5289256198347108,1.0
170,90,45,90,45,60,500,0.427536231884058,50,50,120,80,80,30,410,0.07258064516129033,4.0
50,53,48,53,48,64,316,0.358974358974359,97,165,60,65,50,58,495,0.3902439024390244,2.0
65,80,80,59,63,58,405,0.4411764705882353,60,95,80,60,80,30,405,0.19480519480519481,0.5
250,5,5,35,105,50,450,0.15306122448979592,60,60,60,85,85,85,435,0.631578947368421,0.0
100,100,100,100,100,100,600,0.8805970149253731,45,100,135,65,135,45,525,0.29411764705882354,1.0
65,65,65,50,50,90,385,0.72,80,120,80,120,80,100,580,0.8478260869565217,1.0
45,53,70,40,60,42,310,0.25735294117647056,100,134,110,95,100,61,600,0.4057971014492754,4.0
60,45,70,75,85,55,390,0.3008130081300813,50,53,62,58,63,44,330,0.13709677419354838,1.0
170,90,45,90,45,60,500,0.427536231884058,35,55,40,45,40,60,275,0.35714285714285715,1.0
61,84,65,70,70,70,420,0.5,79,115,70,125,80,111,580,0.864,1.0
60,69,95,69,95,36,424,0.2608695652173913,60,85,40,30,45,68,328,0.6422018348623854,1.0
55,85,122,58,75,99,494,0.8099173553719008,50,40,85,40,65,25,305,0.08870967741935484,0.5
80,100,123,122,120,80,625,0.56,40,45,40,65,40,65,295,0.5661764705882353,1.0
90,110,80,100,80,95,555,0.7982456140350878,75,105,75,105,75,45,480,0.3274336283185841,0.5
90,65,65,40,40,15,315,0.19672131147540983,50,53,48,53,48,64,316,0.358974358974359,0.5
50,52,48,65,50,55,320,0.33098591549295775,70,92,65,80,55,98,460,0.8090909090909091,0.5
55,50,65,175,95,150,590,0.7818181818181819,60,45,70,75,85,55,390,0.3008130081300813,0.5
70,80,102,80,102,40,474,0.2677165354330709,80,185,115,40,105,75,600,0.6230769230769231,2.0
75,105,75,105,75,45,480,0.3274336283185841,105,140,55,30,55,95,480,0.8195488721804511,2.0
75,87,63,87,63,98,473,0.865546218487395,100,100,90,150,140,90,670,0.71875,0.5
55,104,105,94,75,52,485,0.36363636363636365,50,53,62,58,63,44,330,0.13709677419354838,0.5
60,100,89,55,69,112,485,0.9298245614035088,50,95,95,35,110,70,455,0.5179856115107914,0.5
105,95,80,40,80,90,490,0.753968253968254,76,104,71,104,71,108,534,0.912751677852349,1.0
30,42,118,42,88,30,350,0.112,69,69,76,69,86,91,460,0.6554621848739496,0.5
40,65,95,60,45,35,340,0.13986013986013987,75,90,90,140,90,115,600,0.9481481481481482,1.0
40,80,100,30,30,20,300,0.11851851851851852,65,150,60,115,60,115,565,0.935251798561151,1.0
80,95,82,60,82,75,474,0.6,50,100,150,100,150,50,600,0.37142857142857144,1.0
70,90,110,60,75,95,500,0.7333333333333333,55,75,50,40,40,80,340,0.6302521008403361,1.0
45,65,34,40,34,45,263,0.2589928057553957,50,52,48,65,50,55,320,0.33098591549295775,2.0
60,80,110,50,80,45,425,0.2833333333333333,60,52,168,47,138,30,495,0.19834710743801653,4.0
80,110,60,150,130,70,600,0.5042016806722689,80,80,80,80,80,80,480,0.6015037593984962,1.0
60,85,42,85,42,91,405,0.8227848101265823,70,55,55,80,60,45,365,0.2222222222222222,0.5
50,160,110,160,110,110,700,0.8854961832061069,86,92,88,68,75,73,482,0.6835443037974683,2.0
75,85,200,55,65,30,510,0.16778523489932887,30,30,42,30,42,70,244,0.4230769230769231,0.0
79,103,120,135,115,78,630,0.5763888888888888,69,69,76,69,86,91,460,0.6554621848739496,0.5
55,50,65,175,95,150,590,0.7818181818181819,65,65,65,50,50,90,385,0.72,1.0
64,165,75,93,83,75,555,0.6587301587301587,76,25,45,67,55,24,292,0.0390625,2.0
95,110,80,70,80,50,485,0.37209302325581395,10,55,25,35,45,95,265,0.5396825396825397,2.0
70,60,70,87,78,85,450,0.6228070175438597,85,120,70,50,60,100,485,0.8308823529411765,0.5
108,130,95,80,85,102,600,0.7637795275590551,65,105,60,60,70,95,455,63.0,1.0
55,68,64,45,55,31,318,0.11666666666666667,50,85,85,55,55,50,380,0.3902439024390244,0.5
44,38,33,61,43,70,289,0.5267857142857143,71,120,95,120,95,99,600,0.8203125,0.5
80,75,150,75,150,50,580,0.30973451327433627,190,33,58,33,58,33,405,0.13432835820895522,1.0
75,80,55,25,35,35,305,0.18666666666666668,53,54,53,37,46,45,288,0.3090909090909091,1.0
90,132,105,132,105,30,594,0.4246575342465753,20,40,15,35,35,60,205,0.34285714285714286,1.0
25,35,70,95,55,45,325,0.16783216783216784,62,44,50,44,50,55,305,0.3629032258064516,2.0
60,50,70,80,80,140,480,0.8449612403100775,90,85,100,95,125,85,580,0.6834532374100719,2.0
105,30,105,140,105,55,540,0.3524590163934426,58,64,58,80,65,80,405,0.609271523178808,0.5
90,93,55,70,55,55,418,0.3819444444444444,40,45,35,65,55,70,310,0.4482758620689655,2.0
55,65,35,60,30,85,330,0.6126126126126126,45,55,45,65,45,75,330,0.5692307692307692,1.0
75,55,70,55,95,110,460,0.8444444444444444,50,70,50,50,50,40,310,0.16296296296296298,2.0
85,90,80,70,80,130,535,0.9262295081967213,80,70,40,100,60,145,495,0.921875,2.0
60,50,50,60,70,50,340,0.28346456692913385,78,70,61,50,61,100,420,0.8145161290322581,1.0
65,65,60,130,95,110,525,0.823943661971831,80,120,79,95,79,70,523,0.5833333333333334,1.0
40,40,50,30,30,30,220,0.0873015873015873,75,125,75,30,75,85,465,0.625,1.0
100,110,90,85,90,60,535,0.47794117647058826,80,100,70,50,60,45,405,0.25806451612903225,1.0
70,120,65,45,85,125,510,0.9747899159663865,64,115,65,83,63,65,455,0.5323741007194245,2.0
85,97,66,105,66,65,484,0.47107438016528924,44,75,35,63,33,45,295,0.2647058823529412,1.0
65,40,50,125,60,30,370,0.07258064516129033,65,65,60,130,95,110,525,0.823943661971831,0.5
90,120,120,60,60,50,500,0.35294117647058826,45,30,50,65,50,45,285,0.13821138211382114,1.0
40,60,40,40,40,30,250,0.0948905109489051,70,140,70,110,65,105,560,0.95,2.0
75,85,200,55,65,30,510,0.16778523489932887,20,40,90,30,90,25,295,0.11363636363636363,1.0
100,100,100,100,100,100,600,0.831858407079646,60,85,60,85,60,55,405,0.3673469387755102,1.0
100,90,130,45,65,55,485,0.4253731343283582,100,164,150,95,120,71,700,0.5645161290322581,2.0
75,125,70,125,70,115,580,0.9037037037037037,50,50,120,80,80,30,410,0.07258064516129033,1.0
75,95,60,65,60,115,470,0.8778625954198473,55,69,85,32,35,28,304,0.09302325581395349,1.0
70,110,70,115,70,90,525,0.75,84,71,43,71,43,48,360,0.25874125874125875,2.0
70,94,50,94,50,66,424,0.48148148148148145,100,123,75,57,75,80,510,0.6923076923076923,0.5
90,132,105,132,105,30,594,0.4246575342465753,44,48,65,50,64,43,314,0.1623931623931624,1.0
75,69,72,114,100,104,534,0.8253968253968254,75,100,95,40,70,110,490,0.8717948717948718,1.0
50,65,64,44,48,43,314,0.2196969696969697,99,68,83,72,87,51,460,0.417910447761194,0.5
130,65,60,110,95,65,525,0.5227272727272727,55,50,45,135,95,120,500,0.7714285714285715,1.0
40,45,40,35,35,56,251,0.373015873015873,40,80,35,35,45,70,305,0.4661016949152542,2.0
50,75,35,70,30,40,300,0.21296296296296297,63,120,85,90,55,55,468,0.2809917355371901,2.0
111,83,68,92,82,39,475,0.1774193548387097,75,80,70,65,75,90,455,0.7578125,0.0
44,50,91,24,86,10,305,0.1981981981981982,40,27,60,37,50,66,280,0.36220472440944884,0.25
40,30,32,50,52,65,269,0.3671875,72,105,115,54,86,68,500,0.5149253731343284,1.0
65,75,105,35,65,85,430,0.6940298507462687,74,48,76,83,81,104,466,0.7913043478260869,1.0
85,105,55,85,50,115,495,0.9032258064516129,60,67,85,77,75,116,480,0.8888888888888888,0.5
95,80,105,40,70,100,490,0.8046875,100,150,90,180,160,90,770,0.7348484848484849,1.0
86,92,88,68,75,73,482,0.6835443037974683,45,85,70,40,40,60,340,0.5229357798165137,0.0
55,95,115,45,45,35,390,0.2116788321167883,82,80,86,85,75,72,480,0.6183206106870229,1.0
60,60,60,60,60,60,360,0.38095238095238093,70,75,60,105,60,105,475,0.88,1.0
60,50,150,50,150,60,520,0.5206611570247934,44,58,44,58,44,61,309,0.41964285714285715,0.5
95,75,180,130,80,30,590,0.13793103448275862,55,55,85,65,85,35,380,0.2014388489208633,1.0
75,95,122,58,75,69,494,0.5725806451612904,86,92,88,68,75,73,482,0.6835443037974683,1.0
55,68,64,45,55,31,318,0.11666666666666667,80,80,90,110,130,110,600,0.8721804511278195,0.5
65,136,94,54,96,135,580,0.9612403100775194,90,93,55,70,55,55,418,0.3819444444444444,1.0
50,160,110,160,110,110,700,0.8854961832061069,40,55,80,35,60,30,300,0.15037593984962405,0.25
89,125,90,115,80,101,600,0.8725490196078431,95,135,80,110,80,100,600,0.8248175182481752,0.0
50,50,40,50,40,64,294,0.45588235294117646,50,50,95,40,50,35,320,0.20279720279720279,2.0
106,110,90,154,90,130,680,0.926829268292683,35,45,160,30,45,70,385,0.48148148148148145,2.0
110,85,95,80,95,50,515,0.2713178294573643,80,120,70,110,70,80,530,0.6422764227642277,1.0
35,20,65,40,65,20,245,0.02459016393442623,80,100,70,60,70,95,475,0.7416666666666667,1.0
55,50,45,135,95,120,500,0.7714285714285715,49,55,42,42,37,85,310,0.6068376068376068,1.0
65,75,90,97,123,44,494,0.1987179487179487,70,105,105,50,40,20,390,0.33587786259541985,0.5
65,155,120,65,90,105,600,0.8677685950413223,45,50,45,115,55,95,405,0.6936936936936937,0.25
100,70,70,65,65,45,415,0.1897810218978102,100,150,140,100,90,90,670,0.7969924812030075,1.0
80,160,80,130,80,100,630,0.8455284552845529,55,65,35,60,30,85,330,0.6126126126126126,0.5
54,45,47,75,98,52,371,0.39669421487603307,50,75,45,40,45,60,315,0.4380165289256198,1.0
115,115,85,90,75,100,580,0.8134328358208955,30,105,90,25,25,50,325,0.2773722627737226,0.5
135,85,40,40,85,5,390,0.6864406779661016,40,30,32,50,52,65,269,0.3671875,1.0
30,30,42,30,42,70,244,0.4230769230769231,90,90,85,125,90,100,580,0.768595041322314,0.25
60,40,50,75,85,95,405,0.6044776119402985,40,50,45,70,45,70,320,0.5517241379310345,2.0
64,165,75,93,83,75,555,0.6587301587301587,41,50,37,50,37,66,281,0.5175438596491229,0.5
75,95,122,58,75,69,494,0.5725806451612904,60,70,105,70,120,75,500,0.5983606557377049,4.0
50,52,48,65,50,55,320,0.33098591549295775,50,180,20,180,20,150,600,0.9029850746268657,1.0
76,25,45,67,55,24,292,0.0390625,40,45,35,40,40,90,290,0.65,1.0
70,120,65,45,85,125,510,0.9747899159663865,80,185,115,40,105,75,600,0.6230769230769231,0.5
85,90,80,70,80,130,535,0.9262295081967213,60,50,100,85,70,65,430,0.47580645161290325,1.0
80,185,115,40,105,75,600,0.6230769230769231,40,40,35,50,100,70,335,0.5031847133757962,0.25
90,95,105,165,110,45,610,0.2890625,126,131,95,131,98,99,680,0.8102189781021898,2.0
80,80,90,110,130,110,600,0.8721804511278195,75,90,50,110,80,95,500,0.7985611510791367,0.0
41,50,37,50,37,66,281,0.5175438596491229,50,120,53,35,110,87,455,0.640625,0.5
95,80,105,40,70,100,490,0.8046875,44,38,33,61,43,70,289,0.5267857142857143,1.0
65,130,60,75,60,75,465,0.689922480620155,45,50,43,40,38,62,278,0.40441176470588236,1.0
46,57,40,40,40,50,273,0.25,60,100,85,80,85,100,510,0.7007874015748031,1.0
63,120,85,90,55,55,468,0.2809917355371901,83,106,65,86,65,85,490,0.6640625,0.5
60,85,69,60,69,77,420,0.518796992481203,35,55,40,45,40,60,275,0.35714285714285715,1.0
74,48,76,83,81,104,466,0.7322834645669292,45,45,35,20,30,20,195,0.07246376811594203,1.0
100,100,100,100,100,100,600,0.8345864661654135,40,40,50,30,30,30,220,0.0873015873015873,0.5
70,65,65,55,55,70,380,0.5,70,140,230,60,80,50,630,0.32432432432432434,0.5
70,150,140,65,100,75,600,0.55,62,48,66,59,57,49,341,0.33884297520661155,0.25
35,40,100,90,55,35,355,0.1796875,100,150,140,100,90,90,670,0.7969924812030075,1.0
95,100,85,108,70,70,528,0.5652173913043478,45,60,30,80,50,65,330,0.4603174603174603,2.0
73,76,75,81,100,100,505,0.8110236220472441,45,85,50,55,50,65,350,0.5076923076923077,1.0
50,50,40,50,40,64,294,0.45588235294117646,89,124,80,55,80,55,483,0.5714285714285714,2.0
50,85,55,65,65,90,410,0.7478260869565218,45,50,43,40,38,62,278,0.40441176470588236,1.0
61,78,95,56,58,57,405,0.40336134453781514,62,44,50,44,50,55,305,0.3629032258064516,1.0
37,25,41,25,41,25,194,0.08870967741935484,39,52,43,60,50,65,309,0.49107142857142855,0.5
74,48,76,83,81,104,466,0.7322834645669292,59,66,70,44,55,41,335,0.25190839694656486,1.0
104,91,63,91,73,68,490,0.5118110236220472,70,83,50,37,50,60,350,0.3360655737704918,1.0
65,63,45,45,45,45,308,0.2595419847328244,65,105,60,60,70,95,455,63.0,1.0
71,73,88,120,89,59,500,0.43537414965986393,74,48,76,83,81,104,466,0.7322834645669292,1.0
110,65,105,55,95,80,510,0.6258503401360545,44,38,39,61,79,42,303,0.2251655629139073,0.5
78,92,75,74,63,118,500,0.8842975206611571,60,65,80,170,95,130,600,0.8625954198473282,0.0
65,73,55,47,75,85,400,0.6846846846846847,70,135,105,60,105,20,495,0.5806451612903226,0.5
50,65,85,35,35,55,325,0.32575757575757575,110,123,65,100,65,65,528,0.5217391304347826,0.25
60,60,60,60,60,60,360,0.38095238095238093,60,65,60,130,75,110,500,0.7719298245614035,0.0
62,48,66,59,57,49,341,0.33884297520661155,45,55,39,35,39,42,255,0.18518518518518517,1.0
90,55,75,60,75,30,385,0.13970588235294118,50,75,70,35,70,48,348,0.29357798165137616,1.0
110,80,90,95,90,65,530,0.5033557046979866,70,85,65,105,85,120,530,0.9262295081967213,1.0
125,170,100,120,90,95,700,0.77,58,89,77,45,45,48,362,0.3177570093457944,4.0
55,35,50,55,110,85,390,0.6277372262773723,20,10,230,10,230,5,505,0.0,1.0
60,50,40,85,75,95,405,0.7540983606557377,70,95,125,65,75,45,475,0.33613445378151263,1.0
39,52,43,60,50,65,309,0.5041322314049587,80,80,80,55,55,90,440,0.6417910447761194,1.0
55,40,85,80,105,40,405,0.23622047244094488,55,95,55,35,75,115,430,0.9380530973451328,2.0
50,65,107,105,107,86,520,0.7758620689655172,70,40,50,55,50,25,290,0.061068702290076333,1.0
50,85,55,65,65,90,410,0.7478260869565218,60,45,70,45,90,95,405,0.7304964539007093,1.0
78,65,68,112,154,75,552,0.628099173553719,70,150,140,65,100,75,600,0.55,0.5
35,20,65,40,65,20,245,0.02459016393442623,70,110,180,60,60,50,530,0.4117647058823529,0.5
45,60,40,70,50,45,310,0.2846715328467153,30,45,135,45,90,30,375,0.09285714285714286,0.5
80,120,79,95,79,70,523,0.5833333333333334,50,53,48,53,48,64,316,0.358974358974359,2.0
85,115,80,105,80,50,515,0.3063063063063063,46,57,40,40,40,50,273,0.25,1.0
65,75,90,97,123,44,494,0.1987179487179487,40,35,30,20,20,50,195,0.23423423423423423,0.5
40,55,70,45,60,30,300,0.10619469026548672,38,36,38,32,36,57,237,0.3893805309734513,1.0
62,77,62,50,42,65,358,0.4838709677419355,76,48,48,57,62,34,325,0.11688311688311688,1.0
67,89,116,79,116,33,500,0.2624113475177305,95,117,80,65,70,92,519,0.8409090909090909,0.0
80,45,65,90,110,80,470,0.5462962962962963,60,50,150,50,150,60,520,0.5206611570247934,0.5
65,80,65,35,65,60,370,0.38405797101449274,55,50,40,40,40,75,300,0.5945945945945946,1.0
90,75,75,90,100,70,500,0.5462184873949579,45,50,55,75,65,30,320,0.06293706293706294,0.5
82,80,86,85,75,72,480,0.6183206106870229,55,40,50,65,85,40,335,0.3181818181818182,1.0
75,100,95,40,70,110,490,0.8717948717948718,50,65,107,105,107,86,520,0.6991150442477876,1.0
75,125,100,70,80,45,495,0.33035714285714285,40,55,70,45,60,30,300,0.10619469026548672,0.25
45,80,100,35,37,28,325,0.3125,190,33,58,33,58,33,405,0.13432835820895522,2.0
60,50,40,85,75,95,405,0.7540983606557377,50,50,40,50,40,64,294,0.45588235294117646,2.0
40,45,35,65,55,70,310,0.4482758620689655,30,56,35,25,35,72,253,0.48148148148148145,1.0
80,120,80,120,80,100,580,0.8478260869565217,55,55,45,63,45,45,308,0.25,0.5
104,91,63,91,73,68,490,0.5118110236220472,80,95,82,60,82,75,474,0.6,1.0
70,43,53,43,53,40,302,0.19090909090909092,108,170,115,120,95,92,700,0.7083333333333334,0.5
50,35,55,25,25,15,205,0.05263157894736842,65,125,60,95,60,105,510,0.9236641221374046,0.5
60,85,69,65,79,80,438,0.576,55,85,55,50,55,60,360,0.4233576642335766,1.0
100,120,100,150,120,90,680,0.728,85,115,80,105,80,50,515,0.3063063063063063,1.0
55,50,45,135,95,120,500,0.7714285714285715,70,55,65,95,85,70,440,0.5307692307692308,0.5
70,80,50,35,35,35,305,0.14,100,75,115,90,115,85,580,0.6446280991735537,1.0
85,60,65,135,105,100,550,0.7518248175182481,100,100,100,100,100,100,600,0.8345864661654135,8.0
70,135,105,60,105,20,495,0.5806451612903226,40,60,40,40,40,30,250,0.0948905109489051,0.5
90,120,100,150,120,100,680,0.7718120805369127,70,90,45,15,45,50,315,0.3629032258064516,2.0
60,25,35,70,80,60,330,0.3076923076923077,43,80,65,50,35,35,308,0.14193548387096774,1.0
50,53,48,53,48,64,316,0.46153846153846156,55,50,65,175,95,150,590,0.7818181818181819,1.0
60,55,145,75,150,40,525,0.2,75,80,70,65,75,90,455,0.7578125,2.0
75,75,130,75,130,95,580,0.7479674796747967,100,120,120,150,100,90,680,0.7880794701986755,0.5
39,52,43,60,50,65,309,0.49107142857142855,65,65,45,75,45,95,390,0.72,2.0
95,117,80,65,70,92,519,0.8409090909090909,70,85,65,105,85,120,530,0.9262295081967213,0.5
54,45,47,75,98,52,371,0.39669421487603307,105,180,100,180,100,115,780,0.9477611940298507,2.0
35,60,44,40,54,55,288,0.366412213740458,100,103,75,120,75,127,600,0.940677966101695,2.0
85,105,85,40,50,40,405,0.211864406779661,80,70,65,80,120,100,515,0.8034188034188035,0.5
55,50,40,40,40,75,300,0.5945945945945946,60,60,40,65,45,35,305,0.15833333333333333,1.0
75,69,72,114,100,104,534,0.8253968253968254,80,75,150,75,150,50,580,0.30973451327433627,1.0
120,70,120,75,130,85,600,0.6694915254237288,60,85,69,60,69,77,420,0.518796992481203,1.0
60,100,115,70,85,90,520,0.7557251908396947,50,92,108,92,108,35,485,0.2457627118644068,1.0
74,48,76,83,81,104,466,0.7322834645669292,70,135,105,60,105,20,495,0.5806451612903226,0.5
40,30,50,55,55,100,330,0.584070796460177,65,60,110,130,95,65,525,0.47761194029850745,1.0
70,120,40,95,40,95,460,0.8106060606060606,115,140,130,55,55,40,535,0.4519230769230769,4.0
95,125,79,60,100,81,540,0.6165413533834586,78,84,78,109,85,100,534,0.8646616541353384,2.0
75,100,95,40,70,110,490,0.8717948717948718,45,40,60,40,75,50,310,0.2926829268292683,1.0
165,75,80,40,45,65,470,0.5151515151515151,65,65,60,130,95,110,525,0.823943661971831,1.0
54,63,52,83,56,97,405,0.7697841726618705,95,23,48,23,48,23,260,0.046153846153846156,1.0
69,69,76,69,86,91,460,0.6554621848739496,135,85,40,40,85,5,390,0.6864406779661016,1.0
55,75,60,75,60,103,428,0.7982456140350878,86,92,88,68,75,73,482,0.6835443037974683,1.0
70,85,70,60,70,50,405,0.28378378378378377,125,58,58,76,76,67,460,0.515625,1.0
50,20,40,20,40,20,190,0.0962962962962963,80,185,115,40,105,75,600,0.6230769230769231,2.0
90,90,85,125,90,100,580,0.768595041322314,50,65,45,85,65,95,405,0.7238095238095238,1.0
68,90,65,50,55,82,410,0.6165413533834586,50,20,40,20,40,20,190,0.0962962962962963,0.0
60,69,95,69,95,36,424,0.2608695652173913,70,110,75,145,85,145,630,0.9444444444444444,2.0
45,45,35,20,30,20,195,0.07246376811594203,75,100,110,45,55,65,450,0.5333333333333333,1.0
80,80,80,55,55,90,440,0.6417910447761194,38,36,38,32,36,57,237,0.3893805309734513,1.0
95,60,79,100,125,81,540,0.6201550387596899,75,38,38,56,56,67,330,0.5263157894736842,0.5
74,48,76,83,81,104,466,0.7322834645669292,75,125,230,55,95,30,610,0.3448275862068966,1.0
55,45,50,45,65,80,340,0.5546218487394958,54,63,52,83,56,97,405,0.7697841726618705,2.0
86,68,72,109,66,106,507,0.8099173553719008,35,60,44,40,54,55,288,0.366412213740458,1.0
70,150,140,65,100,75,600,0.55,50,70,160,70,160,90,600,0.7417218543046358,2.0
68,90,65,50,55,82,410,0.6165413533834586,85,50,95,120,115,80,545,0.5793650793650794,0.0
74,48,76,83,81,104,466,0.7913043478260869,75,105,75,105,75,45,480,0.3274336283185841,1.0
55,84,105,114,75,52,485,0.2890625,80,120,80,120,80,100,580,0.8478260869565217,1.0
60,45,70,75,85,55,390,0.3008130081300813,52,65,55,58,62,60,352,0.4482758620689655,1.0
65,125,100,60,70,70,490,0.6099290780141844,50,80,95,10,45,10,290,0.232,2.0
75,90,50,110,80,95,500,0.7985611510791367,40,40,50,30,30,30,220,0.0873015873015873,2.0
63,120,85,90,55,55,468,0.2809917355371901,100,150,120,120,100,90,680,0.6493506493506493,0.5
50,50,40,50,40,64,294,0.45588235294117646,50,75,45,40,45,60,315,0.4380165289256198,1.0
61,84,65,70,70,70,420,0.5,95,65,65,110,130,60,525,0.4016393442622951,0.0
74,94,131,54,116,20,489,0.4485294117647059,85,73,70,73,115,67,483,0.5126050420168067,1.0
58,109,112,48,48,109,484,0.8805970149253731,60,85,69,60,69,77,420,0.518796992481203,1.0
50,50,40,30,30,50,250,0.2781954887218045,95,117,80,65,70,92,519,0.8409090909090909,2.0
50,35,55,25,25,15,205,0.021739130434782608,55,85,122,58,75,99,494,0.8099173553719008,1.0
35,45,160,30,45,70,385,0.48148148148148145,65,125,60,95,60,105,510,0.9236641221374046,0.5
91,90,129,90,72,108,580,0.9140625,53,54,53,37,46,45,288,0.3090909090909091,1.0
80,160,60,170,130,80,680,0.6180555555555556,35,20,65,40,65,20,245,0.02459016393442623,0.5
53,51,53,61,56,40,314,0.14285714285714285,100,50,50,76,96,70,442,0.5,1.0
120,70,120,75,130,85,600,0.6694915254237288,58,50,145,95,105,30,483,0.2459016393442623,1.0
65,47,55,73,75,85,400,0.65,75,95,60,65,60,115,470,0.8778625954198473,1.0
68,65,65,125,115,80,518,0.6461538461538462,100,134,110,95,100,61,600,0.4057971014492754,0.0
100,100,100,100,100,100,600,0.8345864661654135,45,30,40,105,50,20,290,0.031007751937984496,0.5
65,80,80,59,63,58,405,0.4411764705882353,120,100,85,30,85,45,465,0.22448979591836735,1.0
60,60,75,60,75,80,410,0.7321428571428571,50,100,150,100,150,50,600,0.37142857142857144,1.0
70,55,55,80,60,45,365,0.2222222222222222,105,125,100,60,100,100,590,0.8359375,1.0
70,90,90,135,90,125,600,0.9401709401709402,30,56,35,25,35,72,253,0.48148148148148145,1.0
123,100,62,97,81,68,531,0.4806201550387597,80,95,82,60,82,75,474,0.6,0.5
67,82,62,46,48,43,348,0.22033898305084745,45,45,35,20,30,20,195,0.07246376811594203,0.5
60,90,140,50,50,40,430,0.2535211267605634,38,30,85,55,65,30,303,0.21428571428571427,1.0
55,55,45,63,45,45,308,0.25,90,100,60,90,60,80,480,0.6422764227642277,0.5
65,125,100,55,70,85,500,0.6532258064516129,20,10,230,10,230,5,505,0.0,1.0
50,50,40,50,40,64,294,0.45588235294117646,55,55,45,63,45,45,308,0.25,0.5
95,65,65,110,130,60,525,0.4016393442622951,75,87,63,87,63,98,473,0.865546218487395,1.0
55,50,65,175,95,150,590,0.7818181818181819,95,110,95,40,95,55,490,0.40336134453781514,1.0
77,85,51,55,51,65,384,0.5163934426229508,79,115,70,125,80,111,580,0.864,0.5
80,100,70,50,60,45,405,0.25806451612903225,70,62,67,55,55,56,365,0.38513513513513514,0.5
35,65,35,65,35,65,300,0.46621621621621623,65,80,80,59,63,58,405,0.4411764705882353,0.5
45,50,45,115,55,95,405,0.6936936936936937,70,110,75,145,85,145,630,0.9444444444444444,2.0
90,120,120,60,60,50,500,0.35294117647058826,80,115,80,65,55,93,488,0.7846153846153846,0.0
91,72,90,129,90,108,580,0.8925619834710744,55,70,45,70,50,60,350,0.45,2.0
85,80,70,135,75,90,535,0.7006802721088435,70,150,140,65,100,75,600,0.55,0.5
40,40,40,70,40,20,250,0.032520325203252036,50,100,150,100,150,50,600,0.37142857142857144,0.5
80,95,82,60,82,75,474,0.6,48,72,48,72,48,48,336,0.25984251968503935,1.0
73,115,60,60,60,90,458,0.6694915254237288,60,85,49,60,49,60,363,0.4444444444444444,1.0
40,30,35,50,70,55,280,0.28205128205128205,49,66,70,44,55,51,335,0.4260869565217391,0.5
85,90,80,70,80,130,535,0.9262295081967213,38,35,35,65,55,50,278,0.2647058823529412,2.0
59,74,50,35,50,35,303,0.3125,90,65,65,40,40,15,315,0.19672131147540983,2.0
60,65,80,170,95,130,600,0.8625954198473282,40,45,35,65,55,70,310,0.4482758620689655,2.0
60,75,100,55,80,50,420,0.3088235294117647,50,95,90,95,90,180,600,0.9172413793103448,0.5
85,110,76,65,82,56,474,0.3933333333333333,85,110,90,45,90,80,500,0.6206896551724138,0.0
74,108,133,83,65,32,495,0.32142857142857145,65,80,65,35,65,60,370,0.38405797101449274,1.0
75,98,63,98,63,101,498,0.8091603053435115,84,71,43,71,43,48,360,0.25874125874125875,1.0
57,80,91,80,87,75,470,0.5737704918032787,60,65,70,85,75,40,395,0.21705426356589147,0.5
40,40,35,50,100,70,335,0.5031847133757962,38,30,41,30,41,60,240,0.2897196261682243,1.0
30,45,55,70,55,85,340,0.5633802816901409,110,65,105,55,95,80,510,0.6258503401360545,1.0
71,120,95,120,95,99,600,0.8203125,100,150,90,180,160,90,770,0.7348484848484849,0.5
65,55,115,100,40,60,435,0.3798449612403101,75,80,60,65,90,102,472,0.8625954198473282,1.0
44,38,39,61,79,42,303,0.2251655629139073,40,40,40,70,40,20,250,0.032520325203252036,0.5
61,84,65,70,70,70,420,0.5,38,41,40,50,65,65,299,0.4108527131782946,1.0
65,75,90,97,123,44,494,0.1987179487179487,59,45,40,35,40,31,250,0.14285714285714285,1.0
60,55,145,75,150,40,525,0.2,60,62,63,80,80,60,405,0.38016528925619836,1.0
55,130,115,50,50,75,475,0.5982142857142857,40,40,50,30,30,30,220,0.0873015873015873,0.5
75,80,85,110,90,50,490,0.3548387096774194,80,80,80,55,55,90,440,0.6417910447761194,1.0
105,125,100,60,100,100,590,0.8359375,77,120,90,60,90,48,485,0.2785714285714286,1.0
65,83,57,95,85,105,490,0.8914728682170543,81,102,77,85,75,85,505,0.5642857142857143,0.0
60,55,90,145,90,80,520,0.6071428571428571,50,100,150,100,150,50,600,0.37142857142857144,0.5
75,80,70,65,75,90,455,0.7578125,53,54,53,37,46,45,288,0.3090909090909091,1.0
35,40,100,90,55,35,355,0.1796875,90,93,55,70,55,55,418,0.3819444444444444,2.0
38,36,38,32,36,57,237,0.3893805309734513,80,50,100,100,200,50,580,0.2357142857142857,1.0
90,90,85,125,90,100,580,0.768595041322314,60,45,50,90,80,70,395,0.625,4.0
75,110,110,110,105,80,590,0.656934306569343,255,10,10,75,135,55,540,0.3125,1.0
65,90,65,61,61,100,442,0.8373983739837398,40,35,30,20,20,50,195,0.23423423423423423,2.0
50,105,79,35,110,76,455,0.6214285714285714,45,63,37,65,55,95,360,0.8055555555555556,1.0
70,55,75,45,65,60,370,0.45901639344262296,50,150,50,150,50,150,600,0.9339622641509434,2.0
85,105,100,79,83,78,530,0.5869565217391305,59,63,80,65,80,58,405,0.41843971631205673,0.5
65,65,65,50,50,90,385,0.72,75,85,200,55,65,30,510,0.16778523489932887,2.0
65,47,55,73,75,85,400,0.65,45,90,20,65,20,65,305,0.5116279069767442,2.0
20,10,230,10,230,5,505,0.0,78,84,78,109,85,100,534,0.8620689655172413,1.0
65,125,60,95,60,105,510,0.9236641221374046,68,165,95,65,115,110,618,0.8615384615384616,0.5
40,65,40,80,40,65,330,0.5038167938931297,75,95,125,45,75,95,510,0.8257575757575758,1.0
35,70,55,45,55,25,285,0.09420289855072464,60,69,95,69,95,36,424,0.2608695652173913,0.125
59,63,80,65,80,58,405,0.41843971631205673,59,66,70,44,55,41,335,0.25190839694656486,0.5
50,50,62,40,62,65,329,0.4188034188034188,115,45,20,45,25,20,270,0.11538461538461539,2.0
50,75,75,65,65,50,380,0.4049586776859504,76,104,71,104,71,108,534,0.912751677852349,0.5
80,80,50,40,50,25,325,0.176056338028169,90,75,75,90,100,70,500,0.5462184873949579,1.0
65,80,80,59,63,58,405,0.4411764705882353,30,40,55,40,55,60,280,0.3237410071942446,1.0
45,22,60,27,30,29,213,0.07518796992481203,80,110,120,130,90,70,600,0.6198347107438017,0.5
77,120,90,60,90,48,485,0.2785714285714286,70,65,65,55,55,70,380,0.5,1.0
50,47,50,57,50,65,319,0.463768115942029,65,47,55,73,75,85,400,0.65,1.0
38,41,40,50,65,65,299,0.4108527131782946,71,73,88,120,89,59,500,0.43537414965986393,0.5
50,55,50,36,30,43,264,0.2922077922077922,110,130,80,70,60,80,530,0.5862068965517241,1.0
75,70,90,70,105,80,490,0.656,60,65,70,85,75,40,395,0.21705426356589147,2.0
70,110,180,60,60,50,530,0.4117647058823529,70,55,95,95,110,65,490,0.48872180451127817,1.0
68,90,65,50,55,82,410,0.6165413533834586,50,20,40,20,40,20,190,0.0962962962962963,0.0
44,50,91,24,86,10,305,0.1981981981981982,80,100,200,50,100,50,580,0.3472222222222222,4.0
90,75,85,115,90,55,510,0.3445378151260504,70,100,70,105,75,40,460,0.23214285714285715,0.0
50,70,100,40,40,30,330,0.2222222222222222,70,90,45,15,45,50,315,0.3629032258064516,1.0
70,65,65,55,55,70,380,0.5,45,35,45,62,53,35,275,0.11851851851851852,1.0
55,70,55,40,55,85,360,0.7073170731707317,60,62,50,62,60,40,334,0.18181818181818182,1.0
90,120,100,150,120,100,680,0.7718120805369127,40,30,30,55,30,85,270,0.4666666666666667,0.5
65,83,57,95,85,105,490,0.8914728682170543,103,93,67,71,61,84,479,0.7142857142857143,1.0
90,55,75,60,75,30,385,0.13970588235294118,50,95,95,35,110,70,455,0.5179856115107914,1.0
100,123,75,57,75,80,510,0.6923076923076923,60,95,80,60,80,30,405,0.19480519480519481,4.0
99,68,83,72,87,51,460,0.417910447761194,130,70,35,70,35,60,400,0.4017857142857143,2.0
60,130,80,60,60,70,460,0.5153846153846153,60,50,150,50,150,60,520,0.5206611570247934,0.0
75,98,63,98,63,101,498,0.849624060150376,65,65,65,50,50,90,385,0.72,0.5
54,66,70,44,55,46,335,0.4214876033057851,70,130,100,55,80,65,500,0.608,0.25
75,125,75,30,75,85,465,0.625,99,68,83,72,87,51,460,0.417910447761194,0.5
50,65,90,35,35,15,290,0.14678899082568808,45,30,15,85,65,65,305,0.36220472440944884,2.0
65,105,60,60,70,95,455,63.0,55,130,115,50,50,75,475,0.5982142857142857,1.0
45,35,45,62,53,35,275,0.11851851851851852,105,150,90,150,90,95,680,0.8285714285714286,0.25
40,60,40,40,40,30,250,0.0948905109489051,40,55,70,45,60,30,300,0.10619469026548672,0.0
55,45,45,25,25,15,210,0.048,50,160,110,160,110,110,700,0.8854961832061069,4.0
58,70,45,40,45,42,300,0.25925925925925924,68,72,78,38,42,32,330,0.23809523809523808,1.0
55,84,105,114,75,52,485,0.2890625,65,75,90,97,123,44,494,0.1987179487179487,0.5
60,50,150,50,150,60,520,0.5206611570247934,91,90,72,90,129,108,580,0.896,1.0
68,125,65,65,115,80,518,0.6277372262773723,39,52,43,60,50,65,309,0.49107142857142855,1.0
100,103,75,120,75,127,600,0.940677966101695,95,65,65,110,130,60,525,0.4016393442622951,1.0
50,50,40,30,30,50,250,0.2781954887218045,70,77,60,97,60,108,472,0.8394160583941606,1.0
74,100,72,90,72,46,454,0.24561403508771928,38,35,40,27,25,35,200,0.08208955223880597,0.5
55,50,40,40,40,75,300,0.5945945945945946,91,72,90,129,90,108,580,0.8620689655172413,1.0
50,80,95,10,45,10,290,0.232,45,95,50,40,50,75,355,0.54,2.0
85,80,70,135,75,90,535,0.7006802721088435,70,55,75,45,65,60,370,0.45901639344262296,1.0
84,71,43,71,43,48,360,0.25874125874125875,60,50,70,50,90,65,385,0.39568345323741005,1.0
45,49,65,49,65,45,318,0.275,50,50,95,40,50,35,320,0.20279720279720279,2.0
78,92,75,74,63,118,500,0.8842975206611571,60,48,45,43,90,42,328,0.21897810218978103,0.5
90,92,87,75,85,76,505,0.5409836065573771,55,85,55,50,55,60,360,0.4233576642335766,1.0
110,85,95,80,95,50,515,0.2713178294573643,62,44,50,44,50,55,305,0.3629032258064516,1.0
90,75,75,90,100,70,500,0.5462184873949579,80,75,150,75,150,50,580,0.30973451327433627,1.0
100,120,100,150,120,90,680,0.728,60,55,50,40,55,45,305,0.22377622377622378,2.0
45,75,60,40,30,50,300,0.304,90,55,75,60,75,30,385,0.13970588235294118,1.0
70,55,55,80,60,45,365,0.2222222222222222,65,80,140,40,70,70,465,0.5223880597014925,2.0
60,60,60,85,85,85,435,0.631578947368421,90,120,120,60,60,50,500,0.35294117647058826,1.0
70,84,70,65,70,51,410,0.2949640287769784,40,29,45,29,45,36,224,0.14634146341463414,1.0
165,75,80,40,45,65,470,0.5151515151515151,50,48,43,46,41,60,288,0.47297297297297297,1.0
78,92,75,74,63,118,500,0.8842975206611571,58,70,45,40,45,42,300,0.25925925925925924,1.0
100,70,70,65,65,45,415,0.1897810218978102,79,105,70,145,80,101,580,0.8608695652173913,1.0
67,125,40,30,30,58,350,0.3431372549019608,55,69,85,32,35,28,304,0.09302325581395349,2.0
50,65,107,105,107,86,520,0.7313432835820896,75,95,122,58,75,69,494,0.5725806451612904,0.25
35,55,35,30,30,35,220,0.23684210526315788,49,49,56,49,61,66,330,0.5190839694656488,1.0
76,147,90,60,70,97,540,0.8267716535433071,45,55,45,65,45,75,330,0.5692307692307692,1.0
65,55,115,100,40,60,435,0.3798449612403101,76,104,71,104,71,108,534,0.912751677852349,0.5
91,134,95,100,100,80,600,0.6304347826086957,65,65,45,75,45,95,390,0.72,2.0
110,78,73,76,71,60,468,0.3333333333333333,65,65,65,50,50,90,385,0.72,0.5
78,104,78,159,115,100,634,0.8444444444444444,66,117,70,40,50,67,410,0.4573643410852713,0.5
50,70,160,70,160,90,600,0.7417218543046358,106,90,130,90,154,110,680,0.8699186991869918,0.5
40,40,40,70,40,20,250,0.032520325203252036,50,65,107,105,107,86,520,0.703125,2.0
79,115,70,125,80,111,580,0.8468468468468469,100,123,75,57,75,80,510,0.6923076923076923,1.0
110,123,65,100,65,65,528,0.5217391304347826,100,134,110,95,100,61,600,0.4057971014492754,2.0
65,45,55,45,70,45,325,0.24369747899159663,90,50,34,60,44,70,348,0.6283185840707964,1.0
65,65,45,75,45,95,390,0.72,55,130,115,50,50,75,475,0.5982142857142857,1.0
50,20,40,20,40,20,190,0.0962962962962963,75,98,63,98,63,101,498,0.889763779527559,0.5
50,40,85,40,65,25,305,0.08870967741935484,65,60,110,130,95,65,525,0.47761194029850745,1.0
90,120,120,60,60,50,500,0.35294117647058826,68,90,65,50,55,82,410,0.6165413533834586,1.0
60,45,50,90,80,70,395,0.625,55,55,50,45,65,55,325,0.37373737373737376,1.0
55,70,40,60,40,40,305,0.26956521739130435,60,50,40,85,75,95,405,0.7540983606557377,1.0
30,35,30,100,35,80,310,0.4765625,65,90,40,45,80,75,395,0.625,0.5
125,120,90,170,100,95,700,0.78125,59,110,150,45,49,35,448,0.3333333333333333,0.25
66,117,70,40,50,67,410,0.4573643410852713,70,80,50,35,35,35,305,0.14,1.0
85,97,66,105,66,65,484,0.47107438016528924,65,95,100,60,50,50,420,0.34959349593495936,0.5
72,85,70,65,70,58,420,0.41304347826086957,65,130,60,75,60,75,465,0.689922480620155,0.5
135,85,40,40,85,5,390,0.6864406779661016,61,84,65,70,70,70,420,0.5,1.0
50,65,107,105,107,86,520,0.7313432835820896,35,55,40,45,40,60,275,0.35714285714285715,0.5
25,35,70,95,55,45,325,0.16783216783216784,106,110,90,154,90,130,680,0.926829268292683,1.0
50,53,62,58,63,44,330,0.13709677419354838,90,60,70,75,70,45,410,0.23880597014925373,0.5
65,90,120,85,70,60,490,0.43410852713178294,86,92,88,68,75,73,482,0.6835443037974683,1.0
130,85,80,85,95,60,535,0.43884892086330934,25,35,70,95,55,45,325,0.16783216783216784,0.5
108,100,121,81,95,95,600,0.7476635514018691,1,90,45,30,30,40,236,0.33064516129032256,0.5
75,80,95,90,100,50,490,0.2158273381294964,80,130,100,160,120,110,700,0.8981481481481481,0.5
64,78,52,78,52,81,405,0.6422764227642277,91,134,95,100,100,80,600,0.6304347826086957,0.25
45,45,35,20,30,20,195,0.07246376811594203,58,89,77,45,45,48,362,0.3177570093457944,1.0
50,75,75,65,65,50,380,0.4049586776859504,80,82,83,100,100,80,525,0.6742424242424242,1.0
123,77,72,99,92,58,521,0.4621212121212121,100,50,50,76,96,70,442,0.5,4.0
55,130,115,50,50,75,475,0.5982142857142857,50,95,180,85,45,70,525,0.5298507462686567,0.5
40,70,130,60,130,25,455,0.17355371900826447,45,53,70,40,60,42,310,0.25735294117647056,1.0
95,117,80,65,70,92,519,0.8409090909090909,60,80,110,50,80,45,425,0.2833333333333333,1.0
81,102,77,85,75,85,505,0.5642857142857143,60,105,60,120,60,105,510,0.8849557522123894,1.0
55,35,50,55,110,85,390,0.6277372262773723,50,60,60,60,60,30,320,0.11290322580645161,0.5
45,30,50,65,50,45,285,0.13821138211382114,110,130,80,70,60,80,530,0.5862068965517241,2.0
125,120,90,170,100,95,700,0.78125,81,102,77,85,75,85,505,0.5642857142857143,2.0
40,30,35,50,70,55,280,0.28205128205128205,80,45,65,90,110,80,470,0.5462962962962963,1.0
20,40,90,30,90,25,295,0.11363636363636363,45,55,39,35,39,42,255,0.18518518518518517,0.0
60,52,168,47,138,30,495,0.19834710743801653,80,70,70,90,100,70,480,0.5609756097560976,0.5
60,40,60,40,60,35,295,0.18055555555555555,60,60,75,60,75,80,410,0.7321428571428571,1.0
60,40,80,60,45,40,325,0.23529411764705882,100,110,90,85,90,60,535,0.47794117647058826,8.0
50,45,45,35,35,50,260,0.23529411764705882,40,70,40,35,40,60,285,0.392,1.0
55,47,52,40,40,41,275,0.16806722689075632,60,115,105,65,70,80,495,0.7181818181818181,0.5
62,44,50,44,50,55,305,0.3629032258064516,70,20,50,20,50,40,250,0.1557377049180328,0.5
45,80,100,35,37,28,325,0.3125,38,35,40,27,25,35,200,0.08208955223880597,1.0
70,70,115,130,90,60,535,0.5338983050847458,55,70,55,40,55,85,360,0.7073170731707317,1.0
100,123,75,57,75,80,510,0.6923076923076923,73,100,60,100,60,65,458,0.42657342657342656,1.0
60,62,80,63,80,60,405,0.4336283185840708,90,120,75,60,60,45,450,0.29411764705882354,1.0
150,120,100,120,100,90,680,0.664179104477612,55,68,64,45,55,31,318,0.11666666666666667,1.0
123,100,62,97,81,68,531,0.4806201550387597,100,100,100,100,100,100,600,0.8345864661654135,0.5
64,115,65,83,63,65,455,0.5323741007194245,50,85,125,85,115,20,480,0.4306569343065693,1.0
45,30,35,20,20,45,195,0.14782608695652175,70,90,110,60,75,95,500,0.7333333333333333,1.0
51,65,65,80,75,59,395,0.4365079365079365,40,45,40,35,35,56,251,0.373015873015873,2.0
68,72,78,38,42,32,330,0.23809523809523808,80,120,79,95,79,70,523,0.5833333333333334,2.0
70,55,95,95,110,65,490,0.48872180451127817,43,30,55,40,65,97,330,0.6030534351145038,1.0
73,76,75,81,100,100,505,0.8110236220472441,25,35,70,95,55,45,325,0.16783216783216784,2.0
68,72,78,38,42,32,330,0.23809523809523808,44,38,39,61,79,42,303,0.2251655629139073,1.0
40,30,30,40,50,30,220,0.07936507936507936,75,55,70,55,95,110,460,0.8444444444444444,0.125
45,35,50,70,50,30,280,0.15753424657534246,90,60,70,75,70,45,410,0.23880597014925373,2.0
75,75,55,105,85,30,425,0.1619718309859155,95,109,105,75,85,56,525,0.34513274336283184,1.0
70,105,105,50,40,20,390,0.33587786259541985,55,69,85,32,35,28,304,0.09302325581395349,2.0
150,160,100,95,65,100,670,0.8866666666666667,40,45,65,100,120,90,460,0.5588235294117647,1.0
100,134,110,95,100,61,600,0.4057971014492754,75,98,63,98,63,101,498,0.889763779527559,2.0
76,147,90,60,70,97,540,0.8267716535433071,60,70,50,100,50,65,395,0.5217391304347826,1.0
65,65,65,50,50,90,385,0.72,73,76,75,81,100,100,505,0.8110236220472441,2.0
70,140,230,60,80,50,630,0.32432432432432434,91,90,129,90,72,108,580,0.9140625,0.5
75,70,90,70,105,80,490,0.656,73,76,75,81,100,100,505,0.8110236220472441,1.0
60,45,70,75,85,55,390,0.3008130081300813,50,50,95,40,50,35,320,0.20279720279720279,2.0
70,84,70,65,70,51,410,0.2949640287769784,50,120,53,35,110,87,455,0.640625,0.5
95,60,79,100,125,81,540,0.6201550387596899,105,95,80,40,80,90,490,0.753968253968254,1.0
79,105,70,145,80,101,580,0.8608695652173913,60,80,50,50,50,40,330,0.23853211009174313,1.0
45,50,45,115,55,95,405,0.6936936936936937,55,70,40,60,40,40,305,0.26956521739130435,1.0
45,30,15,85,65,65,305,0.36220472440944884,255,10,10,75,135,55,540,0.3125,1.0
86,76,86,116,56,95,515,0.7982456140350878,95,155,109,70,130,81,640,0.6788321167883211,2.0
65,65,45,75,45,95,390,0.72,54,45,47,75,98,52,371,0.39669421487603307,0.5
100,100,100,100,100,100,600,0.8345864661654135,90,132,105,132,105,30,594,0.4246575342465753,0.5
55,75,50,40,40,80,340,0.6302521008403361,45,65,34,40,34,45,263,0.2589928057553957,0.5
40,40,35,50,100,70,335,0.5031847133757962,60,105,60,120,60,105,510,0.8849557522123894,1.0
83,80,80,135,80,121,579,0.9444444444444444,50,53,62,58,63,44,330,0.13709677419354838,1.0
100,120,100,150,120,90,680,0.728,74,100,72,90,72,46,454,0.24561403508771928,2.0
45,30,50,65,50,45,285,0.13821138211382114,90,100,70,110,150,80,600,0.6037735849056604,1.0
100,123,75,57,75,80,510,0.6923076923076923,100,50,50,76,96,70,442,0.5,1.0
25,20,15,105,55,90,310,0.32407407407407407,100,128,90,77,77,128,600,0.959349593495935,1.0
75,100,66,60,66,115,482,0.918918918918919,25,20,15,105,55,90,310,0.32407407407407407,1.0
89,145,90,105,80,91,600,0.8549618320610687,106,150,70,194,120,140,780,0.952,1.0
70,55,65,95,85,70,440,0.5307692307692308,150,120,100,120,100,90,680,0.664179104477612,1.0
55,55,50,45,65,55,325,0.37373737373737376,70,115,60,115,60,55,475,0.4647887323943662,1.0
55,75,85,25,25,15,280,0.1875,45,67,60,35,50,63,320,0.5128205128205128,1.0
60,60,60,105,105,105,495,0.848,79,115,70,125,80,111,580,0.864,1.0
35,65,35,65,35,65,300,0.46621621621621623,30,45,55,70,55,85,340,0.5633802816901409,0.5
170,90,45,90,45,60,500,0.427536231884058,65,90,40,45,80,75,395,0.625,1.0
51,65,65,80,75,59,395,0.4365079365079365,37,25,41,25,41,25,194,0.08870967741935484,1.0
75,95,95,95,95,85,540,0.6470588235294118,55,75,85,25,25,15,280,0.1875,2.0
45,100,135,65,135,45,525,0.29411764705882354,50,65,64,44,48,43,314,0.2196969696969697,1.0
1,90,45,30,30,40,236,0.33064516129032256,65,85,70,75,70,40,405,0.203125,1.0
50,48,43,46,41,60,288,0.47297297297297297,65,130,60,95,110,65,525,0.5303030303030303,4.0
65,90,122,58,75,84,494,0.71875,43,80,65,50,35,35,308,0.14193548387096774,2.0
103,60,86,60,86,50,445,0.3458646616541353,100,128,90,77,77,128,600,0.959349593495935,1.0
70,43,53,43,53,40,302,0.19090909090909092,95,117,184,44,46,28,514,0.2975206611570248,1.0
45,100,135,65,135,45,525,0.29411764705882354,55,66,44,44,56,85,350,0.6888888888888889,0.0
60,52,168,47,138,30,495,0.19834710743801653,100,100,80,60,60,50,450,0.3050847457627119,2.0
54,78,103,53,45,22,355,0.23255813953488372,125,120,90,170,100,95,700,0.78125,1.0
68,85,65,165,135,100,618,0.8083333333333333,75,125,75,30,75,85,465,0.625,2.0
77,120,90,60,90,48,485,0.2785714285714286,74,100,72,90,72,46,454,0.24561403508771928,1.0
95,109,105,75,85,56,525,0.34513274336283184,75,85,200,55,65,30,510,0.16778523489932887,2.0
55,55,85,65,85,35,380,0.2014388489208633,70,55,65,95,85,70,440,0.5307692307692308,2.0
150,120,100,120,100,90,680,0.664179104477612,90,60,70,75,70,45,410,0.23880597014925373,1.0
42,52,67,39,56,50,306,0.2868217054263566,70,115,60,115,60,55,475,0.4647887323943662,0.5
55,70,45,70,50,60,350,0.45,57,24,86,24,86,23,300,0.12727272727272726,2.0
90,130,80,65,85,55,505,0.4396551724137931,50,75,70,35,70,48,348,0.29357798165137616,2.0
50,160,110,160,110,110,700,0.8854961832061069,60,60,60,105,105,105,495,0.848,1.0
72,105,115,54,86,68,500,0.5149253731343284,78,65,68,112,154,75,552,0.628099173553719,1.0
60,62,63,80,80,60,405,0.38016528925619836,35,20,65,40,65,20,245,0.02459016393442623,2.0
85,110,90,45,90,80,500,0.6206896551724138,50,95,90,95,90,180,600,0.9172413793103448,1.0
30,80,90,55,45,55,355,0.4295774647887324,70,20,50,20,50,40,250,0.1557377049180328,0.5
45,25,50,25,25,35,205,0.13076923076923078,64,51,23,51,23,28,240,0.11363636363636363,1.0
78,84,78,109,85,100,534,0.8620689655172413,70,150,140,65,100,75,600,0.55,4.0
70,70,70,70,70,70,420,0.5289256198347108,65,75,90,97,123,44,494,0.1987179487179487,1.0
60,40,50,75,85,95,405,0.6044776119402985,55,40,85,80,105,40,405,0.23622047244094488,2.0
30,105,90,25,25,50,325,0.2773722627737226,103,93,67,71,61,84,479,0.7142857142857143,1.0
65,63,45,45,45,45,308,0.2595419847328244,70,110,75,145,85,145,630,0.9444444444444444,1.0
45,85,50,55,50,65,350,0.5076923076923077,45,100,135,65,135,45,525,0.29411764705882354,0.0
95,65,65,110,130,60,525,0.4016393442622951,74,108,133,83,65,32,495,0.32142857142857145,1.0
45,85,70,40,40,60,340,0.5229357798165137,106,130,90,110,154,90,680,0.719626168224299,0.5
75,87,63,87,63,98,473,0.865546218487395,70,80,65,90,65,85,455,0.578125,1.0
165,75,80,40,45,65,470,0.5151515151515151,65,65,45,75,45,95,390,0.72,1.0
89,145,90,105,80,91,600,0.8549618320610687,70,120,100,145,105,20,560,0.2824427480916031,2.0
70,62,67,55,55,56,365,0.38513513513513514,64,66,68,81,76,50,405,0.25190839694656486,1.0
40,30,35,50,70,55,280,0.28205128205128205,49,66,70,44,55,51,335,0.4260869565217391,0.5
100,100,125,110,50,50,535,0.384,60,90,70,60,120,40,440,0.27419354838709675,1.0
45,95,50,40,50,75,355,0.54,86,68,72,109,66,106,507,0.8099173553719008,1.0
75,65,55,65,55,69,384,0.43548387096774194,40,55,30,30,30,60,245,0.43548387096774194,0.0
30,105,90,25,25,50,325,0.2773722627737226,50,85,40,85,40,35,335,0.1746031746031746,0.5
70,65,60,90,75,90,450,0.6571428571428571,55,68,64,45,55,31,318,0.11666666666666667,4.0
45,60,45,25,45,55,275,0.29,105,150,90,150,90,95,680,0.8285714285714286,1.0
40,70,130,60,130,25,455,0.17355371900826447,45,55,39,35,39,42,255,0.18518518518518517,0.0
95,110,80,70,80,50,485,0.37209302325581395,45,67,60,35,50,63,320,0.5128205128205128,0.5
85,50,95,120,115,80,545,0.5793650793650794,83,80,75,70,70,101,479,0.8615384615384616,1.0
70,120,40,95,40,95,460,0.8106060606060606,60,30,30,36,56,50,262,0.32432432432432434,1.0
90,110,80,100,80,95,555,0.7982456140350878,80,135,85,70,95,150,615,0.9844961240310077,0.5
60,60,50,40,50,75,335,0.5882352941176471,100,150,90,180,160,90,770,0.7348484848484849,2.0
65,125,60,95,60,105,510,0.9236641221374046,70,110,180,60,60,50,530,0.4117647058823529,4.0
100,120,120,150,100,90,680,0.7880794701986755,37,25,41,25,41,25,194,0.08870967741935484,1.0
30,30,42,30,42,70,244,0.4230769230769231,70,90,45,15,45,50,315,0.3629032258064516,0.5
45,22,60,27,30,29,213,0.07518796992481203,80,185,115,40,105,75,600,0.6230769230769231,0.5
54,66,70,44,55,46,335,0.4214876033057851,90,60,70,75,70,45,410,0.23880597014925373,2.0
56,61,65,48,45,38,313,0.17567567567567569,85,105,55,85,50,115,495,0.9032258064516129,2.0
35,35,40,35,55,50,250,0.40336134453781514,95,124,78,69,71,58,495,0.37398373983739835,2.0
55,65,95,95,45,85,440,0.6610169491525424,75,80,60,65,90,102,472,0.8625954198473282,1.0
100,100,90,150,140,90,670,0.71875,75,125,100,70,80,45,495,0.33035714285714285,2.0
90,60,70,75,70,45,410,0.23880597014925373,65,125,60,95,60,105,510,0.9236641221374046,1.0
78,130,111,130,85,100,634,0.8561151079136691,45,100,135,65,135,45,525,0.29411764705882354,1.0
45,45,35,20,30,20,195,0.07246376811594203,103,60,126,80,126,50,545,0.36363636363636365,0.5
65,150,60,115,60,115,565,0.935251798561151,60,105,60,120,60,105,510,0.8849557522123894,0.5
50,20,55,25,25,30,205,0.09774436090225563,50,120,53,35,110,87,455,0.640625,0.5
55,65,35,60,30,85,330,0.6126126126126126,103,60,86,60,86,50,445,0.3458646616541353,1.0
65,90,120,85,70,60,490,0.43410852713178294,90,90,85,125,90,100,580,0.768595041322314,1.0
45,30,50,65,50,45,285,0.13821138211382114,100,100,100,100,100,100,600,0.8758169934640523,0.25
125,120,90,170,100,95,700,0.78125,58,109,112,48,48,109,484,0.8805970149253731,0.25
70,80,102,80,102,40,474,0.2677165354330709,91,72,90,129,90,108,580,0.8925619834710744,1.0
50,85,55,65,65,90,410,0.7478260869565218,105,95,75,85,75,74,509,0.5714285714285714,0.5
85,70,80,97,80,123,535,0.9304347826086956,60,52,168,47,138,30,495,0.19834710743801653,0.125
45,30,35,20,20,45,195,0.14782608695652175,80,90,80,130,110,110,600,0.856,2.0
100,164,150,95,120,71,700,0.5645161290322581,65,90,40,45,80,75,395,0.625,2.0
45,22,60,27,30,29,213,0.07518796992481203,50,48,43,46,41,60,288,0.47297297297297297,1.0
60,75,100,55,80,50,420,0.3088235294117647,40,35,30,20,20,50,195,0.23423423423423423,2.0
35,45,160,30,45,70,385,0.48148148148148145,50,60,45,100,80,65,400,0.45689655172413796,1.0
90,90,85,125,90,100,580,0.768595041322314,55,84,105,114,75,52,485,0.2890625,2.0
60,100,115,70,85,90,520,0.7557251908396947,75,95,95,95,95,85,540,0.6470588235294118,0.5
45,53,70,40,60,42,310,0.25735294117647056,50,75,75,65,65,50,380,0.4049586776859504,1.0
75,95,67,125,95,83,540,0.7117117117117117,70,20,50,20,50,40,250,0.1557377049180328,0.5
70,90,70,60,60,70,420,0.6390977443609023,100,100,100,100,100,100,600,0.8758169934640523,2.0
70,145,88,140,70,112,625,0.8888888888888888,55,40,85,80,105,40,405,0.23622047244094488,0.125
73,100,60,100,60,65,458,0.42657342657342656,116,55,85,107,95,29,487,0.06818181818181818,1.0
80,52,50,90,50,89,411,0.6666666666666666,80,105,65,60,75,130,515,0.9645390070921985,0.25
65,95,100,60,50,50,420,0.34959349593495936,40,45,35,30,40,55,245,0.3793103448275862,1.0
74,108,133,83,65,32,495,0.32142857142857145,79,100,80,110,90,121,580,0.968,2.0
60,48,45,43,90,42,328,0.21897810218978103,45,95,50,40,50,75,355,0.54,1.0
64,165,75,93,83,75,555,0.6587301587301587,55,84,105,114,75,52,485,0.2890625,1.0
60,62,50,62,60,40,334,0.18181818181818182,54,78,103,53,45,22,355,0.23255813953488372,2.0
61,78,95,56,58,57,405,0.40336134453781514,40,30,35,50,70,55,280,0.28205128205128205,0.25
30,35,30,100,35,80,310,0.4765625,70,60,125,115,70,55,495,0.35507246376811596,0.5
35,46,34,35,45,20,215,0.072,90,30,15,40,20,15,210,0.043478260869565216,1.0
105,125,100,60,100,100,590,0.8359375,45,75,60,40,30,50,300,0.304,1.0
50,75,70,35,70,48,348,0.29357798165137616,20,15,20,10,55,80,200,0.2682926829268293,1.0
75,125,75,30,75,85,465,0.625,70,80,50,35,35,35,305,0.14,1.0
54,66,70,44,55,46,335,0.4214876033057851,70,55,75,45,65,60,370,0.45901639344262296,0.25
38,35,35,65,55,50,278,0.2647058823529412,40,40,55,40,70,55,300,0.40939597315436244,1.0
57,80,91,80,87,75,470,0.5737704918032787,70,70,70,70,70,70,420,0.5289256198347108,1.0
10,55,25,35,45,95,265,0.5396825396825397,70,135,105,60,105,20,495,0.5806451612903226,1.0
64,51,23,51,23,28,240,0.11363636363636363,45,20,50,60,120,50,345,0.24074074074074073,1.0
60,30,30,36,56,50,262,0.32432432432432434,50,50,95,40,50,35,320,0.20279720279720279,1.0
65,125,60,95,60,105,510,0.9236641221374046,75,90,50,110,80,95,500,0.7985611510791367,2.0
70,75,80,135,80,135,575,0.917910447761194,80,75,150,75,150,50,580,0.30973451327433627,1.0
60,80,50,40,40,30,300,0.15328467153284672,60,50,40,85,75,95,405,0.7540983606557377,1.0
38,30,41,30,41,60,240,0.2897196261682243,50,92,108,92,108,35,485,0.2457627118644068,0.0
50,65,107,105,107,86,520,0.6991150442477876,80,70,40,100,60,145,495,0.921875,2.0
44,75,35,63,33,45,295,0.2647058823529412,80,110,120,130,90,70,600,0.6198347107438017,1.0
1,90,45,30,30,40,236,0.33064516129032256,100,70,70,65,65,45,415,0.1897810218978102,0.0
75,70,90,70,105,80,490,0.656,60,50,70,80,80,140,480,0.8449612403100775,0.5
106,90,130,90,154,110,680,0.8699186991869918,70,110,75,145,85,145,630,0.9444444444444444,2.0
71,95,85,110,95,79,535,0.664,90,75,75,90,100,70,500,0.5462184873949579,0.5
50,50,77,95,77,91,440,0.5916666666666667,55,69,85,32,35,28,304,0.09302325581395349,1.0
100,128,90,77,77,128,600,0.959349593495935,85,105,55,85,50,115,495,0.9032258064516129,1.0
60,55,145,75,150,40,525,0.2,60,62,63,80,80,60,405,0.38016528925619836,1.0
50,35,55,25,25,15,205,0.021739130434782608,60,45,70,45,90,95,405,0.7304964539007093,1.0
40,20,30,40,80,55,265,0.22764227642276422,70,95,125,65,75,45,475,0.33613445378151263,1.0
115,115,85,90,75,100,580,0.8134328358208955,50,55,50,36,30,43,264,0.2922077922077922,1.0
50,35,55,25,25,15,205,0.021739130434782608,40,40,55,40,70,55,300,0.40939597315436244,2.0
60,85,69,60,69,77,420,0.518796992481203,45,49,49,65,65,45,318,0.2781954887218045,1.0
108,170,115,120,95,92,700,0.7083333333333334,82,121,119,69,59,71,521,0.5394736842105263,4.0
60,85,40,30,45,68,328,0.6422018348623854,50,105,125,55,95,50,480,0.375886524822695,2.0
89,124,80,55,80,55,483,0.5714285714285714,78,52,60,63,65,23,341,0.06015037593984962,1.0
58,70,45,40,45,42,300,0.25925925925925924,50,92,108,92,108,35,485,0.2457627118644068,1.0
75,38,38,56,56,67,330,0.5263157894736842,75,140,65,112,65,110,567,0.9140625,4.0
95,60,79,100,125,81,540,0.6201550387596899,75,80,55,25,35,35,305,0.18666666666666668,1.0
91,72,90,129,90,108,580,0.8925619834710744,40,70,40,35,40,60,285,0.392,1.0
40,65,95,60,45,35,340,0.13986013986013987,70,120,40,95,40,95,460,0.8106060606060606,1.0
40,30,50,55,55,100,330,0.584070796460177,65,75,105,35,65,85,430,0.6940298507462687,0.0
80,110,60,150,130,70,600,0.5042016806722689,45,63,37,65,55,95,360,0.8055555555555556,1.0
40,30,35,50,70,55,280,0.28205128205128205,80,100,123,122,120,80,625,0.56,0.25
60,70,50,100,50,65,395,0.5217391304347826,85,73,70,73,115,67,483,0.5126050420168067,2.0
65,40,70,80,140,70,465,0.5954198473282443,70,50,30,95,135,105,485,0.8040540540540541,1.0
80,80,80,55,55,90,440,0.6417910447761194,90,93,55,70,55,55,418,0.3819444444444444,1.0
70,120,40,95,40,95,460,0.8106060606060606,60,50,150,50,150,60,520,0.5206611570247934,2.0
65,60,70,85,75,40,395,0.1796875,75,65,55,65,55,69,384,0.43548387096774194,1.0
45,40,60,40,75,50,310,0.2926829268292683,65,136,94,54,96,135,580,0.9612403100775194,2.0
40,35,30,120,70,105,400,0.6692307692307692,70,55,75,45,65,60,370,0.45901639344262296,0.0
79,105,70,145,80,101,580,0.8608695652173913,60,50,70,50,90,65,385,0.39568345323741005,2.0
91,90,106,130,106,77,600,0.648854961832061,38,35,35,65,55,50,278,0.2647058823529412,0.5
105,130,120,45,45,40,485,0.4444444444444444,70,90,45,15,45,50,315,0.3629032258064516,4.0
50,50,40,30,30,50,250,0.2781954887218045,35,70,55,45,55,25,285,0.09420289855072464,0.5
70,140,230,60,80,50,630,0.32432432432432434,67,89,116,79,116,33,500,0.2624113475177305,0.5
70,55,55,80,60,45,365,0.2222222222222222,80,45,65,90,110,80,470,0.5462962962962963,1.0
76,104,71,104,71,108,534,0.912751677852349,90,60,70,75,70,45,410,0.23880597014925373,2.0
58,64,58,80,65,80,405,0.5423728813559322,90,120,100,150,120,100,680,0.7718120805369127,0.25
60,45,70,45,90,95,405,0.7304964539007093,70,70,70,70,70,70,420,0.5289256198347108,1.0
50,35,55,25,25,15,205,0.021739130434782608,60,62,63,80,80,60,405,0.38016528925619836,1.0
70,65,60,90,75,90,450,0.6571428571428571,31,45,90,30,30,40,266,0.21929824561403508,0.5
50,95,90,95,90,180,600,0.9172413793103448,60,60,60,85,85,85,435,0.631578947368421,1.0
75,95,60,65,60,115,470,0.8778625954198473,45,75,60,40,30,50,300,0.304,1.0
86,81,97,81,107,43,495,0.203125,80,160,60,170,130,80,680,0.6180555555555556,1.0
78,130,111,130,85,100,634,0.8561151079136691,39,52,43,60,50,65,309,0.49107142857142855,0.5
46,87,60,30,40,57,320,0.37777777777777777,50,75,70,35,70,48,348,0.29357798165137616,1.0
60,40,60,95,60,55,370,0.4222222222222222,38,36,38,32,36,57,237,0.3893805309734513,0.0
60,82,45,45,45,74,351,0.5752212389380531,70,80,70,80,70,110,480,0.6594202898550725,2.0
31,45,90,30,30,40,266,0.21929824561403508,85,60,65,135,105,100,550,0.7518248175182481,0.5
44,75,35,63,33,45,295,0.2647058823529412,52,65,55,58,62,60,352,0.4482758620689655,0.0
45,55,39,35,39,42,255,0.18518518518518517,70,80,50,35,35,35,305,0.14,1.0
50,50,62,40,62,65,329,0.4188034188034188,70,70,115,130,90,60,535,0.5338983050847458,0.0
67,125,40,30,30,58,350,0.3431372549019608,69,55,45,55,55,15,294,0.11666666666666667,1.0
105,130,120,45,45,40,485,0.4444444444444444,57,24,86,24,86,23,300,0.12727272727272726,1.0
60,70,50,100,50,65,395,0.5217391304347826,90,110,80,100,80,95,555,0.7982456140350878,0.5
85,110,76,65,82,56,474,0.3933333333333333,80,70,65,80,120,100,515,0.8034188034188035,1.0
40,45,35,30,40,55,245,0.3793103448275862,95,135,80,110,80,100,600,0.8248175182481752,1.0
60,50,70,80,80,140,480,0.8449612403100775,100,150,90,180,160,90,770,0.7348484848484849,2.0
55,45,45,25,25,15,210,0.048,60,90,70,60,120,40,440,0.27419354838709675,1.0
35,64,85,74,55,32,345,0.19827586206896552,67,89,116,79,116,33,500,0.2624113475177305,1.0
65,90,50,85,45,55,390,0.371900826446281,43,80,65,50,35,35,308,0.14193548387096774,2.0
65,40,70,80,140,70,465,0.5954198473282443,50,50,40,50,40,64,294,0.45588235294117646,0.5
53,54,53,37,46,45,288,0.3090909090909091,45,75,60,40,30,50,300,0.304,1.0
105,180,100,180,100,115,780,0.9477611940298507,95,80,105,40,70,100,490,0.8046875,1.0
70,40,50,55,50,25,290,0.061068702290076333,62,77,62,50,42,65,358,0.4838709677419355,2.0
95,23,48,23,48,23,260,0.046153846153846156,70,92,65,80,55,98,460,0.8090909090909091,1.0
116,55,85,107,95,29,487,0.06818181818181818,45,25,50,25,25,35,205,0.13076923076923078,2.0
95,75,80,100,110,30,490,0.24242424242424243,30,40,55,40,55,60,280,0.3237410071942446,0.5
100,100,80,60,60,50,450,0.3050847457627119,97,165,60,65,50,58,495,0.3902439024390244,2.0
70,55,75,45,65,60,370,0.45901639344262296,60,55,50,40,55,45,305,0.22377622377622378,2.0
70,80,102,80,102,40,474,0.2677165354330709,65,110,130,60,65,95,525,0.8278145695364238,4.0
95,100,85,108,70,70,528,0.5652173913043478,50,50,150,50,150,50,500,0.2571428571428571,2.0
45,40,60,40,75,50,310,0.2926829268292683,80,100,80,80,80,100,520,0.9051724137931034,1.0
95,75,180,130,80,30,590,0.13793103448275862,62,55,52,109,94,109,481,0.7833333333333333,1.0
60,85,60,85,60,55,405,0.3673469387755102,53,54,53,37,46,45,288,0.3090909090909091,1.0
67,89,116,79,116,33,500,0.2624113475177305,35,55,40,45,40,60,275,0.35714285714285715,0.5
91,90,72,90,129,108,580,0.896,50,20,40,20,40,20,190,0.0962962962962963,1.0
50,72,35,35,35,65,292,0.5373134328358209,60,95,80,60,80,30,405,0.19480519480519481,0.25
60,79,105,59,85,36,424,0.17054263565891473,75,100,66,60,66,115,482,0.918918918918919,1.0
80,120,70,110,70,80,530,0.6422764227642277,40,55,70,45,60,30,300,0.10619469026548672,4.0
50,85,125,85,115,20,480,0.4306569343065693,80,115,80,65,55,93,488,0.7846153846153846,0.0
85,105,100,79,83,78,530,0.5869565217391305,65,75,90,97,123,44,494,0.1987179487179487,0.5
73,100,60,100,60,65,458,0.42657342657342656,83,106,65,86,65,85,490,0.6640625,0.5
66,41,77,61,87,23,355,0.12096774193548387,75,95,125,45,75,95,510,0.8257575757575758,1.0
105,105,75,65,100,50,500,0.37593984962406013,50,120,53,35,110,87,455,0.640625,1.0
79,100,80,110,90,121,580,0.968,50,85,85,55,55,50,380,0.3902439024390244,0.5
40,35,30,120,70,105,400,0.6692307692307692,105,95,75,85,75,74,509,0.5714285714285714,2.0
60,62,50,62,60,40,334,0.18181818181818182,100,73,83,73,83,55,467,0.371900826446281,0.5
50,65,107,105,107,86,520,0.703125,70,55,75,45,65,60,370,0.45901639344262296,4.0
52,65,55,58,62,60,352,0.4482758620689655,1,90,45,30,30,40,236,0.33064516129032256,0.0
75,90,90,140,90,115,600,0.9481481481481482,110,65,75,125,85,30,490,0.15,2.0
52,65,50,45,50,38,300,0.27419354838709675,50,55,50,36,30,43,264,0.2922077922077922,1.0
65,65,65,50,50,90,385,0.72,85,110,76,65,82,56,474,0.3933333333333333,0.5
95,155,109,70,130,81,640,0.6788321167883211,80,95,82,60,82,75,474,0.6,1.0
35,45,160,30,45,70,385,0.48148148148148145,66,65,48,62,57,52,350,0.36220472440944884,0.5
60,85,40,30,45,68,328,0.6422018348623854,85,76,64,45,55,90,415,0.6739130434782609,1.0
40,35,30,120,70,105,400,0.6692307692307692,40,45,65,100,120,90,460,0.5588235294117647,0.5
76,48,48,57,62,34,325,0.11688311688311688,100,100,100,100,100,100,600,0.8778625954198473,2.0
75,98,63,98,63,101,498,0.849624060150376,70,75,60,105,60,105,475,0.88,1.0
58,70,45,40,45,42,300,0.25925925925925924,75,98,63,98,63,101,498,0.889763779527559,2.0
70,80,70,80,70,110,480,0.6594202898550725,80,160,80,130,80,100,630,0.8455284552845529,0.5
65,65,60,110,95,130,525,0.9253731343283582,125,170,100,120,90,95,700,0.77,0.5
90,120,100,150,120,100,680,0.7718120805369127,65,90,50,85,45,55,390,0.371900826446281,0.5
80,105,65,60,75,130,515,0.9645390070921985,80,100,70,50,60,45,405,0.25806451612903225,1.0
80,90,80,130,110,110,600,0.856,69,69,76,69,86,91,460,0.6554621848739496,1.0
60,40,60,95,60,55,370,0.4222222222222222,44,38,33,61,43,70,289,0.5267857142857143,0.0
76,48,48,57,62,34,325,0.11688311688311688,95,145,130,120,90,120,700,0.9398496240601504,0.5
45,25,50,25,25,35,205,0.13076923076923078,60,70,50,100,50,65,395,0.5217391304347826,0.5
83,106,65,86,65,85,490,0.6640625,70,94,50,94,50,66,424,0.48148148148148145,0.25
75,75,130,75,130,95,580,0.7479674796747967,45,53,70,40,60,42,310,0.25735294117647056,1.0
80,120,70,110,70,80,530,0.6422764227642277,50,65,107,105,107,86,520,0.703125,4.0
40,45,40,65,40,65,295,0.5661764705882353,55,55,85,65,85,35,380,0.2014388489208633,2.0
70,120,100,145,105,20,560,0.2824427480916031,130,85,80,85,95,60,535,0.43884892086330934,1.0
65,65,60,130,95,110,525,0.823943661971831,35,60,44,40,54,55,288,0.366412213740458,2.0
70,65,65,55,55,70,380,0.5,75,80,95,90,100,50,490,0.2158273381294964,1.0
103,60,126,80,126,50,545,0.36363636363636365,43,80,65,50,35,35,308,0.14193548387096774,1.0
40,55,30,30,30,85,270,0.688,75,125,75,30,75,85,465,0.625,2.0
90,85,100,95,125,85,580,0.6834532374100719,65,90,65,61,61,100,442,0.8373983739837398,2.0
89,124,80,55,80,55,483,0.5714285714285714,100,73,83,73,83,55,467,0.371900826446281,2.0
90,110,80,100,80,95,555,0.7982456140350878,60,50,70,50,90,65,385,0.39568345323741005,2.0
170,90,45,90,45,60,500,0.427536231884058,55,47,52,40,40,41,275,0.16806722689075632,1.0
73,100,60,100,60,65,458,0.42657342657342656,95,70,73,95,90,60,483,0.3983739837398374,2.0
45,20,50,60,120,50,345,0.24074074074074073,1,90,45,30,30,40,236,0.33064516129032256,2.0
60,85,40,30,45,68,328,0.6422018348623854,100,164,150,95,120,71,700,0.5645161290322581,2.0
70,110,80,55,80,105,500,0.8794326241134752,80,125,75,40,95,85,500,0.6911764705882353,2.0
50,50,77,95,77,91,440,0.5916666666666667,75,100,63,80,63,116,497,0.9345794392523364,0.5
50,85,125,85,115,20,480,0.4306569343065693,50,85,85,55,55,50,380,0.3902439024390244,0.5
58,64,58,80,65,80,405,0.609271523178808,40,40,50,30,30,30,220,0.0873015873015873,2.0
45,35,45,62,53,35,275,0.11851851851851852,60,70,50,100,50,65,395,0.5217391304347826,0.25
75,125,230,55,95,30,610,0.3448275862068966,70,90,45,15,45,50,315,0.3629032258064516,1.0
91,134,95,100,100,80,600,0.6304347826086957,114,85,70,85,80,30,464,0.2066115702479339,2.0
40,50,90,30,55,65,330,0.44680851063829785,90,120,120,60,60,50,500,0.35294117647058826,0.5
80,105,105,105,105,80,580,0.5939849624060151,78,84,78,109,85,100,534,0.8646616541353384,1.0
75,65,55,65,55,69,384,0.43548387096774194,70,83,50,37,50,60,350,0.3360655737704918,0.0
95,109,105,75,85,56,525,0.34513274336283184,30,40,70,70,25,60,295,0.41353383458646614,2.0
100,180,160,150,90,90,770,0.7520661157024794,70,77,60,97,60,108,472,0.8394160583941606,2.0
95,117,80,65,70,92,519,0.8409090909090909,80,82,100,83,100,80,525,0.6821705426356589,0.5
76,147,90,60,70,97,540,0.8267716535433071,65,90,65,61,61,100,442,0.8373983739837398,1.0
60,25,35,70,80,60,330,0.3076923076923077,30,42,118,42,88,30,350,0.112,0.5
55,84,105,114,75,52,485,0.2890625,100,100,80,60,60,50,450,0.3050847457627119,2.0
110,135,60,50,65,88,508,0.7744360902255639,45,67,60,35,50,63,320,0.5128205128205128,0.5
43,80,65,50,35,35,308,0.14193548387096774,95,75,110,100,80,30,490,0.15267175572519084,0.5
60,80,95,70,85,50,440,0.2231404958677686,110,135,60,50,65,88,508,0.7744360902255639,0.5
110,65,75,125,85,30,490,0.15,89,124,80,55,80,55,483,0.5714285714285714,2.0
35,64,85,74,55,32,345,0.19827586206896552,95,75,80,100,110,30,490,0.24242424242424243,0.5
40,40,40,70,40,20,250,0.032520325203252036,55,63,90,50,80,42,380,0.21138211382113822,4.0
40,45,40,65,40,65,295,0.5661764705882353,50,70,100,40,40,30,330,0.2222222222222222,1.0
120,100,85,30,85,45,465,0.22448979591836735,50,50,62,40,62,65,329,0.4188034188034188,0.5
70,60,125,115,70,55,495,0.35507246376811596,75,100,66,60,66,115,482,0.918918918918919,1.0
105,150,90,150,90,95,680,0.8285714285714286,110,130,80,70,60,80,530,0.5862068965517241,1.0
50,45,45,35,35,50,260,0.23529411764705882,49,66,70,44,55,51,335,0.4260869565217391,0.0
50,40,85,40,65,25,305,0.08870967741935484,45,75,60,40,30,50,300,0.304,1.0
71,120,95,120,95,99,600,0.8203125,55,75,85,25,25,15,280,0.1875,2.0
85,110,90,45,90,80,500,0.6206896551724138,75,38,38,56,56,67,330,0.5263157894736842,1.0
65,75,90,97,123,44,494,0.1987179487179487,60,130,80,60,60,70,460,0.5153846153846153,2.0
66,65,48,62,57,52,350,0.36220472440944884,100,103,75,120,75,127,600,0.940677966101695,0.25
55,75,85,25,25,15,280,0.1875,67,57,55,77,55,114,425,0.8879310344827587,2.0
75,125,75,30,75,85,465,0.625,110,160,110,80,110,100,670,0.8591549295774648,2.0
58,70,45,40,45,42,300,0.25925925925925924,60,60,60,85,85,85,435,0.631578947368421,1.0
100,75,115,90,115,85,580,0.6446280991735537,100,100,125,110,50,50,535,0.384,0.5
60,65,70,85,75,40,395,0.21705426356589147,80,52,50,90,50,89,411,0.6666666666666666,0.25
100,150,140,100,90,90,670,0.7969924812030075,110,65,75,125,85,30,490,0.15,1.0
65,125,60,95,60,105,510,0.9236641221374046,85,105,100,79,83,78,530,0.5869565217391305,1.0
68,65,65,125,115,80,518,0.6461538461538462,70,115,60,115,60,55,475,0.4647887323943662,0.0
35,55,40,50,50,90,320,0.6838235294117647,45,35,45,62,53,35,275,0.11851851851851852,0.5
65,73,55,47,75,85,400,0.6846846846846847,55,50,40,40,40,75,300,0.5945945945945946,1.0
40,45,35,30,40,55,245,0.3793103448275862,70,110,75,145,85,145,630,0.9444444444444444,4.0
40,80,35,35,45,70,305,0.4661016949152542,90,95,95,70,90,70,510,0.5230769230769231,1.0
78,52,60,63,65,23,341,0.06015037593984962,60,50,100,85,70,65,430,0.47580645161290325,1.0
70,50,30,95,135,105,485,0.8040540540540541,80,82,78,95,80,85,500,0.6869565217391305,0.5
80,85,95,30,30,25,345,0.2857142857142857,45,63,37,65,55,95,360,0.8055555555555556,2.0
20,10,55,15,20,80,200,0.17985611510791366,80,80,50,40,50,25,325,0.176056338028169,1.0
60,40,80,60,45,40,325,0.23529411764705882,60,80,50,50,50,40,330,0.23853211009174313,1.0
41,56,40,62,44,71,314,0.568,100,120,120,150,100,90,680,0.7880794701986755,0.5
50,40,85,40,65,25,305,0.08870967741935484,105,150,90,150,90,95,680,0.8285714285714286,0.5
50,70,50,50,50,40,310,0.16296296296296298,78,52,60,63,65,23,341,0.06015037593984962,1.0
68,90,65,50,55,82,410,0.6165413533834586,80,70,40,100,60,145,495,0.921875,0.5
55,84,105,114,75,52,485,0.2890625,50,60,45,100,80,65,400,0.45689655172413796,0.5
70,115,60,115,60,55,475,0.4647887323943662,20,15,20,10,55,80,200,0.2682926829268293,2.0
91,90,72,90,129,108,580,0.896,120,100,85,30,85,45,465,0.22448979591836735,1.0
35,55,40,50,50,90,320,0.6838235294117647,110,65,105,55,95,80,510,0.6258503401360545,2.0
70,50,30,95,135,105,485,0.8040540540540541,50,95,95,35,110,70,455,0.5179856115107914,1.0
70,140,230,60,80,50,630,0.32432432432432434,50,53,48,53,48,64,316,0.46153846153846156,0.5
85,115,80,105,80,50,515,0.3063063063063063,10,55,25,35,45,95,265,0.5396825396825397,0.0
88,107,122,74,75,64,530,0.4596774193548387,100,100,125,110,50,50,535,0.384,0.5
65,55,115,100,40,60,435,0.3798449612403101,50,53,62,58,63,44,330,0.13709677419354838,2.0
45,50,35,55,75,40,300,0.21367521367521367,75,90,90,140,90,115,600,0.9481481481481482,1.0
40,30,30,40,50,30,220,0.07936507936507936,80,70,40,100,60,145,495,0.921875,0.5
50,45,45,35,35,50,260,0.23529411764705882,50,30,55,65,55,20,275,0.13675213675213677,0.0
70,62,67,55,55,56,365,0.38513513513513514,100,50,50,76,96,70,442,0.5,1.0
74,94,131,54,116,20,489,0.4485294117647059,45,55,45,65,45,75,330,0.5692307692307692,1.0
150,160,100,95,65,100,670,0.8866666666666667,123,77,72,99,92,58,521,0.4621212121212121,0.5
65,76,84,54,96,105,480,0.9008264462809917,40,30,35,50,70,55,280,0.28205128205128205,1.0
70,75,80,135,80,135,575,0.917910447761194,65,47,55,73,75,85,400,0.65,1.0
65,75,105,35,65,85,430,0.6940298507462687,60,85,69,60,69,77,420,0.518796992481203,1.0
50,50,62,40,62,65,329,0.4188034188034188,60,100,115,70,85,90,520,0.7557251908396947,0.0
60,65,60,130,75,110,500,0.7719298245614035,60,55,50,40,55,45,305,0.22377622377622378,0.5
75,89,85,55,65,36,405,0.29545454545454547,65,125,60,95,60,105,510,0.9236641221374046,1.0
55,85,55,50,55,60,360,0.4233576642335766,70,140,230,60,80,50,630,0.32432432432432434,1.0
100,77,77,128,128,90,600,0.6901408450704225,100,70,70,65,65,45,415,0.1897810218978102,1.0
60,48,45,43,90,42,328,0.21897810218978103,123,77,72,99,92,58,521,0.4621212121212121,1.0
70,45,48,60,65,35,323,0.15748031496062992,60,40,60,40,60,35,295,0.18055555555555555,1.0
75,98,63,98,63,101,498,0.8091603053435115,70,77,60,97,60,108,472,0.8394160583941606,0.5
65,110,130,60,65,95,525,0.8278145695364238,135,85,40,40,85,5,390,0.6864406779661016,1.0
65,150,40,15,80,145,495,0.9663865546218487,1,90,45,30,30,40,236,0.33064516129032256,0.25
75,95,125,45,75,95,510,0.8257575757575758,50,53,48,53,48,64,316,0.46153846153846156,2.0
50,35,55,25,25,15,205,0.05263157894736842,100,75,115,90,115,85,580,0.6446280991735537,1.0
54,63,52,83,56,97,405,0.7697841726618705,80,185,115,40,105,75,600,0.6230769230769231,1.0
54,63,52,83,56,97,405,0.7697841726618705,75,80,70,65,75,90,455,0.7578125,1.0
70,85,140,85,70,20,470,0.272,45,30,50,65,50,45,285,0.13821138211382114,1.0
44,38,33,61,43,70,289,0.5267857142857143,20,25,45,70,90,60,310,0.30833333333333335,1.0
50,53,62,58,63,44,330,0.13709677419354838,126,131,95,131,98,99,680,0.8102189781021898,1.0
55,45,45,25,25,15,210,0.048,20,10,230,10,230,5,505,0.0,2.0
59,66,70,44,55,41,335,0.25190839694656486,85,97,66,105,66,65,484,0.47107438016528924,0.5
40,65,40,80,40,65,330,0.5038167938931297,76,25,45,67,55,24,292,0.0390625,2.0
90,55,75,60,75,30,385,0.13970588235294118,80,100,70,50,60,45,405,0.25806451612903225,1.0
95,125,79,60,100,81,540,0.6165413533834586,50,70,50,50,50,70,340,0.5645161290322581,1.0
70,50,30,95,135,105,485,0.8040540540540541,70,60,70,87,78,85,450,0.6228070175438597,2.0
70,90,70,60,60,70,420,0.6390977443609023,40,45,40,62,60,60,307,0.33884297520661155,1.0
150,100,120,100,120,90,680,0.6666666666666666,70,85,65,105,85,120,530,0.9262295081967213,1.0
45,30,50,55,65,45,290,0.208,70,85,70,60,70,50,405,0.28378378378378377,2.0
80,82,83,100,100,80,525,0.6742424242424242,55,45,45,25,25,15,210,0.048,2.0
100,180,160,150,90,90,770,0.7520661157024794,65,65,60,110,95,130,525,0.9253731343283582,2.0
160,110,65,65,110,30,540,0.35714285714285715,105,150,90,150,90,95,680,0.8285714285714286,1.0
52,65,50,45,50,38,300,0.27419354838709675,60,60,60,60,60,60,360,0.38095238095238093,1.0
35,85,45,35,35,75,310,0.6492537313432836,70,60,125,115,70,55,495,0.35507246376811596,0.25
100,150,120,120,100,90,680,0.6493506493506493,70,62,67,55,55,56,365,0.38513513513513514,1.0
65,90,115,45,115,58,488,0.5041322314049587,40,45,40,62,60,60,307,0.33884297520661155,1.0
50,92,108,92,108,35,485,0.2457627118644068,106,190,100,154,100,130,780,0.9259259259259259,2.0
60,75,100,55,80,50,420,0.3088235294117647,65,136,94,54,96,135,580,0.9612403100775194,1.0
75,95,125,45,75,95,510,0.8257575757575758,89,124,80,55,80,55,483,0.5714285714285714,1.0
60,85,69,65,79,80,438,0.576,91,72,90,129,90,108,580,0.8925619834710744,1.0
100,120,100,150,120,90,680,0.728,70,83,50,37,50,60,350,0.3360655737704918,1.0
250,5,5,35,105,50,450,0.15306122448979592,65,50,70,95,80,65,425,0.4262295081967213,1.0
50,35,55,25,25,15,205,0.021739130434782608,60,75,100,55,80,50,420,0.3088235294117647,1.0
45,30,50,55,65,45,290,0.208,60,75,100,55,80,50,420,0.3088235294117647,0.25
80,130,100,160,120,110,700,0.8981481481481481,103,93,67,71,61,84,479,0.7142857142857143,0.0
72,105,115,54,86,68,500,0.5149253731343284,70,55,55,80,60,45,365,0.2222222222222222,1.0
105,105,75,65,100,50,500,0.37593984962406013,65,136,94,54,96,135,580,0.9612403100775194,1.0
44,50,91,24,86,10,305,0.1981981981981982,65,73,55,47,75,85,400,0.6846846846846847,0.5
55,112,45,74,45,70,401,0.559322033898305,95,110,95,40,95,55,490,0.40336134453781514,1.0
75,80,55,25,35,35,305,0.18666666666666668,67,58,57,81,67,101,431,0.8790322580645161,0.5
55,84,105,114,75,52,485,0.2890625,45,90,20,65,20,65,305,0.5116279069767442,0.5
50,65,85,35,35,55,325,0.32575757575757575,106,190,100,154,100,130,780,0.9259259259259259,0.5
70,70,40,60,40,60,340,0.4247787610619469,90,92,87,75,85,76,505,0.5409836065573771,1.0
40,29,45,29,45,36,224,0.14634146341463414,105,125,100,60,100,100,590,0.8359375,1.0
50,160,110,160,110,110,700,0.8854961832061069,42,52,67,39,56,50,306,0.2868217054263566,1.0
44,75,35,63,33,45,295,0.2647058823529412,50,65,107,105,107,86,520,0.6991150442477876,1.0
50,60,45,100,80,65,400,0.45689655172413796,44,58,44,58,44,61,309,0.41964285714285715,0.5
55,84,105,114,75,52,485,0.2890625,65,40,50,125,60,30,370,0.07258064516129033,1.0
79,85,60,55,60,71,410,0.60431654676259,64,66,68,81,76,50,405,0.25190839694656486,0.5
60,100,85,80,85,100,510,0.7007874015748031,110,85,95,80,95,50,515,0.2713178294573643,2.0
95,155,109,70,130,81,640,0.6788321167883211,90,75,85,115,90,55,510,0.3445378151260504,1.0
70,85,140,85,70,20,470,0.272,65,60,110,130,95,65,525,0.47761194029850745,2.0
45,90,20,65,20,65,305,0.5116279069767442,70,110,75,145,85,145,630,0.9444444444444444,0.25
63,60,55,50,50,71,349,0.5289256198347108,45,30,35,20,20,45,195,0.14782608695652175,2.0
50,105,125,55,95,50,480,0.375886524822695,75,100,110,45,55,65,450,0.5333333333333333,1.0
90,132,105,132,105,30,594,0.4246575342465753,65,63,45,45,45,45,308,0.2595419847328244,0.25
42,52,67,39,56,50,306,0.2868217054263566,46,87,60,30,40,57,320,0.37777777777777777,0.5
78,92,75,74,63,118,500,0.8842975206611571,35,45,160,30,45,70,385,0.48148148148148145,1.0
83,80,80,135,80,121,579,0.9444444444444444,50,70,50,50,50,40,310,0.16296296296296298,1.0
50,85,40,85,40,35,335,0.1746031746031746,80,120,80,120,80,100,580,0.8478260869565217,1.0
85,56,77,50,77,78,423,0.53125,85,135,130,60,80,25,515,0.40540540540540543,1.0
65,75,105,35,65,85,430,0.6940298507462687,100,150,110,95,110,70,635,0.5923076923076923,1.0
45,30,50,65,50,45,285,0.13821138211382114,50,70,160,70,160,90,600,0.7417218543046358,0.5
95,70,73,95,90,60,483,0.3983739837398374,70,80,70,80,70,110,480,0.6594202898550725,1.0
49,66,70,44,55,51,335,0.4260869565217391,70,60,70,87,78,85,450,0.6228070175438597,0.5
20,40,15,35,35,60,205,0.34285714285714286,70,80,50,35,35,35,305,0.14,1.0
75,80,60,65,90,102,472,0.8625954198473282,82,80,86,85,75,72,480,0.6183206106870229,1.0
100,73,83,73,83,55,467,0.371900826446281,80,105,105,105,105,80,580,0.5939849624060151,1.0
70,20,50,20,50,40,250,0.1557377049180328,50,75,45,40,45,60,315,0.4380165289256198,1.0
45,55,45,65,45,75,330,0.5692307692307692,60,79,105,59,85,36,424,0.17054263565891473,4.0
45,85,50,55,50,65,350,0.5076923076923077,55,55,85,65,85,35,380,0.2014388489208633,2.0
91,134,95,100,100,80,600,0.6304347826086957,60,55,90,145,90,80,520,0.6071428571428571,1.0
85,105,55,85,50,115,495,0.9032258064516129,60,70,105,70,120,75,500,0.5983606557377049,2.0
95,110,95,40,95,55,490,0.40336134453781514,90,75,75,90,100,70,500,0.5462184873949579,1.0
50,50,120,80,80,30,410,0.07258064516129033,40,40,35,50,100,70,335,0.5031847133757962,0.5
170,90,45,90,45,60,500,0.427536231884058,65,90,122,58,75,84,494,0.71875,0.5
50,180,20,180,20,150,600,0.9029850746268657,60,75,85,100,85,115,520,0.8992248062015504,0.5
58,64,58,80,65,80,405,0.5423728813559322,50,95,90,95,90,180,600,0.9172413793103448,1.0
70,130,100,55,80,65,500,0.608,80,92,65,65,80,68,450,0.4824561403508772,0.5
100,164,150,95,120,71,700,0.5645161290322581,80,92,65,65,80,68,450,0.4824561403508772,1.0
30,35,30,100,35,80,310,0.4765625,70,140,230,60,80,50,630,0.32432432432432434,0.0
66,117,70,40,50,67,410,0.4573643410852713,95,117,80,65,70,92,519,0.8409090909090909,1.0
75,123,67,95,85,95,540,0.7642276422764228,41,56,40,62,44,71,314,0.568,2.0
72,95,67,103,71,122,530,0.9606299212598425,75,100,110,45,55,65,450,0.5333333333333333,2.0
50,85,85,55,55,50,380,0.3902439024390244,40,45,35,65,55,70,310,0.4482758620689655,1.0
40,45,40,35,35,56,251,0.373015873015873,91,129,90,72,90,108,580,0.8536585365853658,0.5
90,132,105,132,105,30,594,0.4246575342465753,57,80,91,80,87,75,470,0.5737704918032787,0.25
67,82,62,46,48,43,348,0.22033898305084745,35,80,50,50,70,120,405,0.84375,1.0
55,63,90,50,80,42,380,0.21138211382113822,82,80,86,85,75,72,480,0.6183206106870229,0.5
55,47,52,40,40,41,275,0.16806722689075632,45,100,45,45,45,10,290,0.2949640287769784,0.5
44,48,65,50,64,43,314,0.1623931623931624,95,75,180,130,80,30,590,0.13793103448275862,0.5
62,55,52,109,94,109,481,0.7833333333333333,75,75,60,83,60,60,413,0.39344262295081966,2.0
30,45,59,30,39,57,260,0.2803030303030303,50,65,107,105,107,86,520,0.7313432835820896,4.0
80,100,200,50,100,50,580,0.3472222222222222,50,85,125,85,115,20,480,0.4306569343065693,1.0
86,81,97,81,107,43,495,0.203125,67,58,57,81,67,101,431,0.8790322580645161,1.0
165,75,80,40,45,65,470,0.5151515151515151,30,56,35,25,35,72,253,0.48148148148148145,1.0
45,30,50,55,65,45,290,0.208,95,155,109,70,130,81,640,0.6788321167883211,0.0
60,110,70,60,60,100,460,0.8461538461538461,50,100,150,100,150,50,600,0.37142857142857144,0.25
73,100,60,100,60,65,458,0.42657342657342656,75,100,63,80,63,116,497,0.9345794392523364,1.0
50,105,125,55,95,50,480,0.375886524822695,55,81,60,50,70,97,413,0.7214285714285714,1.0
50,55,50,36,30,43,264,0.2922077922077922,67,58,57,81,67,101,431,0.8790322580645161,0.5
70,140,230,60,80,50,630,0.32432432432432434,60,82,45,45,45,74,351,0.5752212389380531,1.0
65,50,35,115,95,95,455,0.7333333333333333,110,78,73,76,71,60,468,0.3333333333333333,2.0
65,150,60,115,60,115,565,0.935251798561151,35,64,85,74,55,32,345,0.19827586206896552,1.0
75,75,55,105,85,30,425,0.1619718309859155,60,80,110,50,80,45,425,0.2833333333333333,2.0
40,55,70,45,60,30,300,0.10619469026548672,60,60,75,60,75,80,410,0.7321428571428571,1.0
35,40,100,90,55,35,355,0.1796875,95,124,78,69,71,58,495,0.37398373983739835,0.5
60,52,168,47,138,30,495,0.19834710743801653,123,100,62,97,81,68,531,0.4806201550387597,1.0
59,59,58,90,70,73,409,0.5826086956521739,85,56,77,50,77,78,423,0.53125,1.0
100,50,50,76,96,70,442,0.5,60,45,50,90,80,70,395,0.625,2.0
100,77,77,128,128,90,600,0.6901408450704225,30,45,55,70,55,85,340,0.5633802816901409,1.0
75,98,63,98,63,101,498,0.849624060150376,60,60,60,35,35,30,280,0.11194029850746269,1.0
55,47,52,40,40,41,275,0.16806722689075632,80,160,80,130,80,100,630,0.8455284552845529,1.0
30,56,35,25,35,72,253,0.48148148148148145,55,55,50,45,65,55,325,0.37373737373737376,1.0
40,45,65,100,120,90,460,0.5588235294117647,78,81,71,74,69,126,499,0.9090909090909091,0.5
40,65,95,60,45,35,340,0.13986013986013987,74,100,72,90,72,46,454,0.24561403508771928,2.0
80,80,80,55,55,90,440,0.6417910447761194,100,100,100,100,100,100,600,0.8758169934640523,0.5
71,120,95,120,95,99,600,0.8203125,64,78,52,78,52,81,405,0.6422764227642277,0.125
150,160,100,95,65,100,670,0.8866666666666667,65,110,130,60,65,95,525,0.8278145695364238,1.0
40,30,30,55,30,85,270,0.4666666666666667,40,45,40,62,60,60,307,0.33884297520661155,2.0
50,30,55,65,55,20,275,0.13675213675213677,55,112,45,74,45,70,401,0.559322033898305,0.5
70,70,70,70,70,70,420,0.5289256198347108,62,73,55,56,52,84,382,0.7244094488188977,1.0
65,65,60,110,95,130,525,0.9253731343283582,75,140,65,112,65,110,567,0.9140625,2.0
70,120,40,95,40,95,460,0.8106060606060606,45,30,15,85,65,65,305,0.36220472440944884,2.0
70,60,62,80,82,60,414,0.4375,60,105,60,120,60,105,510,0.8849557522123894,2.0
70,43,53,43,53,40,302,0.19090909090909092,50,60,60,60,60,30,320,0.11290322580645161,0.5
82,121,119,69,59,71,521,0.5394736842105263,85,80,70,135,75,90,535,0.7006802721088435,1.0
75,125,75,30,75,85,465,0.625,44,50,91,24,86,10,305,0.1981981981981982,2.0
70,65,60,90,75,90,450,0.6571428571428571,57,80,91,80,87,75,470,0.5737704918032787,0.0
80,80,80,80,80,80,480,0.6015037593984962,84,86,88,111,101,60,530,0.4634146341463415,0.25
89,124,80,55,80,55,483,0.5714285714285714,45,95,50,40,50,75,355,0.54,1.0
100,73,83,73,83,55,467,0.371900826446281,70,70,40,60,40,60,340,0.4247787610619469,2.0
64,88,50,88,50,106,446,0.9111111111111111,45,45,35,20,30,20,195,0.07246376811594203,1.0
150,80,44,90,54,80,498,0.625,60,48,45,43,90,42,328,0.21897810218978103,2.0
70,60,62,80,82,60,414,0.4375,46,57,40,40,40,50,273,0.25,0.5
45,50,45,115,55,95,405,0.6936936936936937,45,90,20,65,20,65,305,0.5116279069767442,0.5
100,150,120,120,100,90,680,0.6493506493506493,35,45,160,30,45,70,385,0.48148148148148145,0.0
60,50,100,85,70,65,430,0.47580645161290325,50,53,48,53,48,64,316,0.4076923076923077,1.0
60,40,60,95,60,55,370,0.4222222222222222,84,71,43,71,43,48,360,0.25874125874125875,0.0
80,80,80,80,80,80,480,0.6015037593984962,64,66,68,81,76,50,405,0.25190839694656486,0.5
60,85,40,30,45,68,328,0.6422018348623854,110,80,90,95,90,65,530,0.5033557046979866,1.0
61,84,65,70,70,70,420,0.5,58,89,77,45,45,48,362,0.3177570093457944,2.0
80,145,150,105,110,110,700,0.8692307692307693,60,85,60,50,50,125,430,0.9090909090909091,1.0
60,65,80,170,95,130,600,0.8625954198473282,45,25,50,25,25,35,205,0.13076923076923078,0.5
60,79,105,59,85,36,424,0.17054263565891473,55,70,55,40,55,85,360,0.7073170731707317,1.0
68,75,53,83,113,60,452,0.45384615384615384,50,50,95,40,50,35,320,0.20279720279720279,1.0
60,85,49,60,49,60,363,0.4444444444444444,60,90,140,50,50,40,430,0.2535211267605634,1.0
40,50,90,30,55,65,330,0.44680851063829785,52,65,55,58,62,60,352,0.4482758620689655,0.5
50,75,35,70,30,40,300,0.21296296296296297,74,108,133,83,65,32,495,0.32142857142857145,2.0
111,83,68,92,82,39,475,0.1774193548387097,55,70,45,70,50,60,350,0.45,4.0
45,60,40,70,50,45,310,0.2846715328467153,85,73,70,73,115,67,483,0.5126050420168067,1.0
40,20,30,40,80,55,265,0.22764227642276422,75,123,67,95,85,95,540,0.7642276422764228,0.5
40,55,99,40,79,47,360,0.26262626262626265,78,84,78,109,85,100,534,0.8646616541353384,0.25
90,100,70,110,150,80,600,0.6037735849056604,60,25,35,70,80,60,330,0.3076923076923077,1.0
70,60,62,80,82,60,414,0.4375,85,56,77,50,77,78,423,0.53125,1.0
75,103,80,70,80,92,500,0.7933884297520661,110,160,110,80,110,100,670,0.8591549295774648,1.0
30,42,118,42,88,30,350,0.112,60,55,90,145,90,80,520,0.6071428571428571,1.0
77,85,51,55,51,65,384,0.5163934426229508,84,71,43,71,43,48,360,0.25874125874125875,1.0
81,102,77,85,75,85,505,0.5642857142857143,49,66,70,44,55,51,335,0.4260869565217391,0.5
100,75,115,90,115,85,580,0.6446280991735537,30,35,30,100,35,80,310,0.4765625,1.0
55,50,40,40,40,75,300,0.5945945945945946,70,92,65,80,55,98,460,0.8090909090909091,1.0
70,65,60,90,75,90,450,0.6571428571428571,55,95,115,45,45,35,390,0.2116788321167883,0.25
100,100,100,100,100,100,600,0.8758169934640523,70,95,125,65,75,45,475,0.33613445378151263,2.0
100,100,100,100,100,100,600,0.8805970149253731,65,125,100,60,70,70,490,0.6099290780141844,1.0
35,40,100,90,55,35,355,0.1796875,120,70,120,75,130,85,600,0.6694915254237288,1.0
10,55,25,35,45,95,265,0.5396825396825397,85,73,70,73,115,67,483,0.5126050420168067,1.0
70,55,65,95,85,70,440,0.5307692307692308,100,134,110,95,100,61,600,0.4057971014492754,0.0
65,75,105,35,65,85,430,0.6940298507462687,49,55,42,42,37,85,310,0.6068376068376068,1.0
70,70,115,130,90,60,535,0.5338983050847458,20,40,90,30,90,25,295,0.11363636363636363,1.0
50,48,43,46,41,60,288,0.47297297297297297,45,63,37,65,55,95,360,0.8055555555555556,2.0
75,125,75,30,75,85,465,0.625,73,76,75,81,100,100,505,0.8110236220472441,1.0
105,30,105,140,105,55,540,0.3524590163934426,130,85,80,85,95,60,535,0.43884892086330934,1.0
50,53,48,53,48,64,316,0.358974358974359,65,110,130,60,65,95,525,0.8278145695364238,0.5
90,55,75,60,75,30,385,0.13970588235294118,45,95,50,40,50,75,355,0.54,0.5
20,15,20,10,55,80,200,0.2682926829268293,40,29,45,29,45,36,224,0.14634146341463414,1.0
91,134,95,100,100,80,600,0.6304347826086957,106,190,100,154,100,130,780,0.9259259259259259,2.0
65,90,120,85,70,60,490,0.43410852713178294,50,85,55,65,65,90,410,0.7478260869565218,1.0
62,44,50,44,50,55,305,0.3629032258064516,106,110,90,154,90,130,680,0.926829268292683,1.0
115,115,85,90,75,100,580,0.8134328358208955,60,70,105,70,120,75,500,0.5983606557377049,1.0
80,52,50,90,50,89,411,0.6666666666666666,65,80,80,59,63,58,405,0.4411764705882353,1.0
50,55,50,36,30,43,264,0.2922077922077922,190,33,58,33,58,33,405,0.13432835820895522,1.0
80,50,100,100,200,50,580,0.2357142857142857,50,65,45,85,65,95,405,0.7238095238095238,2.0
43,70,48,50,60,38,309,0.2391304347826087,28,25,25,45,35,40,198,0.16083916083916083,2.0
61,84,65,70,70,70,420,0.5,100,90,130,45,65,55,485,0.4253731343283582,1.0
60,55,50,40,55,45,305,0.22377622377622378,40,40,55,40,70,55,300,0.40939597315436244,1.0
110,65,105,55,95,80,510,0.6258503401360545,40,65,95,60,45,35,340,0.13986013986013987,1.0
45,55,45,65,45,75,330,0.5692307692307692,80,70,40,100,60,145,495,0.921875,2.0
50,80,95,10,45,10,290,0.232,85,110,76,65,82,56,474,0.3933333333333333,1.0
60,45,70,45,90,95,405,0.7304964539007093,110,65,75,125,85,30,490,0.15,1.0
35,85,45,35,35,75,310,0.6492537313432836,65,83,57,95,85,105,490,0.8914728682170543,0.5
70,92,65,80,55,98,460,0.8090909090909091,50,65,107,105,107,86,520,0.6991150442477876,2.0
74,48,76,83,81,104,466,0.7322834645669292,85,80,70,135,75,90,535,0.7006802721088435,1.0
50,70,100,40,40,30,330,0.2222222222222222,54,78,103,53,45,22,355,0.23255813953488372,1.0
115,115,85,90,75,100,580,0.8134328358208955,50,60,45,100,80,65,400,0.45689655172413796,2.0
41,50,37,50,37,66,281,0.5175438596491229,95,124,78,69,71,58,495,0.37398373983739835,0.25
70,120,65,45,85,125,510,0.9747899159663865,80,70,70,90,100,70,480,0.5609756097560976,1.0
95,23,48,23,48,23,260,0.046153846153846156,76,25,45,67,55,24,292,0.0390625,0.5
30,80,90,55,45,55,355,0.4295774647887324,50,53,62,58,63,44,330,0.13709677419354838,0.5
50,50,62,40,62,65,329,0.4188034188034188,50,95,95,35,110,70,455,0.5179856115107914,1.0
85,90,80,70,80,130,535,0.9262295081967213,64,66,68,81,76,50,405,0.25190839694656486,1.0
85,56,77,50,77,78,423,0.53125,40,30,35,50,70,55,280,0.28205128205128205,1.0
70,110,75,145,85,145,630,0.9444444444444444,60,95,80,60,80,30,405,0.19480519480519481,0.25
100,120,100,150,120,90,680,0.728,30,40,70,70,25,60,295,0.41353383458646614,0.5
92,105,90,125,90,98,600,0.8217054263565892,80,52,50,90,50,89,411,0.6666666666666666,1.0
55,70,55,40,55,85,360,0.7073170731707317,75,125,75,30,75,85,465,0.625,1.0
72,85,70,65,70,58,420,0.41304347826086957,75,98,63,98,63,101,498,0.849624060150376,1.0
30,40,55,40,55,60,280,0.3237410071942446,28,25,25,45,35,40,198,0.16083916083916083,0.125
72,60,30,20,30,25,237,0.11570247933884298,91,90,72,90,129,108,580,0.896,1.0
45,49,65,49,65,45,318,0.275,108,100,121,81,95,95,600,0.7476635514018691,1.0
55,40,40,65,45,35,280,0.16428571428571428,64,51,23,51,23,28,240,0.11363636363636363,1.0
70,95,125,65,75,45,475,0.33613445378151263,60,55,90,145,90,80,520,0.6071428571428571,0.5
80,100,200,50,100,50,580,0.3472222222222222,50,65,45,85,65,95,405,0.7238095238095238,1.0
90,92,87,75,85,76,505,0.5409836065573771,85,80,90,105,95,60,515,0.49074074074074076,1.0
50,40,85,40,65,25,305,0.08870967741935484,40,40,35,50,100,70,335,0.5031847133757962,0.5
80,125,75,40,95,85,500,0.6911764705882353,75,140,65,112,65,110,567,0.9140625,0.5
45,50,43,40,38,62,278,0.40441176470588236,58,64,58,80,65,80,405,0.609271523178808,1.0
60,52,168,47,138,30,495,0.19834710743801653,73,100,60,100,60,65,458,0.42657342657342656,1.0
50,53,62,58,63,44,330,0.13709677419354838,89,124,80,55,80,55,483,0.5714285714285714,2.0
62,48,66,59,57,49,341,0.33884297520661155,90,60,70,75,70,45,410,0.23880597014925373,1.0
28,25,25,45,35,40,198,0.16083916083916083,45,50,45,115,55,95,405,0.6936936936936937,1.0
73,95,62,85,65,85,465,0.6666666666666666,42,52,67,39,56,50,306,0.2868217054263566,0.5
100,100,100,100,100,100,600,0.8778625954198473,50,65,107,105,107,86,520,0.6991150442477876,0.5
126,131,95,131,98,99,680,0.8102189781021898,80,80,90,110,130,110,600,0.8721804511278195,2.0
40,45,35,65,55,70,310,0.4482758620689655,68,90,65,50,55,82,410,0.6165413533834586,1.0
106,90,130,90,154,110,680,0.8699186991869918,58,50,145,95,105,30,483,0.2459016393442623,1.0
90,95,95,70,90,70,510,0.5230769230769231,80,80,80,80,80,80,480,0.6015037593984962,2.0
60,75,100,55,80,50,420,0.3088235294117647,90,95,105,165,110,45,610,0.2890625,0.5
75,95,95,95,95,85,540,0.6470588235294118,75,80,70,65,75,90,455,0.7578125,1.0
80,110,120,130,90,70,600,0.6198347107438017,81,102,77,85,75,85,505,0.5642857142857143,2.0
75,105,75,105,75,45,480,0.3274336283185841,75,80,85,110,90,50,490,0.3548387096774194,0.5
80,80,80,80,80,80,480,0.5606060606060606,55,55,55,85,55,30,335,0.1320754716981132,1.0
80,100,200,50,100,50,580,0.3472222222222222,70,60,62,80,82,60,414,0.4375,4.0
40,65,95,60,45,35,340,0.13986013986013987,55,65,95,95,45,85,440,0.6610169491525424,1.0
65,80,140,40,70,70,465,0.5223880597014925,74,100,72,90,72,46,454,0.24561403508771928,2.0
86,92,88,68,75,73,482,0.6835443037974683,40,27,60,37,50,66,280,0.36220472440944884,0.5
40,50,45,70,45,70,320,0.5517241379310345,62,44,50,44,50,55,305,0.3629032258064516,1.0
75,55,70,55,95,110,460,0.8444444444444444,65,70,60,65,65,115,440,0.8583333333333333,1.0
45,60,30,80,50,65,330,0.4603174603174603,105,95,75,85,75,74,509,0.5714285714285714,0.5
64,51,23,51,23,28,240,0.11363636363636363,95,85,85,65,65,35,430,0.2571428571428571,1.0
20,25,45,70,90,60,310,0.30833333333333335,65,65,60,130,95,110,525,0.823943661971831,0.5
50,70,50,50,50,40,310,0.16296296296296298,60,40,60,40,60,35,295,0.18055555555555555,0.5
50,50,40,30,30,50,250,0.2781954887218045,44,38,39,61,79,42,303,0.2251655629139073,1.0
82,80,86,85,75,72,480,0.6183206106870229,50,53,48,53,48,64,316,0.4076923076923077,1.0
50,95,95,35,110,70,455,0.5179856115107914,80,52,50,90,50,89,411,0.6666666666666666,0.25
50,65,107,105,107,86,520,0.6991150442477876,38,35,35,65,55,50,278,0.2647058823529412,1.0
30,30,30,30,30,30,180,0.12612612612612611,46,57,40,40,40,50,273,0.25,0.5
70,84,70,65,70,51,410,0.2949640287769784,76,104,71,104,71,108,534,0.912751677852349,2.0
65,150,60,115,60,115,565,0.935251798561151,80,120,80,120,80,100,580,0.8478260869565217,1.0
90,65,65,40,40,15,315,0.19672131147540983,50,52,48,65,50,55,320,0.33098591549295775,0.5
60,65,60,130,75,110,500,0.7719298245614035,105,95,75,85,75,74,509,0.5714285714285714,0.5
58,89,77,45,45,48,362,0.3177570093457944,106,150,70,194,120,140,780,0.952,1.0
80,145,150,105,110,110,700,0.8692307692307693,74,48,76,83,81,104,466,0.7913043478260869,0.5
50,70,160,70,160,90,600,0.7417218543046358,105,30,105,140,105,55,540,0.3524590163934426,0.5
80,52,50,90,50,89,411,0.6666666666666666,75,105,75,105,75,45,480,0.3274336283185841,1.0
70,85,65,105,85,120,530,0.9262295081967213,60,67,85,77,75,116,480,0.8888888888888888,0.5
95,85,85,65,65,35,430,0.2571428571428571,74,94,131,54,116,20,489,0.4485294117647059,0.5
60,40,80,60,45,40,325,0.23529411764705882,41,56,40,62,44,71,314,0.568,2.0
70,95,85,55,65,70,440,0.5,105,150,90,150,90,95,680,0.8285714285714286,2.0
40,35,30,120,70,105,400,0.6692307692307692,95,75,180,130,80,30,590,0.13793103448275862,0.5
60,55,145,75,150,40,525,0.2,44,75,35,63,33,45,295,0.2647058823529412,1.0
74,100,72,90,72,46,454,0.24561403508771928,73,100,60,100,60,65,458,0.42657342657342656,0.5
50,53,48,53,48,64,316,0.4076923076923077,60,40,60,40,60,35,295,0.18055555555555555,0.5
50,75,35,70,30,40,300,0.21296296296296297,55,20,35,20,45,75,250,0.37681159420289856,1.0
80,120,79,95,79,70,523,0.5833333333333334,85,76,64,45,55,90,415,0.6739130434782609,1.0
75,125,70,125,70,115,580,0.9037037037037037,91,72,90,129,90,108,580,0.8620689655172413,1.0
50,95,95,35,110,70,455,0.5179856115107914,74,100,72,90,72,46,454,0.24561403508771928,1.0
88,107,122,74,75,64,530,0.4596774193548387,61,90,45,50,50,160,456,0.9230769230769231,0.0625
28,25,25,45,35,40,198,0.16083916083916083,83,80,80,135,80,121,579,0.9444444444444444,1.0
49,49,56,49,61,66,330,0.5190839694656488,85,110,76,65,82,56,474,0.3933333333333333,0.5
65,95,57,100,85,93,495,0.7441860465116279,60,40,60,40,60,35,295,0.18055555555555555,2.0
85,110,76,65,82,56,474,0.3933333333333333,1,90,45,30,30,40,236,0.33064516129032256,1.0
64,78,52,78,52,81,405,0.6422764227642277,76,147,90,60,70,97,540,0.8267716535433071,0.5
85,120,70,50,60,100,485,0.8308823529411765,70,60,75,110,75,90,480,0.7165354330708661,2.0
85,105,55,85,50,115,495,0.9032258064516129,85,60,65,135,105,100,550,0.7518248175182481,2.0
38,35,35,65,55,50,278,0.2647058823529412,45,22,60,27,30,29,213,0.07518796992481203,1.0
65,130,60,75,60,75,465,0.689922480620155,80,80,50,40,50,25,325,0.176056338028169,1.0
41,56,40,62,44,71,314,0.568,70,90,90,135,90,125,600,0.9401709401709402,1.0
50,60,45,100,80,65,400,0.45689655172413796,111,83,68,92,82,39,475,0.1774193548387097,2.0
80,115,80,65,55,93,488,0.7846153846153846,59,110,150,45,49,35,448,0.3333333333333333,0.0
255,10,10,75,135,55,540,0.3125,73,100,60,100,60,65,458,0.42657342657342656,1.0
123,77,72,99,92,58,521,0.4621212121212121,60,40,60,40,60,35,295,0.18055555555555555,2.0
110,123,65,100,65,65,528,0.5217391304347826,80,100,70,50,60,45,405,0.25806451612903225,1.0
55,40,85,80,105,40,405,0.23622047244094488,105,125,100,60,100,100,590,0.8359375,1.0
91,129,90,72,90,108,580,0.8536585365853658,65,80,140,40,70,70,465,0.5223880597014925,1.0
75,75,130,75,130,95,580,0.7479674796747967,106,150,70,194,120,140,780,0.952,0.5
60,70,65,125,105,90,515,0.6911764705882353,61,90,45,50,50,160,456,0.9230769230769231,0.25
45,100,45,45,45,10,290,0.2949640287769784,45,55,45,65,45,75,330,0.5692307692307692,0.0
64,66,68,81,76,50,405,0.25190839694656486,79,100,80,110,90,121,580,0.968,1.0
69,69,76,69,86,91,460,0.6554621848739496,60,60,60,105,105,105,495,0.848,1.0
70,85,65,105,85,120,530,0.9262295081967213,75,80,70,65,75,90,455,0.7578125,0.25
60,100,85,80,85,100,510,0.7007874015748031,55,75,60,75,60,103,428,0.7982456140350878,0.5
40,29,45,29,45,36,224,0.14634146341463414,65,47,55,73,75,85,400,0.65,1.0
70,85,65,105,85,120,530,0.9262295081967213,50,70,50,50,50,70,340,0.5645161290322581,1.0
60,70,65,125,105,90,515,0.6911764705882353,75,90,90,140,90,115,600,0.9481481481481482,0.5
38,36,38,32,36,57,237,0.3893805309734513,60,80,95,70,85,50,440,0.2231404958677686,0.5
106,90,130,90,154,110,680,0.8699186991869918,70,110,75,145,85,145,630,0.9444444444444444,2.0
65,90,40,45,80,75,395,0.625,45,75,60,40,30,50,300,0.304,1.0
55,63,90,50,80,42,380,0.21138211382113822,85,80,70,135,75,90,535,0.7006802721088435,1.0
50,52,48,65,50,55,320,0.33098591549295775,60,59,85,79,105,36,424,0.16666666666666666,0.5
108,130,95,80,85,102,600,0.7637795275590551,70,70,70,70,70,70,420,0.5289256198347108,1.0
110,160,110,80,110,100,670,0.8591549295774648,40,65,95,60,45,35,340,0.13986013986013987,1.0
80,100,70,50,60,45,405,0.25806451612903225,50,60,45,100,80,65,400,0.45689655172413796,0.5
75,55,70,55,95,110,460,0.8444444444444444,45,80,100,35,37,28,325,0.3125,0.25
45,35,45,62,53,35,275,0.11851851851851852,105,105,75,65,100,50,500,0.37593984962406013,0.5
62,48,54,63,60,68,355,0.5178571428571429,80,105,105,105,105,80,580,0.5939849624060151,0.5
65,40,50,125,60,30,370,0.07258064516129033,35,35,40,35,55,50,250,0.40336134453781514,1.0
65,80,80,59,63,58,405,0.4411764705882353,255,10,10,75,135,55,540,0.3125,1.0
70,110,180,60,60,50,530,0.4117647058823529,67,82,62,46,48,43,348,0.22033898305084745,0.5
55,55,45,63,45,45,308,0.25,75,70,90,70,105,80,490,0.656,0.5
70,55,95,95,110,65,490,0.48872180451127817,70,90,90,135,90,125,600,0.9401709401709402,0.0
100,100,80,60,60,50,450,0.3050847457627119,60,110,70,60,60,100,460,0.8461538461538461,0.0
50,20,40,20,40,20,190,0.0962962962962963,65,60,70,85,75,40,395,0.1796875,1.0
38,30,85,55,65,30,303,0.21428571428571427,72,85,70,65,70,58,420,0.41304347826086957,0.5
61,78,95,56,58,57,405,0.40336134453781514,45,22,60,27,30,29,213,0.07518796992481203,0.5
45,100,135,65,135,45,525,0.29411764705882354,110,80,90,95,90,65,530,0.5033557046979866,1.0
95,70,73,95,90,60,483,0.3983739837398374,85,73,70,73,115,67,483,0.5126050420168067,1.0
56,61,65,48,45,38,313,0.17567567567567569,65,90,120,85,70,60,490,0.43410852713178294,0.5
90,60,60,40,40,40,330,0.29545454545454547,50,65,90,35,35,15,290,0.14678899082568808,0.5
55,50,65,175,95,150,590,0.7818181818181819,106,190,100,154,100,130,780,0.9259259259259259,0.5
20,15,20,10,55,80,200,0.2682926829268293,78,52,60,63,65,23,341,0.06015037593984962,1.0
79,103,120,135,115,78,630,0.5763888888888888,70,90,90,135,90,125,600,0.9401709401709402,1.0
45,90,20,65,20,65,305,0.5116279069767442,30,30,30,30,30,30,180,0.12612612612612611,0.5
95,109,105,75,85,56,525,0.34513274336283184,85,73,70,73,115,67,483,0.5126050420168067,1.0
65,130,60,95,110,65,525,0.5303030303030303,150,80,44,90,54,80,498,0.625,1.0
99,68,83,72,87,51,460,0.417910447761194,125,58,58,76,76,67,460,0.515625,1.0
70,60,75,110,75,90,480,0.7165354330708661,62,50,58,73,54,72,369,0.4435483870967742,0.5
51,65,65,80,75,59,395,0.4365079365079365,80,50,100,100,200,50,580,0.2357142857142857,0.5
70,115,60,115,60,55,475,0.4647887323943662,60,90,55,90,80,110,485,0.8677685950413223,1.0
73,95,62,85,65,85,465,0.6666666666666666,76,48,48,57,62,34,325,0.11688311688311688,1.0
90,120,100,150,120,100,680,0.7718120805369127,70,80,65,90,65,85,455,0.578125,1.0
125,120,90,170,100,95,700,0.78125,100,120,100,150,120,90,680,0.728,2.0
40,30,35,50,70,55,280,0.28205128205128205,50,65,107,105,107,86,520,0.6991150442477876,0.5
76,147,90,60,70,97,540,0.8267716535433071,55,55,50,45,65,55,325,0.37373737373737376,1.0
85,76,64,45,55,90,415,0.6739130434782609,70,95,85,55,65,70,440,0.5,0.5
85,110,90,45,90,80,500,0.6206896551724138,55,20,35,20,45,75,250,0.37681159420289856,1.0
20,15,20,10,55,80,200,0.2682926829268293,108,100,121,81,95,95,600,0.7476635514018691,1.0
85,105,55,85,50,115,495,0.9032258064516129,86,76,86,116,56,95,515,0.7982456140350878,1.0
40,35,30,20,20,50,195,0.23423423423423423,74,48,76,83,81,104,466,0.7913043478260869,2.0
35,60,44,40,54,55,288,0.366412213740458,65,80,80,59,63,58,405,0.4411764705882353,1.0
75,80,85,110,90,50,490,0.3548387096774194,103,60,86,60,86,50,445,0.3458646616541353,1.0
40,55,30,30,30,60,245,0.43548387096774194,45,30,50,65,50,45,285,0.13821138211382114,1.0
60,30,30,36,56,50,262,0.32432432432432434,40,35,30,20,20,50,195,0.23423423423423423,2.0
100,5,5,15,65,30,220,0.07692307692307693,64,165,75,93,83,75,555,0.6587301587301587,0.0
41,50,37,50,37,66,281,0.5175438596491229,65,80,65,35,65,60,370,0.38405797101449274,1.0
85,105,55,85,50,115,495,0.9032258064516129,35,55,40,50,50,90,320,0.6838235294117647,1.0
70,60,70,87,78,85,450,0.6228070175438597,65,80,65,35,65,60,370,0.38405797101449274,1.0
50,47,50,57,50,65,319,0.463768115942029,126,131,95,131,98,99,680,0.8102189781021898,2.0
115,45,20,45,25,20,270,0.11538461538461539,95,65,65,110,130,60,525,0.4016393442622951,1.0
75,98,63,98,63,101,498,0.8091603053435115,80,70,70,90,100,70,480,0.5609756097560976,1.0
170,90,45,90,45,60,500,0.427536231884058,70,100,70,105,75,40,460,0.23214285714285715,4.0
60,60,50,40,50,75,335,0.5882352941176471,103,60,126,80,126,50,545,0.36363636363636365,1.0
50,65,107,105,107,86,520,0.7272727272727273,100,120,120,150,100,90,680,0.7880794701986755,0.25
50,75,35,70,30,40,300,0.21296296296296297,50,65,85,35,35,55,325,0.32575757575757575,0.5
35,55,40,45,40,60,275,0.35714285714285715,60,52,168,47,138,30,495,0.19834710743801653,1.0
100,110,90,85,90,60,535,0.47794117647058826,60,130,80,60,60,70,460,0.5153846153846153,0.25
64,115,65,83,63,65,455,0.5323741007194245,60,130,80,60,60,70,460,0.5153846153846153,1.0
44,50,91,24,86,10,305,0.1981981981981982,50,180,20,180,20,150,600,0.9029850746268657,1.0
81,102,77,85,75,85,505,0.5642857142857143,45,40,60,40,75,50,310,0.2926829268292683,0.0
60,85,60,85,60,55,405,0.3673469387755102,60,150,50,150,50,60,520,0.5,0.0
75,125,75,30,75,85,465,0.625,50,75,75,65,65,50,380,0.4049586776859504,0.0
60,85,60,50,50,125,430,0.9090909090909091,69,69,76,69,86,91,460,0.6554621848739496,1.0
1,90,45,30,30,40,236,0.33064516129032256,70,140,70,110,65,105,560,0.95,1.0
78,81,71,74,69,126,499,0.9090909090909091,70,65,60,90,75,90,450,0.6571428571428571,4.0
55,45,45,25,25,15,210,0.048,35,55,35,30,30,35,220,0.23684210526315788,1.0
75,125,75,30,75,85,465,0.625,58,89,77,45,45,48,362,0.3177570093457944,2.0
45,60,32,50,32,76,295,0.5925925925925926,100,90,130,45,65,55,485,0.4253731343283582,2.0
30,45,59,30,39,57,260,0.2803030303030303,75,90,90,140,90,115,600,0.9481481481481482,1.0
60,70,50,100,50,65,395,0.5217391304347826,65,155,120,65,90,105,600,0.8677685950413223,1.0
85,76,64,45,55,90,415,0.6739130434782609,65,40,70,80,140,70,465,0.5954198473282443,1.0
130,65,60,110,95,65,525,0.5227272727272727,50,75,70,35,70,48,348,0.29357798165137616,1.0
55,75,60,75,60,103,428,0.7982456140350878,75,98,63,98,63,101,498,0.8091603053435115,1.0
20,10,55,15,20,80,200,0.17985611510791366,60,50,40,85,75,95,405,0.7540983606557377,1.0
50,60,60,60,60,30,320,0.11290322580645161,76,48,48,57,62,34,325,0.11688311688311688,0.5
70,100,70,105,75,40,460,0.23214285714285715,75,90,50,110,80,95,500,0.7985611510791367,1.0
70,60,70,87,78,85,450,0.6228070175438597,65,95,57,100,85,93,495,0.7441860465116279,0.5
80,120,70,110,70,80,530,0.6422764227642277,40,55,30,30,30,60,245,0.43548387096774194,1.0
55,75,85,25,25,15,280,0.1875,92,105,90,125,90,98,600,0.8217054263565892,1.0
45,53,70,40,60,42,310,0.25735294117647056,95,75,180,130,80,30,590,0.13793103448275862,4.0
70,62,67,55,55,56,365,0.38513513513513514,60,100,115,70,85,90,520,0.7557251908396947,0.0
65,95,57,100,85,93,495,0.7441860465116279,74,94,131,54,116,20,489,0.4485294117647059,4.0
100,150,140,100,90,90,670,0.7969924812030075,110,65,75,125,85,30,490,0.15,1.0
60,60,60,85,85,85,435,0.631578947368421,115,45,20,45,25,20,270,0.11538461538461539,0.0
130,65,60,110,95,65,525,0.5227272727272727,60,60,60,60,60,60,360,0.38095238095238093,1.0
40,30,50,55,55,100,330,0.584070796460177,100,50,80,60,80,50,420,0.34375,2.0
85,110,90,45,90,80,500,0.6206896551724138,100,150,90,180,160,90,770,0.7348484848484849,1.0
75,105,75,105,75,45,480,0.3274336283185841,45,40,60,40,75,50,310,0.2926829268292683,1.0
68,72,78,38,42,32,330,0.23809523809523808,70,62,67,55,55,56,365,0.38513513513513514,2.0
50,70,100,40,40,30,330,0.2222222222222222,65,100,70,80,80,105,500,0.8666666666666667,1.0
50,47,50,57,50,65,319,0.463768115942029,40,50,45,70,45,70,320,0.5517241379310345,2.0
60,40,60,95,60,55,370,0.4222222222222222,78,92,75,74,63,118,500,0.8842975206611571,1.0
55,112,45,74,45,70,401,0.559322033898305,70,55,95,95,110,65,490,0.48872180451127817,1.0
165,75,80,40,45,65,470,0.5151515151515151,100,123,75,57,75,80,510,0.6923076923076923,1.0
60,70,50,100,50,65,395,0.5217391304347826,80,70,70,90,100,70,480,0.5609756097560976,4.0
95,80,105,40,70,100,490,0.8046875,75,95,122,58,75,69,494,0.5725806451612904,0.0
59,66,70,44,55,41,335,0.25190839694656486,58,70,45,40,45,42,300,0.25925925925925924,1.0
65,50,35,115,95,95,455,0.7333333333333333,80,125,75,40,95,85,500,0.6911764705882353,1.0
70,95,85,55,65,70,440,0.5,60,100,85,80,85,100,510,0.7007874015748031,0.25
64,66,68,81,76,50,405,0.25190839694656486,100,120,120,150,100,90,680,0.7880794701986755,0.5
90,132,105,132,105,30,594,0.4246575342465753,55,55,50,45,65,55,325,0.37373737373737376,1.0
73,115,60,60,60,90,458,0.6694915254237288,85,80,90,105,95,60,515,0.49074074074074076,1.0
70,95,125,65,75,45,475,0.33613445378151263,60,75,85,100,85,115,520,0.8992248062015504,2.0
67,89,116,79,116,33,500,0.2624113475177305,60,85,60,85,60,55,405,0.3673469387755102,0.5
50,105,125,55,95,50,480,0.375886524822695,35,64,85,74,55,32,345,0.19827586206896552,0.5
103,60,86,60,86,50,445,0.3458646616541353,44,38,39,61,79,42,303,0.2251655629139073,1.0
60,67,85,77,75,116,480,0.8888888888888888,35,46,34,35,45,20,215,0.072,1.0
105,130,120,45,45,40,485,0.4444444444444444,20,10,55,15,20,80,200,0.17985611510791366,1.0
50,75,75,65,65,50,380,0.4049586776859504,86,92,88,68,75,73,482,0.6835443037974683,1.0
100,150,90,180,160,90,770,0.7348484848484849,92,105,90,125,90,98,600,0.8217054263565892,0.5
45,65,34,40,34,45,263,0.2589928057553957,99,68,83,72,87,51,460,0.417910447761194,1.0
91,90,106,130,106,77,600,0.648854961832061,60,62,50,62,60,40,334,0.18181818181818182,8.0
120,120,120,120,120,120,720,0.9344262295081968,60,55,145,75,150,40,525,0.2,0.25
55,95,115,45,45,35,390,0.2116788321167883,63,63,47,41,41,74,329,0.56,2.0
150,120,100,120,100,90,680,0.664179104477612,68,90,65,50,55,82,410,0.6165413533834586,2.0
75,80,95,90,100,50,490,0.2158273381294964,95,135,80,110,80,100,600,0.8248175182481752,0.25
40,30,30,55,30,85,270,0.4666666666666667,76,25,45,67,55,24,292,0.0390625,1.0
50,53,48,53,48,64,316,0.358974358974359,20,10,55,15,20,80,200,0.17985611510791366,0.5
63,60,55,50,50,71,349,0.5289256198347108,100,100,125,110,50,50,535,0.384,2.0
52,65,55,58,62,60,352,0.4482758620689655,95,155,109,70,130,81,640,0.6788321167883211,1.0
85,73,70,73,115,67,483,0.5126050420168067,40,20,30,40,80,55,265,0.22764227642276422,1.0
46,57,40,40,40,50,273,0.25,79,115,70,125,80,111,580,0.8468468468468469,1.0
71,82,64,64,59,112,452,0.9327731092436975,40,30,30,55,30,85,270,0.4666666666666667,1.0
111,83,68,92,82,39,475,0.1774193548387097,85,97,66,105,66,65,484,0.47107438016528924,4.0
71,120,95,120,95,99,600,0.8203125,108,170,115,120,95,92,700,0.7083333333333334,1.0
43,70,48,50,60,38,309,0.2391304347826087,40,40,40,70,40,20,250,0.032520325203252036,0.5
65,80,80,59,63,58,405,0.4411764705882353,55,20,35,20,45,75,250,0.37681159420289856,1.0
100,100,90,150,140,90,670,0.71875,70,105,105,50,40,20,390,0.33587786259541985,2.0
150,120,100,120,100,90,680,0.664179104477612,45,100,135,65,135,45,525,0.29411764705882354,2.0
75,80,55,25,35,35,305,0.18666666666666668,50,55,50,36,30,43,264,0.2922077922077922,1.0
70,100,70,105,75,40,460,0.23214285714285715,65,80,80,59,63,58,405,0.4411764705882353,0.5
74,94,131,54,116,20,489,0.4485294117647059,90,110,80,100,80,95,555,0.7982456140350878,0.25
55,50,45,135,95,120,500,0.7714285714285715,90,75,85,115,90,55,510,0.3445378151260504,1.0
50,65,107,105,107,86,520,0.7313432835820896,75,75,75,125,95,40,485,0.15671641791044777,1.0
40,55,30,30,30,60,245,0.43548387096774194,110,130,80,70,60,80,530,0.5862068965517241,1.0
50,95,95,35,110,70,455,0.5179856115107914,103,60,86,60,86,50,445,0.3458646616541353,2.0
100,128,90,77,77,128,600,0.959349593495935,85,110,90,45,90,80,500,0.6206896551724138,2.0
75,75,95,75,95,113,528,0.9015151515151515,75,100,63,80,63,116,497,0.9345794392523364,1.0
110,123,65,100,65,65,528,0.5217391304347826,65,45,55,45,70,45,325,0.24369747899159663,0.5
80,80,80,80,80,80,480,0.6015037593984962,60,60,50,40,50,75,335,0.5882352941176471,2.0
50,120,53,35,110,87,455,0.640625,65,60,70,85,75,40,395,0.1796875,2.0
60,80,110,50,80,45,425,0.2833333333333333,65,60,70,85,75,40,395,0.1796875,1.0
65,65,60,110,95,130,525,0.9253731343283582,40,30,30,40,50,30,220,0.07936507936507936,1.0
60,85,69,60,69,77,420,0.518796992481203,106,110,90,154,90,130,680,0.926829268292683,1.0
50,95,95,35,110,70,455,0.5179856115107914,120,70,120,75,130,85,600,0.6694915254237288,0.5
70,77,60,97,60,108,472,0.8394160583941606,35,46,34,35,45,20,215,0.072,1.0
100,50,80,60,80,50,420,0.34375,65,63,45,45,45,45,308,0.2595419847328244,1.0
77,59,50,67,63,46,362,0.23140495867768596,80,82,100,83,100,80,525,0.6821705426356589,2.0
103,93,67,71,61,84,479,0.7142857142857143,65,55,115,100,40,60,435,0.3798449612403101,2.0
60,80,50,50,50,40,330,0.23853211009174313,69,69,76,69,86,91,460,0.6554621848739496,1.0
30,80,90,55,45,55,355,0.4295774647887324,60,80,50,50,50,40,330,0.23853211009174313,1.0
65,85,70,75,70,40,405,0.203125,65,80,65,35,65,60,370,0.38405797101449274,1.0
67,89,116,79,116,33,500,0.2624113475177305,40,60,40,40,40,30,250,0.0948905109489051,2.0
50,50,95,40,50,35,320,0.20279720279720279,68,72,78,38,42,32,330,0.23809523809523808,1.0
50,65,107,105,107,86,520,0.703125,40,60,40,40,40,30,250,0.0948905109489051,1.0
95,145,130,120,90,120,700,0.9398496240601504,75,140,65,112,65,110,567,0.9140625,0.5
78,104,78,159,115,100,634,0.8444444444444444,35,20,65,40,65,20,245,0.02459016393442623,1.0
35,64,85,74,55,32,345,0.19827586206896552,50,50,50,50,50,50,300,0.30708661417322836,1.0
50,105,79,35,110,76,455,0.6214285714285714,108,130,95,80,85,102,600,0.7637795275590551,1.0
70,50,30,95,135,105,485,0.8040540540540541,40,65,40,80,40,65,330,0.5038167938931297,1.0
50,100,150,100,150,50,600,0.37142857142857144,55,70,55,40,55,85,360,0.7073170731707317,1.0
60,45,70,75,85,55,390,0.3008130081300813,50,20,40,20,40,20,190,0.0962962962962963,1.0
62,77,62,50,42,65,358,0.4838709677419355,50,20,40,20,40,20,190,0.0962962962962963,1.0
61,78,95,56,58,57,405,0.40336134453781514,40,65,40,80,40,65,330,0.5038167938931297,1.0
95,135,80,110,80,100,600,0.8248175182481752,75,90,140,60,60,40,465,0.3008130081300813,0.5
62,48,54,63,60,68,355,0.5178571428571429,115,140,130,55,55,40,535,0.4519230769230769,2.0
71,95,85,110,95,79,535,0.664,38,30,41,30,41,60,240,0.2897196261682243,1.0
45,67,60,35,50,63,320,0.5128205128205128,65,125,60,95,60,105,510,0.9236641221374046,1.0
55,50,40,40,40,75,300,0.5945945945945946,38,36,38,32,36,57,237,0.3893805309734513,1.0
50,80,95,10,45,10,290,0.232,45,53,70,40,60,42,310,0.25735294117647056,2.0
55,40,50,65,85,40,335,0.3181818181818182,41,56,40,62,44,71,314,0.568,0.5
80,45,65,90,110,80,470,0.5462962962962963,60,100,89,55,69,112,485,0.9298245614035088,2.0
123,77,72,99,92,58,521,0.4621212121212121,60,59,85,79,105,36,424,0.16666666666666666,4.0
68,65,65,125,115,80,518,0.6461538461538462,40,40,40,70,40,20,250,0.032520325203252036,0.5
70,83,50,37,50,60,350,0.3360655737704918,75,100,95,40,70,110,490,0.8717948717948718,1.0
90,75,85,115,90,55,510,0.3445378151260504,130,65,60,110,95,65,525,0.5227272727272727,2.0
79,100,80,110,90,121,580,0.968,35,80,50,50,70,120,405,0.84375,1.0
65,60,70,85,75,40,395,0.1796875,60,69,95,69,95,36,424,0.2608695652173913,0.5
70,80,70,80,70,110,480,0.6594202898550725,50,180,20,180,20,150,600,0.9029850746268657,2.0
70,140,230,60,80,50,630,0.32432432432432434,55,20,35,20,45,75,250,0.37681159420289856,1.0
40,60,30,31,31,70,262,0.4492753623188406,40,20,30,40,80,55,265,0.22764227642276422,2.0
55,81,60,50,70,97,413,0.7214285714285714,60,40,60,40,60,35,295,0.18055555555555555,1.0
35,55,40,45,40,60,275,0.35714285714285715,85,105,85,40,50,40,405,0.211864406779661,1.0
40,45,40,35,35,56,251,0.373015873015873,45,53,70,40,60,42,310,0.25735294117647056,4.0
65,47,55,73,75,85,400,0.65,91,90,72,90,129,108,580,0.896,1.0
100,5,5,15,65,30,220,0.07692307692307693,65,76,84,54,96,105,480,0.9008264462809917,1.0
65,95,75,55,55,85,430,0.6933333333333334,73,115,60,60,60,90,458,0.6694915254237288,1.0
68,165,95,65,115,110,618,0.8615384615384616,95,75,180,130,80,30,590,0.13793103448275862,0.25
75,125,230,55,95,30,610,0.3448275862068966,35,20,65,40,65,20,245,0.02459016393442623,0.5
50,30,55,65,55,20,275,0.13675213675213677,30,45,55,70,55,85,340,0.5633802816901409,0.5
65,75,105,35,65,85,430,0.6940298507462687,85,97,66,105,66,65,484,0.47107438016528924,2.0
70,70,40,60,40,60,340,0.4247787610619469,50,95,95,35,110,70,455,0.5179856115107914,0.5
70,110,80,55,80,105,500,0.8794326241134752,110,80,90,95,90,65,530,0.5033557046979866,1.0
70,65,65,55,55,70,380,0.5,65,65,60,130,95,110,525,0.823943661971831,1.0
67,89,116,79,116,33,500,0.2624113475177305,85,80,70,135,75,90,535,0.7006802721088435,1.0
50,75,75,65,65,50,380,0.4049586776859504,60,62,63,80,80,60,405,0.38016528925619836,1.0
50,65,107,105,107,86,520,0.6991150442477876,38,30,41,30,41,60,240,0.2897196261682243,1.0
70,115,60,115,60,55,475,0.4647887323943662,55,130,115,50,50,75,475,0.5982142857142857,2.0
90,60,70,75,70,45,410,0.23880597014925373,70,75,80,135,80,135,575,0.917910447761194,1.0
90,110,80,100,80,95,555,0.7982456140350878,95,155,109,70,130,81,640,0.6788321167883211,0.5
60,90,55,90,80,110,485,0.8677685950413223,65,75,90,97,123,44,494,0.1987179487179487,0.5
65,50,70,95,80,65,425,0.4262295081967213,55,75,50,40,40,80,340,0.6302521008403361,1.0
80,95,82,60,82,75,474,0.6,55,104,105,94,75,52,485,0.36363636363636365,1.0
60,65,70,85,75,40,395,0.21705426356589147,65,95,57,100,85,93,495,0.7441860465116279,0.5
39,52,43,60,50,65,309,0.5041322314049587,130,85,80,85,95,60,535,0.43884892086330934,1.0
70,90,110,60,75,95,500,0.7333333333333333,105,105,75,65,100,50,500,0.37593984962406013,0.5
38,30,85,55,65,30,303,0.21428571428571427,78,130,111,130,85,100,634,0.8561151079136691,1.0
60,50,40,85,75,95,405,0.7540983606557377,45,85,50,55,50,65,350,0.5076923076923077,1.0
95,23,48,23,48,23,260,0.046153846153846156,53,51,53,61,56,40,314,0.14285714285714285,1.0
80,80,50,40,50,25,325,0.176056338028169,50,120,53,35,110,87,455,0.640625,1.0
125,170,100,120,90,95,700,0.77,60,75,85,100,85,115,520,0.8992248062015504,0.5
50,50,120,80,80,30,410,0.07258064516129033,75,75,55,105,85,30,425,0.1619718309859155,2.0
68,65,65,125,115,80,518,0.6461538461538462,40,45,40,35,35,56,251,0.373015873015873,1.0
45,49,65,49,65,45,318,0.275,80,120,70,110,70,80,530,0.6422764227642277,0.5
70,70,70,70,70,70,420,0.5289256198347108,95,155,109,70,130,81,640,0.6788321167883211,1.0
45,53,70,40,60,42,310,0.25735294117647056,38,30,41,30,41,60,240,0.2897196261682243,1.0
95,145,130,120,90,120,700,0.9398496240601504,50,150,50,150,50,150,600,0.9339622641509434,1.0
62,55,52,109,94,109,481,0.7833333333333333,83,106,65,86,65,85,490,0.6640625,1.0
65,95,100,60,50,50,420,0.34959349593495936,90,30,15,40,20,15,210,0.043478260869565216,0.0
50,55,50,36,30,43,264,0.2922077922077922,75,98,63,98,63,101,498,0.8091603053435115,2.0
85,105,85,40,50,40,405,0.211864406779661,55,50,40,40,40,75,300,0.5945945945945946,2.0
70,110,80,55,80,105,500,0.8794326241134752,106,90,130,90,154,110,680,0.8699186991869918,1.0
45,30,35,20,20,45,195,0.14782608695652175,35,60,44,40,54,55,288,0.366412213740458,0.5
60,45,70,75,85,55,390,0.3008130081300813,45,50,55,75,65,30,320,0.06293706293706294,2.0
74,48,76,83,81,104,466,0.7322834645669292,78,81,71,74,69,126,499,0.9090909090909091,1.0
71,95,85,110,95,79,535,0.664,90,60,60,40,40,40,330,0.29545454545454547,2.0
35,70,55,45,55,25,285,0.09420289855072464,66,65,48,62,57,52,350,0.36220472440944884,1.0
77,120,90,60,90,48,485,0.2785714285714286,65,47,55,73,75,85,400,0.65,1.0
90,130,80,65,85,55,505,0.4396551724137931,70,120,40,95,40,95,460,0.8106060606060606,2.0
65,40,70,80,140,70,465,0.5954198473282443,45,49,65,49,65,45,318,0.275,1.0
55,66,44,44,56,85,350,0.6888888888888889,70,70,115,130,90,60,535,0.5338983050847458,0.5
50,50,50,50,50,50,300,0.30708661417322836,100,100,100,100,100,100,600,0.8758169934640523,0.5
45,53,70,40,60,42,310,0.25735294117647056,55,55,55,85,55,30,335,0.1320754716981132,2.0
80,80,90,110,130,110,600,0.8721804511278195,55,75,60,75,60,103,428,0.7982456140350878,1.0
95,60,79,100,125,81,540,0.6201550387596899,55,68,64,45,55,31,318,0.11666666666666667,0.5
76,104,71,104,71,108,534,0.912751677852349,55,55,50,45,65,55,325,0.37373737373737376,2.0
70,85,140,85,70,20,470,0.272,70,90,70,60,60,70,420,0.6390977443609023,1.0
60,45,70,75,85,55,390,0.3008130081300813,100,100,80,60,60,50,450,0.3050847457627119,2.0
65,155,120,65,90,105,600,0.8677685950413223,63,63,47,41,41,74,329,0.56,1.0
70,85,65,105,85,120,530,0.9262295081967213,67,89,116,79,116,33,500,0.2624113475177305,0.5
55,75,50,40,40,80,340,0.6302521008403361,80,82,83,100,100,80,525,0.6742424242424242,2.0
80,80,90,110,130,110,600,0.8721804511278195,57,80,91,80,87,75,470,0.5737704918032787,0.0
40,50,45,70,45,70,320,0.5517241379310345,115,140,130,55,55,40,535,0.4519230769230769,1.0
85,120,70,50,60,100,485,0.8308823529411765,31,45,90,30,30,40,266,0.21929824561403508,2.0
50,35,55,25,25,15,205,0.05263157894736842,106,110,90,154,90,130,680,0.926829268292683,2.0
90,120,75,60,60,45,450,0.29411764705882354,90,100,60,90,60,80,480,0.6422764227642277,2.0
75,80,60,65,90,102,472,0.8625954198473282,150,160,100,95,65,100,670,0.8866666666666667,1.0
45,40,60,40,75,50,310,0.2926829268292683,40,45,40,65,40,65,295,0.5661764705882353,0.5
65,125,60,95,60,105,510,0.9236641221374046,60,52,168,47,138,30,495,0.19834710743801653,4.0
70,60,75,110,75,90,480,0.7165354330708661,60,70,105,70,120,75,500,0.5983606557377049,2.0
110,160,110,80,110,100,670,0.8591549295774648,76,65,45,92,42,91,411,0.7449664429530202,1.0
60,70,65,125,105,90,515,0.6911764705882353,50,70,160,70,160,90,600,0.7417218543046358,1.0
50,85,125,85,115,20,480,0.4306569343065693,100,5,5,15,65,30,220,0.07692307692307693,0.0
35,45,160,30,45,70,385,0.48148148148148145,41,56,40,62,44,71,314,0.568,1.0
40,45,40,65,40,65,295,0.5661764705882353,81,102,77,85,75,85,505,0.5642857142857143,0.0
65,95,75,55,55,85,430,0.6933333333333334,40,40,35,50,100,70,335,0.5031847133757962,0.25
50,105,125,55,95,50,480,0.375886524822695,40,35,30,20,20,50,195,0.23423423423423423,0.5
40,60,30,31,31,70,262,0.4492753623188406,45,60,32,50,32,76,295,0.5925925925925926,0.5
90,130,80,65,85,55,505,0.4396551724137931,65,60,70,85,75,40,395,0.1796875,2.0
50,25,28,45,55,15,218,0.0625,38,30,85,55,65,30,303,0.21428571428571427,1.0
45,90,20,65,20,65,305,0.5116279069767442,45,25,50,25,25,35,205,0.13076923076923078,1.0
70,70,70,70,70,70,420,0.5289256198347108,48,61,40,61,40,50,300,0.2543859649122807,1.0
40,30,32,50,52,65,269,0.3671875,105,125,100,60,100,100,590,0.8359375,1.0
79,103,120,135,115,78,630,0.5763888888888888,65,100,70,80,80,105,500,0.8666666666666667,2.0
55,112,45,74,45,70,401,0.559322033898305,71,95,85,110,95,79,535,0.664,2.0
70,84,70,65,70,51,410,0.2949640287769784,50,50,40,30,30,50,250,0.2781954887218045,1.0
110,78,73,76,71,60,468,0.3333333333333333,60,40,50,75,85,95,405,0.6044776119402985,2.0
50,70,160,70,160,90,600,0.7417218543046358,100,150,140,100,90,90,670,0.7969924812030075,2.0
50,150,50,150,50,150,600,0.9339622641509434,80,100,123,122,120,80,625,0.56,2.0
120,100,85,30,85,45,465,0.22448979591836735,77,120,90,60,90,48,485,0.2785714285714286,1.0
50,85,85,55,55,50,380,0.3902439024390244,50,65,45,85,65,95,405,0.7238095238095238,1.0
44,48,65,50,64,43,314,0.1623931623931624,80,115,80,65,55,93,488,0.7846153846153846,1.0
38,35,35,65,55,50,278,0.2647058823529412,75,103,80,70,80,92,500,0.7933884297520661,1.0
45,60,32,50,32,76,295,0.5925925925925926,70,94,50,94,50,66,424,0.48148148148148145,2.0
80,100,70,50,60,45,405,0.25806451612903225,50,50,95,40,50,35,320,0.20279720279720279,1.0
97,165,60,65,50,58,495,0.3902439024390244,85,73,70,73,115,67,483,0.5126050420168067,1.0
84,71,43,71,43,48,360,0.25874125874125875,85,73,70,73,115,67,483,0.5126050420168067,1.0
80,92,65,65,80,68,450,0.4824561403508772,50,75,75,65,65,50,380,0.4049586776859504,1.0
65,80,140,40,70,70,465,0.5223880597014925,55,69,85,32,35,28,304,0.09302325581395349,2.0
90,30,15,40,20,15,210,0.043478260869565216,65,150,40,15,80,145,495,0.9663865546218487,0.5
65,60,70,85,75,40,395,0.1796875,80,80,80,80,80,80,480,0.6015037593984962,1.0
70,105,105,50,40,20,390,0.33587786259541985,37,25,41,25,41,25,194,0.08870967741935484,2.0
60,65,80,170,95,130,600,0.8625954198473282,75,125,100,70,80,45,495,0.33035714285714285,0.5
65,65,60,130,95,110,525,0.823943661971831,59,74,50,35,50,35,303,0.3125,2.0
75,103,80,70,80,92,500,0.7933884297520661,80,100,70,60,70,95,475,0.7416666666666667,1.0
65,85,70,75,70,40,405,0.203125,64,78,52,78,52,81,405,0.6422764227642277,1.0
60,45,70,45,90,95,405,0.7304964539007093,45,80,100,35,37,28,325,0.3125,1.0
90,130,80,65,85,55,505,0.4396551724137931,69,55,45,55,55,15,294,0.11666666666666667,0.5
70,135,105,60,105,20,495,0.5806451612903226,79,85,60,55,60,71,410,0.60431654676259,0.5
60,60,60,105,105,105,495,0.848,86,68,72,109,66,106,507,0.8099173553719008,0.0
100,150,120,120,100,90,680,0.6493506493506493,95,23,48,23,48,23,260,0.046153846153846156,1.0
90,75,75,90,100,70,500,0.5462184873949579,80,100,123,122,120,80,625,0.56,0.5
75,80,95,90,100,50,490,0.2158273381294964,80,85,95,30,30,25,345,0.2857142857142857,4.0
45,75,60,40,30,50,300,0.304,40,40,40,70,40,20,250,0.032520325203252036,1.0
46,57,40,40,40,50,273,0.25,100,150,140,100,90,90,670,0.7969924812030075,0.5
58,64,58,80,65,80,405,0.5423728813559322,70,75,60,105,60,105,475,0.88,1.0
95,75,180,130,80,30,590,0.13793103448275862,45,65,34,40,34,45,263,0.2589928057553957,1.0
75,80,55,25,35,35,305,0.18666666666666668,50,30,55,65,55,20,275,0.13675213675213677,0.0
70,55,95,95,110,65,490,0.48872180451127817,40,45,40,62,60,60,307,0.33884297520661155,1.0
65,73,55,47,75,85,400,0.6846846846846847,125,120,90,170,100,95,700,0.78125,1.0
91,134,95,100,100,80,600,0.6304347826086957,66,65,48,62,57,52,350,0.36220472440944884,2.0
61,72,57,55,55,65,365,0.3984375,56,61,65,48,45,38,313,0.17567567567567569,2.0
80,90,80,130,110,110,600,0.856,60,62,50,62,60,40,334,0.18181818181818182,1.0
75,100,66,60,66,115,482,0.918918918918919,60,50,50,60,70,50,340,0.28346456692913385,1.0
39,52,43,60,50,65,309,0.49107142857142855,70,83,50,37,50,60,350,0.3360655737704918,1.0
25,35,70,95,55,45,325,0.16783216783216784,100,123,75,57,75,80,510,0.6923076923076923,2.0
89,124,80,55,80,55,483,0.5714285714285714,38,30,41,30,41,60,240,0.2897196261682243,0.0
85,76,64,45,55,90,415,0.6739130434782609,36,50,50,65,60,44,305,0.16363636363636364,1.0
90,60,70,75,70,45,410,0.23880597014925373,110,80,90,95,90,65,530,0.5033557046979866,0.125
77,85,51,55,51,65,384,0.5163934426229508,44,50,91,24,86,10,305,0.1981981981981982,1.0
40,45,35,40,40,90,290,0.65,85,80,90,105,95,60,515,0.49074074074074076,1.0
70,100,115,30,65,30,410,0.24390243902439024,45,50,35,55,75,40,300,0.21367521367521367,1.0
55,70,45,70,50,60,350,0.45,44,38,33,61,43,70,289,0.5267857142857143,1.0
75,75,95,75,95,113,528,0.9015151515151515,108,112,118,68,72,47,525,0.2916666666666667,2.0
35,20,65,40,65,20,245,0.02459016393442623,60,90,55,90,80,110,485,0.8677685950413223,1.0
60,65,60,130,75,110,500,0.7719298245614035,30,56,35,25,35,72,253,0.48148148148148145,0.0
85,90,80,70,80,130,535,0.9262295081967213,55,55,85,65,85,35,380,0.2014388489208633,0.25
50,50,40,50,40,64,294,0.45588235294117646,55,45,45,25,25,15,210,0.048,1.0
62,77,62,50,42,65,358,0.4838709677419355,95,109,105,75,85,56,525,0.34513274336283184,2.0
120,100,85,30,85,45,465,0.22448979591836735,40,65,95,60,45,35,340,0.13986013986013987,0.5
40,30,35,50,70,55,280,0.28205128205128205,75,125,230,55,95,30,610,0.3448275862068966,0.0
62,48,54,63,60,68,355,0.5178571428571429,43,80,65,50,35,35,308,0.14193548387096774,1.0
60,130,80,60,60,70,460,0.5153846153846153,55,45,43,55,43,72,313,0.5853658536585366,0.125
90,100,70,110,150,80,600,0.6037735849056604,105,95,80,40,80,90,490,0.753968253968254,1.0
100,73,83,73,83,55,467,0.371900826446281,35,60,44,40,54,55,288,0.366412213740458,0.5
30,30,30,30,30,30,180,0.12612612612612611,60,100,89,55,69,112,485,0.9298245614035088,0.25
70,110,180,60,60,50,530,0.4117647058823529,20,15,20,10,55,80,200,0.2682926829268293,0.5
111,83,68,92,82,39,475,0.1774193548387097,60,80,50,40,40,30,300,0.15328467153284672,1.0
45,25,50,25,25,35,205,0.13076923076923078,79,85,60,55,60,71,410,0.60431654676259,1.0
85,110,76,65,82,56,474,0.3933333333333333,45,45,35,20,30,20,195,0.07246376811594203,0.5
40,40,55,40,70,55,300,0.40939597315436244,85,135,130,60,80,25,515,0.40540540540540543,2.0
30,56,35,25,35,72,253,0.48148148148148145,65,40,50,125,60,30,370,0.07258064516129033,1.0
45,95,50,40,50,75,355,0.54,76,104,71,104,71,108,534,0.912751677852349,0.25
70,145,88,140,70,112,625,0.8888888888888888,50,60,60,60,60,30,320,0.11290322580645161,0.25
45,35,45,62,53,35,275,0.11851851851851852,130,70,35,70,35,60,400,0.4017857142857143,2.0
30,45,55,70,55,85,340,0.5633802816901409,90,75,75,90,100,70,500,0.5462184873949579,0.5
50,64,50,45,50,41,300,0.22727272727272727,28,25,25,45,35,40,198,0.16083916083916083,1.0
65,90,120,85,70,60,490,0.43410852713178294,50,70,50,50,50,40,310,0.16296296296296298,1.0
50,92,108,92,108,35,485,0.2457627118644068,30,35,30,100,35,80,310,0.4765625,4.0
95,65,65,110,130,60,525,0.4016393442622951,65,83,57,95,85,105,490,0.8914728682170543,1.0
95,70,73,95,90,60,483,0.3983739837398374,76,147,90,60,70,97,540,0.8267716535433071,2.0
150,100,120,100,120,90,680,0.6666666666666666,65,90,40,45,80,75,395,0.625,1.0
64,78,52,78,52,81,405,0.6422764227642277,57,80,91,80,87,75,470,0.5737704918032787,2.0
70,75,60,105,60,105,475,0.88,45,60,45,25,45,55,275,0.29,1.0
100,120,120,150,100,90,680,0.7880794701986755,60,80,95,70,85,50,440,0.2231404958677686,0.25
85,110,76,65,82,56,474,0.3933333333333333,90,55,75,60,75,30,385,0.13970588235294118,0.0
60,100,115,70,85,90,520,0.7557251908396947,40,20,30,40,80,55,265,0.22764227642276422,1.0
69,55,45,55,55,15,294,0.11666666666666667,65,75,70,95,70,95,470,0.7272727272727273,0.5
135,85,40,40,85,5,390,0.6864406779661016,80,90,80,130,110,110,600,0.856,1.0
55,55,55,85,55,30,335,0.1320754716981132,65,76,84,54,96,105,480,0.9008264462809917,1.0
80,160,80,130,80,100,630,0.8455284552845529,100,150,90,180,160,90,770,0.7348484848484849,0.5
100,50,50,76,96,70,442,0.5,65,50,35,115,95,95,455,0.7333333333333333,1.0
45,60,30,80,50,65,330,0.4603174603174603,100,128,90,77,77,128,600,0.959349593495935,0.5
48,72,48,72,48,48,336,0.25984251968503935,30,35,30,100,35,80,310,0.4765625,2.0
50,35,55,25,25,15,205,0.021739130434782608,70,145,88,140,70,112,625,0.8888888888888888,0.25
35,64,85,74,55,32,345,0.19827586206896552,75,125,230,55,95,30,610,0.3448275862068966,2.0
45,60,40,70,50,45,310,0.2846715328467153,70,80,50,35,35,35,305,0.14,1.0
78,104,78,159,115,100,634,0.8444444444444444,63,63,47,41,41,74,329,0.56,1.0
65,90,122,58,75,84,494,0.71875,64,66,68,81,76,50,405,0.25190839694656486,2.0
40,60,40,40,40,30,250,0.0948905109489051,95,80,105,40,70,100,490,0.8046875,1.0
40,40,55,40,70,55,300,0.40939597315436244,40,45,40,65,40,65,295,0.5661764705882353,2.0
100,50,80,60,80,50,420,0.34375,30,35,30,100,35,80,310,0.4765625,0.5
55,70,40,60,40,40,305,0.26956521739130435,106,110,90,154,90,130,680,0.926829268292683,1.0
85,97,66,105,66,65,484,0.47107438016528924,90,70,80,70,95,70,475,0.5190839694656488,1.0
64,66,68,81,76,50,405,0.25190839694656486,38,35,40,27,25,35,200,0.08208955223880597,1.0
68,65,65,125,115,80,518,0.6461538461538462,60,85,60,50,50,125,430,0.9090909090909091,1.0
65,125,100,60,70,70,490,0.6099290780141844,100,100,125,110,50,50,535,0.384,1.0
75,55,70,55,95,110,460,0.8444444444444444,55,84,105,114,75,52,485,0.2890625,2.0
72,85,70,65,70,58,420,0.41304347826086957,71,82,64,64,59,112,452,0.9327731092436975,1.0
75,75,60,83,60,60,413,0.39344262295081966,75,125,70,125,70,115,580,0.9037037037037037,1.0
35,65,35,65,35,65,300,0.46621621621621623,80,135,85,70,95,150,615,0.9844961240310077,2.0
50,65,45,85,65,95,405,0.7238095238095238,40,80,100,30,30,20,300,0.11851851851851852,4.0
70,60,75,110,75,90,480,0.7165354330708661,70,110,80,55,80,105,500,0.8794326241134752,0.25
50,75,45,40,45,60,315,0.4380165289256198,50,53,62,58,63,44,330,0.13709677419354838,1.0
44,48,65,50,64,43,314,0.1623931623931624,40,55,99,40,79,47,360,0.26262626262626265,1.0
62,48,54,63,60,68,355,0.5178571428571429,75,75,75,125,95,40,485,0.15671641791044777,0.5
80,120,80,120,80,100,580,0.8478260869565217,105,30,105,140,105,55,540,0.3524590163934426,0.5
50,65,107,105,107,86,520,0.7313432835820896,91,72,90,129,90,108,580,0.8925619834710744,4.0
61,78,95,56,58,57,405,0.40336134453781514,60,60,60,35,35,30,280,0.11194029850746269,1.0
35,60,44,40,54,55,288,0.366412213740458,108,100,121,81,95,95,600,0.7476635514018691,0.5
45,65,34,40,34,45,263,0.2589928057553957,60,50,50,60,70,50,340,0.28346456692913385,1.0
75,80,60,65,90,102,472,0.8625954198473282,55,55,85,65,85,35,380,0.2014388489208633,0.5
80,120,130,55,65,45,495,0.37037037037037035,55,63,90,50,80,42,380,0.21138211382113822,0.5
50,53,48,53,48,64,316,0.358974358974359,90,65,65,40,40,15,315,0.19672131147540983,0.5
75,75,75,125,95,40,485,0.15671641791044777,50,65,45,85,65,95,405,0.7238095238095238,1.0
65,150,60,115,60,115,565,0.935251798561151,60,50,70,80,80,140,480,0.8449612403100775,1.0
40,30,50,55,55,100,330,0.584070796460177,66,41,77,61,87,23,355,0.12096774193548387,0.5
55,81,60,50,70,97,413,0.7214285714285714,55,47,52,40,40,41,275,0.16806722689075632,1.0
95,145,130,120,90,120,700,0.9398496240601504,50,105,125,55,95,50,480,0.375886524822695,0.0
65,65,45,75,45,95,390,0.72,60,40,50,75,85,95,405,0.6044776119402985,0.5
40,70,40,35,40,60,285,0.392,65,60,70,85,75,40,395,0.1796875,2.0
30,105,90,25,25,50,325,0.2773722627737226,54,45,47,75,98,52,371,0.39669421487603307,1.0
85,56,77,50,77,78,423,0.53125,95,124,78,69,71,58,495,0.37398373983739835,1.0
54,63,52,83,56,97,405,0.7697841726618705,100,100,100,100,100,100,600,0.8758169934640523,1.0
85,80,70,135,75,90,535,0.7006802721088435,72,60,30,20,30,25,237,0.11570247933884298,1.0
75,90,90,140,90,115,600,0.9481481481481482,84,71,43,71,43,48,360,0.25874125874125875,1.0
30,35,30,100,35,80,310,0.4765625,105,140,55,30,55,95,480,0.8195488721804511,1.0
50,75,70,35,70,48,348,0.29357798165137616,73,95,62,85,65,85,465,0.6666666666666666,2.0
55,45,43,55,43,72,313,0.5853658536585366,55,55,45,63,45,45,308,0.25,1.0
65,130,60,75,60,75,465,0.689922480620155,40,65,95,60,45,35,340,0.13986013986013987,1.0
60,59,85,79,105,36,424,0.16666666666666666,45,50,43,40,38,62,278,0.40441176470588236,0.25
60,100,115,70,85,90,520,0.7557251908396947,55,75,50,40,40,80,340,0.6302521008403361,1.0
35,55,40,50,50,90,320,0.6838235294117647,109,66,84,81,99,32,471,0.2013888888888889,0.0
40,30,35,50,70,55,280,0.28205128205128205,110,65,105,55,95,80,510,0.6258503401360545,0.5
88,107,122,74,75,64,530,0.4596774193548387,70,110,80,55,80,105,500,0.8794326241134752,0.0625
106,90,130,90,154,110,680,0.8699186991869918,100,150,120,120,100,90,680,0.6493506493506493,0.5
64,66,68,81,76,50,405,0.25190839694656486,170,90,45,90,45,60,500,0.427536231884058,0.5
76,25,45,67,55,24,292,0.0390625,100,90,130,45,65,55,485,0.4253731343283582,1.0
100,73,83,73,83,55,467,0.371900826446281,70,130,100,55,80,65,500,0.608,0.0
130,85,80,85,95,60,535,0.43884892086330934,20,10,55,15,20,80,200,0.17985611510791366,0.25
70,80,70,80,70,110,480,0.6594202898550725,42,52,67,39,56,50,306,0.2868217054263566,0.5
55,40,85,80,105,40,405,0.23622047244094488,82,121,119,69,59,71,521,0.5394736842105263,1.0
50,48,43,46,41,60,288,0.47297297297297297,46,87,60,30,40,57,320,0.37777777777777777,0.5
60,75,100,55,80,50,420,0.3088235294117647,55,45,45,25,25,15,210,0.048,1.0
45,55,45,65,45,75,330,0.5692307692307692,100,120,100,150,120,90,680,0.728,1.0
49,55,42,42,37,85,310,0.6068376068376068,35,55,40,50,50,90,320,0.6838235294117647,1.0
62,44,50,44,50,55,305,0.3629032258064516,75,100,95,40,70,110,490,0.8717948717948718,1.0
44,38,39,61,79,42,303,0.2251655629139073,70,40,50,55,50,25,290,0.061068702290076333,1.0
100,5,5,15,65,30,220,0.07692307692307693,75,100,66,60,66,115,482,0.918918918918919,1.0
71,82,64,64,59,112,452,0.9327731092436975,78,52,60,63,65,23,341,0.06015037593984962,1.0
65,136,94,54,96,135,580,0.9612403100775194,50,85,55,65,65,90,410,0.7478260869565218,1.0
75,100,95,40,70,110,490,0.8717948717948718,70,85,70,60,70,50,405,0.28378378378378377,1.0
68,72,78,38,42,32,330,0.23809523809523808,170,90,45,90,45,60,500,0.427536231884058,1.0
62,77,62,50,42,65,358,0.4838709677419355,70,75,80,135,80,135,575,0.917910447761194,0.5
60,70,50,100,50,65,395,0.5217391304347826,91,90,129,90,72,108,580,0.9140625,0.25
105,140,95,55,65,45,505,0.3,100,120,100,150,120,90,680,0.728,1.0
45,100,45,45,45,10,290,0.2949640287769784,65,90,40,45,80,75,395,0.625,1.0
20,15,20,10,55,80,200,0.2682926829268293,44,58,44,58,44,61,309,0.41964285714285715,2.0
70,95,85,55,65,70,440,0.5,65,40,70,80,140,70,465,0.5954198473282443,2.0
90,60,70,75,70,45,410,0.23880597014925373,110,130,80,70,60,80,530,0.5862068965517241,2.0
70,60,75,110,75,90,480,0.7165354330708661,75,75,55,105,85,30,425,0.1619718309859155,0.5
70,77,60,97,60,108,472,0.8394160583941606,100,110,90,85,90,60,535,0.47794117647058826,0.0
45,49,49,65,65,45,318,0.2781954887218045,130,70,35,70,35,60,400,0.4017857142857143,2.0
75,98,63,98,63,101,498,0.889763779527559,60,85,40,30,45,68,328,0.6422018348623854,1.0
45,80,100,35,37,28,325,0.3125,70,84,70,65,70,51,410,0.2949640287769784,2.0
45,90,20,65,20,65,305,0.5116279069767442,65,85,70,75,70,40,405,0.203125,1.0
60,85,69,60,69,77,420,0.518796992481203,80,100,123,122,120,80,625,0.56,1.0
40,45,65,100,120,90,460,0.5588235294117647,108,112,118,68,72,47,525,0.2916666666666667,2.0
75,105,75,105,75,45,480,0.3274336283185841,65,63,45,45,45,45,308,0.2595419847328244,2.0
45,90,20,65,20,65,305,0.5116279069767442,60,60,40,65,45,35,305,0.15833333333333333,4.0
75,75,130,75,130,95,580,0.7479674796747967,75,90,90,140,90,115,600,0.9481481481481482,0.0
78,81,71,74,69,126,499,0.9090909090909091,40,60,30,31,31,70,262,0.4492753623188406,1.0
60,40,60,95,60,55,370,0.4222222222222222,45,40,60,40,75,50,310,0.2926829268292683,0.0
85,105,100,79,83,78,530,0.5869565217391305,80,100,123,122,120,80,625,0.56,0.5
123,100,62,97,81,68,531,0.4806201550387597,60,40,60,40,60,35,295,0.18055555555555555,0.5
100,90,130,45,65,55,485,0.4253731343283582,62,48,54,63,60,68,355,0.5178571428571429,1.0
75,75,130,75,130,95,580,0.7479674796747967,101,72,72,99,89,29,462,0.1937984496124031,1.0
25,35,70,95,55,45,325,0.16783216783216784,100,110,90,85,90,60,535,0.47794117647058826,0.0
61,72,57,55,55,65,365,0.3984375,68,72,78,38,42,32,330,0.23809523809523808,0.5
61,84,65,70,70,70,420,0.5,65,110,130,60,65,95,525,0.8278145695364238,1.0
60,40,80,60,45,40,325,0.23529411764705882,54,63,52,83,56,97,405,0.7697841726618705,2.0
109,66,84,81,99,32,471,0.2013888888888889,63,63,47,41,41,74,329,0.56,2.0
75,75,130,75,130,95,580,0.7479674796747967,123,100,62,97,81,68,531,0.4806201550387597,1.0
44,38,39,61,79,42,303,0.2251655629139073,35,46,34,35,45,20,215,0.072,1.0
62,55,52,109,94,109,481,0.7833333333333333,75,98,63,98,63,101,498,0.849624060150376,2.0
100,90,130,45,65,55,485,0.4253731343283582,25,35,70,95,55,45,325,0.16783216783216784,0.5
79,85,60,55,60,71,410,0.60431654676259,50,92,108,92,108,35,485,0.2457627118644068,0.0
45,49,65,49,65,45,318,0.275,125,130,90,130,90,95,660,0.7734375,0.5
90,95,95,70,90,70,510,0.5230769230769231,50,60,45,100,80,65,400,0.45689655172413796,0.25
74,48,76,83,81,104,466,0.7322834645669292,65,90,115,45,115,58,488,0.5041322314049587,0.0
85,105,100,79,83,78,530,0.5869565217391305,75,70,90,70,105,80,490,0.656,0.5
35,85,45,35,35,75,310,0.6492537313432836,68,90,65,50,55,82,410,0.6165413533834586,1.0
71,82,64,64,59,112,452,0.9327731092436975,99,68,83,72,87,51,460,0.417910447761194,1.0
66,117,70,40,50,67,410,0.4573643410852713,55,55,85,65,85,35,380,0.2014388489208633,1.0
86,76,86,116,56,95,515,0.7982456140350878,50,100,150,100,150,50,600,0.37142857142857144,0.25
35,45,160,30,45,70,385,0.48148148148148145,65,75,70,95,70,95,470,0.7272727272727273,0.0
45,85,50,55,50,65,350,0.5076923076923077,70,45,48,60,65,35,323,0.15748031496062992,0.5
78,130,111,130,85,100,634,0.8561151079136691,55,40,50,65,85,40,335,0.3181818181818182,0.5
65,130,60,75,60,75,465,0.689922480620155,90,100,70,110,150,80,600,0.6037735849056604,1.0
50,180,20,180,20,150,600,0.9029850746268657,50,70,100,40,40,30,330,0.2222222222222222,0.5
66,41,77,61,87,23,355,0.12096774193548387,65,40,50,125,60,30,370,0.07258064516129033,1.0
100,77,77,128,128,90,600,0.6901408450704225,45,50,45,115,55,95,405,0.6936936936936937,0.0
90,75,85,115,90,55,510,0.3445378151260504,86,92,88,68,75,73,482,0.6835443037974683,1.0
40,55,70,45,60,30,300,0.10619469026548672,86,92,88,68,75,73,482,0.6835443037974683,1.0
65,45,55,45,70,45,325,0.24369747899159663,95,135,80,110,80,100,600,0.8248175182481752,0.5
85,60,65,135,105,100,550,0.7518248175182481,125,58,58,76,76,67,460,0.515625,0.5
80,82,83,100,100,80,525,0.6742424242424242,40,27,60,37,50,66,280,0.36220472440944884,2.0
106,90,130,90,154,110,680,0.8699186991869918,58,70,45,40,45,42,300,0.25925925925925924,2.0
106,110,90,154,90,130,680,0.926829268292683,35,55,35,30,30,35,220,0.23684210526315788,0.0
65,60,70,85,75,40,395,0.1796875,30,42,118,42,88,30,350,0.112,0.25
55,50,40,40,40,75,300,0.5945945945945946,55,45,45,25,25,15,210,0.048,1.0
59,66,70,44,55,41,335,0.25190839694656486,50,105,79,35,110,76,455,0.6214285714285714,1.0
62,48,54,63,60,68,355,0.5178571428571429,90,60,70,75,70,45,410,0.23880597014925373,1.0
72,95,67,103,71,122,530,0.9606299212598425,50,65,107,105,107,86,520,0.7758620689655172,0.5
75,89,85,55,65,36,405,0.29545454545454547,70,90,45,15,45,50,315,0.3629032258064516,0.5
40,30,50,55,55,100,330,0.584070796460177,63,60,55,50,50,71,349,0.5289256198347108,2.0
50,60,60,60,60,30,320,0.11290322580645161,75,95,122,58,75,69,494,0.5725806451612904,0.5
50,70,50,50,50,70,340,0.5645161290322581,100,77,77,128,128,90,600,0.6901408450704225,1.0
45,50,35,55,75,40,300,0.21367521367521367,90,100,90,125,85,90,580,0.7352941176470589,1.0
38,30,85,55,65,30,303,0.21428571428571427,103,60,126,80,126,50,545,0.36363636363636365,0.0
70,110,70,115,70,90,525,0.75,63,63,47,41,41,74,329,0.56,1.0
85,110,76,65,82,56,474,0.3933333333333333,60,60,60,60,60,60,360,0.38095238095238093,0.0
75,38,38,56,56,67,330,0.5263157894736842,40,45,35,30,40,55,245,0.3793103448275862,2.0
60,105,60,120,60,105,510,0.8849557522123894,75,69,72,114,100,104,534,0.8253968253968254,2.0
70,20,50,20,50,40,250,0.1557377049180328,48,61,40,61,40,50,300,0.2543859649122807,1.0
89,125,90,115,80,101,600,0.8725490196078431,41,50,37,50,37,66,281,0.5175438596491229,1.0
45,30,50,55,65,45,290,0.208,80,100,200,50,100,50,580,0.3472222222222222,1.0
60,45,50,90,80,70,395,0.625,75,100,95,40,70,110,490,0.8717948717948718,1.0
80,110,60,150,130,70,600,0.5042016806722689,60,60,60,60,60,60,360,0.38095238095238093,0.0
59,45,40,35,40,31,250,0.14285714285714285,78,81,71,74,69,126,499,0.9090909090909091,1.0
62,48,54,63,60,68,355,0.5178571428571429,85,110,90,45,90,80,500,0.6206896551724138,1.0
73,95,62,85,65,85,465,0.6666666666666666,65,40,50,125,60,30,370,0.07258064516129033,1.0
75,80,55,25,35,35,305,0.18666666666666668,90,93,55,70,55,55,418,0.3819444444444444,1.0
35,45,160,30,45,70,385,0.48148148148148145,80,100,200,50,100,50,580,0.3472222222222222,2.0
70,90,45,15,45,50,315,0.3629032258064516,91,134,95,100,100,80,600,0.6304347826086957,0.5
40,45,40,62,60,60,307,0.33884297520661155,70,80,50,35,35,35,305,0.14,1.0
70,40,50,55,50,25,290,0.061068702290076333,55,75,60,75,60,103,428,0.7982456140350878,2.0
70,65,60,90,75,90,450,0.6571428571428571,1,90,45,30,30,40,236,0.33064516129032256,0.25
95,110,95,40,95,55,490,0.40336134453781514,20,10,55,15,20,80,200,0.17985611510791366,1.0
55,85,55,50,55,60,360,0.4233576642335766,75,105,75,105,75,45,480,0.3274336283185841,0.5
110,65,105,55,95,80,510,0.6258503401360545,70,80,70,80,70,110,480,0.6594202898550725,2.0
73,100,60,100,60,65,458,0.42657342657342656,50,95,95,35,110,70,455,0.5179856115107914,1.0
20,40,15,35,35,60,205,0.34285714285714286,40,40,35,50,100,70,335,0.5031847133757962,2.0
70,110,80,55,80,105,500,0.8794326241134752,50,65,107,105,107,86,520,0.7758620689655172,0.5
85,105,100,79,83,78,530,0.5869565217391305,55,55,85,65,85,35,380,0.2014388489208633,1.0
50,35,55,25,25,15,205,0.05263157894736842,70,100,115,30,65,30,410,0.24390243902439024,1.0
56,61,65,48,45,38,313,0.17567567567567569,40,65,40,80,40,65,330,0.5038167938931297,1.0
130,65,60,110,95,65,525,0.5227272727272727,40,55,80,35,60,30,300,0.15037593984962405,1.0
70,45,48,60,65,35,323,0.15748031496062992,76,65,45,92,42,91,411,0.7449664429530202,1.0
75,125,100,70,80,45,495,0.33035714285714285,76,65,45,92,42,91,411,0.7449664429530202,1.0
105,150,90,150,90,95,680,0.8285714285714286,65,75,105,35,65,85,430,0.6940298507462687,1.0
55,112,45,74,45,70,401,0.559322033898305,35,85,45,35,35,75,310,0.6492537313432836,2.0
95,125,79,60,100,81,540,0.6165413533834586,70,110,70,115,70,90,525,0.75,1.0
108,130,95,80,85,102,600,0.7637795275590551,40,30,32,50,52,65,269,0.3671875,0.5
67,125,40,30,30,58,350,0.3431372549019608,35,65,35,65,35,65,300,0.46621621621621623,1.0
73,100,60,100,60,65,458,0.42657342657342656,55,84,105,114,75,52,485,0.2890625,1.0
60,150,50,150,50,60,520,0.5,60,45,70,45,90,95,405,0.7304964539007093,0.5
65,50,35,115,95,95,455,0.7333333333333333,80,135,130,95,90,70,600,0.5181818181818182,0.125
100,150,110,95,110,70,635,0.5923076923076923,90,90,85,125,90,100,580,0.768595041322314,0.0
85,60,65,135,105,100,550,0.7518248175182481,59,110,150,45,49,35,448,0.3333333333333333,0.5
62,50,58,73,54,72,369,0.4435483870967742,54,78,103,53,45,22,355,0.23255813953488372,0.125
65,90,115,45,115,58,488,0.5041322314049587,70,135,105,60,105,20,495,0.5806451612903226,1.0
75,55,70,55,95,110,460,0.8444444444444444,45,50,35,55,75,40,300,0.21367521367521367,0.5
70,120,40,95,40,95,460,0.8106060606060606,100,180,160,150,90,90,770,0.7520661157024794,4.0
60,79,105,59,85,36,424,0.17054263565891473,70,84,70,65,70,51,410,0.2949640287769784,2.0
59,74,50,35,50,35,303,0.3125,58,64,58,80,65,80,405,0.5423728813559322,2.0
91,90,72,90,129,108,580,0.896,90,93,55,70,55,55,418,0.3819444444444444,0.5
125,120,90,170,100,95,700,0.78125,100,100,100,100,100,100,600,0.8758169934640523,0.25
20,40,90,30,90,25,295,0.11363636363636363,60,40,60,95,60,55,370,0.4222222222222222,2.0
60,85,69,60,69,77,420,0.518796992481203,70,150,140,65,100,75,600,0.55,0.5
40,65,40,80,40,65,330,0.5038167938931297,100,150,140,100,90,90,670,0.7969924812030075,1.0
75,123,67,95,85,95,540,0.7642276422764228,61,72,57,55,55,65,365,0.3984375,1.0
55,95,115,45,45,35,390,0.2116788321167883,50,65,45,85,65,95,405,0.7238095238095238,0.5
86,92,88,68,75,73,482,0.6835443037974683,45,65,34,40,34,45,263,0.2589928057553957,1.0
55,85,122,58,75,99,494,0.8099173553719008,80,105,65,60,75,130,515,0.9645390070921985,1.0
90,130,80,65,85,55,505,0.4396551724137931,90,60,70,75,70,45,410,0.23880597014925373,2.0
99,68,83,72,87,51,460,0.417910447761194,65,150,60,115,60,115,565,0.935251798561151,1.0
40,35,30,20,20,50,195,0.23423423423423423,50,85,85,55,55,50,380,0.3902439024390244,0.0
30,42,118,42,88,30,350,0.112,60,50,50,60,70,50,340,0.28346456692913385,0.5
60,45,50,90,80,70,395,0.625,70,135,105,60,105,20,495,0.5806451612903226,0.5
60,80,110,50,80,45,425,0.2833333333333333,70,135,105,60,105,20,495,0.5806451612903226,1.0
90,132,105,132,105,30,594,0.4246575342465753,80,100,70,60,70,95,475,0.7416666666666667,1.0
35,40,100,90,55,35,355,0.1796875,20,25,45,70,90,60,310,0.30833333333333335,1.0
90,55,75,60,75,30,385,0.13970588235294118,50,80,95,10,45,10,290,0.232,0.5
55,20,35,20,45,75,250,0.37681159420289856,75,69,72,114,100,104,534,0.8253968253968254,1.0
75,95,67,125,95,83,540,0.7117117117117117,80,145,150,105,110,110,700,0.8692307692307693,2.0
65,47,55,73,75,85,400,0.65,40,55,30,30,30,85,270,0.688,0.5
60,48,45,43,90,42,328,0.21897810218978103,70,90,90,135,90,125,600,0.9401709401709402,0.0
40,45,35,40,40,90,290,0.65,109,66,84,81,99,32,471,0.2013888888888889,1.0
120,70,120,75,130,85,600,0.6694915254237288,114,85,70,85,80,30,464,0.2066115702479339,2.0
60,40,60,40,60,35,295,0.18055555555555555,72,58,80,103,80,97,490,0.7171052631578947,0.5
40,35,30,20,20,50,195,0.23423423423423423,65,90,120,85,70,60,490,0.43410852713178294,0.25
95,145,130,120,90,120,700,0.9398496240601504,65,150,40,15,80,145,495,0.9663865546218487,2.0
65,150,40,15,80,145,495,0.9663865546218487,71,120,95,120,95,99,600,0.8203125,0.0
76,104,71,104,71,108,534,0.912751677852349,75,100,95,40,70,110,490,0.8717948717948718,2.0
67,57,55,77,55,114,425,0.8879310344827587,50,105,79,35,110,76,455,0.6214285714285714,2.0
80,135,85,70,95,150,615,0.9844961240310077,50,85,125,85,115,20,480,0.4306569343065693,1.0
85,56,77,50,77,78,423,0.53125,60,100,89,55,69,112,485,0.9298245614035088,1.0
60,85,60,50,50,125,430,0.9090909090909091,126,131,95,131,98,99,680,0.8102189781021898,1.0
65,130,60,75,60,75,465,0.689922480620155,130,85,80,85,95,60,535,0.43884892086330934,1.0
50,40,85,40,65,25,305,0.08870967741935484,65,150,40,15,80,145,495,0.9663865546218487,0.5
75,75,130,75,130,95,580,0.7479674796747967,55,95,115,45,45,35,390,0.2116788321167883,2.0
50,50,95,40,50,35,320,0.20279720279720279,81,102,77,85,75,85,505,0.5642857142857143,2.0
76,147,90,60,70,97,540,0.8267716535433071,80,80,80,55,55,90,440,0.6417910447761194,1.0
55,50,65,175,95,150,590,0.7818181818181819,61,84,65,70,70,70,420,0.5,1.0
75,95,60,65,60,115,470,0.8778625954198473,110,160,110,80,110,100,670,0.8591549295774648,1.0
60,90,70,60,120,40,440,0.27419354838709675,40,30,35,45,40,55,245,0.31496062992125984,1.0
41,50,37,50,37,66,281,0.5175438596491229,70,60,62,80,82,60,414,0.4375,1.0
35,70,55,45,55,25,285,0.09420289855072464,45,20,50,60,120,50,345,0.24074074074074073,0.5
80,135,85,70,95,150,615,0.9844961240310077,70,60,75,110,75,90,480,0.7165354330708661,2.0
43,70,48,50,60,38,309,0.2391304347826087,86,68,72,109,66,106,507,0.8099173553719008,0.0
70,105,105,50,40,20,390,0.33587786259541985,65,100,70,80,80,105,500,0.8666666666666667,2.0
65,130,60,95,110,65,525,0.5303030303030303,60,40,60,40,60,35,295,0.18055555555555555,2.0
40,40,35,50,100,70,335,0.5031847133757962,70,80,50,35,35,35,305,0.14,1.0
60,30,30,36,56,50,262,0.32432432432432434,75,90,50,110,80,95,500,0.7985611510791367,1.0
60,50,100,85,70,65,430,0.47580645161290325,78,84,78,109,85,100,534,0.8620689655172413,2.0
50,47,50,57,50,65,319,0.463768115942029,55,55,85,65,85,35,380,0.2014388489208633,2.0
59,59,58,90,70,73,409,0.5826086956521739,55,130,115,50,50,75,475,0.5982142857142857,0.5
65,50,70,95,80,65,425,0.4262295081967213,75,100,66,60,66,115,482,0.918918918918919,1.0
80,75,150,75,150,50,580,0.30973451327433627,69,69,76,69,86,91,460,0.6554621848739496,0.5
45,55,39,35,39,42,255,0.18518518518518517,125,120,90,170,100,95,700,0.78125,1.0
55,70,55,40,55,85,360,0.7073170731707317,100,50,50,76,96,70,442,0.5,1.0
105,140,95,55,65,45,505,0.3,70,90,90,135,90,125,600,0.9401709401709402,2.0
40,35,30,120,70,105,400,0.6692307692307692,49,49,56,49,61,66,330,0.5190839694656488,1.0
72,95,67,103,71,122,530,0.9606299212598425,55,81,60,50,70,97,413,0.7214285714285714,1.0
40,45,35,65,55,70,310,0.4482758620689655,95,117,80,65,70,92,519,0.8409090909090909,2.0
45,30,40,105,50,20,290,0.031007751937984496,60,70,50,100,50,65,395,0.5217391304347826,1.0
105,105,75,65,100,50,500,0.37593984962406013,50,50,62,40,62,65,329,0.4188034188034188,0.5
106,150,70,194,120,140,780,0.952,69,69,76,69,86,91,460,0.6554621848739496,1.0
1,90,45,30,30,40,236,0.33064516129032256,38,41,40,50,65,65,299,0.4108527131782946,0.5
72,60,30,20,30,25,237,0.11570247933884298,60,40,80,60,45,40,325,0.23529411764705882,0.5
61,84,65,70,70,70,420,0.5,67,89,116,79,116,33,500,0.2624113475177305,0.5
75,125,70,125,70,115,580,0.9037037037037037,85,50,95,120,115,80,545,0.5793650793650794,1.0
75,125,70,125,70,115,580,0.9037037037037037,70,43,53,43,53,40,302,0.19090909090909092,2.0
45,90,20,65,20,65,305,0.5116279069767442,45,60,30,80,50,65,330,0.4603174603174603,1.0
85,110,76,65,82,56,474,0.3933333333333333,50,50,77,95,77,91,440,0.5916666666666667,2.0
80,70,65,80,120,100,515,0.8034188034188035,91,129,90,72,90,108,580,0.8536585365853658,1.0
62,48,66,59,57,49,341,0.33884297520661155,45,90,20,65,20,65,305,0.5116279069767442,2.0
55,40,85,80,105,40,405,0.23622047244094488,75,75,75,125,95,40,485,0.15671641791044777,1.0
50,70,160,70,160,90,600,0.7417218543046358,65,90,115,45,115,58,488,0.5041322314049587,0.0
60,70,105,70,120,75,500,0.5983606557377049,80,100,70,60,70,95,475,0.7416666666666667,0.5
100,164,150,95,120,71,700,0.5645161290322581,75,95,60,65,60,115,470,0.8778625954198473,1.0
45,45,55,45,55,63,308,0.4594594594594595,60,70,105,70,120,75,500,0.5983606557377049,2.0
50,85,40,85,40,35,335,0.1746031746031746,85,105,55,85,50,115,495,0.9032258064516129,2.0
60,67,85,77,75,116,480,0.8888888888888888,40,30,30,55,30,85,270,0.4666666666666667,1.0
70,55,65,95,85,70,440,0.5307692307692308,30,30,30,30,30,30,180,0.12612612612612611,1.0
36,50,50,65,60,44,305,0.16363636363636364,30,56,35,25,35,72,253,0.48148148148148145,1.0
75,80,95,90,100,50,490,0.2158273381294964,80,100,80,80,80,100,520,0.9051724137931034,1.0
45,55,39,35,39,42,255,0.18518518518518517,64,88,50,88,50,106,446,0.9111111111111111,1.0
55,66,44,44,56,85,350,0.6888888888888889,80,50,100,100,200,50,580,0.2357142857142857,1.0
35,55,40,45,40,60,275,0.35714285714285715,60,85,49,60,49,60,363,0.4444444444444444,0.5
55,40,85,80,105,40,405,0.23622047244094488,50,53,48,53,48,64,316,0.358974358974359,1.0
55,112,45,74,45,70,401,0.559322033898305,86,76,86,116,56,95,515,0.7982456140350878,8.0
64,88,50,88,50,106,446,0.9111111111111111,75,110,110,110,105,80,590,0.656934306569343,0.5
100,150,110,95,110,70,635,0.5923076923076923,30,40,55,40,55,60,280,0.3237410071942446,1.0
50,50,77,95,77,91,440,0.5916666666666667,75,85,200,55,65,30,510,0.16778523489932887,0.0
165,75,80,40,45,65,470,0.5151515151515151,40,50,90,30,55,65,330,0.44680851063829785,1.0
60,30,30,36,56,50,262,0.32432432432432434,60,85,42,85,42,91,405,0.8227848101265823,1.0
55,68,64,45,55,31,318,0.11666666666666667,80,105,105,105,105,80,580,0.5939849624060151,1.0
67,82,62,46,48,43,348,0.22033898305084745,80,130,100,160,120,110,700,0.8981481481481481,0.5
65,150,40,15,80,145,495,0.9663865546218487,115,115,85,90,75,100,580,0.8134328358208955,0.5
65,73,55,47,75,85,400,0.6846846846846847,125,58,58,76,76,67,460,0.515625,1.0
45,30,35,20,20,45,195,0.14782608695652175,90,130,80,65,85,55,505,0.4396551724137931,0.5
60,50,40,85,75,95,405,0.7540983606557377,100,100,100,100,100,100,600,0.8758169934640523,1.0
65,95,100,60,50,50,420,0.34959349593495936,85,110,90,45,90,80,500,0.6206896551724138,1.0
120,70,120,75,130,85,600,0.6694915254237288,55,70,40,60,40,40,305,0.26956521739130435,1.0
70,105,105,50,40,20,390,0.33587786259541985,58,64,58,80,65,80,405,0.5423728813559322,2.0
60,25,35,70,80,60,330,0.3076923076923077,39,52,43,60,50,65,309,0.49107142857142855,1.0
91,129,90,72,90,108,580,0.8536585365853658,85,100,122,58,75,54,494,0.3939393939393939,0.0
59,45,40,35,40,31,250,0.14285714285714285,100,164,150,95,120,71,700,0.5645161290322581,0.5
41,50,37,50,37,66,281,0.5175438596491229,68,65,65,125,115,80,518,0.6461538461538462,1.0
65,95,75,55,55,85,430,0.6933333333333334,55,66,44,44,56,85,350,0.6888888888888889,1.0
75,98,63,98,63,101,498,0.849624060150376,75,110,110,110,105,80,590,0.656934306569343,0.5
85,110,76,65,82,56,474,0.3933333333333333,60,55,145,75,150,40,525,0.2,1.0
40,30,35,50,70,55,280,0.28205128205128205,62,50,58,73,54,72,369,0.4435483870967742,0.5
80,120,70,110,70,80,530,0.6422764227642277,50,35,55,25,25,15,205,0.021739130434782608,1.0
50,45,45,35,35,50,260,0.23529411764705882,120,100,85,30,85,45,465,0.22448979591836735,1.0
40,30,30,55,30,85,270,0.4666666666666667,30,45,135,45,90,30,375,0.09285714285714286,1.0
45,65,34,40,34,45,263,0.2589928057553957,50,65,107,105,107,86,520,0.7313432835820896,0.25
45,35,45,62,53,35,275,0.11851851851851852,78,84,78,109,85,100,534,0.8620689655172413,0.5
70,55,65,95,85,70,440,0.5307692307692308,85,105,85,40,50,40,405,0.211864406779661,0.5
79,85,60,55,60,71,410,0.60431654676259,45,100,135,65,135,45,525,0.29411764705882354,0.0
115,115,85,90,75,100,580,0.8134328358208955,71,73,88,120,89,59,500,0.43537414965986393,0.5
50,65,107,105,107,86,520,0.7758620689655172,85,105,100,79,83,78,530,0.5869565217391305,1.0
50,65,107,105,107,86,520,0.7758620689655172,45,45,55,45,55,63,308,0.4594594594594595,0.25
10,55,25,35,45,95,265,0.5396825396825397,55,55,45,63,45,45,308,0.25,1.0
30,45,55,70,55,85,340,0.5633802816901409,65,65,60,110,95,130,525,0.9253731343283582,1.0
85,70,80,97,80,123,535,0.9304347826086956,85,105,55,85,50,115,495,0.9032258064516129,1.0
110,85,95,80,95,50,515,0.2713178294573643,100,100,100,100,100,100,600,0.8602941176470589,1.0
75,80,85,110,90,50,490,0.3548387096774194,50,53,62,58,63,44,330,0.13709677419354838,2.0
110,160,110,80,110,100,670,0.8591549295774648,70,140,70,110,65,105,560,0.95,1.0
79,85,60,55,60,71,410,0.60431654676259,105,125,100,60,100,100,590,0.8359375,1.0
110,85,95,80,95,50,515,0.2713178294573643,90,92,87,75,85,76,505,0.5409836065573771,1.0
100,134,110,95,100,61,600,0.4057971014492754,40,29,45,29,45,36,224,0.14634146341463414,2.0
44,38,39,61,79,42,303,0.2251655629139073,40,29,45,29,45,36,224,0.14634146341463414,1.0
75,90,140,60,60,40,465,0.3008130081300813,64,115,65,83,63,65,455,0.5323741007194245,0.5
70,60,75,110,75,90,480,0.7165354330708661,76,25,45,67,55,24,292,0.0390625,1.0
70,145,88,140,70,112,625,0.8888888888888888,80,82,78,95,80,85,500,0.6869565217391305,0.5
60,85,42,85,42,91,405,0.8227848101265823,130,65,60,110,95,65,525,0.5227272727272727,1.0
75,55,70,55,95,110,460,0.8444444444444444,72,105,115,54,86,68,500,0.5149253731343284,2.0
64,51,23,51,23,28,240,0.11363636363636363,70,85,140,85,70,20,470,0.272,1.0
50,50,150,50,150,50,500,0.2571428571428571,75,75,55,105,85,30,425,0.1619718309859155,1.0
70,110,80,55,80,105,500,0.8794326241134752,60,80,50,40,40,30,300,0.15328467153284672,0.5
90,130,80,65,85,55,505,0.4396551724137931,50,75,70,35,70,48,348,0.29357798165137616,2.0
20,10,55,15,20,80,200,0.17985611510791366,55,55,85,65,85,35,380,0.2014388489208633,1.0
75,125,70,125,70,115,580,0.9037037037037037,78,70,61,50,61,100,420,0.8145161290322581,1.0
123,77,72,99,92,58,521,0.4621212121212121,50,160,110,160,110,110,700,0.8854961832061069,1.0
95,75,80,100,110,30,490,0.24242424242424243,43,30,55,40,65,97,330,0.6030534351145038,0.5
60,100,85,80,85,100,510,0.7007874015748031,50,50,40,30,30,50,250,0.2781954887218045,4.0
85,80,90,105,95,60,515,0.49074074074074076,150,80,44,90,54,80,498,0.625,0.0
80,80,50,40,50,25,325,0.176056338028169,72,85,70,65,70,58,420,0.41304347826086957,1.0
75,80,60,65,90,102,472,0.8625954198473282,80,100,200,50,100,50,580,0.3472222222222222,0.5
103,60,126,80,126,50,545,0.36363636363636365,60,115,105,65,70,80,495,0.7181818181818181,0.5
95,110,95,40,95,55,490,0.40336134453781514,80,115,80,65,55,93,488,0.7846153846153846,1.0
91,129,90,72,90,108,580,0.8536585365853658,68,72,78,38,42,32,330,0.23809523809523808,0.5
105,180,100,180,100,115,780,0.9477611940298507,75,75,55,105,85,30,425,0.1619718309859155,2.0
1,90,45,30,30,40,236,0.33064516129032256,64,66,68,81,76,50,405,0.25190839694656486,1.0
80,130,100,160,120,110,700,0.8981481481481481,75,103,80,70,80,92,500,0.7933884297520661,1.0
61,84,65,70,70,70,420,0.5,45,30,15,85,65,65,305,0.36220472440944884,1.0
40,30,30,40,50,30,220,0.07936507936507936,50,95,90,95,90,180,600,0.9172413793103448,1.0
60,90,70,60,120,40,440,0.27419354838709675,115,140,130,55,55,40,535,0.4519230769230769,0.5
95,155,109,70,130,81,640,0.6788321167883211,70,94,50,94,50,66,424,0.48148148148148145,1.0
45,60,30,80,50,65,330,0.4603174603174603,59,45,40,35,40,31,250,0.14285714285714285,1.0
45,85,70,40,40,60,340,0.5229357798165137,75,75,130,75,130,95,580,0.7479674796747967,2.0
70,135,105,60,105,20,495,0.5806451612903226,70,120,40,95,40,95,460,0.8106060606060606,1.0
79,100,80,110,90,121,580,0.968,90,93,55,70,55,55,418,0.3819444444444444,2.0
79,105,70,145,80,101,580,0.8608695652173913,30,80,90,55,45,55,355,0.4295774647887324,1.0
60,80,110,50,80,45,425,0.2833333333333333,79,100,80,110,90,121,580,0.968,0.0
130,70,35,70,35,60,400,0.4017857142857143,95,135,80,110,80,100,600,0.8248175182481752,0.5
80,70,40,100,60,145,495,0.921875,35,46,34,35,45,20,215,0.072,1.0
41,50,37,50,37,66,281,0.5175438596491229,55,65,35,60,30,85,330,0.6126126126126126,1.0
77,59,50,67,63,46,362,0.23140495867768596,67,125,40,30,30,58,350,0.3431372549019608,1.0
65,95,100,60,50,50,420,0.34959349593495936,45,60,40,70,50,45,310,0.2846715328467153,1.0
28,25,25,45,35,40,198,0.16083916083916083,20,15,20,10,55,80,200,0.2682926829268293,1.0
45,75,37,70,55,83,365,0.6183206106870229,70,84,70,65,70,51,410,0.2949640287769784,0.5
80,160,60,170,130,80,680,0.6180555555555556,50,52,48,65,50,55,320,0.33098591549295775,1.0
70,70,70,70,70,70,420,0.5289256198347108,60,70,65,125,105,90,515,0.6911764705882353,1.0
110,160,110,80,110,100,670,0.8591549295774648,50,52,48,65,50,55,320,0.33098591549295775,1.0
40,40,55,40,70,55,300,0.40939597315436244,40,40,35,50,100,70,335,0.5031847133757962,4.0
70,92,65,80,55,98,460,0.8090909090909091,75,75,55,105,85,30,425,0.1619718309859155,0.5
89,145,90,105,80,91,600,0.8549618320610687,40,55,30,30,30,85,270,0.688,0.0
110,160,110,80,110,100,670,0.8591549295774648,110,80,90,95,90,65,530,0.5033557046979866,1.0
35,70,55,45,55,25,285,0.09420289855072464,70,70,40,60,40,60,340,0.4247787610619469,2.0
110,160,110,80,110,100,670,0.8591549295774648,91,90,129,90,72,108,580,0.9140625,0.5
49,49,56,49,61,66,330,0.5190839694656488,100,75,115,90,115,85,580,0.6446280991735537,0.5
35,55,35,30,30,35,220,0.23684210526315788,95,110,80,70,80,50,485,0.37209302325581395,1.0
70,70,70,70,70,70,420,0.5289256198347108,86,68,72,109,66,106,507,0.8099173553719008,1.0
75,140,65,112,65,110,567,0.9140625,55,85,55,50,55,60,360,0.4233576642335766,8.0
75,95,125,45,75,95,510,0.8257575757575758,70,120,65,45,85,125,510,0.9747899159663865,1.0
50,50,50,50,50,50,300,0.30708661417322836,85,135,130,60,80,25,515,0.40540540540540543,1.0
30,80,90,55,45,55,355,0.4295774647887324,72,105,115,54,86,68,500,0.5149253731343284,1.0
85,110,76,65,82,56,474,0.3933333333333333,65,90,50,85,45,55,390,0.371900826446281,0.25
40,60,40,40,40,30,250,0.0948905109489051,70,145,88,140,70,112,625,0.8888888888888888,0.0
70,95,125,65,75,45,475,0.33613445378151263,40,70,130,60,130,25,455,0.17355371900826447,0.5
70,77,60,97,60,108,472,0.8394160583941606,90,90,85,125,90,100,580,0.768595041322314,0.5
48,72,48,72,48,48,336,0.25984251968503935,65,130,60,75,60,75,465,0.689922480620155,0.0
20,40,15,35,35,60,205,0.34285714285714286,75,80,70,65,75,90,455,0.7578125,2.0
120,70,120,75,130,85,600,0.6694915254237288,45,49,49,65,65,45,318,0.2781954887218045,2.0
90,85,75,115,100,115,580,0.9381443298969072,80,70,65,80,120,100,515,0.8034188034188035,2.0
135,85,40,40,85,5,390,0.6864406779661016,75,55,70,55,95,110,460,0.8444444444444444,1.0
68,125,65,65,115,80,518,0.6277372262773723,90,110,80,100,80,95,555,0.7982456140350878,1.0
80,70,70,90,100,70,480,0.5609756097560976,67,57,55,77,55,114,425,0.8879310344827587,0.5
70,95,125,65,75,45,475,0.33613445378151263,70,120,40,95,40,95,460,0.8106060606060606,2.0
70,110,70,115,70,90,525,0.75,130,65,60,110,95,65,525,0.5227272727272727,0.5
130,85,80,85,95,60,535,0.43884892086330934,100,150,110,95,110,70,635,0.5923076923076923,1.0
85,73,70,73,115,67,483,0.5126050420168067,60,100,89,55,69,112,485,0.9298245614035088,2.0
125,130,90,130,90,95,660,0.7734375,88,107,122,74,75,64,530,0.4596774193548387,2.0
120,120,120,120,120,120,720,0.9344262295081968,65,76,84,54,96,105,480,0.9008264462809917,1.0
31,45,90,30,30,40,266,0.21929824561403508,62,48,66,59,57,49,341,0.33884297520661155,0.5
38,35,35,65,55,50,278,0.2647058823529412,58,109,112,48,48,109,484,0.8805970149253731,0.25
65,75,105,35,65,85,430,0.6940298507462687,135,85,40,40,85,5,390,0.6864406779661016,1.0
45,40,60,40,75,50,310,0.2926829268292683,45,85,50,55,50,65,350,0.5076923076923077,2.0
75,70,90,70,105,80,490,0.656,83,80,80,135,80,121,579,0.9444444444444444,1.0
50,52,48,65,50,55,320,0.33098591549295775,70,55,65,95,85,70,440,0.5307692307692308,2.0
120,70,120,75,130,85,600,0.6694915254237288,67,58,57,81,67,101,431,0.8790322580645161,1.0
60,40,50,75,85,95,405,0.6044776119402985,61,72,57,55,55,65,365,0.3984375,1.0
50,150,50,150,50,150,600,0.9339622641509434,55,66,44,44,56,85,350,0.6888888888888889,1.0
75,140,65,112,65,110,567,0.9140625,70,80,70,80,70,110,480,0.6594202898550725,2.0
30,35,30,100,35,80,310,0.4765625,50,85,125,85,115,20,480,0.4306569343065693,0.5
48,61,40,61,40,50,300,0.2543859649122807,55,45,43,55,43,72,313,0.5853658536585366,0.25
70,60,62,80,82,60,414,0.4375,126,131,95,131,98,99,680,0.8102189781021898,1.0
65,150,40,15,80,145,495,0.9663865546218487,75,90,50,110,80,95,500,0.7985611510791367,1.0
60,85,69,65,79,80,438,0.576,75,125,100,70,80,45,495,0.33035714285714285,0.5
45,25,50,25,25,35,205,0.13076923076923078,60,115,105,65,70,80,495,0.7181818181818181,0.5
65,100,70,80,80,105,500,0.8666666666666667,50,50,120,80,80,30,410,0.07258064516129033,0.25
44,75,35,63,33,45,295,0.2647058823529412,71,82,64,64,59,112,452,0.9327731092436975,0.0
75,75,95,75,95,113,528,0.9015151515151515,78,84,78,109,85,100,534,0.8620689655172413,0.5
80,115,80,65,55,93,488,0.7846153846153846,44,38,39,61,79,42,303,0.2251655629139073,1.0
125,58,58,76,76,67,460,0.515625,75,100,95,40,70,110,490,0.8717948717948718,1.0
105,150,90,150,90,95,680,0.8285714285714286,115,45,20,45,25,20,270,0.11538461538461539,0.0
110,85,95,80,95,50,515,0.2713178294573643,43,30,55,40,65,97,330,0.6030534351145038,1.0
54,45,47,75,98,52,371,0.39669421487603307,20,15,20,10,55,80,200,0.2682926829268293,1.0
100,100,100,100,100,100,600,0.8345864661654135,45,60,32,50,32,76,295,0.5925925925925926,1.0
85,110,76,65,82,56,474,0.3933333333333333,64,51,23,51,23,28,240,0.11363636363636363,0.0
55,130,115,50,50,75,475,0.5982142857142857,70,60,70,87,78,85,450,0.6228070175438597,0.5
40,55,30,30,30,60,245,0.43548387096774194,105,125,100,60,100,100,590,0.8359375,1.0
65,90,115,45,115,58,488,0.5041322314049587,35,70,55,45,55,25,285,0.09420289855072464,0.5
108,130,95,80,85,102,600,0.7637795275590551,50,65,107,105,107,86,520,0.7313432835820896,1.0
55,55,50,45,65,55,325,0.37373737373737376,70,95,125,65,75,45,475,0.33613445378151263,0.5
75,90,90,140,90,115,600,0.9481481481481482,68,72,78,38,42,32,330,0.23809523809523808,1.0
123,100,62,97,81,68,531,0.4806201550387597,54,78,103,53,45,22,355,0.23255813953488372,4.0
65,65,60,130,95,110,525,0.823943661971831,90,92,75,92,85,60,494,0.49586776859504134,1.0
50,85,40,85,40,35,335,0.1746031746031746,45,60,40,70,50,45,310,0.2846715328467153,0.5
55,65,95,95,45,85,440,0.6610169491525424,120,100,85,30,85,45,465,0.22448979591836735,1.0
57,80,91,80,87,75,470,0.5737704918032787,60,70,65,125,105,90,515,0.6911764705882353,0.5
55,75,50,40,40,80,340,0.6302521008403361,103,60,126,80,126,50,545,0.36363636363636365,1.0
60,100,115,70,85,90,520,0.7557251908396947,75,95,122,58,75,69,494,0.5725806451612904,1.0
65,85,70,75,70,40,405,0.203125,25,35,70,95,55,45,325,0.16783216783216784,0.5
61,84,65,70,70,70,420,0.5,86,76,86,116,56,95,515,0.7982456140350878,1.0
50,40,85,40,65,25,305,0.08870967741935484,64,115,65,83,63,65,455,0.5323741007194245,0.5
30,65,100,45,25,40,305,0.1891891891891892,105,95,80,40,80,90,490,0.753968253968254,1.0
78,70,61,50,61,100,420,0.8145161290322581,86,76,86,116,56,95,515,0.7982456140350878,1.0
190,33,58,33,58,33,405,0.13432835820895522,70,85,140,85,70,20,470,0.272,1.0
45,100,45,45,45,10,290,0.2949640287769784,55,45,43,55,43,72,313,0.5853658536585366,0.0
75,125,100,70,80,45,495,0.33035714285714285,70,120,40,95,40,95,460,0.8106060606060606,2.0
45,75,60,40,30,50,300,0.304,80,75,150,75,150,50,580,0.30973451327433627,0.5
65,130,60,75,60,75,465,0.689922480620155,61,84,65,70,70,70,420,0.5,1.0
79,115,70,125,80,111,580,0.8468468468468469,55,112,45,74,45,70,401,0.559322033898305,0.5
75,95,122,58,75,69,494,0.5725806451612904,85,80,70,135,75,90,535,0.7006802721088435,0.0
108,130,95,80,85,102,600,0.7637795275590551,70,70,40,60,40,60,340,0.4247787610619469,0.5
45,67,60,35,50,63,320,0.5128205128205128,45,50,55,75,65,30,320,0.06293706293706294,0.5
54,66,70,44,55,46,335,0.4214876033057851,45,30,35,20,20,45,195,0.14782608695652175,0.5
60,62,63,80,80,60,405,0.38016528925619836,55,84,105,114,75,52,485,0.2890625,2.0
50,60,60,60,60,30,320,0.11290322580645161,40,35,30,120,70,105,400,0.6692307692307692,1.0
60,80,95,70,85,50,440,0.2231404958677686,65,83,57,95,85,105,490,0.8914728682170543,0.5
45,50,55,75,65,30,320,0.06293706293706294,85,115,80,105,80,50,515,0.3063063063063063,1.0
100,103,75,120,75,127,600,0.940677966101695,45,90,20,65,20,65,305,0.5116279069767442,2.0
45,35,50,70,50,30,280,0.15753424657534246,65,125,100,55,70,85,500,0.6532258064516129,0.5
45,30,35,20,20,45,195,0.14782608695652175,90,90,85,125,90,100,580,0.768595041322314,0.5
81,102,77,85,75,85,505,0.5642857142857143,100,110,90,85,90,60,535,0.47794117647058826,0.5
80,92,65,65,80,68,450,0.4824561403508772,45,63,37,65,55,95,360,0.8055555555555556,1.0
79,105,70,145,80,101,580,0.8608695652173913,35,20,65,40,65,20,245,0.02459016393442623,1.0
100,110,90,85,90,60,535,0.47794117647058826,90,60,60,40,40,40,330,0.29545454545454547,2.0
75,80,55,25,35,35,305,0.18666666666666668,38,35,40,27,25,35,200,0.08208955223880597,0.5
110,135,60,50,65,88,508,0.7744360902255639,60,110,70,60,60,100,460,0.8461538461538461,0.0
40,80,35,35,45,70,305,0.4661016949152542,125,130,90,130,90,95,660,0.7734375,2.0
50,70,50,50,50,70,340,0.5645161290322581,64,165,75,93,83,75,555,0.6587301587301587,1.0
95,80,105,40,70,100,490,0.8046875,75,95,122,58,75,69,494,0.5725806451612904,0.0
55,40,85,80,105,40,405,0.23622047244094488,60,85,60,85,60,55,405,0.3673469387755102,2.0
95,100,85,108,70,70,528,0.5652173913043478,135,85,40,40,85,5,390,0.6864406779661016,1.0
68,72,78,38,42,32,330,0.23809523809523808,60,90,55,90,80,110,485,0.8677685950413223,2.0
60,75,85,100,85,115,520,0.8992248062015504,81,102,77,85,75,85,505,0.5642857142857143,8.0
55,45,43,55,43,72,313,0.5853658536585366,80,52,50,90,50,89,411,0.6666666666666666,2.0
65,95,75,55,55,85,430,0.6933333333333334,60,130,80,60,60,70,460,0.5153846153846153,1.0
35,20,65,40,65,20,245,0.02459016393442623,100,134,110,95,100,61,600,0.4057971014492754,2.0
108,112,118,68,72,47,525,0.2916666666666667,70,55,65,95,85,70,440,0.5307692307692308,2.0
70,65,65,55,55,70,380,0.5,100,100,100,100,100,100,600,0.8778625954198473,1.0
55,65,35,60,30,85,330,0.6126126126126126,40,45,40,65,40,65,295,0.5661764705882353,1.0
60,95,80,60,80,30,405,0.19480519480519481,40,40,55,40,70,55,300,0.40939597315436244,4.0
95,75,110,100,80,30,490,0.15267175572519084,20,25,45,70,90,60,310,0.30833333333333335,0.5
60,100,89,55,69,112,485,0.9298245614035088,83,80,80,135,80,121,579,0.9444444444444444,0.5
90,70,80,70,95,70,475,0.5190839694656488,50,75,75,65,65,50,380,0.4049586776859504,1.0
50,85,40,85,40,35,335,0.1746031746031746,45,75,37,70,55,83,365,0.6183206106870229,0.5
50,95,95,35,110,70,455,0.5179856115107914,105,140,55,30,55,95,480,0.8195488721804511,1.0
35,20,65,40,65,20,245,0.02459016393442623,70,70,70,70,70,70,420,0.5289256198347108,1.0
60,50,150,50,150,60,520,0.5206611570247934,85,110,90,45,90,80,500,0.6206896551724138,0.0
60,115,105,65,70,80,495,0.7181818181818181,50,85,40,85,40,35,335,0.1746031746031746,0.5
65,80,140,40,70,70,465,0.5223880597014925,123,100,62,97,81,68,531,0.4806201550387597,2.0
60,50,50,60,70,50,340,0.28346456692913385,85,110,76,65,82,56,474,0.3933333333333333,0.25
90,60,60,40,40,40,330,0.29545454545454547,50,65,107,105,107,86,520,0.703125,2.0
75,75,60,83,60,60,413,0.39344262295081966,75,125,230,55,95,30,610,0.3448275862068966,2.0
125,170,100,120,90,95,700,0.77,55,65,35,60,30,85,330,0.6126126126126126,0.5
65,63,45,45,45,45,308,0.2595419847328244,25,20,15,105,55,90,310,0.32407407407407407,1.0
69,55,45,55,55,15,294,0.11666666666666667,62,55,52,109,94,109,481,0.7833333333333333,1.0
35,55,35,30,30,35,220,0.23684210526315788,84,86,88,111,101,60,530,0.4634146341463415,1.0
90,85,100,95,125,85,580,0.6834532374100719,100,100,100,100,100,100,600,0.8778625954198473,0.5
65,130,60,95,110,65,525,0.5303030303030303,65,50,35,115,95,95,455,0.7333333333333333,2.0
65,76,84,54,96,105,480,0.9008264462809917,60,60,40,65,45,35,305,0.15833333333333333,1.0
110,65,75,125,85,30,490,0.15,30,40,70,70,25,60,295,0.41353383458646614,1.0
71,73,88,120,89,59,500,0.43537414965986393,80,105,65,60,75,130,515,0.9645390070921985,2.0
67,89,116,79,116,33,500,0.2624113475177305,55,65,35,60,30,85,330,0.6126126126126126,0.5
30,45,59,30,39,57,260,0.2803030303030303,123,100,62,97,81,68,531,0.4806201550387597,4.0
50,70,160,70,160,90,600,0.7417218543046358,70,55,65,95,85,70,440,0.5307692307692308,0.5
100,100,100,100,100,100,600,0.8758169934640523,95,70,73,95,90,60,483,0.3983739837398374,0.5
79,100,80,110,90,121,580,0.968,110,65,105,55,95,80,510,0.6258503401360545,1.0
45,45,55,45,55,63,308,0.4594594594594595,85,50,95,120,115,80,545,0.5793650793650794,0.5
50,55,50,36,30,43,264,0.2922077922077922,75,75,130,75,130,95,580,0.7479674796747967,1.0
60,60,60,60,60,60,360,0.38095238095238093,95,65,65,110,130,60,525,0.4016393442622951,1.0
50,30,55,65,55,20,275,0.13675213675213677,91,90,106,130,106,77,600,0.648854961832061,1.0
68,75,53,83,113,60,452,0.45384615384615384,44,58,44,58,44,61,309,0.41964285714285715,1.0
50,95,95,35,110,70,455,0.5179856115107914,70,75,60,105,60,105,475,0.88,1.0
75,98,63,98,63,101,498,0.849624060150376,60,62,50,62,60,40,334,0.18181818181818182,0.5
70,150,140,65,100,75,600,0.55,65,65,60,130,95,110,525,0.823943661971831,2.0
45,75,60,40,30,50,300,0.304,60,65,80,170,95,130,600,0.8625954198473282,1.0
104,91,63,91,73,68,490,0.5118110236220472,35,55,40,45,40,60,275,0.35714285714285715,1.0
54,63,52,83,56,97,405,0.7697841726618705,75,55,70,55,95,110,460,0.8444444444444444,0.5
70,110,75,145,85,145,630,0.9444444444444444,38,30,85,55,65,30,303,0.21428571428571427,1.0
41,50,37,50,37,66,281,0.5175438596491229,40,65,95,60,45,35,340,0.13986013986013987,1.0
50,95,90,95,90,180,600,0.9172413793103448,55,65,95,95,45,85,440,0.6610169491525424,1.0
95,109,105,75,85,56,525,0.34513274336283184,55,40,85,80,105,40,405,0.23622047244094488,0.0
90,93,55,70,55,55,418,0.3819444444444444,40,55,30,30,30,85,270,0.688,1.0
45,25,50,25,25,35,205,0.13076923076923078,68,165,95,65,115,110,618,0.8615384615384616,1.0
60,110,70,60,60,100,460,0.8461538461538461,115,140,130,55,55,40,535,0.4519230769230769,0.25
50,50,40,50,40,64,294,0.45588235294117646,95,125,79,60,100,81,540,0.6165413533834586,0.5
65,125,100,60,70,70,490,0.6099290780141844,90,65,65,40,40,15,315,0.19672131147540983,1.0
59,45,40,35,40,31,250,0.14285714285714285,85,60,65,135,105,100,550,0.7518248175182481,1.0
64,51,23,51,23,28,240,0.11363636363636363,100,123,75,57,75,80,510,0.6923076923076923,1.0
62,55,52,109,94,109,481,0.7833333333333333,92,105,90,125,90,98,600,0.8217054263565892,0.5
70,45,48,60,65,35,323,0.15748031496062992,85,50,95,120,115,80,545,0.5793650793650794,1.0
91,90,129,90,72,108,580,0.9140625,57,80,91,80,87,75,470,0.5737704918032787,0.25
43,30,55,40,65,97,330,0.6030534351145038,76,104,71,104,71,108,534,0.912751677852349,2.0
68,90,65,50,55,82,410,0.6165413533834586,90,90,85,125,90,100,580,0.768595041322314,0.0
20,40,15,35,35,60,205,0.34285714285714286,165,75,80,40,45,65,470,0.5151515151515151,2.0
80,115,80,65,55,93,488,0.7846153846153846,45,35,45,62,53,35,275,0.11851851851851852,2.0
45,85,50,55,50,65,350,0.5076923076923077,50,100,150,100,150,50,600,0.37142857142857144,1.0
50,50,62,40,62,65,329,0.4188034188034188,43,30,55,40,65,97,330,0.6030534351145038,1.0
62,55,52,109,94,109,481,0.7833333333333333,50,53,48,53,48,64,316,0.358974358974359,2.0
77,85,51,55,51,65,384,0.5163934426229508,50,65,107,105,107,86,520,0.7758620689655172,1.0
50,65,107,105,107,86,520,0.6991150442477876,90,93,55,70,55,55,418,0.3819444444444444,0.5
105,180,100,180,100,115,780,0.9477611940298507,48,61,40,61,40,50,300,0.2543859649122807,2.0
110,135,60,50,65,88,508,0.7744360902255639,69,55,45,55,55,15,294,0.11666666666666667,1.0
41,50,37,50,37,66,281,0.5175438596491229,71,95,85,110,95,79,535,0.664,1.0
60,80,95,70,85,50,440,0.2231404958677686,50,75,45,40,45,60,315,0.4380165289256198,1.0
73,115,60,60,60,90,458,0.6694915254237288,45,50,45,115,55,95,405,0.6936936936936937,0.0
60,85,69,60,69,77,420,0.518796992481203,60,60,40,65,45,35,305,0.15833333333333333,1.0
75,75,55,105,85,30,425,0.1619718309859155,115,115,85,90,75,100,580,0.8134328358208955,0.5
55,20,35,20,45,75,250,0.37681159420289856,60,65,60,130,75,110,500,0.7719298245614035,0.0
60,45,70,45,90,95,405,0.7304964539007093,250,5,5,35,105,50,450,0.15306122448979592,1.0
70,80,50,35,35,35,305,0.14,95,85,85,65,65,35,430,0.2571428571428571,1.0
85,115,80,105,80,50,515,0.3063063063063063,45,30,40,105,50,20,290,0.031007751937984496,1.0
55,47,52,40,40,41,275,0.16806722689075632,49,49,56,49,61,66,330,0.5190839694656488,1.0
45,65,34,40,34,45,263,0.2589928057553957,40,60,30,31,31,70,262,0.4492753623188406,2.0
60,90,140,50,50,40,430,0.2535211267605634,45,85,50,55,50,65,350,0.5076923076923077,0.5
80,120,130,55,65,45,495,0.37037037037037035,10,55,25,35,45,95,265,0.5396825396825397,0.5
115,140,130,55,55,40,535,0.4519230769230769,74,48,76,83,81,104,466,0.7322834645669292,1.0
60,60,50,40,50,75,335,0.5882352941176471,65,90,50,85,45,55,390,0.371900826446281,0.25
72,85,70,65,70,58,420,0.41304347826086957,40,45,35,65,55,70,310,0.4482758620689655,1.0
70,75,60,105,60,105,475,0.88,130,70,35,70,35,60,400,0.4017857142857143,2.0
59,110,150,45,49,35,448,0.3333333333333333,50,65,45,85,65,95,405,0.7238095238095238,1.0
89,124,80,55,80,55,483,0.5714285714285714,60,50,100,85,70,65,430,0.47580645161290325,0.0
60,50,150,50,150,60,520,0.5206611570247934,60,25,35,70,80,60,330,0.3076923076923077,2.0
130,65,60,110,95,65,525,0.5227272727272727,110,123,65,100,65,65,528,0.5217391304347826,2.0
95,65,110,60,130,65,525,0.5275590551181102,90,110,80,100,80,95,555,0.7982456140350878,1.0
60,82,45,45,45,74,351,0.5752212389380531,65,70,60,65,65,115,440,0.8583333333333333,1.0
76,65,45,92,42,91,411,0.7449664429530202,110,160,110,80,110,100,670,0.8591549295774648,1.0
67,57,55,77,55,114,425,0.8879310344827587,50,48,43,46,41,60,288,0.47297297297297297,2.0
80,85,95,30,30,25,345,0.2857142857142857,65,130,60,75,60,75,465,0.689922480620155,1.0
85,90,80,70,80,130,535,0.9262295081967213,90,70,80,70,95,70,475,0.5190839694656488,1.0
45,60,32,50,32,76,295,0.5925925925925926,103,60,86,60,86,50,445,0.3458646616541353,1.0
64,66,68,81,76,50,405,0.25190839694656486,68,65,65,125,115,80,518,0.6461538461538462,1.0
74,108,133,83,65,32,495,0.32142857142857145,80,75,150,75,150,50,580,0.30973451327433627,0.5
53,54,53,37,46,45,288,0.3090909090909091,40,40,55,40,70,55,300,0.40939597315436244,2.0
95,75,80,100,110,30,490,0.24242424242424243,85,80,90,105,95,60,515,0.49074074074074076,1.0
10,55,25,35,45,95,265,0.5396825396825397,60,65,70,85,75,40,395,0.21705426356589147,1.0
70,55,65,95,85,70,440,0.5307692307692308,58,109,112,48,48,109,484,0.8805970149253731,0.5
72,60,30,20,30,25,237,0.11570247933884298,55,20,35,20,45,75,250,0.37681159420289856,2.0
105,150,90,150,90,95,680,0.8285714285714286,52,65,55,58,62,60,352,0.4482758620689655,1.0
60,59,85,79,105,36,424,0.16666666666666666,40,45,40,35,35,56,251,0.373015873015873,0.25
54,45,47,75,98,52,371,0.39669421487603307,45,30,15,85,65,65,305,0.36220472440944884,1.0
70,75,60,105,60,105,475,0.88,60,62,50,62,60,40,334,0.18181818181818182,0.5
58,64,58,80,65,80,405,0.5423728813559322,40,45,40,62,60,60,307,0.33884297520661155,0.5
60,150,50,150,50,60,520,0.5,75,80,55,25,35,35,305,0.18666666666666668,1.0
100,100,100,100,100,100,600,0.8805970149253731,80,100,70,60,70,95,475,0.7416666666666667,0.5
60,95,80,60,80,30,405,0.19480519480519481,80,110,120,130,90,70,600,0.6198347107438017,0.5
90,95,95,70,90,70,510,0.5230769230769231,40,65,95,60,45,35,340,0.13986013986013987,0.5
55,81,60,50,70,97,413,0.7214285714285714,50,180,20,180,20,150,600,0.9029850746268657,1.0
70,55,65,95,85,70,440,0.5307692307692308,60,50,70,50,90,65,385,0.39568345323741005,4.0
40,45,65,100,120,90,460,0.5588235294117647,75,38,38,56,56,67,330,0.5263157894736842,1.0
55,65,35,60,30,85,330,0.6126126126126126,109,66,84,81,99,32,471,0.2013888888888889,2.0
75,100,95,40,70,110,490,0.8717948717948718,70,100,115,30,65,30,410,0.24390243902439024,0.5
40,50,45,70,45,70,320,0.5517241379310345,41,56,40,62,44,71,314,0.568,1.0
70,90,90,135,90,125,600,0.9401709401709402,70,20,50,20,50,40,250,0.1557377049180328,0.5
59,74,50,35,50,35,303,0.3125,52,65,50,45,50,38,300,0.27419354838709675,0.5
111,83,68,92,82,39,475,0.1774193548387097,65,136,94,54,96,135,580,0.9612403100775194,1.0
60,40,60,40,60,35,295,0.18055555555555555,103,60,126,80,126,50,545,0.36363636363636365,1.0
65,150,40,15,80,145,495,0.9663865546218487,75,100,63,80,63,116,497,0.9345794392523364,1.0
60,52,168,47,138,30,495,0.19834710743801653,60,40,80,60,45,40,325,0.23529411764705882,1.0
65,95,57,100,85,93,495,0.7441860465116279,46,57,40,40,40,50,273,0.25,1.0
50,50,40,50,40,64,294,0.45588235294117646,65,55,115,100,40,60,435,0.3798449612403101,0.5
38,35,40,27,25,35,200,0.08208955223880597,60,62,50,62,60,40,334,0.18181818181818182,2.0
110,135,60,50,65,88,508,0.7744360902255639,38,36,38,32,36,57,237,0.3893805309734513,1.0
100,128,90,77,77,128,600,0.959349593495935,70,110,180,60,60,50,530,0.4117647058823529,1.0
30,45,55,70,55,85,340,0.5633802816901409,70,90,70,60,60,70,420,0.6390977443609023,1.0
80,80,80,80,80,80,480,0.5606060606060606,74,108,133,83,65,32,495,0.32142857142857145,1.0
50,75,35,70,30,40,300,0.21296296296296297,111,83,68,92,82,39,475,0.1774193548387097,2.0
50,25,28,45,55,15,218,0.0625,58,64,58,80,65,80,405,0.5423728813559322,0.5
54,66,70,44,55,46,335,0.4214876033057851,44,75,35,63,33,45,295,0.2647058823529412,2.0
100,120,120,150,100,90,680,0.7880794701986755,105,140,95,55,65,45,505,0.3,1.0
69,55,45,55,55,15,294,0.11666666666666667,90,90,85,125,90,100,580,0.768595041322314,0.5
64,78,52,78,52,81,405,0.6422764227642277,70,130,100,55,80,65,500,0.608,4.0
85,115,80,105,80,50,515,0.3063063063063063,62,73,55,56,52,84,382,0.7244094488188977,2.0
38,41,40,50,65,65,299,0.4108527131782946,89,145,90,105,80,91,600,0.8549618320610687,1.0
65,60,110,130,95,65,525,0.47761194029850745,86,81,97,81,107,43,495,0.203125,2.0
165,75,80,40,45,65,470,0.5151515151515151,50,65,107,105,107,86,520,0.7758620689655172,0.5
80,125,75,40,95,85,500,0.6911764705882353,50,55,50,36,30,43,264,0.2922077922077922,0.5
60,70,105,70,120,75,500,0.5983606557377049,70,60,70,87,78,85,450,0.6228070175438597,0.5
65,40,70,80,140,70,465,0.5954198473282443,70,90,110,60,75,95,500,0.7333333333333333,1.0
70,85,140,85,70,20,470,0.272,60,62,63,80,80,60,405,0.38016528925619836,2.0
105,180,100,180,100,115,780,0.9477611940298507,80,105,105,105,105,80,580,0.5939849624060151,1.0
65,150,40,15,80,145,495,0.9663865546218487,50,64,50,45,50,41,300,0.22727272727272727,0.25
170,90,45,90,45,60,500,0.427536231884058,91,134,95,100,100,80,600,0.6304347826086957,0.5
70,145,88,140,70,112,625,0.8888888888888888,62,73,55,56,52,84,382,0.7244094488188977,0.25
70,140,230,60,80,50,630,0.32432432432432434,114,85,70,85,80,30,464,0.2066115702479339,1.0
55,45,43,55,43,72,313,0.5853658536585366,40,45,35,40,40,90,290,0.65,1.0
106,110,90,154,90,130,680,0.926829268292683,75,95,125,45,75,95,510,0.8257575757575758,2.0
103,60,86,60,86,50,445,0.3458646616541353,80,90,80,130,110,110,600,0.856,1.0
54,45,47,75,98,52,371,0.39669421487603307,65,80,140,40,70,70,465,0.5223880597014925,0.5
70,70,70,70,70,70,420,0.5289256198347108,56,61,65,48,45,38,313,0.17567567567567569,1.0
125,130,90,130,90,95,660,0.7734375,60,85,49,60,49,60,363,0.4444444444444444,1.0
105,30,105,140,105,55,540,0.3524590163934426,55,40,50,65,85,40,335,0.3181818181818182,0.5
50,48,43,46,41,60,288,0.47297297297297297,90,110,80,100,80,95,555,0.7982456140350878,4.0
65,80,140,40,70,70,465,0.5223880597014925,75,80,60,65,90,102,472,0.8625954198473282,1.0
45,49,49,65,65,45,318,0.2781954887218045,68,90,65,50,55,82,410,0.6165413533834586,0.5
30,80,90,55,45,55,355,0.4295774647887324,50,75,45,40,45,60,315,0.4380165289256198,2.0
45,22,60,27,30,29,213,0.07518796992481203,20,10,55,15,20,80,200,0.17985611510791366,1.0
68,72,78,38,42,32,330,0.23809523809523808,123,77,72,99,92,58,521,0.4621212121212121,2.0
100,100,125,110,50,50,535,0.384,55,55,85,65,85,35,380,0.2014388489208633,4.0
50,75,70,35,70,48,348,0.29357798165137616,30,80,90,55,45,55,355,0.4295774647887324,2.0
70,55,75,45,65,60,370,0.45901639344262296,106,190,100,154,100,130,780,0.9259259259259259,2.0
66,65,48,62,57,52,350,0.36220472440944884,40,27,60,37,50,66,280,0.36220472440944884,0.5
50,70,50,50,50,70,340,0.5645161290322581,60,60,60,105,105,105,495,0.848,1.0
150,120,100,120,100,90,680,0.664179104477612,71,95,85,110,95,79,535,0.664,1.0
67,58,57,81,67,101,431,0.8790322580645161,60,100,89,55,69,112,485,0.9298245614035088,0.5
70,85,70,60,70,50,405,0.28378378378378377,106,190,100,154,100,130,780,0.9259259259259259,1.0
45,50,43,40,38,62,278,0.40441176470588236,90,75,75,90,100,70,500,0.5462184873949579,1.0
65,65,60,110,95,130,525,0.9253731343283582,70,130,100,55,80,65,500,0.608,1.0
95,85,85,65,65,35,430,0.2571428571428571,80,125,75,40,95,85,500,0.6911764705882353,0.5
116,55,85,107,95,29,487,0.06818181818181818,56,61,65,48,45,38,313,0.17567567567567569,1.0
81,102,77,85,75,85,505,0.5642857142857143,66,117,70,40,50,67,410,0.4573643410852713,1.0
50,53,48,53,48,64,316,0.358974358974359,125,130,90,130,90,95,660,0.7734375,0.5
40,20,30,40,80,55,265,0.22764227642276422,90,110,80,100,80,95,555,0.7982456140350878,0.5
77,59,50,67,63,46,362,0.23140495867768596,45,63,37,65,55,95,360,0.8055555555555556,1.0
45,22,60,27,30,29,213,0.07518796992481203,50,120,53,35,110,87,455,0.640625,0.5
80,100,80,80,80,100,520,0.9051724137931034,110,78,73,76,71,60,468,0.3333333333333333,1.0
45,30,40,105,50,20,290,0.031007751937984496,45,35,50,70,50,30,280,0.15753424657534246,1.0
80,52,50,90,50,89,411,0.6666666666666666,45,75,60,40,30,50,300,0.304,1.0
40,40,50,30,30,30,220,0.0873015873015873,30,45,55,70,55,85,340,0.5633802816901409,2.0
81,102,77,85,75,85,505,0.5642857142857143,50,50,50,50,50,50,300,0.30708661417322836,1.0
50,65,64,44,48,43,314,0.2196969696969697,70,65,65,55,55,70,380,0.5,1.0
50,65,85,35,35,55,325,0.32575757575757575,100,73,83,73,83,55,467,0.371900826446281,0.5
45,67,60,35,50,63,320,0.5128205128205128,135,85,40,40,85,5,390,0.6864406779661016,1.0
90,75,75,90,100,70,500,0.5462184873949579,100,100,125,110,50,50,535,0.384,0.5
40,30,50,55,55,100,330,0.584070796460177,110,65,105,55,95,80,510,0.6258503401360545,2.0
65,95,57,100,85,93,495,0.7441860465116279,40,40,40,70,40,20,250,0.032520325203252036,0.5
50,65,85,35,35,55,325,0.32575757575757575,67,58,57,81,67,101,431,0.8790322580645161,0.5
85,110,90,45,90,80,500,0.6206896551724138,65,90,40,45,80,75,395,0.625,1.0
62,50,58,73,54,72,369,0.4435483870967742,55,81,60,50,70,97,413,0.7214285714285714,1.0
55,112,45,74,45,70,401,0.559322033898305,61,84,65,70,70,70,420,0.5,1.0
75,95,122,58,75,69,494,0.5725806451612904,50,50,40,50,40,64,294,0.45588235294117646,2.0
38,30,85,55,65,30,303,0.21428571428571427,51,65,65,80,75,59,395,0.4365079365079365,1.0
31,45,90,30,30,40,266,0.21929824561403508,65,50,35,115,95,95,455,0.7333333333333333,2.0
90,85,100,95,125,85,580,0.6834532374100719,80,125,75,40,95,85,500,0.6911764705882353,4.0
55,130,115,50,50,75,475,0.5982142857142857,82,80,86,85,75,72,480,0.6183206106870229,1.0
76,65,45,92,42,91,411,0.7449664429530202,88,107,122,74,75,64,530,0.4596774193548387,4.0
90,120,100,150,120,100,680,0.7718120805369127,70,120,40,95,40,95,460,0.8106060606060606,0.5
58,89,77,45,45,48,362,0.3177570093457944,60,45,50,90,80,70,395,0.625,4.0
70,40,50,55,50,25,290,0.061068702290076333,70,84,70,65,70,51,410,0.2949640287769784,8.0
72,85,70,65,70,58,420,0.41304347826086957,55,112,45,74,45,70,401,0.559322033898305,1.0
60,48,45,43,90,42,328,0.21897810218978103,160,110,65,65,110,30,540,0.35714285714285715,1.0
70,110,80,55,80,105,500,0.8794326241134752,90,132,105,132,105,30,594,0.4246575342465753,4.0
55,75,50,40,40,80,340,0.6302521008403361,55,130,115,50,50,75,475,0.5982142857142857,1.0
60,50,150,50,150,60,520,0.5206611570247934,60,90,70,60,120,40,440,0.27419354838709675,0.0
70,60,75,110,75,90,480,0.7165354330708661,115,45,20,45,25,20,270,0.11538461538461539,1.0
75,90,140,60,60,40,465,0.3008130081300813,64,88,50,88,50,106,446,0.9111111111111111,2.0
105,105,75,65,100,50,500,0.37593984962406013,100,100,80,60,60,50,450,0.3050847457627119,0.5
70,70,70,70,70,70,420,0.5289256198347108,60,70,65,125,105,90,515,0.6911764705882353,1.0
59,59,58,90,70,73,409,0.5826086956521739,70,85,140,85,70,20,470,0.272,0.5
65,75,90,97,123,44,494,0.1987179487179487,74,94,131,54,116,20,489,0.4485294117647059,0.0
62,77,62,50,42,65,358,0.4838709677419355,64,88,50,88,50,106,446,0.9111111111111111,1.0
60,65,70,85,75,40,395,0.21705426356589147,65,150,60,115,60,115,565,0.935251798561151,1.0
90,30,15,40,20,15,210,0.043478260869565216,50,52,48,65,50,55,320,0.33098591549295775,1.0
60,40,60,40,60,35,295,0.18055555555555555,90,110,80,100,80,95,555,0.7982456140350878,0.5
55,81,60,50,70,97,413,0.7214285714285714,90,75,85,115,90,55,510,0.3445378151260504,1.0
100,50,80,60,80,50,420,0.34375,45,30,50,65,50,45,285,0.13821138211382114,1.0
35,64,85,74,55,32,345,0.19827586206896552,125,120,90,170,100,95,700,0.78125,0.5
50,70,50,50,50,40,310,0.16296296296296298,68,72,78,38,42,32,330,0.23809523809523808,2.0
59,45,40,35,40,31,250,0.14285714285714285,50,75,70,35,70,48,348,0.29357798165137616,1.0
108,130,95,80,85,102,600,0.7637795275590551,100,100,100,100,100,100,600,0.8758169934640523,1.0
55,45,45,25,25,15,210,0.048,75,95,122,58,75,69,494,0.5725806451612904,0.25
85,105,85,40,50,40,405,0.211864406779661,42,52,67,39,56,50,306,0.2868217054263566,2.0
70,110,80,55,80,105,500,0.8794326241134752,42,52,67,39,56,50,306,0.2868217054263566,0.5
65,65,65,50,50,90,385,0.72,125,130,90,130,90,95,660,0.7734375,0.5
75,65,55,65,55,69,384,0.43548387096774194,45,75,60,40,30,50,300,0.304,0.5
106,90,130,90,154,110,680,0.8699186991869918,79,115,70,125,80,111,580,0.864,0.5
90,100,70,110,150,80,600,0.6037735849056604,38,36,38,32,36,57,237,0.3893805309734513,1.0
77,120,90,60,90,48,485,0.2785714285714286,65,130,60,75,60,75,465,0.689922480620155,1.0
40,30,35,50,70,55,280,0.28205128205128205,75,38,38,56,56,67,330,0.5263157894736842,2.0
75,85,200,55,65,30,510,0.16778523489932887,100,100,90,150,140,90,670,0.71875,0.5
40,65,95,60,45,35,340,0.13986013986013987,82,80,86,85,75,72,480,0.6183206106870229,2.0
75,85,200,55,65,30,510,0.16778523489932887,65,136,94,54,96,135,580,0.9612403100775194,1.0
71,73,88,120,89,59,500,0.43537414965986393,35,70,55,45,55,25,285,0.09420289855072464,0.5
80,160,60,170,130,80,680,0.6180555555555556,45,30,15,85,65,65,305,0.36220472440944884,1.0
67,125,40,30,30,58,350,0.3431372549019608,62,44,50,44,50,55,305,0.3629032258064516,2.0
70,83,50,37,50,60,350,0.3360655737704918,65,125,100,55,70,85,500,0.6532258064516129,2.0
70,85,140,85,70,20,470,0.272,80,120,79,95,79,70,523,0.5833333333333334,1.0
60,90,140,50,50,40,430,0.2535211267605634,95,124,78,69,71,58,495,0.37398373983739835,0.5
90,85,100,95,125,85,580,0.6834532374100719,80,130,100,160,120,110,700,0.8981481481481481,2.0
85,50,95,120,115,80,545,0.5793650793650794,79,85,60,55,60,71,410,0.60431654676259,1.0
89,125,90,115,80,101,600,0.8725490196078431,49,49,56,49,61,66,330,0.5190839694656488,1.0
35,85,45,35,35,75,310,0.6492537313432836,60,40,60,95,60,55,370,0.4222222222222222,0.0
70,65,65,55,55,70,380,0.5,100,90,130,45,65,55,485,0.4253731343283582,0.5
39,52,43,60,50,65,309,0.49107142857142855,60,75,100,55,80,50,420,0.3088235294117647,2.0
95,135,80,110,80,100,600,0.8248175182481752,55,65,95,95,45,85,440,0.6610169491525424,1.0
44,58,44,58,44,61,309,0.41964285714285715,95,145,130,120,90,120,700,0.9398496240601504,0.5
65,65,60,130,95,110,525,0.823943661971831,60,85,60,85,60,55,405,0.3673469387755102,1.0
75,65,55,65,55,69,384,0.43548387096774194,60,48,45,43,90,42,328,0.21897810218978103,1.0
60,55,90,145,90,80,520,0.6071428571428571,84,71,43,71,43,48,360,0.25874125874125875,0.0
80,70,65,80,120,100,515,0.8034188034188035,150,160,100,95,65,100,670,0.8866666666666667,1.0
65,130,60,75,60,75,465,0.689922480620155,40,30,30,40,50,30,220,0.07936507936507936,1.0
95,117,80,65,70,92,519,0.8409090909090909,60,50,40,85,75,95,405,0.7540983606557377,2.0
65,76,84,54,96,105,480,0.9008264462809917,100,5,5,15,65,30,220,0.07692307692307693,1.0
20,15,20,10,55,80,200,0.2682926829268293,75,55,70,55,95,110,460,0.8444444444444444,0.5
60,69,95,69,95,36,424,0.2608695652173913,45,75,60,40,30,50,300,0.304,1.0
30,42,118,42,88,30,350,0.112,100,100,100,100,100,100,600,0.8805970149253731,0.5
50,50,62,40,62,65,329,0.4188034188034188,75,87,63,87,63,98,473,0.865546218487395,1.0
40,40,35,50,100,70,335,0.5031847133757962,60,69,95,69,95,36,424,0.2608695652173913,0.0
53,51,53,61,56,40,314,0.14285714285714285,65,80,80,59,63,58,405,0.4411764705882353,0.5
125,130,90,130,90,95,660,0.7734375,35,35,40,35,55,50,250,0.40336134453781514,4.0
75,103,80,70,80,92,500,0.7933884297520661,95,95,85,125,65,55,520,0.3894736842105263,2.0
78,104,78,159,115,100,634,0.8444444444444444,49,66,70,44,55,51,335,0.4260869565217391,4.0
65,75,105,35,65,85,430,0.6940298507462687,50,105,125,55,95,50,480,0.375886524822695,1.0
65,155,120,65,90,105,600,0.8677685950413223,71,95,85,110,95,79,535,0.664,1.0
76,48,48,57,62,34,325,0.11688311688311688,106,150,70,194,120,140,780,0.952,1.0
95,117,80,65,70,92,519,0.8409090909090909,61,84,65,70,70,70,420,0.5,1.0
50,50,62,40,62,65,329,0.4188034188034188,80,80,80,80,80,80,480,0.6015037593984962,1.0
75,65,55,65,55,69,384,0.43548387096774194,41,56,40,62,44,71,314,0.568,0.5
62,44,50,44,50,55,305,0.3629032258064516,78,65,68,112,154,75,552,0.628099173553719,1.0
80,92,65,65,80,68,450,0.4824561403508772,30,30,42,30,42,70,244,0.4230769230769231,1.0
70,77,60,97,60,108,472,0.8394160583941606,66,117,70,40,50,67,410,0.4573643410852713,0.5
65,75,105,35,65,85,430,0.6940298507462687,31,45,90,30,30,40,266,0.21929824561403508,1.0
60,45,70,75,85,55,390,0.3008130081300813,70,100,115,30,65,30,410,0.24390243902439024,1.0
75,70,90,70,105,80,490,0.656,83,80,75,70,70,101,479,0.8615384615384616,1.0
74,94,131,54,116,20,489,0.4485294117647059,65,63,45,45,45,45,308,0.2595419847328244,0.25
80,100,80,80,80,100,520,0.9051724137931034,70,85,70,60,70,50,405,0.28378378378378377,1.0
58,64,58,80,65,80,405,0.609271523178808,72,95,67,103,71,122,530,0.9606299212598425,0.5
75,125,100,70,80,45,495,0.33035714285714285,40,55,99,40,79,47,360,0.26262626262626265,1.0
80,45,65,90,110,80,470,0.5462962962962963,44,38,33,61,43,70,289,0.5267857142857143,1.0
60,25,35,70,80,60,330,0.3076923076923077,44,38,33,61,43,70,289,0.5267857142857143,1.0
91,72,90,129,90,108,580,0.8925619834710744,68,72,78,38,42,32,330,0.23809523809523808,2.0
65,150,40,15,80,145,495,0.9663865546218487,55,104,105,94,75,52,485,0.36363636363636365,1.0
55,55,55,85,55,30,335,0.1320754716981132,90,70,80,70,95,70,475,0.5190839694656488,1.0
55,104,105,94,75,52,485,0.36363636363636365,41,56,40,62,44,71,314,0.568,0.5
86,68,72,109,66,106,507,0.8099173553719008,50,20,55,25,25,30,205,0.09774436090225563,2.0
106,110,90,154,90,130,680,0.926829268292683,60,69,95,69,95,36,424,0.2608695652173913,0.5
65,130,60,75,60,75,465,0.689922480620155,45,25,50,25,25,35,205,0.13076923076923078,1.0
70,120,40,95,40,95,460,0.8106060606060606,63,60,55,50,50,71,349,0.5289256198347108,1.0
30,45,135,45,90,30,375,0.09285714285714286,64,66,68,81,76,50,405,0.25190839694656486,1.0
91,90,72,90,129,108,580,0.896,50,72,35,35,35,65,292,0.5373134328358209,4.0
20,10,230,10,230,5,505,0.0,40,45,40,35,35,56,251,0.373015873015873,1.0
60,45,50,90,80,70,395,0.625,60,40,60,40,60,35,295,0.18055555555555555,4.0
60,150,50,150,50,60,520,0.5,60,85,60,50,50,125,430,0.9090909090909091,0.0
50,95,180,85,45,70,525,0.5298507462686567,79,85,60,55,60,71,410,0.60431654676259,0.25
65,90,50,85,45,55,390,0.371900826446281,85,97,66,105,66,65,484,0.47107438016528924,0.5
78,70,61,50,61,100,420,0.8145161290322581,90,55,75,60,75,30,385,0.13970588235294118,1.0
65,95,57,100,85,93,495,0.7441860465116279,72,85,70,65,70,58,420,0.41304347826086957,0.5
58,70,45,40,45,42,300,0.25925925925925924,120,120,120,120,120,120,720,0.9344262295081968,1.0
61,90,45,50,50,160,456,0.9230769230769231,75,75,130,75,130,95,580,0.7479674796747967,2.0
50,55,50,36,30,43,264,0.2922077922077922,65,65,60,110,95,130,525,0.9253731343283582,0.5
50,105,79,35,110,76,455,0.6214285714285714,70,60,125,115,70,55,495,0.35507246376811596,2.0
58,109,112,48,48,109,484,0.8805970149253731,50,80,95,10,45,10,290,0.232,2.0
85,60,65,135,105,100,550,0.7518248175182481,55,70,55,40,55,85,360,0.7073170731707317,1.0
65,155,120,65,90,105,600,0.8677685950413223,65,75,70,95,70,95,470,0.7272727272727273,1.0
60,85,60,85,60,55,405,0.3673469387755102,90,110,80,100,80,95,555,0.7982456140350878,0.5
86,81,97,81,107,43,495,0.203125,70,110,80,55,80,105,500,0.8794326241134752,1.0
50,75,70,35,70,48,348,0.29357798165137616,20,10,230,10,230,5,505,0.0,1.0
100,100,100,100,100,100,600,0.8805970149253731,100,100,125,110,50,50,535,0.384,0.5
75,69,72,114,100,104,534,0.8253968253968254,40,70,40,35,40,60,285,0.392,1.0
58,109,112,48,48,109,484,0.8805970149253731,100,75,115,90,115,85,580,0.6446280991735537,0.5
60,90,70,60,120,40,440,0.27419354838709675,35,46,34,35,45,20,215,0.072,1.0
75,65,55,65,55,69,384,0.43548387096774194,75,95,95,95,95,85,540,0.6470588235294118,0.25
70,85,70,60,70,50,405,0.28378378378378377,70,94,50,94,50,66,424,0.48148148148148145,0.0
95,110,95,40,95,55,490,0.40336134453781514,60,60,40,65,45,35,305,0.15833333333333333,1.0
68,125,65,65,115,80,518,0.6277372262773723,78,52,60,63,65,23,341,0.06015037593984962,0.5
50,120,53,35,110,87,455,0.640625,45,50,43,40,38,62,278,0.40441176470588236,1.0
50,65,107,105,107,86,520,0.7313432835820896,45,30,40,105,50,20,290,0.031007751937984496,1.0
95,155,109,70,130,81,640,0.6788321167883211,45,50,43,40,38,62,278,0.40441176470588236,1.0
90,110,80,100,80,95,555,0.7982456140350878,75,69,72,114,100,104,534,0.8253968253968254,0.5
105,105,75,65,100,50,500,0.37593984962406013,70,130,100,55,80,65,500,0.608,0.0
49,66,70,44,55,51,335,0.4260869565217391,91,90,129,90,72,108,580,0.9140625,0.5
55,75,50,40,40,80,340,0.6302521008403361,75,110,110,110,105,80,590,0.656934306569343,1.0
64,78,52,78,52,81,405,0.6422764227642277,45,30,50,65,50,45,285,0.13821138211382114,0.5
79,85,60,55,60,71,410,0.60431654676259,55,40,50,65,85,40,335,0.3181818181818182,0.0
74,48,76,83,81,104,466,0.7322834645669292,65,63,45,45,45,45,308,0.2595419847328244,1.0
85,97,66,105,66,65,484,0.47107438016528924,70,40,50,55,50,25,290,0.061068702290076333,1.0
80,160,60,170,130,80,680,0.6180555555555556,108,100,121,81,95,95,600,0.7476635514018691,2.0
50,120,53,35,110,87,455,0.640625,50,60,60,60,60,30,320,0.11290322580645161,0.5
75,98,63,98,63,101,498,0.8091603053435115,60,62,63,80,80,60,405,0.38016528925619836,0.25
50,50,120,80,80,30,410,0.07258064516129033,45,85,70,40,40,60,340,0.5229357798165137,1.0
70,90,70,60,60,70,420,0.6390977443609023,99,68,83,72,87,51,460,0.417910447761194,1.0
110,123,65,100,65,65,528,0.5217391304347826,100,100,80,60,60,50,450,0.3050847457627119,4.0
61,72,57,55,55,65,365,0.3984375,40,40,40,70,40,20,250,0.032520325203252036,1.0
100,75,115,90,115,85,580,0.6446280991735537,25,35,70,95,55,45,325,0.16783216783216784,1.0
60,95,80,60,80,30,405,0.19480519480519481,79,103,120,135,115,78,630,0.5763888888888888,2.0
58,64,58,80,65,80,405,0.5423728813559322,50,20,55,25,25,30,205,0.09774436090225563,2.0
20,10,55,15,20,80,200,0.17985611510791366,90,55,75,60,75,30,385,0.13970588235294118,1.0
103,60,126,80,126,50,545,0.36363636363636365,70,60,75,110,75,90,480,0.7165354330708661,1.0
70,130,100,55,80,65,500,0.608,70,55,65,95,85,70,440,0.5307692307692308,4.0
80,80,50,40,50,25,325,0.176056338028169,70,100,70,105,75,40,460,0.23214285714285715,0.5
90,100,90,125,85,90,580,0.7352941176470589,91,129,90,72,90,108,580,0.8536585365853658,0.5
55,75,85,25,25,15,280,0.1875,59,66,70,44,55,41,335,0.25190839694656486,1.0
95,75,180,130,80,30,590,0.13793103448275862,70,110,80,55,80,105,500,0.8794326241134752,1.0
65,95,57,100,85,93,495,0.7441860465116279,50,50,50,50,50,50,300,0.30708661417322836,2.0
100,103,75,120,75,127,600,0.940677966101695,41,64,45,50,50,50,300,0.36752136752136755,0.5
70,65,60,90,75,90,450,0.6571428571428571,100,100,80,60,60,50,450,0.3050847457627119,0.5
80,135,130,95,90,70,600,0.5181818181818182,58,89,77,45,45,48,362,0.3177570093457944,2.0
80,80,90,110,130,110,600,0.8721804511278195,100,50,50,76,96,70,442,0.5,1.0
45,50,45,115,55,95,405,0.6936936936936937,91,90,106,130,106,77,600,0.648854961832061,0.0
70,75,80,135,80,135,575,0.917910447761194,130,85,80,85,95,60,535,0.43884892086330934,2.0
50,53,48,53,48,64,316,0.358974358974359,100,100,100,100,100,100,600,0.8778625954198473,2.0
91,129,90,72,90,108,580,0.8536585365853658,38,30,85,55,65,30,303,0.21428571428571427,0.0
60,90,70,60,120,40,440,0.27419354838709675,60,115,105,65,70,80,495,0.7181818181818181,0.5
75,105,75,105,75,45,480,0.3274336283185841,50,20,40,20,40,20,190,0.0962962962962963,1.0
60,65,70,85,75,40,395,0.21705426356589147,70,140,70,110,65,105,560,0.95,2.0
90,95,105,165,110,45,610,0.2890625,75,75,55,105,85,30,425,0.1619718309859155,0.5
105,125,100,60,100,100,590,0.8359375,70,60,70,87,78,85,450,0.6228070175438597,1.0
75,125,230,55,95,30,610,0.3448275862068966,65,65,65,50,50,90,385,0.72,0.5
80,52,50,90,50,89,411,0.6666666666666666,55,20,35,20,45,75,250,0.37681159420289856,1.0
75,70,90,70,105,80,490,0.656,50,95,180,85,45,70,525,0.5298507462686567,1.0
59,74,50,35,50,35,303,0.3125,49,55,42,42,37,85,310,0.6068376068376068,0.0
40,55,30,30,30,60,245,0.43548387096774194,85,105,85,40,50,40,405,0.211864406779661,2.0
39,52,43,60,50,65,309,0.5041322314049587,91,72,90,129,90,108,580,0.8925619834710744,0.5
95,85,85,65,65,35,430,0.2571428571428571,125,130,90,130,90,95,660,0.7734375,0.5
36,50,50,65,60,44,305,0.16363636363636364,70,80,50,35,35,35,305,0.14,1.0
55,50,65,175,95,150,590,0.7818181818181819,90,30,15,40,20,15,210,0.043478260869565216,1.0
73,95,62,85,65,85,465,0.6666666666666666,76,48,48,57,62,34,325,0.11688311688311688,1.0
80,82,78,95,80,85,500,0.6869565217391305,75,90,140,60,60,40,465,0.3008130081300813,1.0
59,74,50,35,50,35,303,0.3125,85,105,85,40,50,40,405,0.211864406779661,1.0
45,50,55,75,65,30,320,0.06293706293706294,100,100,100,100,100,100,600,0.8345864661654135,1.0
125,120,90,170,100,95,700,0.78125,75,80,60,65,90,102,472,0.8625954198473282,1.0
70,110,70,115,70,90,525,0.75,85,105,100,79,83,78,530,0.5869565217391305,0.5
70,80,50,35,35,35,305,0.14,50,65,107,105,107,86,520,0.703125,2.0
62,77,62,50,42,65,358,0.4838709677419355,50,65,107,105,107,86,520,0.7313432835820896,1.0
86,68,72,109,66,106,507,0.8099173553719008,45,100,135,65,135,45,525,0.29411764705882354,0.0
78,84,78,109,85,100,534,0.8646616541353384,80,70,65,80,120,100,515,0.8034188034188035,0.5
100,5,5,15,65,30,220,0.07692307692307693,53,54,53,37,46,45,288,0.3090909090909091,1.0
110,160,110,80,110,100,670,0.8591549295774648,60,45,50,90,80,70,395,0.625,1.0
105,105,75,65,100,50,500,0.37593984962406013,44,58,44,58,44,61,309,0.41964285714285715,1.0
135,85,40,40,85,5,390,0.6864406779661016,40,60,40,40,40,30,250,0.0948905109489051,1.0
50,35,55,25,25,15,205,0.05263157894736842,71,82,64,64,59,112,452,0.9327731092436975,1.0
55,40,40,65,45,35,280,0.16428571428571428,90,120,100,150,120,100,680,0.7718120805369127,1.0
55,85,122,58,75,99,494,0.8099173553719008,60,50,50,60,70,50,340,0.28346456692913385,1.0
55,40,40,65,45,35,280,0.16428571428571428,123,100,62,97,81,68,531,0.4806201550387597,0.5
70,85,140,85,70,20,470,0.272,70,55,65,95,85,70,440,0.5307692307692308,0.5
45,60,30,80,50,65,330,0.4603174603174603,60,80,95,70,85,50,440,0.2231404958677686,2.0
35,60,44,40,54,55,288,0.366412213740458,44,58,44,58,44,61,309,0.41964285714285715,1.0
100,123,75,57,75,80,510,0.6923076923076923,70,20,50,20,50,40,250,0.1557377049180328,1.0
85,97,66,105,66,65,484,0.47107438016528924,85,50,95,120,115,80,545,0.5793650793650794,1.0
55,50,40,40,40,75,300,0.5945945945945946,110,130,80,70,60,80,530,0.5862068965517241,1.0
100,110,90,85,90,60,535,0.47794117647058826,106,150,70,194,120,140,780,0.952,1.0
70,70,40,60,40,60,340,0.4247787610619469,62,77,62,50,42,65,358,0.4838709677419355,0.5
75,100,110,45,55,65,450,0.5333333333333333,100,150,120,120,100,90,680,0.6493506493506493,2.0
38,35,35,65,55,50,278,0.2647058823529412,80,185,115,40,105,75,600,0.6230769230769231,2.0
100,70,70,65,65,45,415,0.1897810218978102,70,80,65,90,65,85,455,0.578125,1.0
80,82,83,100,100,80,525,0.6742424242424242,50,30,55,65,55,20,275,0.13675213675213677,0.25
80,82,100,83,100,80,525,0.6821705426356589,67,89,116,79,116,33,500,0.2624113475177305,0.5
40,30,30,40,50,30,220,0.07936507936507936,62,48,54,63,60,68,355,0.5178571428571429,1.0
85,76,64,45,55,90,415,0.6739130434782609,80,70,65,80,120,100,515,0.8034188034188035,1.0
65,95,100,60,50,50,420,0.34959349593495936,55,40,40,65,45,35,280,0.16428571428571428,1.0
60,85,60,85,60,55,405,0.3673469387755102,75,125,70,125,70,115,580,0.9037037037037037,0.5
78,92,75,74,63,118,500,0.8842975206611571,110,80,90,95,90,65,530,0.5033557046979866,2.0
65,83,57,95,85,105,490,0.8914728682170543,61,72,57,55,55,65,365,0.3984375,1.0
66,65,48,62,57,52,350,0.36220472440944884,95,75,180,130,80,30,590,0.13793103448275862,2.0
86,68,72,109,66,106,507,0.8099173553719008,100,50,50,76,96,70,442,0.5,1.0
75,80,60,65,90,102,472,0.8625954198473282,50,35,55,25,25,15,205,0.021739130434782608,1.0
97,165,60,65,50,58,495,0.3902439024390244,89,124,80,55,80,55,483,0.5714285714285714,0.5
70,94,50,94,50,66,424,0.48148148148148145,95,110,80,70,80,50,485,0.37209302325581395,1.0
50,150,50,150,50,150,600,0.9339622641509434,100,103,75,120,75,127,600,0.940677966101695,1.0
78,84,78,109,85,100,534,0.8620689655172413,90,30,15,40,20,15,210,0.043478260869565216,1.0
50,150,50,150,50,150,600,0.9339622641509434,60,110,70,60,60,100,460,0.8461538461538461,1.0
44,48,65,50,64,43,314,0.1623931623931624,105,95,75,85,75,74,509,0.5714285714285714,1.0
60,65,80,170,95,130,600,0.8625954198473282,72,105,115,54,86,68,500,0.5149253731343284,0.5
85,100,122,58,75,54,494,0.3939393939393939,120,100,85,30,85,45,465,0.22448979591836735,1.0
75,70,90,70,105,80,490,0.656,70,95,85,55,65,70,440,0.5,0.5
50,85,40,85,40,35,335,0.1746031746031746,80,100,123,122,120,80,625,0.56,0.25
40,60,30,31,31,70,262,0.4492753623188406,45,100,45,45,45,10,290,0.2949640287769784,1.0
28,25,25,45,35,40,198,0.16083916083916083,50,65,107,105,107,86,520,0.6991150442477876,0.5
75,75,55,105,85,30,425,0.1619718309859155,40,30,35,50,70,55,280,0.28205128205128205,0.25
45,85,70,40,40,60,340,0.5229357798165137,130,70,35,70,35,60,400,0.4017857142857143,0.5
48,72,48,72,48,48,336,0.25984251968503935,60,150,50,150,50,60,520,0.5,0.5
90,120,120,60,60,50,500,0.35294117647058826,65,125,60,95,60,105,510,0.9236641221374046,1.0
55,40,40,65,45,35,280,0.16428571428571428,48,72,48,72,48,48,336,0.25984251968503935,1.0
40,40,50,30,30,30,220,0.0873015873015873,95,75,80,100,110,30,490,0.24242424242424243,2.0
80,75,150,75,150,50,580,0.30973451327433627,80,50,100,100,200,50,580,0.2357142857142857,2.0
100,120,100,150,120,90,680,0.728,71,73,88,120,89,59,500,0.43537414965986393,0.5
40,30,30,40,50,30,220,0.07936507936507936,50,35,55,25,25,15,205,0.05263157894736842,0.5
71,73,88,120,89,59,500,0.43537414965986393,44,50,91,24,86,10,305,0.1981981981981982,0.5
150,80,44,90,54,80,498,0.625,63,63,47,41,41,74,329,0.56,0.5
80,80,50,40,50,25,325,0.176056338028169,100,110,90,85,90,60,535,0.47794117647058826,0.5
65,90,50,85,45,55,390,0.371900826446281,75,80,55,25,35,35,305,0.18666666666666668,1.0
60,85,40,30,45,68,328,0.6422018348623854,75,98,63,98,63,101,498,0.889763779527559,2.0
40,45,65,100,120,90,460,0.5588235294117647,70,55,55,80,60,45,365,0.2222222222222222,1.0
91,90,129,90,72,108,580,0.9140625,50,60,60,60,60,30,320,0.11290322580645161,0.25
50,65,107,105,107,86,520,0.7758620689655172,70,100,70,105,75,40,460,0.23214285714285715,0.0
75,95,67,125,95,83,540,0.7117117117117117,86,76,86,116,56,95,515,0.7982456140350878,2.0
90,60,60,40,40,40,330,0.29545454545454547,70,85,70,60,70,50,405,0.28378378378378377,1.0
70,60,125,115,70,55,495,0.35507246376811596,65,60,110,130,95,65,525,0.47761194029850745,2.0
53,54,53,37,46,45,288,0.3090909090909091,70,75,60,105,60,105,475,0.88,1.0
75,87,63,87,63,98,473,0.865546218487395,50,50,150,50,150,50,500,0.2571428571428571,1.0
70,60,62,80,82,60,414,0.4375,65,76,84,54,96,105,480,0.9008264462809917,1.0
90,132,105,132,105,30,594,0.4246575342465753,95,75,110,100,80,30,490,0.15267175572519084,1.0
100,180,160,150,90,90,770,0.7520661157024794,61,90,45,50,50,160,456,0.9230769230769231,0.0
95,100,85,108,70,70,528,0.5652173913043478,108,170,115,120,95,92,700,0.7083333333333334,1.0
45,75,37,70,55,83,365,0.6183206106870229,55,50,40,40,40,75,300,0.5945945945945946,1.0
50,60,45,100,80,65,400,0.45689655172413796,40,55,30,30,30,60,245,0.43548387096774194,0.5
75,38,38,56,56,67,330,0.5263157894736842,90,130,80,65,85,55,505,0.4396551724137931,1.0
65,80,80,59,63,58,405,0.4411764705882353,64,88,50,88,50,106,446,0.9111111111111111,1.0
20,10,55,15,20,80,200,0.17985611510791366,70,62,67,55,55,56,365,0.38513513513513514,1.0
45,55,45,65,45,75,330,0.5692307692307692,60,65,60,130,75,110,500,0.7719298245614035,1.0
60,115,105,65,70,80,495,0.7181818181818181,40,45,35,40,40,90,290,0.65,1.0
68,72,78,38,42,32,330,0.23809523809523808,35,40,100,90,55,35,355,0.1796875,2.0
44,58,44,58,44,61,309,0.41964285714285715,50,53,48,53,48,64,316,0.4076923076923077,2.0
73,100,60,100,60,65,458,0.42657342657342656,62,48,54,63,60,68,355,0.5178571428571429,1.0
65,63,45,45,45,45,308,0.2595419847328244,65,60,110,130,95,65,525,0.47761194029850745,2.0
100,150,110,95,110,70,635,0.5923076923076923,62,48,66,59,57,49,341,0.33884297520661155,1.0
65,65,65,50,50,90,385,0.72,50,75,45,40,45,60,315,0.4380165289256198,1.0
40,30,50,55,55,100,330,0.584070796460177,40,55,80,35,60,30,300,0.15037593984962405,1.0
50,75,75,65,65,50,380,0.4049586776859504,55,45,45,25,25,15,210,0.048,1.0
80,70,70,90,100,70,480,0.5609756097560976,74,94,131,54,116,20,489,0.4485294117647059,0.125
20,40,90,30,90,25,295,0.11363636363636363,31,45,90,30,30,40,266,0.21929824561403508,1.0
35,55,40,50,50,90,320,0.6838235294117647,100,134,110,95,100,61,600,0.4057971014492754,1.0
40,45,40,62,60,60,307,0.33884297520661155,35,65,35,65,35,65,300,0.46621621621621623,0.5
86,81,97,81,107,43,495,0.203125,68,90,65,50,55,82,410,0.6165413533834586,0.5
40,80,100,30,30,20,300,0.11851851851851852,50,75,35,70,30,40,300,0.21296296296296297,1.0
50,25,28,45,55,15,218,0.0625,55,65,35,60,30,85,330,0.6126126126126126,1.0
64,88,50,88,50,106,446,0.9111111111111111,45,63,37,65,55,95,360,0.8055555555555556,1.0
70,55,65,95,85,70,440,0.5307692307692308,70,62,67,55,55,56,365,0.38513513513513514,2.0
125,58,58,76,76,67,460,0.515625,43,70,48,50,60,38,309,0.2391304347826087,0.25
65,70,60,65,65,115,440,0.8583333333333333,91,72,90,129,90,108,580,0.8620689655172413,1.0
50,95,180,85,45,70,525,0.5298507462686567,30,42,118,42,88,30,350,0.112,1.0
85,70,80,97,80,123,535,0.9304347826086956,55,20,35,20,45,75,250,0.37681159420289856,1.0
60,40,60,95,60,55,370,0.4222222222222222,91,90,129,90,72,108,580,0.9140625,2.0
65,136,94,54,96,135,580,0.9612403100775194,60,50,40,85,75,95,405,0.7540983606557377,1.0
45,100,45,45,45,10,290,0.2949640287769784,58,50,145,95,105,30,483,0.2459016393442623,1.0
79,100,80,110,90,121,580,0.968,30,35,30,100,35,80,310,0.4765625,1.0
60,62,80,63,80,60,405,0.4336283185840708,30,35,30,100,35,80,310,0.4765625,0.5
20,10,230,10,230,5,505,0.0,40,65,40,80,40,65,330,0.5038167938931297,2.0
103,60,126,80,126,50,545,0.36363636363636365,91,129,90,72,90,108,580,0.8536585365853658,1.0
30,45,135,45,90,30,375,0.09285714285714286,120,100,85,30,85,45,465,0.22448979591836735,0.5
75,95,95,95,95,85,540,0.6470588235294118,60,90,140,50,50,40,430,0.2535211267605634,1.0
50,105,79,35,110,76,455,0.6214285714285714,70,80,50,35,35,35,305,0.14,1.0
40,35,30,120,70,105,400,0.6692307692307692,54,66,70,44,55,46,335,0.4214876033057851,1.0
45,49,49,65,65,45,318,0.2781954887218045,38,41,40,50,65,65,299,0.4108527131782946,0.5
51,65,65,80,75,59,395,0.4365079365079365,105,180,100,180,100,115,780,0.9477611940298507,4.0
80,120,70,110,70,80,530,0.6422764227642277,60,85,42,85,42,91,405,0.8227848101265823,1.0
35,35,40,35,55,50,250,0.40336134453781514,46,87,60,30,40,57,320,0.37777777777777777,0.5
70,60,125,115,70,55,495,0.35507246376811596,70,80,65,90,65,85,455,0.578125,1.0
40,55,30,30,30,85,270,0.688,38,35,35,65,55,50,278,0.2647058823529412,1.0
50,65,107,105,107,86,520,0.7758620689655172,66,65,48,62,57,52,350,0.36220472440944884,0.25
44,38,39,61,79,42,303,0.2251655629139073,105,30,105,140,105,55,540,0.3524590163934426,0.5
30,65,100,45,25,40,305,0.1891891891891892,40,60,30,31,31,70,262,0.4492753623188406,1.0
65,130,60,95,110,65,525,0.5303030303030303,45,50,35,55,75,40,300,0.21367521367521367,0.5
50,95,95,35,110,70,455,0.5179856115107914,60,67,85,77,75,116,480,0.8888888888888888,0.5
38,35,40,27,25,35,200,0.08208955223880597,45,22,60,27,30,29,213,0.07518796992481203,1.0
65,125,100,60,70,70,490,0.6099290780141844,44,38,33,61,43,70,289,0.5267857142857143,0.5
90,120,120,60,60,50,500,0.35294117647058826,70,84,70,65,70,51,410,0.2949640287769784,2.0
75,75,75,125,95,40,485,0.15671641791044777,59,110,150,45,49,35,448,0.3333333333333333,0.5
60,65,80,170,95,130,600,0.8625954198473282,85,105,100,79,83,78,530,0.5869565217391305,1.0
90,60,70,75,70,45,410,0.23880597014925373,60,85,69,60,69,77,420,0.518796992481203,1.0
64,78,52,78,52,81,405,0.6422764227642277,123,100,62,97,81,68,531,0.4806201550387597,2.0
45,60,30,80,50,65,330,0.4603174603174603,35,85,45,35,35,75,310,0.6492537313432836,1.0
50,20,55,25,25,30,205,0.09774436090225563,108,170,115,120,95,92,700,0.7083333333333334,1.0
70,150,140,65,100,75,600,0.55,100,100,100,100,100,100,600,0.8778625954198473,0.5
46,57,40,40,40,50,273,0.25,48,61,40,61,40,50,300,0.2543859649122807,0.5
55,40,85,80,105,40,405,0.23622047244094488,90,110,80,100,80,95,555,0.7982456140350878,0.5
75,87,63,87,63,98,473,0.865546218487395,59,66,70,44,55,41,335,0.25190839694656486,1.0
108,130,95,80,85,102,600,0.7637795275590551,25,35,70,95,55,45,325,0.16783216783216784,2.0
165,75,80,40,45,65,470,0.5151515151515151,43,70,48,50,60,38,309,0.2391304347826087,0.5
55,95,115,45,45,35,390,0.2116788321167883,90,70,80,70,95,70,475,0.5190839694656488,2.0
55,50,40,40,40,75,300,0.5945945945945946,105,95,80,40,80,90,490,0.753968253968254,1.0
60,60,50,40,50,75,335,0.5882352941176471,80,100,80,80,80,100,520,0.9051724137931034,1.0
105,125,100,60,100,100,590,0.8359375,60,110,70,60,60,100,460,0.8461538461538461,1.0
41,64,45,50,50,50,300,0.36752136752136755,45,67,60,35,50,63,320,0.5128205128205128,1.0
70,120,65,45,85,125,510,0.9747899159663865,75,125,70,125,70,115,580,0.9037037037037037,2.0
70,70,70,70,70,70,420,0.5289256198347108,50,65,107,105,107,86,520,0.7758620689655172,1.0
45,49,65,49,65,45,318,0.275,70,20,50,20,50,40,250,0.1557377049180328,2.0
45,35,45,62,53,35,275,0.11851851851851852,90,92,75,92,85,60,494,0.49586776859504134,0.5
85,110,76,65,82,56,474,0.3933333333333333,68,75,53,83,113,60,452,0.45384615384615384,0.5
95,110,80,70,80,50,485,0.37209302325581395,25,35,70,95,55,45,325,0.16783216783216784,0.5
130,85,80,85,95,60,535,0.43884892086330934,123,77,72,99,92,58,521,0.4621212121212121,1.0
38,35,40,27,25,35,200,0.08208955223880597,38,36,38,32,36,57,237,0.3893805309734513,1.0
1,90,45,30,30,40,236,0.33064516129032256,50,120,53,35,110,87,455,0.640625,0.5
50,95,90,95,90,180,600,0.9172413793103448,68,65,65,125,115,80,518,0.6461538461538462,0.5
62,50,58,73,54,72,369,0.4435483870967742,50,72,35,35,35,65,292,0.5373134328358209,1.0
35,64,85,74,55,32,345,0.19827586206896552,45,90,20,65,20,65,305,0.5116279069767442,0.5
80,160,60,170,130,80,680,0.6180555555555556,20,40,15,35,35,60,205,0.34285714285714286,1.0
95,65,65,110,130,60,525,0.4016393442622951,70,55,95,95,110,65,490,0.48872180451127817,1.0
50,50,50,50,50,50,300,0.30708661417322836,103,60,126,80,126,50,545,0.36363636363636365,1.0
49,55,42,42,37,85,310,0.6068376068376068,91,129,90,72,90,108,580,0.8536585365853658,0.5
110,80,90,95,90,65,530,0.5033557046979866,95,145,130,120,90,120,700,0.9398496240601504,2.0
78,84,78,109,85,100,534,0.8620689655172413,60,85,42,85,42,91,405,0.8227848101265823,1.0
68,65,65,125,115,80,518,0.6461538461538462,75,110,110,110,105,80,590,0.656934306569343,2.0
90,65,65,40,40,15,315,0.19672131147540983,85,100,122,58,75,54,494,0.3939393939393939,0.5
95,155,109,70,130,81,640,0.6788321167883211,115,45,20,45,25,20,270,0.11538461538461539,0.5
40,45,35,30,40,55,245,0.3793103448275862,70,65,60,90,75,90,450,0.6571428571428571,1.0
85,105,55,85,50,115,495,0.9032258064516129,65,136,94,54,96,135,580,0.9612403100775194,1.0
55,35,50,55,110,85,390,0.6277372262773723,65,130,60,95,110,65,525,0.5303030303030303,0.5
80,50,100,100,200,50,580,0.2357142857142857,50,65,107,105,107,86,520,0.703125,0.5
60,90,70,60,120,40,440,0.27419354838709675,49,49,56,49,61,66,330,0.5190839694656488,1.0
65,80,80,59,63,58,405,0.4411764705882353,40,30,35,45,40,55,245,0.31496062992125984,0.5
70,60,75,110,75,90,480,0.7165354330708661,70,110,75,145,85,145,630,0.9444444444444444,0.25
50,50,40,50,40,64,294,0.45588235294117646,100,110,90,85,90,60,535,0.47794117647058826,1.0
40,40,55,40,70,55,300,0.40939597315436244,106,150,70,194,120,140,780,0.952,0.5
60,150,50,150,50,60,520,0.5,70,75,60,105,60,105,475,0.88,0.5
55,69,85,32,35,28,304,0.09302325581395349,31,45,90,30,30,40,266,0.21929824561403508,2.0
135,85,40,40,85,5,390,0.6864406779661016,55,95,115,45,45,35,390,0.2116788321167883,0.5
110,78,73,76,71,60,468,0.3333333333333333,50,75,45,40,45,60,315,0.4380165289256198,0.5
45,50,55,75,65,30,320,0.06293706293706294,1,90,45,30,30,40,236,0.33064516129032256,0.25
123,100,62,97,81,68,531,0.4806201550387597,100,150,90,180,160,90,770,0.7348484848484849,2.0
75,85,200,55,65,30,510,0.16778523489932887,60,62,63,80,80,60,405,0.38016528925619836,1.0
90,60,60,40,40,40,330,0.29545454545454547,110,65,75,125,85,30,490,0.15,1.0
40,40,40,70,40,20,250,0.032520325203252036,30,30,42,30,42,70,244,0.4230769230769231,2.0
55,55,55,85,55,30,335,0.1320754716981132,45,35,45,62,53,35,275,0.11851851851851852,1.0
70,90,90,135,90,125,600,0.9401709401709402,70,20,50,20,50,40,250,0.1557377049180328,0.5
60,50,70,80,80,140,480,0.8449612403100775,150,120,100,120,100,90,680,0.664179104477612,0.5
