First_pokemon_HP,First_pokemon_ATK,First_pokemon_DEF,First_pokemon_SP_ATK,First_pokemon_DP_DEF,First_pokemon_Speed,First_pokemon_STATS_SUM,First_pokemon_RATIO,Second_pokemon_HP,Second_pokemon_ATK,Second_pokemon_DEF,Second_pokemon_SP_ATK,Second_pokemon_DP_DEF,Second_pokemon_Speed,Second_pokemon_STATS_SUM,Second_pokemon_RATIO,Relation
75,98,63,98,63,101,498,0.849624060150376,105,180,100,180,100,115,780,0.9477611940298507,0.5
45,30,50,65,50,45,285,0.13821138211382114,78,84,78,109,85,100,534,0.8620689655172413,1.0
65,60,70,85,75,40,395,0.1796875,95,117,80,65,70,92,519,0.8409090909090909,1.0
60,130,80,60,60,70,460,0.5153846153846153,45,22,60,27,30,29,213,0.07518796992481203,0.25
60,30,30,36,56,50,262,0.32432432432432434,73,95,62,85,65,85,465,0.6666666666666666,1.0
76,65,45,92,42,91,411,0.7449664429530202,55,20,35,20,45,75,250,0.37681159420289856,1.0
100,100,100,100,100,100,600,0.8758169934640523,45,35,50,70,50,30,280,0.15753424657534246,1.0
76,104,71,104,71,108,534,0.912751677852349,70,80,65,90,65,85,455,0.578125,1.0
55,70,55,40,55,85,360,0.7073170731707317,60,80,50,40,40,30,300,0.15328467153284672,1.0
75,90,90,140,90,115,600,0.9481481481481482,65,150,60,115,60,115,565,0.935251798561151,0.5
70,40,50,55,50,25,290,0.061068702290076333,60,50,40,85,75,95,405,0.7540983606557377,1.0
85,110,90,45,90,80,500,0.6206896551724138,100,5,5,15,65,30,220,0.07692307692307693,1.0
58,109,112,48,48,109,484,0.8805970149253731,69,55,45,55,55,15,294,0.11666666666666667,1.0
130,85,80,85,95,60,535,0.43884892086330934,114,85,70,85,80,30,464,0.2066115702479339,1.0
65,80,65,35,65,60,370,0.38405797101449274,60,85,60,50,50,125,430,0.9090909090909091,1.0
50,53,62,58,63,44,330,0.13709677419354838,60,45,70,75,85,55,390,0.3008130081300813,1.0
90,90,85,125,90,100,580,0.768595041322314,75,75,60,83,60,60,413,0.39344262295081966,2.0
50,65,64,44,48,43,314,0.2196969696969697,80,160,60,170,130,80,680,0.6180555555555556,1.0
71,82,64,64,59,112,452,0.9327731092436975,50,70,50,50,50,70,340,0.5645161290322581,1.0
72,85,70,65,70,58,420,0.41304347826086957,109,66,84,81,99,32,471,0.2013888888888889,1.0
90,132,105,132,105,30,594,0.4246575342465753,70,120,40,95,40,95,460,0.8106060606060606,1.0
85,56,77,50,77,78,423,0.53125,60,75,100,55,80,50,420,0.3088235294117647,1.0
70,105,105,50,40,20,390,0.33587786259541985,40,30,30,40,50,30,220,0.07936507936507936,1.0
65,125,60,95,60,105,510,0.9236641221374046,50,85,85,55,55,50,380,0.3902439024390244,1.0
106,90,130,90,154,110,680,0.8699186991869918,78,104,78,159,115,100,634,0.8444444444444444,1.0
50,55,50,36,30,43,264,0.2922077922077922,64,66,68,81,76,50,405,0.25190839694656486,1.0
70,55,75,45,65,60,370,0.45901639344262296,50,50,120,80,80,30,410,0.07258064516129033,0.5
40,40,50,30,30,30,220,0.0873015873015873,61,90,45,50,50,160,456,0.9230769230769231,0.25
70,80,65,90,65,85,455,0.578125,126,131,95,131,98,99,680,0.8294573643410853,1.0
70,100,70,105,75,40,460,0.23214285714285715,50,95,95,35,110,70,455,0.5179856115107914,1.0
100,120,100,150,120,90,680,0.728,90,110,80,100,80,95,555,0.7982456140350878,0.5
50,50,120,80,80,30,410,0.07258064516129033,75,110,110,110,105,80,590,0.656934306569343,0.5
78,92,75,74,63,118,500,0.8842975206611571,78,52,60,63,65,23,341,0.06015037593984962,0.5
75,75,95,75,95,113,528,0.9015151515151515,65,90,40,45,80,75,395,0.625,0.25
39,52,43,60,50,65,309,0.49107142857142855,120,100,85,30,85,45,465,0.22448979591836735,1.0
78,104,78,159,115,100,634,0.8444444444444444,100,100,100,100,100,100,600,0.8805970149253731,0.5
95,100,85,108,70,70,528,0.5652173913043478,80,160,80,130,80,100,630,0.8455284552845529,2.0
90,100,70,110,150,80,600,0.6037735849056604,60,150,50,150,50,60,520,0.5,0.5
100,73,83,73,83,55,467,0.371900826446281,65,50,35,115,95,95,455,0.7333333333333333,1.0
78,65,68,112,154,75,552,0.628099173553719,105,180,100,180,100,115,780,0.9477611940298507,2.0
50,105,79,35,110,76,455,0.6214285714285714,50,85,40,85,40,35,335,0.1746031746031746,1.0
50,70,160,70,160,90,600,0.7417218543046358,60,69,95,69,95,36,424,0.2608695652173913,0.5
45,50,45,115,55,95,405,0.6936936936936937,110,80,90,95,90,65,530,0.5033557046979866,1.0
95,75,180,130,80,30,590,0.13793103448275862,75,75,95,75,95,113,528,0.9015151515151515,0.5
40,60,40,40,40,30,250,0.0948905109489051,43,70,48,50,60,38,309,0.2391304347826087,1.0
91,134,95,100,100,80,600,0.6304347826086957,90,60,70,75,70,45,410,0.23880597014925373,1.0
82,121,119,69,59,71,521,0.5394736842105263,99,68,83,72,87,51,460,0.417910447761194,2.0
50,95,95,35,110,70,455,0.5179856115107914,95,75,80,100,110,30,490,0.24242424242424243,0.5
72,105,115,54,86,68,500,0.5149253731343284,45,49,65,49,65,45,318,0.275,0.5
78,130,111,130,85,100,634,0.8561151079136691,50,95,95,35,110,70,455,0.5179856115107914,1.0
100,90,130,45,65,55,485,0.4253731343283582,110,85,95,80,95,50,515,0.2713178294573643,1.0
75,95,125,45,75,95,510,0.8257575757575758,60,55,145,75,150,40,525,0.2,1.0
10,55,25,35,45,95,265,0.5396825396825397,79,105,70,145,80,101,580,0.8608695652173913,0.0
70,55,55,80,60,45,365,0.2222222222222222,40,30,35,45,40,55,245,0.31496062992125984,1.0
50,60,45,100,80,65,400,0.45689655172413796,104,91,63,91,73,68,490,0.5118110236220472,1.0
90,100,90,125,85,90,580,0.7352941176470589,80,70,70,90,100,70,480,0.5609756097560976,2.0
68,85,65,165,135,100,618,0.8083333333333333,50,20,55,25,25,30,205,0.09774436090225563,1.0
55,85,122,58,75,99,494,0.8099173553719008,75,87,63,87,63,98,473,0.865546218487395,1.0
123,77,72,99,92,58,521,0.4621212121212121,70,110,75,145,85,145,630,0.9444444444444444,4.0
73,76,75,81,100,100,505,0.8110236220472441,50,20,40,20,40,20,190,0.0962962962962963,1.0
70,130,100,55,80,65,500,0.608,110,85,95,80,95,50,515,0.2713178294573643,1.0
60,50,40,85,75,95,405,0.7540983606557377,54,45,47,75,98,52,371,0.39669421487603307,1.0
50,65,107,105,107,86,520,0.6991150442477876,73,100,60,100,60,65,458,0.42657342657342656,1.0
100,50,50,76,96,70,442,0.5,100,100,125,110,50,50,535,0.384,2.0
110,78,73,76,71,60,468,0.3333333333333333,60,60,60,35,35,30,280,0.11194029850746269,1.0
35,70,55,45,55,25,285,0.09420289855072464,100,100,100,100,100,100,600,0.8345864661654135,2.0
60,100,85,80,85,100,510,0.7007874015748031,80,115,80,65,55,93,488,0.7846153846153846,1.0
60,67,85,77,75,116,480,0.8888888888888888,75,85,200,55,65,30,510,0.16778523489932887,0.5
70,90,70,60,60,70,420,0.6390977443609023,115,140,130,55,55,40,535,0.4519230769230769,1.0
77,120,90,60,90,48,485,0.2785714285714286,75,90,90,140,90,115,600,0.9481481481481482,1.0
85,105,85,40,50,40,405,0.211864406779661,90,120,120,60,60,50,500,0.35294117647058826,1.0
60,62,80,63,80,60,405,0.4336283185840708,55,40,50,65,85,40,335,0.3181818181818182,2.0
60,45,70,45,90,95,405,0.7304964539007093,35,60,44,40,54,55,288,0.366412213740458,1.0
60,50,100,85,70,65,430,0.47580645161290325,65,125,100,60,70,70,490,0.6099290780141844,0.5
85,56,77,50,77,78,423,0.53125,65,80,80,59,63,58,405,0.4411764705882353,1.0
50,50,40,30,30,50,250,0.2781954887218045,55,40,85,80,105,40,405,0.23622047244094488,0.0
80,110,60,150,130,70,600,0.5042016806722689,45,85,50,55,50,65,350,0.5076923076923077,1.0
35,80,50,50,70,120,405,0.84375,65,95,100,60,50,50,420,0.34959349593495936,1.0
45,35,45,62,53,35,275,0.11851851851851852,68,65,65,125,115,80,518,0.6461538461538462,1.0
80,120,130,55,65,45,495,0.37037037037037035,80,70,70,90,100,70,480,0.5609756097560976,0.5
65,60,110,130,95,65,525,0.47761194029850745,70,95,125,65,75,45,475,0.33613445378151263,1.0
65,47,55,73,75,85,400,0.65,65,155,120,65,90,105,600,0.8677685950413223,0.5
54,63,52,83,56,97,405,0.7697841726618705,73,95,62,85,65,85,465,0.6666666666666666,1.0
60,40,50,75,85,95,405,0.6044776119402985,40,80,100,30,30,20,300,0.11851851851851852,0.0
75,125,70,125,70,115,580,0.9037037037037037,75,75,130,75,130,95,580,0.7479674796747967,0.5
95,100,85,108,70,70,528,0.5652173913043478,40,20,30,40,80,55,265,0.22764227642276422,1.0
68,90,65,50,55,82,410,0.6165413533834586,95,80,105,40,70,100,490,0.8046875,1.0
75,89,85,55,65,36,405,0.29545454545454547,55,130,115,50,50,75,475,0.5982142857142857,2.0
100,128,90,77,77,128,600,0.959349593495935,64,66,68,81,76,50,405,0.25190839694656486,1.0
55,35,50,55,110,85,390,0.6277372262773723,69,55,45,55,55,15,294,0.11666666666666667,2.0
65,83,57,95,85,105,490,0.8914728682170543,80,105,105,105,105,80,580,0.5939849624060151,1.0
50,75,35,70,30,40,300,0.21296296296296297,75,70,90,70,105,80,490,0.656,0.25
105,140,95,55,65,45,505,0.3,60,75,85,100,85,115,520,0.8992248062015504,0.5
64,66,68,81,76,50,405,0.25190839694656486,65,80,140,40,70,70,465,0.5223880597014925,1.0
65,95,75,55,55,85,430,0.6933333333333334,95,95,85,125,65,55,520,0.3894736842105263,1.0
72,58,80,103,80,97,490,0.7171052631578947,45,67,60,35,50,63,320,0.5128205128205128,1.0
20,10,230,10,230,5,505,0.0,135,85,40,40,85,5,390,0.6864406779661016,1.0
65,65,60,110,95,130,525,0.9253731343283582,60,90,140,50,50,40,430,0.2535211267605634,1.0
55,85,55,50,55,60,360,0.4233576642335766,40,65,40,80,40,65,330,0.5038167938931297,2.0
60,50,40,85,75,95,405,0.7540983606557377,75,89,85,55,65,36,405,0.29545454545454547,0.5
60,75,85,100,85,115,520,0.8992248062015504,65,65,60,130,95,110,525,0.823943661971831,0.5
35,80,50,50,70,120,405,0.84375,60,100,115,70,85,90,520,0.7557251908396947,2.0
80,160,60,170,130,80,680,0.6180555555555556,135,85,40,40,85,5,390,0.6864406779661016,1.0
45,75,37,70,55,83,365,0.6183206106870229,55,81,60,50,70,97,413,0.7214285714285714,1.0
59,66,70,44,55,41,335,0.25190839694656486,75,75,95,75,95,113,528,0.9015151515151515,0.5
65,80,65,35,65,60,370,0.38405797101449274,165,75,80,40,45,65,470,0.5151515151515151,1.0
60,90,140,50,50,40,430,0.2535211267605634,73,115,60,60,60,90,458,0.6694915254237288,1.0
65,55,115,100,40,60,435,0.3798449612403101,55,68,64,45,55,31,318,0.11666666666666667,0.5
50,75,75,65,65,50,380,0.4049586776859504,55,45,50,45,65,80,340,0.5546218487394958,1.0
125,58,58,76,76,67,460,0.515625,70,120,100,145,105,20,560,0.2824427480916031,0.0
50,105,125,55,95,50,480,0.375886524822695,70,115,60,115,60,55,475,0.4647887323943662,2.0
50,20,55,25,25,30,205,0.09774436090225563,60,75,85,100,85,115,520,0.8992248062015504,2.0
45,30,15,85,65,65,305,0.36220472440944884,59,59,58,90,70,73,409,0.5826086956521739,0.5
70,110,70,115,70,90,525,0.75,45,50,55,75,65,30,320,0.06293706293706294,0.5
105,180,100,180,100,115,780,0.9477611940298507,115,115,85,90,75,100,580,0.8134328358208955,1.0
85,80,70,135,75,90,535,0.7006802721088435,89,145,90,105,80,91,600,0.8549618320610687,1.0
84,86,88,111,101,60,530,0.4634146341463415,110,65,105,55,95,80,510,0.6258503401360545,1.0
45,20,50,60,120,50,345,0.24074074074074073,45,60,40,70,50,45,310,0.2846715328467153,2.0
55,112,45,74,45,70,401,0.559322033898305,20,25,45,70,90,60,310,0.30833333333333335,1.0
70,55,95,95,110,65,490,0.48872180451127817,60,60,60,60,60,60,360,0.38095238095238093,1.0
50,53,48,53,48,64,316,0.4076923076923077,40,45,40,65,40,65,295,0.5661764705882353,1.0
65,95,75,55,55,85,430,0.6933333333333334,90,93,55,70,55,55,418,0.3819444444444444,2.0
50,50,40,50,40,64,294,0.45588235294117646,79,85,60,55,60,71,410,0.60431654676259,0.5
76,48,48,57,62,34,325,0.11688311688311688,55,70,55,40,55,85,360,0.7073170731707317,1.0
30,45,59,30,39,57,260,0.2803030303030303,40,80,100,30,30,20,300,0.11851851851851852,0.25
35,20,65,40,65,20,245,0.02459016393442623,45,53,70,40,60,42,310,0.25735294117647056,1.0
60,70,50,100,50,65,395,0.5217391304347826,57,24,86,24,86,23,300,0.12727272727272726,0.5
80,50,100,100,200,50,580,0.2357142857142857,50,65,107,105,107,86,520,0.7272727272727273,2.0
41,64,45,50,50,50,300,0.36752136752136755,70,100,115,30,65,30,410,0.24390243902439024,1.0
255,10,10,75,135,55,540,0.3125,65,75,90,97,123,44,494,0.1987179487179487,1.0
60,67,85,77,75,116,480,0.8888888888888888,40,30,32,50,52,65,269,0.3671875,1.0
80,75,150,75,150,50,580,0.30973451327433627,40,70,130,60,130,25,455,0.17355371900826447,1.0
70,70,40,60,40,60,340,0.4247787610619469,60,60,60,60,60,60,360,0.38095238095238093,1.0
66,117,70,40,50,67,410,0.4573643410852713,55,95,55,35,75,115,430,0.9380530973451328,1.0
71,120,95,120,95,99,600,0.8203125,70,80,70,80,70,110,480,0.6594202898550725,1.0
80,145,150,105,110,110,700,0.8692307692307693,72,60,30,20,30,25,237,0.11570247933884298,1.0
71,82,64,64,59,112,452,0.9327731092436975,65,70,60,65,65,115,440,0.8583333333333333,1.0
64,88,50,88,50,106,446,0.9111111111111111,91,72,90,129,90,108,580,0.8620689655172413,0.5
108,170,115,120,95,92,700,0.7083333333333334,35,55,40,45,40,60,275,0.35714285714285715,2.0
135,85,40,40,85,5,390,0.6864406779661016,78,130,111,130,85,100,634,0.8561151079136691,1.0
25,20,15,105,55,90,310,0.32407407407407407,60,30,30,36,56,50,262,0.32432432432432434,1.0
103,60,86,60,86,50,445,0.3458646616541353,91,134,95,100,100,80,600,0.6304347826086957,1.0
75,38,38,56,56,67,330,0.5263157894736842,100,103,75,120,75,127,600,0.940677966101695,0.5
78,70,61,50,61,100,420,0.8145161290322581,78,92,75,74,63,118,500,0.8842975206611571,1.0
50,55,50,36,30,43,264,0.2922077922077922,70,55,75,45,65,60,370,0.45901639344262296,1.0
50,85,85,55,55,50,380,0.3902439024390244,75,80,95,90,100,50,490,0.2158273381294964,1.0
60,80,95,70,85,50,440,0.2231404958677686,58,64,58,80,65,80,405,0.609271523178808,0.5
55,84,105,114,75,52,485,0.2890625,60,50,40,85,75,95,405,0.7540983606557377,1.0
65,85,70,75,70,40,405,0.203125,95,60,79,100,125,81,540,0.6201550387596899,2.0
35,45,160,30,45,70,385,0.48148148148148145,190,33,58,33,58,33,405,0.13432835820895522,1.0
60,45,70,75,85,55,390,0.3008130081300813,100,100,100,100,100,100,600,0.8602941176470589,1.0
150,160,100,95,65,100,670,0.8866666666666667,90,95,105,165,110,45,610,0.2890625,1.0
100,103,75,120,75,127,600,0.940677966101695,90,120,100,150,120,100,680,0.7718120805369127,1.0
50,72,35,35,35,65,292,0.5373134328358209,80,185,115,40,105,75,600,0.6230769230769231,0.25
85,105,85,40,50,40,405,0.211864406779661,109,66,84,81,99,32,471,0.2013888888888889,1.0
95,60,79,100,125,81,540,0.6201550387596899,75,140,65,112,65,110,567,0.9140625,2.0
100,100,100,100,100,100,600,0.8778625954198473,85,56,77,50,77,78,423,0.53125,2.0
70,80,65,90,65,85,455,0.578125,80,105,105,105,105,80,580,0.5939849624060151,0.5
61,90,45,50,50,160,456,0.9230769230769231,64,115,65,83,63,65,455,0.5323741007194245,0.5
45,22,60,27,30,29,213,0.07518796992481203,63,120,85,90,55,55,468,0.2809917355371901,2.0
75,80,55,25,35,35,305,0.18666666666666668,45,60,45,25,45,55,275,0.29,2.0
75,85,200,55,65,30,510,0.16778523489932887,60,25,35,70,80,60,330,0.3076923076923077,1.0
60,75,85,100,85,115,520,0.8992248062015504,30,56,35,25,35,72,253,0.48148148148148145,1.0
60,50,40,85,75,95,405,0.7540983606557377,50,85,125,85,115,20,480,0.4306569343065693,1.0
40,30,32,50,52,65,269,0.3671875,110,160,110,80,110,100,670,0.8591549295774648,1.0
80,80,80,80,80,80,480,0.6015037593984962,70,90,90,135,90,125,600,0.9401709401709402,1.0
70,110,70,115,70,90,525,0.75,65,70,60,65,65,115,440,0.8583333333333333,2.0
65,40,50,125,60,30,370,0.07258064516129033,75,98,63,98,63,101,498,0.8091603053435115,1.0
55,70,55,40,55,85,360,0.7073170731707317,60,50,150,50,150,60,520,0.5206611570247934,0.0
45,40,60,40,75,50,310,0.2926829268292683,65,90,65,61,61,100,442,0.8373983739837398,1.0
60,50,150,50,150,60,520,0.5206611570247934,66,41,77,61,87,23,355,0.12096774193548387,2.0
125,58,58,76,76,67,460,0.515625,79,115,70,125,80,111,580,0.864,1.0
70,60,125,115,70,55,495,0.35507246376811596,80,100,70,50,60,45,405,0.25806451612903225,0.5
90,110,80,100,80,95,555,0.7982456140350878,60,55,145,75,150,40,525,0.2,1.0
84,71,43,71,43,48,360,0.25874125874125875,40,80,35,35,45,70,305,0.4661016949152542,1.0
100,100,100,100,100,100,600,0.8345864661654135,38,35,40,27,25,35,200,0.08208955223880597,0.5
65,75,90,97,123,44,494,0.1987179487179487,100,100,90,150,140,90,670,0.71875,1.0
60,80,110,50,80,45,425,0.2833333333333333,38,41,40,50,65,65,299,0.4108527131782946,2.0
51,65,65,80,75,59,395,0.4365079365079365,30,65,100,45,25,40,305,0.1891891891891892,0.5
30,42,118,42,88,30,350,0.112,56,61,65,48,45,38,313,0.17567567567567569,1.0
70,110,180,60,60,50,530,0.4117647058823529,70,55,75,45,65,60,370,0.45901639344262296,2.0
35,65,35,65,35,65,300,0.46621621621621623,89,125,90,115,80,101,600,0.8725490196078431,2.0
104,91,63,91,73,68,490,0.5118110236220472,83,80,75,70,70,101,479,0.8615384615384616,1.0
60,55,50,40,55,45,305,0.22377622377622378,65,95,57,100,85,93,495,0.7441860465116279,0.5
50,52,48,65,50,55,320,0.33098591549295775,70,100,70,105,75,40,460,0.23214285714285715,4.0
40,35,30,20,20,50,195,0.23423423423423423,42,52,67,39,56,50,306,0.2868217054263566,0.5
55,45,50,45,65,80,340,0.5546218487394958,65,90,50,85,45,55,390,0.371900826446281,0.5
80,80,50,40,50,25,325,0.176056338028169,50,85,40,85,40,35,335,0.1746031746031746,2.0
75,100,110,45,55,65,450,0.5333333333333333,65,75,70,95,70,95,470,0.7272727272727273,0.0
40,80,35,35,45,70,305,0.4661016949152542,45,60,32,50,32,76,295,0.5925925925925926,1.0
45,49,65,49,65,45,318,0.275,85,73,70,73,115,67,483,0.5126050420168067,1.0
150,160,100,95,65,100,670,0.8866666666666667,105,105,75,65,100,50,500,0.37593984962406013,1.0
50,105,125,55,95,50,480,0.375886524822695,75,110,110,110,105,80,590,0.656934306569343,1.0
50,55,50,36,30,43,264,0.2922077922077922,35,65,35,65,35,65,300,0.46621621621621623,1.0
45,50,43,40,38,62,278,0.40441176470588236,58,50,145,95,105,30,483,0.2459016393442623,0.0
55,50,40,40,40,75,300,0.5945945945945946,68,65,65,125,115,80,518,0.6461538461538462,1.0
100,123,75,57,75,80,510,0.6923076923076923,57,80,91,80,87,75,470,0.5737704918032787,0.25
82,121,119,69,59,71,521,0.5394736842105263,100,70,70,65,65,45,415,0.1897810218978102,1.0
40,55,99,40,79,47,360,0.26262626262626265,60,82,45,45,45,74,351,0.5752212389380531,1.0
90,92,75,92,85,60,494,0.49586776859504134,65,76,84,54,96,105,480,0.9008264462809917,1.0
80,120,130,55,65,45,495,0.37037037037037035,50,92,108,92,108,35,485,0.2457627118644068,1.0
160,110,65,65,110,30,540,0.35714285714285715,110,135,60,50,65,88,508,0.7744360902255639,0.5
130,70,35,70,35,60,400,0.4017857142857143,90,60,60,40,40,40,330,0.29545454545454547,2.0
49,55,42,42,37,85,310,0.6068376068376068,85,56,77,50,77,78,423,0.53125,1.0
45,50,43,40,38,62,278,0.40441176470588236,65,125,100,55,70,85,500,0.6532258064516129,2.0
20,10,230,10,230,5,505,0.0,45,60,40,70,50,45,310,0.2846715328467153,1.0
70,130,100,55,80,65,500,0.608,55,65,95,95,45,85,440,0.6610169491525424,0.5
40,27,60,37,50,66,280,0.36220472440944884,123,100,62,97,81,68,531,0.4806201550387597,0.5
110,65,75,125,85,30,490,0.15,80,70,40,100,60,145,495,0.921875,1.0
50,50,77,95,77,91,440,0.5916666666666667,125,58,58,76,76,67,460,0.515625,1.0
70,94,50,94,50,66,424,0.48148148148148145,30,30,42,30,42,70,244,0.4230769230769231,1.0
100,134,110,95,100,61,600,0.4057971014492754,70,50,30,95,135,105,485,0.8040540540540541,2.0
83,80,80,135,80,121,579,0.9444444444444444,79,115,70,125,80,111,580,0.864,0.5
43,80,65,50,35,35,308,0.14193548387096774,100,123,75,57,75,80,510,0.6923076923076923,1.0
70,120,100,145,105,20,560,0.2824427480916031,100,70,70,65,65,45,415,0.1897810218978102,1.0
76,147,90,60,70,97,540,0.8267716535433071,55,81,60,50,70,97,413,0.7214285714285714,1.0
75,75,130,75,130,95,580,0.7479674796747967,55,45,45,25,25,15,210,0.048,2.0
90,100,90,125,85,90,580,0.7352941176470589,50,53,48,53,48,64,316,0.358974358974359,0.5
40,60,30,31,31,70,262,0.4492753623188406,65,90,50,85,45,55,390,0.371900826446281,2.0
49,55,42,42,37,85,310,0.6068376068376068,80,82,78,95,80,85,500,0.6869565217391305,1.0
69,69,76,69,86,91,460,0.6554621848739496,60,70,50,100,50,65,395,0.5217391304347826,1.0
37,25,41,25,41,25,194,0.08870967741935484,80,50,100,100,200,50,580,0.2357142857142857,1.0
110,130,80,70,60,80,530,0.5862068965517241,58,64,58,80,65,80,405,0.5423728813559322,1.0
35,60,44,40,54,55,288,0.366412213740458,50,25,28,45,55,15,218,0.0625,2.0
80,115,80,65,55,93,488,0.7846153846153846,80,120,70,110,70,80,530,0.6422764227642277,2.0
75,38,38,56,56,67,330,0.5263157894736842,86,76,86,116,56,95,515,0.7982456140350878,2.0
100,110,90,85,90,60,535,0.47794117647058826,68,75,53,83,113,60,452,0.45384615384615384,0.5
30,30,42,30,42,70,244,0.4230769230769231,110,160,110,80,110,100,670,0.8591549295774648,1.0
60,90,70,60,120,40,440,0.27419354838709675,60,82,45,45,45,74,351,0.5752212389380531,1.0
30,35,30,100,35,80,310,0.4765625,48,72,48,72,48,48,336,0.25984251968503935,2.0
70,150,140,65,100,75,600,0.55,60,115,105,65,70,80,495,0.7181818181818181,1.0
103,60,126,80,126,50,545,0.36363636363636365,106,190,100,154,100,130,780,0.9259259259259259,2.0
105,95,75,85,75,74,509,0.5714285714285714,72,85,70,65,70,58,420,0.41304347826086957,0.5
106,130,90,110,154,90,680,0.719626168224299,50,65,107,105,107,86,520,0.703125,1.0
44,58,44,58,44,61,309,0.41964285714285715,60,90,70,60,120,40,440,0.27419354838709675,1.0
60,62,80,63,80,60,405,0.4336283185840708,45,60,40,70,50,45,310,0.2846715328467153,0.5
55,65,35,60,30,85,330,0.6126126126126126,73,100,60,100,60,65,458,0.42657342657342656,1.0
74,100,72,90,72,46,454,0.24561403508771928,60,50,40,85,75,95,405,0.7540983606557377,1.0
70,120,40,95,40,95,460,0.8106060606060606,100,100,100,100,100,100,600,0.8758169934640523,2.0
60,40,60,95,60,55,370,0.4222222222222222,40,45,35,65,55,70,310,0.4482758620689655,2.0
75,87,63,87,63,98,473,0.865546218487395,80,110,120,130,90,70,600,0.6198347107438017,1.0
39,52,43,60,50,65,309,0.5041322314049587,70,120,40,95,40,95,460,0.8106060606060606,0.5
150,80,44,90,54,80,498,0.625,130,85,80,85,95,60,535,0.43884892086330934,1.0
35,55,35,30,30,35,220,0.23684210526315788,100,5,5,15,65,30,220,0.07692307692307693,1.0
76,65,45,92,42,91,411,0.7449664429530202,70,85,140,85,70,20,470,0.272,1.0
70,120,65,45,85,125,510,0.9747899159663865,126,131,95,131,98,99,680,0.8102189781021898,1.0
105,105,75,65,100,50,500,0.37593984962406013,80,70,40,100,60,145,495,0.921875,1.0
60,90,55,90,80,110,485,0.8677685950413223,70,90,45,15,45,50,315,0.3629032258064516,1.0
62,50,58,73,54,72,369,0.4435483870967742,65,65,65,50,50,90,385,0.72,0.5
30,35,30,100,35,80,310,0.4765625,108,170,115,120,95,92,700,0.7083333333333334,0.5
106,110,90,154,90,130,680,0.926829268292683,65,70,60,65,65,115,440,0.8583333333333333,1.0
40,55,30,30,30,85,270,0.688,30,65,100,45,25,40,305,0.1891891891891892,1.0
55,50,45,135,95,120,500,0.7714285714285715,65,65,60,110,95,130,525,0.9253731343283582,1.0
50,55,50,36,30,43,264,0.2922077922077922,73,95,62,85,65,85,465,0.6666666666666666,1.0
80,50,100,100,200,50,580,0.2357142857142857,100,120,120,150,100,90,680,0.7880794701986755,1.0
70,60,125,115,70,55,495,0.35507246376811596,68,125,65,65,115,80,518,0.6277372262773723,0.5
110,78,73,76,71,60,468,0.3333333333333333,95,145,130,120,90,120,700,0.9398496240601504,0.0
50,95,90,95,90,180,600,0.9172413793103448,72,60,30,20,30,25,237,0.11570247933884298,1.0
90,120,120,60,60,50,500,0.35294117647058826,40,30,32,50,52,65,269,0.3671875,0.5
43,70,48,50,60,38,309,0.2391304347826087,91,90,72,90,129,108,580,0.896,0.5
50,95,180,85,45,70,525,0.5298507462686567,125,120,90,170,100,95,700,0.78125,0.5
78,104,78,159,115,100,634,0.8444444444444444,65,130,60,95,110,65,525,0.5303030303030303,0.5
55,75,85,25,25,15,280,0.1875,125,120,90,170,100,95,700,0.78125,2.0
30,30,30,30,30,30,180,0.12612612612612611,44,75,35,63,33,45,295,0.2647058823529412,1.0
101,72,72,99,89,29,462,0.1937984496124031,75,100,66,60,66,115,482,0.918918918918919,1.0
65,130,60,75,60,75,465,0.689922480620155,70,45,48,60,65,35,323,0.15748031496062992,0.5
55,66,44,44,56,85,350,0.6888888888888889,85,90,80,70,80,130,535,0.9262295081967213,1.0
63,60,55,50,50,71,349,0.5289256198347108,43,70,48,50,60,38,309,0.2391304347826087,0.0
78,52,60,63,65,23,341,0.06015037593984962,40,40,55,40,70,55,300,0.40939597315436244,1.0
90,120,100,150,120,100,680,0.7718120805369127,50,47,50,57,50,65,319,0.463768115942029,1.0
70,85,65,105,85,120,530,0.9262295081967213,65,60,110,130,95,65,525,0.47761194029850745,1.0
79,105,70,145,80,101,580,0.8608695652173913,70,45,48,60,65,35,323,0.15748031496062992,1.0
100,180,160,150,90,90,770,0.7520661157024794,55,45,50,45,65,80,340,0.5546218487394958,0.0
45,55,39,35,39,42,255,0.18518518518518517,75,100,66,60,66,115,482,0.918918918918919,1.0
85,90,80,70,80,130,535,0.9262295081967213,50,120,53,35,110,87,455,0.640625,2.0
75,65,55,65,55,69,384,0.43548387096774194,80,120,79,95,79,70,523,0.5833333333333334,2.0
60,105,60,120,60,105,510,0.8849557522123894,30,105,90,25,25,50,325,0.2773722627737226,1.0
55,55,45,63,45,45,308,0.25,68,90,65,50,55,82,410,0.6165413533834586,1.0
95,124,78,69,71,58,495,0.37398373983739835,79,103,120,135,115,78,630,0.5763888888888888,1.0
70,20,50,20,50,40,250,0.1557377049180328,70,110,180,60,60,50,530,0.4117647058823529,1.0
55,63,90,50,80,42,380,0.21138211382113822,90,120,100,150,120,100,680,0.7718120805369127,1.0
91,90,72,90,129,108,580,0.896,51,65,65,80,75,59,395,0.4365079365079365,2.0
40,30,30,55,30,85,270,0.4666666666666667,70,75,80,135,80,135,575,0.917910447761194,0.5
170,90,45,90,45,60,500,0.427536231884058,75,65,55,65,55,69,384,0.43548387096774194,1.0
70,120,40,95,40,95,460,0.8106060606060606,61,78,95,56,58,57,405,0.40336134453781514,0.5
40,80,100,30,30,20,300,0.11851851851851852,95,65,65,110,130,60,525,0.4016393442622951,1.0
150,160,100,95,65,100,670,0.8866666666666667,65,130,60,75,60,75,465,0.689922480620155,1.0
50,25,28,45,55,15,218,0.0625,60,25,35,70,80,60,330,0.3076923076923077,1.0
80,80,50,40,50,25,325,0.176056338028169,89,145,90,105,80,91,600,0.8549618320610687,0.5
106,110,90,154,90,130,680,0.926829268292683,80,70,40,100,60,145,495,0.921875,1.0
170,90,45,90,45,60,500,0.427536231884058,90,55,75,60,75,30,385,0.13970588235294118,1.0
70,140,230,60,80,50,630,0.32432432432432434,100,120,100,150,120,90,680,0.728,0.5
130,85,80,85,95,60,535,0.43884892086330934,80,110,60,150,130,70,600,0.5042016806722689,1.0
75,110,110,110,105,80,590,0.656934306569343,100,134,110,95,100,61,600,0.4057971014492754,2.0
40,30,35,45,40,55,245,0.31496062992125984,63,60,55,50,50,71,349,0.5289256198347108,1.0
75,38,38,56,56,67,330,0.5263157894736842,67,57,55,77,55,114,425,0.8879310344827587,2.0
70,70,40,60,40,60,340,0.4247787610619469,45,100,45,45,45,10,290,0.2949640287769784,2.0
59,63,80,65,80,58,405,0.41843971631205673,60,85,42,85,42,91,405,0.8227848101265823,1.0
75,95,122,58,75,69,494,0.5725806451612904,85,105,85,40,50,40,405,0.211864406779661,1.0
60,65,80,170,95,130,600,0.8625954198473282,80,95,82,60,82,75,474,0.6,0.5
50,53,48,53,48,64,316,0.46153846153846156,75,125,230,55,95,30,610,0.3448275862068966,2.0
40,30,35,45,40,55,245,0.31496062992125984,45,30,50,65,50,45,285,0.13821138211382114,1.0
45,35,45,62,53,35,275,0.11851851851851852,120,70,120,75,130,85,600,0.6694915254237288,1.0
75,90,90,140,90,115,600,0.9481481481481482,63,60,55,50,50,71,349,0.5289256198347108,1.0
40,45,40,35,35,56,251,0.373015873015873,30,56,35,25,35,72,253,0.48148148148148145,1.0
70,145,88,140,70,112,625,0.8888888888888888,75,95,122,58,75,69,494,0.5725806451612904,0.0
50,70,50,50,50,40,310,0.16296296296296298,60,40,60,95,60,55,370,0.4222222222222222,2.0
90,75,85,115,90,55,510,0.3445378151260504,60,69,95,69,95,36,424,0.2608695652173913,1.0
60,60,60,60,60,60,360,0.38095238095238093,50,65,107,105,107,86,520,0.7272727272727273,1.0
50,60,60,60,60,30,320,0.11290322580645161,125,130,90,130,90,95,660,0.7734375,0.5
45,45,55,45,55,63,308,0.4594594594594595,45,30,35,20,20,45,195,0.14782608695652175,0.5
60,48,45,43,90,42,328,0.21897810218978103,70,80,102,80,102,40,474,0.2677165354330709,1.0
50,47,50,57,50,65,319,0.463768115942029,100,70,70,65,65,45,415,0.1897810218978102,1.0
30,40,70,70,25,60,295,0.41353383458646614,80,160,80,130,80,100,630,0.8455284552845529,2.0
80,80,50,40,50,25,325,0.176056338028169,103,60,86,60,86,50,445,0.3458646616541353,1.0
55,65,95,95,45,85,440,0.6610169491525424,65,80,140,40,70,70,465,0.5223880597014925,1.0
70,130,100,55,80,65,500,0.608,75,75,60,83,60,60,413,0.39344262295081966,0.5
40,20,30,40,80,55,265,0.22764227642276422,95,23,48,23,48,23,260,0.046153846153846156,2.0
70,65,65,55,55,70,380,0.5,35,35,35,35,35,35,210,0.13385826771653545,1.0
89,145,90,105,80,91,600,0.8549618320610687,45,55,39,35,39,42,255,0.18518518518518517,1.0
45,50,45,115,55,95,405,0.6936936936936937,70,150,140,65,100,75,600,0.55,0.0
110,160,110,80,110,100,670,0.8591549295774648,55,66,44,44,56,85,350,0.6888888888888889,1.0
95,145,130,120,90,120,700,0.9398496240601504,55,63,90,50,80,42,380,0.21138211382113822,4.0
123,100,62,97,81,68,531,0.4806201550387597,86,68,72,109,66,106,507,0.8099173553719008,0.5
95,155,109,70,130,81,640,0.6788321167883211,59,110,150,45,49,35,448,0.3333333333333333,2.0
30,42,118,42,88,30,350,0.112,50,50,95,40,50,35,320,0.20279720279720279,0.5
73,100,60,100,60,65,458,0.42657342657342656,79,115,70,125,80,111,580,0.8468468468468469,1.0
70,65,60,90,75,90,450,0.6571428571428571,70,77,60,97,60,108,472,0.8394160583941606,1.0
55,55,55,85,55,30,335,0.1320754716981132,100,164,150,95,120,71,700,0.5645161290322581,0.0
66,41,77,61,87,23,355,0.12096774193548387,65,130,60,75,60,75,465,0.689922480620155,1.0
105,130,120,45,45,40,485,0.4444444444444444,60,100,85,80,85,100,510,0.7007874015748031,0.5
125,58,58,76,76,67,460,0.515625,70,105,105,50,40,20,390,0.33587786259541985,2.0
100,5,5,15,65,30,220,0.07692307692307693,86,92,88,68,75,73,482,0.6835443037974683,1.0
66,117,70,40,50,67,410,0.4573643410852713,150,160,100,95,65,100,670,0.8866666666666667,1.0
44,38,33,61,43,70,289,0.5267857142857143,65,136,94,54,96,135,580,0.9612403100775194,1.0
85,97,66,105,66,65,484,0.47107438016528924,75,103,80,70,80,92,500,0.7933884297520661,4.0
50,75,70,35,70,48,348,0.29357798165137616,45,55,45,65,45,75,330,0.5692307692307692,1.0
50,65,45,85,65,95,405,0.7238095238095238,88,107,122,74,75,64,530,0.4596774193548387,0.5
74,94,131,54,116,20,489,0.4485294117647059,45,30,15,85,65,65,305,0.36220472440944884,2.0
90,132,105,132,105,30,594,0.4246575342465753,20,40,15,35,35,60,205,0.34285714285714286,1.0
50,95,90,95,90,180,600,0.9172413793103448,75,110,110,110,105,80,590,0.656934306569343,1.0
120,100,85,30,85,45,465,0.22448979591836735,60,85,60,50,50,125,430,0.9090909090909091,1.0
50,160,110,160,110,110,700,0.8854961832061069,45,49,49,65,65,45,318,0.2781954887218045,0.5
70,90,90,135,90,125,600,0.9401709401709402,50,70,100,40,40,30,330,0.2222222222222222,1.0
60,85,69,60,69,77,420,0.518796992481203,40,35,30,120,70,105,400,0.6692307692307692,1.0
100,100,100,100,100,100,600,0.8778625954198473,48,72,48,72,48,48,336,0.25984251968503935,0.5
71,120,95,120,95,99,600,0.8203125,80,145,150,105,110,110,700,0.8692307692307693,0.5
45,55,39,35,39,42,255,0.18518518518518517,55,130,115,50,50,75,475,0.5982142857142857,1.0
91,72,90,129,90,108,580,0.8925619834710744,80,120,79,95,79,70,523,0.5833333333333334,1.0
75,125,230,55,95,30,610,0.3448275862068966,35,46,34,35,45,20,215,0.072,1.0
57,80,91,80,87,75,470,0.5737704918032787,50,35,55,25,25,15,205,0.021739130434782608,1.0
50,70,50,50,50,70,340,0.5645161290322581,67,89,116,79,116,33,500,0.2624113475177305,1.0
75,80,85,110,90,50,490,0.3548387096774194,50,53,48,53,48,64,316,0.358974358974359,2.0
55,69,85,32,35,28,304,0.09302325581395349,60,80,50,40,40,30,300,0.15328467153284672,1.0
120,100,85,30,85,45,465,0.22448979591836735,40,45,40,62,60,60,307,0.33884297520661155,1.0
120,100,85,30,85,45,465,0.22448979591836735,70,62,67,55,55,56,365,0.38513513513513514,0.5
90,30,15,40,20,15,210,0.043478260869565216,70,70,40,60,40,60,340,0.4247787610619469,2.0
20,25,45,70,90,60,310,0.30833333333333335,40,40,50,30,30,30,220,0.0873015873015873,1.0
45,60,45,25,45,55,275,0.29,100,120,100,150,120,90,680,0.728,1.0
60,105,60,120,60,105,510,0.8849557522123894,68,75,53,83,113,60,452,0.45384615384615384,1.0
120,100,85,30,85,45,465,0.22448979591836735,63,63,47,41,41,74,329,0.56,1.0
90,132,105,132,105,30,594,0.4246575342465753,80,185,115,40,105,75,600,0.6230769230769231,0.5
55,40,85,80,105,40,405,0.23622047244094488,75,140,65,112,65,110,567,0.9140625,0.5
55,45,50,45,65,80,340,0.5546218487394958,40,29,45,29,45,36,224,0.14634146341463414,1.0
83,80,75,70,70,101,479,0.8615384615384616,45,49,65,49,65,45,318,0.275,2.0
150,100,120,100,120,90,680,0.6666666666666666,50,85,85,55,55,50,380,0.3902439024390244,0.0
110,65,105,55,95,80,510,0.6258503401360545,60,80,95,70,85,50,440,0.2231404958677686,0.5
75,80,70,65,75,90,455,0.7578125,40,65,40,80,40,65,330,0.5038167938931297,1.0
45,20,50,60,120,50,345,0.24074074074074073,40,60,30,31,31,70,262,0.4492753623188406,1.0
130,65,60,110,95,65,525,0.5227272727272727,30,30,30,30,30,30,180,0.12612612612612611,0.5
48,72,48,72,48,48,336,0.25984251968503935,91,72,90,129,90,108,580,0.8620689655172413,1.0
45,67,60,35,50,63,320,0.5128205128205128,45,30,35,20,20,45,195,0.14782608695652175,1.0
70,130,100,55,80,65,500,0.608,80,110,60,150,130,70,600,0.5042016806722689,1.0
79,115,70,125,80,111,580,0.8468468468468469,45,90,20,65,20,65,305,0.5116279069767442,1.0
20,10,230,10,230,5,505,0.0,80,115,80,65,55,93,488,0.7846153846153846,1.0
50,65,107,105,107,86,520,0.7758620689655172,55,70,40,60,40,40,305,0.26956521739130435,1.0
85,80,70,135,75,90,535,0.7006802721088435,70,70,40,60,40,60,340,0.4247787610619469,1.0
55,81,60,50,70,97,413,0.7214285714285714,74,48,76,83,81,104,466,0.7322834645669292,1.0
45,95,50,40,50,75,355,0.54,40,45,40,62,60,60,307,0.33884297520661155,1.0
255,10,10,75,135,55,540,0.3125,75,95,60,65,60,115,470,0.8778625954198473,1.0
50,48,43,46,41,60,288,0.47297297297297297,68,165,95,65,115,110,618,0.8615384615384616,1.0
35,60,44,40,54,55,288,0.366412213740458,53,51,53,61,56,40,314,0.14285714285714285,1.0
41,64,45,50,50,50,300,0.36752136752136755,20,40,90,30,90,25,295,0.11363636363636363,1.0
68,90,65,50,55,82,410,0.6165413533834586,60,79,105,59,85,36,424,0.17054263565891473,0.5
75,90,140,60,60,40,465,0.3008130081300813,40,45,40,62,60,60,307,0.33884297520661155,0.25
67,58,57,81,67,101,431,0.8790322580645161,65,75,105,35,65,85,430,0.6940298507462687,0.0
150,160,100,95,65,100,670,0.8866666666666667,45,49,65,49,65,45,318,0.275,1.0
30,45,59,30,39,57,260,0.2803030303030303,90,95,105,165,110,45,610,0.2890625,1.0
60,60,40,65,45,35,305,0.15833333333333333,64,51,23,51,23,28,240,0.11363636363636363,1.0
45,20,50,60,120,50,345,0.24074074074074073,75,123,67,95,85,95,540,0.7642276422764228,0.5
75,140,65,112,65,110,567,0.9140625,70,95,125,65,75,45,475,0.33613445378151263,2.0
70,100,70,105,75,40,460,0.23214285714285715,45,60,32,50,32,76,295,0.5925925925925926,2.0
78,130,111,130,85,100,634,0.8561151079136691,123,77,72,99,92,58,521,0.4621212121212121,1.0
40,40,55,40,70,55,300,0.40939597315436244,116,55,85,107,95,29,487,0.06818181818181818,0.5
100,70,70,65,65,45,415,0.1897810218978102,70,60,75,110,75,90,480,0.7165354330708661,1.0
90,120,75,60,60,45,450,0.29411764705882354,80,90,80,130,110,110,600,0.856,2.0
70,95,125,65,75,45,475,0.33613445378151263,78,92,75,74,63,118,500,0.8842975206611571,0.25
60,40,60,95,60,55,370,0.4222222222222222,60,75,85,100,85,115,520,0.8992248062015504,1.0
73,76,75,81,100,100,505,0.8110236220472441,90,90,85,125,90,100,580,0.768595041322314,1.0
80,75,150,75,150,50,580,0.30973451327433627,100,150,120,120,100,90,680,0.6493506493506493,0.5
30,45,59,30,39,57,260,0.2803030303030303,95,155,109,70,130,81,640,0.6788321167883211,2.0
65,155,120,65,90,105,600,0.8677685950413223,85,90,80,70,80,130,535,0.9262295081967213,0.25
45,90,20,65,20,65,305,0.5116279069767442,79,115,70,125,80,111,580,0.8468468468468469,1.0
70,150,140,65,100,75,600,0.55,70,77,60,97,60,108,472,0.8394160583941606,0.5
50,95,180,85,45,70,525,0.5298507462686567,48,61,40,61,40,50,300,0.2543859649122807,1.0
60,60,60,105,105,105,495,0.848,20,40,90,30,90,25,295,0.11363636363636363,2.0
50,70,50,50,50,40,310,0.16296296296296298,45,90,20,65,20,65,305,0.5116279069767442,0.5
75,140,65,112,65,110,567,0.9140625,60,55,50,40,55,45,305,0.22377622377622378,4.0
65,95,57,100,85,93,495,0.7441860465116279,58,64,58,80,65,80,405,0.5423728813559322,0.5
71,95,85,110,95,79,535,0.664,50,50,120,80,80,30,410,0.07258064516129033,0.5
61,72,57,55,55,65,365,0.3984375,90,100,60,90,60,80,480,0.6422764227642277,2.0
78,130,111,130,85,100,634,0.8561151079136691,40,80,100,30,30,20,300,0.11851851851851852,0.5
84,71,43,71,43,48,360,0.25874125874125875,60,65,60,130,75,110,500,0.7719298245614035,0.0
55,130,115,50,50,75,475,0.5982142857142857,36,50,50,65,60,44,305,0.16363636363636364,1.0
82,121,119,69,59,71,521,0.5394736842105263,82,80,86,85,75,72,480,0.6183206106870229,0.0
75,125,75,30,75,85,465,0.625,60,48,45,43,90,42,328,0.21897810218978103,0.5
69,69,76,69,86,91,460,0.6554621848739496,60,50,70,50,90,65,385,0.39568345323741005,1.0
91,72,90,129,90,108,580,0.8925619834710744,85,80,70,135,75,90,535,0.7006802721088435,2.0
86,76,86,116,56,95,515,0.7982456140350878,28,25,25,45,35,40,198,0.16083916083916083,1.0
83,80,80,135,80,121,579,0.9444444444444444,50,40,85,40,65,25,305,0.08870967741935484,2.0
40,30,50,55,55,100,330,0.584070796460177,60,115,105,65,70,80,495,0.7181818181818181,2.0
90,85,75,115,100,115,580,0.9381443298969072,70,120,100,145,105,20,560,0.2824427480916031,0.0
80,105,65,60,75,130,515,0.9645390070921985,46,57,40,40,40,50,273,0.25,1.0
125,130,90,130,90,95,660,0.7734375,60,60,60,35,35,30,280,0.11194029850746269,1.0
95,23,48,23,48,23,260,0.046153846153846156,95,110,80,70,80,50,485,0.37209302325581395,1.0
50,70,50,50,50,70,340,0.5645161290322581,70,62,67,55,55,56,365,0.38513513513513514,2.0
35,40,100,90,55,35,355,0.1796875,60,90,70,60,120,40,440,0.27419354838709675,1.0
85,105,85,40,50,40,405,0.211864406779661,125,58,58,76,76,67,460,0.515625,1.0
35,35,40,35,55,50,250,0.40336134453781514,75,80,70,65,75,90,455,0.7578125,0.25
50,95,180,85,45,70,525,0.5298507462686567,55,45,43,55,43,72,313,0.5853658536585366,2.0
65,95,100,60,50,50,420,0.34959349593495936,35,85,45,35,35,75,310,0.6492537313432836,1.0
70,75,80,135,80,135,575,0.917910447761194,70,140,230,60,80,50,630,0.32432432432432434,1.0
55,55,50,45,65,55,325,0.37373737373737376,64,66,68,81,76,50,405,0.25190839694656486,1.0
64,66,68,81,76,50,405,0.25190839694656486,70,110,80,55,80,105,500,0.8794326241134752,1.0
65,90,120,85,70,60,490,0.43410852713178294,63,120,85,90,55,55,468,0.2809917355371901,1.0
86,68,72,109,66,106,507,0.8099173553719008,105,30,105,140,105,55,540,0.3524590163934426,0.5
65,90,122,58,75,84,494,0.71875,76,65,45,92,42,91,411,0.7449664429530202,0.0
58,64,58,80,65,80,405,0.5423728813559322,60,40,80,60,45,40,325,0.23529411764705882,2.0
125,120,90,170,100,95,700,0.78125,79,115,70,125,80,111,580,0.8468468468468469,2.0
80,100,70,60,70,95,475,0.7416666666666667,65,40,70,80,140,70,465,0.5954198473282443,1.0
65,40,70,80,140,70,465,0.5954198473282443,45,50,35,55,75,40,300,0.21367521367521367,0.5
150,120,100,120,100,90,680,0.664179104477612,105,125,100,60,100,100,590,0.8359375,0.0
83,80,80,135,80,121,579,0.9444444444444444,60,50,50,60,70,50,340,0.28346456692913385,2.0
101,72,72,99,89,29,462,0.1937984496124031,70,85,140,85,70,20,470,0.272,0.5
123,100,62,97,81,68,531,0.4806201550387597,45,80,100,35,37,28,325,0.3125,0.5
70,100,115,30,65,30,410,0.24390243902439024,65,63,45,45,45,45,308,0.2595419847328244,2.0
35,45,160,30,45,70,385,0.48148148148148145,30,45,55,70,55,85,340,0.5633802816901409,1.0
80,80,80,55,55,90,440,0.6417910447761194,80,120,79,95,79,70,523,0.5833333333333334,1.0
50,35,55,25,25,15,205,0.05263157894736842,100,134,110,95,100,61,600,0.4057971014492754,2.0
70,65,60,90,75,90,450,0.6571428571428571,100,90,130,45,65,55,485,0.4253731343283582,0.5
80,80,90,110,130,110,600,0.8721804511278195,65,80,80,59,63,58,405,0.4411764705882353,1.0
80,80,80,80,80,80,480,0.6015037593984962,50,65,107,105,107,86,520,0.7313432835820896,2.0
65,55,115,100,40,60,435,0.3798449612403101,74,48,76,83,81,104,466,0.7322834645669292,1.0
106,150,70,194,120,140,780,0.952,61,78,95,56,58,57,405,0.40336134453781514,1.0
85,105,100,79,83,78,530,0.5869565217391305,50,95,90,95,90,180,600,0.9172413793103448,1.0
60,50,70,80,80,140,480,0.8449612403100775,135,85,40,40,85,5,390,0.6864406779661016,1.0
55,84,105,114,75,52,485,0.2890625,65,155,120,65,90,105,600,0.8677685950413223,1.0
80,95,82,60,82,75,474,0.6,65,110,130,60,65,95,525,0.8278145695364238,2.0
103,60,126,80,126,50,545,0.36363636363636365,54,78,103,53,45,22,355,0.23255813953488372,0.5
80,100,123,122,120,80,625,0.56,40,65,40,80,40,65,330,0.5038167938931297,1.0
60,90,140,50,50,40,430,0.2535211267605634,75,80,85,110,90,50,490,0.3548387096774194,1.0
55,40,50,65,85,40,335,0.3181818181818182,71,95,85,110,95,79,535,0.664,1.0
65,75,105,35,65,85,430,0.6940298507462687,60,40,60,40,60,35,295,0.18055555555555555,1.0
60,60,50,40,50,75,335,0.5882352941176471,78,130,111,130,85,100,634,0.8561151079136691,0.25
100,100,125,110,50,50,535,0.384,255,10,10,75,135,55,540,0.3125,1.0
85,70,80,97,80,123,535,0.9304347826086956,79,105,70,145,80,101,580,0.8608695652173913,0.5
80,160,60,170,130,80,680,0.6180555555555556,100,73,83,73,83,55,467,0.371900826446281,2.0
60,25,35,70,80,60,330,0.3076923076923077,75,75,95,75,95,113,528,0.9015151515151515,1.0
65,73,55,47,75,85,400,0.6846846846846847,55,35,50,55,110,85,390,0.6277372262773723,0.5
65,110,130,60,65,95,525,0.8278145695364238,60,69,95,69,95,36,424,0.2608695652173913,0.25
79,115,70,125,80,111,580,0.864,58,64,58,80,65,80,405,0.609271523178808,1.0
80,50,100,100,200,50,580,0.2357142857142857,59,45,40,35,40,31,250,0.14285714285714285,1.0
85,135,130,60,80,25,515,0.40540540540540543,60,85,49,60,49,60,363,0.4444444444444444,1.0
91,72,90,129,90,108,580,0.8620689655172413,99,68,83,72,87,51,460,0.417910447761194,0.25
61,90,45,50,50,160,456,0.9230769230769231,75,75,55,105,85,30,425,0.1619718309859155,4.0
50,35,55,25,25,15,205,0.021739130434782608,69,69,76,69,86,91,460,0.6554621848739496,1.0
85,110,76,65,82,56,474,0.3933333333333333,60,60,50,40,50,75,335,0.5882352941176471,0.0
35,60,44,40,54,55,288,0.366412213740458,68,85,65,165,135,100,618,0.8083333333333333,2.0
90,75,75,90,100,70,500,0.5462184873949579,68,72,78,38,42,32,330,0.23809523809523808,2.0
150,100,120,100,120,90,680,0.6666666666666666,100,134,110,95,100,61,600,0.4057971014492754,0.5
40,35,30,20,20,50,195,0.23423423423423423,50,80,95,10,45,10,290,0.232,0.5
65,47,55,73,75,85,400,0.65,80,50,100,100,200,50,580,0.2357142857142857,1.0
20,40,15,35,35,60,205,0.34285714285714286,20,10,230,10,230,5,505,0.0,1.0
60,60,60,85,85,85,435,0.631578947368421,90,85,75,115,100,115,580,0.9381443298969072,1.0
35,46,34,35,45,20,215,0.072,38,35,40,27,25,35,200,0.08208955223880597,1.0
43,80,65,50,35,35,308,0.14193548387096774,40,55,80,35,60,30,300,0.15037593984962405,1.0
74,94,131,54,116,20,489,0.4485294117647059,35,60,44,40,54,55,288,0.366412213740458,0.5
75,69,72,114,100,104,534,0.8253968253968254,40,60,40,40,40,30,250,0.0948905109489051,4.0
114,85,70,85,80,30,464,0.2066115702479339,75,85,200,55,65,30,510,0.16778523489932887,0.0
53,54,53,37,46,45,288,0.3090909090909091,35,20,65,40,65,20,245,0.02459016393442623,0.5
70,110,75,145,85,145,630,0.9444444444444444,82,121,119,69,59,71,521,0.5394736842105263,2.0
80,125,75,40,95,85,500,0.6911764705882353,62,55,52,109,94,109,481,0.7833333333333333,2.0
74,100,72,90,72,46,454,0.24561403508771928,101,72,72,99,89,29,462,0.1937984496124031,1.0
40,30,30,40,50,30,220,0.07936507936507936,60,48,45,43,90,42,328,0.21897810218978103,1.0
100,164,150,95,120,71,700,0.5645161290322581,60,60,60,85,85,85,435,0.631578947368421,2.0
50,72,35,35,35,65,292,0.5373134328358209,90,120,75,60,60,45,450,0.29411764705882354,0.5
46,57,40,40,40,50,273,0.25,44,38,33,61,43,70,289,0.5267857142857143,1.0
89,145,90,105,80,91,600,0.8549618320610687,63,60,55,50,50,71,349,0.5289256198347108,0.0
85,76,64,45,55,90,415,0.6739130434782609,44,75,35,63,33,45,295,0.2647058823529412,0.0
65,136,94,54,96,135,580,0.9612403100775194,60,62,80,63,80,60,405,0.4336283185840708,1.0
55,70,45,70,50,60,350,0.45,60,50,150,50,150,60,520,0.5206611570247934,2.0
50,85,85,55,55,50,380,0.3902439024390244,85,115,80,105,80,50,515,0.3063063063063063,0.5
106,190,100,154,100,130,780,0.9259259259259259,65,40,50,125,60,30,370,0.07258064516129033,0.25
75,140,65,112,65,110,567,0.9140625,79,103,120,135,115,78,630,0.5763888888888888,1.0
45,45,55,45,55,63,308,0.4594594594594595,100,123,75,57,75,80,510,0.6923076923076923,0.5
62,77,62,50,42,65,358,0.4838709677419355,72,58,80,103,80,97,490,0.7171052631578947,1.0
68,85,65,165,135,100,618,0.8083333333333333,45,30,40,105,50,20,290,0.031007751937984496,0.5
70,94,50,94,50,66,424,0.48148148148148145,44,58,44,58,44,61,309,0.41964285714285715,0.5
125,130,90,130,90,95,660,0.7734375,65,125,60,95,60,105,510,0.9236641221374046,1.0
50,160,110,160,110,110,700,0.8854961832061069,60,50,70,80,80,140,480,0.8449612403100775,1.0
62,77,62,50,42,65,358,0.4838709677419355,54,63,52,83,56,97,405,0.7697841726618705,1.0
25,20,15,105,55,90,310,0.32407407407407407,70,145,88,140,70,112,625,0.8888888888888888,0.5
100,50,80,60,80,50,420,0.34375,100,70,70,65,65,45,415,0.1897810218978102,1.0
40,55,30,30,30,85,270,0.688,70,140,230,60,80,50,630,0.32432432432432434,0.25
54,78,103,53,45,22,355,0.23255813953488372,100,150,120,120,100,90,680,0.6493506493506493,0.5
95,85,85,65,65,35,430,0.2571428571428571,77,59,50,67,63,46,362,0.23140495867768596,4.0
40,50,45,70,45,70,320,0.5517241379310345,31,45,90,30,30,40,266,0.21929824561403508,4.0
75,95,95,95,95,85,540,0.6470588235294118,55,70,40,60,40,40,305,0.26956521739130435,1.0
75,70,90,70,105,80,490,0.656,45,95,50,40,50,75,355,0.54,1.0
95,135,80,110,80,100,600,0.8248175182481752,60,60,75,60,75,80,410,0.7321428571428571,2.0
68,90,65,50,55,82,410,0.6165413533834586,45,75,37,70,55,83,365,0.6183206106870229,2.0
55,47,52,40,40,41,275,0.16806722689075632,40,29,45,29,45,36,224,0.14634146341463414,1.0
40,30,35,50,70,55,280,0.28205128205128205,70,65,65,55,55,70,380,0.5,1.0
45,63,37,65,55,95,360,0.8055555555555556,80,130,100,160,120,110,700,0.8981481481481481,0.5
83,80,75,70,70,101,479,0.8615384615384616,40,30,50,55,55,100,330,0.584070796460177,0.5
89,124,80,55,80,55,483,0.5714285714285714,100,120,100,150,120,90,680,0.728,2.0
95,110,80,70,80,50,485,0.37209302325581395,100,150,90,180,160,90,770,0.7348484848484849,0.5
106,90,130,90,154,110,680,0.8699186991869918,46,87,60,30,40,57,320,0.37777777777777777,1.0
100,100,100,100,100,100,600,0.8805970149253731,100,120,100,150,120,90,680,0.728,1.0
70,90,110,60,75,95,500,0.7333333333333333,55,66,44,44,56,85,350,0.6888888888888889,1.0
63,60,55,50,50,71,349,0.5289256198347108,70,55,75,45,65,60,370,0.45901639344262296,1.0
35,80,50,50,70,120,405,0.84375,68,90,65,50,55,82,410,0.6165413533834586,1.0
50,50,120,80,80,30,410,0.07258064516129033,40,55,80,35,60,30,300,0.15037593984962405,1.0
49,49,56,49,61,66,330,0.5190839694656488,75,80,85,110,90,50,490,0.3548387096774194,0.5
84,86,88,111,101,60,530,0.4634146341463415,50,70,160,70,160,90,600,0.7417218543046358,1.0
44,38,33,61,43,70,289,0.5267857142857143,126,131,95,131,98,99,680,0.8294573643410853,1.0
40,55,30,30,30,85,270,0.688,68,65,65,125,115,80,518,0.6461538461538462,1.0
69,69,76,69,86,91,460,0.6554621848739496,60,55,50,40,55,45,305,0.22377622377622378,1.0
45,50,43,40,38,62,278,0.40441176470588236,45,49,49,65,65,45,318,0.2781954887218045,2.0
65,60,110,130,95,65,525,0.47761194029850745,83,80,80,135,80,121,579,0.9444444444444444,2.0
125,58,58,76,76,67,460,0.515625,44,75,35,63,33,45,295,0.2647058823529412,1.0
55,55,50,45,65,55,325,0.37373737373737376,70,55,95,95,110,65,490,0.48872180451127817,1.0
70,84,70,65,70,51,410,0.2949640287769784,80,85,95,30,30,25,345,0.2857142857142857,1.0
80,110,120,130,90,70,600,0.6198347107438017,150,80,44,90,54,80,498,0.625,1.0
58,70,45,40,45,42,300,0.25925925925925924,80,185,115,40,105,75,600,0.6230769230769231,0.5
115,140,130,55,55,40,535,0.4519230769230769,78,104,78,159,115,100,634,0.8444444444444444,0.0
100,90,130,45,65,55,485,0.4253731343283582,58,50,145,95,105,30,483,0.2459016393442623,1.0
70,90,45,15,45,50,315,0.3629032258064516,85,105,85,40,50,40,405,0.211864406779661,1.0
100,50,80,60,80,50,420,0.34375,75,95,125,45,75,95,510,0.8257575757575758,2.0
80,110,120,130,90,70,600,0.6198347107438017,75,80,55,25,35,35,305,0.18666666666666668,1.0
104,91,63,91,73,68,490,0.5118110236220472,85,110,76,65,82,56,474,0.3933333333333333,0.0
45,65,34,40,34,45,263,0.2589928057553957,71,120,95,120,95,99,600,0.8203125,1.0
79,115,70,125,80,111,580,0.864,41,56,40,62,44,71,314,0.568,2.0
60,40,60,95,60,55,370,0.4222222222222222,60,45,70,45,90,95,405,0.7304964539007093,1.0
50,50,120,80,80,30,410,0.07258064516129033,50,20,55,25,25,30,205,0.09774436090225563,4.0
50,65,64,44,48,43,314,0.2196969696969697,30,30,42,30,42,70,244,0.4230769230769231,1.0
97,165,60,65,50,58,495,0.3902439024390244,40,45,40,65,40,65,295,0.5661764705882353,1.0
75,80,70,65,75,90,455,0.7578125,50,65,107,105,107,86,520,0.7758620689655172,0.5
80,125,75,40,95,85,500,0.6911764705882353,70,110,180,60,60,50,530,0.4117647058823529,2.0
70,77,60,97,60,108,472,0.8394160583941606,40,60,30,31,31,70,262,0.4492753623188406,1.0
30,45,59,30,39,57,260,0.2803030303030303,50,65,107,105,107,86,520,0.703125,1.0
90,120,75,60,60,45,450,0.29411764705882354,60,110,70,60,60,100,460,0.8461538461538461,1.0
110,78,73,76,71,60,468,0.3333333333333333,100,100,80,60,60,50,450,0.3050847457627119,2.0
64,51,23,51,23,28,240,0.11363636363636363,105,130,120,45,45,40,485,0.4444444444444444,0.5
60,85,60,50,50,125,430,0.9090909090909091,25,20,15,105,55,90,310,0.32407407407407407,1.0
40,20,30,40,80,55,265,0.22764227642276422,85,60,65,135,105,100,550,0.7518248175182481,1.0
72,85,70,65,70,58,420,0.41304347826086957,50,65,45,85,65,95,405,0.7238095238095238,1.0
50,70,160,70,160,90,600,0.7417218543046358,86,92,88,68,75,73,482,0.6835443037974683,0.0
45,49,65,49,65,45,318,0.275,54,78,103,53,45,22,355,0.23255813953488372,4.0
77,59,50,67,63,46,362,0.23140495867768596,115,115,85,90,75,100,580,0.8134328358208955,1.0
30,45,55,70,55,85,340,0.5633802816901409,85,110,76,65,82,56,474,0.3933333333333333,0.5
110,130,80,70,60,80,530,0.5862068965517241,76,65,45,92,42,91,411,0.7449664429530202,0.0
50,55,50,36,30,43,264,0.2922077922077922,255,10,10,75,135,55,540,0.3125,1.0
70,40,50,55,50,25,290,0.061068702290076333,90,93,55,70,55,55,418,0.3819444444444444,1.0
64,78,52,78,52,81,405,0.6422764227642277,86,76,86,116,56,95,515,0.7982456140350878,0.5
55,55,55,85,55,30,335,0.1320754716981132,43,80,65,50,35,35,308,0.14193548387096774,1.0
71,82,64,64,59,112,452,0.9327731092436975,65,63,45,45,45,45,308,0.2595419847328244,1.0
82,121,119,69,59,71,521,0.5394736842105263,60,90,70,60,120,40,440,0.27419354838709675,1.0
80,100,123,122,120,80,625,0.56,100,5,5,15,65,30,220,0.07692307692307693,1.0
84,86,88,111,101,60,530,0.4634146341463415,95,95,85,125,65,55,520,0.3894736842105263,0.5
35,45,160,30,45,70,385,0.48148148148148145,106,150,70,194,120,140,780,0.952,1.0
20,40,15,35,35,60,205,0.34285714285714286,100,150,90,180,160,90,770,0.7348484848484849,2.0
100,150,110,95,110,70,635,0.5923076923076923,120,120,120,120,120,120,720,0.9344262295081968,1.0
60,60,50,40,50,75,335,0.5882352941176471,66,117,70,40,50,67,410,0.4573643410852713,0.5
45,60,32,50,32,76,295,0.5925925925925926,85,70,80,97,80,123,535,0.9304347826086956,1.0
35,60,44,40,54,55,288,0.366412213740458,45,20,50,60,120,50,345,0.24074074074074073,1.0
85,76,64,45,55,90,415,0.6739130434782609,103,60,86,60,86,50,445,0.3458646616541353,1.0
70,80,50,35,35,35,305,0.14,90,95,105,165,110,45,610,0.2890625,1.0
115,140,130,55,55,40,535,0.4519230769230769,78,65,68,112,154,75,552,0.628099173553719,1.0
85,50,95,120,115,80,545,0.5793650793650794,40,45,40,65,40,65,295,0.5661764705882353,0.5
62,55,52,109,94,109,481,0.7833333333333333,50,65,107,105,107,86,520,0.7758620689655172,1.0
46,87,60,30,40,57,320,0.37777777777777777,40,35,30,120,70,105,400,0.6692307692307692,1.0
75,95,122,58,75,69,494,0.5725806451612904,40,27,60,37,50,66,280,0.36220472440944884,0.5
75,98,63,98,63,101,498,0.849624060150376,25,35,70,95,55,45,325,0.16783216783216784,1.0
50,180,20,180,20,150,600,0.9029850746268657,80,100,200,50,100,50,580,0.3472222222222222,1.0
55,47,52,40,40,41,275,0.16806722689075632,85,105,85,40,50,40,405,0.211864406779661,1.0
100,164,150,95,120,71,700,0.5645161290322581,65,45,55,45,70,45,325,0.24369747899159663,1.0
65,90,65,61,61,100,442,0.8373983739837398,78,130,111,130,85,100,634,0.8561151079136691,1.0
77,85,51,55,51,65,384,0.5163934426229508,65,95,75,55,55,85,430,0.6933333333333334,0.5
78,65,68,112,154,75,552,0.628099173553719,40,29,45,29,45,36,224,0.14634146341463414,1.0
60,150,50,150,50,60,520,0.5,45,100,45,45,45,10,290,0.2949640287769784,1.0
70,62,67,55,55,56,365,0.38513513513513514,90,70,80,70,95,70,475,0.5190839694656488,1.0
65,130,60,75,60,75,465,0.689922480620155,70,110,80,55,80,105,500,0.8794326241134752,1.0
50,95,95,35,110,70,455,0.5179856115107914,75,100,110,45,55,65,450,0.5333333333333333,1.0
10,55,25,35,45,95,265,0.5396825396825397,50,20,55,25,25,30,205,0.09774436090225563,0.5
75,75,60,83,60,60,413,0.39344262295081966,65,50,70,95,80,65,425,0.4262295081967213,1.0
20,40,15,35,35,60,205,0.34285714285714286,85,105,85,40,50,40,405,0.211864406779661,1.0
130,65,60,110,95,65,525,0.5227272727272727,65,63,45,45,45,45,308,0.2595419847328244,2.0
100,50,80,60,80,50,420,0.34375,45,25,50,25,25,35,205,0.13076923076923078,0.5
106,190,100,154,100,130,780,0.9259259259259259,100,164,150,95,120,71,700,0.5645161290322581,0.0
20,10,55,15,20,80,200,0.17985611510791366,40,60,30,31,31,70,262,0.4492753623188406,1.0
60,52,168,47,138,30,495,0.19834710743801653,45,30,15,85,65,65,305,0.36220472440944884,4.0
80,82,100,83,100,80,525,0.6821705426356589,45,55,45,65,45,75,330,0.5692307692307692,0.5
45,49,65,49,65,45,318,0.275,110,85,95,80,95,50,515,0.2713178294573643,1.0
50,35,55,25,25,15,205,0.05263157894736842,80,120,130,55,65,45,495,0.37037037037037035,1.0
65,90,65,61,61,100,442,0.8373983739837398,78,84,78,109,85,100,534,0.8646616541353384,1.0
65,136,94,54,96,135,580,0.9612403100775194,50,52,48,65,50,55,320,0.33098591549295775,1.0
30,80,90,55,45,55,355,0.4295774647887324,50,53,62,58,63,44,330,0.13709677419354838,0.5
150,100,120,100,120,90,680,0.6666666666666666,65,47,55,73,75,85,400,0.65,1.0
40,50,45,70,45,70,320,0.5517241379310345,150,100,120,100,120,90,680,0.6666666666666666,1.0
60,70,105,70,120,75,500,0.5983606557377049,116,55,85,107,95,29,487,0.06818181818181818,0.5
60,100,85,80,85,100,510,0.7007874015748031,115,140,130,55,55,40,535,0.4519230769230769,4.0
70,40,50,55,50,25,290,0.061068702290076333,40,50,45,70,45,70,320,0.5517241379310345,2.0
38,41,40,50,65,65,299,0.4108527131782946,50,100,150,100,150,50,600,0.37142857142857144,0.5
65,90,65,61,61,100,442,0.8373983739837398,85,120,70,50,60,100,485,0.8308823529411765,1.0
70,110,70,115,70,90,525,0.75,48,61,40,61,40,50,300,0.2543859649122807,0.5
30,30,42,30,42,70,244,0.4230769230769231,55,69,85,32,35,28,304,0.09302325581395349,1.0
85,70,80,97,80,123,535,0.9304347826086956,78,130,111,130,85,100,634,0.8561151079136691,2.0
54,45,47,75,98,52,371,0.39669421487603307,45,85,50,55,50,65,350,0.5076923076923077,2.0
120,120,120,120,120,120,720,0.9344262295081968,65,90,40,45,80,75,395,0.625,1.0
90,55,75,60,75,30,385,0.13970588235294118,85,100,122,58,75,54,494,0.3939393939393939,0.0
85,50,95,120,115,80,545,0.5793650793650794,60,50,100,85,70,65,430,0.47580645161290325,1.0
65,125,60,95,60,105,510,0.9236641221374046,40,45,40,35,35,56,251,0.373015873015873,1.0
50,65,107,105,107,86,520,0.7758620689655172,81,102,77,85,75,85,505,0.5642857142857143,0.0
45,50,43,40,38,62,278,0.40441176470588236,67,82,62,46,48,43,348,0.22033898305084745,2.0
40,60,30,31,31,70,262,0.4492753623188406,80,82,78,95,80,85,500,0.6869565217391305,1.0
60,85,42,85,42,91,405,0.8227848101265823,90,60,70,75,70,45,410,0.23880597014925373,1.0
85,60,65,135,105,100,550,0.7518248175182481,115,45,20,45,25,20,270,0.11538461538461539,0.5
80,125,75,40,95,85,500,0.6911764705882353,100,123,75,57,75,80,510,0.6923076923076923,0.5
65,100,70,80,80,105,500,0.8666666666666667,67,89,116,79,116,33,500,0.2624113475177305,2.0
50,65,90,35,35,15,290,0.14678899082568808,65,105,60,60,70,95,455,63.0,0.5
85,80,90,105,95,60,515,0.49074074074074076,90,95,105,165,110,45,610,0.2890625,1.0
70,40,50,55,50,25,290,0.061068702290076333,50,50,40,30,30,50,250,0.2781954887218045,2.0
100,50,80,60,80,50,420,0.34375,70,85,140,85,70,20,470,0.272,1.0
91,129,90,72,90,108,580,0.8536585365853658,85,73,70,73,115,67,483,0.5126050420168067,0.5
58,109,112,48,48,109,484,0.8805970149253731,80,100,70,60,70,95,475,0.7416666666666667,2.0
65,50,35,115,95,95,455,0.7333333333333333,35,65,35,65,35,65,300,0.46621621621621623,0.5
65,130,60,95,110,65,525,0.5303030303030303,70,115,60,115,60,55,475,0.4647887323943662,2.0
65,40,50,125,60,30,370,0.07258064516129033,90,92,87,75,85,76,505,0.5409836065573771,4.0
67,82,62,46,48,43,348,0.22033898305084745,50,50,40,50,40,64,294,0.45588235294117646,1.0
65,60,70,85,75,40,395,0.1796875,90,120,120,60,60,50,500,0.35294117647058826,1.0
25,35,70,95,55,45,325,0.16783216783216784,76,65,45,92,42,91,411,0.7449664429530202,2.0
65,80,65,35,65,60,370,0.38405797101449274,40,30,30,40,50,30,220,0.07936507936507936,1.0
64,115,65,83,63,65,455,0.5323741007194245,50,160,110,160,110,110,700,0.8854961832061069,1.0
80,80,90,110,130,110,600,0.8721804511278195,103,60,86,60,86,50,445,0.3458646616541353,1.0
70,65,65,55,55,70,380,0.5,76,25,45,67,55,24,292,0.0390625,1.0
60,48,45,43,90,42,328,0.21897810218978103,55,45,45,25,25,15,210,0.048,2.0
114,85,70,85,80,30,464,0.2066115702479339,37,25,41,25,41,25,194,0.08870967741935484,0.5
55,55,55,85,55,30,335,0.1320754716981132,105,95,80,40,80,90,490,0.753968253968254,1.0
50,105,125,55,95,50,480,0.375886524822695,80,110,120,130,90,70,600,0.6198347107438017,0.125
40,45,35,40,40,90,290,0.65,95,110,95,40,95,55,490,0.40336134453781514,1.0
80,100,80,80,80,100,520,0.9051724137931034,60,50,70,80,80,140,480,0.8449612403100775,2.0
85,70,80,97,80,123,535,0.9304347826086956,90,60,60,40,40,40,330,0.29545454545454547,1.0
105,140,95,55,65,45,505,0.3,45,75,37,70,55,83,365,0.6183206106870229,1.0
35,40,100,90,55,35,355,0.1796875,73,76,75,81,100,100,505,0.8110236220472441,4.0
70,65,65,55,55,70,380,0.5,45,100,135,65,135,45,525,0.29411764705882354,0.0
40,80,100,30,30,20,300,0.11851851851851852,105,125,100,60,100,100,590,0.8359375,1.0
80,160,80,130,80,100,630,0.8455284552845529,65,65,60,110,95,130,525,0.9253731343283582,1.0
79,115,70,125,80,111,580,0.864,40,65,40,80,40,65,330,0.5038167938931297,1.0
45,63,37,65,55,95,360,0.8055555555555556,64,78,52,78,52,81,405,0.6422764227642277,1.0
60,65,80,170,95,130,600,0.8625954198473282,70,40,50,55,50,25,290,0.061068702290076333,1.0
43,80,65,50,35,35,308,0.14193548387096774,65,65,60,110,95,130,525,0.9253731343283582,1.0
80,160,60,170,130,80,680,0.6180555555555556,50,85,85,55,55,50,380,0.3902439024390244,0.25
75,98,63,98,63,101,498,0.849624060150376,95,117,184,44,46,28,514,0.2975206611570248,1.0
65,40,50,125,60,30,370,0.07258064516129033,50,50,150,50,150,50,500,0.2571428571428571,1.0
150,120,100,120,100,90,680,0.664179104477612,70,140,70,110,65,105,560,0.95,0.5
99,68,83,72,87,51,460,0.417910447761194,45,50,35,55,75,40,300,0.21367521367521367,0.5
60,50,70,80,80,140,480,0.8449612403100775,90,120,100,150,120,100,680,0.7718120805369127,1.0
70,60,125,115,70,55,495,0.35507246376811596,35,35,35,35,35,35,210,0.13385826771653545,0.5
65,100,70,80,80,105,500,0.8666666666666667,38,35,40,27,25,35,200,0.08208955223880597,2.0
100,100,100,100,100,100,600,0.8805970149253731,65,105,60,60,70,95,455,63.0,1.0
70,135,105,60,105,20,495,0.5806451612903226,90,120,120,60,60,50,500,0.35294117647058826,1.0
75,125,70,125,70,115,580,0.9037037037037037,150,80,44,90,54,80,498,0.625,1.0
50,65,45,85,65,95,405,0.7238095238095238,60,69,95,69,95,36,424,0.2608695652173913,0.25
70,83,50,37,50,60,350,0.3360655737704918,79,85,60,55,60,71,410,0.60431654676259,1.0
109,66,84,81,99,32,471,0.2013888888888889,75,95,95,95,95,85,540,0.6470588235294118,1.0
50,92,108,92,108,35,485,0.2457627118644068,63,120,85,90,55,55,468,0.2809917355371901,0.25
28,25,25,45,35,40,198,0.16083916083916083,40,80,100,30,30,20,300,0.11851851851851852,2.0
60,55,90,145,90,80,520,0.6071428571428571,40,45,40,65,40,65,295,0.5661764705882353,1.0
60,70,65,125,105,90,515,0.6911764705882353,75,90,90,140,90,115,600,0.9481481481481482,0.5
60,85,49,60,49,60,363,0.4444444444444444,50,45,45,35,35,50,260,0.23529411764705882,1.0
55,84,105,114,75,52,485,0.2890625,75,125,70,125,70,115,580,0.9037037037037037,1.0
70,115,60,115,60,55,475,0.4647887323943662,104,91,63,91,73,68,490,0.5118110236220472,1.0
40,55,70,45,60,30,300,0.10619469026548672,90,30,15,40,20,15,210,0.043478260869565216,0.5
58,70,45,40,45,42,300,0.25925925925925924,92,105,90,125,90,98,600,0.8217054263565892,2.0
45,60,32,50,32,76,295,0.5925925925925926,55,75,50,40,40,80,340,0.6302521008403361,2.0
190,33,58,33,58,33,405,0.13432835820895522,40,35,30,20,20,50,195,0.23423423423423423,2.0
59,110,150,45,49,35,448,0.3333333333333333,61,84,65,70,70,70,420,0.5,1.0
65,55,115,100,40,60,435,0.3798449612403101,74,100,72,90,72,46,454,0.24561403508771928,0.5
63,63,47,41,41,74,329,0.56,35,65,35,65,35,65,300,0.46621621621621623,1.0
45,95,50,40,50,75,355,0.54,63,63,47,41,41,74,329,0.56,1.0
62,48,54,63,60,68,355,0.5178571428571429,60,79,105,59,85,36,424,0.17054263565891473,2.0
70,65,65,55,55,70,380,0.5,80,70,70,90,100,70,480,0.5609756097560976,1.0
45,85,70,40,40,60,340,0.5229357798165137,85,105,55,85,50,115,495,0.9032258064516129,0.5
70,80,50,35,35,35,305,0.14,95,70,73,95,90,60,483,0.3983739837398374,0.5
75,98,63,98,63,101,498,0.849624060150376,60,80,50,50,50,40,330,0.23853211009174313,1.0
45,49,49,65,65,45,318,0.2781954887218045,75,90,90,140,90,115,600,0.9481481481481482,0.5
80,100,70,60,70,95,475,0.7416666666666667,60,100,89,55,69,112,485,0.9298245614035088,0.25
70,77,60,97,60,108,472,0.8394160583941606,60,80,50,40,40,30,300,0.15328467153284672,0.5
60,90,55,90,80,110,485,0.8677685950413223,110,123,65,100,65,65,528,0.5217391304347826,1.0
50,52,48,65,50,55,320,0.33098591549295775,58,64,58,80,65,80,405,0.609271523178808,2.0
100,100,100,100,100,100,600,0.8345864661654135,80,160,80,130,80,100,630,0.8455284552845529,0.5
60,85,60,50,50,125,430,0.9090909090909091,67,82,62,46,48,43,348,0.22033898305084745,2.0
160,110,65,65,110,30,540,0.35714285714285715,95,23,48,23,48,23,260,0.046153846153846156,1.0
54,66,70,44,55,46,335,0.4214876033057851,40,30,30,40,50,30,220,0.07936507936507936,1.0
110,80,90,95,90,65,530,0.5033557046979866,95,65,65,110,130,60,525,0.4016393442622951,1.0
59,110,150,45,49,35,448,0.3333333333333333,65,40,70,80,140,70,465,0.5954198473282443,0.5
45,50,43,40,38,62,278,0.40441176470588236,80,70,65,80,120,100,515,0.8034188034188035,1.0
50,180,20,180,20,150,600,0.9029850746268657,50,25,28,45,55,15,218,0.0625,1.0
110,85,95,80,95,50,515,0.2713178294573643,65,60,110,130,95,65,525,0.47761194029850745,1.0
40,30,32,50,52,65,269,0.3671875,60,48,45,43,90,42,328,0.21897810218978103,2.0
68,125,65,65,115,80,518,0.6277372262773723,80,80,80,55,55,90,440,0.6417910447761194,2.0
67,57,55,77,55,114,425,0.8879310344827587,74,100,72,90,72,46,454,0.24561403508771928,2.0
60,82,45,45,45,74,351,0.5752212389380531,55,70,40,60,40,40,305,0.26956521739130435,1.0
80,90,80,130,110,110,600,0.856,71,120,95,120,95,99,600,0.8203125,0.25
35,55,40,45,40,60,275,0.35714285714285715,35,60,44,40,54,55,288,0.366412213740458,1.0
50,35,55,25,25,15,205,0.021739130434782608,65,45,55,45,70,45,325,0.24369747899159663,1.0
40,45,35,30,40,55,245,0.3793103448275862,55,70,45,70,50,60,350,0.45,1.0
55,70,55,40,55,85,360,0.7073170731707317,60,90,55,90,80,110,485,0.8677685950413223,1.0
60,69,95,69,95,36,424,0.2608695652173913,65,95,57,100,85,93,495,0.7441860465116279,0.25
50,85,85,55,55,50,380,0.3902439024390244,35,60,44,40,54,55,288,0.366412213740458,0.5
160,110,65,65,110,30,540,0.35714285714285715,55,81,60,50,70,97,413,0.7214285714285714,1.0
80,185,115,40,105,75,600,0.6230769230769231,62,48,66,59,57,49,341,0.33884297520661155,0.25
75,100,63,80,63,116,497,0.9345794392523364,70,65,65,55,55,70,380,0.5,1.0
60,40,80,60,45,40,325,0.23529411764705882,30,80,90,55,45,55,355,0.4295774647887324,4.0
80,100,70,60,70,95,475,0.7416666666666667,90,50,34,60,44,70,348,0.6283185840707964,0.0
59,66,70,44,55,41,335,0.25190839694656486,60,75,85,100,85,115,520,0.8992248062015504,4.0
70,65,65,55,55,70,380,0.5,54,66,70,44,55,46,335,0.4214876033057851,0.0
35,40,100,90,55,35,355,0.1796875,45,22,60,27,30,29,213,0.07518796992481203,2.0
50,95,90,95,90,180,600,0.9172413793103448,71,120,95,120,95,99,600,0.8203125,0.5
77,120,90,60,90,48,485,0.2785714285714286,100,73,83,73,83,55,467,0.371900826446281,1.0
70,140,70,110,65,105,560,0.95,90,132,105,132,105,30,594,0.4246575342465753,0.5
55,65,95,95,45,85,440,0.6610169491525424,80,145,150,105,110,110,700,0.8692307692307693,1.0
100,100,100,100,100,100,600,0.8778625954198473,75,75,95,75,95,113,528,0.9015151515151515,2.0
60,80,50,40,40,30,300,0.15328467153284672,70,80,50,35,35,35,305,0.14,2.0
90,90,85,125,90,100,580,0.768595041322314,80,120,80,120,80,100,580,0.8478260869565217,1.0
75,123,67,95,85,95,540,0.7642276422764228,60,130,80,60,60,70,460,0.5153846153846153,0.5
30,65,100,45,25,40,305,0.1891891891891892,100,100,100,100,100,100,600,0.8758169934640523,1.0
50,160,110,160,110,110,700,0.8854961832061069,40,45,65,100,120,90,460,0.5588235294117647,1.0
79,115,70,125,80,111,580,0.864,28,25,25,45,35,40,198,0.16083916083916083,1.0
95,75,80,100,110,30,490,0.24242424242424243,60,150,50,150,50,60,520,0.5,0.5
90,75,75,90,100,70,500,0.5462184873949579,100,128,90,77,77,128,600,0.959349593495935,1.0
63,60,55,50,50,71,349,0.5289256198347108,60,40,50,75,85,95,405,0.6044776119402985,0.5
100,100,100,100,100,100,600,0.8758169934640523,60,60,40,65,45,35,305,0.15833333333333333,1.0
43,80,65,50,35,35,308,0.14193548387096774,165,75,80,40,45,65,470,0.5151515151515151,0.5
85,120,70,50,60,100,485,0.8308823529411765,78,84,78,109,85,100,534,0.8620689655172413,1.0
70,84,70,65,70,51,410,0.2949640287769784,90,75,75,90,100,70,500,0.5462184873949579,1.0
65,90,120,85,70,60,490,0.43410852713178294,60,82,45,45,45,74,351,0.5752212389380531,0.5
100,70,70,65,65,45,415,0.1897810218978102,90,90,85,125,90,100,580,0.768595041322314,1.0
50,50,95,40,50,35,320,0.20279720279720279,75,80,85,110,90,50,490,0.3548387096774194,1.0
45,35,45,62,53,35,275,0.11851851851851852,70,55,95,95,110,65,490,0.48872180451127817,1.0
45,90,20,65,20,65,305,0.5116279069767442,55,65,95,95,45,85,440,0.6610169491525424,0.5
79,115,70,125,80,111,580,0.864,65,125,100,55,70,85,500,0.6532258064516129,2.0
65,80,140,40,70,70,465,0.5223880597014925,45,80,100,35,37,28,325,0.3125,0.25
105,30,105,140,105,55,540,0.3524590163934426,46,57,40,40,40,50,273,0.25,2.0
43,70,48,50,60,38,309,0.2391304347826087,45,63,37,65,55,95,360,0.8055555555555556,1.0
74,100,72,90,72,46,454,0.24561403508771928,95,60,79,100,125,81,540,0.6201550387596899,2.0
85,105,55,85,50,115,495,0.9032258064516129,65,95,75,55,55,85,430,0.6933333333333334,0.5
95,70,73,95,90,60,483,0.3983739837398374,60,45,50,90,80,70,395,0.625,1.0
95,135,80,110,80,100,600,0.8248175182481752,41,56,40,62,44,71,314,0.568,1.0
30,65,100,45,25,40,305,0.1891891891891892,100,77,77,128,128,90,600,0.6901408450704225,1.0
70,115,60,115,60,55,475,0.4647887323943662,55,104,105,94,75,52,485,0.36363636363636365,2.0
60,59,85,79,105,36,424,0.16666666666666666,125,120,90,170,100,95,700,0.78125,0.5
125,120,90,170,100,95,700,0.78125,80,75,150,75,150,50,580,0.30973451327433627,0.25
65,50,35,115,95,95,455,0.7333333333333333,45,30,40,105,50,20,290,0.031007751937984496,0.5
80,105,105,105,105,80,580,0.5939849624060151,58,64,58,80,65,80,405,0.609271523178808,1.0
46,87,60,30,40,57,320,0.37777777777777777,105,105,75,65,100,50,500,0.37593984962406013,1.0
110,123,65,100,65,65,528,0.5217391304347826,60,40,80,60,45,40,325,0.23529411764705882,1.0
75,100,63,80,63,116,497,0.9345794392523364,80,115,80,65,55,93,488,0.7846153846153846,2.0
35,55,40,50,50,90,320,0.6838235294117647,80,70,70,90,100,70,480,0.5609756097560976,1.0
64,66,68,81,76,50,405,0.25190839694656486,70,90,45,15,45,50,315,0.3629032258064516,2.0
89,125,90,115,80,101,600,0.8725490196078431,40,65,95,60,45,35,340,0.13986013986013987,2.0
55,85,122,58,75,99,494,0.8099173553719008,65,80,140,40,70,70,465,0.5223880597014925,0.25
60,95,80,60,80,30,405,0.19480519480519481,40,65,40,80,40,65,330,0.5038167938931297,2.0
65,65,60,130,95,110,525,0.823943661971831,85,115,80,105,80,50,515,0.3063063063063063,1.0
95,65,65,110,130,60,525,0.4016393442622951,50,20,40,20,40,20,190,0.0962962962962963,1.0
80,105,65,60,75,130,515,0.9645390070921985,43,80,65,50,35,35,308,0.14193548387096774,1.0
45,49,49,65,65,45,318,0.2781954887218045,70,80,65,90,65,85,455,0.578125,1.0
68,72,78,38,42,32,330,0.23809523809523808,85,135,130,60,80,25,515,0.40540540540540543,2.0
80,135,85,70,95,150,615,0.9844961240310077,80,145,150,105,110,110,700,0.8692307692307693,0.25
125,130,90,130,90,95,660,0.7734375,64,165,75,93,83,75,555,0.6587301587301587,1.0
78,130,111,130,85,100,634,0.8561151079136691,150,80,44,90,54,80,498,0.625,1.0
66,41,77,61,87,23,355,0.12096774193548387,108,130,95,80,85,102,600,0.7637795275590551,0.5
50,47,50,57,50,65,319,0.463768115942029,81,102,77,85,75,85,505,0.5642857142857143,0.0
60,60,60,60,60,60,360,0.38095238095238093,60,40,60,95,60,55,370,0.4222222222222222,0.0
65,75,90,97,123,44,494,0.1987179487179487,35,46,34,35,45,20,215,0.072,1.0
70,85,140,85,70,20,470,0.272,65,75,105,35,65,85,430,0.6940298507462687,1.0
45,65,34,40,34,45,263,0.2589928057553957,43,30,55,40,65,97,330,0.6030534351145038,2.0
80,95,82,60,82,75,474,0.6,100,100,100,100,100,100,600,0.8805970149253731,1.0
111,83,68,92,82,39,475,0.1774193548387097,70,84,70,65,70,51,410,0.2949640287769784,8.0
1,90,45,30,30,40,236,0.33064516129032256,86,68,72,109,66,106,507,0.8099173553719008,0.0
35,40,100,90,55,35,355,0.1796875,75,95,67,125,95,83,540,0.7117117117117117,4.0
85,76,64,45,55,90,415,0.6739130434782609,97,165,60,65,50,58,495,0.3902439024390244,0.5
60,85,49,60,49,60,363,0.4444444444444444,78,130,111,130,85,100,634,0.8561151079136691,0.5
78,104,78,159,115,100,634,0.8444444444444444,60,69,95,69,95,36,424,0.2608695652173913,4.0
30,40,55,40,55,60,280,0.3237410071942446,85,90,80,70,80,130,535,0.9262295081967213,0.5
36,50,50,65,60,44,305,0.16363636363636364,120,120,120,120,120,120,720,0.9344262295081968,1.0
59,59,58,90,70,73,409,0.5826086956521739,78,70,61,50,61,100,420,0.8145161290322581,1.0
74,108,133,83,65,32,495,0.32142857142857145,125,170,100,120,90,95,700,0.77,1.0
55,65,35,60,30,85,330,0.6126126126126126,53,54,53,37,46,45,288,0.3090909090909091,1.0
75,98,63,98,63,101,498,0.889763779527559,55,95,55,35,75,115,430,0.9380530973451328,2.0
70,60,70,87,78,85,450,0.6228070175438597,65,50,70,95,80,65,425,0.4262295081967213,1.0
75,80,70,65,75,90,455,0.7578125,125,58,58,76,76,67,460,0.515625,0.5
40,45,40,65,40,65,295,0.5661764705882353,68,125,65,65,115,80,518,0.6277372262773723,1.0
75,95,125,45,75,95,510,0.8257575757575758,74,48,76,83,81,104,466,0.7913043478260869,1.0
80,45,65,90,110,80,470,0.5462962962962963,106,110,90,154,90,130,680,0.926829268292683,0.5
35,40,100,90,55,35,355,0.1796875,35,80,50,50,70,120,405,0.84375,1.0
50,70,50,50,50,40,310,0.16296296296296298,114,85,70,85,80,30,464,0.2066115702479339,0.5
76,25,45,67,55,24,292,0.0390625,90,60,60,40,40,40,330,0.29545454545454547,2.0
75,95,95,95,95,85,540,0.6470588235294118,40,60,30,31,31,70,262,0.4492753623188406,1.0
60,65,60,130,75,110,500,0.7719298245614035,65,60,70,85,75,40,395,0.1796875,0.0
70,85,140,85,70,20,470,0.272,110,80,90,95,90,65,530,0.5033557046979866,1.0
30,45,55,70,55,85,340,0.5633802816901409,65,150,60,115,60,115,565,0.935251798561151,1.0
30,65,100,45,25,40,305,0.1891891891891892,104,91,63,91,73,68,490,0.5118110236220472,1.0
150,160,100,95,65,100,670,0.8866666666666667,50,65,107,105,107,86,520,0.6991150442477876,1.0
70,140,70,110,65,105,560,0.95,41,50,37,50,37,66,281,0.5175438596491229,0.5
79,103,120,135,115,78,630,0.5763888888888888,48,61,40,61,40,50,300,0.2543859649122807,1.0
100,50,50,76,96,70,442,0.5,65,80,65,35,65,60,370,0.38405797101449274,1.0
50,85,85,55,55,50,380,0.3902439024390244,70,135,105,60,105,20,495,0.5806451612903226,0.25
59,74,50,35,50,35,303,0.3125,49,66,70,44,55,51,335,0.4260869565217391,1.0
30,42,118,42,88,30,350,0.112,45,22,60,27,30,29,213,0.07518796992481203,2.0
100,100,125,110,50,50,535,0.384,64,66,68,81,76,50,405,0.25190839694656486,2.0
64,165,75,93,83,75,555,0.6587301587301587,55,50,65,175,95,150,590,0.7818181818181819,2.0
126,131,95,131,98,99,680,0.8294573643410853,90,85,75,115,100,115,580,0.9381443298969072,1.0
55,40,40,65,45,35,280,0.16428571428571428,106,130,90,110,154,90,680,0.719626168224299,2.0
100,120,100,150,120,90,680,0.728,95,124,78,69,71,58,495,0.37398373983739835,1.0
91,90,72,90,129,108,580,0.896,55,65,35,60,30,85,330,0.6126126126126126,2.0
80,130,100,160,120,110,700,0.8981481481481481,84,71,43,71,43,48,360,0.25874125874125875,1.0
83,106,65,86,65,85,490,0.6640625,50,85,55,65,65,90,410,0.7478260869565218,1.0
90,95,95,70,90,70,510,0.5230769230769231,106,110,90,154,90,130,680,0.926829268292683,0.5
38,35,35,65,55,50,278,0.2647058823529412,55,40,85,80,105,40,405,0.23622047244094488,1.0
65,63,45,45,45,45,308,0.2595419847328244,63,120,85,90,55,55,468,0.2809917355371901,0.5
65,90,40,45,80,75,395,0.625,78,84,78,109,85,100,534,0.8620689655172413,0.5
90,65,65,40,40,15,315,0.19672131147540983,90,95,95,70,90,70,510,0.5230769230769231,0.5
50,65,45,85,65,95,405,0.7238095238095238,70,90,45,15,45,50,315,0.3629032258064516,0.5
100,77,77,128,128,90,600,0.6901408450704225,62,55,52,109,94,109,481,0.7833333333333333,1.0
45,53,70,40,60,42,310,0.25735294117647056,64,115,65,83,63,65,455,0.5323741007194245,0.5
75,80,60,65,90,102,472,0.8625954198473282,90,130,80,65,85,55,505,0.4396551724137931,1.0
54,66,70,44,55,46,335,0.4214876033057851,71,73,88,120,89,59,500,0.43537414965986393,2.0
91,90,129,90,72,108,580,0.9140625,60,60,60,60,60,60,360,0.38095238095238093,2.0
100,110,90,85,90,60,535,0.47794117647058826,65,110,130,60,65,95,525,0.8278145695364238,0.25
60,67,85,77,75,116,480,0.8888888888888888,59,110,150,45,49,35,448,0.3333333333333333,0.25
115,45,20,45,25,20,270,0.11538461538461539,70,110,75,145,85,145,630,0.9444444444444444,2.0
65,136,94,54,96,135,580,0.9612403100775194,101,72,72,99,89,29,462,0.1937984496124031,0.5
40,50,90,30,55,65,330,0.44680851063829785,40,55,30,30,30,85,270,0.688,0.5
75,123,67,95,85,95,540,0.7642276422764228,40,30,35,50,70,55,280,0.28205128205128205,0.5
50,50,95,40,50,35,320,0.20279720279720279,40,30,32,50,52,65,269,0.3671875,0.5
38,30,85,55,65,30,303,0.21428571428571427,100,100,100,100,100,100,600,0.8778625954198473,2.0
50,75,35,70,30,40,300,0.21296296296296297,45,60,40,70,50,45,310,0.2846715328467153,0.5
70,120,40,95,40,95,460,0.8106060606060606,80,50,100,100,200,50,580,0.2357142857142857,1.0
62,48,66,59,57,49,341,0.33884297520661155,77,120,90,60,90,48,485,0.2785714285714286,2.0
50,92,108,92,108,35,485,0.2457627118644068,55,75,60,75,60,103,428,0.7982456140350878,1.0
40,45,40,65,40,65,295,0.5661764705882353,45,25,50,25,25,35,205,0.13076923076923078,1.0
60,150,50,150,50,60,520,0.5,85,50,95,120,115,80,545,0.5793650793650794,0.5
100,134,110,95,100,61,600,0.4057971014492754,100,73,83,73,83,55,467,0.371900826446281,1.0
110,80,90,95,90,65,530,0.5033557046979866,65,155,120,65,90,105,600,0.8677685950413223,2.0
255,10,10,75,135,55,540,0.3125,45,100,45,45,45,10,290,0.2949640287769784,1.0
75,98,63,98,63,101,498,0.849624060150376,60,67,85,77,75,116,480,0.8888888888888888,0.5
78,92,75,74,63,118,500,0.8842975206611571,95,117,80,65,70,92,519,0.8409090909090909,2.0
70,120,65,45,85,125,510,0.9747899159663865,70,90,45,15,45,50,315,0.3629032258064516,0.5
91,90,72,90,129,108,580,0.896,60,40,50,75,85,95,405,0.6044776119402985,1.0
75,90,50,110,80,95,500,0.7985611510791367,91,90,72,90,129,108,580,0.896,1.0
75,90,140,60,60,40,465,0.3008130081300813,80,160,80,130,80,100,630,0.8455284552845529,0.125
36,50,50,65,60,44,305,0.16363636363636364,40,70,130,60,130,25,455,0.17355371900826447,1.0
50,65,107,105,107,86,520,0.703125,90,70,80,70,95,70,475,0.5190839694656488,0.5
105,150,90,150,90,95,680,0.8285714285714286,50,20,40,20,40,20,190,0.0962962962962963,0.0
68,85,65,165,135,100,618,0.8083333333333333,104,91,63,91,73,68,490,0.5118110236220472,1.0
85,80,70,135,75,90,535,0.7006802721088435,91,90,72,90,129,108,580,0.896,1.0
60,85,40,30,45,68,328,0.6422018348623854,100,100,90,150,140,90,670,0.71875,1.0
30,42,118,42,88,30,350,0.112,45,50,35,55,75,40,300,0.21367521367521367,1.0
59,45,40,35,40,31,250,0.14285714285714285,44,38,33,61,43,70,289,0.5267857142857143,1.0
40,50,45,70,45,70,320,0.5517241379310345,35,64,85,74,55,32,345,0.19827586206896552,1.0
70,60,75,110,75,90,480,0.7165354330708661,41,56,40,62,44,71,314,0.568,2.0
68,165,95,65,115,110,618,0.8615384615384616,84,86,88,111,101,60,530,0.4634146341463415,1.0
45,50,55,75,65,30,320,0.06293706293706294,65,65,60,110,95,130,525,0.9253731343283582,1.0
35,85,45,35,35,75,310,0.6492537313432836,40,60,40,40,40,30,250,0.0948905109489051,2.0
85,97,66,105,66,65,484,0.47107438016528924,95,145,130,120,90,120,700,0.9398496240601504,0.5
65,136,94,54,96,135,580,0.9612403100775194,75,75,60,83,60,60,413,0.39344262295081966,1.0
50,35,55,25,25,15,205,0.021739130434782608,35,55,35,30,30,35,220,0.23684210526315788,2.0
52,65,55,58,62,60,352,0.4482758620689655,69,55,45,55,55,15,294,0.11666666666666667,2.0
65,63,45,45,45,45,308,0.2595419847328244,60,95,80,60,80,30,405,0.19480519480519481,4.0
45,50,55,75,65,30,320,0.06293706293706294,80,70,65,80,120,100,515,0.8034188034188035,0.5
100,110,90,85,90,60,535,0.47794117647058826,55,65,35,60,30,85,330,0.6126126126126126,0.5
95,124,78,69,71,58,495,0.37398373983739835,45,100,135,65,135,45,525,0.29411764705882354,0.0
59,59,58,90,70,73,409,0.5826086956521739,90,120,100,150,120,100,680,0.7718120805369127,0.25
80,120,80,120,80,100,580,0.8478260869565217,35,64,85,74,55,32,345,0.19827586206896552,0.5
95,80,105,40,70,100,490,0.8046875,60,40,50,75,85,95,405,0.6044776119402985,1.0
59,110,150,45,49,35,448,0.3333333333333333,80,70,70,90,100,70,480,0.5609756097560976,0.5
70,75,60,105,60,105,475,0.88,50,85,40,85,40,35,335,0.1746031746031746,0.5
40,27,60,37,50,66,280,0.36220472440944884,85,80,70,135,75,90,535,0.7006802721088435,1.0
50,85,85,55,55,50,380,0.3902439024390244,85,110,90,45,90,80,500,0.6206896551724138,1.0
50,50,77,95,77,91,440,0.5916666666666667,65,80,140,40,70,70,465,0.5223880597014925,2.0
50,105,125,55,95,50,480,0.375886524822695,65,85,70,75,70,40,405,0.203125,0.5
35,40,100,90,55,35,355,0.1796875,50,65,45,85,65,95,405,0.7238095238095238,0.5
86,81,97,81,107,43,495,0.203125,55,85,55,50,55,60,360,0.4233576642335766,1.0
70,90,70,60,60,70,420,0.6390977443609023,95,100,85,108,70,70,528,0.5652173913043478,1.0
89,145,90,105,80,91,600,0.8549618320610687,90,75,75,90,100,70,500,0.5462184873949579,1.0
85,76,64,45,55,90,415,0.6739130434782609,100,90,130,45,65,55,485,0.4253731343283582,0.5
50,160,110,160,110,110,700,0.8854961832061069,68,72,78,38,42,32,330,0.23809523809523808,0.5
45,50,35,55,75,40,300,0.21367521367521367,59,59,58,90,70,73,409,0.5826086956521739,1.0
50,50,77,95,77,91,440,0.5916666666666667,75,95,67,125,95,83,540,0.7117117117117117,1.0
30,45,135,45,90,30,375,0.09285714285714286,60,60,50,40,50,75,335,0.5882352941176471,1.0
54,66,70,44,55,46,335,0.4214876033057851,65,95,100,60,50,50,420,0.34959349593495936,0.5
95,70,73,95,90,60,483,0.3983739837398374,45,95,50,40,50,75,355,0.54,1.0
75,125,100,70,80,45,495,0.33035714285714285,45,60,40,70,50,45,310,0.2846715328467153,1.0
74,108,133,83,65,32,495,0.32142857142857145,79,85,60,55,60,71,410,0.60431654676259,0.5
65,75,90,97,123,44,494,0.1987179487179487,65,90,122,58,75,84,494,0.71875,1.0
150,160,100,95,65,100,670,0.8866666666666667,100,100,90,150,140,90,670,0.71875,1.0
40,45,40,65,40,65,295,0.5661764705882353,50,72,35,35,35,65,292,0.5373134328358209,0.0
65,125,60,95,60,105,510,0.9236641221374046,110,65,75,125,85,30,490,0.15,0.5
70,120,65,45,85,125,510,0.9747899159663865,60,90,140,50,50,40,430,0.2535211267605634,0.5
80,105,105,105,105,80,580,0.5939849624060151,90,92,87,75,85,76,505,0.5409836065573771,4.0
85,135,130,60,80,25,515,0.40540540540540543,50,75,45,40,45,60,315,0.4380165289256198,2.0
75,90,50,110,80,95,500,0.7985611510791367,90,55,75,60,75,30,385,0.13970588235294118,1.0
40,70,40,35,40,60,285,0.392,75,90,50,110,80,95,500,0.7985611510791367,2.0
95,75,80,100,110,30,490,0.24242424242424243,95,65,110,60,130,65,525,0.5275590551181102,0.0
35,64,85,74,55,32,345,0.19827586206896552,50,60,60,60,60,30,320,0.11290322580645161,0.5
60,30,30,36,56,50,262,0.32432432432432434,80,120,130,55,65,45,495,0.37037037037037035,0.25
125,170,100,120,90,95,700,0.77,80,130,100,160,120,110,700,0.8981481481481481,4.0
61,72,57,55,55,65,365,0.3984375,95,65,110,60,130,65,525,0.5275590551181102,1.0
103,60,86,60,86,50,445,0.3458646616541353,100,150,120,120,100,90,680,0.6493506493506493,1.0
66,117,70,40,50,67,410,0.4573643410852713,70,90,45,15,45,50,315,0.3629032258064516,1.0
100,100,80,60,60,50,450,0.3050847457627119,45,95,50,40,50,75,355,0.54,1.0
25,35,70,95,55,45,325,0.16783216783216784,50,65,107,105,107,86,520,0.7313432835820896,0.125
40,35,30,120,70,105,400,0.6692307692307692,70,60,62,80,82,60,414,0.4375,1.0
55,20,35,20,45,75,250,0.37681159420289856,65,65,45,75,45,95,390,0.72,1.0
35,55,40,50,50,90,320,0.6838235294117647,70,140,230,60,80,50,630,0.32432432432432434,1.0
65,90,122,58,75,84,494,0.71875,55,75,50,40,40,80,340,0.6302521008403361,0.0
95,80,105,40,70,100,490,0.8046875,100,70,70,65,65,45,415,0.1897810218978102,1.0
105,30,105,140,105,55,540,0.3524590163934426,60,45,50,90,80,70,395,0.625,2.0
50,65,107,105,107,86,520,0.703125,70,100,115,30,65,30,410,0.24390243902439024,1.0
1,90,45,30,30,40,236,0.33064516129032256,60,100,115,70,85,90,520,0.7557251908396947,0.5
80,50,100,100,200,50,580,0.2357142857142857,95,117,184,44,46,28,514,0.2975206611570248,0.5
50,65,107,105,107,86,520,0.7313432835820896,50,20,40,20,40,20,190,0.0962962962962963,1.0
70,55,55,80,60,45,365,0.2222222222222222,60,85,60,85,60,55,405,0.3673469387755102,1.0
75,125,100,70,80,45,495,0.33035714285714285,54,45,47,75,98,52,371,0.39669421487603307,0.5
60,70,65,125,105,90,515,0.6911764705882353,40,45,40,62,60,60,307,0.33884297520661155,0.5
70,105,105,50,40,20,390,0.33587786259541985,150,120,100,120,100,90,680,0.664179104477612,1.0
55,75,85,25,25,15,280,0.1875,110,65,105,55,95,80,510,0.6258503401360545,2.0
45,63,37,65,55,95,360,0.8055555555555556,40,45,35,30,40,55,245,0.3793103448275862,2.0
65,75,105,35,65,85,430,0.6940298507462687,60,50,150,50,150,60,520,0.5206611570247934,1.0
80,160,60,170,130,80,680,0.6180555555555556,73,76,75,81,100,100,505,0.8110236220472441,1.0
50,60,45,100,80,65,400,0.45689655172413796,60,60,75,60,75,80,410,0.7321428571428571,1.0
90,120,75,60,60,45,450,0.29411764705882354,108,112,118,68,72,47,525,0.2916666666666667,1.0
150,100,120,100,120,90,680,0.6666666666666666,75,98,63,98,63,101,498,0.8091603053435115,1.0
60,70,50,100,50,65,395,0.5217391304347826,105,130,120,45,45,40,485,0.4444444444444444,0.5
75,65,55,65,55,69,384,0.43548387096774194,80,50,100,100,200,50,580,0.2357142857142857,1.0
80,80,50,40,50,25,325,0.176056338028169,100,75,115,90,115,85,580,0.6446280991735537,1.0
70,80,102,80,102,40,474,0.2677165354330709,70,120,100,145,105,20,560,0.2824427480916031,0.5
64,66,68,81,76,50,405,0.25190839694656486,90,120,100,150,120,100,680,0.7718120805369127,0.25
40,55,30,30,30,85,270,0.688,70,60,62,80,82,60,414,0.4375,2.0
59,66,70,44,55,41,335,0.25190839694656486,75,80,60,65,90,102,472,0.8625954198473282,0.0
75,110,110,110,105,80,590,0.656934306569343,95,23,48,23,48,23,260,0.046153846153846156,1.0
103,60,126,80,126,50,545,0.36363636363636365,69,55,45,55,55,15,294,0.11666666666666667,0.5
70,130,100,55,80,65,500,0.608,50,35,55,25,25,15,205,0.021739130434782608,1.0
90,65,65,40,40,15,315,0.19672131147540983,70,80,50,35,35,35,305,0.14,1.0
50,45,45,35,35,50,260,0.23529411764705882,50,48,43,46,41,60,288,0.47297297297297297,1.0
62,77,62,50,42,65,358,0.4838709677419355,90,70,80,70,95,70,475,0.5190839694656488,1.0
95,100,85,108,70,70,528,0.5652173913043478,40,45,40,35,35,56,251,0.373015873015873,1.0
30,40,55,40,55,60,280,0.3237410071942446,50,65,107,105,107,86,520,0.703125,2.0
70,80,102,80,102,40,474,0.2677165354330709,120,120,120,120,120,120,720,0.9344262295081968,1.0
62,73,55,56,52,84,382,0.7244094488188977,70,140,70,110,65,105,560,0.95,0.5
73,76,75,81,100,100,505,0.8110236220472441,72,58,80,103,80,97,490,0.7171052631578947,1.0
60,70,105,70,120,75,500,0.5983606557377049,65,75,70,95,70,95,470,0.7272727272727273,0.0
60,48,45,43,90,42,328,0.21897810218978103,69,55,45,55,55,15,294,0.11666666666666667,2.0
45,45,55,45,55,63,308,0.4594594594594595,55,75,50,40,40,80,340,0.6302521008403361,0.5
130,65,60,110,95,65,525,0.5227272727272727,95,117,80,65,70,92,519,0.8409090909090909,2.0
70,94,50,94,50,66,424,0.48148148148148145,65,95,100,60,50,50,420,0.34959349593495936,1.0
50,75,70,35,70,48,348,0.29357798165137616,65,75,90,97,123,44,494,0.1987179487179487,0.5
70,60,125,115,70,55,495,0.35507246376811596,60,85,49,60,49,60,363,0.4444444444444444,1.0
70,80,102,80,102,40,474,0.2677165354330709,85,76,64,45,55,90,415,0.6739130434782609,1.0
35,35,40,35,55,50,250,0.40336134453781514,40,55,30,30,30,60,245,0.43548387096774194,0.5
95,145,130,120,90,120,700,0.9398496240601504,50,50,77,95,77,91,440,0.5916666666666667,0.5
40,40,55,40,70,55,300,0.40939597315436244,115,140,130,55,55,40,535,0.4519230769230769,4.0
67,58,57,81,67,101,431,0.8790322580645161,68,125,65,65,115,80,518,0.6277372262773723,2.0
90,92,75,92,85,60,494,0.49586776859504134,45,30,50,55,65,45,290,0.208,1.0
111,83,68,92,82,39,475,0.1774193548387097,45,30,15,85,65,65,305,0.36220472440944884,1.0
65,40,70,80,140,70,465,0.5954198473282443,100,164,150,95,120,71,700,0.5645161290322581,1.0
65,90,40,45,80,75,395,0.625,100,70,70,65,65,45,415,0.1897810218978102,1.0
57,24,86,24,86,23,300,0.12727272727272726,68,65,65,125,115,80,518,0.6461538461538462,0.25
90,132,105,132,105,30,594,0.4246575342465753,70,94,50,94,50,66,424,0.48148148148148145,0.5
40,40,40,70,40,20,250,0.032520325203252036,77,120,90,60,90,48,485,0.2785714285714286,0.5
45,45,35,20,30,20,195,0.07246376811594203,80,110,60,150,130,70,600,0.5042016806722689,1.0
85,115,80,105,80,50,515,0.3063063063063063,85,105,85,40,50,40,405,0.211864406779661,1.0
70,100,70,105,75,40,460,0.23214285714285715,89,124,80,55,80,55,483,0.5714285714285714,1.0
67,58,57,81,67,101,431,0.8790322580645161,70,62,67,55,55,56,365,0.38513513513513514,0.5
45,35,45,62,53,35,275,0.11851851851851852,62,55,52,109,94,109,481,0.7833333333333333,1.0
59,63,80,65,80,58,405,0.41843971631205673,55,70,45,70,50,60,350,0.45,2.0
41,50,37,50,37,66,281,0.5175438596491229,50,65,107,105,107,86,520,0.7758620689655172,1.0
105,105,75,65,100,50,500,0.37593984962406013,35,70,55,45,55,25,285,0.09420289855072464,2.0
59,74,50,35,50,35,303,0.3125,80,95,82,60,82,75,474,0.6,2.0
30,40,55,40,55,60,280,0.3237410071942446,40,40,40,70,40,20,250,0.032520325203252036,1.0
45,55,45,65,45,75,330,0.5692307692307692,45,75,60,40,30,50,300,0.304,2.0
80,120,79,95,79,70,523,0.5833333333333334,170,90,45,90,45,60,500,0.427536231884058,2.0
100,150,120,120,100,90,680,0.6493506493506493,75,90,50,110,80,95,500,0.7985611510791367,1.0
58,109,112,48,48,109,484,0.8805970149253731,75,75,95,75,95,113,528,0.9015151515151515,2.0
60,67,85,77,75,116,480,0.8888888888888888,45,35,45,62,53,35,275,0.11851851851851852,0.5
55,75,50,40,40,80,340,0.6302521008403361,100,100,100,100,100,100,600,0.831858407079646,1.0
100,150,110,95,110,70,635,0.5923076923076923,100,100,100,100,100,100,600,0.8805970149253731,0.5
54,78,103,53,45,22,355,0.23255813953488372,58,70,45,40,45,42,300,0.25925925925925924,0.5
30,45,59,30,39,57,260,0.2803030303030303,70,60,75,110,75,90,480,0.7165354330708661,4.0
63,60,55,50,50,71,349,0.5289256198347108,30,30,30,30,30,30,180,0.12612612612612611,2.0
65,150,40,15,80,145,495,0.9663865546218487,59,63,80,65,80,58,405,0.41843971631205673,1.0
60,90,140,50,50,40,430,0.2535211267605634,38,41,40,50,65,65,299,0.4108527131782946,1.0
74,48,76,83,81,104,466,0.7322834645669292,55,65,35,60,30,85,330,0.6126126126126126,1.0
70,95,125,65,75,45,475,0.33613445378151263,95,125,79,60,100,81,540,0.6165413533834586,1.0
70,80,102,80,102,40,474,0.2677165354330709,45,30,35,20,20,45,195,0.14782608695652175,2.0
70,95,85,55,65,70,440,0.5,250,5,5,35,105,50,450,0.15306122448979592,1.0
100,70,70,65,65,45,415,0.1897810218978102,80,105,65,60,75,130,515,0.9645390070921985,0.5
60,85,60,50,50,125,430,0.9090909090909091,85,50,95,120,115,80,545,0.5793650793650794,1.0
115,45,20,45,25,20,270,0.11538461538461539,38,35,40,27,25,35,200,0.08208955223880597,1.0
58,64,58,80,65,80,405,0.609271523178808,45,30,15,85,65,65,305,0.36220472440944884,2.0
50,85,55,65,65,90,410,0.7478260869565218,73,76,75,81,100,100,505,0.8110236220472441,0.5
40,40,50,30,30,30,220,0.0873015873015873,50,95,95,35,110,70,455,0.5179856115107914,1.0
41,50,37,50,37,66,281,0.5175438596491229,60,59,85,79,105,36,424,0.16666666666666666,1.0
90,85,100,95,125,85,580,0.6834532374100719,30,56,35,25,35,72,253,0.48148148148148145,1.0
39,52,43,60,50,65,309,0.49107142857142855,106,130,90,110,154,90,680,0.719626168224299,0.5
86,68,72,109,66,106,507,0.8099173553719008,85,76,64,45,55,90,415,0.6739130434782609,1.0
48,61,40,61,40,50,300,0.2543859649122807,75,125,230,55,95,30,610,0.3448275862068966,0.0
70,90,70,60,60,70,420,0.6390977443609023,70,135,105,60,105,20,495,0.5806451612903226,1.0
95,145,130,120,90,120,700,0.9398496240601504,85,105,100,79,83,78,530,0.5869565217391305,1.0
75,100,95,40,70,110,490,0.8717948717948718,90,60,70,75,70,45,410,0.23880597014925373,1.0
75,89,85,55,65,36,405,0.29545454545454547,75,75,130,75,130,95,580,0.7479674796747967,1.0
60,59,85,79,105,36,424,0.16666666666666666,103,60,86,60,86,50,445,0.3458646616541353,1.0
50,85,85,55,55,50,380,0.3902439024390244,95,124,78,69,71,58,495,0.37398373983739835,4.0
60,45,70,75,85,55,390,0.3008130081300813,71,120,95,120,95,99,600,0.8203125,0.5
40,55,30,30,30,85,270,0.688,60,62,50,62,60,40,334,0.18181818181818182,2.0
70,95,85,55,65,70,440,0.5,165,75,80,40,45,65,470,0.5151515151515151,1.0
40,45,40,62,60,60,307,0.33884297520661155,89,124,80,55,80,55,483,0.5714285714285714,1.0
65,85,70,75,70,40,405,0.203125,40,45,40,65,40,65,295,0.5661764705882353,0.5
70,83,50,37,50,60,350,0.3360655737704918,100,73,83,73,83,55,467,0.371900826446281,1.0
70,120,40,95,40,95,460,0.8106060606060606,40,60,40,40,40,30,250,0.0948905109489051,1.0
48,61,40,61,40,50,300,0.2543859649122807,70,110,70,115,70,90,525,0.75,0.0
45,100,135,65,135,45,525,0.29411764705882354,85,70,80,97,80,123,535,0.9304347826086956,1.0
89,125,90,115,80,101,600,0.8725490196078431,49,66,70,44,55,51,335,0.4260869565217391,1.0
20,25,45,70,90,60,310,0.30833333333333335,50,85,85,55,55,50,380,0.3902439024390244,0.25
50,85,125,85,115,20,480,0.4306569343065693,35,60,44,40,54,55,288,0.366412213740458,1.0
40,80,100,30,30,20,300,0.11851851851851852,80,75,150,75,150,50,580,0.30973451327433627,1.0
100,123,75,57,75,80,510,0.6923076923076923,114,85,70,85,80,30,464,0.2066115702479339,2.0
150,80,44,90,54,80,498,0.625,66,65,48,62,57,52,350,0.36220472440944884,2.0
73,115,60,60,60,90,458,0.6694915254237288,105,180,100,180,100,115,780,0.9477611940298507,1.0
100,100,125,110,50,50,535,0.384,60,59,85,79,105,36,424,0.16666666666666666,0.25
95,125,79,60,100,81,540,0.6165413533834586,62,48,66,59,57,49,341,0.33884297520661155,1.0
90,110,80,100,80,95,555,0.7982456140350878,65,83,57,95,85,105,490,0.8914728682170543,1.0
38,36,38,32,36,57,237,0.3893805309734513,70,80,50,35,35,35,305,0.14,1.0
78,81,71,74,69,126,499,0.9090909090909091,46,57,40,40,40,50,273,0.25,1.0
60,85,69,65,79,80,438,0.576,80,110,120,130,90,70,600,0.6198347107438017,1.0
85,115,80,105,80,50,515,0.3063063063063063,38,30,85,55,65,30,303,0.21428571428571427,1.0
70,70,40,60,40,60,340,0.4247787610619469,70,110,70,115,70,90,525,0.75,0.25
75,90,90,140,90,115,600,0.9481481481481482,45,35,50,70,50,30,280,0.15753424657534246,2.0
55,84,105,114,75,52,485,0.2890625,85,60,65,135,105,100,550,0.7518248175182481,2.0
60,52,168,47,138,30,495,0.19834710743801653,100,164,150,95,120,71,700,0.5645161290322581,2.0
95,95,85,125,65,55,520,0.3894736842105263,90,75,85,115,90,55,510,0.3445378151260504,1.0
55,47,52,40,40,41,275,0.16806722689075632,65,65,60,130,95,110,525,0.823943661971831,1.0
40,60,40,40,40,30,250,0.0948905109489051,100,150,120,120,100,90,680,0.6493506493506493,1.0
59,110,150,45,49,35,448,0.3333333333333333,45,85,70,40,40,60,340,0.5229357798165137,0.25
65,75,105,35,65,85,430,0.6940298507462687,50,64,50,45,50,41,300,0.22727272727272727,1.0
30,45,135,45,90,30,375,0.09285714285714286,35,80,50,50,70,120,405,0.84375,0.5
103,93,67,71,61,84,479,0.7142857142857143,78,104,78,159,115,100,634,0.8444444444444444,1.0
76,104,71,104,71,108,534,0.912751677852349,70,84,70,65,70,51,410,0.2949640287769784,1.0
75,75,130,75,130,95,580,0.7479674796747967,30,80,90,55,45,55,355,0.4295774647887324,1.0
105,125,100,60,100,100,590,0.8359375,35,55,40,50,50,90,320,0.6838235294117647,1.0
39,52,43,60,50,65,309,0.5041322314049587,50,150,50,150,50,150,600,0.9339622641509434,1.0
65,60,70,85,75,40,395,0.1796875,64,51,23,51,23,28,240,0.11363636363636363,1.0
100,110,90,85,90,60,535,0.47794117647058826,100,100,125,110,50,50,535,0.384,0.25
125,120,90,170,100,95,700,0.78125,85,120,70,50,60,100,485,0.8308823529411765,2.0
40,50,45,70,45,70,320,0.5517241379310345,60,59,85,79,105,36,424,0.16666666666666666,4.0
79,115,70,125,80,111,580,0.864,68,165,95,65,115,110,618,0.8615384615384616,2.0
20,10,55,15,20,80,200,0.17985611510791366,86,92,88,68,75,73,482,0.6835443037974683,1.0
103,60,86,60,86,50,445,0.3458646616541353,71,73,88,120,89,59,500,0.43537414965986393,1.0
77,59,50,67,63,46,362,0.23140495867768596,125,120,90,170,100,95,700,0.78125,2.0
90,60,70,75,70,45,410,0.23880597014925373,97,165,60,65,50,58,495,0.3902439024390244,2.0
56,61,65,48,45,38,313,0.17567567567567569,60,40,60,95,60,55,370,0.4222222222222222,0.5
75,95,67,125,95,83,540,0.7117117117117117,50,75,70,35,70,48,348,0.29357798165137616,1.0
80,90,80,130,110,110,600,0.856,40,80,35,35,45,70,305,0.4661016949152542,1.0
40,40,40,70,40,20,250,0.032520325203252036,52,65,55,58,62,60,352,0.4482758620689655,1.0
55,65,35,60,30,85,330,0.6126126126126126,40,50,90,30,55,65,330,0.44680851063829785,1.0
125,130,90,130,90,95,660,0.7734375,50,85,125,85,115,20,480,0.4306569343065693,1.0
80,50,100,100,200,50,580,0.2357142857142857,70,120,65,45,85,125,510,0.9747899159663865,0.5
75,95,60,65,60,115,470,0.8778625954198473,25,20,15,105,55,90,310,0.32407407407407407,1.0
65,125,60,95,60,105,510,0.9236641221374046,45,35,50,70,50,30,280,0.15753424657534246,1.0
90,120,100,150,120,100,680,0.7718120805369127,84,71,43,71,43,48,360,0.25874125874125875,1.0
90,50,34,60,44,70,348,0.6283185840707964,72,85,70,65,70,58,420,0.41304347826086957,0.5
80,95,82,60,82,75,474,0.6,70,80,50,35,35,35,305,0.14,1.0
60,50,70,50,90,65,385,0.39568345323741005,150,80,44,90,54,80,498,0.625,0.125
78,84,78,109,85,100,534,0.8646616541353384,95,23,48,23,48,23,260,0.046153846153846156,1.0
50,50,62,40,62,65,329,0.4188034188034188,45,22,60,27,30,29,213,0.07518796992481203,1.0
70,75,60,105,60,105,475,0.88,45,85,70,40,40,60,340,0.5229357798165137,1.0
75,123,67,95,85,95,540,0.7642276422764228,90,100,60,90,60,80,480,0.6422764227642277,0.5
45,30,35,20,20,45,195,0.14782608695652175,45,55,39,35,39,42,255,0.18518518518518517,1.0
40,45,65,100,120,90,460,0.5588235294117647,95,70,73,95,90,60,483,0.3983739837398374,1.0
85,110,90,45,90,80,500,0.6206896551724138,60,60,60,85,85,85,435,0.631578947368421,0.0
45,65,34,40,34,45,263,0.2589928057553957,68,165,95,65,115,110,618,0.8615384615384616,1.0
70,80,102,80,102,40,474,0.2677165354330709,50,72,35,35,35,65,292,0.5373134328358209,2.0
40,45,35,40,40,90,290,0.65,60,115,105,65,70,80,495,0.7181818181818181,0.5
80,160,80,130,80,100,630,0.8455284552845529,85,70,80,97,80,123,535,0.9304347826086956,0.25
90,120,75,60,60,45,450,0.29411764705882354,60,52,168,47,138,30,495,0.19834710743801653,0.5
80,85,95,30,30,25,345,0.2857142857142857,60,75,85,100,85,115,520,0.8992248062015504,1.0
70,43,53,43,53,40,302,0.19090909090909092,90,120,100,150,120,100,680,0.7718120805369127,1.0
90,75,85,115,90,55,510,0.3445378151260504,68,72,78,38,42,32,330,0.23809523809523808,0.0
75,125,75,30,75,85,465,0.625,60,85,49,60,49,60,363,0.4444444444444444,1.0
54,78,103,53,45,22,355,0.23255813953488372,60,65,70,85,75,40,395,0.21705426356589147,0.5
100,150,90,180,160,90,770,0.7348484848484849,50,47,50,57,50,65,319,0.463768115942029,1.0
76,104,71,104,71,108,534,0.912751677852349,50,48,43,46,41,60,288,0.47297297297297297,0.5
90,55,75,60,75,30,385,0.13970588235294118,58,70,45,40,45,42,300,0.25925925925925924,1.0
70,55,65,95,85,70,440,0.5307692307692308,75,110,110,110,105,80,590,0.656934306569343,1.0
50,50,40,30,30,50,250,0.2781954887218045,78,104,78,159,115,100,634,0.8444444444444444,0.0
57,24,86,24,86,23,300,0.12727272727272726,20,10,230,10,230,5,505,0.0,2.0
50,50,77,95,77,91,440,0.5916666666666667,65,73,55,47,75,85,400,0.6846846846846847,1.0
70,85,65,105,85,120,530,0.9262295081967213,50,50,120,80,80,30,410,0.07258064516129033,1.0
55,45,50,45,65,80,340,0.5546218487394958,100,77,77,128,128,90,600,0.6901408450704225,1.0
60,80,110,50,80,45,425,0.2833333333333333,55,55,45,63,45,45,308,0.25,1.0
50,40,85,40,65,25,305,0.08870967741935484,50,20,55,25,25,30,205,0.09774436090225563,1.0
80,95,82,60,82,75,474,0.6,75,90,140,60,60,40,465,0.3008130081300813,0.0
30,30,30,30,30,30,180,0.12612612612612611,55,63,90,50,80,42,380,0.21138211382113822,0.25
60,25,35,70,80,60,330,0.3076923076923077,40,70,40,35,40,60,285,0.392,1.0
65,76,84,54,96,105,480,0.9008264462809917,135,85,40,40,85,5,390,0.6864406779661016,1.0
45,85,70,40,40,60,340,0.5229357798165137,70,80,65,90,65,85,455,0.578125,2.0
55,45,50,45,65,80,340,0.5546218487394958,60,110,70,60,60,100,460,0.8461538461538461,0.5
40,35,30,20,20,50,195,0.23423423423423423,57,24,86,24,86,23,300,0.12727272727272726,0.0
106,150,70,194,120,140,780,0.952,91,72,90,129,90,108,580,0.8620689655172413,1.0
75,95,67,125,95,83,540,0.7117117117117117,70,115,60,115,60,55,475,0.4647887323943662,2.0
85,56,77,50,77,78,423,0.53125,71,120,95,120,95,99,600,0.8203125,0.5
60,100,115,70,85,90,520,0.7557251908396947,75,90,90,140,90,115,600,0.9481481481481482,0.5
36,50,50,65,60,44,305,0.16363636363636364,85,50,95,120,115,80,545,0.5793650793650794,2.0
95,23,48,23,48,23,260,0.046153846153846156,80,115,80,65,55,93,488,0.7846153846153846,1.0
72,60,30,20,30,25,237,0.11570247933884298,75,80,85,110,90,50,490,0.3548387096774194,0.5
60,62,63,80,80,60,405,0.38016528925619836,85,100,122,58,75,54,494,0.3939393939393939,0.5
108,112,118,68,72,47,525,0.2916666666666667,60,85,69,60,69,77,420,0.518796992481203,1.0
80,105,105,105,105,80,580,0.5939849624060151,60,85,69,65,79,80,438,0.576,2.0
73,115,60,60,60,90,458,0.6694915254237288,83,106,65,86,65,85,490,0.6640625,1.0
89,124,80,55,80,55,483,0.5714285714285714,111,83,68,92,82,39,475,0.1774193548387097,1.0
90,75,75,90,100,70,500,0.5462184873949579,38,35,35,65,55,50,278,0.2647058823529412,1.0
45,30,40,105,50,20,290,0.031007751937984496,50,85,40,85,40,35,335,0.1746031746031746,1.0
60,100,115,70,85,90,520,0.7557251908396947,70,94,50,94,50,66,424,0.48148148148148145,1.0
91,134,95,100,100,80,600,0.6304347826086957,65,150,60,115,60,115,565,0.935251798561151,1.0
75,123,67,95,85,95,540,0.7642276422764228,68,75,53,83,113,60,452,0.45384615384615384,0.5
65,83,57,95,85,105,490,0.8914728682170543,105,130,120,45,45,40,485,0.4444444444444444,0.0
60,90,55,90,80,110,485,0.8677685950413223,50,65,107,105,107,86,520,0.7272727272727273,1.0
68,90,65,50,55,82,410,0.6165413533834586,80,100,80,80,80,100,520,0.9051724137931034,2.0
75,123,67,95,85,95,540,0.7642276422764228,50,50,95,40,50,35,320,0.20279720279720279,0.0
80,110,60,150,130,70,600,0.5042016806722689,50,105,79,35,110,76,455,0.6214285714285714,1.0
60,70,65,125,105,90,515,0.6911764705882353,70,43,53,43,53,40,302,0.19090909090909092,0.25
44,48,65,50,64,43,314,0.1623931623931624,45,45,55,45,55,63,308,0.4594594594594595,0.5
45,50,45,115,55,95,405,0.6936936936936937,110,135,60,50,65,88,508,0.7744360902255639,0.0
70,70,70,70,70,70,420,0.5289256198347108,43,30,55,40,65,97,330,0.6030534351145038,1.0
69,55,45,55,55,15,294,0.11666666666666667,55,68,64,45,55,31,318,0.11666666666666667,1.0
55,75,85,25,25,15,280,0.1875,90,120,100,150,120,100,680,0.7718120805369127,1.0
38,35,40,27,25,35,200,0.08208955223880597,61,78,95,56,58,57,405,0.40336134453781514,2.0
60,90,140,50,50,40,430,0.2535211267605634,75,98,63,98,63,101,498,0.8091603053435115,1.0
50,70,50,50,50,70,340,0.5645161290322581,85,105,55,85,50,115,495,0.9032258064516129,1.0
55,75,60,75,60,103,428,0.7982456140350878,85,80,70,135,75,90,535,0.7006802721088435,1.0
95,110,95,40,95,55,490,0.40336134453781514,70,55,65,95,85,70,440,0.5307692307692308,0.5
70,90,110,60,75,95,500,0.7333333333333333,85,76,64,45,55,90,415,0.6739130434782609,1.0
80,135,85,70,95,150,615,0.9844961240310077,45,67,60,35,50,63,320,0.5128205128205128,1.0
35,64,85,74,55,32,345,0.19827586206896552,100,150,140,100,90,90,670,0.7969924812030075,2.0
70,130,100,55,80,65,500,0.608,80,85,95,30,30,25,345,0.2857142857142857,2.0
67,57,55,77,55,114,425,0.8879310344827587,103,60,86,60,86,50,445,0.3458646616541353,1.0
85,70,80,97,80,123,535,0.9304347826086956,65,90,40,45,80,75,395,0.625,2.0
109,66,84,81,99,32,471,0.2013888888888889,75,80,95,90,100,50,490,0.2158273381294964,0.25
83,80,80,135,80,121,579,0.9444444444444444,45,20,50,60,120,50,345,0.24074074074074073,1.0
150,120,100,120,100,90,680,0.664179104477612,40,30,50,55,55,100,330,0.584070796460177,1.0
100,100,100,100,100,100,600,0.8758169934640523,110,80,90,95,90,65,530,0.5033557046979866,1.0
40,55,99,40,79,47,360,0.26262626262626265,79,85,60,55,60,71,410,0.60431654676259,1.0
100,134,110,95,100,61,600,0.4057971014492754,40,40,50,30,30,30,220,0.0873015873015873,1.0
70,55,95,95,110,65,490,0.48872180451127817,35,45,160,30,45,70,385,0.48148148148148145,2.0
25,35,70,95,55,45,325,0.16783216783216784,60,65,60,130,75,110,500,0.7719298245614035,1.0
35,55,40,50,50,90,320,0.6838235294117647,100,100,100,100,100,100,600,0.8345864661654135,0.5
75,95,67,125,95,83,540,0.7117117117117117,40,40,50,30,30,30,220,0.0873015873015873,2.0
55,95,115,45,45,35,390,0.2116788321167883,65,80,140,40,70,70,465,0.5223880597014925,0.0
100,100,90,150,140,90,670,0.71875,50,50,40,30,30,50,250,0.2781954887218045,2.0
62,73,55,56,52,84,382,0.7244094488188977,52,65,55,58,62,60,352,0.4482758620689655,1.0
55,85,122,58,75,99,494,0.8099173553719008,126,131,95,131,98,99,680,0.8294573643410853,1.0
68,90,65,50,55,82,410,0.6165413533834586,70,80,70,80,70,110,480,0.6594202898550725,1.0
48,72,48,72,48,48,336,0.25984251968503935,30,35,30,100,35,80,310,0.4765625,2.0
80,120,80,120,80,100,580,0.8478260869565217,65,90,120,85,70,60,490,0.43410852713178294,1.0
80,50,100,100,200,50,580,0.2357142857142857,110,80,90,95,90,65,530,0.5033557046979866,0.25
50,50,95,40,50,35,320,0.20279720279720279,58,50,145,95,105,30,483,0.2459016393442623,1.0
50,75,75,65,65,50,380,0.4049586776859504,50,65,107,105,107,86,520,0.703125,1.0
60,60,40,65,45,35,305,0.15833333333333333,100,150,110,95,110,70,635,0.5923076923076923,0.5
40,29,45,29,45,36,224,0.14634146341463414,60,50,150,50,150,60,520,0.5206611570247934,0.25
91,129,90,72,90,108,580,0.8536585365853658,55,50,65,175,95,150,590,0.7818181818181819,0.5
65,90,40,45,80,75,395,0.625,60,25,35,70,80,60,330,0.3076923076923077,2.0
69,55,45,55,55,15,294,0.11666666666666667,85,135,130,60,80,25,515,0.40540540540540543,1.0
60,50,50,60,70,50,340,0.28346456692913385,65,47,55,73,75,85,400,0.65,0.5
80,120,70,110,70,80,530,0.6422764227642277,91,72,90,129,90,108,580,0.8620689655172413,0.5
60,70,50,100,50,65,395,0.5217391304347826,70,115,60,115,60,55,475,0.4647887323943662,8.0
100,100,100,100,100,100,600,0.8602941176470589,59,45,40,35,40,31,250,0.14285714285714285,1.0
38,30,85,55,65,30,303,0.21428571428571427,91,134,95,100,100,80,600,0.6304347826086957,1.0
46,57,40,40,40,50,273,0.25,90,120,100,150,120,100,680,0.7718120805369127,1.0
95,117,184,44,46,28,514,0.2975206611570248,50,85,125,85,115,20,480,0.4306569343065693,1.0
38,30,41,30,41,60,240,0.2897196261682243,40,45,35,65,55,70,310,0.4482758620689655,1.0
45,30,50,55,65,45,290,0.208,90,85,100,95,125,85,580,0.6834532374100719,1.0
70,100,115,30,65,30,410,0.24390243902439024,68,75,53,83,113,60,452,0.45384615384615384,1.0
100,100,100,100,100,100,600,0.8805970149253731,80,82,78,95,80,85,500,0.6869565217391305,0.5
45,35,50,70,50,30,280,0.15753424657534246,90,95,95,70,90,70,510,0.5230769230769231,2.0
50,50,40,30,30,50,250,0.2781954887218045,91,90,129,90,72,108,580,0.9140625,1.0
50,70,50,50,50,40,310,0.16296296296296298,74,94,131,54,116,20,489,0.4485294117647059,0.5
75,140,65,112,65,110,567,0.9140625,55,65,35,60,30,85,330,0.6126126126126126,1.0
71,82,64,64,59,112,452,0.9327731092436975,40,80,100,30,30,20,300,0.11851851851851852,0.5
125,170,100,120,90,95,700,0.77,50,53,48,53,48,64,316,0.358974358974359,0.5
30,40,55,40,55,60,280,0.3237410071942446,70,83,50,37,50,60,350,0.3360655737704918,1.0
65,95,75,55,55,85,430,0.6933333333333334,35,70,55,45,55,25,285,0.09420289855072464,1.0
80,130,100,160,120,110,700,0.8981481481481481,40,50,90,30,55,65,330,0.44680851063829785,2.0
35,35,35,35,35,35,210,0.13385826771653545,85,50,95,120,115,80,545,0.5793650793650794,0.25
50,75,70,35,70,48,348,0.29357798165137616,110,78,73,76,71,60,468,0.3333333333333333,1.0
20,40,90,30,90,25,295,0.11363636363636363,100,128,90,77,77,128,600,0.959349593495935,0.0
95,70,73,95,90,60,483,0.3983739837398374,100,90,130,45,65,55,485,0.4253731343283582,1.0
60,80,50,50,50,40,330,0.23853211009174313,50,95,180,85,45,70,525,0.5298507462686567,1.0
115,140,130,55,55,40,535,0.4519230769230769,115,115,85,90,75,100,580,0.8134328358208955,4.0
78,84,78,109,85,100,534,0.8646616541353384,80,70,65,80,120,100,515,0.8034188034188035,0.5
76,104,71,104,71,108,534,0.912751677852349,95,124,78,69,71,58,495,0.37398373983739835,2.0
45,67,60,35,50,63,320,0.5128205128205128,70,60,62,80,82,60,414,0.4375,1.0
72,60,30,20,30,25,237,0.11570247933884298,83,80,75,70,70,101,479,0.8615384615384616,1.0
80,100,123,122,120,80,625,0.56,130,85,80,85,95,60,535,0.43884892086330934,2.0
60,69,95,69,95,36,424,0.2608695652173913,70,70,115,130,90,60,535,0.5338983050847458,0.125
80,70,70,90,100,70,480,0.5609756097560976,66,65,48,62,57,52,350,0.36220472440944884,0.25
75,85,200,55,65,30,510,0.16778523489932887,30,30,30,30,30,30,180,0.12612612612612611,0.5
69,55,45,55,55,15,294,0.11666666666666667,48,61,40,61,40,50,300,0.2543859649122807,0.25
76,104,71,104,71,108,534,0.912751677852349,55,65,95,95,45,85,440,0.6610169491525424,0.5
60,80,50,50,50,40,330,0.23853211009174313,70,85,65,105,85,120,530,0.9262295081967213,1.0
70,75,80,135,80,135,575,0.917910447761194,50,105,79,35,110,76,455,0.6214285714285714,1.0
68,125,65,65,115,80,518,0.6277372262773723,55,81,60,50,70,97,413,0.7214285714285714,2.0
60,65,60,130,75,110,500,0.7719298245614035,68,90,65,50,55,82,410,0.6165413533834586,0.5
85,120,70,50,60,100,485,0.8308823529411765,70,85,65,105,85,120,530,0.9262295081967213,2.0
40,35,30,120,70,105,400,0.6692307692307692,90,132,105,132,105,30,594,0.4246575342465753,1.0
90,100,90,125,85,90,580,0.7352941176470589,78,130,111,130,85,100,634,0.8561151079136691,0.25
60,65,80,170,95,130,600,0.8625954198473282,41,50,37,50,37,66,281,0.5175438596491229,0.5
35,20,65,40,65,20,245,0.02459016393442623,40,40,35,50,100,70,335,0.5031847133757962,0.5
80,125,75,40,95,85,500,0.6911764705882353,75,98,63,98,63,101,498,0.8091603053435115,2.0
75,80,95,90,100,50,490,0.2158273381294964,50,85,55,65,65,90,410,0.7478260869565218,0.5
65,90,50,85,45,55,390,0.371900826446281,50,50,50,50,50,50,300,0.30708661417322836,1.0
30,45,59,30,39,57,260,0.2803030303030303,50,53,62,58,63,44,330,0.13709677419354838,1.0
59,110,150,45,49,35,448,0.3333333333333333,63,120,85,90,55,55,468,0.2809917355371901,0.25
95,95,85,125,65,55,520,0.3894736842105263,65,125,100,60,70,70,490,0.6099290780141844,0.0
54,78,103,53,45,22,355,0.23255813953488372,80,120,80,120,80,100,580,0.8478260869565217,2.0
130,70,35,70,35,60,400,0.4017857142857143,75,140,65,112,65,110,567,0.9140625,2.0
40,60,30,31,31,70,262,0.4492753623188406,80,110,60,150,130,70,600,0.5042016806722689,0.0
75,80,55,25,35,35,305,0.18666666666666668,70,40,50,55,50,25,290,0.061068702290076333,2.0
80,50,100,100,200,50,580,0.2357142857142857,79,100,80,110,90,121,580,0.968,2.0
45,30,15,85,65,65,305,0.36220472440944884,35,80,50,50,70,120,405,0.84375,4.0
40,45,40,62,60,60,307,0.33884297520661155,72,85,70,65,70,58,420,0.41304347826086957,0.5
55,81,60,50,70,97,413,0.7214285714285714,91,134,95,100,100,80,600,0.6304347826086957,1.0
35,20,65,40,65,20,245,0.02459016393442623,55,63,90,50,80,42,380,0.21138211382113822,1.0
80,92,65,65,80,68,450,0.4824561403508772,60,59,85,79,105,36,424,0.16666666666666666,0.5
50,70,100,40,40,30,330,0.2222222222222222,40,70,40,35,40,60,285,0.392,0.5
100,100,100,100,100,100,600,0.8345864661654135,50,70,50,50,50,70,340,0.5645161290322581,2.0
90,92,75,92,85,60,494,0.49586776859504134,50,50,50,50,50,50,300,0.30708661417322836,0.5
50,50,95,40,50,35,320,0.20279720279720279,30,45,59,30,39,57,260,0.2803030303030303,1.0
66,41,77,61,87,23,355,0.12096774193548387,80,125,75,40,95,85,500,0.6911764705882353,0.5
60,85,60,50,50,125,430,0.9090909090909091,75,95,122,58,75,69,494,0.5725806451612904,0.0
72,85,70,65,70,58,420,0.41304347826086957,70,94,50,94,50,66,424,0.48148148148148145,1.0
70,84,70,65,70,51,410,0.2949640287769784,60,40,80,60,45,40,325,0.23529411764705882,0.5
45,49,49,65,65,45,318,0.2781954887218045,90,92,87,75,85,76,505,0.5409836065573771,0.25
45,60,30,80,50,65,330,0.4603174603174603,61,72,57,55,55,65,365,0.3984375,1.0
30,65,100,45,25,40,305,0.1891891891891892,30,45,55,70,55,85,340,0.5633802816901409,0.5
50,50,40,50,40,64,294,0.45588235294117646,80,135,130,95,90,70,600,0.5181818181818182,1.0
80,92,65,65,80,68,450,0.4824561403508772,80,120,80,120,80,100,580,0.8478260869565217,1.0
62,50,58,73,54,72,369,0.4435483870967742,100,100,100,100,100,100,600,0.8345864661654135,2.0
71,120,95,120,95,99,600,0.8203125,70,135,105,60,105,20,495,0.5806451612903226,0.25
50,72,35,35,35,65,292,0.5373134328358209,80,100,200,50,100,50,580,0.3472222222222222,2.0
35,55,40,50,50,90,320,0.6838235294117647,50,50,120,80,80,30,410,0.07258064516129033,1.0
55,45,43,55,43,72,313,0.5853658536585366,70,90,90,135,90,125,600,0.9401709401709402,0.0
30,35,30,100,35,80,310,0.4765625,60,70,50,100,50,65,395,0.5217391304347826,1.0
30,40,55,40,55,60,280,0.3237410071942446,40,27,60,37,50,66,280,0.36220472440944884,0.5
40,45,40,65,40,65,295,0.5661764705882353,45,80,100,35,37,28,325,0.3125,1.0
100,150,90,180,160,90,770,0.7348484848484849,45,22,60,27,30,29,213,0.07518796992481203,1.0
75,100,95,40,70,110,490,0.8717948717948718,53,54,53,37,46,45,288,0.3090909090909091,1.0
79,115,70,125,80,111,580,0.864,100,150,120,120,100,90,680,0.6493506493506493,0.125
50,30,55,65,55,20,275,0.13675213675213677,42,52,67,39,56,50,306,0.2868217054263566,0.25
75,105,75,105,75,45,480,0.3274336283185841,43,80,65,50,35,35,308,0.14193548387096774,0.5
40,40,35,50,100,70,335,0.5031847133757962,100,103,75,120,75,127,600,0.940677966101695,1.0
40,30,30,40,50,30,220,0.07936507936507936,85,50,95,120,115,80,545,0.5793650793650794,0.5
95,95,85,125,65,55,520,0.3894736842105263,65,80,65,35,65,60,370,0.38405797101449274,1.0
75,90,50,110,80,95,500,0.7985611510791367,60,55,90,145,90,80,520,0.6071428571428571,1.0
55,75,85,25,25,15,280,0.1875,85,76,64,45,55,90,415,0.6739130434782609,1.0
58,64,58,80,65,80,405,0.609271523178808,40,30,30,40,50,30,220,0.07936507936507936,1.0
75,125,75,30,75,85,465,0.625,70,90,110,60,75,95,500,0.7333333333333333,1.0
95,23,48,23,48,23,260,0.046153846153846156,55,63,90,50,80,42,380,0.21138211382113822,1.0
65,75,105,35,65,85,430,0.6940298507462687,45,63,37,65,55,95,360,0.8055555555555556,1.0
40,70,40,35,40,60,285,0.392,160,110,65,65,110,30,540,0.35714285714285715,2.0
73,100,60,100,60,65,458,0.42657342657342656,110,135,60,50,65,88,508,0.7744360902255639,0.0
84,86,88,111,101,60,530,0.4634146341463415,35,40,100,90,55,35,355,0.1796875,1.0
80,100,123,122,120,80,625,0.56,65,90,120,85,70,60,490,0.43410852713178294,0.25
40,70,40,35,40,60,285,0.392,30,45,135,45,90,30,375,0.09285714285714286,2.0
45,50,43,40,38,62,278,0.40441176470588236,45,85,70,40,40,60,340,0.5229357798165137,0.25
90,132,105,132,105,30,594,0.4246575342465753,75,125,100,70,80,45,495,0.33035714285714285,1.0
50,65,90,35,35,15,290,0.14678899082568808,50,85,125,85,115,20,480,0.4306569343065693,1.0
100,134,110,95,100,61,600,0.4057971014492754,67,57,55,77,55,114,425,0.8879310344827587,4.0
65,73,55,47,75,85,400,0.6846846846846847,115,115,85,90,75,100,580,0.8134328358208955,0.5
60,115,105,65,70,80,495,0.7181818181818181,69,55,45,55,55,15,294,0.11666666666666667,0.5
50,65,64,44,48,43,314,0.2196969696969697,55,50,40,40,40,75,300,0.5945945945945946,1.0
35,60,44,40,54,55,288,0.366412213740458,60,45,70,45,90,95,405,0.7304964539007093,1.0
70,60,125,115,70,55,495,0.35507246376811596,57,80,91,80,87,75,470,0.5737704918032787,0.5
40,55,70,45,60,30,300,0.10619469026548672,65,65,65,50,50,90,385,0.72,0.5
60,48,45,43,90,42,328,0.21897810218978103,58,89,77,45,45,48,362,0.3177570093457944,1.0
60,80,110,50,80,45,425,0.2833333333333333,80,120,79,95,79,70,523,0.5833333333333334,2.0
90,120,100,150,120,100,680,0.7718120805369127,85,90,80,70,80,130,535,0.9262295081967213,1.0
65,90,120,85,70,60,490,0.43410852713178294,60,60,60,85,85,85,435,0.631578947368421,0.5
86,68,72,109,66,106,507,0.8099173553719008,78,130,111,130,85,100,634,0.8561151079136691,0.25
64,115,65,83,63,65,455,0.5323741007194245,95,85,85,65,65,35,430,0.2571428571428571,1.0
71,82,64,64,59,112,452,0.9327731092436975,50,53,48,53,48,64,316,0.4076923076923077,1.0
45,30,35,20,20,45,195,0.14782608695652175,60,130,80,60,60,70,460,0.5153846153846153,1.0
65,125,60,95,60,105,510,0.9236641221374046,65,65,65,50,50,90,385,0.72,1.0
75,75,60,83,60,60,413,0.39344262295081966,70,60,125,115,70,55,495,0.35507246376811596,1.0
100,100,90,150,140,90,670,0.71875,59,59,58,90,70,73,409,0.5826086956521739,2.0
85,135,130,60,80,25,515,0.40540540540540543,60,75,100,55,80,50,420,0.3088235294117647,0.5
76,104,71,104,71,108,534,0.912751677852349,50,75,70,35,70,48,348,0.29357798165137616,2.0
50,50,40,30,30,50,250,0.2781954887218045,60,85,40,30,45,68,328,0.6422018348623854,2.0
80,80,80,80,80,80,480,0.5606060606060606,95,85,85,65,65,35,430,0.2571428571428571,1.0
50,95,180,85,45,70,525,0.5298507462686567,90,85,100,95,125,85,580,0.6834532374100719,1.0
85,76,64,45,55,90,415,0.6739130434782609,95,124,78,69,71,58,495,0.37398373983739835,1.0
60,85,69,60,69,77,420,0.518796992481203,65,60,70,85,75,40,395,0.1796875,1.0
40,29,45,29,45,36,224,0.14634146341463414,72,60,30,20,30,25,237,0.11570247933884298,0.5
60,100,89,55,69,112,485,0.9298245614035088,85,80,90,105,95,60,515,0.49074074074074076,1.0
45,100,135,65,135,45,525,0.29411764705882354,45,50,55,75,65,30,320,0.06293706293706294,1.0
100,120,100,150,120,90,680,0.728,68,72,78,38,42,32,330,0.23809523809523808,1.0
90,92,75,92,85,60,494,0.49586776859504134,60,100,85,80,85,100,510,0.7007874015748031,1.0
80,75,150,75,150,50,580,0.30973451327433627,70,50,30,95,135,105,485,0.8040540540540541,2.0
55,95,115,45,45,35,390,0.2116788321167883,60,150,50,150,50,60,520,0.5,1.0
76,25,45,67,55,24,292,0.0390625,123,77,72,99,92,58,521,0.4621212121212121,1.0
60,65,70,85,75,40,395,0.21705426356589147,55,40,50,65,85,40,335,0.3181818181818182,1.0
75,80,60,65,90,102,472,0.8625954198473282,55,68,64,45,55,31,318,0.11666666666666667,1.0
75,125,100,70,80,45,495,0.33035714285714285,55,45,43,55,43,72,313,0.5853658536585366,2.0
65,65,45,75,45,95,390,0.72,65,45,55,45,70,45,325,0.24369747899159663,1.0
100,5,5,15,65,30,220,0.07692307692307693,25,20,15,105,55,90,310,0.32407407407407407,1.0
76,25,45,67,55,24,292,0.0390625,53,54,53,37,46,45,288,0.3090909090909091,0.0
91,90,72,90,129,108,580,0.896,170,90,45,90,45,60,500,0.427536231884058,2.0
100,100,100,100,100,100,600,0.8345864661654135,90,85,75,115,100,115,580,0.9381443298969072,1.0
65,47,55,73,75,85,400,0.65,115,115,85,90,75,100,580,0.8134328358208955,0.5
44,48,65,50,64,43,314,0.1623931623931624,60,110,70,60,60,100,460,0.8461538461538461,1.0
55,70,55,40,55,85,360,0.7073170731707317,75,123,67,95,85,95,540,0.7642276422764228,1.0
50,70,100,40,40,30,330,0.2222222222222222,70,60,70,87,78,85,450,0.6228070175438597,1.0
50,64,50,45,50,41,300,0.22727272727272727,55,69,85,32,35,28,304,0.09302325581395349,2.0
80,105,65,60,75,130,515,0.9645390070921985,50,50,50,50,50,50,300,0.30708661417322836,2.0
58,109,112,48,48,109,484,0.8805970149253731,91,90,106,130,106,77,600,0.648854961832061,0.0625
100,100,125,110,50,50,535,0.384,78,65,68,112,154,75,552,0.628099173553719,1.0
55,130,115,50,50,75,475,0.5982142857142857,80,50,100,100,200,50,580,0.2357142857142857,1.0
108,100,121,81,95,95,600,0.7476635514018691,45,25,50,25,25,35,205,0.13076923076923078,1.0
105,95,75,85,75,74,509,0.5714285714285714,60,85,60,50,50,125,430,0.9090909090909091,0.0
88,107,122,74,75,64,530,0.4596774193548387,70,85,70,60,70,50,405,0.28378378378378377,4.0
150,80,44,90,54,80,498,0.625,40,30,30,55,30,85,270,0.4666666666666667,1.0
100,120,100,150,120,90,680,0.728,85,80,70,135,75,90,535,0.7006802721088435,1.0
55,55,55,85,55,30,335,0.1320754716981132,108,130,95,80,85,102,600,0.7637795275590551,2.0
85,80,90,105,95,60,515,0.49074074074074076,55,130,115,50,50,75,475,0.5982142857142857,1.0
66,117,70,40,50,67,410,0.4573643410852713,60,75,85,100,85,115,520,0.8992248062015504,1.0
65,75,70,95,70,95,470,0.7272727272727273,55,65,35,60,30,85,330,0.6126126126126126,1.0
50,65,107,105,107,86,520,0.703125,73,76,75,81,100,100,505,0.8110236220472441,0.5
170,90,45,90,45,60,500,0.427536231884058,45,30,35,20,20,45,195,0.14782608695652175,1.0
70,94,50,94,50,66,424,0.48148148148148145,65,110,130,60,65,95,525,0.8278145695364238,4.0
55,50,40,40,40,75,300,0.5945945945945946,95,60,79,100,125,81,540,0.6201550387596899,1.0
65,55,115,100,40,60,435,0.3798449612403101,60,70,105,70,120,75,500,0.5983606557377049,2.0
70,40,50,55,50,25,290,0.061068702290076333,65,125,100,55,70,85,500,0.6532258064516129,1.0
72,85,70,65,70,58,420,0.41304347826086957,58,89,77,45,45,48,362,0.3177570093457944,2.0
45,22,60,27,30,29,213,0.07518796992481203,79,85,60,55,60,71,410,0.60431654676259,1.0
65,95,57,100,85,93,495,0.7441860465116279,65,50,35,115,95,95,455,0.7333333333333333,2.0
108,100,121,81,95,95,600,0.7476635514018691,95,145,130,120,90,120,700,0.9398496240601504,0.0
68,72,78,38,42,32,330,0.23809523809523808,85,56,77,50,77,78,423,0.53125,1.0
66,65,48,62,57,52,350,0.36220472440944884,58,64,58,80,65,80,405,0.609271523178808,0.5
75,75,95,75,95,113,528,0.9015151515151515,35,46,34,35,45,20,215,0.072,1.0
50,50,120,80,80,30,410,0.07258064516129033,95,110,80,70,80,50,485,0.37209302325581395,4.0
95,135,80,110,80,100,600,0.8248175182481752,38,36,38,32,36,57,237,0.3893805309734513,1.0
55,95,115,45,45,35,390,0.2116788321167883,78,84,78,109,85,100,534,0.8646616541353384,0.0
48,61,40,61,40,50,300,0.2543859649122807,75,100,95,40,70,110,490,0.8717948717948718,2.0
70,80,50,35,35,35,305,0.14,35,46,34,35,45,20,215,0.072,2.0
60,45,50,90,80,70,395,0.625,35,85,45,35,35,75,310,0.6492537313432836,0.5
60,60,60,85,85,85,435,0.631578947368421,90,60,70,75,70,45,410,0.23880597014925373,1.0
84,71,43,71,43,48,360,0.25874125874125875,50,50,40,50,40,64,294,0.45588235294117646,1.0
70,135,105,60,105,20,495,0.5806451612903226,49,66,70,44,55,51,335,0.4260869565217391,1.0
60,80,95,70,85,50,440,0.2231404958677686,20,15,20,10,55,80,200,0.2682926829268293,0.5
60,25,35,70,80,60,330,0.3076923076923077,70,65,65,55,55,70,380,0.5,1.0
60,50,100,85,70,65,430,0.47580645161290325,45,49,65,49,65,45,318,0.275,1.0
60,59,85,79,105,36,424,0.16666666666666666,65,85,70,75,70,40,405,0.203125,1.0
60,45,50,90,80,70,395,0.625,48,61,40,61,40,50,300,0.2543859649122807,0.5
100,164,150,95,120,71,700,0.5645161290322581,50,65,45,85,65,95,405,0.7238095238095238,1.0
60,115,105,65,70,80,495,0.7181818181818181,50,150,50,150,50,150,600,0.9339622641509434,1.0
95,109,105,75,85,56,525,0.34513274336283184,50,50,150,50,150,50,500,0.2571428571428571,4.0
100,100,125,110,50,50,535,0.384,55,50,45,135,95,120,500,0.7714285714285715,1.0
60,45,70,45,90,95,405,0.7304964539007093,20,10,230,10,230,5,505,0.0,1.0
90,100,70,110,150,80,600,0.6037735849056604,60,60,60,85,85,85,435,0.631578947368421,1.0
50,65,107,105,107,86,520,0.6991150442477876,100,100,100,100,100,100,600,0.831858407079646,1.0
67,89,116,79,116,33,500,0.2624113475177305,89,145,90,105,80,91,600,0.8549618320610687,2.0
40,45,35,40,40,90,290,0.65,40,30,30,40,50,30,220,0.07936507936507936,1.0
50,53,48,53,48,64,316,0.46153846153846156,60,70,65,125,105,90,515,0.6911764705882353,2.0
35,80,50,50,70,120,405,0.84375,91,90,106,130,106,77,600,0.648854961832061,4.0
20,40,90,30,90,25,295,0.11363636363636363,55,40,40,65,45,35,280,0.16428571428571428,1.0
70,60,70,87,78,85,450,0.6228070175438597,100,100,100,100,100,100,600,0.8602941176470589,0.5
50,50,95,40,50,35,320,0.20279720279720279,91,129,90,72,90,108,580,0.8536585365853658,2.0
45,30,15,85,65,65,305,0.36220472440944884,60,80,95,70,85,50,440,0.2231404958677686,0.25
78,81,71,74,69,126,499,0.9090909090909091,105,95,80,40,80,90,490,0.753968253968254,1.0
44,75,35,63,33,45,295,0.2647058823529412,70,140,70,110,65,105,560,0.95,0.5
65,55,115,100,40,60,435,0.3798449612403101,45,63,37,65,55,95,360,0.8055555555555556,1.0
95,155,109,70,130,81,640,0.6788321167883211,60,45,70,75,85,55,390,0.3008130081300813,2.0
115,115,85,90,75,100,580,0.8134328358208955,61,72,57,55,55,65,365,0.3984375,1.0
100,100,100,100,100,100,600,0.8805970149253731,40,80,35,35,45,70,305,0.4661016949152542,1.0
80,90,80,130,110,110,600,0.856,54,63,52,83,56,97,405,0.7697841726618705,1.0
72,95,67,103,71,122,530,0.9606299212598425,100,120,100,150,120,90,680,0.728,1.0
50,105,125,55,95,50,480,0.375886524822695,70,120,40,95,40,95,460,0.8106060606060606,1.0
75,110,110,110,105,80,590,0.656934306569343,50,105,79,35,110,76,455,0.6214285714285714,2.0
70,40,50,55,50,25,290,0.061068702290076333,50,65,107,105,107,86,520,0.703125,0.5
51,65,65,80,75,59,395,0.4365079365079365,68,90,65,50,55,82,410,0.6165413533834586,4.0
105,30,105,140,105,55,540,0.3524590163934426,83,80,80,135,80,121,579,0.9444444444444444,1.0
30,56,35,25,35,72,253,0.48148148148148145,58,50,145,95,105,30,483,0.2459016393442623,0.0
30,42,118,42,88,30,350,0.112,20,40,15,35,35,60,205,0.34285714285714286,0.5
80,80,50,40,50,25,325,0.176056338028169,55,70,55,40,55,85,360,0.7073170731707317,1.0
80,100,80,80,80,100,520,0.9051724137931034,48,72,48,72,48,48,336,0.25984251968503935,1.0
123,77,72,99,92,58,521,0.4621212121212121,110,85,95,80,95,50,515,0.2713178294573643,1.0
55,45,43,55,43,72,313,0.5853658536585366,70,90,70,60,60,70,420,0.6390977443609023,0.0
90,65,65,40,40,15,315,0.19672131147540983,115,115,85,90,75,100,580,0.8134328358208955,2.0
75,75,75,125,95,40,485,0.15671641791044777,60,70,65,125,105,90,515,0.6911764705882353,2.0
65,55,115,100,40,60,435,0.3798449612403101,60,85,69,60,69,77,420,0.518796992481203,1.0
70,100,115,30,65,30,410,0.24390243902439024,67,58,57,81,67,101,431,0.8790322580645161,1.0
45,55,45,65,45,75,330,0.5692307692307692,58,50,145,95,105,30,483,0.2459016393442623,1.0
75,100,63,80,63,116,497,0.9345794392523364,60,62,50,62,60,40,334,0.18181818181818182,0.5
44,50,91,24,86,10,305,0.1981981981981982,65,110,130,60,65,95,525,0.8278145695364238,0.5
64,115,65,83,63,65,455,0.5323741007194245,68,75,53,83,113,60,452,0.45384615384615384,1.0
74,94,131,54,116,20,489,0.4485294117647059,90,30,15,40,20,15,210,0.043478260869565216,0.5
62,44,50,44,50,55,305,0.3629032258064516,62,50,58,73,54,72,369,0.4435483870967742,2.0
50,70,160,70,160,90,600,0.7417218543046358,110,65,105,55,95,80,510,0.6258503401360545,0.0
95,145,130,120,90,120,700,0.9398496240601504,45,50,55,75,65,30,320,0.06293706293706294,2.0
75,123,67,95,85,95,540,0.7642276422764228,65,130,60,95,110,65,525,0.5303030303030303,1.0
60,25,35,70,80,60,330,0.3076923076923077,123,100,62,97,81,68,531,0.4806201550387597,1.0
50,95,90,95,90,180,600,0.9172413793103448,70,85,70,60,70,50,405,0.28378378378378377,2.0
80,110,120,130,90,70,600,0.6198347107438017,50,47,50,57,50,65,319,0.463768115942029,2.0
108,130,95,80,85,102,600,0.7637795275590551,100,75,115,90,115,85,580,0.6446280991735537,1.0
95,65,110,60,130,65,525,0.5275590551181102,50,65,107,105,107,86,520,0.703125,1.0
43,70,48,50,60,38,309,0.2391304347826087,35,46,34,35,45,20,215,0.072,0.0
40,30,50,55,55,100,330,0.584070796460177,60,100,89,55,69,112,485,0.9298245614035088,1.0
45,95,50,40,50,75,355,0.54,40,45,35,40,40,90,290,0.65,1.0
65,150,40,15,80,145,495,0.9663865546218487,95,117,184,44,46,28,514,0.2975206611570248,1.0
115,115,85,90,75,100,580,0.8134328358208955,100,120,100,150,120,90,680,0.728,0.25
45,30,50,55,65,45,290,0.208,75,125,75,30,75,85,465,0.625,1.0
120,70,120,75,130,85,600,0.6694915254237288,70,110,70,115,70,90,525,0.75,0.5
45,49,65,49,65,45,318,0.275,55,75,85,25,25,15,280,0.1875,2.0
65,110,130,60,65,95,525,0.8278145695364238,65,95,57,100,85,93,495,0.7441860465116279,0.5
60,40,50,75,85,95,405,0.6044776119402985,55,45,50,45,65,80,340,0.5546218487394958,1.0
70,90,70,60,60,70,420,0.6390977443609023,60,79,105,59,85,36,424,0.17054263565891473,1.0
80,100,80,80,80,100,520,0.9051724137931034,63,63,47,41,41,74,329,0.56,2.0
55,68,64,45,55,31,318,0.11666666666666667,85,120,70,50,60,100,485,0.8308823529411765,0.5
95,117,80,65,70,92,519,0.8409090909090909,70,95,125,65,75,45,475,0.33613445378151263,1.0
60,40,80,60,45,40,325,0.23529411764705882,65,76,84,54,96,105,480,0.9008264462809917,1.0
65,80,65,35,65,60,370,0.38405797101449274,100,100,100,100,100,100,600,0.8345864661654135,1.0
86,68,72,109,66,106,507,0.8099173553719008,65,50,70,95,80,65,425,0.4262295081967213,1.0
65,90,122,58,75,84,494,0.71875,62,55,52,109,94,109,481,0.7833333333333333,0.0
90,75,75,90,100,70,500,0.5462184873949579,89,124,80,55,80,55,483,0.5714285714285714,2.0
110,65,75,125,85,30,490,0.15,126,131,95,131,98,99,680,0.8294573643410853,1.0
40,30,30,55,30,85,270,0.4666666666666667,190,33,58,33,58,33,405,0.13432835820895522,1.0
80,82,78,95,80,85,500,0.6869565217391305,40,35,30,120,70,105,400,0.6692307692307692,1.0
90,75,85,115,90,55,510,0.3445378151260504,72,58,80,103,80,97,490,0.7171052631578947,2.0
106,110,90,154,90,130,680,0.926829268292683,30,30,30,30,30,30,180,0.12612612612612611,1.0
63,60,55,50,50,71,349,0.5289256198347108,50,53,62,58,63,44,330,0.13709677419354838,1.0
80,80,80,80,80,80,480,0.6015037593984962,75,125,70,125,70,115,580,0.9037037037037037,1.0
63,120,85,90,55,55,468,0.2809917355371901,75,65,55,65,55,69,384,0.43548387096774194,1.0
55,81,60,50,70,97,413,0.7214285714285714,70,55,75,45,65,60,370,0.45901639344262296,1.0
83,106,65,86,65,85,490,0.6640625,126,131,95,131,98,99,680,0.8102189781021898,1.0
45,22,60,27,30,29,213,0.07518796992481203,60,110,70,60,60,100,460,0.8461538461538461,0.5
62,55,52,109,94,109,481,0.7833333333333333,84,86,88,111,101,60,530,0.4634146341463415,1.0
40,45,35,30,40,55,245,0.3793103448275862,50,30,55,65,55,20,275,0.13675213675213677,0.5
85,76,64,45,55,90,415,0.6739130434782609,100,100,125,110,50,50,535,0.384,1.0
75,85,200,55,65,30,510,0.16778523489932887,50,65,107,105,107,86,520,0.7272727272727273,0.0
45,35,50,70,50,30,280,0.15753424657534246,55,75,60,75,60,103,428,0.7982456140350878,0.5
60,40,60,40,60,35,295,0.18055555555555555,60,115,105,65,70,80,495,0.7181818181818181,4.0
105,125,100,60,100,100,590,0.8359375,86,81,97,81,107,43,495,0.203125,0.5
95,95,85,125,65,55,520,0.3894736842105263,70,95,125,65,75,45,475,0.33613445378151263,1.0
55,75,85,25,25,15,280,0.1875,80,70,40,100,60,145,495,0.921875,2.0
55,55,55,85,55,30,335,0.1320754716981132,83,80,80,135,80,121,579,0.9444444444444444,1.0
65,75,70,95,70,95,470,0.7272727272727273,70,90,45,15,45,50,315,0.3629032258064516,1.0
60,65,70,85,75,40,395,0.21705426356589147,89,125,90,115,80,101,600,0.8725490196078431,0.5
50,75,45,40,45,60,315,0.4380165289256198,60,95,80,60,80,30,405,0.19480519480519481,2.0
100,150,110,95,110,70,635,0.5923076923076923,50,80,95,10,45,10,290,0.232,4.0
59,63,80,65,80,58,405,0.41843971631205673,75,105,75,105,75,45,480,0.3274336283185841,0.5
75,75,130,75,130,95,580,0.7479674796747967,60,90,55,90,80,110,485,0.8677685950413223,1.0
130,85,80,85,95,60,535,0.43884892086330934,65,110,130,60,65,95,525,0.8278145695364238,1.0
60,62,50,62,60,40,334,0.18181818181818182,60,100,115,70,85,90,520,0.7557251908396947,0.25
70,120,65,45,85,125,510,0.9747899159663865,49,66,70,44,55,51,335,0.4260869565217391,4.0
88,107,122,74,75,64,530,0.4596774193548387,91,90,72,90,129,108,580,0.896,0.5
28,25,25,45,35,40,198,0.16083916083916083,38,35,40,27,25,35,200,0.08208955223880597,1.0
62,73,55,56,52,84,382,0.7244094488188977,44,38,39,61,79,42,303,0.2251655629139073,1.0
76,147,90,60,70,97,540,0.8267716535433071,58,64,58,80,65,80,405,0.609271523178808,1.0
65,80,140,40,70,70,465,0.5223880597014925,50,47,50,57,50,65,319,0.463768115942029,0.5
60,40,50,75,85,95,405,0.6044776119402985,60,85,40,30,45,68,328,0.6422018348623854,0.0
40,65,40,80,40,65,330,0.5038167938931297,75,85,200,55,65,30,510,0.16778523489932887,1.0
70,92,65,80,55,98,460,0.8090909090909091,130,70,35,70,35,60,400,0.4017857142857143,0.5
70,77,60,97,60,108,472,0.8394160583941606,80,135,85,70,95,150,615,0.9844961240310077,1.0
100,164,150,95,120,71,700,0.5645161290322581,39,52,43,60,50,65,309,0.49107142857142855,2.0
90,60,70,75,70,45,410,0.23880597014925373,95,75,110,100,80,30,490,0.15267175572519084,0.25
65,73,55,47,75,85,400,0.6846846846846847,45,75,60,40,30,50,300,0.304,1.0
60,60,60,60,60,60,360,0.38095238095238093,150,160,100,95,65,100,670,0.8866666666666667,1.0
80,50,100,100,200,50,580,0.2357142857142857,42,52,67,39,56,50,306,0.2868217054263566,0.5
100,100,100,100,100,100,600,0.8602941176470589,40,45,65,100,120,90,460,0.5588235294117647,1.0
70,110,180,60,60,50,530,0.4117647058823529,60,55,145,75,150,40,525,0.2,0.5
75,38,38,56,56,67,330,0.5263157894736842,65,150,60,115,60,115,565,0.935251798561151,1.0
76,65,45,92,42,91,411,0.7449664429530202,79,103,120,135,115,78,630,0.5763888888888888,1.0
64,165,75,93,83,75,555,0.6587301587301587,75,125,230,55,95,30,610,0.3448275862068966,1.0
40,45,65,100,120,90,460,0.5588235294117647,55,40,40,65,45,35,280,0.16428571428571428,1.0
90,95,95,70,90,70,510,0.5230769230769231,45,50,43,40,38,62,278,0.40441176470588236,1.0
62,55,52,109,94,109,481,0.7833333333333333,80,105,65,60,75,130,515,0.9645390070921985,1.0
50,40,85,40,65,25,305,0.08870967741935484,40,27,60,37,50,66,280,0.36220472440944884,1.0
75,95,60,65,60,115,470,0.8778625954198473,41,56,40,62,44,71,314,0.568,1.0
61,90,45,50,50,160,456,0.9230769230769231,55,40,50,65,85,40,335,0.3181818181818182,0.5
55,112,45,74,45,70,401,0.559322033898305,70,120,40,95,40,95,460,0.8106060606060606,1.0
90,95,95,70,90,70,510,0.5230769230769231,60,55,50,40,55,45,305,0.22377622377622378,0.25
45,55,45,65,45,75,330,0.5692307692307692,79,103,120,135,115,78,630,0.5763888888888888,0.5
55,85,122,58,75,99,494,0.8099173553719008,80,100,80,80,80,100,520,0.9051724137931034,1.0
80,80,80,55,55,90,440,0.6417910447761194,90,132,105,132,105,30,594,0.4246575342465753,1.0
75,103,80,70,80,92,500,0.7933884297520661,50,20,55,25,25,30,205,0.09774436090225563,0.5
65,45,55,45,70,45,325,0.24369747899159663,83,80,75,70,70,101,479,0.8615384615384616,1.0
60,65,60,130,75,110,500,0.7719298245614035,105,125,100,60,100,100,590,0.8359375,0.0
30,56,35,25,35,72,253,0.48148148148148145,45,49,49,65,65,45,318,0.2781954887218045,1.0
80,110,60,150,130,70,600,0.5042016806722689,30,45,59,30,39,57,260,0.2803030303030303,2.0
65,60,110,130,95,65,525,0.47761194029850745,90,120,100,150,120,100,680,0.7718120805369127,1.0
50,120,53,35,110,87,455,0.640625,30,56,35,25,35,72,253,0.48148148148148145,2.0
55,70,45,70,50,60,350,0.45,45,100,135,65,135,45,525,0.29411764705882354,1.0
35,70,55,45,55,25,285,0.09420289855072464,58,109,112,48,48,109,484,0.8805970149253731,0.125
50,95,90,95,90,180,600,0.9172413793103448,60,100,85,80,85,100,510,0.7007874015748031,0.5
95,155,109,70,130,81,640,0.6788321167883211,80,70,70,90,100,70,480,0.5609756097560976,0.25
80,110,60,150,130,70,600,0.5042016806722689,50,60,60,60,60,30,320,0.11290322580645161,2.0
30,105,90,25,25,50,325,0.2773722627737226,49,49,56,49,61,66,330,0.5190839694656488,0.5
95,80,105,40,70,100,490,0.8046875,76,25,45,67,55,24,292,0.0390625,1.0
110,160,110,80,110,100,670,0.8591549295774648,60,62,50,62,60,40,334,0.18181818181818182,1.0
65,80,140,40,70,70,465,0.5223880597014925,80,125,75,40,95,85,500,0.6911764705882353,4.0
75,98,63,98,63,101,498,0.8091603053435115,165,75,80,40,45,65,470,0.5151515151515151,2.0
1,90,45,30,30,40,236,0.33064516129032256,60,62,63,80,80,60,405,0.38016528925619836,1.0
45,30,40,105,50,20,290,0.031007751937984496,75,89,85,55,65,36,405,0.29545454545454547,1.0
50,95,95,35,110,70,455,0.5179856115107914,95,70,73,95,90,60,483,0.3983739837398374,0.5
70,40,50,55,50,25,290,0.061068702290076333,91,72,90,129,90,108,580,0.8925619834710744,0.25
60,60,60,60,60,60,360,0.38095238095238093,60,85,40,30,45,68,328,0.6422018348623854,1.0
85,97,66,105,66,65,484,0.47107438016528924,60,55,50,40,55,45,305,0.22377622377622378,2.0
45,30,15,85,65,65,305,0.36220472440944884,45,75,37,70,55,83,365,0.6183206106870229,0.5
91,90,72,90,129,108,580,0.896,65,150,60,115,60,115,565,0.935251798561151,2.0
55,65,35,60,30,85,330,0.6126126126126126,70,92,65,80,55,98,460,0.8090909090909091,0.5
90,90,85,125,90,100,580,0.768595041322314,100,110,90,85,90,60,535,0.47794117647058826,0.0
40,45,35,40,40,90,290,0.65,70,90,90,135,90,125,600,0.9401709401709402,1.0
123,77,72,99,92,58,521,0.4621212121212121,62,44,50,44,50,55,305,0.3629032258064516,2.0
75,100,95,40,70,110,490,0.8717948717948718,72,58,80,103,80,97,490,0.7171052631578947,1.0
80,80,50,40,50,25,325,0.176056338028169,50,75,45,40,45,60,315,0.4380165289256198,1.0
84,71,43,71,43,48,360,0.25874125874125875,75,98,63,98,63,101,498,0.849624060150376,1.0
55,55,50,45,65,55,325,0.37373737373737376,58,50,145,95,105,30,483,0.2459016393442623,0.0
90,100,70,110,150,80,600,0.6037735849056604,105,140,95,55,65,45,505,0.3,1.0
70,65,60,90,75,90,450,0.6571428571428571,60,50,70,50,90,65,385,0.39568345323741005,0.25
190,33,58,33,58,33,405,0.13432835820895522,46,57,40,40,40,50,273,0.25,2.0
50,150,50,150,50,150,600,0.9339622641509434,40,50,90,30,55,65,330,0.44680851063829785,2.0
90,60,70,75,70,45,410,0.23880597014925373,125,58,58,76,76,67,460,0.515625,0.25
30,42,118,42,88,30,350,0.112,85,80,70,135,75,90,535,0.7006802721088435,1.0
60,50,100,85,70,65,430,0.47580645161290325,85,50,95,120,115,80,545,0.5793650793650794,1.0
90,90,85,125,90,100,580,0.768595041322314,65,65,45,75,45,95,390,0.72,4.0
35,65,35,65,35,65,300,0.46621621621621623,55,63,90,50,80,42,380,0.21138211382113822,0.5
45,50,55,75,65,30,320,0.06293706293706294,45,35,50,70,50,30,280,0.15753424657534246,1.0
75,105,75,105,75,45,480,0.3274336283185841,103,60,86,60,86,50,445,0.3458646616541353,1.0
100,73,83,73,83,55,467,0.371900826446281,60,60,60,85,85,85,435,0.631578947368421,0.5
52,65,50,45,50,38,300,0.27419354838709675,39,52,43,60,50,65,309,0.5041322314049587,1.0
50,35,55,25,25,15,205,0.021739130434782608,50,47,50,57,50,65,319,0.463768115942029,1.0
50,50,62,40,62,65,329,0.4188034188034188,55,47,52,40,40,41,275,0.16806722689075632,0.5
30,40,70,70,25,60,295,0.41353383458646614,60,80,50,40,40,30,300,0.15328467153284672,1.0
75,55,70,55,95,110,460,0.8444444444444444,50,100,150,100,150,50,600,0.37142857142857144,1.0
108,112,118,68,72,47,525,0.2916666666666667,85,135,130,60,80,25,515,0.40540540540540543,2.0
65,65,60,110,95,130,525,0.9253731343283582,65,90,122,58,75,84,494,0.71875,0.5
76,147,90,60,70,97,540,0.8267716535433071,20,10,55,15,20,80,200,0.17985611510791366,1.0
70,135,105,60,105,20,495,0.5806451612903226,45,35,50,70,50,30,280,0.15753424657534246,2.0
65,80,140,40,70,70,465,0.5223880597014925,65,40,50,125,60,30,370,0.07258064516129033,1.0
73,95,62,85,65,85,465,0.6666666666666666,30,40,55,40,55,60,280,0.3237410071942446,1.0
30,35,30,100,35,80,310,0.4765625,88,107,122,74,75,64,530,0.4596774193548387,2.0
70,94,50,94,50,66,424,0.48148148148148145,38,35,40,27,25,35,200,0.08208955223880597,2.0
64,78,52,78,52,81,405,0.6422764227642277,66,65,48,62,57,52,350,0.36220472440944884,2.0
120,120,120,120,120,120,720,0.9344262295081968,45,95,50,40,50,75,355,0.54,0.5
125,170,100,120,90,95,700,0.77,60,79,105,59,85,36,424,0.17054263565891473,2.0
65,136,94,54,96,135,580,0.9612403100775194,55,20,35,20,45,75,250,0.37681159420289856,2.0
55,45,45,25,25,15,210,0.048,80,160,60,170,130,80,680,0.6180555555555556,1.0
50,72,35,35,35,65,292,0.5373134328358209,45,90,20,65,20,65,305,0.5116279069767442,0.5
69,69,76,69,86,91,460,0.6554621848739496,68,165,95,65,115,110,618,0.8615384615384616,1.0
71,82,64,64,59,112,452,0.9327731092436975,70,55,55,80,60,45,365,0.2222222222222222,1.0
101,72,72,99,89,29,462,0.1937984496124031,75,89,85,55,65,36,405,0.29545454545454547,1.0
150,160,100,95,65,100,670,0.8866666666666667,50,105,79,35,110,76,455,0.6214285714285714,1.0
65,65,65,50,50,90,385,0.72,90,75,75,90,100,70,500,0.5462184873949579,0.5
95,145,130,120,90,120,700,0.9398496240601504,95,60,79,100,125,81,540,0.6201550387596899,1.0
80,92,65,65,80,68,450,0.4824561403508772,55,75,50,40,40,80,340,0.6302521008403361,1.0
100,100,90,150,140,90,670,0.71875,65,75,105,35,65,85,430,0.6940298507462687,2.0
255,10,10,75,135,55,540,0.3125,80,70,40,100,60,145,495,0.921875,1.0
114,85,70,85,80,30,464,0.2066115702479339,90,132,105,132,105,30,594,0.4246575342465753,1.0
60,130,80,60,60,70,460,0.5153846153846153,64,115,65,83,63,65,455,0.5323741007194245,0.0
45,100,45,45,45,10,290,0.2949640287769784,60,45,70,75,85,55,390,0.3008130081300813,1.0
60,150,50,150,50,60,520,0.5,95,65,110,60,130,65,525,0.5275590551181102,0.5
95,85,85,65,65,35,430,0.2571428571428571,30,30,30,30,30,30,180,0.12612612612612611,0.25
65,90,65,61,61,100,442,0.8373983739837398,103,93,67,71,61,84,479,0.7142857142857143,1.0
110,123,65,100,65,65,528,0.5217391304347826,55,75,60,75,60,103,428,0.7982456140350878,0.5
90,100,90,125,85,90,580,0.7352941176470589,40,20,30,40,80,55,265,0.22764227642276422,4.0
50,53,48,53,48,64,316,0.358974358974359,44,48,65,50,64,43,314,0.1623931623931624,0.5
50,75,35,70,30,40,300,0.21296296296296297,85,120,70,50,60,100,485,0.8308823529411765,0.5
65,150,40,15,80,145,495,0.9663865546218487,71,73,88,120,89,59,500,0.43537414965986393,1.0
70,150,140,65,100,75,600,0.55,50,65,64,44,48,43,314,0.2196969696969697,0.5
45,20,50,60,120,50,345,0.24074074074074073,50,30,55,65,55,20,275,0.13675213675213677,2.0
90,60,70,75,70,45,410,0.23880597014925373,40,40,55,40,70,55,300,0.40939597315436244,4.0
90,55,75,60,75,30,385,0.13970588235294118,75,140,65,112,65,110,567,0.9140625,0.5
76,147,90,60,70,97,540,0.8267716535433071,45,60,40,70,50,45,310,0.2846715328467153,1.0
70,60,125,115,70,55,495,0.35507246376811596,80,120,70,110,70,80,530,0.6422764227642277,2.0
85,105,55,85,50,115,495,0.9032258064516129,50,45,45,35,35,50,260,0.23529411764705882,1.0
45,22,60,27,30,29,213,0.07518796992481203,66,117,70,40,50,67,410,0.4573643410852713,1.0
79,85,60,55,60,71,410,0.60431654676259,80,85,95,30,30,25,345,0.2857142857142857,2.0
103,93,67,71,61,84,479,0.7142857142857143,60,25,35,70,80,60,330,0.3076923076923077,2.0
76,48,48,57,62,34,325,0.11688311688311688,60,70,65,125,105,90,515,0.6911764705882353,0.5
45,55,39,35,39,42,255,0.18518518518518517,75,38,38,56,56,67,330,0.5263157894736842,1.0
150,100,120,100,120,90,680,0.6666666666666666,62,48,54,63,60,68,355,0.5178571428571429,2.0
70,145,88,140,70,112,625,0.8888888888888888,130,65,60,110,95,65,525,0.5227272727272727,0.5
65,40,70,80,140,70,465,0.5954198473282443,45,50,55,75,65,30,320,0.06293706293706294,1.0
40,29,45,29,45,36,224,0.14634146341463414,35,65,35,65,35,65,300,0.46621621621621623,1.0
50,75,70,35,70,48,348,0.29357798165137616,52,65,50,45,50,38,300,0.27419354838709675,1.0
50,53,48,53,48,64,316,0.4076923076923077,60,40,80,60,45,40,325,0.23529411764705882,0.5
50,65,107,105,107,86,520,0.703125,99,68,83,72,87,51,460,0.417910447761194,4.0
65,150,40,15,80,145,495,0.9663865546218487,95,75,180,130,80,30,590,0.13793103448275862,2.0
100,150,110,95,110,70,635,0.5923076923076923,60,60,75,60,75,80,410,0.7321428571428571,1.0
60,69,95,69,95,36,424,0.2608695652173913,120,120,120,120,120,120,720,0.9344262295081968,1.0
110,85,95,80,95,50,515,0.2713178294573643,54,66,70,44,55,46,335,0.4214876033057851,0.0
60,70,50,100,50,65,395,0.5217391304347826,70,77,60,97,60,108,472,0.8394160583941606,1.0
25,20,15,105,55,90,310,0.32407407407407407,105,180,100,180,100,115,780,0.9477611940298507,1.0
58,64,58,80,65,80,405,0.609271523178808,80,70,40,100,60,145,495,0.921875,2.0
59,63,80,65,80,58,405,0.41843971631205673,90,85,75,115,100,115,580,0.9381443298969072,1.0
52,65,50,45,50,38,300,0.27419354838709675,65,90,115,45,115,58,488,0.5041322314049587,0.25
95,75,110,100,80,30,490,0.15267175572519084,63,120,85,90,55,55,468,0.2809917355371901,0.0
120,100,85,30,85,45,465,0.22448979591836735,150,160,100,95,65,100,670,0.8866666666666667,2.0
80,105,65,60,75,130,515,0.9645390070921985,70,110,180,60,60,50,530,0.4117647058823529,0.125
85,110,90,45,90,80,500,0.6206896551724138,50,50,120,80,80,30,410,0.07258064516129033,0.5
68,90,65,50,55,82,410,0.6165413533834586,52,65,50,45,50,38,300,0.27419354838709675,2.0
75,75,130,75,130,95,580,0.7479674796747967,73,95,62,85,65,85,465,0.6666666666666666,1.0
76,147,90,60,70,97,540,0.8267716535433071,80,100,70,50,60,45,405,0.25806451612903225,1.0
59,63,80,65,80,58,405,0.41843971631205673,44,58,44,58,44,61,309,0.41964285714285715,2.0
45,67,60,35,50,63,320,0.5128205128205128,60,85,49,60,49,60,363,0.4444444444444444,1.0
85,56,77,50,77,78,423,0.53125,105,125,100,60,100,100,590,0.8359375,1.0
45,90,20,65,20,65,305,0.5116279069767442,75,75,55,105,85,30,425,0.1619718309859155,0.5
55,40,40,65,45,35,280,0.16428571428571428,75,80,85,110,90,50,490,0.3548387096774194,0.5
41,56,40,62,44,71,314,0.568,80,82,78,95,80,85,500,0.6869565217391305,0.5
85,76,64,45,55,90,415,0.6739130434782609,59,45,40,35,40,31,250,0.14285714285714285,1.0
91,90,72,90,129,108,580,0.896,60,105,60,120,60,105,510,0.8849557522123894,2.0
90,130,80,65,85,55,505,0.4396551724137931,75,125,230,55,95,30,610,0.3448275862068966,2.0
67,89,116,79,116,33,500,0.2624113475177305,95,155,109,70,130,81,640,0.6788321167883211,0.0
55,81,60,50,70,97,413,0.7214285714285714,50,80,95,10,45,10,290,0.232,0.5
91,90,72,90,129,108,580,0.896,95,135,80,110,80,100,600,0.8248175182481752,0.125
68,125,65,65,115,80,518,0.6277372262773723,65,73,55,47,75,85,400,0.6846846846846847,0.5
60,70,65,125,105,90,515,0.6911764705882353,95,117,80,65,70,92,519,0.8409090909090909,1.0
60,25,35,70,80,60,330,0.3076923076923077,50,65,107,105,107,86,520,0.7272727272727273,1.0
45,45,55,45,55,63,308,0.4594594594594595,1,90,45,30,30,40,236,0.33064516129032256,0.5
55,55,85,65,85,35,380,0.2014388489208633,20,40,90,30,90,25,295,0.11363636363636363,1.0
60,90,70,60,120,40,440,0.27419354838709675,50,55,50,36,30,43,264,0.2922077922077922,1.0
65,65,60,130,95,110,525,0.823943661971831,100,73,83,73,83,55,467,0.371900826446281,2.0
50,65,107,105,107,86,520,0.7313432835820896,79,85,60,55,60,71,410,0.60431654676259,4.0
100,100,80,60,60,50,450,0.3050847457627119,70,110,80,55,80,105,500,0.8794326241134752,0.0
40,45,35,30,40,55,245,0.3793103448275862,45,95,50,40,50,75,355,0.54,0.5
84,71,43,71,43,48,360,0.25874125874125875,100,150,120,120,100,90,680,0.6493506493506493,1.0
100,73,83,73,83,55,467,0.371900826446281,115,45,20,45,25,20,270,0.11538461538461539,2.0
75,95,67,125,95,83,540,0.7117117117117117,63,63,47,41,41,74,329,0.56,1.0
105,95,80,40,80,90,490,0.753968253968254,90,132,105,132,105,30,594,0.4246575342465753,1.0
65,45,55,45,70,45,325,0.24369747899159663,50,60,45,100,80,65,400,0.45689655172413796,0.5
55,130,115,50,50,75,475,0.5982142857142857,90,100,90,125,85,90,580,0.7352941176470589,2.0
70,140,230,60,80,50,630,0.32432432432432434,90,85,100,95,125,85,580,0.6834532374100719,2.0
50,50,40,50,40,64,294,0.45588235294117646,45,85,50,55,50,65,350,0.5076923076923077,1.0
70,65,65,55,55,70,380,0.5,89,124,80,55,80,55,483,0.5714285714285714,0.0
116,55,85,107,95,29,487,0.06818181818181818,82,121,119,69,59,71,521,0.5394736842105263,1.0
55,65,35,60,30,85,330,0.6126126126126126,75,98,63,98,63,101,498,0.8091603053435115,0.5
55,104,105,94,75,52,485,0.36363636363636365,95,75,110,100,80,30,490,0.15267175572519084,0.5
40,35,30,20,20,50,195,0.23423423423423423,62,48,54,63,60,68,355,0.5178571428571429,2.0
50,70,100,40,40,30,330,0.2222222222222222,10,55,25,35,45,95,265,0.5396825396825397,0.5
105,30,105,140,105,55,540,0.3524590163934426,44,48,65,50,64,43,314,0.1623931623931624,0.5
40,55,99,40,79,47,360,0.26262626262626265,20,15,20,10,55,80,200,0.2682926829268293,1.0
125,120,90,170,100,95,700,0.78125,70,115,60,115,60,55,475,0.4647887323943662,2.0
65,60,110,130,95,65,525,0.47761194029850745,165,75,80,40,45,65,470,0.5151515151515151,0.5
50,20,55,25,25,30,205,0.09774436090225563,50,50,50,50,50,50,300,0.30708661417322836,1.0
45,60,30,80,50,65,330,0.4603174603174603,58,89,77,45,45,48,362,0.3177570093457944,0.25
90,60,60,40,40,40,330,0.29545454545454547,90,85,100,95,125,85,580,0.6834532374100719,0.0
72,95,67,103,71,122,530,0.9606299212598425,69,55,45,55,55,15,294,0.11666666666666667,0.5
101,72,72,99,89,29,462,0.1937984496124031,40,50,90,30,55,65,330,0.44680851063829785,0.5
95,70,73,95,90,60,483,0.3983739837398374,100,50,80,60,80,50,420,0.34375,1.0
30,30,30,30,30,30,180,0.12612612612612611,110,65,105,55,95,80,510,0.6258503401360545,0.5
61,84,65,70,70,70,420,0.5,75,100,110,45,55,65,450,0.5333333333333333,1.0
75,70,90,70,105,80,490,0.656,50,150,50,150,50,150,600,0.9339622641509434,1.0
68,165,95,65,115,110,618,0.8615384615384616,70,80,102,80,102,40,474,0.2677165354330709,0.25
39,52,43,60,50,65,309,0.49107142857142855,50,55,50,36,30,43,264,0.2922077922077922,1.0
125,120,90,170,100,95,700,0.78125,190,33,58,33,58,33,405,0.13432835820895522,1.0
82,121,119,69,59,71,521,0.5394736842105263,86,92,88,68,75,73,482,0.6835443037974683,1.0
75,95,95,95,95,85,540,0.6470588235294118,40,40,55,40,70,55,300,0.40939597315436244,2.0
105,95,75,85,75,74,509,0.5714285714285714,44,58,44,58,44,61,309,0.41964285714285715,4.0
80,105,105,105,105,80,580,0.5939849624060151,50,65,107,105,107,86,520,0.7272727272727273,1.0
55,35,50,55,110,85,390,0.6277372262773723,100,100,125,110,50,50,535,0.384,4.0
100,120,120,150,100,90,680,0.7880794701986755,250,5,5,35,105,50,450,0.15306122448979592,1.0
70,75,80,135,80,135,575,0.917910447761194,40,27,60,37,50,66,280,0.36220472440944884,0.5
91,90,72,90,129,108,580,0.896,60,80,110,50,80,45,425,0.2833333333333333,2.0
75,85,200,55,65,30,510,0.16778523489932887,40,45,40,35,35,56,251,0.373015873015873,0.0
50,85,85,55,55,50,380,0.3902439024390244,105,105,75,65,100,50,500,0.37593984962406013,0.5
90,70,80,70,95,70,475,0.5190839694656488,40,50,45,70,45,70,320,0.5517241379310345,2.0
55,70,55,40,55,85,360,0.7073170731707317,58,64,58,80,65,80,405,0.609271523178808,1.0
90,50,34,60,44,70,348,0.6283185840707964,40,45,35,65,55,70,310,0.4482758620689655,2.0
75,105,75,105,75,45,480,0.3274336283185841,95,70,73,95,90,60,483,0.3983739837398374,1.0
70,70,70,70,70,70,420,0.5289256198347108,65,40,50,125,60,30,370,0.07258064516129033,1.0
80,100,80,80,80,100,520,0.9051724137931034,59,110,150,45,49,35,448,0.3333333333333333,1.0
68,85,65,165,135,100,618,0.8083333333333333,60,100,89,55,69,112,485,0.9298245614035088,1.0
20,40,15,35,35,60,205,0.34285714285714286,50,70,50,50,50,70,340,0.5645161290322581,0.0
80,85,95,30,30,25,345,0.2857142857142857,76,104,71,104,71,108,534,0.912751677852349,2.0
103,60,126,80,126,50,545,0.36363636363636365,70,90,110,60,75,95,500,0.7333333333333333,1.0
62,48,54,63,60,68,355,0.5178571428571429,30,65,100,45,25,40,305,0.1891891891891892,1.0
103,60,126,80,126,50,545,0.36363636363636365,91,72,90,129,90,108,580,0.8925619834710744,2.0
40,80,100,30,30,20,300,0.11851851851851852,45,35,50,70,50,30,280,0.15753424657534246,0.5
80,70,65,80,120,100,515,0.8034188034188035,58,50,145,95,105,30,483,0.2459016393442623,0.5
250,5,5,35,105,50,450,0.15306122448979592,67,89,116,79,116,33,500,0.2624113475177305,0.5
70,135,105,60,105,20,495,0.5806451612903226,79,105,70,145,80,101,580,0.8608695652173913,0.25
60,55,50,40,55,45,305,0.22377622377622378,100,50,80,60,80,50,420,0.34375,1.0
75,89,85,55,65,36,405,0.29545454545454547,90,30,15,40,20,15,210,0.043478260869565216,1.0
45,60,40,70,50,45,310,0.2846715328467153,60,50,70,50,90,65,385,0.39568345323741005,2.0
71,95,85,110,95,79,535,0.664,60,62,50,62,60,40,334,0.18181818181818182,1.0
60,50,50,60,70,50,340,0.28346456692913385,58,70,45,40,45,42,300,0.25925925925925924,1.0
110,160,110,80,110,100,670,0.8591549295774648,85,110,76,65,82,56,474,0.3933333333333333,0.0
60,55,50,40,55,45,305,0.22377622377622378,65,105,60,60,70,95,455,63.0,0.5
60,40,50,75,85,95,405,0.6044776119402985,70,75,60,105,60,105,475,0.88,0.5
76,147,90,60,70,97,540,0.8267716535433071,50,50,50,50,50,50,300,0.30708661417322836,1.0
70,90,70,60,60,70,420,0.6390977443609023,43,70,48,50,60,38,309,0.2391304347826087,2.0
55,40,50,65,85,40,335,0.3181818181818182,81,102,77,85,75,85,505,0.5642857142857143,2.0
75,75,60,83,60,60,413,0.39344262295081966,70,110,80,55,80,105,500,0.8794326241134752,1.0
55,85,55,50,55,60,360,0.4233576642335766,60,80,50,40,40,30,300,0.15328467153284672,0.5
50,92,108,92,108,35,485,0.2457627118644068,64,115,65,83,63,65,455,0.5323741007194245,4.0
50,50,40,30,30,50,250,0.2781954887218045,50,85,40,85,40,35,335,0.1746031746031746,1.0
70,83,50,37,50,60,350,0.3360655737704918,90,92,75,92,85,60,494,0.49586776859504134,2.0
90,85,100,95,125,85,580,0.6834532374100719,67,82,62,46,48,43,348,0.22033898305084745,2.0
30,80,90,55,45,55,355,0.4295774647887324,75,90,140,60,60,40,465,0.3008130081300813,1.0
41,56,40,62,44,71,314,0.568,80,120,79,95,79,70,523,0.5833333333333334,1.0
105,125,100,60,100,100,590,0.8359375,61,72,57,55,55,65,365,0.3984375,1.0
35,64,85,74,55,32,345,0.19827586206896552,85,120,70,50,60,100,485,0.8308823529411765,1.0
79,85,60,55,60,71,410,0.60431654676259,45,30,35,20,20,45,195,0.14782608695652175,1.0
43,70,48,50,60,38,309,0.2391304347826087,40,45,35,30,40,55,245,0.3793103448275862,0.25
100,123,75,57,75,80,510,0.6923076923076923,75,95,95,95,95,85,540,0.6470588235294118,1.0
58,64,58,80,65,80,405,0.5423728813559322,100,134,110,95,100,61,600,0.4057971014492754,0.5
40,45,65,100,120,90,460,0.5588235294117647,60,75,85,100,85,115,520,0.8992248062015504,0.5
85,76,64,45,55,90,415,0.6739130434782609,45,30,15,85,65,65,305,0.36220472440944884,1.0
100,100,100,100,100,100,600,0.8602941176470589,57,80,91,80,87,75,470,0.5737704918032787,0.5
90,95,105,165,110,45,610,0.2890625,45,65,34,40,34,45,263,0.2589928057553957,0.5
105,105,75,65,100,50,500,0.37593984962406013,59,66,70,44,55,41,335,0.25190839694656486,1.0
95,155,109,70,130,81,640,0.6788321167883211,70,80,50,35,35,35,305,0.14,0.5
55,55,85,65,85,35,380,0.2014388489208633,62,73,55,56,52,84,382,0.7244094488188977,8.0
90,92,87,75,85,76,505,0.5409836065573771,80,115,80,65,55,93,488,0.7846153846153846,0.0
50,160,110,160,110,110,700,0.8854961832061069,45,60,32,50,32,76,295,0.5925925925925926,1.0
100,90,130,45,65,55,485,0.4253731343283582,55,130,115,50,50,75,475,0.5982142857142857,0.5
45,49,49,65,65,45,318,0.2781954887218045,70,90,110,60,75,95,500,0.7333333333333333,0.25
100,150,140,100,90,90,670,0.7969924812030075,35,20,65,40,65,20,245,0.02459016393442623,1.0
80,80,90,110,130,110,600,0.8721804511278195,55,75,60,75,60,103,428,0.7982456140350878,1.0
65,150,40,15,80,145,495,0.9663865546218487,100,100,100,100,100,100,600,0.831858407079646,2.0
110,160,110,80,110,100,670,0.8591549295774648,80,85,95,30,30,25,345,0.2857142857142857,0.5
65,130,60,95,110,65,525,0.5303030303030303,250,5,5,35,105,50,450,0.15306122448979592,1.0
45,55,39,35,39,42,255,0.18518518518518517,100,150,110,95,110,70,635,0.5923076923076923,1.0
65,95,75,55,55,85,430,0.6933333333333334,50,55,50,36,30,43,264,0.2922077922077922,1.0
100,100,80,60,60,50,450,0.3050847457627119,53,54,53,37,46,45,288,0.3090909090909091,1.0
50,120,53,35,110,87,455,0.640625,72,85,70,65,70,58,420,0.41304347826086957,2.0
50,30,55,65,55,20,275,0.13675213675213677,60,80,110,50,80,45,425,0.2833333333333333,1.0
40,45,65,100,120,90,460,0.5588235294117647,66,41,77,61,87,23,355,0.12096774193548387,1.0
72,105,115,54,86,68,500,0.5149253731343284,60,90,55,90,80,110,485,0.8677685950413223,1.0
85,80,70,135,75,90,535,0.7006802721088435,55,84,105,114,75,52,485,0.2890625,1.0
62,44,50,44,50,55,305,0.3629032258064516,105,95,80,40,80,90,490,0.753968253968254,1.0
90,95,105,165,110,45,610,0.2890625,70,110,180,60,60,50,530,0.4117647058823529,0.5
59,110,150,45,49,35,448,0.3333333333333333,45,50,43,40,38,62,278,0.40441176470588236,0.0
45,45,55,45,55,63,308,0.4594594594594595,75,80,95,90,100,50,490,0.2158273381294964,0.5
80,70,40,100,60,145,495,0.921875,67,125,40,30,30,58,350,0.3431372549019608,1.0
60,60,60,35,35,30,280,0.11194029850746269,100,100,100,100,100,100,600,0.831858407079646,1.0
95,80,105,40,70,100,490,0.8046875,90,55,75,60,75,30,385,0.13970588235294118,1.0
60,95,80,60,80,30,405,0.19480519480519481,50,35,55,25,25,15,205,0.021739130434782608,0.5
80,100,70,60,70,95,475,0.7416666666666667,110,65,75,125,85,30,490,0.15,1.0
80,100,80,80,80,100,520,0.9051724137931034,60,50,100,85,70,65,430,0.47580645161290325,0.0
75,100,110,45,55,65,450,0.5333333333333333,68,125,65,65,115,80,518,0.6277372262773723,1.0
75,140,65,112,65,110,567,0.9140625,66,117,70,40,50,67,410,0.4573643410852713,1.0
78,104,78,159,115,100,634,0.8444444444444444,75,90,90,140,90,115,600,0.9481481481481482,0.5
30,42,118,42,88,30,350,0.112,40,65,95,60,45,35,340,0.13986013986013987,1.0
70,100,70,105,75,40,460,0.23214285714285715,50,50,95,40,50,35,320,0.20279720279720279,1.0
60,95,80,60,80,30,405,0.19480519480519481,60,79,105,59,85,36,424,0.17054263565891473,1.0
63,63,47,41,41,74,329,0.56,62,48,66,59,57,49,341,0.33884297520661155,1.0
55,66,44,44,56,85,350,0.6888888888888889,52,65,55,58,62,60,352,0.4482758620689655,1.0
40,55,30,30,30,85,270,0.688,70,100,70,105,75,40,460,0.23214285714285715,1.0
45,100,45,45,45,10,290,0.2949640287769784,65,70,60,65,65,115,440,0.8583333333333333,1.0
74,48,76,83,81,104,466,0.7913043478260869,70,115,60,115,60,55,475,0.4647887323943662,0.0
90,100,60,90,60,80,480,0.6422764227642277,75,100,63,80,63,116,497,0.9345794392523364,1.0
75,95,60,65,60,115,470,0.8778625954198473,45,60,40,70,50,45,310,0.2846715328467153,1.0
90,130,80,65,85,55,505,0.4396551724137931,38,30,41,30,41,60,240,0.2897196261682243,2.0
40,30,30,55,30,85,270,0.4666666666666667,75,38,38,56,56,67,330,0.5263157894736842,0.25
83,80,80,135,80,121,579,0.9444444444444444,100,100,80,60,60,50,450,0.3050847457627119,1.0
109,66,84,81,99,32,471,0.2013888888888889,60,80,95,70,85,50,440,0.2231404958677686,2.0
91,134,95,100,100,80,600,0.6304347826086957,86,92,88,68,75,73,482,0.6835443037974683,1.0
68,125,65,65,115,80,518,0.6277372262773723,60,40,60,40,60,35,295,0.18055555555555555,1.0
90,65,65,40,40,15,315,0.19672131147540983,20,15,20,10,55,80,200,0.2682926829268293,0.5
70,110,180,60,60,50,530,0.4117647058823529,50,55,50,36,30,43,264,0.2922077922077922,2.0
85,56,77,50,77,78,423,0.53125,40,45,35,30,40,55,245,0.3793103448275862,0.0
90,100,70,110,150,80,600,0.6037735849056604,75,95,95,95,95,85,540,0.6470588235294118,2.0
125,130,90,130,90,95,660,0.7734375,108,130,95,80,85,102,600,0.7637795275590551,8.0
65,125,100,60,70,70,490,0.6099290780141844,90,92,75,92,85,60,494,0.49586776859504134,2.0
31,45,90,30,30,40,266,0.21929824561403508,60,115,105,65,70,80,495,0.7181818181818181,2.0
54,66,70,44,55,46,335,0.4214876033057851,50,65,64,44,48,43,314,0.2196969696969697,2.0
54,66,70,44,55,46,335,0.4214876033057851,78,65,68,112,154,75,552,0.628099173553719,1.0
60,40,50,75,85,95,405,0.6044776119402985,60,59,85,79,105,36,424,0.16666666666666666,0.5
65,136,94,54,96,135,580,0.9612403100775194,52,65,50,45,50,38,300,0.27419354838709675,2.0
63,63,47,41,41,74,329,0.56,35,85,45,35,35,75,310,0.6492537313432836,1.0
65,55,115,100,40,60,435,0.3798449612403101,95,124,78,69,71,58,495,0.37398373983739835,1.0
59,110,150,45,49,35,448,0.3333333333333333,53,54,53,37,46,45,288,0.3090909090909091,1.0
65,55,115,100,40,60,435,0.3798449612403101,80,105,105,105,105,80,580,0.5939849624060151,1.0
95,117,184,44,46,28,514,0.2975206611570248,123,77,72,99,92,58,521,0.4621212121212121,0.5
70,110,70,115,70,90,525,0.75,61,90,45,50,50,160,456,0.9230769230769231,0.25
50,25,28,45,55,15,218,0.0625,60,80,50,50,50,40,330,0.23853211009174313,1.0
99,68,83,72,87,51,460,0.417910447761194,90,65,65,40,40,15,315,0.19672131147540983,2.0
95,80,105,40,70,100,490,0.8046875,65,60,110,130,95,65,525,0.47761194029850745,1.0
75,89,85,55,65,36,405,0.29545454545454547,85,60,65,135,105,100,550,0.7518248175182481,0.25
70,70,115,130,90,60,535,0.5338983050847458,45,60,45,25,45,55,275,0.29,1.0
55,95,55,35,75,115,430,0.9380530973451328,85,97,66,105,66,65,484,0.47107438016528924,0.5
95,125,79,60,100,81,540,0.6165413533834586,95,23,48,23,48,23,260,0.046153846153846156,1.0
65,100,70,80,80,105,500,0.8666666666666667,40,20,30,40,80,55,265,0.22764227642276422,2.0
55,40,50,65,85,40,335,0.3181818181818182,70,95,125,65,75,45,475,0.33613445378151263,2.0
55,35,50,55,110,85,390,0.6277372262773723,95,125,79,60,100,81,540,0.6165413533834586,0.5
75,95,95,95,95,85,540,0.6470588235294118,60,40,80,60,45,40,325,0.23529411764705882,0.5
70,83,50,37,50,60,350,0.3360655737704918,70,94,50,94,50,66,424,0.48148148148148145,2.0
70,75,60,105,60,105,475,0.88,86,92,88,68,75,73,482,0.6835443037974683,1.0
55,50,40,40,40,75,300,0.5945945945945946,65,155,120,65,90,105,600,0.8677685950413223,1.0
85,76,64,45,55,90,415,0.6739130434782609,40,30,32,50,52,65,269,0.3671875,1.0
35,55,40,50,50,90,320,0.6838235294117647,100,100,90,150,140,90,670,0.71875,2.0
52,65,55,58,62,60,352,0.4482758620689655,55,55,85,65,85,35,380,0.2014388489208633,0.25
126,131,95,131,98,99,680,0.8294573643410853,41,50,37,50,37,66,281,0.5175438596491229,2.0
90,55,75,60,75,30,385,0.13970588235294118,49,49,56,49,61,66,330,0.5190839694656488,1.0
79,103,120,135,115,78,630,0.5763888888888888,110,135,60,50,65,88,508,0.7744360902255639,2.0
59,45,40,35,40,31,250,0.14285714285714285,90,100,70,110,150,80,600,0.6037735849056604,1.0
40,50,45,70,45,70,320,0.5517241379310345,60,85,42,85,42,91,405,0.8227848101265823,0.0
70,110,180,60,60,50,530,0.4117647058823529,43,70,48,50,60,38,309,0.2391304347826087,1.0
75,75,95,75,95,113,528,0.9015151515151515,65,85,70,75,70,40,405,0.203125,1.0
103,60,86,60,86,50,445,0.3458646616541353,75,70,90,70,105,80,490,0.656,1.0
190,33,58,33,58,33,405,0.13432835820895522,80,70,70,90,100,70,480,0.5609756097560976,1.0
60,60,60,105,105,105,495,0.848,45,50,35,55,75,40,300,0.21367521367521367,1.0
20,15,20,10,55,80,200,0.2682926829268293,50,65,45,85,65,95,405,0.7238095238095238,0.5
95,85,85,65,65,35,430,0.2571428571428571,50,50,150,50,150,50,500,0.2571428571428571,4.0
10,55,25,35,45,95,265,0.5396825396825397,69,69,76,69,86,91,460,0.6554621848739496,1.0
70,60,75,110,75,90,480,0.7165354330708661,41,56,40,62,44,71,314,0.568,2.0
45,67,60,35,50,63,320,0.5128205128205128,75,95,67,125,95,83,540,0.7117117117117117,2.0
45,60,45,25,45,55,275,0.29,75,90,140,60,60,40,465,0.3008130081300813,0.5
80,80,50,40,50,25,325,0.176056338028169,81,102,77,85,75,85,505,0.5642857142857143,0.25
70,115,60,115,60,55,475,0.4647887323943662,55,112,45,74,45,70,401,0.559322033898305,1.0
50,75,75,65,65,50,380,0.4049586776859504,70,75,80,135,80,135,575,0.917910447761194,1.0
60,105,60,120,60,105,510,0.8849557522123894,40,30,35,50,70,55,280,0.28205128205128205,1.0
52,65,55,58,62,60,352,0.4482758620689655,77,120,90,60,90,48,485,0.2785714285714286,1.0
80,115,80,65,55,93,488,0.7846153846153846,75,95,122,58,75,69,494,0.5725806451612904,0.0
40,40,55,40,70,55,300,0.40939597315436244,65,75,70,95,70,95,470,0.7272727272727273,0.0
80,92,65,65,80,68,450,0.4824561403508772,95,135,80,110,80,100,600,0.8248175182481752,0.5
60,105,60,120,60,105,510,0.8849557522123894,64,78,52,78,52,81,405,0.6422764227642277,0.5
120,120,120,120,120,120,720,0.9344262295081968,90,90,85,125,90,100,580,0.768595041322314,1.0
70,50,30,95,135,105,485,0.8040540540540541,60,62,80,63,80,60,405,0.4336283185840708,2.0
70,140,230,60,80,50,630,0.32432432432432434,65,75,105,35,65,85,430,0.6940298507462687,1.0
100,75,115,90,115,85,580,0.6446280991735537,55,95,55,35,75,115,430,0.9380530973451328,1.0
60,80,95,70,85,50,440,0.2231404958677686,72,105,115,54,86,68,500,0.5149253731343284,1.0
86,68,72,109,66,106,507,0.8099173553719008,75,65,55,65,55,69,384,0.43548387096774194,0.5
65,40,70,80,140,70,465,0.5954198473282443,45,53,70,40,60,42,310,0.25735294117647056,2.0
60,85,40,30,45,68,328,0.6422018348623854,54,45,47,75,98,52,371,0.39669421487603307,1.0
55,45,45,25,25,15,210,0.048,125,130,90,130,90,95,660,0.7734375,0.5
60,85,40,30,45,68,328,0.6422018348623854,65,65,60,110,95,130,525,0.9253731343283582,2.0
67,89,116,79,116,33,500,0.2624113475177305,74,108,133,83,65,32,495,0.32142857142857145,1.0
45,60,40,70,50,45,310,0.2846715328467153,50,70,160,70,160,90,600,0.7417218543046358,1.0
55,50,65,175,95,150,590,0.7818181818181819,123,77,72,99,92,58,521,0.4621212121212121,1.0
78,84,78,109,85,100,534,0.8620689655172413,84,86,88,111,101,60,530,0.4634146341463415,1.0
50,70,50,50,50,40,310,0.16296296296296298,45,50,35,55,75,40,300,0.21367521367521367,0.5
86,76,86,116,56,95,515,0.7982456140350878,46,57,40,40,40,50,273,0.25,0.5
84,71,43,71,43,48,360,0.25874125874125875,70,94,50,94,50,66,424,0.48148148148148145,1.0
52,65,55,58,62,60,352,0.4482758620689655,55,84,105,114,75,52,485,0.2890625,1.0
40,45,35,30,40,55,245,0.3793103448275862,58,89,77,45,45,48,362,0.3177570093457944,0.25
73,115,60,60,60,90,458,0.6694915254237288,100,128,90,77,77,128,600,0.959349593495935,1.0
39,52,43,60,50,65,309,0.49107142857142855,50,53,48,53,48,64,316,0.358974358974359,0.5
54,45,47,75,98,52,371,0.39669421487603307,60,85,42,85,42,91,405,0.8227848101265823,2.0
35,46,34,35,45,20,215,0.072,55,70,40,60,40,40,305,0.26956521739130435,1.0
50,50,95,40,50,35,320,0.20279720279720279,72,60,30,20,30,25,237,0.11570247933884298,1.0
85,105,55,85,50,115,495,0.9032258064516129,60,40,50,75,85,95,405,0.6044776119402985,1.0
110,130,80,70,60,80,530,0.5862068965517241,10,55,25,35,45,95,265,0.5396825396825397,2.0
62,77,62,50,42,65,358,0.4838709677419355,64,78,52,78,52,81,405,0.6422764227642277,2.0
35,70,55,45,55,25,285,0.09420289855072464,60,85,69,60,69,77,420,0.518796992481203,1.0
70,55,65,95,85,70,440,0.5307692307692308,70,94,50,94,50,66,424,0.48148148148148145,4.0
60,80,50,50,50,40,330,0.23853211009174313,65,75,90,97,123,44,494,0.1987179487179487,1.0
75,75,60,83,60,60,413,0.39344262295081966,92,105,90,125,90,98,600,0.8217054263565892,0.5
123,100,62,97,81,68,531,0.4806201550387597,58,64,58,80,65,80,405,0.609271523178808,0.5
75,55,70,55,95,110,460,0.8444444444444444,60,30,30,36,56,50,262,0.32432432432432434,0.5
35,35,40,35,55,50,250,0.40336134453781514,80,52,50,90,50,89,411,0.6666666666666666,0.5
38,30,41,30,41,60,240,0.2897196261682243,65,100,70,80,80,105,500,0.8666666666666667,1.0
75,95,95,95,95,85,540,0.6470588235294118,70,60,75,110,75,90,480,0.7165354330708661,0.5
60,45,70,45,90,95,405,0.7304964539007093,60,45,50,90,80,70,395,0.625,2.0
106,110,90,154,90,130,680,0.926829268292683,109,66,84,81,99,32,471,0.2013888888888889,2.0
60,65,70,85,75,40,395,0.21705426356589147,45,30,50,65,50,45,285,0.13821138211382114,1.0
90,120,75,60,60,45,450,0.29411764705882354,90,92,75,92,85,60,494,0.49586776859504134,1.0
45,30,35,20,20,45,195,0.14782608695652175,55,95,55,35,75,115,430,0.9380530973451328,2.0
85,115,80,105,80,50,515,0.3063063063063063,67,82,62,46,48,43,348,0.22033898305084745,1.0
50,65,107,105,107,86,520,0.703125,70,70,70,70,70,70,420,0.5289256198347108,1.0
40,80,100,30,30,20,300,0.11851851851851852,75,70,90,70,105,80,490,0.656,0.0
65,80,140,40,70,70,465,0.5223880597014925,110,85,95,80,95,50,515,0.2713178294573643,1.0
65,73,55,47,75,85,400,0.6846846846846847,44,50,91,24,86,10,305,0.1981981981981982,1.0
67,89,116,79,116,33,500,0.2624113475177305,90,93,55,70,55,55,418,0.3819444444444444,0.5
52,65,50,45,50,38,300,0.27419354838709675,40,30,32,50,52,65,269,0.3671875,1.0
60,130,80,60,60,70,460,0.5153846153846153,120,100,85,30,85,45,465,0.22448979591836735,1.0
95,85,85,65,65,35,430,0.2571428571428571,67,58,57,81,67,101,431,0.8790322580645161,2.0
80,135,130,95,90,70,600,0.5181818181818182,85,115,80,105,80,50,515,0.3063063063063063,0.5
60,100,85,80,85,100,510,0.7007874015748031,60,85,60,50,50,125,430,0.9090909090909091,1.0
50,50,95,40,50,35,320,0.20279720279720279,55,75,85,25,25,15,280,0.1875,2.0
68,165,95,65,115,110,618,0.8615384615384616,46,57,40,40,40,50,273,0.25,1.0
68,72,78,38,42,32,330,0.23809523809523808,40,45,35,65,55,70,310,0.4482758620689655,0.5
75,90,140,60,60,40,465,0.3008130081300813,65,155,120,65,90,105,600,0.8677685950413223,0.5
70,62,67,55,55,56,365,0.38513513513513514,45,60,45,25,45,55,275,0.29,1.0
40,55,80,35,60,30,300,0.15037593984962405,65,90,65,61,61,100,442,0.8373983739837398,1.0
65,95,75,55,55,85,430,0.6933333333333334,70,77,60,97,60,108,472,0.8394160583941606,1.0
58,64,58,80,65,80,405,0.5423728813559322,50,75,70,35,70,48,348,0.29357798165137616,1.0
100,164,150,95,120,71,700,0.5645161290322581,60,70,50,100,50,65,395,0.5217391304347826,4.0
55,75,85,25,25,15,280,0.1875,65,40,70,80,140,70,465,0.5954198473282443,2.0
150,120,100,120,100,90,680,0.664179104477612,65,105,60,60,70,95,455,63.0,1.0
95,65,65,110,130,60,525,0.4016393442622951,73,115,60,60,60,90,458,0.6694915254237288,1.0
35,70,55,45,55,25,285,0.09420289855072464,40,45,65,100,120,90,460,0.5588235294117647,1.0
80,120,70,110,70,80,530,0.6422764227642277,45,25,50,25,25,35,205,0.13076923076923078,0.5
45,65,34,40,34,45,263,0.2589928057553957,45,60,32,50,32,76,295,0.5925925925925926,0.5
80,105,65,60,75,130,515,0.9645390070921985,50,45,45,35,35,50,260,0.23529411764705882,1.0
50,65,64,44,48,43,314,0.2196969696969697,85,105,100,79,83,78,530,0.5869565217391305,0.5
50,65,85,35,35,55,325,0.32575757575757575,80,70,65,80,120,100,515,0.8034188034188035,0.5
90,65,65,40,40,15,315,0.19672131147540983,55,55,55,85,55,30,335,0.1320754716981132,0.5
80,110,60,150,130,70,600,0.5042016806722689,67,125,40,30,30,58,350,0.3431372549019608,1.0
40,65,95,60,45,35,340,0.13986013986013987,123,77,72,99,92,58,521,0.4621212121212121,0.5
70,40,50,55,50,25,290,0.061068702290076333,120,100,85,30,85,45,465,0.22448979591836735,1.0
60,45,70,75,85,55,390,0.3008130081300813,150,120,100,120,100,90,680,0.664179104477612,1.0
71,95,85,110,95,79,535,0.664,45,30,35,20,20,45,195,0.14782608695652175,1.0
35,85,45,35,35,75,310,0.6492537313432836,80,100,200,50,100,50,580,0.3472222222222222,0.25
35,65,35,65,35,65,300,0.46621621621621623,40,30,32,50,52,65,269,0.3671875,0.5
50,85,125,85,115,20,480,0.4306569343065693,55,69,85,32,35,28,304,0.09302325581395349,1.0
89,125,90,115,80,101,600,0.8725490196078431,63,120,85,90,55,55,468,0.2809917355371901,1.0
74,48,76,83,81,104,466,0.7322834645669292,45,55,39,35,39,42,255,0.18518518518518517,1.0
65,90,122,58,75,84,494,0.71875,105,105,75,65,100,50,500,0.37593984962406013,0.5
60,79,105,59,85,36,424,0.17054263565891473,50,95,180,85,45,70,525,0.5298507462686567,1.0
78,104,78,159,115,100,634,0.8444444444444444,55,66,44,44,56,85,350,0.6888888888888889,1.0
60,40,80,60,45,40,325,0.23529411764705882,60,40,50,75,85,95,405,0.6044776119402985,1.0
67,82,62,46,48,43,348,0.22033898305084745,50,65,85,35,35,55,325,0.32575757575757575,1.0
65,65,60,110,95,130,525,0.9253731343283582,63,60,55,50,50,71,349,0.5289256198347108,2.0
70,55,55,80,60,45,365,0.2222222222222222,90,92,87,75,85,76,505,0.5409836065573771,0.0
80,45,65,90,110,80,470,0.5462962962962963,55,45,50,45,65,80,340,0.5546218487394958,1.0
100,100,80,60,60,50,450,0.3050847457627119,65,65,45,75,45,95,390,0.72,0.0
55,81,60,50,70,97,413,0.7214285714285714,58,109,112,48,48,109,484,0.8805970149253731,0.5
60,105,60,120,60,105,510,0.8849557522123894,90,90,85,125,90,100,580,0.768595041322314,1.0
100,100,90,150,140,90,670,0.71875,135,85,40,40,85,5,390,0.6864406779661016,1.0
71,73,88,120,89,59,500,0.43537414965986393,25,20,15,105,55,90,310,0.32407407407407407,1.0
58,89,77,45,45,48,362,0.3177570093457944,40,40,55,40,70,55,300,0.40939597315436244,0.5
80,75,150,75,150,50,580,0.30973451327433627,70,55,55,80,60,45,365,0.2222222222222222,0.5
69,55,45,55,55,15,294,0.11666666666666667,35,65,35,65,35,65,300,0.46621621621621623,2.0
78,104,78,159,115,100,634,0.8444444444444444,75,98,63,98,63,101,498,0.889763779527559,0.5
105,95,80,40,80,90,490,0.753968253968254,45,65,34,40,34,45,263,0.2589928057553957,1.0
125,58,58,76,76,67,460,0.515625,95,117,184,44,46,28,514,0.2975206611570248,1.0
95,155,109,70,130,81,640,0.6788321167883211,100,150,140,100,90,90,670,0.7969924812030075,2.0
90,120,75,60,60,45,450,0.29411764705882354,70,55,55,80,60,45,365,0.2222222222222222,1.0
50,52,48,65,50,55,320,0.33098591549295775,106,130,90,110,154,90,680,0.719626168224299,2.0
58,50,145,95,105,30,483,0.2459016393442623,70,62,67,55,55,56,365,0.38513513513513514,1.0
70,55,95,95,110,65,490,0.48872180451127817,64,66,68,81,76,50,405,0.25190839694656486,1.0
95,135,80,110,80,100,600,0.8248175182481752,55,40,40,65,45,35,280,0.16428571428571428,0.5
115,115,85,90,75,100,580,0.8134328358208955,86,76,86,116,56,95,515,0.7982456140350878,2.0
60,90,70,60,120,40,440,0.27419354838709675,45,65,34,40,34,45,263,0.2589928057553957,1.0
70,85,70,60,70,50,405,0.28378378378378377,70,90,70,60,60,70,420,0.6390977443609023,1.0
61,78,95,56,58,57,405,0.40336134453781514,50,70,160,70,160,90,600,0.7417218543046358,1.0
77,120,90,60,90,48,485,0.2785714285714286,55,55,45,63,45,45,308,0.25,1.0
50,65,45,85,65,95,405,0.7238095238095238,40,35,30,120,70,105,400,0.6692307692307692,1.0
75,80,70,65,75,90,455,0.7578125,95,70,73,95,90,60,483,0.3983739837398374,2.0
43,80,65,50,35,35,308,0.14193548387096774,82,121,119,69,59,71,521,0.5394736842105263,1.0
74,48,76,83,81,104,466,0.7322834645669292,85,80,70,135,75,90,535,0.7006802721088435,1.0
45,50,45,115,55,95,405,0.6936936936936937,65,70,60,65,65,115,440,0.8583333333333333,0.0
91,72,90,129,90,108,580,0.8925619834710744,79,100,80,110,90,121,580,0.968,0.5
100,100,80,60,60,50,450,0.3050847457627119,60,45,50,90,80,70,395,0.625,0.0
95,75,110,100,80,30,490,0.15267175572519084,70,77,60,97,60,108,472,0.8394160583941606,1.0
64,78,52,78,52,81,405,0.6422764227642277,60,62,50,62,60,40,334,0.18181818181818182,8.0
150,100,120,100,120,90,680,0.6666666666666666,103,93,67,71,61,84,479,0.7142857142857143,0.5
106,190,100,154,100,130,780,0.9259259259259259,60,90,140,50,50,40,430,0.2535211267605634,2.0
54,63,52,83,56,97,405,0.7697841726618705,83,106,65,86,65,85,490,0.6640625,1.0
50,180,20,180,20,150,600,0.9029850746268657,51,65,65,80,75,59,395,0.4365079365079365,1.0
65,65,60,110,95,130,525,0.9253731343283582,66,65,48,62,57,52,350,0.36220472440944884,0.5
60,105,60,120,60,105,510,0.8849557522123894,95,65,110,60,130,65,525,0.5275590551181102,0.5
44,58,44,58,44,61,309,0.41964285714285715,79,103,120,135,115,78,630,0.5763888888888888,0.5
90,92,75,92,85,60,494,0.49586776859504134,45,75,60,40,30,50,300,0.304,1.0
73,100,60,100,60,65,458,0.42657342657342656,60,50,150,50,150,60,520,0.5206611570247934,0.0
75,125,100,70,80,45,495,0.33035714285714285,48,72,48,72,48,48,336,0.25984251968503935,2.0
84,86,88,111,101,60,530,0.4634146341463415,80,70,40,100,60,145,495,0.921875,1.0
60,62,50,62,60,40,334,0.18181818181818182,50,95,180,85,45,70,525,0.5298507462686567,0.5
90,65,65,40,40,15,315,0.19672131147540983,90,85,75,115,100,115,580,0.9381443298969072,1.0
65,80,80,59,63,58,405,0.4411764705882353,75,125,70,125,70,115,580,0.9037037037037037,1.0
60,100,85,80,85,100,510,0.7007874015748031,111,83,68,92,82,39,475,0.1774193548387097,2.0
40,55,30,30,30,60,245,0.43548387096774194,45,75,60,40,30,50,300,0.304,1.0
135,85,40,40,85,5,390,0.6864406779661016,91,90,106,130,106,77,600,0.648854961832061,0.5
55,55,85,65,85,35,380,0.2014388489208633,52,65,55,58,62,60,352,0.4482758620689655,2.0
45,30,50,55,65,45,290,0.208,80,95,82,60,82,75,474,0.6,2.0
55,130,115,50,50,75,475,0.5982142857142857,40,30,50,55,55,100,330,0.584070796460177,1.0
95,75,110,100,80,30,490,0.15267175572519084,45,53,70,40,60,42,310,0.25735294117647056,0.5
72,58,80,103,80,97,490,0.7171052631578947,35,20,65,40,65,20,245,0.02459016393442623,1.0
70,60,62,80,82,60,414,0.4375,95,60,79,100,125,81,540,0.6201550387596899,1.0
60,50,100,85,70,65,430,0.47580645161290325,73,115,60,60,60,90,458,0.6694915254237288,1.0
80,145,150,105,110,110,700,0.8692307692307693,60,90,70,60,120,40,440,0.27419354838709675,1.0
75,125,100,70,80,45,495,0.33035714285714285,85,80,70,135,75,90,535,0.7006802721088435,1.0
50,105,79,35,110,76,455,0.6214285714285714,100,100,100,100,100,100,600,0.8345864661654135,0.5
79,100,80,110,90,121,580,0.968,60,80,95,70,85,50,440,0.2231404958677686,0.5
65,70,60,65,65,115,440,0.8583333333333333,35,40,100,90,55,35,355,0.1796875,0.5
95,117,80,65,70,92,519,0.8409090909090909,45,30,50,65,50,45,285,0.13821138211382114,2.0
64,51,23,51,23,28,240,0.11363636363636363,45,60,40,70,50,45,310,0.2846715328467153,1.0
60,70,50,100,50,65,395,0.5217391304347826,110,85,95,80,95,50,515,0.2713178294573643,1.0
83,80,75,70,70,101,479,0.8615384615384616,100,100,100,100,100,100,600,0.831858407079646,1.0
54,66,70,44,55,46,335,0.4214876033057851,55,130,115,50,50,75,475,0.5982142857142857,2.0
45,50,45,115,55,95,405,0.6936936936936937,44,48,65,50,64,43,314,0.1623931623931624,1.0
105,125,100,60,100,100,590,0.8359375,125,58,58,76,76,67,460,0.515625,1.0
75,103,80,70,80,92,500,0.7933884297520661,68,125,65,65,115,80,518,0.6277372262773723,1.0
65,47,55,73,75,85,400,0.65,90,120,120,60,60,50,500,0.35294117647058826,1.0
60,25,35,70,80,60,330,0.3076923076923077,50,50,150,50,150,50,500,0.2571428571428571,1.0
60,52,168,47,138,30,495,0.19834710743801653,64,51,23,51,23,28,240,0.11363636363636363,1.0
67,89,116,79,116,33,500,0.2624113475177305,65,47,55,73,75,85,400,0.65,1.0
77,59,50,67,63,46,362,0.23140495867768596,85,50,95,120,115,80,545,0.5793650793650794,4.0
95,75,180,130,80,30,590,0.13793103448275862,55,55,45,63,45,45,308,0.25,0.5
60,82,45,45,45,74,351,0.5752212389380531,60,50,150,50,150,60,520,0.5206611570247934,4.0
80,135,130,95,90,70,600,0.5181818181818182,126,131,95,131,98,99,680,0.8102189781021898,0.0
50,64,50,45,50,41,300,0.22727272727272727,60,130,80,60,60,70,460,0.5153846153846153,0.25
70,145,88,140,70,112,625,0.8888888888888888,100,100,100,100,100,100,600,0.8758169934640523,0.5
46,87,60,30,40,57,320,0.37777777777777777,60,85,42,85,42,91,405,0.8227848101265823,1.0
65,50,70,95,80,65,425,0.4262295081967213,67,125,40,30,30,58,350,0.3431372549019608,1.0
70,150,140,65,100,75,600,0.55,45,55,45,65,45,75,330,0.5692307692307692,1.0
80,82,78,95,80,85,500,0.6869565217391305,55,45,45,25,25,15,210,0.048,1.0
76,104,71,104,71,108,534,0.912751677852349,90,100,90,125,85,90,580,0.7352941176470589,0.25
67,125,40,30,30,58,350,0.3431372549019608,46,87,60,30,40,57,320,0.37777777777777777,1.0
68,85,65,165,135,100,618,0.8083333333333333,75,95,122,58,75,69,494,0.5725806451612904,1.0
60,65,80,170,95,130,600,0.8625954198473282,114,85,70,85,80,30,464,0.2066115702479339,1.0
100,180,160,150,90,90,770,0.7520661157024794,106,90,130,90,154,110,680,0.8699186991869918,0.0
25,20,15,105,55,90,310,0.32407407407407407,53,54,53,37,46,45,288,0.3090909090909091,0.0
62,44,50,44,50,55,305,0.3629032258064516,72,85,70,65,70,58,420,0.41304347826086957,0.5
83,106,65,86,65,85,490,0.6640625,95,109,105,75,85,56,525,0.34513274336283184,1.0
62,55,52,109,94,109,481,0.7833333333333333,105,180,100,180,100,115,780,0.9477611940298507,1.0
100,164,150,95,120,71,700,0.5645161290322581,40,65,40,80,40,65,330,0.5038167938931297,0.5
75,100,66,60,66,115,482,0.918918918918919,65,90,40,45,80,75,395,0.625,1.0
65,75,90,97,123,44,494,0.1987179487179487,35,65,35,65,35,65,300,0.46621621621621623,1.0
50,85,55,65,65,90,410,0.7478260869565218,50,180,20,180,20,150,600,0.9029850746268657,1.0
40,40,35,50,100,70,335,0.5031847133757962,50,30,55,65,55,20,275,0.13675213675213677,1.0
45,63,37,65,55,95,360,0.8055555555555556,65,90,65,61,61,100,442,0.8373983739837398,2.0
65,90,120,85,70,60,490,0.43410852713178294,103,60,86,60,86,50,445,0.3458646616541353,1.0
50,105,125,55,95,50,480,0.375886524822695,70,150,140,65,100,75,600,0.55,0.25
73,115,60,60,60,90,458,0.6694915254237288,108,130,95,80,85,102,600,0.7637795275590551,1.0
79,100,80,110,90,121,580,0.968,40,70,130,60,130,25,455,0.17355371900826447,1.0
51,65,65,80,75,59,395,0.4365079365079365,65,130,60,75,60,75,465,0.689922480620155,1.0
60,90,70,60,120,40,440,0.27419354838709675,58,109,112,48,48,109,484,0.8805970149253731,0.5
60,100,85,80,85,100,510,0.7007874015748031,108,130,95,80,85,102,600,0.7637795275590551,2.0
44,38,33,61,43,70,289,0.5267857142857143,70,110,180,60,60,50,530,0.4117647058823529,0.25
40,70,40,35,40,60,285,0.392,66,65,48,62,57,52,350,0.36220472440944884,1.0
60,80,95,70,85,50,440,0.2231404958677686,95,80,105,40,70,100,490,0.8046875,1.0
61,90,45,50,50,160,456,0.9230769230769231,60,85,60,85,60,55,405,0.3673469387755102,0.5
83,80,80,135,80,121,579,0.9444444444444444,60,100,85,80,85,100,510,0.7007874015748031,2.0
90,60,70,75,70,45,410,0.23880597014925373,65,90,40,45,80,75,395,0.625,1.0
45,49,49,65,65,45,318,0.2781954887218045,99,68,83,72,87,51,460,0.417910447761194,0.5
75,140,65,112,65,110,567,0.9140625,76,25,45,67,55,24,292,0.0390625,1.0
65,50,35,115,95,95,455,0.7333333333333333,46,57,40,40,40,50,273,0.25,2.0
106,190,100,154,100,130,780,0.9259259259259259,45,50,43,40,38,62,278,0.40441176470588236,1.0
50,50,40,30,30,50,250,0.2781954887218045,90,70,80,70,95,70,475,0.5190839694656488,0.25
70,120,40,95,40,95,460,0.8106060606060606,54,45,47,75,98,52,371,0.39669421487603307,0.5
45,35,45,62,53,35,275,0.11851851851851852,50,95,95,35,110,70,455,0.5179856115107914,1.0
45,35,45,62,53,35,275,0.11851851851851852,69,69,76,69,86,91,460,0.6554621848739496,2.0
76,65,45,92,42,91,411,0.7449664429530202,111,83,68,92,82,39,475,0.1774193548387097,1.0
79,115,70,125,80,111,580,0.864,55,65,95,95,45,85,440,0.6610169491525424,2.0
40,55,30,30,30,60,245,0.43548387096774194,110,123,65,100,65,65,528,0.5217391304347826,2.0
61,72,57,55,55,65,365,0.3984375,70,85,70,60,70,50,405,0.28378378378378377,0.5
50,70,50,50,50,70,340,0.5645161290322581,30,30,42,30,42,70,244,0.4230769230769231,0.0
60,40,60,40,60,35,295,0.18055555555555555,44,58,44,58,44,61,309,0.41964285714285715,0.5
50,85,40,85,40,35,335,0.1746031746031746,80,45,65,90,110,80,470,0.5462962962962963,1.0
89,125,90,115,80,101,600,0.8725490196078431,50,50,150,50,150,50,500,0.2571428571428571,1.0
92,105,90,125,90,98,600,0.8217054263565892,100,120,100,150,120,90,680,0.728,2.0
40,70,130,60,130,25,455,0.17355371900826447,100,5,5,15,65,30,220,0.07692307692307693,0.0
72,95,67,103,71,122,530,0.9606299212598425,60,60,60,85,85,85,435,0.631578947368421,2.0
90,100,60,90,60,80,480,0.6422764227642277,38,41,40,50,65,65,299,0.4108527131782946,0.5
55,40,85,80,105,40,405,0.23622047244094488,60,75,85,100,85,115,520,0.8992248062015504,1.0
40,45,40,65,40,65,295,0.5661764705882353,111,83,68,92,82,39,475,0.1774193548387097,0.0
99,68,83,72,87,51,460,0.417910447761194,40,45,35,40,40,90,290,0.65,1.0
115,140,130,55,55,40,535,0.4519230769230769,83,80,80,135,80,121,579,0.9444444444444444,0.0
20,40,90,30,90,25,295,0.11363636363636363,45,95,50,40,50,75,355,0.54,1.0
80,92,65,65,80,68,450,0.4824561403508772,126,131,95,131,98,99,680,0.8294573643410853,1.0
84,71,43,71,43,48,360,0.25874125874125875,91,72,90,129,90,108,580,0.8925619834710744,1.0
50,65,85,35,35,55,325,0.32575757575757575,70,90,110,60,75,95,500,0.7333333333333333,1.0
75,85,200,55,65,30,510,0.16778523489932887,70,140,70,110,65,105,560,0.95,0.5
65,95,75,55,55,85,430,0.6933333333333334,75,125,230,55,95,30,610,0.3448275862068966,0.0
100,120,100,150,120,90,680,0.728,52,65,55,58,62,60,352,0.4482758620689655,1.0
70,85,70,60,70,50,405,0.28378378378378377,85,105,55,85,50,115,495,0.9032258064516129,0.5
86,92,88,68,75,73,482,0.6835443037974683,78,84,78,109,85,100,534,0.8646616541353384,1.0
80,100,200,50,100,50,580,0.3472222222222222,86,92,88,68,75,73,482,0.6835443037974683,1.0
100,128,90,77,77,128,600,0.959349593495935,40,45,40,35,35,56,251,0.373015873015873,1.0
105,150,90,150,90,95,680,0.8285714285714286,50,52,48,65,50,55,320,0.33098591549295775,1.0
66,65,48,62,57,52,350,0.36220472440944884,60,75,100,55,80,50,420,0.3088235294117647,0.5
85,80,90,105,95,60,515,0.49074074074074076,60,115,105,65,70,80,495,0.7181818181818181,0.5
100,100,100,100,100,100,600,0.8805970149253731,106,150,70,194,120,140,780,0.952,1.0
70,50,30,95,135,105,485,0.8040540540540541,35,65,35,65,35,65,300,0.46621621621621623,0.5
90,95,105,165,110,45,610,0.2890625,30,30,30,30,30,30,180,0.12612612612612611,0.5
64,51,23,51,23,28,240,0.11363636363636363,76,48,48,57,62,34,325,0.11688311688311688,1.0
55,75,85,25,25,15,280,0.1875,55,75,60,75,60,103,428,0.7982456140350878,2.0
80,82,83,100,100,80,525,0.6742424242424242,70,105,105,50,40,20,390,0.33587786259541985,1.0
76,65,45,92,42,91,411,0.7449664429530202,55,112,45,74,45,70,401,0.559322033898305,0.25
55,68,64,45,55,31,318,0.11666666666666667,80,82,78,95,80,85,500,0.6869565217391305,2.0
50,20,40,20,40,20,190,0.0962962962962963,55,70,55,40,55,85,360,0.7073170731707317,1.0
65,95,75,55,55,85,430,0.6933333333333334,35,60,44,40,54,55,288,0.366412213740458,0.5
65,85,70,75,70,40,405,0.203125,39,52,43,60,50,65,309,0.5041322314049587,1.0
75,70,90,70,105,80,490,0.656,60,75,100,55,80,50,420,0.3088235294117647,0.25
100,150,110,95,110,70,635,0.5923076923076923,59,45,40,35,40,31,250,0.14285714285714285,1.0
100,100,100,100,100,100,600,0.831858407079646,40,27,60,37,50,66,280,0.36220472440944884,1.0
70,80,65,90,65,85,455,0.578125,85,100,122,58,75,54,494,0.3939393939393939,0.0
68,90,65,50,55,82,410,0.6165413533834586,66,41,77,61,87,23,355,0.12096774193548387,1.0
64,88,50,88,50,106,446,0.9111111111111111,70,83,50,37,50,60,350,0.3360655737704918,1.0
20,15,20,10,55,80,200,0.2682926829268293,105,180,100,180,100,115,780,0.9477611940298507,0.5
40,70,130,60,130,25,455,0.17355371900826447,95,135,80,110,80,100,600,0.8248175182481752,1.0
108,100,121,81,95,95,600,0.7476635514018691,73,100,60,100,60,65,458,0.42657342657342656,2.0
100,100,100,100,100,100,600,0.8778625954198473,73,115,60,60,60,90,458,0.6694915254237288,1.0
25,35,70,95,55,45,325,0.16783216783216784,50,30,55,65,55,20,275,0.13675213675213677,0.5
65,80,140,40,70,70,465,0.5223880597014925,65,40,70,80,140,70,465,0.5954198473282443,0.5
81,102,77,85,75,85,505,0.5642857142857143,85,135,130,60,80,25,515,0.40540540540540543,1.0
55,95,55,35,75,115,430,0.9380530973451328,50,50,77,95,77,91,440,0.5916666666666667,2.0
85,105,100,79,83,78,530,0.5869565217391305,50,92,108,92,108,35,485,0.2457627118644068,1.0
83,106,65,86,65,85,490,0.6640625,78,92,75,74,63,118,500,0.8842975206611571,0.5
61,72,57,55,55,65,365,0.3984375,90,93,55,70,55,55,418,0.3819444444444444,1.0
99,68,83,72,87,51,460,0.417910447761194,100,5,5,15,65,30,220,0.07692307692307693,1.0
70,110,180,60,60,50,530,0.4117647058823529,50,50,150,50,150,50,500,0.2571428571428571,1.0
114,85,70,85,80,30,464,0.2066115702479339,89,125,90,115,80,101,600,0.8725490196078431,0.5
70,60,75,110,75,90,480,0.7165354330708661,45,45,35,20,30,20,195,0.07246376811594203,0.5
95,65,110,60,130,65,525,0.5275590551181102,65,90,115,45,115,58,488,0.5041322314049587,0.25
60,62,50,62,60,40,334,0.18181818181818182,62,73,55,56,52,84,382,0.7244094488188977,0.25
78,65,68,112,154,75,552,0.628099173553719,105,95,80,40,80,90,490,0.753968253968254,1.0
75,100,66,60,66,115,482,0.918918918918919,45,20,50,60,120,50,345,0.24074074074074073,1.0
28,25,25,45,35,40,198,0.16083916083916083,75,65,55,65,55,69,384,0.43548387096774194,2.0
20,25,45,70,90,60,310,0.30833333333333335,45,60,40,70,50,45,310,0.2846715328467153,0.5
85,70,80,97,80,123,535,0.9304347826086956,40,60,30,31,31,70,262,0.4492753623188406,1.0
50,65,90,35,35,15,290,0.14678899082568808,105,140,95,55,65,45,505,0.3,0.5
50,50,40,50,40,64,294,0.45588235294117646,70,65,60,90,75,90,450,0.6571428571428571,1.0
60,67,85,77,75,116,480,0.8888888888888888,75,103,80,70,80,92,500,0.7933884297520661,0.25
10,55,25,35,45,95,265,0.5396825396825397,56,61,65,48,45,38,313,0.17567567567567569,0.5
45,60,32,50,32,76,295,0.5925925925925926,85,80,90,105,95,60,515,0.49074074074074076,1.0
65,50,35,115,95,95,455,0.7333333333333333,109,66,84,81,99,32,471,0.2013888888888889,4.0
78,52,60,63,65,23,341,0.06015037593984962,55,40,85,80,105,40,405,0.23622047244094488,1.0
58,109,112,48,48,109,484,0.8805970149253731,76,25,45,67,55,24,292,0.0390625,2.0
60,100,85,80,85,100,510,0.7007874015748031,100,90,130,45,65,55,485,0.4253731343283582,2.0
70,95,125,65,75,45,475,0.33613445378151263,90,85,75,115,100,115,580,0.9381443298969072,1.0
50,35,55,25,25,15,205,0.05263157894736842,75,38,38,56,56,67,330,0.5263157894736842,1.0
50,20,40,20,40,20,190,0.0962962962962963,70,110,180,60,60,50,530,0.4117647058823529,0.125
60,90,140,50,50,40,430,0.2535211267605634,60,85,69,65,79,80,438,0.576,1.0
44,58,44,58,44,61,309,0.41964285714285715,43,30,55,40,65,97,330,0.6030534351145038,0.5
70,90,90,135,90,125,600,0.9401709401709402,50,52,48,65,50,55,320,0.33098591549295775,1.0
45,49,49,65,65,45,318,0.2781954887218045,63,63,47,41,41,74,329,0.56,0.25
42,52,67,39,56,50,306,0.2868217054263566,115,115,85,90,75,100,580,0.8134328358208955,4.0
50,53,48,53,48,64,316,0.4076923076923077,75,95,95,95,95,85,540,0.6470588235294118,1.0
35,35,40,35,55,50,250,0.40336134453781514,123,77,72,99,92,58,521,0.4621212121212121,1.0
100,150,110,95,110,70,635,0.5923076923076923,75,90,50,110,80,95,500,0.7985611510791367,4.0
45,75,37,70,55,83,365,0.6183206106870229,75,125,100,70,80,45,495,0.33035714285714285,1.0
105,140,95,55,65,45,505,0.3,65,50,70,95,80,65,425,0.4262295081967213,0.5
65,40,50,125,60,30,370,0.07258064516129033,58,89,77,45,45,48,362,0.3177570093457944,1.0
55,75,60,75,60,103,428,0.7982456140350878,44,50,91,24,86,10,305,0.1981981981981982,0.5
65,125,100,55,70,85,500,0.6532258064516129,99,68,83,72,87,51,460,0.417910447761194,1.0
116,55,85,107,95,29,487,0.06818181818181818,70,55,95,95,110,65,490,0.48872180451127817,0.5
57,80,91,80,87,75,470,0.5737704918032787,85,70,80,97,80,123,535,0.9304347826086956,2.0
41,64,45,50,50,50,300,0.36752136752136755,75,98,63,98,63,101,498,0.889763779527559,1.0
76,104,71,104,71,108,534,0.912751677852349,75,70,90,70,105,80,490,0.656,0.25
100,103,75,120,75,127,600,0.940677966101695,110,135,60,50,65,88,508,0.7744360902255639,0.5
50,72,35,35,35,65,292,0.5373134328358209,100,150,140,100,90,90,670,0.7969924812030075,1.0
60,50,40,85,75,95,405,0.7540983606557377,50,53,48,53,48,64,316,0.4076923076923077,0.5
55,65,35,60,30,85,330,0.6126126126126126,65,80,140,40,70,70,465,0.5223880597014925,1.0
75,95,125,45,75,95,510,0.8257575757575758,110,130,80,70,60,80,530,0.5862068965517241,1.0
80,120,79,95,79,70,523,0.5833333333333334,60,62,63,80,80,60,405,0.38016528925619836,0.5
70,77,60,97,60,108,472,0.8394160583941606,50,64,50,45,50,41,300,0.22727272727272727,0.0
48,72,48,72,48,48,336,0.25984251968503935,65,40,70,80,140,70,465,0.5954198473282443,1.0
75,125,100,70,80,45,495,0.33035714285714285,95,23,48,23,48,23,260,0.046153846153846156,2.0
50,50,150,50,150,50,500,0.2571428571428571,86,68,72,109,66,106,507,0.8099173553719008,1.0
60,50,50,60,70,50,340,0.28346456692913385,50,75,45,40,45,60,315,0.4380165289256198,0.5
30,45,55,70,55,85,340,0.5633802816901409,80,105,65,60,75,130,515,0.9645390070921985,2.0
70,110,180,60,60,50,530,0.4117647058823529,65,40,70,80,140,70,465,0.5954198473282443,1.0
31,45,90,30,30,40,266,0.21929824561403508,80,70,40,100,60,145,495,0.921875,0.5
120,120,120,120,120,120,720,0.9344262295081968,50,105,125,55,95,50,480,0.375886524822695,0.5
170,90,45,90,45,60,500,0.427536231884058,40,50,45,70,45,70,320,0.5517241379310345,1.0
80,80,80,55,55,90,440,0.6417910447761194,90,100,90,125,85,90,580,0.7352941176470589,1.0
70,83,50,37,50,60,350,0.3360655737704918,35,35,35,35,35,35,210,0.13385826771653545,2.0
71,73,88,120,89,59,500,0.43537414965986393,40,60,40,40,40,30,250,0.0948905109489051,1.0
79,115,70,125,80,111,580,0.8468468468468469,50,150,50,150,50,150,600,0.9339622641509434,1.0
35,35,35,35,35,35,210,0.13385826771653545,60,50,50,60,70,50,340,0.28346456692913385,1.0
20,15,20,10,55,80,200,0.2682926829268293,45,45,55,45,55,63,308,0.4594594594594595,0.5
54,66,70,44,55,46,335,0.4214876033057851,56,61,65,48,45,38,313,0.17567567567567569,0.5
90,93,55,70,55,55,418,0.3819444444444444,60,69,95,69,95,36,424,0.2608695652173913,4.0
115,115,85,90,75,100,580,0.8134328358208955,86,76,86,116,56,95,515,0.7982456140350878,2.0
65,60,110,130,95,65,525,0.47761194029850745,50,80,95,10,45,10,290,0.232,1.0
28,25,25,45,35,40,198,0.16083916083916083,49,49,56,49,61,66,330,0.5190839694656488,1.0
80,70,65,80,120,100,515,0.8034188034188035,50,50,50,50,50,50,300,0.30708661417322836,1.0
50,65,90,35,35,15,290,0.14678899082568808,85,115,80,105,80,50,515,0.3063063063063063,1.0
75,100,66,60,66,115,482,0.918918918918919,100,150,140,100,90,90,670,0.7969924812030075,1.0
60,50,70,80,80,140,480,0.8449612403100775,55,69,85,32,35,28,304,0.09302325581395349,1.0
60,110,70,60,60,100,460,0.8461538461538461,90,93,55,70,55,55,418,0.3819444444444444,2.0
78,92,75,74,63,118,500,0.8842975206611571,65,50,70,95,80,65,425,0.4262295081967213,0.5
65,85,70,75,70,40,405,0.203125,48,72,48,72,48,48,336,0.25984251968503935,1.0
81,102,77,85,75,85,505,0.5642857142857143,76,147,90,60,70,97,540,0.8267716535433071,1.0
65,95,75,55,55,85,430,0.6933333333333334,80,75,150,75,150,50,580,0.30973451327433627,0.0
100,5,5,15,65,30,220,0.07692307692307693,100,73,83,73,83,55,467,0.371900826446281,1.0
80,82,100,83,100,80,525,0.6821705426356589,39,52,43,60,50,65,309,0.5041322314049587,0.5
50,45,45,35,35,50,260,0.23529411764705882,40,45,40,65,40,65,295,0.5661764705882353,1.0
73,95,62,85,65,85,465,0.6666666666666666,45,30,15,85,65,65,305,0.36220472440944884,1.0
103,93,67,71,61,84,479,0.7142857142857143,109,66,84,81,99,32,471,0.2013888888888889,0.5
92,105,90,125,90,98,600,0.8217054263565892,50,48,43,46,41,60,288,0.47297297297297297,1.0
1,90,45,30,30,40,236,0.33064516129032256,90,70,80,70,95,70,475,0.5190839694656488,1.0
60,55,145,75,150,40,525,0.2,80,100,123,122,120,80,625,0.56,1.0
75,98,63,98,63,101,498,0.889763779527559,70,120,100,145,105,20,560,0.2824427480916031,0.5
120,100,85,30,85,45,465,0.22448979591836735,60,50,70,80,80,140,480,0.8449612403100775,1.0
50,40,85,40,65,25,305,0.08870967741935484,62,77,62,50,42,65,358,0.4838709677419355,0.5
170,90,45,90,45,60,500,0.427536231884058,70,95,85,55,65,70,440,0.5,2.0
68,125,65,65,115,80,518,0.6277372262773723,95,75,180,130,80,30,590,0.13793103448275862,0.25
20,10,55,15,20,80,200,0.17985611510791366,50,95,180,85,45,70,525,0.5298507462686567,0.5
40,40,50,30,30,30,220,0.0873015873015873,40,45,35,65,55,70,310,0.4482758620689655,0.5
75,80,60,65,90,102,472,0.8625954198473282,95,75,110,100,80,30,490,0.15267175572519084,1.0
70,150,140,65,100,75,600,0.55,50,180,20,180,20,150,600,0.9029850746268657,2.0
50,70,100,40,40,30,330,0.2222222222222222,55,85,55,50,55,60,360,0.4233576642335766,2.0
46,87,60,30,40,57,320,0.37777777777777777,20,10,55,15,20,80,200,0.17985611510791366,1.0
35,40,100,90,55,35,355,0.1796875,105,140,55,30,55,95,480,0.8195488721804511,4.0
95,117,184,44,46,28,514,0.2975206611570248,90,120,100,150,120,100,680,0.7718120805369127,1.0
40,45,35,65,55,70,310,0.4482758620689655,70,70,115,130,90,60,535,0.5338983050847458,0.5
110,130,80,70,60,80,530,0.5862068965517241,40,80,100,30,30,20,300,0.11851851851851852,4.0
64,88,50,88,50,106,446,0.9111111111111111,90,100,60,90,60,80,480,0.6422764227642277,0.5
58,109,112,48,48,109,484,0.8805970149253731,40,65,95,60,45,35,340,0.13986013986013987,0.5
80,90,80,130,110,110,600,0.856,57,24,86,24,86,23,300,0.12727272727272726,0.125
65,45,55,45,70,45,325,0.24369747899159663,60,60,60,85,85,85,435,0.631578947368421,1.0
50,48,43,46,41,60,288,0.47297297297297297,80,160,80,130,80,100,630,0.8455284552845529,4.0
40,30,30,40,50,30,220,0.07936507936507936,80,90,80,130,110,110,600,0.856,0.25
80,160,60,170,130,80,680,0.6180555555555556,100,100,100,100,100,100,600,0.8345864661654135,1.0
40,45,65,100,120,90,460,0.5588235294117647,25,20,15,105,55,90,310,0.32407407407407407,0.5
50,95,180,85,45,70,525,0.5298507462686567,60,90,55,90,80,110,485,0.8677685950413223,1.0
100,100,100,100,100,100,600,0.8345864661654135,80,110,120,130,90,70,600,0.6198347107438017,1.0
90,55,75,60,75,30,385,0.13970588235294118,60,70,65,125,105,90,515,0.6911764705882353,1.0
55,63,90,50,80,42,380,0.21138211382113822,85,76,64,45,55,90,415,0.6739130434782609,1.0
60,62,50,62,60,40,334,0.18181818181818182,80,100,80,80,80,100,520,0.9051724137931034,4.0
106,90,130,90,154,110,680,0.8699186991869918,61,84,65,70,70,70,420,0.5,1.0
100,100,100,100,100,100,600,0.8758169934640523,60,40,50,75,85,95,405,0.6044776119402985,0.5
100,5,5,15,65,30,220,0.07692307692307693,55,95,55,35,75,115,430,0.9380530973451328,1.0
75,80,60,65,90,102,472,0.8625954198473282,50,65,85,35,35,55,325,0.32575757575757575,0.5
60,75,100,55,80,50,420,0.3088235294117647,105,30,105,140,105,55,540,0.3524590163934426,0.25
40,40,40,70,40,20,250,0.032520325203252036,59,45,40,35,40,31,250,0.14285714285714285,1.0
80,92,65,65,80,68,450,0.4824561403508772,60,65,70,85,75,40,395,0.21705426356589147,0.5
65,90,122,58,75,84,494,0.71875,50,65,90,35,35,15,290,0.14678899082568808,0.5
40,40,50,30,30,30,220,0.0873015873015873,100,128,90,77,77,128,600,0.959349593495935,1.0
35,46,34,35,45,20,215,0.072,100,100,100,100,100,100,600,0.8778625954198473,1.0
64,66,68,81,76,50,405,0.25190839694656486,65,75,90,97,123,44,494,0.1987179487179487,0.5
90,100,90,125,85,90,580,0.7352941176470589,95,135,80,110,80,100,600,0.8248175182481752,0.5
80,135,85,70,95,150,615,0.9844961240310077,40,30,35,45,40,55,245,0.31496062992125984,2.0
75,98,63,98,63,101,498,0.849624060150376,75,125,75,30,75,85,465,0.625,1.0
35,45,160,30,45,70,385,0.48148148148148145,50,100,150,100,150,50,600,0.37142857142857144,2.0
90,60,70,75,70,45,410,0.23880597014925373,44,50,91,24,86,10,305,0.1981981981981982,0.5
91,129,90,72,90,108,580,0.8536585365853658,79,115,70,125,80,111,580,0.8468468468468469,1.0
70,110,80,55,80,105,500,0.8794326241134752,85,60,65,135,105,100,550,0.7518248175182481,1.0
90,93,55,70,55,55,418,0.3819444444444444,40,80,35,35,45,70,305,0.4661016949152542,1.0
70,90,70,60,60,70,420,0.6390977443609023,10,55,25,35,45,95,265,0.5396825396825397,1.0
65,83,57,95,85,105,490,0.8914728682170543,45,30,50,65,50,45,285,0.13821138211382114,1.0
75,80,55,25,35,35,305,0.18666666666666668,100,77,77,128,128,90,600,0.6901408450704225,1.0
40,40,40,70,40,20,250,0.032520325203252036,60,90,70,60,120,40,440,0.27419354838709675,1.0
70,70,40,60,40,60,340,0.4247787610619469,75,75,95,75,95,113,528,0.9015151515151515,0.5
70,110,75,145,85,145,630,0.9444444444444444,40,50,90,30,55,65,330,0.44680851063829785,0.25
70,110,180,60,60,50,530,0.4117647058823529,50,92,108,92,108,35,485,0.2457627118644068,1.0
100,73,83,73,83,55,467,0.371900826446281,65,95,100,60,50,50,420,0.34959349593495936,1.0
72,58,80,103,80,97,490,0.7171052631578947,125,120,90,170,100,95,700,0.78125,1.0
65,90,40,45,80,75,395,0.625,50,72,35,35,35,65,292,0.5373134328358209,1.0
80,80,90,110,130,110,600,0.8721804511278195,68,90,65,50,55,82,410,0.6165413533834586,4.0
60,150,50,150,50,60,520,0.5,105,95,75,85,75,74,509,0.5714285714285714,0.5
75,125,100,70,80,45,495,0.33035714285714285,70,55,65,95,85,70,440,0.5307692307692308,2.0
91,134,95,100,100,80,600,0.6304347826086957,60,80,110,50,80,45,425,0.2833333333333333,1.0
65,125,100,60,70,70,490,0.6099290780141844,105,30,105,140,105,55,540,0.3524590163934426,1.0
85,110,90,45,90,80,500,0.6206896551724138,70,94,50,94,50,66,424,0.48148148148148145,1.0
65,95,75,55,55,85,430,0.6933333333333334,50,35,55,25,25,15,205,0.021739130434782608,1.0
85,110,90,45,90,80,500,0.6206896551724138,28,25,25,45,35,40,198,0.16083916083916083,1.0
190,33,58,33,58,33,405,0.13432835820895522,49,66,70,44,55,51,335,0.4260869565217391,1.0
85,80,70,135,75,90,535,0.7006802721088435,75,100,66,60,66,115,482,0.918918918918919,1.0
120,100,85,30,85,45,465,0.22448979591836735,85,80,70,135,75,90,535,0.7006802721088435,2.0
100,100,100,100,100,100,600,0.8602941176470589,61,78,95,56,58,57,405,0.40336134453781514,0.5
10,55,25,35,45,95,265,0.5396825396825397,71,82,64,64,59,112,452,0.9327731092436975,1.0
100,50,50,76,96,70,442,0.5,90,120,75,60,60,45,450,0.29411764705882354,1.0
40,45,40,35,35,56,251,0.373015873015873,105,95,80,40,80,90,490,0.753968253968254,1.0
30,40,70,70,25,60,295,0.41353383458646614,70,130,100,55,80,65,500,0.608,1.0
62,73,55,56,52,84,382,0.7244094488188977,84,86,88,111,101,60,530,0.4634146341463415,0.5
100,100,80,60,60,50,450,0.3050847457627119,75,75,95,75,95,113,528,0.9015151515151515,1.0
70,140,70,110,65,105,560,0.95,80,82,83,100,100,80,525,0.6742424242424242,0.5
95,110,80,70,80,50,485,0.37209302325581395,71,73,88,120,89,59,500,0.43537414965986393,0.5
105,130,120,45,45,40,485,0.4444444444444444,95,110,95,40,95,55,490,0.40336134453781514,1.0
65,75,105,35,65,85,430,0.6940298507462687,72,85,70,65,70,58,420,0.41304347826086957,1.0
70,80,50,35,35,35,305,0.14,50,75,35,70,30,40,300,0.21296296296296297,0.5
65,155,120,65,90,105,600,0.8677685950413223,53,51,53,61,56,40,314,0.14285714285714285,1.0
48,61,40,61,40,50,300,0.2543859649122807,67,57,55,77,55,114,425,0.8879310344827587,0.25
65,45,55,45,70,45,325,0.24369747899159663,75,105,75,105,75,45,480,0.3274336283185841,0.5
90,50,34,60,44,70,348,0.6283185840707964,45,55,39,35,39,42,255,0.18518518518518517,0.0
55,63,90,50,80,42,380,0.21138211382113822,65,90,65,61,61,100,442,0.8373983739837398,0.25
68,90,65,50,55,82,410,0.6165413533834586,103,60,86,60,86,50,445,0.3458646616541353,1.0
40,30,30,40,50,30,220,0.07936507936507936,70,95,85,55,65,70,440,0.5,4.0
91,72,90,129,90,108,580,0.8925619834710744,50,50,62,40,62,65,329,0.4188034188034188,0.5
75,95,60,65,60,115,470,0.8778625954198473,60,40,60,95,60,55,370,0.4222222222222222,0.0
165,75,80,40,45,65,470,0.5151515151515151,20,15,20,10,55,80,200,0.2682926829268293,0.5
70,65,60,90,75,90,450,0.6571428571428571,76,48,48,57,62,34,325,0.11688311688311688,1.0
35,45,160,30,45,70,385,0.48148148148148145,41,56,40,62,44,71,314,0.568,1.0
45,30,15,85,65,65,305,0.36220472440944884,50,55,50,36,30,43,264,0.2922077922077922,2.0
80,70,40,100,60,145,495,0.921875,80,100,70,60,70,95,475,0.7416666666666667,2.0
31,45,90,30,30,40,266,0.21929824561403508,70,100,115,30,65,30,410,0.24390243902439024,2.0
100,73,83,73,83,55,467,0.371900826446281,100,50,50,76,96,70,442,0.5,1.0
45,85,50,55,50,65,350,0.5076923076923077,100,100,80,60,60,50,450,0.3050847457627119,2.0
75,100,110,45,55,65,450,0.5333333333333333,65,45,55,45,70,45,325,0.24369747899159663,1.0
105,140,95,55,65,45,505,0.3,90,85,75,115,100,115,580,0.9381443298969072,1.0
65,65,60,110,95,130,525,0.9253731343283582,80,125,75,40,95,85,500,0.6911764705882353,1.0
85,90,80,70,80,130,535,0.9262295081967213,35,40,100,90,55,35,355,0.1796875,0.25
90,92,75,92,85,60,494,0.49586776859504134,40,30,35,50,70,55,280,0.28205128205128205,0.5
105,130,120,45,45,40,485,0.4444444444444444,50,72,35,35,35,65,292,0.5373134328358209,0.5
64,88,50,88,50,106,446,0.9111111111111111,35,55,40,50,50,90,320,0.6838235294117647,1.0
80,92,65,65,80,68,450,0.4824561403508772,49,55,42,42,37,85,310,0.6068376068376068,1.0
75,98,63,98,63,101,498,0.849624060150376,35,55,40,50,50,90,320,0.6838235294117647,1.0
85,80,90,105,95,60,515,0.49074074074074076,52,65,55,58,62,60,352,0.4482758620689655,1.0
55,47,52,40,40,41,275,0.16806722689075632,65,110,130,60,65,95,525,0.8278145695364238,2.0
40,50,45,70,45,70,320,0.5517241379310345,70,83,50,37,50,60,350,0.3360655737704918,1.0
85,135,130,60,80,25,515,0.40540540540540543,45,55,39,35,39,42,255,0.18518518518518517,1.0
135,85,40,40,85,5,390,0.6864406779661016,60,60,60,105,105,105,495,0.848,0.0
72,85,70,65,70,58,420,0.41304347826086957,100,75,115,90,115,85,580,0.6446280991735537,1.0
100,100,90,150,140,90,670,0.71875,40,70,40,35,40,60,285,0.392,1.0
60,60,60,85,85,85,435,0.631578947368421,255,10,10,75,135,55,540,0.3125,0.0
105,125,100,60,100,100,590,0.8359375,75,105,75,105,75,45,480,0.3274336283185841,1.0
40,55,30,30,30,60,245,0.43548387096774194,55,50,45,135,95,120,500,0.7714285714285715,1.0
80,75,150,75,150,50,580,0.30973451327433627,35,60,44,40,54,55,288,0.366412213740458,1.0
91,90,129,90,72,108,580,0.9140625,40,45,35,30,40,55,245,0.3793103448275862,0.25
30,45,55,70,55,85,340,0.5633802816901409,39,52,43,60,50,65,309,0.5041322314049587,2.0
39,52,43,60,50,65,309,0.5041322314049587,78,65,68,112,154,75,552,0.628099173553719,1.0
50,75,70,35,70,48,348,0.29357798165137616,50,70,50,50,50,40,310,0.16296296296296298,1.0
91,129,90,72,90,108,580,0.8536585365853658,45,45,55,45,55,63,308,0.4594594594594595,1.0
60,55,90,145,90,80,520,0.6071428571428571,55,70,45,70,50,60,350,0.45,0.5
70,80,50,35,35,35,305,0.14,50,70,50,50,50,70,340,0.5645161290322581,1.0
88,107,122,74,75,64,530,0.4596774193548387,35,55,40,50,50,90,320,0.6838235294117647,1.0
80,100,123,122,120,80,625,0.56,100,75,115,90,115,85,580,0.6446280991735537,2.0
45,65,34,40,34,45,263,0.2589928057553957,45,95,50,40,50,75,355,0.54,1.0
35,35,35,35,35,35,210,0.13385826771653545,75,98,63,98,63,101,498,0.889763779527559,1.0
50,50,40,50,40,64,294,0.45588235294117646,60,45,70,45,90,95,405,0.7304964539007093,1.0
65,150,40,15,80,145,495,0.9663865546218487,91,72,90,129,90,108,580,0.8620689655172413,0.5
100,5,5,15,65,30,220,0.07692307692307693,65,100,70,80,80,105,500,0.8666666666666667,1.0
40,45,35,40,40,90,290,0.65,60,50,100,85,70,65,430,0.47580645161290325,1.0
110,160,110,80,110,100,670,0.8591549295774648,48,72,48,72,48,48,336,0.25984251968503935,1.0
110,85,95,80,95,50,515,0.2713178294573643,91,90,72,90,129,108,580,0.896,1.0
50,95,95,35,110,70,455,0.5179856115107914,100,100,100,100,100,100,600,0.831858407079646,0.5
60,85,69,60,69,77,420,0.518796992481203,97,165,60,65,50,58,495,0.3902439024390244,0.5
95,23,48,23,48,23,260,0.046153846153846156,60,80,95,70,85,50,440,0.2231404958677686,0.5
78,130,111,130,85,100,634,0.8561151079136691,65,105,60,60,70,95,455,63.0,1.0
90,60,70,75,70,45,410,0.23880597014925373,80,95,82,60,82,75,474,0.6,1.0
78,104,78,159,115,100,634,0.8444444444444444,86,92,88,68,75,73,482,0.6835443037974683,1.0
65,76,84,54,96,105,480,0.9008264462809917,60,60,50,40,50,75,335,0.5882352941176471,1.0
90,100,70,110,150,80,600,0.6037735849056604,115,140,130,55,55,40,535,0.4519230769230769,1.0
91,72,90,129,90,108,580,0.8620689655172413,111,83,68,92,82,39,475,0.1774193548387097,1.0
70,65,60,90,75,90,450,0.6571428571428571,70,90,70,60,60,70,420,0.6390977443609023,2.0
60,67,85,77,75,116,480,0.8888888888888888,45,55,39,35,39,42,255,0.18518518518518517,1.0
30,56,35,25,35,72,253,0.48148148148148145,50,92,108,92,108,35,485,0.2457627118644068,0.0
100,123,75,57,75,80,510,0.6923076923076923,78,52,60,63,65,23,341,0.06015037593984962,1.0
40,45,35,65,55,70,310,0.4482758620689655,44,38,33,61,43,70,289,0.5267857142857143,1.0
1,90,45,30,30,40,236,0.33064516129032256,70,70,40,60,40,60,340,0.4247787610619469,2.0
50,72,35,35,35,65,292,0.5373134328358209,70,80,50,35,35,35,305,0.14,0.5
75,125,230,55,95,30,610,0.3448275862068966,50,53,48,53,48,64,316,0.4076923076923077,0.5
38,41,40,50,65,65,299,0.4108527131782946,70,120,100,145,105,20,560,0.2824427480916031,0.5
80,100,70,50,60,45,405,0.25806451612903225,85,80,90,105,95,60,515,0.49074074074074076,2.0
80,80,50,40,50,25,325,0.176056338028169,70,94,50,94,50,66,424,0.48148148148148145,1.0
90,85,75,115,100,115,580,0.9381443298969072,30,42,118,42,88,30,350,0.112,1.0
28,25,25,45,35,40,198,0.16083916083916083,50,53,48,53,48,64,316,0.4076923076923077,1.0
50,50,120,80,80,30,410,0.07258064516129033,89,125,90,115,80,101,600,0.8725490196078431,1.0
105,125,100,60,100,100,590,0.8359375,100,100,90,150,140,90,670,0.71875,1.0
80,70,40,100,60,145,495,0.921875,59,59,58,90,70,73,409,0.5826086956521739,0.5
79,115,70,125,80,111,580,0.8468468468468469,30,30,30,30,30,30,180,0.12612612612612611,2.0
67,89,116,79,116,33,500,0.2624113475177305,55,45,50,45,65,80,340,0.5546218487394958,1.0
50,85,85,55,55,50,380,0.3902439024390244,45,50,35,55,75,40,300,0.21367521367521367,2.0
50,85,85,55,55,50,380,0.3902439024390244,62,48,54,63,60,68,355,0.5178571428571429,1.0
80,100,123,122,120,80,625,0.56,50,50,150,50,150,50,500,0.2571428571428571,2.0
59,59,58,90,70,73,409,0.5826086956521739,60,60,50,40,50,75,335,0.5882352941176471,2.0
95,117,80,65,70,92,519,0.8409090909090909,48,61,40,61,40,50,300,0.2543859649122807,1.0
110,130,80,70,60,80,530,0.5862068965517241,40,30,50,55,55,100,330,0.584070796460177,2.0
63,63,47,41,41,74,329,0.56,85,110,76,65,82,56,474,0.3933333333333333,2.0
79,105,70,145,80,101,580,0.8608695652173913,74,48,76,83,81,104,466,0.7913043478260869,1.0
83,106,65,86,65,85,490,0.6640625,160,110,65,65,110,30,540,0.35714285714285715,2.0
95,145,130,120,90,120,700,0.9398496240601504,46,87,60,30,40,57,320,0.37777777777777777,2.0
55,95,115,45,45,35,390,0.2116788321167883,80,82,78,95,80,85,500,0.6869565217391305,1.0
70,95,125,65,75,45,475,0.33613445378151263,58,50,145,95,105,30,483,0.2459016393442623,0.5
50,53,48,53,48,64,316,0.4076923076923077,75,125,230,55,95,30,610,0.3448275862068966,1.0
65,136,94,54,96,135,580,0.9612403100775194,65,80,65,35,65,60,370,0.38405797101449274,2.0
100,100,90,150,140,90,670,0.71875,70,43,53,43,53,40,302,0.19090909090909092,1.0
60,62,80,63,80,60,405,0.4336283185840708,55,40,85,80,105,40,405,0.23622047244094488,0.5
75,75,130,75,130,95,580,0.7479674796747967,35,55,40,45,40,60,275,0.35714285714285715,1.0
70,77,60,97,60,108,472,0.8394160583941606,65,40,70,80,140,70,465,0.5954198473282443,2.0
56,61,65,48,45,38,313,0.17567567567567569,85,50,95,120,115,80,545,0.5793650793650794,0.5
36,50,50,65,60,44,305,0.16363636363636364,110,78,73,76,71,60,468,0.3333333333333333,1.0
45,90,20,65,20,65,305,0.5116279069767442,95,23,48,23,48,23,260,0.046153846153846156,2.0
100,164,150,95,120,71,700,0.5645161290322581,50,75,45,40,45,60,315,0.4380165289256198,2.0
70,85,140,85,70,20,470,0.272,60,82,45,45,45,74,351,0.5752212389380531,1.0
89,145,90,105,80,91,600,0.8549618320610687,79,103,120,135,115,78,630,0.5763888888888888,1.0
95,109,105,75,85,56,525,0.34513274336283184,100,90,130,45,65,55,485,0.4253731343283582,8.0
75,75,95,75,95,113,528,0.9015151515151515,110,65,105,55,95,80,510,0.6258503401360545,0.5
125,120,90,170,100,95,700,0.78125,30,30,42,30,42,70,244,0.4230769230769231,2.0
91,90,129,90,72,108,580,0.9140625,90,110,80,100,80,95,555,0.7982456140350878,0.5
43,80,65,50,35,35,308,0.14193548387096774,66,117,70,40,50,67,410,0.4573643410852713,0.5
40,45,35,65,55,70,310,0.4482758620689655,50,65,90,35,35,15,290,0.14678899082568808,0.5
77,85,51,55,51,65,384,0.5163934426229508,110,123,65,100,65,65,528,0.5217391304347826,0.25
64,51,23,51,23,28,240,0.11363636363636363,79,105,70,145,80,101,580,0.8608695652173913,1.0
100,134,110,95,100,61,600,0.4057971014492754,90,65,65,40,40,15,315,0.19672131147540983,2.0
70,80,102,80,102,40,474,0.2677165354330709,74,94,131,54,116,20,489,0.4485294117647059,1.0
126,131,95,131,98,99,680,0.8102189781021898,40,65,40,80,40,65,330,0.5038167938931297,0.5
95,23,48,23,48,23,260,0.046153846153846156,53,51,53,61,56,40,314,0.14285714285714285,1.0
45,60,32,50,32,76,295,0.5925925925925926,35,55,40,50,50,90,320,0.6838235294117647,0.5
90,90,85,125,90,100,580,0.768595041322314,60,85,69,60,69,77,420,0.518796992481203,1.0
75,100,110,45,55,65,450,0.5333333333333333,78,84,78,109,85,100,534,0.8646616541353384,0.0
41,64,45,50,50,50,300,0.36752136752136755,100,50,50,76,96,70,442,0.5,1.0
65,76,84,54,96,105,480,0.9008264462809917,68,125,65,65,115,80,518,0.6277372262773723,1.0
65,45,55,45,70,45,325,0.24369747899159663,85,56,77,50,77,78,423,0.53125,2.0
35,35,35,35,35,35,210,0.13385826771653545,80,100,80,80,80,100,520,0.9051724137931034,1.0
43,80,65,50,35,35,308,0.14193548387096774,45,49,49,65,65,45,318,0.2781954887218045,0.5
100,77,77,128,128,90,600,0.6901408450704225,80,70,70,90,100,70,480,0.5609756097560976,1.0
79,85,60,55,60,71,410,0.60431654676259,80,80,80,55,55,90,440,0.6417910447761194,1.0
45,55,45,65,45,75,330,0.5692307692307692,50,53,48,53,48,64,316,0.4076923076923077,4.0
60,40,60,40,60,35,295,0.18055555555555555,80,82,78,95,80,85,500,0.6869565217391305,2.0
55,70,45,70,50,60,350,0.45,100,150,90,180,160,90,770,0.7348484848484849,0.5
75,70,90,70,105,80,490,0.656,61,84,65,70,70,70,420,0.5,2.0
50,50,77,95,77,91,440,0.5916666666666667,70,75,80,135,80,135,575,0.917910447761194,0.5
76,65,45,92,42,91,411,0.7449664429530202,60,50,150,50,150,60,520,0.5206611570247934,0.0
80,100,200,50,100,50,580,0.3472222222222222,80,115,80,65,55,93,488,0.7846153846153846,2.0
100,5,5,15,65,30,220,0.07692307692307693,60,50,100,85,70,65,430,0.47580645161290325,1.0
60,75,100,55,80,50,420,0.3088235294117647,86,68,72,109,66,106,507,0.8099173553719008,0.5
89,145,90,105,80,91,600,0.8549618320610687,50,25,28,45,55,15,218,0.0625,1.0
95,70,73,95,90,60,483,0.3983739837398374,110,123,65,100,65,65,528,0.5217391304347826,1.0
126,131,95,131,98,99,680,0.8102189781021898,50,80,95,10,45,10,290,0.232,0.5
43,30,55,40,65,97,330,0.6030534351145038,65,45,55,45,70,45,325,0.24369747899159663,0.5
80,50,100,100,200,50,580,0.2357142857142857,66,117,70,40,50,67,410,0.4573643410852713,2.0
95,75,110,100,80,30,490,0.15267175572519084,95,124,78,69,71,58,495,0.37398373983739835,0.0
85,76,64,45,55,90,415,0.6739130434782609,60,85,60,50,50,125,430,0.9090909090909091,1.0
65,75,90,97,123,44,494,0.1987179487179487,65,150,40,15,80,145,495,0.9663865546218487,0.5
39,52,43,60,50,65,309,0.49107142857142855,50,60,45,100,80,65,400,0.45689655172413796,2.0
90,60,60,40,40,40,330,0.29545454545454547,71,95,85,110,95,79,535,0.664,1.0
80,82,83,100,100,80,525,0.6742424242424242,65,100,70,80,80,105,500,0.8666666666666667,0.5
75,140,65,112,65,110,567,0.9140625,70,100,70,105,75,40,460,0.23214285714285715,1.0
60,70,65,125,105,90,515,0.6911764705882353,74,48,76,83,81,104,466,0.7322834645669292,1.0
30,56,35,25,35,72,253,0.48148148148148145,40,65,40,80,40,65,330,0.5038167938931297,1.0
100,100,100,100,100,100,600,0.8758169934640523,58,64,58,80,65,80,405,0.5423728813559322,0.5
30,40,55,40,55,60,280,0.3237410071942446,95,65,110,60,130,65,525,0.5275590551181102,0.0
90,100,90,125,85,90,580,0.7352941176470589,62,48,54,63,60,68,355,0.5178571428571429,1.0
69,55,45,55,55,15,294,0.11666666666666667,86,92,88,68,75,73,482,0.6835443037974683,1.0
110,123,65,100,65,65,528,0.5217391304347826,60,85,49,60,49,60,363,0.4444444444444444,1.0
95,110,95,40,95,55,490,0.40336134453781514,68,125,65,65,115,80,518,0.6277372262773723,1.0
90,55,75,60,75,30,385,0.13970588235294118,95,65,110,60,130,65,525,0.5275590551181102,1.0
50,70,50,50,50,40,310,0.16296296296296298,75,75,55,105,85,30,425,0.1619718309859155,0.5
65,105,60,60,70,95,455,63.0,91,72,90,129,90,108,580,0.8620689655172413,1.0
71,120,95,120,95,99,600,0.8203125,105,140,55,30,55,95,480,0.8195488721804511,0.25
55,45,43,55,43,72,313,0.5853658536585366,65,90,40,45,80,75,395,0.625,4.0
50,65,107,105,107,86,520,0.703125,65,65,45,75,45,95,390,0.72,4.0
60,100,85,80,85,100,510,0.7007874015748031,60,90,140,50,50,40,430,0.2535211267605634,2.0
75,95,67,125,95,83,540,0.7117117117117117,68,85,65,165,135,100,618,0.8083333333333333,1.0
50,105,79,35,110,76,455,0.6214285714285714,76,48,48,57,62,34,325,0.11688311688311688,1.0
55,47,52,40,40,41,275,0.16806722689075632,60,60,50,40,50,75,335,0.5882352941176471,2.0
50,50,95,40,50,35,320,0.20279720279720279,110,85,95,80,95,50,515,0.2713178294573643,1.0
72,95,67,103,71,122,530,0.9606299212598425,40,50,90,30,55,65,330,0.44680851063829785,1.0
66,65,48,62,57,52,350,0.36220472440944884,50,70,160,70,160,90,600,0.7417218543046358,1.0
69,69,76,69,86,91,460,0.6554621848739496,60,50,70,50,90,65,385,0.39568345323741005,1.0
70,80,70,80,70,110,480,0.6594202898550725,95,65,65,110,130,60,525,0.4016393442622951,1.0
65,65,60,110,95,130,525,0.9253731343283582,70,60,70,87,78,85,450,0.6228070175438597,0.5
75,55,70,55,95,110,460,0.8444444444444444,65,95,57,100,85,93,495,0.7441860465116279,0.5
65,80,80,59,63,58,405,0.4411764705882353,65,60,70,85,75,40,395,0.1796875,1.0
91,72,90,129,90,108,580,0.8620689655172413,53,54,53,37,46,45,288,0.3090909090909091,1.0
65,80,65,35,65,60,370,0.38405797101449274,60,45,50,90,80,70,395,0.625,1.0
55,40,40,65,45,35,280,0.16428571428571428,126,131,95,131,98,99,680,0.8294573643410853,1.0
60,50,50,60,70,50,340,0.28346456692913385,35,46,34,35,45,20,215,0.072,1.0
70,85,140,85,70,20,470,0.272,66,117,70,40,50,67,410,0.4573643410852713,0.5
85,56,77,50,77,78,423,0.53125,100,128,90,77,77,128,600,0.959349593495935,1.0
75,125,230,55,95,30,610,0.3448275862068966,65,50,35,115,95,95,455,0.7333333333333333,2.0
35,85,45,35,35,75,310,0.6492537313432836,50,80,95,10,45,10,290,0.232,0.25
78,84,78,109,85,100,534,0.8646616541353384,190,33,58,33,58,33,405,0.13432835820895522,1.0
45,63,37,65,55,95,360,0.8055555555555556,50,75,45,40,45,60,315,0.4380165289256198,1.0
80,160,60,170,130,80,680,0.6180555555555556,70,110,70,115,70,90,525,0.75,0.25
70,60,70,87,78,85,450,0.6228070175438597,60,75,85,100,85,115,520,0.8992248062015504,2.0
79,115,70,125,80,111,580,0.8468468468468469,80,135,85,70,95,150,615,0.9844961240310077,0.5
60,65,80,170,95,130,600,0.8625954198473282,65,80,65,35,65,60,370,0.38405797101449274,0.0
70,90,70,60,60,70,420,0.6390977443609023,70,110,70,115,70,90,525,0.75,0.5
55,75,60,75,60,103,428,0.7982456140350878,64,78,52,78,52,81,405,0.6422764227642277,2.0
45,53,70,40,60,42,310,0.25735294117647056,65,130,60,95,110,65,525,0.5303030303030303,0.25
60,105,60,120,60,105,510,0.8849557522123894,50,95,95,35,110,70,455,0.5179856115107914,0.5
40,45,35,30,40,55,245,0.3793103448275862,80,100,70,50,60,45,405,0.25806451612903225,2.0
72,60,30,20,30,25,237,0.11570247933884298,83,80,75,70,70,101,479,0.8615384615384616,1.0
75,80,85,110,90,50,490,0.3548387096774194,105,30,105,140,105,55,540,0.3524590163934426,0.5
70,130,100,55,80,65,500,0.608,67,82,62,46,48,43,348,0.22033898305084745,0.5
80,160,80,130,80,100,630,0.8455284552845529,97,165,60,65,50,58,495,0.3902439024390244,1.0
106,130,90,110,154,90,680,0.719626168224299,60,130,80,60,60,70,460,0.5153846153846153,8.0
77,120,90,60,90,48,485,0.2785714285714286,90,30,15,40,20,15,210,0.043478260869565216,0.0
80,135,85,70,95,150,615,0.9844961240310077,53,51,53,61,56,40,314,0.14285714285714285,1.0
105,30,105,140,105,55,540,0.3524590163934426,60,30,30,36,56,50,262,0.32432432432432434,1.0
65,90,50,85,45,55,390,0.371900826446281,45,50,55,75,65,30,320,0.06293706293706294,0.25
55,45,50,45,65,80,340,0.5546218487394958,35,45,160,30,45,70,385,0.48148148148148145,2.0
60,60,60,35,35,30,280,0.11194029850746269,54,45,47,75,98,52,371,0.39669421487603307,1.0
70,130,100,55,80,65,500,0.608,90,110,80,100,80,95,555,0.7982456140350878,0.25
85,80,90,105,95,60,515,0.49074074074074076,60,30,30,36,56,50,262,0.32432432432432434,1.0
54,63,52,83,56,97,405,0.7697841726618705,51,65,65,80,75,59,395,0.4365079365079365,1.0
105,150,90,150,90,95,680,0.8285714285714286,69,69,76,69,86,91,460,0.6554621848739496,1.0
60,69,95,69,95,36,424,0.2608695652173913,50,70,160,70,160,90,600,0.7417218543046358,2.0
95,75,110,100,80,30,490,0.15267175572519084,60,52,168,47,138,30,495,0.19834710743801653,1.0
40,70,40,35,40,60,285,0.392,35,55,40,50,50,90,320,0.6838235294117647,1.0
70,55,65,95,85,70,440,0.5307692307692308,49,66,70,44,55,51,335,0.4260869565217391,1.0
40,80,100,30,30,20,300,0.11851851851851852,80,100,80,80,80,100,520,0.9051724137931034,0.5
80,160,60,170,130,80,680,0.6180555555555556,65,150,40,15,80,145,495,0.9663865546218487,2.0
60,50,70,50,90,65,385,0.39568345323741005,115,115,85,90,75,100,580,0.8134328358208955,0.5
45,35,50,70,50,30,280,0.15753424657534246,60,85,60,50,50,125,430,0.9090909090909091,0.5
105,95,75,85,75,74,509,0.5714285714285714,74,94,131,54,116,20,489,0.4485294117647059,0.5
90,132,105,132,105,30,594,0.4246575342465753,40,20,30,40,80,55,265,0.22764227642276422,0.5
35,46,34,35,45,20,215,0.072,70,77,60,97,60,108,472,0.8394160583941606,1.0
60,45,50,90,80,70,395,0.625,50,70,160,70,160,90,600,0.7417218543046358,2.0
75,90,50,110,80,95,500,0.7985611510791367,80,100,70,50,60,45,405,0.25806451612903225,0.5
60,79,105,59,85,36,424,0.17054263565891473,60,90,140,50,50,40,430,0.2535211267605634,2.0
90,110,80,100,80,95,555,0.7982456140350878,100,100,100,100,100,100,600,0.8758169934640523,2.0
95,65,65,110,130,60,525,0.4016393442622951,83,80,80,135,80,121,579,0.9444444444444444,1.0
50,95,95,35,110,70,455,0.5179856115107914,80,52,50,90,50,89,411,0.6666666666666666,0.25
80,95,82,60,82,75,474,0.6,60,45,70,75,85,55,390,0.3008130081300813,1.0
50,53,48,53,48,64,316,0.46153846153846156,40,29,45,29,45,36,224,0.14634146341463414,2.0
65,75,90,97,123,44,494,0.1987179487179487,65,80,140,40,70,70,465,0.5223880597014925,0.0
106,90,130,90,154,110,680,0.8699186991869918,60,50,100,85,70,65,430,0.47580645161290325,1.0
20,10,55,15,20,80,200,0.17985611510791366,63,63,47,41,41,74,329,0.56,1.0
39,52,43,60,50,65,309,0.49107142857142855,45,30,40,105,50,20,290,0.031007751937984496,1.0
67,57,55,77,55,114,425,0.8879310344827587,55,55,45,63,45,45,308,0.25,1.0
54,63,52,83,56,97,405,0.7697841726618705,70,80,65,90,65,85,455,0.578125,1.0
60,80,50,40,40,30,300,0.15328467153284672,85,60,65,135,105,100,550,0.7518248175182481,0.5
65,90,65,61,61,100,442,0.8373983739837398,60,55,50,40,55,45,305,0.22377622377622378,2.0
40,80,100,30,30,20,300,0.11851851851851852,70,50,30,95,135,105,485,0.8040540540540541,2.0
45,65,34,40,34,45,263,0.2589928057553957,83,80,75,70,70,101,479,0.8615384615384616,2.0
80,85,95,30,30,25,345,0.2857142857142857,50,105,125,55,95,50,480,0.375886524822695,1.0
120,70,120,75,130,85,600,0.6694915254237288,250,5,5,35,105,50,450,0.15306122448979592,1.0
70,20,50,20,50,40,250,0.1557377049180328,90,85,100,95,125,85,580,0.6834532374100719,1.0
60,59,85,79,105,36,424,0.16666666666666666,60,60,60,105,105,105,495,0.848,0.5
100,120,120,150,100,90,680,0.7880794701986755,95,70,73,95,90,60,483,0.3983739837398374,0.0
95,100,85,108,70,70,528,0.5652173913043478,66,117,70,40,50,67,410,0.4573643410852713,0.5
100,134,110,95,100,61,600,0.4057971014492754,55,55,55,85,55,30,335,0.1320754716981132,2.0
75,90,50,110,80,95,500,0.7985611510791367,85,110,76,65,82,56,474,0.3933333333333333,4.0
65,85,70,75,70,40,405,0.203125,64,51,23,51,23,28,240,0.11363636363636363,1.0
55,63,90,50,80,42,380,0.21138211382113822,35,40,100,90,55,35,355,0.1796875,4.0
46,57,40,40,40,50,273,0.25,54,78,103,53,45,22,355,0.23255813953488372,0.5
65,90,115,45,115,58,488,0.5041322314049587,80,120,79,95,79,70,523,0.5833333333333334,1.0
50,92,108,92,108,35,485,0.2457627118644068,70,77,60,97,60,108,472,0.8394160583941606,1.0
45,50,45,115,55,95,405,0.6936936936936937,35,55,35,30,30,35,220,0.23684210526315788,0.5
45,100,135,65,135,45,525,0.29411764705882354,65,73,55,47,75,85,400,0.6846846846846847,1.0
80,185,115,40,105,75,600,0.6230769230769231,50,85,85,55,55,50,380,0.3902439024390244,0.25
55,55,55,85,55,30,335,0.1320754716981132,80,80,50,40,50,25,325,0.176056338028169,2.0
75,110,110,110,105,80,590,0.656934306569343,75,123,67,95,85,95,540,0.7642276422764228,1.0
100,164,150,95,120,71,700,0.5645161290322581,68,165,95,65,115,110,618,0.8615384615384616,0.5
60,62,63,80,80,60,405,0.38016528925619836,60,85,42,85,42,91,405,0.8227848101265823,0.5
80,130,100,160,120,110,700,0.8981481481481481,65,80,65,35,65,60,370,0.38405797101449274,1.0
79,85,60,55,60,71,410,0.60431654676259,62,73,55,56,52,84,382,0.7244094488188977,2.0
50,50,77,95,77,91,440,0.5916666666666667,70,60,70,87,78,85,450,0.6228070175438597,0.5
50,75,45,40,45,60,315,0.4380165289256198,90,90,85,125,90,100,580,0.768595041322314,0.5
60,25,35,70,80,60,330,0.3076923076923077,45,30,35,20,20,45,195,0.14782608695652175,1.0
90,120,120,60,60,50,500,0.35294117647058826,100,120,120,150,100,90,680,0.7880794701986755,2.0
91,129,90,72,90,108,580,0.8536585365853658,55,130,115,50,50,75,475,0.5982142857142857,1.0
90,100,70,110,150,80,600,0.6037735849056604,65,60,110,130,95,65,525,0.47761194029850745,1.0
66,41,77,61,87,23,355,0.12096774193548387,170,90,45,90,45,60,500,0.427536231884058,2.0
85,97,66,105,66,65,484,0.47107438016528924,115,115,85,90,75,100,580,0.8134328358208955,0.5
59,59,58,90,70,73,409,0.5826086956521739,45,30,50,65,50,45,285,0.13821138211382114,1.0
70,20,50,20,50,40,250,0.1557377049180328,65,76,84,54,96,105,480,0.9008264462809917,1.0
68,165,95,65,115,110,618,0.8615384615384616,65,85,70,75,70,40,405,0.203125,1.0
100,100,100,100,100,100,600,0.8602941176470589,150,80,44,90,54,80,498,0.625,0.5
60,60,50,40,50,75,335,0.5882352941176471,80,100,70,50,60,45,405,0.25806451612903225,1.0
30,40,70,70,25,60,295,0.41353383458646614,45,75,37,70,55,83,365,0.6183206106870229,2.0
85,76,64,45,55,90,415,0.6739130434782609,50,50,50,50,50,50,300,0.30708661417322836,1.0
80,95,82,60,82,75,474,0.6,90,85,100,95,125,85,580,0.6834532374100719,1.0
45,35,45,62,53,35,275,0.11851851851851852,43,30,55,40,65,97,330,0.6030534351145038,2.0
69,55,45,55,55,15,294,0.11666666666666667,95,117,184,44,46,28,514,0.2975206611570248,1.0
40,60,40,40,40,30,250,0.0948905109489051,60,69,95,69,95,36,424,0.2608695652173913,0.0
40,60,30,31,31,70,262,0.4492753623188406,95,95,85,125,65,55,520,0.3894736842105263,2.0
80,95,82,60,82,75,474,0.6,40,45,40,35,35,56,251,0.373015873015873,1.0
90,30,15,40,20,15,210,0.043478260869565216,77,85,51,55,51,65,384,0.5163934426229508,1.0
64,115,65,83,63,65,455,0.5323741007194245,50,65,90,35,35,15,290,0.14678899082568808,1.0
91,72,90,129,90,108,580,0.8620689655172413,105,140,55,30,55,95,480,0.8195488721804511,2.0
60,50,40,85,75,95,405,0.7540983606557377,60,85,42,85,42,91,405,0.8227848101265823,2.0
40,40,50,30,30,30,220,0.0873015873015873,44,50,91,24,86,10,305,0.1981981981981982,0.25
72,58,80,103,80,97,490,0.7171052631578947,62,48,66,59,57,49,341,0.33884297520661155,1.0
50,180,20,180,20,150,600,0.9029850746268657,60,82,45,45,45,74,351,0.5752212389380531,0.0
105,95,75,85,75,74,509,0.5714285714285714,50,40,85,40,65,25,305,0.08870967741935484,0.5
85,120,70,50,60,100,485,0.8308823529411765,45,85,50,55,50,65,350,0.5076923076923077,2.0
55,20,35,20,45,75,250,0.37681159420289856,67,89,116,79,116,33,500,0.2624113475177305,0.5
30,105,90,25,25,50,325,0.2773722627737226,40,40,40,70,40,20,250,0.032520325203252036,2.0
40,55,30,30,30,85,270,0.688,60,100,85,80,85,100,510,0.7007874015748031,2.0
20,15,20,10,55,80,200,0.2682926829268293,100,100,90,150,140,90,670,0.71875,0.5
25,20,15,105,55,90,310,0.32407407407407407,110,130,80,70,60,80,530,0.5862068965517241,2.0
46,57,40,40,40,50,273,0.25,75,95,125,45,75,95,510,0.8257575757575758,0.5
85,105,100,79,83,78,530,0.5869565217391305,75,95,60,65,60,115,470,0.8778625954198473,1.0
80,135,130,95,90,70,600,0.5181818181818182,120,120,120,120,120,120,720,0.9344262295081968,1.0
56,61,65,48,45,38,313,0.17567567567567569,100,150,90,180,160,90,770,0.7348484848484849,2.0
65,76,84,54,96,105,480,0.9008264462809917,50,50,95,40,50,35,320,0.20279720279720279,1.0
80,120,80,120,80,100,580,0.8478260869565217,55,47,52,40,40,41,275,0.16806722689075632,1.0
40,50,90,30,55,65,330,0.44680851063829785,60,75,85,100,85,115,520,0.8992248062015504,2.0
75,95,125,45,75,95,510,0.8257575757575758,40,30,30,40,50,30,220,0.07936507936507936,1.0
60,70,50,100,50,65,395,0.5217391304347826,60,85,69,60,69,77,420,0.518796992481203,1.0
80,100,70,50,60,45,405,0.25806451612903225,75,55,70,55,95,110,460,0.8444444444444444,0.5
60,90,140,50,50,40,430,0.2535211267605634,60,100,85,80,85,100,510,0.7007874015748031,0.5
79,103,120,135,115,78,630,0.5763888888888888,72,105,115,54,86,68,500,0.5149253731343284,1.0
35,35,35,35,35,35,210,0.13385826771653545,82,121,119,69,59,71,521,0.5394736842105263,2.0
60,85,42,85,42,91,405,0.8227848101265823,46,87,60,30,40,57,320,0.37777777777777777,1.0
74,100,72,90,72,46,454,0.24561403508771928,35,35,40,35,55,50,250,0.40336134453781514,0.25
60,85,49,60,49,60,363,0.4444444444444444,68,125,65,65,115,80,518,0.6277372262773723,1.0
45,55,45,65,45,75,330,0.5692307692307692,114,85,70,85,80,30,464,0.2066115702479339,4.0
40,35,30,20,20,50,195,0.23423423423423423,50,48,43,46,41,60,288,0.47297297297297297,0.5
60,50,70,50,90,65,385,0.39568345323741005,70,90,70,60,60,70,420,0.6390977443609023,2.0
58,109,112,48,48,109,484,0.8805970149253731,55,95,115,45,45,35,390,0.2116788321167883,2.0
80,135,130,95,90,70,600,0.5181818181818182,75,100,63,80,63,116,497,0.9345794392523364,0.5
55,35,50,55,110,85,390,0.6277372262773723,80,85,95,30,30,25,345,0.2857142857142857,0.5
55,47,52,40,40,41,275,0.16806722689075632,105,180,100,180,100,115,780,0.9477611940298507,1.0
100,90,130,45,65,55,485,0.4253731343283582,90,85,100,95,125,85,580,0.6834532374100719,4.0
55,40,85,80,105,40,405,0.23622047244094488,68,90,65,50,55,82,410,0.6165413533834586,2.0
105,180,100,180,100,115,780,0.9477611940298507,73,100,60,100,60,65,458,0.42657342657342656,1.0
75,90,140,60,60,40,465,0.3008130081300813,55,75,50,40,40,80,340,0.6302521008403361,0.5
60,85,60,85,60,55,405,0.3673469387755102,95,117,80,65,70,92,519,0.8409090909090909,2.0
40,20,30,40,80,55,265,0.22764227642276422,68,65,65,125,115,80,518,0.6461538461538462,1.0
108,112,118,68,72,47,525,0.2916666666666667,60,40,50,75,85,95,405,0.6044776119402985,2.0
150,160,100,95,65,100,670,0.8866666666666667,85,105,100,79,83,78,530,0.5869565217391305,1.0
95,110,95,40,95,55,490,0.40336134453781514,105,95,80,40,80,90,490,0.753968253968254,1.0
53,51,53,61,56,40,314,0.14285714285714285,110,78,73,76,71,60,468,0.3333333333333333,1.0
60,80,110,50,80,45,425,0.2833333333333333,58,64,58,80,65,80,405,0.5423728813559322,2.0
85,120,70,50,60,100,485,0.8308823529411765,60,60,60,105,105,105,495,0.848,0.0
75,100,66,60,66,115,482,0.918918918918919,150,100,120,100,120,90,680,0.6666666666666666,0.0
75,95,125,45,75,95,510,0.8257575757575758,55,81,60,50,70,97,413,0.7214285714285714,1.0
20,10,55,15,20,80,200,0.17985611510791366,160,110,65,65,110,30,540,0.35714285714285715,1.0
35,45,160,30,45,70,385,0.48148148148148145,88,107,122,74,75,64,530,0.4596774193548387,0.25
50,50,150,50,150,50,500,0.2571428571428571,30,40,55,40,55,60,280,0.3237410071942446,1.0
46,57,40,40,40,50,273,0.25,65,80,140,40,70,70,465,0.5223880597014925,0.0
100,103,75,120,75,127,600,0.940677966101695,60,30,30,36,56,50,262,0.32432432432432434,0.5
60,50,40,85,75,95,405,0.7540983606557377,30,35,30,100,35,80,310,0.4765625,1.0
60,80,110,50,80,45,425,0.2833333333333333,70,100,115,30,65,30,410,0.24390243902439024,2.0
60,85,69,60,69,77,420,0.518796992481203,60,79,105,59,85,36,424,0.17054263565891473,1.0
70,75,60,105,60,105,475,0.88,90,85,75,115,100,115,580,0.9381443298969072,0.5
41,56,40,62,44,71,314,0.568,60,25,35,70,80,60,330,0.3076923076923077,1.0
95,117,80,65,70,92,519,0.8409090909090909,105,30,105,140,105,55,540,0.3524590163934426,4.0
67,125,40,30,30,58,350,0.3431372549019608,70,65,60,90,75,90,450,0.6571428571428571,2.0
65,90,65,61,61,100,442,0.8373983739837398,65,70,60,65,65,115,440,0.8583333333333333,1.0
66,65,48,62,57,52,350,0.36220472440944884,80,50,100,100,200,50,580,0.2357142857142857,1.0
84,71,43,71,43,48,360,0.25874125874125875,35,70,55,45,55,25,285,0.09420289855072464,1.0
59,66,70,44,55,41,335,0.25190839694656486,69,69,76,69,86,91,460,0.6554621848739496,2.0
75,103,80,70,80,92,500,0.7933884297520661,60,85,60,50,50,125,430,0.9090909090909091,0.25
100,180,160,150,90,90,770,0.7520661157024794,59,110,150,45,49,35,448,0.3333333333333333,4.0
90,100,70,110,150,80,600,0.6037735849056604,106,150,70,194,120,140,780,0.952,1.0
75,125,75,30,75,85,465,0.625,55,70,55,40,55,85,360,0.7073170731707317,2.0
76,48,48,57,62,34,325,0.11688311688311688,60,50,40,85,75,95,405,0.7540983606557377,1.0
75,75,95,75,95,113,528,0.9015151515151515,75,125,230,55,95,30,610,0.3448275862068966,1.0
35,64,85,74,55,32,345,0.19827586206896552,40,30,32,50,52,65,269,0.3671875,0.5
50,85,125,85,115,20,480,0.4306569343065693,40,55,30,30,30,60,245,0.43548387096774194,0.0
60,40,80,60,45,40,325,0.23529411764705882,80,80,50,40,50,25,325,0.176056338028169,1.0
76,48,48,57,62,34,325,0.11688311688311688,75,100,95,40,70,110,490,0.8717948717948718,1.0
60,100,115,70,85,90,520,0.7557251908396947,125,120,90,170,100,95,700,0.78125,2.0
70,105,105,50,40,20,390,0.33587786259541985,60,40,50,75,85,95,405,0.6044776119402985,1.0
30,40,70,70,25,60,295,0.41353383458646614,70,55,75,45,65,60,370,0.45901639344262296,1.0
58,89,77,45,45,48,362,0.3177570093457944,73,115,60,60,60,90,458,0.6694915254237288,1.0
89,125,90,115,80,101,600,0.8725490196078431,61,90,45,50,50,160,456,0.9230769230769231,0.0
85,105,55,85,50,115,495,0.9032258064516129,70,100,115,30,65,30,410,0.24390243902439024,2.0
45,55,39,35,39,42,255,0.18518518518518517,45,45,35,20,30,20,195,0.07246376811594203,1.0
80,100,80,80,80,100,520,0.9051724137931034,105,180,100,180,100,115,780,0.9477611940298507,0.0
85,76,64,45,55,90,415,0.6739130434782609,55,84,105,114,75,52,485,0.2890625,1.0
170,90,45,90,45,60,500,0.427536231884058,45,50,43,40,38,62,278,0.40441176470588236,1.0
50,92,108,92,108,35,485,0.2457627118644068,130,85,80,85,95,60,535,0.43884892086330934,1.0
70,90,110,60,75,95,500,0.7333333333333333,105,95,75,85,75,74,509,0.5714285714285714,0.5
55,50,40,40,40,75,300,0.5945945945945946,70,90,110,60,75,95,500,0.7333333333333333,1.0
80,95,82,60,82,75,474,0.6,90,100,60,90,60,80,480,0.6422764227642277,2.0
60,85,40,30,45,68,328,0.6422018348623854,75,85,200,55,65,30,510,0.16778523489932887,2.0
75,95,122,58,75,69,494,0.5725806451612904,55,45,50,45,65,80,340,0.5546218487394958,0.25
67,82,62,46,48,43,348,0.22033898305084745,81,102,77,85,75,85,505,0.5642857142857143,0.5
55,63,90,50,80,42,380,0.21138211382113822,108,100,121,81,95,95,600,0.7476635514018691,1.0
70,95,85,55,65,70,440,0.5,50,53,48,53,48,64,316,0.4076923076923077,1.0
50,60,60,60,60,30,320,0.11290322580645161,52,65,55,58,62,60,352,0.4482758620689655,1.0
90,75,85,115,90,55,510,0.3445378151260504,70,95,125,65,75,45,475,0.33613445378151263,1.0
126,131,95,131,98,99,680,0.8102189781021898,55,95,55,35,75,115,430,0.9380530973451328,0.5
60,60,75,60,75,80,410,0.7321428571428571,130,65,60,110,95,65,525,0.5227272727272727,1.0
150,120,100,120,100,90,680,0.664179104477612,45,45,35,20,30,20,195,0.07246376811594203,1.0
45,90,20,65,20,65,305,0.5116279069767442,60,62,63,80,80,60,405,0.38016528925619836,0.5
75,75,95,75,95,113,528,0.9015151515151515,78,65,68,112,154,75,552,0.628099173553719,1.0
55,85,55,50,55,60,360,0.4233576642335766,70,60,62,80,82,60,414,0.4375,1.0
64,88,50,88,50,106,446,0.9111111111111111,110,123,65,100,65,65,528,0.5217391304347826,0.5
30,40,55,40,55,60,280,0.3237410071942446,95,85,85,65,65,35,430,0.2571428571428571,2.0
95,60,79,100,125,81,540,0.6201550387596899,60,130,80,60,60,70,460,0.5153846153846153,0.5
30,56,35,25,35,72,253,0.48148148148148145,50,50,50,50,50,50,300,0.30708661417322836,1.0
80,100,123,122,120,80,625,0.56,72,60,30,20,30,25,237,0.11570247933884298,1.0
65,125,100,55,70,85,500,0.6532258064516129,85,110,76,65,82,56,474,0.3933333333333333,1.0
40,30,50,55,55,100,330,0.584070796460177,45,85,50,55,50,65,350,0.5076923076923077,1.0
95,75,110,100,80,30,490,0.15267175572519084,40,40,35,50,100,70,335,0.5031847133757962,1.0
41,50,37,50,37,66,281,0.5175438596491229,85,80,70,135,75,90,535,0.7006802721088435,1.0
49,66,70,44,55,51,335,0.4260869565217391,90,100,90,125,85,90,580,0.7352941176470589,0.25
55,65,95,95,45,85,440,0.6610169491525424,85,115,80,105,80,50,515,0.3063063063063063,1.0
75,75,55,105,85,30,425,0.1619718309859155,48,61,40,61,40,50,300,0.2543859649122807,0.5
95,145,130,120,90,120,700,0.9398496240601504,108,130,95,80,85,102,600,0.7637795275590551,2.0
115,140,130,55,55,40,535,0.4519230769230769,50,52,48,65,50,55,320,0.33098591549295775,1.0
50,35,55,25,25,15,205,0.021739130434782608,50,65,107,105,107,86,520,0.703125,1.0
90,100,70,110,150,80,600,0.6037735849056604,170,90,45,90,45,60,500,0.427536231884058,1.0
55,20,35,20,45,75,250,0.37681159420289856,100,150,110,95,110,70,635,0.5923076923076923,1.0
50,70,50,50,50,70,340,0.5645161290322581,50,80,95,10,45,10,290,0.232,2.0
86,68,72,109,66,106,507,0.8099173553719008,80,82,78,95,80,85,500,0.6869565217391305,0.5
88,107,122,74,75,64,530,0.4596774193548387,123,100,62,97,81,68,531,0.4806201550387597,0.5
20,25,45,70,90,60,310,0.30833333333333335,60,50,100,85,70,65,430,0.47580645161290325,1.0
80,110,60,150,130,70,600,0.5042016806722689,60,85,42,85,42,91,405,0.8227848101265823,0.0
60,67,85,77,75,116,480,0.8888888888888888,60,110,70,60,60,100,460,0.8461538461538461,0.5
28,25,25,45,35,40,198,0.16083916083916083,50,35,55,25,25,15,205,0.021739130434782608,1.0
65,47,55,73,75,85,400,0.65,55,112,45,74,45,70,401,0.559322033898305,0.5
61,90,45,50,50,160,456,0.9230769230769231,40,40,40,70,40,20,250,0.032520325203252036,0.5
80,100,123,122,120,80,625,0.56,80,52,50,90,50,89,411,0.6666666666666666,0.25
70,80,102,80,102,40,474,0.2677165354330709,65,60,110,130,95,65,525,0.47761194029850745,1.0
44,48,65,50,64,43,314,0.1623931623931624,35,55,40,50,50,90,320,0.6838235294117647,1.0
35,64,85,74,55,32,345,0.19827586206896552,50,70,160,70,160,90,600,0.7417218543046358,1.0
100,100,100,100,100,100,600,0.8602941176470589,100,180,160,150,90,90,770,0.7520661157024794,1.0
70,140,70,110,65,105,560,0.95,100,77,77,128,128,90,600,0.6901408450704225,2.0
60,85,69,65,79,80,438,0.576,40,20,30,40,80,55,265,0.22764227642276422,1.0
85,120,70,50,60,100,485,0.8308823529411765,95,117,184,44,46,28,514,0.2975206611570248,1.0
70,85,140,85,70,20,470,0.272,50,48,43,46,41,60,288,0.47297297297297297,0.5
100,100,100,100,100,100,600,0.8758169934640523,60,60,60,85,85,85,435,0.631578947368421,1.0
75,95,60,65,60,115,470,0.8778625954198473,95,75,180,130,80,30,590,0.13793103448275862,1.0
95,109,105,75,85,56,525,0.34513274336283184,60,80,50,50,50,40,330,0.23853211009174313,1.0
75,110,110,110,105,80,590,0.656934306569343,45,60,40,70,50,45,310,0.2846715328467153,0.5
90,120,75,60,60,45,450,0.29411764705882354,95,125,79,60,100,81,540,0.6165413533834586,1.0
80,85,95,30,30,25,345,0.2857142857142857,50,92,108,92,108,35,485,0.2457627118644068,1.0
109,66,84,81,99,32,471,0.2013888888888889,60,70,65,125,105,90,515,0.6911764705882353,0.5
85,120,70,50,60,100,485,0.8308823529411765,65,136,94,54,96,135,580,0.9612403100775194,2.0
90,120,75,60,60,45,450,0.29411764705882354,135,85,40,40,85,5,390,0.6864406779661016,1.0
75,75,75,125,95,40,485,0.15671641791044777,70,95,85,55,65,70,440,0.5,0.5
70,60,62,80,82,60,414,0.4375,80,120,130,55,65,45,495,0.37037037037037035,0.5
60,52,168,47,138,30,495,0.19834710743801653,64,78,52,78,52,81,405,0.6422764227642277,0.5
75,90,140,60,60,40,465,0.3008130081300813,77,85,51,55,51,65,384,0.5163934426229508,1.0
85,97,66,105,66,65,484,0.47107438016528924,55,35,50,55,110,85,390,0.6277372262773723,2.0
75,95,122,58,75,69,494,0.5725806451612904,84,71,43,71,43,48,360,0.25874125874125875,0.0
63,120,85,90,55,55,468,0.2809917355371901,110,123,65,100,65,65,528,0.5217391304347826,1.0
86,81,97,81,107,43,495,0.203125,75,80,85,110,90,50,490,0.3548387096774194,0.25
35,35,35,35,35,35,210,0.13385826771653545,95,60,79,100,125,81,540,0.6201550387596899,1.0
50,50,150,50,150,50,500,0.2571428571428571,85,97,66,105,66,65,484,0.47107438016528924,1.0
60,79,105,59,85,36,424,0.17054263565891473,78,52,60,63,65,23,341,0.06015037593984962,0.5
63,60,55,50,50,71,349,0.5289256198347108,60,100,89,55,69,112,485,0.9298245614035088,2.0
76,48,48,57,62,34,325,0.11688311688311688,70,43,53,43,53,40,302,0.19090909090909092,1.0
70,80,70,80,70,110,480,0.6594202898550725,45,95,50,40,50,75,355,0.54,1.0
71,95,85,110,95,79,535,0.664,45,60,40,70,50,45,310,0.2846715328467153,0.5
60,55,145,75,150,40,525,0.2,50,65,90,35,35,15,290,0.14678899082568808,2.0
80,82,78,95,80,85,500,0.6869565217391305,50,20,55,25,25,30,205,0.09774436090225563,1.0
80,130,100,160,120,110,700,0.8981481481481481,95,95,85,125,65,55,520,0.3894736842105263,0.5
60,48,45,43,90,42,328,0.21897810218978103,70,60,75,110,75,90,480,0.7165354330708661,1.0
106,130,90,110,154,90,680,0.719626168224299,25,20,15,105,55,90,310,0.32407407407407407,1.0
80,75,150,75,150,50,580,0.30973451327433627,60,25,35,70,80,60,330,0.3076923076923077,1.0
50,80,95,10,45,10,290,0.232,30,56,35,25,35,72,253,0.48148148148148145,1.0
106,90,130,90,154,110,680,0.8699186991869918,39,52,43,60,50,65,309,0.49107142857142855,1.0
35,70,55,45,55,25,285,0.09420289855072464,69,69,76,69,86,91,460,0.6554621848739496,2.0
90,92,75,92,85,60,494,0.49586776859504134,39,52,43,60,50,65,309,0.5041322314049587,0.25
73,100,60,100,60,65,458,0.42657342657342656,75,98,63,98,63,101,498,0.8091603053435115,2.0
85,105,100,79,83,78,530,0.5869565217391305,90,95,95,70,90,70,510,0.5230769230769231,0.5
51,65,65,80,75,59,395,0.4365079365079365,40,29,45,29,45,36,224,0.14634146341463414,1.0
125,58,58,76,76,67,460,0.515625,84,71,43,71,43,48,360,0.25874125874125875,1.0
71,120,95,120,95,99,600,0.8203125,38,30,85,55,65,30,303,0.21428571428571427,0.5
60,50,150,50,150,60,520,0.5206611570247934,108,170,115,120,95,92,700,0.7083333333333334,1.0
78,104,78,159,115,100,634,0.8444444444444444,50,65,107,105,107,86,520,0.7758620689655172,0.25
55,70,45,70,50,60,350,0.45,60,60,60,60,60,60,360,0.38095238095238093,1.0
65,55,115,100,40,60,435,0.3798449612403101,85,80,70,135,75,90,535,0.7006802721088435,1.0
100,75,115,90,115,85,580,0.6446280991735537,75,75,55,105,85,30,425,0.1619718309859155,0.5
80,130,100,160,120,110,700,0.8981481481481481,108,130,95,80,85,102,600,0.7637795275590551,4.0
60,105,60,120,60,105,510,0.8849557522123894,75,125,230,55,95,30,610,0.3448275862068966,1.0
76,147,90,60,70,97,540,0.8267716535433071,86,92,88,68,75,73,482,0.6835443037974683,1.0
80,160,60,170,130,80,680,0.6180555555555556,55,75,50,40,40,80,340,0.6302521008403361,1.0
65,47,55,73,75,85,400,0.65,20,40,90,30,90,25,295,0.11363636363636363,0.5
110,65,105,55,95,80,510,0.6258503401360545,35,55,40,45,40,60,275,0.35714285714285715,0.5
50,60,45,100,80,65,400,0.45689655172413796,100,100,100,100,100,100,600,0.8805970149253731,2.0
80,130,100,160,120,110,700,0.8981481481481481,60,85,69,60,69,77,420,0.518796992481203,1.0
125,58,58,76,76,67,460,0.515625,165,75,80,40,45,65,470,0.5151515151515151,1.0
20,10,230,10,230,5,505,0.0,45,49,65,49,65,45,318,0.275,2.0
50,60,45,100,80,65,400,0.45689655172413796,45,100,45,45,45,10,290,0.2949640287769784,1.0
80,95,82,60,82,75,474,0.6,55,40,50,65,85,40,335,0.3181818181818182,0.5
82,121,119,69,59,71,521,0.5394736842105263,79,105,70,145,80,101,580,0.8608695652173913,2.0
40,70,40,35,40,60,285,0.392,68,65,65,125,115,80,518,0.6461538461538462,0.25
20,10,230,10,230,5,505,0.0,65,73,55,47,75,85,400,0.6846846846846847,2.0
43,70,48,50,60,38,309,0.2391304347826087,91,90,72,90,129,108,580,0.896,0.5
79,85,60,55,60,71,410,0.60431654676259,74,48,76,83,81,104,466,0.7913043478260869,1.0
46,57,40,40,40,50,273,0.25,78,52,60,63,65,23,341,0.06015037593984962,2.0
40,45,65,100,120,90,460,0.5588235294117647,95,135,80,110,80,100,600,0.8248175182481752,2.0
58,70,45,40,45,42,300,0.25925925925925924,70,70,70,70,70,70,420,0.5289256198347108,1.0
45,40,60,40,75,50,310,0.2926829268292683,65,76,84,54,96,105,480,0.9008264462809917,1.0
90,120,120,60,60,50,500,0.35294117647058826,80,75,150,75,150,50,580,0.30973451327433627,2.0
70,105,105,50,40,20,390,0.33587786259541985,55,75,50,40,40,80,340,0.6302521008403361,2.0
45,53,70,40,60,42,310,0.25735294117647056,52,65,50,45,50,38,300,0.27419354838709675,1.0
40,70,130,60,130,25,455,0.17355371900826447,55,65,35,60,30,85,330,0.6126126126126126,1.0
60,60,60,35,35,30,280,0.11194029850746269,10,55,25,35,45,95,265,0.5396825396825397,1.0
65,136,94,54,96,135,580,0.9612403100775194,60,60,60,60,60,60,360,0.38095238095238093,2.0
65,70,60,65,65,115,440,0.8583333333333333,80,85,95,30,30,25,345,0.2857142857142857,0.5
75,90,90,140,90,115,600,0.9481481481481482,78,84,78,109,85,100,534,0.8620689655172413,0.5
43,80,65,50,35,35,308,0.14193548387096774,80,70,65,80,120,100,515,0.8034188034188035,0.5
50,70,50,50,50,40,310,0.16296296296296298,44,50,91,24,86,10,305,0.1981981981981982,0.5
75,85,200,55,65,30,510,0.16778523489932887,70,110,70,115,70,90,525,0.75,1.0
105,130,120,45,45,40,485,0.4444444444444444,80,70,70,90,100,70,480,0.5609756097560976,0.5
30,65,100,45,25,40,305,0.1891891891891892,50,65,107,105,107,86,520,0.7313432835820896,0.5
95,117,184,44,46,28,514,0.2975206611570248,50,40,85,40,65,25,305,0.08870967741935484,1.0
100,75,115,90,115,85,580,0.6446280991735537,38,30,85,55,65,30,303,0.21428571428571427,1.0
45,95,50,40,50,75,355,0.54,65,90,50,85,45,55,390,0.371900826446281,1.0
45,30,50,65,50,45,285,0.13821138211382114,80,120,80,120,80,100,580,0.8478260869565217,1.0
70,83,50,37,50,60,350,0.3360655737704918,95,110,95,40,95,55,490,0.40336134453781514,1.0
65,47,55,73,75,85,400,0.65,74,48,76,83,81,104,466,0.7322834645669292,2.0
75,105,75,105,75,45,480,0.3274336283185841,255,10,10,75,135,55,540,0.3125,1.0
105,180,100,180,100,115,780,0.9477611940298507,50,25,28,45,55,15,218,0.0625,0.0
61,84,65,70,70,70,420,0.5,45,65,34,40,34,45,263,0.2589928057553957,1.0
45,30,40,105,50,20,290,0.031007751937984496,165,75,80,40,45,65,470,0.5151515151515151,1.0
106,190,100,154,100,130,780,0.9259259259259259,65,95,75,55,55,85,430,0.6933333333333334,1.0
75,140,65,112,65,110,567,0.9140625,62,44,50,44,50,55,305,0.3629032258064516,2.0
45,50,55,75,65,30,320,0.06293706293706294,75,65,55,65,55,69,384,0.43548387096774194,2.0
50,64,50,45,50,41,300,0.22727272727272727,20,15,20,10,55,80,200,0.2682926829268293,1.0
50,70,160,70,160,90,600,0.7417218543046358,85,135,130,60,80,25,515,0.40540540540540543,1.0
49,66,70,44,55,51,335,0.4260869565217391,82,80,86,85,75,72,480,0.6183206106870229,1.0
65,110,130,60,65,95,525,0.8278145695364238,100,123,75,57,75,80,510,0.6923076923076923,0.5
55,50,40,40,40,75,300,0.5945945945945946,45,85,50,55,50,65,350,0.5076923076923077,1.0
75,95,60,65,60,115,470,0.8778625954198473,55,55,85,65,85,35,380,0.2014388489208633,0.5
70,92,65,80,55,98,460,0.8090909090909091,85,105,85,40,50,40,405,0.211864406779661,1.0
100,123,75,57,75,80,510,0.6923076923076923,20,40,90,30,90,25,295,0.11363636363636363,0.0
70,83,50,37,50,60,350,0.3360655737704918,85,80,90,105,95,60,515,0.49074074074074076,1.0
50,45,45,35,35,50,260,0.23529411764705882,60,80,110,50,80,45,425,0.2833333333333333,1.0
80,125,75,40,95,85,500,0.6911764705882353,59,63,80,65,80,58,405,0.41843971631205673,1.0
90,60,60,40,40,40,330,0.29545454545454547,45,35,50,70,50,30,280,0.15753424657534246,0.5
95,155,109,70,130,81,640,0.6788321167883211,85,73,70,73,115,67,483,0.5126050420168067,2.0
90,93,55,70,55,55,418,0.3819444444444444,65,85,70,75,70,40,405,0.203125,1.0
70,90,90,135,90,125,600,0.9401709401709402,80,120,80,120,80,100,580,0.8478260869565217,1.0
55,50,45,135,95,120,500,0.7714285714285715,82,121,119,69,59,71,521,0.5394736842105263,1.0
55,75,85,25,25,15,280,0.1875,190,33,58,33,58,33,405,0.13432835820895522,1.0
40,45,40,35,35,56,251,0.373015873015873,40,45,35,30,40,55,245,0.3793103448275862,1.0
150,80,44,90,54,80,498,0.625,90,100,60,90,60,80,480,0.6422764227642277,1.0
70,95,85,55,65,70,440,0.5,50,85,85,55,55,50,380,0.3902439024390244,0.25
70,120,40,95,40,95,460,0.8106060606060606,55,50,45,135,95,120,500,0.7714285714285715,2.0
74,100,72,90,72,46,454,0.24561403508771928,45,95,50,40,50,75,355,0.54,1.0
60,55,90,145,90,80,520,0.6071428571428571,80,90,80,130,110,110,600,0.856,1.0
60,80,110,50,80,45,425,0.2833333333333333,85,120,70,50,60,100,485,0.8308823529411765,0.0
90,92,75,92,85,60,494,0.49586776859504134,50,64,50,45,50,41,300,0.22727272727272727,8.0
65,150,40,15,80,145,495,0.9663865546218487,80,100,70,50,60,45,405,0.25806451612903225,0.5
80,120,70,110,70,80,530,0.6422764227642277,37,25,41,25,41,25,194,0.08870967741935484,1.0
45,30,50,65,50,45,285,0.13821138211382114,30,45,135,45,90,30,375,0.09285714285714286,1.0
60,79,105,59,85,36,424,0.17054263565891473,125,120,90,170,100,95,700,0.78125,1.0
45,60,32,50,32,76,295,0.5925925925925926,55,40,50,65,85,40,335,0.3181818181818182,2.0
45,22,60,27,30,29,213,0.07518796992481203,80,70,70,90,100,70,480,0.5609756097560976,2.0
75,95,125,45,75,95,510,0.8257575757575758,95,85,85,65,65,35,430,0.2571428571428571,1.0
20,10,230,10,230,5,505,0.0,30,45,59,30,39,57,260,0.2803030303030303,1.0
100,100,100,100,100,100,600,0.831858407079646,90,93,55,70,55,55,418,0.3819444444444444,1.0
85,110,76,65,82,56,474,0.3933333333333333,70,50,30,95,135,105,485,0.8040540540540541,1.0
70,75,80,135,80,135,575,0.917910447761194,101,72,72,99,89,29,462,0.1937984496124031,1.0
78,84,78,109,85,100,534,0.8646616541353384,105,30,105,140,105,55,540,0.3524590163934426,0.5
90,85,75,115,100,115,580,0.9381443298969072,79,100,80,110,90,121,580,0.968,2.0
108,170,115,120,95,92,700,0.7083333333333334,85,105,100,79,83,78,530,0.5869565217391305,1.0
63,63,47,41,41,74,329,0.56,90,60,70,75,70,45,410,0.23880597014925373,1.0
78,65,68,112,154,75,552,0.628099173553719,60,62,63,80,80,60,405,0.38016528925619836,0.5
100,180,160,150,90,90,770,0.7520661157024794,63,63,47,41,41,74,329,0.56,2.0
100,123,75,57,75,80,510,0.6923076923076923,75,90,90,140,90,115,600,0.9481481481481482,1.0
80,105,65,60,75,130,515,0.9645390070921985,70,50,30,95,135,105,485,0.8040540540540541,2.0
95,110,95,40,95,55,490,0.40336134453781514,75,69,72,114,100,104,534,0.8253968253968254,1.0
30,40,70,70,25,60,295,0.41353383458646614,65,130,60,95,110,65,525,0.5303030303030303,2.0
60,60,75,60,75,80,410,0.7321428571428571,38,35,40,27,25,35,200,0.08208955223880597,0.5
72,58,80,103,80,97,490,0.7171052631578947,35,64,85,74,55,32,345,0.19827586206896552,1.0
126,131,95,131,98,99,680,0.8102189781021898,95,117,184,44,46,28,514,0.2975206611570248,1.0
65,73,55,47,75,85,400,0.6846846846846847,83,80,75,70,70,101,479,0.8615384615384616,0.5
74,94,131,54,116,20,489,0.4485294117647059,110,80,90,95,90,65,530,0.5033557046979866,2.0
78,84,78,109,85,100,534,0.8646616541353384,105,140,55,30,55,95,480,0.8195488721804511,0.5
109,66,84,81,99,32,471,0.2013888888888889,67,57,55,77,55,114,425,0.8879310344827587,0.0
135,85,40,40,85,5,390,0.6864406779661016,45,50,55,75,65,30,320,0.06293706293706294,1.0
65,45,55,45,70,45,325,0.24369747899159663,70,75,60,105,60,105,475,0.88,1.0
75,80,95,90,100,50,490,0.2158273381294964,65,95,57,100,85,93,495,0.7441860465116279,0.5
44,38,33,61,43,70,289,0.5267857142857143,75,75,95,75,95,113,528,0.9015151515151515,0.5
65,45,55,45,70,45,325,0.24369747899159663,68,90,65,50,55,82,410,0.6165413533834586,1.0
65,130,60,75,60,75,465,0.689922480620155,80,100,200,50,100,50,580,0.3472222222222222,1.0
67,82,62,46,48,43,348,0.22033898305084745,65,40,70,80,140,70,465,0.5954198473282443,0.5
38,35,35,65,55,50,278,0.2647058823529412,40,50,45,70,45,70,320,0.5517241379310345,0.5
70,80,70,80,70,110,480,0.6594202898550725,45,63,37,65,55,95,360,0.8055555555555556,1.0
90,90,85,125,90,100,580,0.768595041322314,80,105,105,105,105,80,580,0.5939849624060151,1.0
105,140,95,55,65,45,505,0.3,75,75,55,105,85,30,425,0.1619718309859155,1.0
90,100,70,110,150,80,600,0.6037735849056604,80,135,85,70,95,150,615,0.9844961240310077,1.0
80,100,70,50,60,45,405,0.25806451612903225,45,60,40,70,50,45,310,0.2846715328467153,1.0
80,115,80,65,55,93,488,0.7846153846153846,60,150,50,150,50,60,520,0.5,0.0
45,25,50,25,25,35,205,0.13076923076923078,54,63,52,83,56,97,405,0.7697841726618705,1.0
60,80,50,50,50,40,330,0.23853211009174313,83,80,80,135,80,121,579,0.9444444444444444,1.0
65,47,55,73,75,85,400,0.65,78,84,78,109,85,100,534,0.8620689655172413,0.5
75,98,63,98,63,101,498,0.8091603053435115,80,105,65,60,75,130,515,0.9645390070921985,1.0
70,120,65,45,85,125,510,0.9747899159663865,76,48,48,57,62,34,325,0.11688311688311688,0.5
70,60,75,110,75,90,480,0.7165354330708661,74,48,76,83,81,104,466,0.7322834645669292,1.0
65,155,120,65,90,105,600,0.8677685950413223,95,23,48,23,48,23,260,0.046153846153846156,2.0
85,60,65,135,105,100,550,0.7518248175182481,65,95,75,55,55,85,430,0.6933333333333334,0.25
45,60,32,50,32,76,295,0.5925925925925926,100,100,100,100,100,100,600,0.8345864661654135,0.5
75,90,90,140,90,115,600,0.9481481481481482,70,77,60,97,60,108,472,0.8394160583941606,2.0
20,10,230,10,230,5,505,0.0,30,45,59,30,39,57,260,0.2803030303030303,1.0
50,72,35,35,35,65,292,0.5373134328358209,43,30,55,40,65,97,330,0.6030534351145038,1.0
71,73,88,120,89,59,500,0.43537414965986393,78,130,111,130,85,100,634,0.8561151079136691,1.0
73,100,60,100,60,65,458,0.42657342657342656,109,66,84,81,99,32,471,0.2013888888888889,0.5
70,45,48,60,65,35,323,0.15748031496062992,50,105,125,55,95,50,480,0.375886524822695,0.5
75,95,125,45,75,95,510,0.8257575757575758,72,85,70,65,70,58,420,0.41304347826086957,1.0
58,64,58,80,65,80,405,0.609271523178808,85,115,80,105,80,50,515,0.3063063063063063,1.0
50,85,125,85,115,20,480,0.4306569343065693,65,60,70,85,75,40,395,0.1796875,0.0
60,50,100,85,70,65,430,0.47580645161290325,80,160,60,170,130,80,680,0.6180555555555556,1.0
60,82,45,45,45,74,351,0.5752212389380531,91,72,90,129,90,108,580,0.8620689655172413,0.5
60,105,60,120,60,105,510,0.8849557522123894,85,110,76,65,82,56,474,0.3933333333333333,2.0
80,120,79,95,79,70,523,0.5833333333333334,67,125,40,30,30,58,350,0.3431372549019608,1.0
30,105,90,25,25,50,325,0.2773722627737226,95,65,110,60,130,65,525,0.5275590551181102,1.0
150,160,100,95,65,100,670,0.8866666666666667,100,75,115,90,115,85,580,0.6446280991735537,1.0
50,50,77,95,77,91,440,0.5916666666666667,60,100,115,70,85,90,520,0.7557251908396947,1.0
75,98,63,98,63,101,498,0.8091603053435115,60,45,70,45,90,95,405,0.7304964539007093,1.0
70,90,70,60,60,70,420,0.6390977443609023,81,102,77,85,75,85,505,0.5642857142857143,1.0
79,85,60,55,60,71,410,0.60431654676259,110,123,65,100,65,65,528,0.5217391304347826,2.0
40,29,45,29,45,36,224,0.14634146341463414,45,45,55,45,55,63,308,0.4594594594594595,2.0
61,72,57,55,55,65,365,0.3984375,105,140,95,55,65,45,505,0.3,1.0
110,130,80,70,60,80,530,0.5862068965517241,50,50,62,40,62,65,329,0.4188034188034188,2.0
30,56,35,25,35,72,253,0.48148148148148145,72,58,80,103,80,97,490,0.7171052631578947,1.0
55,40,40,65,45,35,280,0.16428571428571428,85,135,130,60,80,25,515,0.40540540540540543,1.0
75,75,75,125,95,40,485,0.15671641791044777,76,25,45,67,55,24,292,0.0390625,0.5
40,55,30,30,30,60,245,0.43548387096774194,46,57,40,40,40,50,273,0.25,1.0
65,65,65,50,50,90,385,0.72,65,90,120,85,70,60,490,0.43410852713178294,1.0
35,60,44,40,54,55,288,0.366412213740458,50,50,95,40,50,35,320,0.20279720279720279,0.5
65,76,84,54,96,105,480,0.9008264462809917,50,65,90,35,35,15,290,0.14678899082568808,1.0
64,66,68,81,76,50,405,0.25190839694656486,70,77,60,97,60,108,472,0.8394160583941606,1.0
60,85,40,30,45,68,328,0.6422018348623854,55,50,45,135,95,120,500,0.7714285714285715,1.0
45,85,50,55,50,65,350,0.5076923076923077,130,85,80,85,95,60,535,0.43884892086330934,2.0
97,165,60,65,50,58,495,0.3902439024390244,31,45,90,30,30,40,266,0.21929824561403508,1.0
40,45,65,100,120,90,460,0.5588235294117647,65,60,110,130,95,65,525,0.47761194029850745,1.0
35,45,160,30,45,70,385,0.48148148148148145,55,35,50,55,110,85,390,0.6277372262773723,0.0
120,100,85,30,85,45,465,0.22448979591836735,170,90,45,90,45,60,500,0.427536231884058,1.0
70,90,110,60,75,95,500,0.7333333333333333,30,30,42,30,42,70,244,0.4230769230769231,1.0
61,78,95,56,58,57,405,0.40336134453781514,65,40,70,80,140,70,465,0.5954198473282443,1.0
75,75,130,75,130,95,580,0.7479674796747967,66,117,70,40,50,67,410,0.4573643410852713,1.0
70,110,70,115,70,90,525,0.75,103,60,86,60,86,50,445,0.3458646616541353,2.0
45,85,50,55,50,65,350,0.5076923076923077,80,70,65,80,120,100,515,0.8034188034188035,0.5
91,90,106,130,106,77,600,0.648854961832061,55,35,50,55,110,85,390,0.6277372262773723,2.0
67,82,62,46,48,43,348,0.22033898305084745,95,65,110,60,130,65,525,0.5275590551181102,2.0
50,105,79,35,110,76,455,0.6214285714285714,60,45,70,75,85,55,390,0.3008130081300813,0.5
49,66,70,44,55,51,335,0.4260869565217391,60,40,60,40,60,35,295,0.18055555555555555,0.5
65,125,60,95,60,105,510,0.9236641221374046,60,45,70,75,85,55,390,0.3008130081300813,0.5
60,55,50,40,55,45,305,0.22377622377622378,49,49,56,49,61,66,330,0.5190839694656488,1.0
80,120,70,110,70,80,530,0.6422764227642277,55,20,35,20,45,75,250,0.37681159420289856,2.0
70,150,140,65,100,75,600,0.55,65,90,122,58,75,84,494,0.71875,1.0
40,50,45,70,45,70,320,0.5517241379310345,60,100,85,80,85,100,510,0.7007874015748031,1.0
59,66,70,44,55,41,335,0.25190839694656486,85,76,64,45,55,90,415,0.6739130434782609,0.0
80,100,123,122,120,80,625,0.56,49,66,70,44,55,51,335,0.4260869565217391,0.5
72,85,70,65,70,58,420,0.41304347826086957,70,62,67,55,55,56,365,0.38513513513513514,1.0
80,100,123,122,120,80,625,0.56,70,95,125,65,75,45,475,0.33613445378151263,0.5
75,75,130,75,130,95,580,0.7479674796747967,75,75,95,75,95,113,528,0.9015151515151515,1.0
89,124,80,55,80,55,483,0.5714285714285714,50,50,120,80,80,30,410,0.07258064516129033,4.0
75,80,85,110,90,50,490,0.3548387096774194,89,125,90,115,80,101,600,0.8725490196078431,0.5
50,70,100,40,40,30,330,0.2222222222222222,109,66,84,81,99,32,471,0.2013888888888889,0.25
50,65,107,105,107,86,520,0.7758620689655172,67,125,40,30,30,58,350,0.3431372549019608,2.0
60,79,105,59,85,36,424,0.17054263565891473,50,55,50,36,30,43,264,0.2922077922077922,0.0
103,60,126,80,126,50,545,0.36363636363636365,62,48,54,63,60,68,355,0.5178571428571429,1.0
70,83,50,37,50,60,350,0.3360655737704918,45,45,55,45,55,63,308,0.4594594594594595,2.0
40,40,40,70,40,20,250,0.032520325203252036,35,45,160,30,45,70,385,0.48148148148148145,0.5
60,48,45,43,90,42,328,0.21897810218978103,60,80,50,40,40,30,300,0.15328467153284672,1.0
70,94,50,94,50,66,424,0.48148148148148145,50,65,107,105,107,86,520,0.7313432835820896,2.0
64,66,68,81,76,50,405,0.25190839694656486,75,80,95,90,100,50,490,0.2158273381294964,0.5
90,85,75,115,100,115,580,0.9381443298969072,43,80,65,50,35,35,308,0.14193548387096774,2.0
40,45,40,35,35,56,251,0.373015873015873,55,35,50,55,110,85,390,0.6277372262773723,2.0
120,70,120,75,130,85,600,0.6694915254237288,74,108,133,83,65,32,495,0.32142857142857145,1.0
65,76,84,54,96,105,480,0.9008264462809917,66,117,70,40,50,67,410,0.4573643410852713,1.0
111,83,68,92,82,39,475,0.1774193548387097,64,78,52,78,52,81,405,0.6422764227642277,4.0
40,55,80,35,60,30,300,0.15037593984962405,101,72,72,99,89,29,462,0.1937984496124031,0.5
30,45,135,45,90,30,375,0.09285714285714286,49,66,70,44,55,51,335,0.4260869565217391,1.0
40,29,45,29,45,36,224,0.14634146341463414,60,85,60,50,50,125,430,0.9090909090909091,0.5
59,66,70,44,55,41,335,0.25190839694656486,90,30,15,40,20,15,210,0.043478260869565216,0.0
59,66,70,44,55,41,335,0.25190839694656486,100,100,100,100,100,100,600,0.831858407079646,2.0
55,95,115,45,45,35,390,0.2116788321167883,40,50,45,70,45,70,320,0.5517241379310345,0.0
35,70,55,45,55,25,285,0.09420289855072464,62,48,66,59,57,49,341,0.33884297520661155,0.5
60,50,150,50,150,60,520,0.5206611570247934,52,65,50,45,50,38,300,0.27419354838709675,0.5
67,57,55,77,55,114,425,0.8879310344827587,55,104,105,94,75,52,485,0.36363636363636365,1.0
55,70,55,40,55,85,360,0.7073170731707317,100,150,140,100,90,90,670,0.7969924812030075,1.0
75,65,55,65,55,69,384,0.43548387096774194,60,45,70,75,85,55,390,0.3008130081300813,1.0
85,60,65,135,105,100,550,0.7518248175182481,100,150,120,120,100,90,680,0.6493506493506493,0.5
100,100,100,100,100,100,600,0.8758169934640523,68,65,65,125,115,80,518,0.6461538461538462,0.25
60,90,140,50,50,40,430,0.2535211267605634,95,110,80,70,80,50,485,0.37209302325581395,4.0
35,40,100,90,55,35,355,0.1796875,60,52,168,47,138,30,495,0.19834710743801653,1.0
60,55,50,40,55,45,305,0.22377622377622378,55,68,64,45,55,31,318,0.11666666666666667,4.0
65,70,60,65,65,115,440,0.8583333333333333,40,65,95,60,45,35,340,0.13986013986013987,1.0
80,145,150,105,110,110,700,0.8692307692307693,91,72,90,129,90,108,580,0.8620689655172413,0.5
60,85,42,85,42,91,405,0.8227848101265823,65,90,65,61,61,100,442,0.8373983739837398,1.0
105,95,80,40,80,90,490,0.753968253968254,55,50,65,175,95,150,590,0.7818181818181819,1.0
100,180,160,150,90,90,770,0.7520661157024794,65,45,55,45,70,45,325,0.24369747899159663,0.5
59,110,150,45,49,35,448,0.3333333333333333,126,131,95,131,98,99,680,0.8294573643410853,0.5
101,72,72,99,89,29,462,0.1937984496124031,79,115,70,125,80,111,580,0.8468468468468469,1.0
116,55,85,107,95,29,487,0.06818181818181818,115,115,85,90,75,100,580,0.8134328358208955,1.0
64,115,65,83,63,65,455,0.5323741007194245,60,60,50,40,50,75,335,0.5882352941176471,0.0
45,53,70,40,60,42,310,0.25735294117647056,165,75,80,40,45,65,470,0.5151515151515151,2.0
60,70,65,125,105,90,515,0.6911764705882353,115,45,20,45,25,20,270,0.11538461538461539,2.0
50,35,55,25,25,15,205,0.021739130434782608,90,60,60,40,40,40,330,0.29545454545454547,1.0
75,75,55,105,85,30,425,0.1619718309859155,100,110,90,85,90,60,535,0.47794117647058826,4.0
91,90,129,90,72,108,580,0.9140625,100,90,130,45,65,55,485,0.4253731343283582,2.0
60,65,80,170,95,130,600,0.8625954198473282,76,65,45,92,42,91,411,0.7449664429530202,0.0
43,70,48,50,60,38,309,0.2391304347826087,165,75,80,40,45,65,470,0.5151515151515151,2.0
65,150,40,15,80,145,495,0.9663865546218487,70,135,105,60,105,20,495,0.5806451612903226,0.0
97,165,60,65,50,58,495,0.3902439024390244,50,50,62,40,62,65,329,0.4188034188034188,1.0
60,40,80,60,45,40,325,0.23529411764705882,50,25,28,45,55,15,218,0.0625,1.0
50,40,85,40,65,25,305,0.08870967741935484,50,25,28,45,55,15,218,0.0625,0.5
40,40,55,40,70,55,300,0.40939597315436244,111,83,68,92,82,39,475,0.1774193548387097,2.0
77,120,90,60,90,48,485,0.2785714285714286,50,48,43,46,41,60,288,0.47297297297297297,1.0
90,130,80,65,85,55,505,0.4396551724137931,80,105,65,60,75,130,515,0.9645390070921985,1.0
43,80,65,50,35,35,308,0.14193548387096774,50,75,70,35,70,48,348,0.29357798165137616,1.0
65,76,84,54,96,105,480,0.9008264462809917,37,25,41,25,41,25,194,0.08870967741935484,1.0
35,64,85,74,55,32,345,0.19827586206896552,90,55,75,60,75,30,385,0.13970588235294118,1.0
50,30,55,65,55,20,275,0.13675213675213677,75,80,55,25,35,35,305,0.18666666666666668,1.0
45,49,65,49,65,45,318,0.275,106,90,130,90,154,110,680,0.8699186991869918,0.5
62,48,66,59,57,49,341,0.33884297520661155,50,75,45,40,45,60,315,0.4380165289256198,1.0
79,103,120,135,115,78,630,0.5763888888888888,50,70,160,70,160,90,600,0.7417218543046358,1.0
55,95,55,35,75,115,430,0.9380530973451328,65,90,122,58,75,84,494,0.71875,4.0
90,110,80,100,80,95,555,0.7982456140350878,83,80,75,70,70,101,479,0.8615384615384616,1.0
30,105,90,25,25,50,325,0.2773722627737226,100,50,50,76,96,70,442,0.5,1.0
40,45,35,65,55,70,310,0.4482758620689655,55,47,52,40,40,41,275,0.16806722689075632,0.5
79,115,70,125,80,111,580,0.864,67,57,55,77,55,114,425,0.8879310344827587,2.0
35,35,40,35,55,50,250,0.40336134453781514,73,95,62,85,65,85,465,0.6666666666666666,1.0
150,100,120,100,120,90,680,0.6666666666666666,95,100,85,108,70,70,528,0.5652173913043478,1.0
65,50,70,95,80,65,425,0.4262295081967213,75,95,125,45,75,95,510,0.8257575757575758,2.0
100,180,160,150,90,90,770,0.7520661157024794,55,95,115,45,45,35,390,0.2116788321167883,1.0
95,100,85,108,70,70,528,0.5652173913043478,85,110,76,65,82,56,474,0.3933333333333333,0.5
80,185,115,40,105,75,600,0.6230769230769231,108,170,115,120,95,92,700,0.7083333333333334,1.0
65,76,84,54,96,105,480,0.9008264462809917,49,49,56,49,61,66,330,0.5190839694656488,1.0
106,110,90,154,90,130,680,0.926829268292683,83,80,80,135,80,121,579,0.9444444444444444,1.0
115,115,85,90,75,100,580,0.8134328358208955,78,84,78,109,85,100,534,0.8620689655172413,0.5
72,105,115,54,86,68,500,0.5149253731343284,75,85,200,55,65,30,510,0.16778523489932887,0.5
100,150,140,100,90,90,670,0.7969924812030075,45,50,55,75,65,30,320,0.06293706293706294,1.0
106,130,90,110,154,90,680,0.719626168224299,70,62,67,55,55,56,365,0.38513513513513514,1.0
61,72,57,55,55,65,365,0.3984375,60,50,100,85,70,65,430,0.47580645161290325,1.0
67,89,116,79,116,33,500,0.2624113475177305,65,80,140,40,70,70,465,0.5223880597014925,0.25
100,90,130,45,65,55,485,0.4253731343283582,70,105,105,50,40,20,390,0.33587786259541985,2.0
60,62,50,62,60,40,334,0.18181818181818182,65,95,75,55,55,85,430,0.6933333333333334,0.5
70,94,50,94,50,66,424,0.48148148148148145,85,100,122,58,75,54,494,0.3939393939393939,2.0
70,55,95,95,110,65,490,0.48872180451127817,65,155,120,65,90,105,600,0.8677685950413223,1.0
73,115,60,60,60,90,458,0.6694915254237288,68,85,65,165,135,100,618,0.8083333333333333,1.0
38,35,35,65,55,50,278,0.2647058823529412,58,70,45,40,45,42,300,0.25925925925925924,4.0
40,40,40,70,40,20,250,0.032520325203252036,80,90,80,130,110,110,600,0.856,0.5
100,100,100,100,100,100,600,0.8602941176470589,70,65,60,90,75,90,450,0.6571428571428571,0.25
63,63,47,41,41,74,329,0.56,100,70,70,65,65,45,415,0.1897810218978102,1.0
55,75,50,40,40,80,340,0.6302521008403361,80,80,80,80,80,80,480,0.6015037593984962,1.0
70,55,55,80,60,45,365,0.2222222222222222,68,85,65,165,135,100,618,0.8083333333333333,1.0
190,33,58,33,58,33,405,0.13432835820895522,78,65,68,112,154,75,552,0.628099173553719,1.0
50,50,40,30,30,50,250,0.2781954887218045,60,85,42,85,42,91,405,0.8227848101265823,0.0
75,125,100,70,80,45,495,0.33035714285714285,100,73,83,73,83,55,467,0.371900826446281,0.5
67,89,116,79,116,33,500,0.2624113475177305,71,82,64,64,59,112,452,0.9327731092436975,1.0
45,63,37,65,55,95,360,0.8055555555555556,55,45,45,25,25,15,210,0.048,0.0
114,85,70,85,80,30,464,0.2066115702479339,30,56,35,25,35,72,253,0.48148148148148145,1.0
35,45,160,30,45,70,385,0.48148148148148145,60,52,168,47,138,30,495,0.19834710743801653,2.0
80,135,85,70,95,150,615,0.9844961240310077,50,72,35,35,35,65,292,0.5373134328358209,0.5
70,62,67,55,55,56,365,0.38513513513513514,61,90,45,50,50,160,456,0.9230769230769231,1.0
75,125,100,70,80,45,495,0.33035714285714285,91,90,129,90,72,108,580,0.9140625,0.0625
80,125,75,40,95,85,500,0.6911764705882353,111,83,68,92,82,39,475,0.1774193548387097,1.0
40,45,40,35,35,56,251,0.373015873015873,48,61,40,61,40,50,300,0.2543859649122807,2.0
90,70,80,70,95,70,475,0.5190839694656488,85,105,55,85,50,115,495,0.9032258064516129,0.25
75,75,75,125,95,40,485,0.15671641791044777,95,155,109,70,130,81,640,0.6788321167883211,0.0
60,40,60,95,60,55,370,0.4222222222222222,40,80,35,35,45,70,305,0.4661016949152542,1.0
50,50,95,40,50,35,320,0.20279720279720279,90,93,55,70,55,55,418,0.3819444444444444,2.0
78,104,78,159,115,100,634,0.8444444444444444,55,55,55,85,55,30,335,0.1320754716981132,1.0
125,120,90,170,100,95,700,0.78125,60,60,50,40,50,75,335,0.5882352941176471,2.0
95,75,180,130,80,30,590,0.13793103448275862,110,130,80,70,60,80,530,0.5862068965517241,4.0
50,95,90,95,90,180,600,0.9172413793103448,30,30,30,30,30,30,180,0.12612612612612611,1.0
45,50,43,40,38,62,278,0.40441176470588236,103,93,67,71,61,84,479,0.7142857142857143,1.0
95,75,110,100,80,30,490,0.15267175572519084,70,80,70,80,70,110,480,0.6594202898550725,1.0
126,131,95,131,98,99,680,0.8294573643410853,50,48,43,46,41,60,288,0.47297297297297297,1.0
108,100,121,81,95,95,600,0.7476635514018691,60,90,140,50,50,40,430,0.2535211267605634,2.0
50,20,55,25,25,30,205,0.09774436090225563,75,80,95,90,100,50,490,0.2158273381294964,2.0
55,50,65,175,95,150,590,0.7818181818181819,55,70,40,60,40,40,305,0.26956521739130435,1.0
75,87,63,87,63,98,473,0.865546218487395,78,81,71,74,69,126,499,0.9090909090909091,2.0
81,102,77,85,75,85,505,0.5642857142857143,65,125,60,95,60,105,510,0.9236641221374046,1.0
78,84,78,109,85,100,534,0.8620689655172413,95,75,180,130,80,30,590,0.13793103448275862,0.5
90,95,95,70,90,70,510,0.5230769230769231,70,45,48,60,65,35,323,0.15748031496062992,0.5
80,125,75,40,95,85,500,0.6911764705882353,70,140,70,110,65,105,560,0.95,4.0
59,74,50,35,50,35,303,0.3125,35,64,85,74,55,32,345,0.19827586206896552,1.0
38,41,40,50,65,65,299,0.4108527131782946,50,65,85,35,35,55,325,0.32575757575757575,1.0
55,70,45,70,50,60,350,0.45,100,77,77,128,128,90,600,0.6901408450704225,1.0
70,75,60,105,60,105,475,0.88,80,80,80,80,80,80,480,0.6015037593984962,1.0
160,110,65,65,110,30,540,0.35714285714285715,95,23,48,23,48,23,260,0.046153846153846156,1.0
70,55,75,45,65,60,370,0.45901639344262296,100,70,70,65,65,45,415,0.1897810218978102,1.0
35,45,160,30,45,70,385,0.48148148148148145,75,38,38,56,56,67,330,0.5263157894736842,2.0
78,92,75,74,63,118,500,0.8842975206611571,75,85,200,55,65,30,510,0.16778523489932887,1.0
95,135,80,110,80,100,600,0.8248175182481752,55,75,60,75,60,103,428,0.7982456140350878,0.5
110,85,95,80,95,50,515,0.2713178294573643,74,48,76,83,81,104,466,0.7322834645669292,1.0
49,49,56,49,61,66,330,0.5190839694656488,50,35,55,25,25,15,205,0.021739130434782608,1.0
50,52,48,65,50,55,320,0.33098591549295775,55,75,85,25,25,15,280,0.1875,2.0
65,65,60,110,95,130,525,0.9253731343283582,126,131,95,131,98,99,680,0.8294573643410853,1.0
80,85,95,30,30,25,345,0.2857142857142857,80,82,100,83,100,80,525,0.6821705426356589,0.5
100,90,130,45,65,55,485,0.4253731343283582,60,50,70,80,80,140,480,0.8449612403100775,1.0
50,45,45,35,35,50,260,0.23529411764705882,82,121,119,69,59,71,521,0.5394736842105263,0.5
76,104,71,104,71,108,534,0.912751677852349,80,120,79,95,79,70,523,0.5833333333333334,1.0
55,75,85,25,25,15,280,0.1875,50,85,85,55,55,50,380,0.3902439024390244,0.5
35,80,50,50,70,120,405,0.84375,50,50,62,40,62,65,329,0.4188034188034188,2.0
53,51,53,61,56,40,314,0.14285714285714285,77,85,51,55,51,65,384,0.5163934426229508,1.0
103,60,86,60,86,50,445,0.3458646616541353,61,78,95,56,58,57,405,0.40336134453781514,1.0
65,80,65,35,65,60,370,0.38405797101449274,75,80,55,25,35,35,305,0.18666666666666668,1.0
95,95,85,125,65,55,520,0.3894736842105263,50,65,107,105,107,86,520,0.6991150442477876,0.5
65,105,60,60,70,95,455,63.0,61,72,57,55,55,65,365,0.3984375,0.5
35,70,55,45,55,25,285,0.09420289855072464,70,20,50,20,50,40,250,0.1557377049180328,1.0
75,85,200,55,65,30,510,0.16778523489932887,100,150,120,120,100,90,680,0.6493506493506493,1.0
66,117,70,40,50,67,410,0.4573643410852713,103,93,67,71,61,84,479,0.7142857142857143,1.0
80,80,50,40,50,25,325,0.176056338028169,80,95,82,60,82,75,474,0.6,0.5
60,45,50,90,80,70,395,0.625,100,134,110,95,100,61,600,0.4057971014492754,1.0
50,50,150,50,150,50,500,0.2571428571428571,65,90,120,85,70,60,490,0.43410852713178294,0.5
45,60,45,25,45,55,275,0.29,45,75,60,40,30,50,300,0.304,1.0
80,130,100,160,120,110,700,0.8981481481481481,90,120,120,60,60,50,500,0.35294117647058826,2.0
30,80,90,55,45,55,355,0.4295774647887324,42,52,67,39,56,50,306,0.2868217054263566,1.0
63,63,47,41,41,74,329,0.56,35,55,40,50,50,90,320,0.6838235294117647,1.0
75,95,67,125,95,83,540,0.7117117117117117,65,76,84,54,96,105,480,0.9008264462809917,1.0
40,20,30,40,80,55,265,0.22764227642276422,65,125,60,95,60,105,510,0.9236641221374046,1.0
80,92,65,65,80,68,450,0.4824561403508772,40,27,60,37,50,66,280,0.36220472440944884,0.5
99,68,83,72,87,51,460,0.417910447761194,89,124,80,55,80,55,483,0.5714285714285714,2.0
75,80,60,65,90,102,472,0.8625954198473282,55,95,55,35,75,115,430,0.9380530973451328,1.0
60,55,50,40,55,45,305,0.22377622377622378,66,117,70,40,50,67,410,0.4573643410852713,1.0
40,30,32,50,52,65,269,0.3671875,80,80,50,40,50,25,325,0.176056338028169,0.5
75,55,70,55,95,110,460,0.8444444444444444,190,33,58,33,58,33,405,0.13432835820895522,1.0
68,125,65,65,115,80,518,0.6277372262773723,75,80,60,65,90,102,472,0.8625954198473282,2.0
55,50,45,135,95,120,500,0.7714285714285715,79,105,70,145,80,101,580,0.8608695652173913,1.0
50,105,125,55,95,50,480,0.375886524822695,35,55,40,45,40,60,275,0.35714285714285715,0.5
45,60,40,70,50,45,310,0.2846715328467153,50,120,53,35,110,87,455,0.640625,1.0
60,55,145,75,150,40,525,0.2,20,40,15,35,35,60,205,0.34285714285714286,0.5
85,60,65,135,105,100,550,0.7518248175182481,50,70,160,70,160,90,600,0.7417218543046358,2.0
77,59,50,67,63,46,362,0.23140495867768596,60,62,50,62,60,40,334,0.18181818181818182,2.0
40,50,90,30,55,65,330,0.44680851063829785,71,73,88,120,89,59,500,0.43537414965986393,1.0
65,73,55,47,75,85,400,0.6846846846846847,45,65,34,40,34,45,263,0.2589928057553957,1.0
83,80,75,70,70,101,479,0.8615384615384616,50,60,45,100,80,65,400,0.45689655172413796,2.0
100,128,90,77,77,128,600,0.959349593495935,95,109,105,75,85,56,525,0.34513274336283184,1.0
95,75,110,100,80,30,490,0.15267175572519084,70,120,65,45,85,125,510,0.9747899159663865,0.0
59,74,50,35,50,35,303,0.3125,86,92,88,68,75,73,482,0.6835443037974683,1.0
35,20,65,40,65,20,245,0.02459016393442623,60,60,75,60,75,80,410,0.7321428571428571,2.0
55,35,50,55,110,85,390,0.6277372262773723,60,67,85,77,75,116,480,0.8888888888888888,2.0
80,80,50,40,50,25,325,0.176056338028169,70,70,70,70,70,70,420,0.5289256198347108,1.0
170,90,45,90,45,60,500,0.427536231884058,76,25,45,67,55,24,292,0.0390625,1.0
80,80,80,55,55,90,440,0.6417910447761194,60,50,50,60,70,50,340,0.28346456692913385,1.0
45,50,43,40,38,62,278,0.40441176470588236,70,85,140,85,70,20,470,0.272,1.0
56,61,65,48,45,38,313,0.17567567567567569,70,60,125,115,70,55,495,0.35507246376811596,4.0
90,132,105,132,105,30,594,0.4246575342465753,60,55,50,40,55,45,305,0.22377622377622378,0.25
40,55,30,30,30,85,270,0.688,45,35,50,70,50,30,280,0.15753424657534246,2.0
20,10,55,15,20,80,200,0.17985611510791366,50,48,43,46,41,60,288,0.47297297297297297,1.0
60,55,145,75,150,40,525,0.2,53,51,53,61,56,40,314,0.14285714285714285,0.5
45,80,100,35,37,28,325,0.3125,71,82,64,64,59,112,452,0.9327731092436975,0.0
60,82,45,45,45,74,351,0.5752212389380531,65,130,60,75,60,75,465,0.689922480620155,0.5
45,30,50,65,50,45,285,0.13821138211382114,95,117,80,65,70,92,519,0.8409090909090909,0.0
70,120,65,45,85,125,510,0.9747899159663865,40,35,30,20,20,50,195,0.23423423423423423,1.0
42,52,67,39,56,50,306,0.2868217054263566,49,66,70,44,55,51,335,0.4260869565217391,0.5
40,55,30,30,30,60,245,0.43548387096774194,55,70,55,40,55,85,360,0.7073170731707317,1.0
75,95,67,125,95,83,540,0.7117117117117117,80,115,80,65,55,93,488,0.7846153846153846,1.0
45,22,60,27,30,29,213,0.07518796992481203,60,95,80,60,80,30,405,0.19480519480519481,2.0
40,40,35,50,100,70,335,0.5031847133757962,65,90,50,85,45,55,390,0.371900826446281,0.5
49,55,42,42,37,85,310,0.6068376068376068,75,125,75,30,75,85,465,0.625,1.0
75,95,60,65,60,115,470,0.8778625954198473,90,65,65,40,40,15,315,0.19672131147540983,1.0
130,85,80,85,95,60,535,0.43884892086330934,100,134,110,95,100,61,600,0.4057971014492754,2.0
55,50,65,175,95,150,590,0.7818181818181819,50,30,55,65,55,20,275,0.13675213675213677,1.0
70,40,50,55,50,25,290,0.061068702290076333,70,50,30,95,135,105,485,0.8040540540540541,0.5
70,50,30,95,135,105,485,0.8040540540540541,54,45,47,75,98,52,371,0.39669421487603307,1.0
50,60,60,60,60,30,320,0.11290322580645161,60,95,80,60,80,30,405,0.19480519480519481,1.0
55,20,35,20,45,75,250,0.37681159420289856,123,100,62,97,81,68,531,0.4806201550387597,1.0
30,45,59,30,39,57,260,0.2803030303030303,60,79,105,59,85,36,424,0.17054263565891473,0.5
70,115,60,115,60,55,475,0.4647887323943662,45,25,50,25,25,35,205,0.13076923076923078,0.25
50,70,50,50,50,70,340,0.5645161290322581,95,75,80,100,110,30,490,0.24242424242424243,1.0
45,30,50,55,65,45,290,0.208,40,50,90,30,55,65,330,0.44680851063829785,2.0
73,95,62,85,65,85,465,0.6666666666666666,100,100,100,100,100,100,600,0.8345864661654135,1.0
65,50,35,115,95,95,455,0.7333333333333333,70,90,70,60,60,70,420,0.6390977443609023,0.0
165,75,80,40,45,65,470,0.5151515151515151,100,120,120,150,100,90,680,0.7880794701986755,0.5
90,132,105,132,105,30,594,0.4246575342465753,60,90,55,90,80,110,485,0.8677685950413223,1.0
50,65,107,105,107,86,520,0.7272727272727273,75,110,110,110,105,80,590,0.656934306569343,0.5
65,130,60,75,60,75,465,0.689922480620155,60,70,105,70,120,75,500,0.5983606557377049,2.0
65,65,60,130,95,110,525,0.823943661971831,80,120,70,110,70,80,530,0.6422764227642277,1.0
70,65,60,90,75,90,450,0.6571428571428571,90,92,87,75,85,76,505,0.5409836065573771,0.125
41,64,45,50,50,50,300,0.36752136752136755,90,65,65,40,40,15,315,0.19672131147540983,1.0
150,120,100,120,100,90,680,0.664179104477612,60,50,100,85,70,65,430,0.47580645161290325,1.0
130,65,60,110,95,65,525,0.5227272727272727,60,45,70,45,90,95,405,0.7304964539007093,1.0
40,80,100,30,30,20,300,0.11851851851851852,52,65,50,45,50,38,300,0.27419354838709675,1.0
100,150,90,180,160,90,770,0.7348484848484849,60,48,45,43,90,42,328,0.21897810218978103,1.0
40,55,30,30,30,85,270,0.688,20,40,90,30,90,25,295,0.11363636363636363,0.0
65,60,70,85,75,40,395,0.1796875,78,84,78,109,85,100,534,0.8620689655172413,1.0
50,70,50,50,50,70,340,0.5645161290322581,100,70,70,65,65,45,415,0.1897810218978102,1.0
55,104,105,94,75,52,485,0.36363636363636365,91,90,72,90,129,108,580,0.896,0.5
74,48,76,83,81,104,466,0.7913043478260869,100,150,90,180,160,90,770,0.7348484848484849,1.0
65,40,70,80,140,70,465,0.5954198473282443,40,35,30,120,70,105,400,0.6692307692307692,1.0
70,77,60,97,60,108,472,0.8394160583941606,60,82,45,45,45,74,351,0.5752212389380531,0.0
65,150,60,115,60,115,565,0.935251798561151,60,62,63,80,80,60,405,0.38016528925619836,1.0
90,92,87,75,85,76,505,0.5409836065573771,75,90,50,110,80,95,500,0.7985611510791367,2.0
70,145,88,140,70,112,625,0.8888888888888888,150,100,120,100,120,90,680,0.6666666666666666,0.0
39,52,43,60,50,65,309,0.49107142857142855,55,55,55,85,55,30,335,0.1320754716981132,1.0
40,30,30,40,50,30,220,0.07936507936507936,84,71,43,71,43,48,360,0.25874125874125875,1.0
50,50,95,40,50,35,320,0.20279720279720279,70,77,60,97,60,108,472,0.8394160583941606,1.0
35,70,55,45,55,25,285,0.09420289855072464,80,100,70,50,60,45,405,0.25806451612903225,0.5
42,52,67,39,56,50,306,0.2868217054263566,40,30,50,55,55,100,330,0.584070796460177,1.0
45,75,60,40,30,50,300,0.304,68,85,65,165,135,100,618,0.8083333333333333,0.0
65,40,50,125,60,30,370,0.07258064516129033,84,86,88,111,101,60,530,0.4634146341463415,0.5
50,50,150,50,150,50,500,0.2571428571428571,80,80,80,80,80,80,480,0.6015037593984962,2.0
60,69,95,69,95,36,424,0.2608695652173913,65,65,60,110,95,130,525,0.9253731343283582,0.5
70,40,50,55,50,25,290,0.061068702290076333,105,95,80,40,80,90,490,0.753968253968254,1.0
78,81,71,74,69,126,499,0.9090909090909091,108,112,118,68,72,47,525,0.2916666666666667,1.0
50,85,85,55,55,50,380,0.3902439024390244,78,52,60,63,65,23,341,0.06015037593984962,0.5
95,75,80,100,110,30,490,0.24242424242424243,44,38,39,61,79,42,303,0.2251655629139073,1.0
55,40,85,80,105,40,405,0.23622047244094488,50,60,60,60,60,30,320,0.11290322580645161,0.5
54,45,47,75,98,52,371,0.39669421487603307,80,100,200,50,100,50,580,0.3472222222222222,1.0
50,105,79,35,110,76,455,0.6214285714285714,60,100,89,55,69,112,485,0.9298245614035088,0.25
65,125,60,95,60,105,510,0.9236641221374046,70,83,50,37,50,60,350,0.3360655737704918,1.0
55,84,105,114,75,52,485,0.2890625,40,65,40,80,40,65,330,0.5038167938931297,1.0
35,70,55,45,55,25,285,0.09420289855072464,45,22,60,27,30,29,213,0.07518796992481203,0.5
50,65,64,44,48,43,314,0.2196969696969697,62,77,62,50,42,65,358,0.4838709677419355,1.0
40,60,30,31,31,70,262,0.4492753623188406,100,128,90,77,77,128,600,0.959349593495935,2.0
50,20,40,20,40,20,190,0.0962962962962963,43,80,65,50,35,35,308,0.14193548387096774,1.0
250,5,5,35,105,50,450,0.15306122448979592,65,40,50,125,60,30,370,0.07258064516129033,1.0
100,50,50,76,96,70,442,0.5,55,95,115,45,45,35,390,0.2116788321167883,0.25
50,50,50,50,50,50,300,0.30708661417322836,60,60,60,85,85,85,435,0.631578947368421,1.0
60,45,50,90,80,70,395,0.625,50,52,48,65,50,55,320,0.33098591549295775,1.0
95,75,180,130,80,30,590,0.13793103448275862,250,5,5,35,105,50,450,0.15306122448979592,1.0
75,80,60,65,90,102,472,0.8625954198473282,36,50,50,65,60,44,305,0.16363636363636364,1.0
80,160,80,130,80,100,630,0.8455284552845529,120,100,85,30,85,45,465,0.22448979591836735,1.0
108,100,121,81,95,95,600,0.7476635514018691,50,65,107,105,107,86,520,0.703125,2.0
80,115,80,65,55,93,488,0.7846153846153846,100,100,100,100,100,100,600,0.8805970149253731,1.0
70,94,50,94,50,66,424,0.48148148148148145,80,80,80,80,80,80,480,0.6015037593984962,1.0
50,53,48,53,48,64,316,0.358974358974359,49,55,42,42,37,85,310,0.6068376068376068,1.0
75,100,63,80,63,116,497,0.9345794392523364,50,65,107,105,107,86,520,0.7313432835820896,0.25
90,70,80,70,95,70,475,0.5190839694656488,58,70,45,40,45,42,300,0.25925925925925924,4.0
65,65,60,130,95,110,525,0.823943661971831,90,70,80,70,95,70,475,0.5190839694656488,1.0
70,85,140,85,70,20,470,0.272,40,30,32,50,52,65,269,0.3671875,1.0
60,50,70,50,90,65,385,0.39568345323741005,105,125,100,60,100,100,590,0.8359375,1.0
85,80,90,105,95,60,515,0.49074074074074076,75,95,67,125,95,83,540,0.7117117117117117,1.0
80,100,200,50,100,50,580,0.3472222222222222,61,84,65,70,70,70,420,0.5,1.0
60,70,65,125,105,90,515,0.6911764705882353,55,66,44,44,56,85,350,0.6888888888888889,1.0
85,120,70,50,60,100,485,0.8308823529411765,65,80,140,40,70,70,465,0.5223880597014925,0.25
75,100,63,80,63,116,497,0.9345794392523364,91,72,90,129,90,108,580,0.8620689655172413,2.0
150,120,100,120,100,90,680,0.664179104477612,45,30,40,105,50,20,290,0.031007751937984496,2.0
55,55,55,85,55,30,335,0.1320754716981132,50,85,125,85,115,20,480,0.4306569343065693,0.0
75,95,67,125,95,83,540,0.7117117117117117,95,100,85,108,70,70,528,0.5652173913043478,0.5
90,120,75,60,60,45,450,0.29411764705882354,80,85,95,30,30,25,345,0.2857142857142857,1.0
76,25,45,67,55,24,292,0.0390625,75,140,65,112,65,110,567,0.9140625,1.0
40,70,40,35,40,60,285,0.392,91,90,129,90,72,108,580,0.9140625,2.0
90,100,90,125,85,90,580,0.7352941176470589,70,145,88,140,70,112,625,0.8888888888888888,2.0
90,120,120,60,60,50,500,0.35294117647058826,50,160,110,160,110,110,700,0.8854961832061069,2.0
105,105,75,65,100,50,500,0.37593984962406013,55,40,50,65,85,40,335,0.3181818181818182,0.5
86,68,72,109,66,106,507,0.8099173553719008,55,65,95,95,45,85,440,0.6610169491525424,0.5
130,85,80,85,95,60,535,0.43884892086330934,95,110,95,40,95,55,490,0.40336134453781514,1.0
90,93,55,70,55,55,418,0.3819444444444444,80,160,80,130,80,100,630,0.8455284552845529,0.5
85,90,80,70,80,130,535,0.9262295081967213,55,55,50,45,65,55,325,0.37373737373737376,1.0
70,115,60,115,60,55,475,0.4647887323943662,50,85,85,55,55,50,380,0.3902439024390244,0.25
10,55,25,35,45,95,265,0.5396825396825397,60,85,69,65,79,80,438,0.576,2.0
30,42,118,42,88,30,350,0.112,60,82,45,45,45,74,351,0.5752212389380531,0.5
150,120,100,120,100,90,680,0.664179104477612,35,80,50,50,70,120,405,0.84375,1.0
90,60,60,40,40,40,330,0.29545454545454547,45,53,70,40,60,42,310,0.25735294117647056,0.25
55,81,60,50,70,97,413,0.7214285714285714,45,75,37,70,55,83,365,0.6183206106870229,1.0
79,115,70,125,80,111,580,0.864,90,75,75,90,100,70,500,0.5462184873949579,2.0
76,147,90,60,70,97,540,0.8267716535433071,40,45,65,100,120,90,460,0.5588235294117647,0.0
68,72,78,38,42,32,330,0.23809523809523808,35,65,35,65,35,65,300,0.46621621621621623,1.0
70,80,50,35,35,35,305,0.14,65,70,60,65,65,115,440,0.8583333333333333,2.0
65,80,80,59,63,58,405,0.4411764705882353,64,66,68,81,76,50,405,0.25190839694656486,0.5
65,65,45,75,45,95,390,0.72,40,50,90,30,55,65,330,0.44680851063829785,1.0
72,85,70,65,70,58,420,0.41304347826086957,70,60,125,115,70,55,495,0.35507246376811596,1.0
60,60,60,35,35,30,280,0.11194029850746269,59,59,58,90,70,73,409,0.5826086956521739,1.0
55,65,35,60,30,85,330,0.6126126126126126,56,61,65,48,45,38,313,0.17567567567567569,0.5
55,55,85,65,85,35,380,0.2014388489208633,60,50,100,85,70,65,430,0.47580645161290325,1.0
64,115,65,83,63,65,455,0.5323741007194245,55,81,60,50,70,97,413,0.7214285714285714,0.0
44,50,91,24,86,10,305,0.1981981981981982,85,80,90,105,95,60,515,0.49074074074074076,1.0
65,125,100,60,70,70,490,0.6099290780141844,65,63,45,45,45,45,308,0.2595419847328244,0.5
62,73,55,56,52,84,382,0.7244094488188977,65,47,55,73,75,85,400,0.65,4.0
75,80,70,65,75,90,455,0.7578125,44,48,65,50,64,43,314,0.1623931623931624,1.0
43,70,48,50,60,38,309,0.2391304347826087,35,35,40,35,55,50,250,0.40336134453781514,0.25
66,117,70,40,50,67,410,0.4573643410852713,105,105,75,65,100,50,500,0.37593984962406013,1.0
45,45,55,45,55,63,308,0.4594594594594595,46,57,40,40,40,50,273,0.25,0.5
50,65,107,105,107,86,520,0.7313432835820896,95,117,184,44,46,28,514,0.2975206611570248,1.0
70,120,65,45,85,125,510,0.9747899159663865,49,55,42,42,37,85,310,0.6068376068376068,1.0
35,20,65,40,65,20,245,0.02459016393442623,35,55,40,50,50,90,320,0.6838235294117647,1.0
67,89,116,79,116,33,500,0.2624113475177305,50,50,40,30,30,50,250,0.2781954887218045,4.0
95,100,85,108,70,70,528,0.5652173913043478,70,92,65,80,55,98,460,0.8090909090909091,0.5
55,40,85,80,105,40,405,0.23622047244094488,115,115,85,90,75,100,580,0.8134328358208955,0.5
65,40,50,125,60,30,370,0.07258064516129033,65,47,55,73,75,85,400,0.65,1.0
64,51,23,51,23,28,240,0.11363636363636363,125,120,90,170,100,95,700,0.78125,1.0
72,105,115,54,86,68,500,0.5149253731343284,70,150,140,65,100,75,600,0.55,1.0
64,66,68,81,76,50,405,0.25190839694656486,55,47,52,40,40,41,275,0.16806722689075632,1.0
80,100,123,122,120,80,625,0.56,60,79,105,59,85,36,424,0.17054263565891473,0.5
35,46,34,35,45,20,215,0.072,255,10,10,75,135,55,540,0.3125,1.0
55,112,45,74,45,70,401,0.559322033898305,85,70,80,97,80,123,535,0.9304347826086956,2.0
85,135,130,60,80,25,515,0.40540540540540543,44,38,39,61,79,42,303,0.2251655629139073,1.0
60,60,75,60,75,80,410,0.7321428571428571,40,60,40,40,40,30,250,0.0948905109489051,0.5
92,105,90,125,90,98,600,0.8217054263565892,65,65,45,75,45,95,390,0.72,1.0
67,125,40,30,30,58,350,0.3431372549019608,40,50,45,70,45,70,320,0.5517241379310345,2.0
105,140,95,55,65,45,505,0.3,50,70,160,70,160,90,600,0.7417218543046358,0.5
50,53,48,53,48,64,316,0.358974358974359,50,160,110,160,110,110,700,0.8854961832061069,2.0
100,123,75,57,75,80,510,0.6923076923076923,90,95,95,70,90,70,510,0.5230769230769231,2.0
65,47,55,73,75,85,400,0.65,150,80,44,90,54,80,498,0.625,0.25
40,45,65,100,120,90,460,0.5588235294117647,91,129,90,72,90,108,580,0.8536585365853658,2.0
70,100,70,105,75,40,460,0.23214285714285715,65,47,55,73,75,85,400,0.65,1.0
40,45,40,62,60,60,307,0.33884297520661155,52,65,55,58,62,60,352,0.4482758620689655,1.0
60,65,70,85,75,40,395,0.21705426356589147,95,110,80,70,80,50,485,0.37209302325581395,1.0
60,50,40,85,75,95,405,0.7540983606557377,95,125,79,60,100,81,540,0.6165413533834586,4.0
58,64,58,80,65,80,405,0.609271523178808,30,40,70,70,25,60,295,0.41353383458646614,0.5
55,70,45,70,50,60,350,0.45,150,120,100,120,100,90,680,0.664179104477612,0.5
105,150,90,150,90,95,680,0.8285714285714286,44,58,44,58,44,61,309,0.41964285714285715,1.0
75,65,55,65,55,69,384,0.43548387096774194,82,121,119,69,59,71,521,0.5394736842105263,2.0
50,70,160,70,160,90,600,0.7417218543046358,100,100,90,150,140,90,670,0.71875,1.0
35,46,34,35,45,20,215,0.072,50,75,45,40,45,60,315,0.4380165289256198,1.0
40,70,130,60,130,25,455,0.17355371900826447,115,115,85,90,75,100,580,0.8134328358208955,1.0
78,70,61,50,61,100,420,0.8145161290322581,45,25,50,25,25,35,205,0.13076923076923078,1.0
50,45,45,35,35,50,260,0.23529411764705882,85,120,70,50,60,100,485,0.8308823529411765,1.0
90,130,80,65,85,55,505,0.4396551724137931,55,55,50,45,65,55,325,0.37373737373737376,2.0
135,85,40,40,85,5,390,0.6864406779661016,40,35,30,120,70,105,400,0.6692307692307692,1.0
90,130,80,65,85,55,505,0.4396551724137931,70,105,105,50,40,20,390,0.33587786259541985,2.0
60,60,75,60,75,80,410,0.7321428571428571,75,65,55,65,55,69,384,0.43548387096774194,2.0
75,69,72,114,100,104,534,0.8253968253968254,106,90,130,90,154,110,680,0.8699186991869918,0.5
95,110,95,40,95,55,490,0.40336134453781514,40,55,70,45,60,30,300,0.10619469026548672,0.5
65,75,90,97,123,44,494,0.1987179487179487,35,40,100,90,55,35,355,0.1796875,0.5
70,55,95,95,110,65,490,0.48872180451127817,92,105,90,125,90,98,600,0.8217054263565892,0.0
55,45,50,45,65,80,340,0.5546218487394958,100,123,75,57,75,80,510,0.6923076923076923,0.5
45,50,45,115,55,95,405,0.6936936936936937,83,80,80,135,80,121,579,0.9444444444444444,0.0
65,40,50,125,60,30,370,0.07258064516129033,50,53,48,53,48,64,316,0.4076923076923077,1.0
59,45,40,35,40,31,250,0.14285714285714285,78,65,68,112,154,75,552,0.628099173553719,1.0
105,95,75,85,75,74,509,0.5714285714285714,40,30,30,40,50,30,220,0.07936507936507936,0.125
105,95,80,40,80,90,490,0.753968253968254,74,94,131,54,116,20,489,0.4485294117647059,0.5
70,80,102,80,102,40,474,0.2677165354330709,58,50,145,95,105,30,483,0.2459016393442623,0.5
75,75,95,75,95,113,528,0.9015151515151515,65,105,60,60,70,95,455,63.0,1.0
40,80,100,30,30,20,300,0.11851851851851852,60,105,60,120,60,105,510,0.8849557522123894,1.0
58,64,58,80,65,80,405,0.609271523178808,50,105,125,55,95,50,480,0.375886524822695,2.0
76,65,45,92,42,91,411,0.7449664429530202,114,85,70,85,80,30,464,0.2066115702479339,2.0
62,50,58,73,54,72,369,0.4435483870967742,65,75,105,35,65,85,430,0.6940298507462687,1.0
70,45,48,60,65,35,323,0.15748031496062992,40,40,35,50,100,70,335,0.5031847133757962,0.5
45,75,60,40,30,50,300,0.304,55,35,50,55,110,85,390,0.6277372262773723,1.0
65,75,105,35,65,85,430,0.6940298507462687,110,65,75,125,85,30,490,0.15,1.0
80,70,65,80,120,100,515,0.8034188034188035,65,95,57,100,85,93,495,0.7441860465116279,2.0
65,65,45,75,45,95,390,0.72,100,150,120,120,100,90,680,0.6493506493506493,0.5
70,130,100,55,80,65,500,0.608,109,66,84,81,99,32,471,0.2013888888888889,0.5
78,81,71,74,69,126,499,0.9090909090909091,62,73,55,56,52,84,382,0.7244094488188977,0.5
60,60,75,60,75,80,410,0.7321428571428571,85,105,55,85,50,115,495,0.9032258064516129,1.0
40,30,35,45,40,55,245,0.31496062992125984,55,35,50,55,110,85,390,0.6277372262773723,2.0
50,85,125,85,115,20,480,0.4306569343065693,60,85,49,60,49,60,363,0.4444444444444444,1.0
95,155,109,70,130,81,640,0.6788321167883211,45,35,50,70,50,30,280,0.15753424657534246,0.5
39,52,43,60,50,65,309,0.49107142857142855,90,110,80,100,80,95,555,0.7982456140350878,0.5
75,95,60,65,60,115,470,0.8778625954198473,65,130,60,95,110,65,525,0.5303030303030303,1.0
62,77,62,50,42,65,358,0.4838709677419355,62,48,66,59,57,49,341,0.33884297520661155,1.0
50,95,90,95,90,180,600,0.9172413793103448,82,121,119,69,59,71,521,0.5394736842105263,1.0
60,130,80,60,60,70,460,0.5153846153846153,59,74,50,35,50,35,303,0.3125,0.0
45,25,50,25,25,35,205,0.13076923076923078,106,190,100,154,100,130,780,0.9259259259259259,1.0
80,160,60,170,130,80,680,0.6180555555555556,67,82,62,46,48,43,348,0.22033898305084745,0.5
50,92,108,92,108,35,485,0.2457627118644068,90,132,105,132,105,30,594,0.4246575342465753,1.0
105,95,80,40,80,90,490,0.753968253968254,20,10,55,15,20,80,200,0.17985611510791366,1.0
40,35,30,120,70,105,400,0.6692307692307692,65,125,60,95,60,105,510,0.9236641221374046,1.0
20,40,90,30,90,25,295,0.11363636363636363,75,55,70,55,95,110,460,0.8444444444444444,1.0
61,72,57,55,55,65,365,0.3984375,35,85,45,35,35,75,310,0.6492537313432836,1.0
37,25,41,25,41,25,194,0.08870967741935484,68,165,95,65,115,110,618,0.8615384615384616,1.0
55,20,35,20,45,75,250,0.37681159420289856,70,90,45,15,45,50,315,0.3629032258064516,1.0
65,70,60,65,65,115,440,0.8583333333333333,41,56,40,62,44,71,314,0.568,1.0
55,50,40,40,40,75,300,0.5945945945945946,88,107,122,74,75,64,530,0.4596774193548387,1.0
55,70,45,70,50,60,350,0.45,78,130,111,130,85,100,634,0.8561151079136691,0.25
150,100,120,100,120,90,680,0.6666666666666666,53,51,53,61,56,40,314,0.14285714285714285,1.0
60,40,50,75,85,95,405,0.6044776119402985,40,45,35,30,40,55,245,0.3793103448275862,2.0
75,75,75,125,95,40,485,0.15671641791044777,40,20,30,40,80,55,265,0.22764227642276422,1.0
108,130,95,80,85,102,600,0.7637795275590551,60,115,105,65,70,80,495,0.7181818181818181,2.0
50,65,107,105,107,86,520,0.7758620689655172,40,55,99,40,79,47,360,0.26262626262626265,1.0
70,62,67,55,55,56,365,0.38513513513513514,50,50,40,50,40,64,294,0.45588235294117646,1.0
50,120,53,35,110,87,455,0.640625,52,65,55,58,62,60,352,0.4482758620689655,1.0
75,89,85,55,65,36,405,0.29545454545454547,90,60,70,75,70,45,410,0.23880597014925373,2.0
80,110,60,150,130,70,600,0.5042016806722689,55,95,55,35,75,115,430,0.9380530973451328,0.0
64,88,50,88,50,106,446,0.9111111111111111,60,50,70,50,90,65,385,0.39568345323741005,1.0
65,130,60,95,110,65,525,0.5303030303030303,70,45,48,60,65,35,323,0.15748031496062992,1.0
60,67,85,77,75,116,480,0.8888888888888888,40,40,55,40,70,55,300,0.40939597315436244,2.0
90,92,87,75,85,76,505,0.5409836065573771,60,100,85,80,85,100,510,0.7007874015748031,1.0
90,90,85,125,90,100,580,0.768595041322314,55,85,55,50,55,60,360,0.4233576642335766,2.0
70,50,30,95,135,105,485,0.8040540540540541,60,75,100,55,80,50,420,0.3088235294117647,0.5
50,105,125,55,95,50,480,0.375886524822695,55,55,55,85,55,30,335,0.1320754716981132,1.0
35,55,40,50,50,90,320,0.6838235294117647,60,80,50,40,40,30,300,0.15328467153284672,1.0
75,55,70,55,95,110,460,0.8444444444444444,106,90,130,90,154,110,680,0.8699186991869918,0.5
30,42,118,42,88,30,350,0.112,50,52,48,65,50,55,320,0.33098591549295775,0.5
70,85,70,60,70,50,405,0.28378378378378377,30,30,42,30,42,70,244,0.4230769230769231,0.0
60,85,49,60,49,60,363,0.4444444444444444,75,65,55,65,55,69,384,0.43548387096774194,0.0
45,50,55,75,65,30,320,0.06293706293706294,90,93,55,70,55,55,418,0.3819444444444444,0.5
50,65,64,44,48,43,314,0.2196969696969697,105,105,75,65,100,50,500,0.37593984962406013,1.0
65,76,84,54,96,105,480,0.9008264462809917,60,62,80,63,80,60,405,0.4336283185840708,1.0
75,100,66,60,66,115,482,0.918918918918919,25,35,70,95,55,45,325,0.16783216783216784,0.5
40,45,35,65,55,70,310,0.4482758620689655,76,104,71,104,71,108,534,0.912751677852349,0.5
44,48,65,50,64,43,314,0.1623931623931624,50,50,62,40,62,65,329,0.4188034188034188,1.0
110,80,90,95,90,65,530,0.5033557046979866,75,95,60,65,60,115,470,0.8778625954198473,1.0
50,180,20,180,20,150,600,0.9029850746268657,100,134,110,95,100,61,600,0.4057971014492754,0.0
95,124,78,69,71,58,495,0.37398373983739835,64,115,65,83,63,65,455,0.5323741007194245,0.0
100,103,75,120,75,127,600,0.940677966101695,70,145,88,140,70,112,625,0.8888888888888888,0.5
65,50,70,95,80,65,425,0.4262295081967213,71,73,88,120,89,59,500,0.43537414965986393,1.0
75,80,85,110,90,50,490,0.3548387096774194,95,85,85,65,65,35,430,0.2571428571428571,2.0
95,95,85,125,65,55,520,0.3894736842105263,40,29,45,29,45,36,224,0.14634146341463414,0.5
70,70,70,70,70,70,420,0.5289256198347108,44,38,33,61,43,70,289,0.5267857142857143,1.0
60,90,55,90,80,110,485,0.8677685950413223,50,53,48,53,48,64,316,0.358974358974359,2.0
80,80,90,110,130,110,600,0.8721804511278195,103,60,86,60,86,50,445,0.3458646616541353,1.0
50,105,79,35,110,76,455,0.6214285714285714,45,63,37,65,55,95,360,0.8055555555555556,1.0
44,38,33,61,43,70,289,0.5267857142857143,90,100,70,110,150,80,600,0.6037735849056604,0.5
126,131,95,131,98,99,680,0.8102189781021898,60,60,60,60,60,60,360,0.38095238095238093,1.0
60,52,168,47,138,30,495,0.19834710743801653,55,55,85,65,85,35,380,0.2014388489208633,1.0
50,95,90,95,90,180,600,0.9172413793103448,70,60,75,110,75,90,480,0.7165354330708661,1.0
50,92,108,92,108,35,485,0.2457627118644068,50,85,55,65,65,90,410,0.7478260869565218,1.0
100,100,100,100,100,100,600,0.8345864661654135,70,77,60,97,60,108,472,0.8394160583941606,0.5
90,100,90,125,85,90,580,0.7352941176470589,103,60,86,60,86,50,445,0.3458646616541353,1.0
90,60,70,75,70,45,410,0.23880597014925373,60,62,50,62,60,40,334,0.18181818181818182,0.5
54,66,70,44,55,46,335,0.4214876033057851,79,85,60,55,60,71,410,0.60431654676259,0.0
64,115,65,83,63,65,455,0.5323741007194245,55,65,95,95,45,85,440,0.6610169491525424,1.0
40,30,30,55,30,85,270,0.4666666666666667,71,73,88,120,89,59,500,0.43537414965986393,0.5
90,100,90,125,85,90,580,0.7352941176470589,60,150,50,150,50,60,520,0.5,1.0
85,97,66,105,66,65,484,0.47107438016528924,64,66,68,81,76,50,405,0.25190839694656486,0.5
65,75,70,95,70,95,470,0.7272727272727273,61,90,45,50,50,160,456,0.9230769230769231,2.0
25,35,70,95,55,45,325,0.16783216783216784,40,30,30,40,50,30,220,0.07936507936507936,0.5
35,55,35,30,30,35,220,0.23684210526315788,59,110,150,45,49,35,448,0.3333333333333333,2.0
55,70,40,60,40,40,305,0.26956521739130435,255,10,10,75,135,55,540,0.3125,1.0
60,50,150,50,150,60,520,0.5206611570247934,50,50,120,80,80,30,410,0.07258064516129033,1.0
50,85,55,65,65,90,410,0.7478260869565218,50,75,45,40,45,60,315,0.4380165289256198,2.0
46,87,60,30,40,57,320,0.37777777777777777,78,81,71,74,69,126,499,0.9090909090909091,1.0
65,60,110,130,95,65,525,0.47761194029850745,70,92,65,80,55,98,460,0.8090909090909091,0.5
40,30,35,45,40,55,245,0.31496062992125984,45,90,20,65,20,65,305,0.5116279069767442,1.0
125,58,58,76,76,67,460,0.515625,100,150,120,120,100,90,680,0.6493506493506493,0.125
86,92,88,68,75,73,482,0.6835443037974683,50,53,48,53,48,64,316,0.4076923076923077,1.0
55,20,35,20,45,75,250,0.37681159420289856,59,45,40,35,40,31,250,0.14285714285714285,1.0
105,30,105,140,105,55,540,0.3524590163934426,68,85,65,165,135,100,618,0.8083333333333333,0.5
85,105,55,85,50,115,495,0.9032258064516129,80,82,78,95,80,85,500,0.6869565217391305,0.5
70,62,67,55,55,56,365,0.38513513513513514,55,66,44,44,56,85,350,0.6888888888888889,1.0
60,50,150,50,150,60,520,0.5206611570247934,65,65,65,50,50,90,385,0.72,0.5
74,48,76,83,81,104,466,0.7913043478260869,120,70,120,75,130,85,600,0.6694915254237288,0.5
60,50,50,60,70,50,340,0.28346456692913385,50,55,50,36,30,43,264,0.2922077922077922,0.5
30,65,100,45,25,40,305,0.1891891891891892,74,94,131,54,116,20,489,0.4485294117647059,0.5
60,55,50,40,55,45,305,0.22377622377622378,70,77,60,97,60,108,472,0.8394160583941606,1.0
53,54,53,37,46,45,288,0.3090909090909091,70,90,110,60,75,95,500,0.7333333333333333,0.0
73,95,62,85,65,85,465,0.6666666666666666,30,35,30,100,35,80,310,0.4765625,0.0
91,134,95,100,100,80,600,0.6304347826086957,53,51,53,61,56,40,314,0.14285714285714285,1.0
90,75,85,115,90,55,510,0.3445378151260504,45,90,20,65,20,65,305,0.5116279069767442,2.0
70,55,65,95,85,70,440,0.5307692307692308,65,125,100,55,70,85,500,0.6532258064516129,2.0
75,90,90,140,90,115,600,0.9481481481481482,45,30,35,20,20,45,195,0.14782608695652175,2.0
40,40,40,70,40,20,250,0.032520325203252036,45,53,70,40,60,42,310,0.25735294117647056,4.0
78,104,78,159,115,100,634,0.8444444444444444,45,30,15,85,65,65,305,0.36220472440944884,2.0
91,72,90,129,90,108,580,0.8925619834710744,85,100,122,58,75,54,494,0.3939393939393939,0.0
123,77,72,99,92,58,521,0.4621212121212121,126,131,95,131,98,99,680,0.8102189781021898,4.0
65,50,70,95,80,65,425,0.4262295081967213,40,35,30,120,70,105,400,0.6692307692307692,0.5
60,90,140,50,50,40,430,0.2535211267605634,30,65,100,45,25,40,305,0.1891891891891892,0.5
60,60,60,35,35,30,280,0.11194029850746269,65,150,40,15,80,145,495,0.9663865546218487,1.0
35,64,85,74,55,32,345,0.19827586206896552,91,90,129,90,72,108,580,0.9140625,1.0
45,45,55,45,55,63,308,0.4594594594594595,64,88,50,88,50,106,446,0.9111111111111111,1.0
80,45,65,90,110,80,470,0.5462962962962963,65,95,75,55,55,85,430,0.6933333333333334,2.0
95,65,110,60,130,65,525,0.5275590551181102,40,30,30,40,50,30,220,0.07936507936507936,1.0
97,165,60,65,50,58,495,0.3902439024390244,60,70,65,125,105,90,515,0.6911764705882353,1.0
45,100,45,45,45,10,290,0.2949640287769784,40,29,45,29,45,36,224,0.14634146341463414,0.5
78,84,78,109,85,100,534,0.8646616541353384,100,100,80,60,60,50,450,0.3050847457627119,2.0
60,50,70,50,90,65,385,0.39568345323741005,78,104,78,159,115,100,634,0.8444444444444444,0.25
59,74,50,35,50,35,303,0.3125,100,150,140,100,90,90,670,0.7969924812030075,1.0
55,50,40,40,40,75,300,0.5945945945945946,60,50,150,50,150,60,520,0.5206611570247934,0.0
60,62,63,80,80,60,405,0.38016528925619836,80,80,50,40,50,25,325,0.176056338028169,0.25
50,150,50,150,50,150,600,0.9339622641509434,62,48,66,59,57,49,341,0.33884297520661155,1.0
73,95,62,85,65,85,465,0.6666666666666666,40,55,80,35,60,30,300,0.15037593984962405,0.5
83,106,65,86,65,85,490,0.6640625,55,45,50,45,65,80,340,0.5546218487394958,1.0
75,95,60,65,60,115,470,0.8778625954198473,30,45,59,30,39,57,260,0.2803030303030303,1.0
100,120,100,150,120,90,680,0.728,100,150,120,120,100,90,680,0.6493506493506493,1.0
50,120,53,35,110,87,455,0.640625,85,76,64,45,55,90,415,0.6739130434782609,2.0
105,95,80,40,80,90,490,0.753968253968254,61,72,57,55,55,65,365,0.3984375,1.0
44,50,91,24,86,10,305,0.1981981981981982,65,60,110,130,95,65,525,0.47761194029850745,2.0
65,90,120,85,70,60,490,0.43410852713178294,58,64,58,80,65,80,405,0.609271523178808,1.0
40,65,40,80,40,65,330,0.5038167938931297,100,100,100,100,100,100,600,0.8805970149253731,1.0
110,65,75,125,85,30,490,0.15,82,80,86,85,75,72,480,0.6183206106870229,1.0
50,150,50,150,50,150,600,0.9339622641509434,60,50,150,50,150,60,520,0.5206611570247934,0.5
100,73,83,73,83,55,467,0.371900826446281,50,35,55,25,25,15,205,0.021739130434782608,1.0
58,109,112,48,48,109,484,0.8805970149253731,50,105,125,55,95,50,480,0.375886524822695,0.0625
55,84,105,114,75,52,485,0.2890625,100,120,100,150,120,90,680,0.728,1.0
125,130,90,130,90,95,660,0.7734375,65,75,70,95,70,95,470,0.7272727272727273,2.0
91,90,106,130,106,77,600,0.648854961832061,75,125,230,55,95,30,610,0.3448275862068966,1.0
25,20,15,105,55,90,310,0.32407407407407407,100,5,5,15,65,30,220,0.07692307692307693,1.0
75,90,50,110,80,95,500,0.7985611510791367,104,91,63,91,73,68,490,0.5118110236220472,1.0
65,75,70,95,70,95,470,0.7272727272727273,40,30,32,50,52,65,269,0.3671875,2.0
70,90,45,15,45,50,315,0.3629032258064516,100,100,90,150,140,90,670,0.71875,0.5
90,92,87,75,85,76,505,0.5409836065573771,46,87,60,30,40,57,320,0.37777777777777777,1.0
70,145,88,140,70,112,625,0.8888888888888888,55,40,40,65,45,35,280,0.16428571428571428,0.5
150,120,100,120,100,90,680,0.664179104477612,62,73,55,56,52,84,382,0.7244094488188977,1.0
85,80,90,105,95,60,515,0.49074074074074076,77,59,50,67,63,46,362,0.23140495867768596,0.5
95,23,48,23,48,23,260,0.046153846153846156,65,95,100,60,50,50,420,0.34959349593495936,1.0
55,112,45,74,45,70,401,0.559322033898305,95,60,79,100,125,81,540,0.6201550387596899,1.0
150,100,120,100,120,90,680,0.6666666666666666,60,85,69,60,69,77,420,0.518796992481203,0.0
75,140,65,112,65,110,567,0.9140625,60,85,60,85,60,55,405,0.3673469387755102,2.0
64,66,68,81,76,50,405,0.25190839694656486,74,100,72,90,72,46,454,0.24561403508771928,0.5
60,65,60,130,75,110,500,0.7719298245614035,125,120,90,170,100,95,700,0.78125,1.0
101,72,72,99,89,29,462,0.1937984496124031,71,73,88,120,89,59,500,0.43537414965986393,1.0
75,95,122,58,75,69,494,0.5725806451612904,106,150,70,194,120,140,780,0.952,2.0
80,160,80,130,80,100,630,0.8455284552845529,73,100,60,100,60,65,458,0.42657342657342656,0.5
40,30,30,40,50,30,220,0.07936507936507936,73,100,60,100,60,65,458,0.42657342657342656,0.5
59,110,150,45,49,35,448,0.3333333333333333,65,90,120,85,70,60,490,0.43410852713178294,1.0
80,80,80,80,80,80,480,0.5606060606060606,75,38,38,56,56,67,330,0.5263157894736842,0.5
54,45,47,75,98,52,371,0.39669421487603307,60,45,50,90,80,70,395,0.625,1.0
60,70,105,70,120,75,500,0.5983606557377049,60,70,50,100,50,65,395,0.5217391304347826,0.0
50,50,150,50,150,50,500,0.2571428571428571,40,65,95,60,45,35,340,0.13986013986013987,0.5
65,76,84,54,96,105,480,0.9008264462809917,50,50,50,50,50,50,300,0.30708661417322836,1.0
66,41,77,61,87,23,355,0.12096774193548387,70,65,60,90,75,90,450,0.6571428571428571,0.5
70,62,67,55,55,56,365,0.38513513513513514,80,120,79,95,79,70,523,0.5833333333333334,1.0
75,90,50,110,80,95,500,0.7985611510791367,79,103,120,135,115,78,630,0.5763888888888888,0.5
50,53,48,53,48,64,316,0.358974358974359,170,90,45,90,45,60,500,0.427536231884058,0.5
80,160,60,170,130,80,680,0.6180555555555556,55,70,55,40,55,85,360,0.7073170731707317,1.0
62,48,54,63,60,68,355,0.5178571428571429,68,90,65,50,55,82,410,0.6165413533834586,2.0
45,60,45,25,45,55,275,0.29,75,90,90,140,90,115,600,0.9481481481481482,1.0
85,56,77,50,77,78,423,0.53125,100,164,150,95,120,71,700,0.5645161290322581,1.0
42,52,67,39,56,50,306,0.2868217054263566,50,105,79,35,110,76,455,0.6214285714285714,0.5
80,50,100,100,200,50,580,0.2357142857142857,80,80,80,80,80,80,480,0.6015037593984962,0.5
90,132,105,132,105,30,594,0.4246575342465753,49,55,42,42,37,85,310,0.6068376068376068,1.0
40,30,32,50,52,65,269,0.3671875,80,160,80,130,80,100,630,0.8455284552845529,0.5
40,20,30,40,80,55,265,0.22764227642276422,80,95,82,60,82,75,474,0.6,0.5
75,89,85,55,65,36,405,0.29545454545454547,120,100,85,30,85,45,465,0.22448979591836735,1.0
86,68,72,109,66,106,507,0.8099173553719008,45,50,43,40,38,62,278,0.40441176470588236,1.0
60,25,35,70,80,60,330,0.3076923076923077,70,90,45,15,45,50,315,0.3629032258064516,1.0
50,25,28,45,55,15,218,0.0625,70,65,60,90,75,90,450,0.6571428571428571,0.5
55,50,45,135,95,120,500,0.7714285714285715,70,110,80,55,80,105,500,0.8794326241134752,1.0
45,30,50,55,65,45,290,0.208,68,65,65,125,115,80,518,0.6461538461538462,0.5
66,117,70,40,50,67,410,0.4573643410852713,85,70,80,97,80,123,535,0.9304347826086956,2.0
30,42,118,42,88,30,350,0.112,86,81,97,81,107,43,495,0.203125,2.0
60,150,50,150,50,60,520,0.5,90,95,105,165,110,45,610,0.2890625,0.5
44,75,35,63,33,45,295,0.2647058823529412,55,84,105,114,75,52,485,0.2890625,1.0
90,92,87,75,85,76,505,0.5409836065573771,70,50,30,95,135,105,485,0.8040540540540541,1.0
60,65,70,85,75,40,395,0.21705426356589147,30,30,30,30,30,30,180,0.12612612612612611,1.0
55,40,50,65,85,40,335,0.3181818181818182,80,145,150,105,110,110,700,0.8692307692307693,2.0
65,75,70,95,70,95,470,0.7272727272727273,50,53,62,58,63,44,330,0.13709677419354838,1.0
40,29,45,29,45,36,224,0.14634146341463414,123,100,62,97,81,68,531,0.4806201550387597,2.0
40,45,65,100,120,90,460,0.5588235294117647,80,120,130,55,65,45,495,0.37037037037037035,2.0
79,103,120,135,115,78,630,0.5763888888888888,90,100,90,125,85,90,580,0.7352941176470589,2.0
75,75,130,75,130,95,580,0.7479674796747967,40,27,60,37,50,66,280,0.36220472440944884,1.0
35,40,100,90,55,35,355,0.1796875,75,100,110,45,55,65,450,0.5333333333333333,1.0
90,120,120,60,60,50,500,0.35294117647058826,55,95,55,35,75,115,430,0.9380530973451328,1.0
60,65,80,170,95,130,600,0.8625954198473282,35,46,34,35,45,20,215,0.072,0.0
50,70,50,50,50,70,340,0.5645161290322581,75,140,65,112,65,110,567,0.9140625,0.0
90,130,80,65,85,55,505,0.4396551724137931,70,90,70,60,60,70,420,0.6390977443609023,2.0
60,50,50,60,70,50,340,0.28346456692913385,44,38,33,61,43,70,289,0.5267857142857143,1.0
65,45,55,45,70,45,325,0.24369747899159663,50,60,60,60,60,30,320,0.11290322580645161,0.5
65,80,65,35,65,60,370,0.38405797101449274,43,30,55,40,65,97,330,0.6030534351145038,1.0
78,52,60,63,65,23,341,0.06015037593984962,78,92,75,74,63,118,500,0.8842975206611571,2.0
85,120,70,50,60,100,485,0.8308823529411765,70,70,70,70,70,70,420,0.5289256198347108,1.0
100,100,100,100,100,100,600,0.8805970149253731,70,80,50,35,35,35,305,0.14,1.0
53,51,53,61,56,40,314,0.14285714285714285,60,110,70,60,60,100,460,0.8461538461538461,1.0
45,75,60,40,30,50,300,0.304,55,65,35,60,30,85,330,0.6126126126126126,1.0
30,65,100,45,25,40,305,0.1891891891891892,115,115,85,90,75,100,580,0.8134328358208955,2.0
20,10,55,15,20,80,200,0.17985611510791366,55,75,50,40,40,80,340,0.6302521008403361,1.0
55,65,35,60,30,85,330,0.6126126126126126,60,62,50,62,60,40,334,0.18181818181818182,0.5
52,65,55,58,62,60,352,0.4482758620689655,90,55,75,60,75,30,385,0.13970588235294118,1.0
30,45,55,70,55,85,340,0.5633802816901409,73,76,75,81,100,100,505,0.8110236220472441,2.0
45,22,60,27,30,29,213,0.07518796992481203,70,75,60,105,60,105,475,0.88,1.0
108,112,118,68,72,47,525,0.2916666666666667,50,95,180,85,45,70,525,0.5298507462686567,1.0
70,105,105,50,40,20,390,0.33587786259541985,50,53,48,53,48,64,316,0.4076923076923077,1.0
60,80,110,50,80,45,425,0.2833333333333333,60,65,80,170,95,130,600,0.8625954198473282,2.0
30,42,118,42,88,30,350,0.112,70,80,70,80,70,110,480,0.6594202898550725,4.0
97,165,60,65,50,58,495,0.3902439024390244,86,76,86,116,56,95,515,0.7982456140350878,4.0
60,80,110,50,80,45,425,0.2833333333333333,59,66,70,44,55,41,335,0.25190839694656486,0.5
75,125,230,55,95,30,610,0.3448275862068966,62,48,66,59,57,49,341,0.33884297520661155,0.5
100,134,110,95,100,61,600,0.4057971014492754,62,73,55,56,52,84,382,0.7244094488188977,4.0
100,120,120,150,100,90,680,0.7880794701986755,40,60,30,31,31,70,262,0.4492753623188406,1.0
100,128,90,77,77,128,600,0.959349593495935,40,27,60,37,50,66,280,0.36220472440944884,0.5
65,125,100,55,70,85,500,0.6532258064516129,60,115,105,65,70,80,495,0.7181818181818181,1.0
58,64,58,80,65,80,405,0.609271523178808,90,65,65,40,40,15,315,0.19672131147540983,0.5
65,130,60,75,60,75,465,0.689922480620155,70,60,125,115,70,55,495,0.35507246376811596,1.0
65,125,60,95,60,105,510,0.9236641221374046,38,41,40,50,65,65,299,0.4108527131782946,1.0
40,40,35,50,100,70,335,0.5031847133757962,45,30,50,55,65,45,290,0.208,1.0
80,185,115,40,105,75,600,0.6230769230769231,45,49,49,65,65,45,318,0.2781954887218045,0.5
108,100,121,81,95,95,600,0.7476635514018691,68,90,65,50,55,82,410,0.6165413533834586,2.0
65,125,100,60,70,70,490,0.6099290780141844,76,48,48,57,62,34,325,0.11688311688311688,0.5
55,40,85,80,105,40,405,0.23622047244094488,60,48,45,43,90,42,328,0.21897810218978103,1.0
50,80,95,10,45,10,290,0.232,95,95,85,125,65,55,520,0.3894736842105263,1.0
35,55,40,50,50,90,320,0.6838235294117647,79,85,60,55,60,71,410,0.60431654676259,2.0
70,20,50,20,50,40,250,0.1557377049180328,60,62,63,80,80,60,405,0.38016528925619836,0.25
80,82,83,100,100,80,525,0.6742424242424242,55,85,122,58,75,99,494,0.8099173553719008,0.5
106,90,130,90,154,110,680,0.8699186991869918,78,92,75,74,63,118,500,0.8842975206611571,2.0
100,100,100,100,100,100,600,0.8758169934640523,79,100,80,110,90,121,580,0.968,1.0
40,55,30,30,30,85,270,0.688,125,120,90,170,100,95,700,0.78125,1.0
110,65,75,125,85,30,490,0.15,50,50,95,40,50,35,320,0.20279720279720279,2.0
46,57,40,40,40,50,273,0.25,40,30,30,55,30,85,270,0.4666666666666667,1.0
60,45,50,90,80,70,395,0.625,65,83,57,95,85,105,490,0.8914728682170543,0.5
95,124,78,69,71,58,495,0.37398373983739835,50,65,107,105,107,86,520,0.7313432835820896,1.0
51,65,65,80,75,59,395,0.4365079365079365,68,165,95,65,115,110,618,0.8615384615384616,1.0
100,100,90,150,140,90,670,0.71875,70,85,70,60,70,50,405,0.28378378378378377,1.0
45,50,55,75,65,30,320,0.06293706293706294,95,100,85,108,70,70,528,0.5652173913043478,2.0
45,35,45,62,53,35,275,0.11851851851851852,130,65,60,110,95,65,525,0.5227272727272727,2.0
80,100,123,122,120,80,625,0.56,40,45,35,40,40,90,290,0.65,1.0
95,100,85,108,70,70,528,0.5652173913043478,70,90,70,60,60,70,420,0.6390977443609023,1.0
44,48,65,50,64,43,314,0.1623931623931624,62,48,54,63,60,68,355,0.5178571428571429,1.0
50,53,48,53,48,64,316,0.46153846153846156,45,30,50,65,50,45,285,0.13821138211382114,1.0
40,27,60,37,50,66,280,0.36220472440944884,70,105,105,50,40,20,390,0.33587786259541985,2.0
70,77,60,97,60,108,472,0.8394160583941606,100,100,80,60,60,50,450,0.3050847457627119,0.0
72,105,115,54,86,68,500,0.5149253731343284,35,40,100,90,55,35,355,0.1796875,1.0
75,100,66,60,66,115,482,0.918918918918919,75,100,63,80,63,116,497,0.9345794392523364,1.0
90,95,105,165,110,45,610,0.2890625,80,145,150,105,110,110,700,0.8692307692307693,0.5
70,130,100,55,80,65,500,0.608,60,60,40,65,45,35,305,0.15833333333333333,0.25
65,73,55,47,75,85,400,0.6846846846846847,45,49,49,65,65,45,318,0.2781954887218045,1.0
70,100,115,30,65,30,410,0.24390243902439024,110,65,105,55,95,80,510,0.6258503401360545,2.0
110,80,90,95,90,65,530,0.5033557046979866,85,76,64,45,55,90,415,0.6739130434782609,1.0
106,150,70,194,120,140,780,0.952,42,52,67,39,56,50,306,0.2868217054263566,1.0
105,95,80,40,80,90,490,0.753968253968254,55,84,105,114,75,52,485,0.2890625,1.0
55,55,45,63,45,45,308,0.25,50,85,55,65,65,90,410,0.7478260869565218,2.0
50,45,45,35,35,50,260,0.23529411764705882,75,90,90,140,90,115,600,0.9481481481481482,1.0
55,65,35,60,30,85,330,0.6126126126126126,60,100,115,70,85,90,520,0.7557251908396947,1.0
60,50,40,85,75,95,405,0.7540983606557377,80,110,60,150,130,70,600,0.5042016806722689,1.0
66,117,70,40,50,67,410,0.4573643410852713,55,95,55,35,75,115,430,0.9380530973451328,1.0
46,57,40,40,40,50,273,0.25,100,150,120,120,100,90,680,0.6493506493506493,1.0
75,38,38,56,56,67,330,0.5263157894736842,75,70,90,70,105,80,490,0.656,0.5
79,85,60,55,60,71,410,0.60431654676259,60,90,140,50,50,40,430,0.2535211267605634,0.5
71,82,64,64,59,112,452,0.9327731092436975,50,160,110,160,110,110,700,0.8854961832061069,0.5
50,20,55,25,25,30,205,0.09774436090225563,80,80,80,80,80,80,480,0.5606060606060606,1.0
45,50,55,75,65,30,320,0.06293706293706294,50,20,55,25,25,30,205,0.09774436090225563,0.5
120,120,120,120,120,120,720,0.9344262295081968,78,81,71,74,69,126,499,0.9090909090909091,1.0
75,38,38,56,56,67,330,0.5263157894736842,41,56,40,62,44,71,314,0.568,1.0
45,30,40,105,50,20,290,0.031007751937984496,70,80,50,35,35,35,305,0.14,1.0
60,62,50,62,60,40,334,0.18181818181818182,65,130,60,95,110,65,525,0.5303030303030303,0.25
80,70,40,100,60,145,495,0.921875,70,100,70,105,75,40,460,0.23214285714285715,0.5
50,53,48,53,48,64,316,0.358974358974359,70,120,40,95,40,95,460,0.8106060606060606,0.5
45,50,35,55,75,40,300,0.21367521367521367,70,75,80,135,80,135,575,0.917910447761194,1.0
70,55,55,80,60,45,365,0.2222222222222222,50,53,62,58,63,44,330,0.13709677419354838,2.0
80,75,150,75,150,50,580,0.30973451327433627,75,140,65,112,65,110,567,0.9140625,2.0
60,45,70,75,85,55,390,0.3008130081300813,70,55,55,80,60,45,365,0.2222222222222222,1.0
125,170,100,120,90,95,700,0.77,108,112,118,68,72,47,525,0.2916666666666667,2.0
44,48,65,50,64,43,314,0.1623931623931624,55,45,50,45,65,80,340,0.5546218487394958,0.5
90,130,80,65,85,55,505,0.4396551724137931,65,55,115,100,40,60,435,0.3798449612403101,1.0
64,115,65,83,63,65,455,0.5323741007194245,10,55,25,35,45,95,265,0.5396825396825397,1.0
75,87,63,87,63,98,473,0.865546218487395,106,150,70,194,120,140,780,0.952,1.0
45,90,20,65,20,65,305,0.5116279069767442,95,85,85,65,65,35,430,0.2571428571428571,1.0
55,55,85,65,85,35,380,0.2014388489208633,70,43,53,43,53,40,302,0.19090909090909092,1.0
40,45,35,65,55,70,310,0.4482758620689655,50,72,35,35,35,65,292,0.5373134328358209,2.0
75,98,63,98,63,101,498,0.849624060150376,70,70,115,130,90,60,535,0.5338983050847458,1.0
65,45,55,45,70,45,325,0.24369747899159663,50,70,50,50,50,70,340,0.5645161290322581,1.0
90,100,70,110,150,80,600,0.6037735849056604,170,90,45,90,45,60,500,0.427536231884058,1.0
63,120,85,90,55,55,468,0.2809917355371901,125,170,100,120,90,95,700,0.77,0.5
68,85,65,165,135,100,618,0.8083333333333333,60,110,70,60,60,100,460,0.8461538461538461,1.0
103,93,67,71,61,84,479,0.7142857142857143,70,94,50,94,50,66,424,0.48148148148148145,1.0
65,110,130,60,65,95,525,0.8278145695364238,44,50,91,24,86,10,305,0.1981981981981982,0.25
44,58,44,58,44,61,309,0.41964285714285715,110,78,73,76,71,60,468,0.3333333333333333,0.5
75,98,63,98,63,101,498,0.849624060150376,116,55,85,107,95,29,487,0.06818181818181818,1.0
55,70,40,60,40,40,305,0.26956521739130435,80,52,50,90,50,89,411,0.6666666666666666,2.0
115,140,130,55,55,40,535,0.4519230769230769,35,40,100,90,55,35,355,0.1796875,2.0
85,76,64,45,55,90,415,0.6739130434782609,72,58,80,103,80,97,490,0.7171052631578947,1.0
55,75,60,75,60,103,428,0.7982456140350878,90,75,85,115,90,55,510,0.3445378151260504,0.25
40,45,40,65,40,65,295,0.5661764705882353,35,60,44,40,54,55,288,0.366412213740458,1.0
59,74,50,35,50,35,303,0.3125,110,85,95,80,95,50,515,0.2713178294573643,0.0
52,65,55,58,62,60,352,0.4482758620689655,95,155,109,70,130,81,640,0.6788321167883211,1.0
99,68,83,72,87,51,460,0.417910447761194,76,25,45,67,55,24,292,0.0390625,1.0
95,125,79,60,100,81,540,0.6165413533834586,80,130,100,160,120,110,700,0.8981481481481481,0.5
40,60,40,40,40,30,250,0.0948905109489051,85,80,70,135,75,90,535,0.7006802721088435,1.0
65,70,60,65,65,115,440,0.8583333333333333,100,150,140,100,90,90,670,0.7969924812030075,1.0
105,140,55,30,55,95,480,0.8195488721804511,80,85,95,30,30,25,345,0.2857142857142857,0.5
73,100,60,100,60,65,458,0.42657342657342656,75,90,140,60,60,40,465,0.3008130081300813,0.0
75,85,200,55,65,30,510,0.16778523489932887,65,95,100,60,50,50,420,0.34959349593495936,1.0
80,130,100,160,120,110,700,0.8981481481481481,60,65,80,170,95,130,600,0.8625954198473282,2.0
35,85,45,35,35,75,310,0.6492537313432836,65,80,140,40,70,70,465,0.5223880597014925,0.25
64,88,50,88,50,106,446,0.9111111111111111,53,51,53,61,56,40,314,0.14285714285714285,1.0
60,80,110,50,80,45,425,0.2833333333333333,75,69,72,114,100,104,534,0.8253968253968254,2.0
60,55,50,40,55,45,305,0.22377622377622378,44,38,39,61,79,42,303,0.2251655629139073,1.0
103,93,67,71,61,84,479,0.7142857142857143,50,35,55,25,25,15,205,0.021739130434782608,1.0
60,65,70,85,75,40,395,0.21705426356589147,70,130,100,55,80,65,500,0.608,0.0
90,95,95,70,90,70,510,0.5230769230769231,68,72,78,38,42,32,330,0.23809523809523808,2.0
80,70,70,90,100,70,480,0.5609756097560976,45,95,50,40,50,75,355,0.54,2.0
45,45,35,20,30,20,195,0.07246376811594203,105,180,100,180,100,115,780,0.9477611940298507,0.5
65,80,140,40,70,70,465,0.5223880597014925,90,100,70,110,150,80,600,0.6037735849056604,1.0
100,150,120,120,100,90,680,0.6493506493506493,70,85,70,60,70,50,405,0.28378378378378377,0.0
59,63,80,65,80,58,405,0.41843971631205673,70,120,40,95,40,95,460,0.8106060606060606,0.5
62,48,66,59,57,49,341,0.33884297520661155,35,35,40,35,55,50,250,0.40336134453781514,1.0
48,72,48,72,48,48,336,0.25984251968503935,80,80,80,55,55,90,440,0.6417910447761194,1.0
35,60,44,40,54,55,288,0.366412213740458,60,80,110,50,80,45,425,0.2833333333333333,0.5
95,109,105,75,85,56,525,0.34513274336283184,73,76,75,81,100,100,505,0.8110236220472441,1.0
70,140,230,60,80,50,630,0.32432432432432434,80,130,100,160,120,110,700,0.8981481481481481,1.0
70,110,180,60,60,50,530,0.4117647058823529,99,68,83,72,87,51,460,0.417910447761194,2.0
65,80,65,35,65,60,370,0.38405797101449274,55,66,44,44,56,85,350,0.6888888888888889,1.0
106,110,90,154,90,130,680,0.926829268292683,89,125,90,115,80,101,600,0.8725490196078431,2.0
75,110,110,110,105,80,590,0.656934306569343,76,25,45,67,55,24,292,0.0390625,1.0
70,95,85,55,65,70,440,0.5,44,58,44,58,44,61,309,0.41964285714285715,2.0
66,65,48,62,57,52,350,0.36220472440944884,100,90,130,45,65,55,485,0.4253731343283582,4.0
59,110,150,45,49,35,448,0.3333333333333333,70,110,75,145,85,145,630,0.9444444444444444,1.0
28,25,25,45,35,40,198,0.16083916083916083,60,50,150,50,150,60,520,0.5206611570247934,0.25
58,70,45,40,45,42,300,0.25925925925925924,86,76,86,116,56,95,515,0.7982456140350878,0.0
75,75,95,75,95,113,528,0.9015151515151515,86,68,72,109,66,106,507,0.8099173553719008,0.5
80,120,80,120,80,100,580,0.8478260869565217,40,55,99,40,79,47,360,0.26262626262626265,1.0
85,60,65,135,105,100,550,0.7518248175182481,75,125,230,55,95,30,610,0.3448275862068966,1.0
75,80,70,65,75,90,455,0.7578125,123,100,62,97,81,68,531,0.4806201550387597,4.0
100,100,80,60,60,50,450,0.3050847457627119,65,90,50,85,45,55,390,0.371900826446281,2.0
70,90,70,60,60,70,420,0.6390977443609023,55,47,52,40,40,41,275,0.16806722689075632,1.0
70,95,85,55,65,70,440,0.5,55,85,55,50,55,60,360,0.4233576642335766,4.0
110,135,60,50,65,88,508,0.7744360902255639,28,25,25,45,35,40,198,0.16083916083916083,0.5
125,130,90,130,90,95,660,0.7734375,70,60,70,87,78,85,450,0.6228070175438597,2.0
70,80,70,80,70,110,480,0.6594202898550725,100,100,125,110,50,50,535,0.384,2.0
78,84,78,109,85,100,534,0.8646616541353384,60,50,70,50,90,65,385,0.39568345323741005,4.0
74,108,133,83,65,32,495,0.32142857142857145,100,123,75,57,75,80,510,0.6923076923076923,2.0
65,105,60,60,70,95,455,63.0,64,115,65,83,63,65,455,0.5323741007194245,0.0
45,100,135,65,135,45,525,0.29411764705882354,110,65,105,55,95,80,510,0.6258503401360545,0.5
95,75,80,100,110,30,490,0.24242424242424243,60,50,150,50,150,60,520,0.5206611570247934,0.5
55,55,55,85,55,30,335,0.1320754716981132,130,65,60,110,95,65,525,0.5227272727272727,1.0
100,73,83,73,83,55,467,0.371900826446281,65,47,55,73,75,85,400,0.65,1.0
85,110,76,65,82,56,474,0.3933333333333333,65,125,100,55,70,85,500,0.6532258064516129,0.5
35,40,100,90,55,35,355,0.1796875,55,130,115,50,50,75,475,0.5982142857142857,0.5
35,55,40,45,40,60,275,0.35714285714285715,50,85,85,55,55,50,380,0.3902439024390244,1.0
85,80,70,135,75,90,535,0.7006802721088435,70,105,105,50,40,20,390,0.33587786259541985,0.5
95,85,85,65,65,35,430,0.2571428571428571,1,90,45,30,30,40,236,0.33064516129032256,0.5
91,134,95,100,100,80,600,0.6304347826086957,75,110,110,110,105,80,590,0.656934306569343,0.0
66,41,77,61,87,23,355,0.12096774193548387,105,150,90,150,90,95,680,0.8285714285714286,0.5
80,110,60,150,130,70,600,0.5042016806722689,55,35,50,55,110,85,390,0.6277372262773723,1.0
70,60,70,87,78,85,450,0.6228070175438597,70,135,105,60,105,20,495,0.5806451612903226,0.25
40,80,35,35,45,70,305,0.4661016949152542,70,80,50,35,35,35,305,0.14,1.0
60,60,75,60,75,80,410,0.7321428571428571,84,86,88,111,101,60,530,0.4634146341463415,1.0
55,45,45,25,25,15,210,0.048,75,85,200,55,65,30,510,0.16778523489932887,4.0
60,69,95,69,95,36,424,0.2608695652173913,60,45,50,90,80,70,395,0.625,0.5
54,45,47,75,98,52,371,0.39669421487603307,50,95,90,95,90,180,600,0.9172413793103448,1.0
100,164,150,95,120,71,700,0.5645161290322581,90,65,65,40,40,15,315,0.19672131147540983,2.0
82,121,119,69,59,71,521,0.5394736842105263,80,120,80,120,80,100,580,0.8478260869565217,2.0
50,50,50,50,50,50,300,0.30708661417322836,41,64,45,50,50,50,300,0.36752136752136755,2.0
80,80,80,80,80,80,480,0.6015037593984962,90,95,95,70,90,70,510,0.5230769230769231,0.5
45,60,30,80,50,65,330,0.4603174603174603,75,123,67,95,85,95,540,0.7642276422764228,1.0
85,70,80,97,80,123,535,0.9304347826086956,65,125,100,60,70,70,490,0.6099290780141844,0.25
70,85,70,60,70,50,405,0.28378378378378377,55,45,50,45,65,80,340,0.5546218487394958,0.0
65,130,60,75,60,75,465,0.689922480620155,60,62,63,80,80,60,405,0.38016528925619836,1.0
74,48,76,83,81,104,466,0.7913043478260869,60,40,80,60,45,40,325,0.23529411764705882,0.5
65,90,50,85,45,55,390,0.371900826446281,40,20,30,40,80,55,265,0.22764227642276422,0.25
75,98,63,98,63,101,498,0.849624060150376,65,60,110,130,95,65,525,0.47761194029850745,1.0
95,70,73,95,90,60,483,0.3983739837398374,45,50,55,75,65,30,320,0.06293706293706294,0.5
70,60,62,80,82,60,414,0.4375,55,81,60,50,70,97,413,0.7214285714285714,1.0
65,95,75,55,55,85,430,0.6933333333333334,58,64,58,80,65,80,405,0.5423728813559322,2.0
85,90,80,70,80,130,535,0.9262295081967213,105,105,75,65,100,50,500,0.37593984962406013,0.5
50,85,55,65,65,90,410,0.7478260869565218,60,50,70,50,90,65,385,0.39568345323741005,2.0
80,110,120,130,90,70,600,0.6198347107438017,45,50,35,55,75,40,300,0.21367521367521367,0.25
92,105,90,125,90,98,600,0.8217054263565892,65,90,122,58,75,84,494,0.71875,2.0
90,92,75,92,85,60,494,0.49586776859504134,108,170,115,120,95,92,700,0.7083333333333334,4.0
89,124,80,55,80,55,483,0.5714285714285714,45,50,55,75,65,30,320,0.06293706293706294,1.0
120,100,85,30,85,45,465,0.22448979591836735,70,90,45,15,45,50,315,0.3629032258064516,1.0
40,35,30,120,70,105,400,0.6692307692307692,53,54,53,37,46,45,288,0.3090909090909091,0.0
35,20,65,40,65,20,245,0.02459016393442623,71,82,64,64,59,112,452,0.9327731092436975,1.0
10,55,25,35,45,95,265,0.5396825396825397,62,50,58,73,54,72,369,0.4435483870967742,2.0
36,50,50,65,60,44,305,0.16363636363636364,50,55,50,36,30,43,264,0.2922077922077922,2.0
60,40,80,60,45,40,325,0.23529411764705882,71,95,85,110,95,79,535,0.664,1.0
35,20,65,40,65,20,245,0.02459016393442623,70,90,90,135,90,125,600,0.9401709401709402,2.0
60,60,75,60,75,80,410,0.7321428571428571,105,140,95,55,65,45,505,0.3,1.0
55,70,55,40,55,85,360,0.7073170731707317,80,110,120,130,90,70,600,0.6198347107438017,1.0
64,66,68,81,76,50,405,0.25190839694656486,67,57,55,77,55,114,425,0.8879310344827587,1.0
50,20,55,25,25,30,205,0.09774436090225563,55,47,52,40,40,41,275,0.16806722689075632,0.5
51,65,65,80,75,59,395,0.4365079365079365,89,125,90,115,80,101,600,0.8725490196078431,4.0
50,50,95,40,50,35,320,0.20279720279720279,80,80,80,80,80,80,480,0.5606060606060606,1.0
73,100,60,100,60,65,458,0.42657342657342656,76,25,45,67,55,24,292,0.0390625,1.0
60,60,50,40,50,75,335,0.5882352941176471,50,75,70,35,70,48,348,0.29357798165137616,1.0
70,120,65,45,85,125,510,0.9747899159663865,90,65,65,40,40,15,315,0.19672131147540983,1.0
45,25,50,25,25,35,205,0.13076923076923078,55,130,115,50,50,75,475,0.5982142857142857,1.0
60,85,42,85,42,91,405,0.8227848101265823,60,85,69,65,79,80,438,0.576,1.0
85,135,130,60,80,25,515,0.40540540540540543,40,45,35,65,55,70,310,0.4482758620689655,1.0
78,70,61,50,61,100,420,0.8145161290322581,50,120,53,35,110,87,455,0.640625,1.0
66,117,70,40,50,67,410,0.4573643410852713,35,65,35,65,35,65,300,0.46621621621621623,1.0
60,50,70,50,90,65,385,0.39568345323741005,78,92,75,74,63,118,500,0.8842975206611571,0.25
42,52,67,39,56,50,306,0.2868217054263566,50,100,150,100,150,50,600,0.37142857142857144,2.0
30,45,59,30,39,57,260,0.2803030303030303,60,50,70,50,90,65,385,0.39568345323741005,0.25
62,55,52,109,94,109,481,0.7833333333333333,70,95,125,65,75,45,475,0.33613445378151263,0.5
90,93,55,70,55,55,418,0.3819444444444444,114,85,70,85,80,30,464,0.2066115702479339,1.0
64,165,75,93,83,75,555,0.6587301587301587,80,82,83,100,100,80,525,0.6742424242424242,1.0
95,65,65,110,130,60,525,0.4016393442622951,110,135,60,50,65,88,508,0.7744360902255639,0.5
110,135,60,50,65,88,508,0.7744360902255639,43,30,55,40,65,97,330,0.6030534351145038,0.5
85,105,100,79,83,78,530,0.5869565217391305,78,65,68,112,154,75,552,0.628099173553719,1.0
50,50,40,30,30,50,250,0.2781954887218045,97,165,60,65,50,58,495,0.3902439024390244,2.0
65,83,57,95,85,105,490,0.8914728682170543,90,85,100,95,125,85,580,0.6834532374100719,2.0
70,80,70,80,70,110,480,0.6594202898550725,44,48,65,50,64,43,314,0.1623931623931624,0.5
35,35,35,35,35,35,210,0.13385826771653545,64,165,75,93,83,75,555,0.6587301587301587,0.0
70,85,65,105,85,120,530,0.9262295081967213,41,56,40,62,44,71,314,0.568,2.0
50,70,50,50,50,40,310,0.16296296296296298,60,85,60,50,50,125,430,0.9090909090909091,1.0
95,65,65,110,130,60,525,0.4016393442622951,70,60,70,87,78,85,450,0.6228070175438597,1.0
30,30,42,30,42,70,244,0.4230769230769231,70,60,125,115,70,55,495,0.35507246376811596,0.5
80,160,80,130,80,100,630,0.8455284552845529,111,83,68,92,82,39,475,0.1774193548387097,0.5
45,60,40,70,50,45,310,0.2846715328467153,60,130,80,60,60,70,460,0.5153846153846153,2.0
68,85,65,165,135,100,618,0.8083333333333333,70,80,65,90,65,85,455,0.578125,0.5
40,60,40,40,40,30,250,0.0948905109489051,45,40,60,40,75,50,310,0.2926829268292683,0.5
75,110,110,110,105,80,590,0.656934306569343,70,90,90,135,90,125,600,0.9401709401709402,2.0
90,92,87,75,85,76,505,0.5409836065573771,85,90,80,70,80,130,535,0.9262295081967213,0.0
105,95,75,85,75,74,509,0.5714285714285714,100,77,77,128,128,90,600,0.6901408450704225,1.0
45,95,50,40,50,75,355,0.54,91,72,90,129,90,108,580,0.8925619834710744,0.25
123,77,72,99,92,58,521,0.4621212121212121,68,72,78,38,42,32,330,0.23809523809523808,1.0
30,80,90,55,45,55,355,0.4295774647887324,40,55,99,40,79,47,360,0.26262626262626265,2.0
60,80,110,50,80,45,425,0.2833333333333333,90,132,105,132,105,30,594,0.4246575342465753,0.5
77,59,50,67,63,46,362,0.23140495867768596,60,70,65,125,105,90,515,0.6911764705882353,2.0
80,95,82,60,82,75,474,0.6,106,190,100,154,100,130,780,0.9259259259259259,1.0
30,45,55,70,55,85,340,0.5633802816901409,35,70,55,45,55,25,285,0.09420289855072464,0.5
80,185,115,40,105,75,600,0.6230769230769231,85,115,80,105,80,50,515,0.3063063063063063,1.0
80,70,65,80,120,100,515,0.8034188034188035,105,30,105,140,105,55,540,0.3524590163934426,2.0
89,124,80,55,80,55,483,0.5714285714285714,74,108,133,83,65,32,495,0.32142857142857145,2.0
115,45,20,45,25,20,270,0.11538461538461539,64,115,65,83,63,65,455,0.5323741007194245,0.0
75,38,38,56,56,67,330,0.5263157894736842,45,55,45,65,45,75,330,0.5692307692307692,2.0
75,100,63,80,63,116,497,0.9345794392523364,100,100,100,100,100,100,600,0.8778625954198473,1.0
91,90,72,90,129,108,580,0.896,70,62,67,55,55,56,365,0.38513513513513514,0.25
68,85,65,165,135,100,618,0.8083333333333333,65,125,100,55,70,85,500,0.6532258064516129,1.0
75,95,95,95,95,85,540,0.6470588235294118,45,100,135,65,135,45,525,0.29411764705882354,1.0
75,55,70,55,95,110,460,0.8444444444444444,78,70,61,50,61,100,420,0.8145161290322581,1.0
53,54,53,37,46,45,288,0.3090909090909091,110,160,110,80,110,100,670,0.8591549295774648,1.0
40,45,40,65,40,65,295,0.5661764705882353,90,55,75,60,75,30,385,0.13970588235294118,1.0
45,30,15,85,65,65,305,0.36220472440944884,70,140,230,60,80,50,630,0.32432432432432434,0.25
50,64,50,45,50,41,300,0.22727272727272727,80,120,70,110,70,80,530,0.6422764227642277,2.0
75,80,60,65,90,102,472,0.8625954198473282,55,104,105,94,75,52,485,0.36363636363636365,1.0
55,40,40,65,45,35,280,0.16428571428571428,90,120,120,60,60,50,500,0.35294117647058826,0.0
50,50,40,30,30,50,250,0.2781954887218045,65,40,70,80,140,70,465,0.5954198473282443,0.0
64,165,75,93,83,75,555,0.6587301587301587,86,68,72,109,66,106,507,0.8099173553719008,0.0
70,90,110,60,75,95,500,0.7333333333333333,60,80,95,70,85,50,440,0.2231404958677686,0.0
100,100,90,150,140,90,670,0.71875,60,55,50,40,55,45,305,0.22377622377622378,1.0
85,120,70,50,60,100,485,0.8308823529411765,75,69,72,114,100,104,534,0.8253968253968254,1.0
40,27,60,37,50,66,280,0.36220472440944884,85,50,95,120,115,80,545,0.5793650793650794,0.5
50,53,48,53,48,64,316,0.4076923076923077,73,95,62,85,65,85,465,0.6666666666666666,1.0
35,35,35,35,35,35,210,0.13385826771653545,80,80,80,80,80,80,480,0.5606060606060606,1.0
70,120,65,45,85,125,510,0.9747899159663865,73,95,62,85,65,85,465,0.6666666666666666,1.0
35,65,35,65,35,65,300,0.46621621621621623,100,70,70,65,65,45,415,0.1897810218978102,1.0
75,95,122,58,75,69,494,0.5725806451612904,110,160,110,80,110,100,670,0.8591549295774648,0.0
50,50,40,50,40,64,294,0.45588235294117646,60,85,69,65,79,80,438,0.576,1.0
30,80,90,55,45,55,355,0.4295774647887324,50,55,50,36,30,43,264,0.2922077922077922,2.0
81,102,77,85,75,85,505,0.5642857142857143,70,80,102,80,102,40,474,0.2677165354330709,0.0
58,70,45,40,45,42,300,0.25925925925925924,65,150,40,15,80,145,495,0.9663865546218487,1.0
100,100,100,100,100,100,600,0.8602941176470589,80,70,70,90,100,70,480,0.5609756097560976,1.0
106,190,100,154,100,130,780,0.9259259259259259,76,25,45,67,55,24,292,0.0390625,0.25
67,125,40,30,30,58,350,0.3431372549019608,60,85,60,85,60,55,405,0.3673469387755102,1.0
55,75,50,40,40,80,340,0.6302521008403361,150,160,100,95,65,100,670,0.8866666666666667,1.0
52,65,55,58,62,60,352,0.4482758620689655,62,48,54,63,60,68,355,0.5178571428571429,1.0
70,80,70,80,70,110,480,0.6594202898550725,75,105,75,105,75,45,480,0.3274336283185841,0.5
65,76,84,54,96,105,480,0.9008264462809917,58,89,77,45,45,48,362,0.3177570093457944,0.5
68,65,65,125,115,80,518,0.6461538461538462,76,104,71,104,71,108,534,0.912751677852349,1.0
91,90,72,90,129,108,580,0.896,50,92,108,92,108,35,485,0.2457627118644068,0.0
73,76,75,81,100,100,505,0.8110236220472441,75,80,85,110,90,50,490,0.3548387096774194,2.0
60,90,70,60,120,40,440,0.27419354838709675,45,67,60,35,50,63,320,0.5128205128205128,1.0
60,60,60,35,35,30,280,0.11194029850746269,55,20,35,20,45,75,250,0.37681159420289856,1.0
80,110,60,150,130,70,600,0.5042016806722689,50,45,45,35,35,50,260,0.23529411764705882,0.0
95,145,130,120,90,120,700,0.9398496240601504,84,86,88,111,101,60,530,0.4634146341463415,0.25
60,75,100,55,80,50,420,0.3088235294117647,55,95,55,35,75,115,430,0.9380530973451328,0.0
60,50,70,50,90,65,385,0.39568345323741005,63,63,47,41,41,74,329,0.56,0.5
90,100,60,90,60,80,480,0.6422764227642277,95,117,184,44,46,28,514,0.2975206611570248,1.0
50,25,28,45,55,15,218,0.0625,64,51,23,51,23,28,240,0.11363636363636363,1.0
50,85,85,55,55,50,380,0.3902439024390244,68,65,65,125,115,80,518,0.6461538461538462,0.5
120,120,120,120,120,120,720,0.9344262295081968,50,180,20,180,20,150,600,0.9029850746268657,1.0
75,90,90,140,90,115,600,0.9481481481481482,75,80,85,110,90,50,490,0.3548387096774194,2.0
50,65,107,105,107,86,520,0.703125,105,180,100,180,100,115,780,0.9477611940298507,4.0
50,92,108,92,108,35,485,0.2457627118644068,79,100,80,110,90,121,580,0.968,1.0
106,110,90,154,90,130,680,0.926829268292683,60,80,50,40,40,30,300,0.15328467153284672,1.0
75,80,85,110,90,50,490,0.3548387096774194,90,50,34,60,44,70,348,0.6283185840707964,0.25
68,125,65,65,115,80,518,0.6277372262773723,60,25,35,70,80,60,330,0.3076923076923077,0.25
60,25,35,70,80,60,330,0.3076923076923077,45,100,135,65,135,45,525,0.29411764705882354,1.0
130,70,35,70,35,60,400,0.4017857142857143,85,115,80,105,80,50,515,0.3063063063063063,1.0
110,135,60,50,65,88,508,0.7744360902255639,123,77,72,99,92,58,521,0.4621212121212121,8.0
77,120,90,60,90,48,485,0.2785714285714286,130,70,35,70,35,60,400,0.4017857142857143,1.0
30,45,135,45,90,30,375,0.09285714285714286,40,30,35,45,40,55,245,0.31496062992125984,2.0
78,65,68,112,154,75,552,0.628099173553719,61,72,57,55,55,65,365,0.3984375,0.5
63,120,85,90,55,55,468,0.2809917355371901,75,87,63,87,63,98,473,0.865546218487395,0.5
55,75,85,25,25,15,280,0.1875,35,55,35,30,30,35,220,0.23684210526315788,1.0
45,22,60,27,30,29,213,0.07518796992481203,95,117,80,65,70,92,519,0.8409090909090909,2.0
10,55,25,35,45,95,265,0.5396825396825397,40,65,40,80,40,65,330,0.5038167938931297,1.0
91,90,129,90,72,108,580,0.9140625,55,68,64,45,55,31,318,0.11666666666666667,1.0
71,95,85,110,95,79,535,0.664,65,125,100,55,70,85,500,0.6532258064516129,1.0
43,70,48,50,60,38,309,0.2391304347826087,69,55,45,55,55,15,294,0.11666666666666667,0.25
120,70,120,75,130,85,600,0.6694915254237288,30,105,90,25,25,50,325,0.2773722627737226,1.0
50,65,90,35,35,15,290,0.14678899082568808,50,53,62,58,63,44,330,0.13709677419354838,1.0
70,80,70,80,70,110,480,0.6594202898550725,48,61,40,61,40,50,300,0.2543859649122807,1.0
60,48,45,43,90,42,328,0.21897810218978103,75,95,125,45,75,95,510,0.8257575757575758,2.0
20,10,230,10,230,5,505,0.0,40,30,35,50,70,55,280,0.28205128205128205,1.0
50,50,95,40,50,35,320,0.20279720279720279,60,40,50,75,85,95,405,0.6044776119402985,2.0
55,65,35,60,30,85,330,0.6126126126126126,85,70,80,97,80,123,535,0.9304347826086956,0.5
75,98,63,98,63,101,498,0.889763779527559,106,90,130,90,154,110,680,0.8699186991869918,1.0
103,60,126,80,126,50,545,0.36363636363636365,54,63,52,83,56,97,405,0.7697841726618705,1.0
45,30,50,55,65,45,290,0.208,85,105,100,79,83,78,530,0.5869565217391305,1.0
55,75,60,75,60,103,428,0.7982456140350878,60,130,80,60,60,70,460,0.5153846153846153,2.0
90,120,100,150,120,100,680,0.7718120805369127,70,90,110,60,75,95,500,0.7333333333333333,1.0
40,60,30,31,31,70,262,0.4492753623188406,86,92,88,68,75,73,482,0.6835443037974683,1.0
59,63,80,65,80,58,405,0.41843971631205673,45,30,50,55,65,45,290,0.208,1.0
75,90,50,110,80,95,500,0.7985611510791367,130,70,35,70,35,60,400,0.4017857142857143,0.5
60,115,105,65,70,80,495,0.7181818181818181,65,90,40,45,80,75,395,0.625,2.0
80,125,75,40,95,85,500,0.6911764705882353,125,120,90,170,100,95,700,0.78125,2.0
85,76,64,45,55,90,415,0.6739130434782609,100,120,100,150,120,90,680,0.728,1.0
70,40,50,55,50,25,290,0.061068702290076333,75,125,100,70,80,45,495,0.33035714285714285,2.0
109,66,84,81,99,32,471,0.2013888888888889,70,77,60,97,60,108,472,0.8394160583941606,0.5
59,74,50,35,50,35,303,0.3125,60,80,50,50,50,40,330,0.23853211009174313,0.0
40,45,35,65,55,70,310,0.4482758620689655,80,50,100,100,200,50,580,0.2357142857142857,1.0
86,92,88,68,75,73,482,0.6835443037974683,40,50,45,70,45,70,320,0.5517241379310345,1.0
120,70,120,75,130,85,600,0.6694915254237288,50,85,55,65,65,90,410,0.7478260869565218,1.0
95,110,80,70,80,50,485,0.37209302325581395,45,50,55,75,65,30,320,0.06293706293706294,2.0
60,50,70,50,90,65,385,0.39568345323741005,35,35,40,35,55,50,250,0.40336134453781514,2.0
49,55,42,42,37,85,310,0.6068376068376068,65,65,60,130,95,110,525,0.823943661971831,1.0
71,95,85,110,95,79,535,0.664,82,121,119,69,59,71,521,0.5394736842105263,2.0
50,65,64,44,48,43,314,0.2196969696969697,50,53,48,53,48,64,316,0.46153846153846156,2.0
80,80,50,40,50,25,325,0.176056338028169,76,104,71,104,71,108,534,0.912751677852349,1.0
30,42,118,42,88,30,350,0.112,60,30,30,36,56,50,262,0.32432432432432434,2.0
73,100,60,100,60,65,458,0.42657342657342656,75,75,55,105,85,30,425,0.1619718309859155,2.0
83,80,80,135,80,121,579,0.9444444444444444,70,55,75,45,65,60,370,0.45901639344262296,1.0
80,185,115,40,105,75,600,0.6230769230769231,70,100,115,30,65,30,410,0.24390243902439024,2.0
60,60,60,85,85,85,435,0.631578947368421,65,125,100,60,70,70,490,0.6099290780141844,0.5
50,65,107,105,107,86,520,0.7313432835820896,75,110,110,110,105,80,590,0.656934306569343,0.25
55,50,65,175,95,150,590,0.7818181818181819,89,125,90,115,80,101,600,0.8725490196078431,2.0
85,97,66,105,66,65,484,0.47107438016528924,150,80,44,90,54,80,498,0.625,1.0
100,123,75,57,75,80,510,0.6923076923076923,50,50,120,80,80,30,410,0.07258064516129033,0.25
82,121,119,69,59,71,521,0.5394736842105263,60,100,115,70,85,90,520,0.7557251908396947,0.25
20,25,45,70,90,60,310,0.30833333333333335,85,110,76,65,82,56,474,0.3933333333333333,1.0
65,65,60,110,95,130,525,0.9253731343283582,91,90,129,90,72,108,580,0.9140625,1.0
86,92,88,68,75,73,482,0.6835443037974683,90,120,75,60,60,45,450,0.29411764705882354,0.5
78,65,68,112,154,75,552,0.628099173553719,86,68,72,109,66,106,507,0.8099173553719008,0.5
74,94,131,54,116,20,489,0.4485294117647059,54,78,103,53,45,22,355,0.23255813953488372,4.0
64,165,75,93,83,75,555,0.6587301587301587,50,80,95,10,45,10,290,0.232,1.0
40,35,30,120,70,105,400,0.6692307692307692,75,89,85,55,65,36,405,0.29545454545454547,1.0
55,40,50,65,85,40,335,0.3181818181818182,110,80,90,95,90,65,530,0.5033557046979866,0.5
60,100,115,70,85,90,520,0.7557251908396947,68,72,78,38,42,32,330,0.23809523809523808,1.0
90,120,100,150,120,100,680,0.7718120805369127,110,78,73,76,71,60,468,0.3333333333333333,1.0
50,75,45,40,45,60,315,0.4380165289256198,45,75,60,40,30,50,300,0.304,1.0
103,60,126,80,126,50,545,0.36363636363636365,80,115,80,65,55,93,488,0.7846153846153846,1.0
50,50,77,95,77,91,440,0.5916666666666667,90,55,75,60,75,30,385,0.13970588235294118,0.0
50,105,125,55,95,50,480,0.375886524822695,75,75,75,125,95,40,485,0.15671641791044777,1.0
55,50,45,135,95,120,500,0.7714285714285715,86,68,72,109,66,106,507,0.8099173553719008,1.0
70,80,70,80,70,110,480,0.6594202898550725,60,80,110,50,80,45,425,0.2833333333333333,2.0
85,105,55,85,50,115,495,0.9032258064516129,30,80,90,55,45,55,355,0.4295774647887324,1.0
126,131,95,131,98,99,680,0.8102189781021898,80,125,75,40,95,85,500,0.6911764705882353,2.0
125,120,90,170,100,95,700,0.78125,42,52,67,39,56,50,306,0.2868217054263566,0.5
60,65,80,170,95,130,600,0.8625954198473282,45,30,50,55,65,45,290,0.208,2.0
64,51,23,51,23,28,240,0.11363636363636363,99,68,83,72,87,51,460,0.417910447761194,1.0
45,50,43,40,38,62,278,0.40441176470588236,75,90,50,110,80,95,500,0.7985611510791367,1.0
50,47,50,57,50,65,319,0.463768115942029,40,40,50,30,30,30,220,0.0873015873015873,1.0
120,70,120,75,130,85,600,0.6694915254237288,100,123,75,57,75,80,510,0.6923076923076923,1.0
60,90,55,90,80,110,485,0.8677685950413223,44,75,35,63,33,45,295,0.2647058823529412,1.0
60,60,75,60,75,80,410,0.7321428571428571,60,40,60,95,60,55,370,0.4222222222222222,0.0
75,69,72,114,100,104,534,0.8253968253968254,83,80,75,70,70,101,479,0.8615384615384616,1.0
91,134,95,100,100,80,600,0.6304347826086957,108,100,121,81,95,95,600,0.7476635514018691,2.0
78,65,68,112,154,75,552,0.628099173553719,58,70,45,40,45,42,300,0.25925925925925924,2.0
150,100,120,100,120,90,680,0.6666666666666666,45,60,40,70,50,45,310,0.2846715328467153,1.0
105,150,90,150,90,95,680,0.8285714285714286,50,65,64,44,48,43,314,0.2196969696969697,1.0
100,100,125,110,50,50,535,0.384,80,80,80,80,80,80,480,0.6015037593984962,1.0
44,38,33,61,43,70,289,0.5267857142857143,60,85,49,60,49,60,363,0.4444444444444444,0.5
35,45,160,30,45,70,385,0.48148148148148145,75,75,75,125,95,40,485,0.15671641791044777,1.0
65,75,90,97,123,44,494,0.1987179487179487,50,150,50,150,50,150,600,0.9339622641509434,1.0
55,40,50,65,85,40,335,0.3181818181818182,50,35,55,25,25,15,205,0.05263157894736842,1.0
59,66,70,44,55,41,335,0.25190839694656486,100,100,125,110,50,50,535,0.384,0.5
80,50,100,100,200,50,580,0.2357142857142857,30,45,135,45,90,30,375,0.09285714285714286,1.0
70,62,67,55,55,56,365,0.38513513513513514,97,165,60,65,50,58,495,0.3902439024390244,0.5
100,90,130,45,65,55,485,0.4253731343283582,50,100,150,100,150,50,600,0.37142857142857144,2.0
125,130,90,130,90,95,660,0.7734375,85,110,76,65,82,56,474,0.3933333333333333,2.0
70,80,65,90,65,85,455,0.578125,76,104,71,104,71,108,534,0.912751677852349,1.0
50,50,150,50,150,50,500,0.2571428571428571,90,85,100,95,125,85,580,0.6834532374100719,4.0
95,70,73,95,90,60,483,0.3983739837398374,75,125,230,55,95,30,610,0.3448275862068966,0.5
73,100,60,100,60,65,458,0.42657342657342656,50,50,77,95,77,91,440,0.5916666666666667,0.5
105,150,90,150,90,95,680,0.8285714285714286,106,150,70,194,120,140,780,0.952,1.0
80,80,90,110,130,110,600,0.8721804511278195,81,102,77,85,75,85,505,0.5642857142857143,4.0
70,60,125,115,70,55,495,0.35507246376811596,45,49,65,49,65,45,318,0.275,0.5
60,105,60,120,60,105,510,0.8849557522123894,60,70,65,125,105,90,515,0.6911764705882353,1.0
85,110,90,45,90,80,500,0.6206896551724138,55,95,115,45,45,35,390,0.2116788321167883,0.5
35,70,55,45,55,25,285,0.09420289855072464,80,45,65,90,110,80,470,0.5462962962962963,2.0
90,55,75,60,75,30,385,0.13970588235294118,50,75,75,65,65,50,380,0.4049586776859504,0.0
100,73,83,73,83,55,467,0.371900826446281,75,98,63,98,63,101,498,0.889763779527559,1.0
40,40,50,30,30,30,220,0.0873015873015873,90,60,60,40,40,40,330,0.29545454545454547,2.0
70,145,88,140,70,112,625,0.8888888888888888,70,110,70,115,70,90,525,0.75,1.0
60,40,80,60,45,40,325,0.23529411764705882,45,60,45,25,45,55,275,0.29,1.0
65,125,60,95,60,105,510,0.9236641221374046,20,10,55,15,20,80,200,0.17985611510791366,1.0
45,100,135,65,135,45,525,0.29411764705882354,70,84,70,65,70,51,410,0.2949640287769784,1.0
170,90,45,90,45,60,500,0.427536231884058,70,80,70,80,70,110,480,0.6594202898550725,1.0
100,90,130,45,65,55,485,0.4253731343283582,60,62,63,80,80,60,405,0.38016528925619836,0.5
80,80,80,80,80,80,480,0.5606060606060606,20,40,15,35,35,60,205,0.34285714285714286,1.0
100,50,50,76,96,70,442,0.5,58,109,112,48,48,109,484,0.8805970149253731,0.5
50,50,40,50,40,64,294,0.45588235294117646,20,25,45,70,90,60,310,0.30833333333333335,1.0
68,85,65,165,135,100,618,0.8083333333333333,60,60,60,105,105,105,495,0.848,1.0
71,82,64,64,59,112,452,0.9327731092436975,100,90,130,45,65,55,485,0.4253731343283582,0.5
50,35,55,25,25,15,205,0.05263157894736842,49,49,56,49,61,66,330,0.5190839694656488,1.0
50,65,107,105,107,86,520,0.6991150442477876,101,72,72,99,89,29,462,0.1937984496124031,1.0
105,95,80,40,80,90,490,0.753968253968254,63,60,55,50,50,71,349,0.5289256198347108,1.0
38,35,40,27,25,35,200,0.08208955223880597,60,150,50,150,50,60,520,0.5,0.25
50,180,20,180,20,150,600,0.9029850746268657,65,95,75,55,55,85,430,0.6933333333333334,2.0
150,120,100,120,100,90,680,0.664179104477612,50,120,53,35,110,87,455,0.640625,1.0
82,121,119,69,59,71,521,0.5394736842105263,38,35,40,27,25,35,200,0.08208955223880597,2.0
85,120,70,50,60,100,485,0.8308823529411765,80,125,75,40,95,85,500,0.6911764705882353,4.0
1,90,45,30,30,40,236,0.33064516129032256,55,75,50,40,40,80,340,0.6302521008403361,0.0
72,58,80,103,80,97,490,0.7171052631578947,80,160,60,170,130,80,680,0.6180555555555556,0.0
60,45,70,75,85,55,390,0.3008130081300813,55,55,45,63,45,45,308,0.25,1.0
35,40,100,90,55,35,355,0.1796875,45,80,100,35,37,28,325,0.3125,0.5
80,110,120,130,90,70,600,0.6198347107438017,50,53,48,53,48,64,316,0.46153846153846156,1.0
90,120,120,60,60,50,500,0.35294117647058826,50,65,64,44,48,43,314,0.2196969696969697,1.0
75,100,110,45,55,65,450,0.5333333333333333,60,40,60,95,60,55,370,0.4222222222222222,2.0
50,70,50,50,50,40,310,0.16296296296296298,40,35,30,120,70,105,400,0.6692307692307692,1.0
78,70,61,50,61,100,420,0.8145161290322581,45,53,70,40,60,42,310,0.25735294117647056,1.0
62,44,50,44,50,55,305,0.3629032258064516,30,105,90,25,25,50,325,0.2773722627737226,0.5
40,65,40,80,40,65,330,0.5038167938931297,123,100,62,97,81,68,531,0.4806201550387597,1.0
74,48,76,83,81,104,466,0.7322834645669292,60,60,60,60,60,60,360,0.38095238095238093,1.0
80,115,80,65,55,93,488,0.7846153846153846,60,40,60,95,60,55,370,0.4222222222222222,0.0
76,104,71,104,71,108,534,0.912751677852349,80,130,100,160,120,110,700,0.8981481481481481,0.25
60,50,100,85,70,65,430,0.47580645161290325,49,49,56,49,61,66,330,0.5190839694656488,0.5
70,80,70,80,70,110,480,0.6594202898550725,80,105,105,105,105,80,580,0.5939849624060151,2.0
83,80,80,135,80,121,579,0.9444444444444444,70,110,75,145,85,145,630,0.9444444444444444,2.0
65,150,40,15,80,145,495,0.9663865546218487,58,64,58,80,65,80,405,0.609271523178808,0.5
55,55,45,63,45,45,308,0.25,70,90,90,135,90,125,600,0.9401709401709402,1.0
80,160,80,130,80,100,630,0.8455284552845529,75,95,125,45,75,95,510,0.8257575757575758,0.5
85,120,70,50,60,100,485,0.8308823529411765,40,30,50,55,55,100,330,0.584070796460177,0.5
90,30,15,40,20,15,210,0.043478260869565216,36,50,50,65,60,44,305,0.16363636363636364,1.0
95,110,80,70,80,50,485,0.37209302325581395,61,78,95,56,58,57,405,0.40336134453781514,2.0
40,30,32,50,52,65,269,0.3671875,66,65,48,62,57,52,350,0.36220472440944884,1.0
35,85,45,35,35,75,310,0.6492537313432836,45,60,40,70,50,45,310,0.2846715328467153,1.0
70,40,50,55,50,25,290,0.061068702290076333,80,80,80,80,80,80,480,0.5606060606060606,0.25
106,190,100,154,100,130,780,0.9259259259259259,55,65,35,60,30,85,330,0.6126126126126126,1.0
59,63,80,65,80,58,405,0.41843971631205673,38,35,35,65,55,50,278,0.2647058823529412,1.0
60,59,85,79,105,36,424,0.16666666666666666,70,105,105,50,40,20,390,0.33587786259541985,2.0
62,48,66,59,57,49,341,0.33884297520661155,68,90,65,50,55,82,410,0.6165413533834586,2.0
83,106,65,86,65,85,490,0.6640625,75,75,130,75,130,95,580,0.7479674796747967,0.5
91,90,72,90,129,108,580,0.896,76,104,71,104,71,108,534,0.912751677852349,0.5
35,40,100,90,55,35,355,0.1796875,81,102,77,85,75,85,505,0.5642857142857143,1.0
80,120,70,110,70,80,530,0.6422764227642277,250,5,5,35,105,50,450,0.15306122448979592,2.0
35,65,35,65,35,65,300,0.46621621621621623,46,87,60,30,40,57,320,0.37777777777777777,0.5
38,35,35,65,55,50,278,0.2647058823529412,50,53,62,58,63,44,330,0.13709677419354838,1.0
100,77,77,128,128,90,600,0.6901408450704225,75,100,63,80,63,116,497,0.9345794392523364,1.0
61,84,65,70,70,70,420,0.5,95,70,73,95,90,60,483,0.3983739837398374,0.0
91,90,106,130,106,77,600,0.648854961832061,85,73,70,73,115,67,483,0.5126050420168067,1.0
50,45,45,35,35,50,260,0.23529411764705882,76,147,90,60,70,97,540,0.8267716535433071,1.0
85,100,122,58,75,54,494,0.3939393939393939,41,50,37,50,37,66,281,0.5175438596491229,0.5
20,10,55,15,20,80,200,0.17985611510791366,71,120,95,120,95,99,600,0.8203125,1.0
70,75,60,105,60,105,475,0.88,43,30,55,40,65,97,330,0.6030534351145038,2.0
50,75,70,35,70,48,348,0.29357798165137616,100,100,100,100,100,100,600,0.8602941176470589,1.0
70,75,80,135,80,135,575,0.917910447761194,50,55,50,36,30,43,264,0.2922077922077922,2.0
65,130,60,95,110,65,525,0.5303030303030303,45,45,55,45,55,63,308,0.4594594594594595,2.0
65,90,40,45,80,75,395,0.625,50,105,125,55,95,50,480,0.375886524822695,0.0
50,48,43,46,41,60,288,0.47297297297297297,100,150,120,120,100,90,680,0.6493506493506493,1.0
70,80,50,35,35,35,305,0.14,50,75,70,35,70,48,348,0.29357798165137616,2.0
120,100,85,30,85,45,465,0.22448979591836735,125,130,90,130,90,95,660,0.7734375,2.0
38,35,35,65,55,50,278,0.2647058823529412,80,145,150,105,110,110,700,0.8692307692307693,0.125
70,43,53,43,53,40,302,0.19090909090909092,80,145,150,105,110,110,700,0.8692307692307693,0.0
75,95,95,95,95,85,540,0.6470588235294118,95,65,110,60,130,65,525,0.5275590551181102,1.0
90,100,70,110,150,80,600,0.6037735849056604,95,117,184,44,46,28,514,0.2975206611570248,1.0
40,30,30,40,50,30,220,0.07936507936507936,75,95,95,95,95,85,540,0.6470588235294118,0.25
80,82,78,95,80,85,500,0.6869565217391305,70,60,70,87,78,85,450,0.6228070175438597,0.5
95,110,80,70,80,50,485,0.37209302325581395,54,66,70,44,55,46,335,0.4214876033057851,2.0
65,76,84,54,96,105,480,0.9008264462809917,50,40,85,40,65,25,305,0.08870967741935484,1.0
103,60,126,80,126,50,545,0.36363636363636365,100,100,125,110,50,50,535,0.384,1.0
45,63,37,65,55,95,360,0.8055555555555556,95,155,109,70,130,81,640,0.6788321167883211,2.0
55,55,45,63,45,45,308,0.25,45,63,37,65,55,95,360,0.8055555555555556,1.0
60,65,80,170,95,130,600,0.8625954198473282,50,70,160,70,160,90,600,0.7417218543046358,2.0
90,75,75,90,100,70,500,0.5462184873949579,75,90,90,140,90,115,600,0.9481481481481482,2.0
75,100,63,80,63,116,497,0.9345794392523364,65,76,84,54,96,105,480,0.9008264462809917,1.0
30,56,35,25,35,72,253,0.48148148148148145,50,75,70,35,70,48,348,0.29357798165137616,1.0
80,45,65,90,110,80,470,0.5462962962962963,90,65,65,40,40,15,315,0.19672131147540983,0.5
50,52,48,65,50,55,320,0.33098591549295775,90,50,34,60,44,70,348,0.6283185840707964,1.0
70,120,100,145,105,20,560,0.2824427480916031,35,45,160,30,45,70,385,0.48148148148148145,1.0
55,55,85,65,85,35,380,0.2014388489208633,100,110,90,85,90,60,535,0.47794117647058826,0.5
80,160,80,130,80,100,630,0.8455284552845529,100,120,120,150,100,90,680,0.7880794701986755,2.0
40,40,55,40,70,55,300,0.40939597315436244,35,20,65,40,65,20,245,0.02459016393442623,1.0
135,85,40,40,85,5,390,0.6864406779661016,65,90,50,85,45,55,390,0.371900826446281,1.0
50,50,120,80,80,30,410,0.07258064516129033,50,85,55,65,65,90,410,0.7478260869565218,1.0
55,95,55,35,75,115,430,0.9380530973451328,105,105,75,65,100,50,500,0.37593984962406013,1.0
95,60,79,100,125,81,540,0.6201550387596899,90,120,75,60,60,45,450,0.29411764705882354,1.0
75,98,63,98,63,101,498,0.849624060150376,95,75,80,100,110,30,490,0.24242424242424243,0.5
44,50,91,24,86,10,305,0.1981981981981982,60,75,85,100,85,115,520,0.8992248062015504,1.0
76,48,48,57,62,34,325,0.11688311688311688,58,64,58,80,65,80,405,0.609271523178808,2.0
64,115,65,83,63,65,455,0.5323741007194245,45,50,35,55,75,40,300,0.21367521367521367,1.0
85,60,65,135,105,100,550,0.7518248175182481,60,40,60,95,60,55,370,0.4222222222222222,0.125
50,180,20,180,20,150,600,0.9029850746268657,68,125,65,65,115,80,518,0.6277372262773723,0.5
60,79,105,59,85,36,424,0.17054263565891473,74,48,76,83,81,104,466,0.7913043478260869,2.0
110,160,110,80,110,100,670,0.8591549295774648,65,150,40,15,80,145,495,0.9663865546218487,1.0
70,55,65,95,85,70,440,0.5307692307692308,60,50,100,85,70,65,430,0.47580645161290325,2.0
103,93,67,71,61,84,479,0.7142857142857143,30,65,100,45,25,40,305,0.1891891891891892,1.0
60,60,40,65,45,35,305,0.15833333333333333,85,105,100,79,83,78,530,0.5869565217391305,0.5
85,105,55,85,50,115,495,0.9032258064516129,70,110,75,145,85,145,630,0.9444444444444444,0.25
60,79,105,59,85,36,424,0.17054263565891473,40,20,30,40,80,55,265,0.22764227642276422,0.0
100,123,75,57,75,80,510,0.6923076923076923,255,10,10,75,135,55,540,0.3125,1.0
60,45,50,90,80,70,395,0.625,65,90,122,58,75,84,494,0.71875,2.0
100,120,120,150,100,90,680,0.7880794701986755,80,185,115,40,105,75,600,0.6230769230769231,1.0
59,66,70,44,55,41,335,0.25190839694656486,35,55,40,45,40,60,275,0.35714285714285715,1.0
80,105,105,105,105,80,580,0.5939849624060151,50,50,150,50,150,50,500,0.2571428571428571,1.0
35,80,50,50,70,120,405,0.84375,30,35,30,100,35,80,310,0.4765625,2.0
120,100,85,30,85,45,465,0.22448979591836735,100,100,100,100,100,100,600,0.8805970149253731,1.0
71,82,64,64,59,112,452,0.9327731092436975,95,110,95,40,95,55,490,0.40336134453781514,1.0
45,45,55,45,55,63,308,0.4594594594594595,116,55,85,107,95,29,487,0.06818181818181818,1.0
40,70,40,35,40,60,285,0.392,91,72,90,129,90,108,580,0.8620689655172413,1.0
55,70,45,70,50,60,350,0.45,91,90,72,90,129,108,580,0.896,2.0
72,60,30,20,30,25,237,0.11570247933884298,70,120,100,145,105,20,560,0.2824427480916031,1.0
35,55,40,50,50,90,320,0.6838235294117647,80,70,70,90,100,70,480,0.5609756097560976,1.0
58,64,58,80,65,80,405,0.5423728813559322,54,78,103,53,45,22,355,0.23255813953488372,0.25
105,125,100,60,100,100,590,0.8359375,60,60,60,85,85,85,435,0.631578947368421,0.0
75,100,66,60,66,115,482,0.918918918918919,55,63,90,50,80,42,380,0.21138211382113822,1.0
130,70,35,70,35,60,400,0.4017857142857143,86,68,72,109,66,106,507,0.8099173553719008,2.0
58,64,58,80,65,80,405,0.5423728813559322,68,65,65,125,115,80,518,0.6461538461538462,1.0
120,100,85,30,85,45,465,0.22448979591836735,35,64,85,74,55,32,345,0.19827586206896552,1.0
55,40,40,65,45,35,280,0.16428571428571428,105,180,100,180,100,115,780,0.9477611940298507,1.0
90,95,95,70,90,70,510,0.5230769230769231,75,89,85,55,65,36,405,0.29545454545454547,0.5
250,5,5,35,105,50,450,0.15306122448979592,90,95,105,165,110,45,610,0.2890625,1.0
80,52,50,90,50,89,411,0.6666666666666666,71,95,85,110,95,79,535,0.664,1.0
60,150,50,150,50,60,520,0.5,58,64,58,80,65,80,405,0.609271523178808,0.5
60,60,60,85,85,85,435,0.631578947368421,55,63,90,50,80,42,380,0.21138211382113822,1.0
55,40,85,80,105,40,405,0.23622047244094488,80,135,85,70,95,150,615,0.9844961240310077,0.5
58,109,112,48,48,109,484,0.8805970149253731,30,42,118,42,88,30,350,0.112,0.5
90,85,100,95,125,85,580,0.6834532374100719,72,95,67,103,71,122,530,0.9606299212598425,0.5
40,40,50,30,30,30,220,0.0873015873015873,50,70,50,50,50,40,310,0.16296296296296298,2.0
49,66,70,44,55,51,335,0.4260869565217391,35,65,35,65,35,65,300,0.46621621621621623,2.0
70,70,115,130,90,60,535,0.5338983050847458,70,90,90,135,90,125,600,0.9401709401709402,1.0
35,85,45,35,35,75,310,0.6492537313432836,20,25,45,70,90,60,310,0.30833333333333335,1.0
75,69,72,114,100,104,534,0.8253968253968254,110,80,90,95,90,65,530,0.5033557046979866,1.0
100,128,90,77,77,128,600,0.959349593495935,41,56,40,62,44,71,314,0.568,1.0
45,100,45,45,45,10,290,0.2949640287769784,64,88,50,88,50,106,446,0.9111111111111111,1.0
58,50,145,95,105,30,483,0.2459016393442623,50,65,107,105,107,86,520,0.7313432835820896,1.0
76,25,45,67,55,24,292,0.0390625,70,80,102,80,102,40,474,0.2677165354330709,1.0
75,70,90,70,105,80,490,0.656,60,100,115,70,85,90,520,0.7557251908396947,0.25
80,85,95,30,30,25,345,0.2857142857142857,25,35,70,95,55,45,325,0.16783216783216784,2.0
45,85,70,40,40,60,340,0.5229357798165137,75,38,38,56,56,67,330,0.5263157894736842,0.25
55,40,85,80,105,40,405,0.23622047244094488,60,85,69,60,69,77,420,0.518796992481203,1.0
90,95,95,70,90,70,510,0.5230769230769231,37,25,41,25,41,25,194,0.08870967741935484,0.5
95,85,85,65,65,35,430,0.2571428571428571,50,105,79,35,110,76,455,0.6214285714285714,1.0
45,30,15,85,65,65,305,0.36220472440944884,45,75,60,40,30,50,300,0.304,2.0
90,95,105,165,110,45,610,0.2890625,55,50,45,135,95,120,500,0.7714285714285715,1.0
85,115,80,105,80,50,515,0.3063063063063063,75,95,122,58,75,69,494,0.5725806451612904,0.5
45,63,37,65,55,95,360,0.8055555555555556,50,95,180,85,45,70,525,0.5298507462686567,2.0
65,73,55,47,75,85,400,0.6846846846846847,95,95,85,125,65,55,520,0.3894736842105263,4.0
70,90,110,60,75,95,500,0.7333333333333333,40,20,30,40,80,55,265,0.22764227642276422,1.0
71,95,85,110,95,79,535,0.664,90,120,120,60,60,50,500,0.35294117647058826,2.0
55,69,85,32,35,28,304,0.09302325581395349,30,30,30,30,30,30,180,0.12612612612612611,2.0
50,75,75,65,65,50,380,0.4049586776859504,80,100,80,80,80,100,520,0.9051724137931034,1.0
125,170,100,120,90,95,700,0.77,40,65,40,80,40,65,330,0.5038167938931297,1.0
83,80,80,135,80,121,579,0.9444444444444444,60,50,40,85,75,95,405,0.7540983606557377,0.5
59,63,80,65,80,58,405,0.41843971631205673,50,160,110,160,110,110,700,0.8854961832061069,2.0
59,63,80,65,80,58,405,0.41843971631205673,40,20,30,40,80,55,265,0.22764227642276422,1.0
100,70,70,65,65,45,415,0.1897810218978102,61,72,57,55,55,65,365,0.3984375,1.0
64,66,68,81,76,50,405,0.25190839694656486,75,95,95,95,95,85,540,0.6470588235294118,0.25
72,85,70,65,70,58,420,0.41304347826086957,60,80,95,70,85,50,440,0.2231404958677686,0.5
60,70,65,125,105,90,515,0.6911764705882353,76,25,45,67,55,24,292,0.0390625,1.0
45,60,32,50,32,76,295,0.5925925925925926,55,75,85,25,25,15,280,0.1875,1.0
39,52,43,60,50,65,309,0.5041322314049587,78,65,68,112,154,75,552,0.628099173553719,1.0
60,50,70,80,80,140,480,0.8449612403100775,30,40,55,40,55,60,280,0.3237410071942446,1.0
130,65,60,110,95,65,525,0.5227272727272727,55,84,105,114,75,52,485,0.2890625,0.5
80,90,80,130,110,110,600,0.856,69,55,45,55,55,15,294,0.11666666666666667,2.0
30,40,70,70,25,60,295,0.41353383458646614,70,145,88,140,70,112,625,0.8888888888888888,1.0
89,125,90,115,80,101,600,0.8725490196078431,31,45,90,30,30,40,266,0.21929824561403508,1.0
105,140,55,30,55,95,480,0.8195488721804511,65,60,70,85,75,40,395,0.1796875,1.0
70,110,180,60,60,50,530,0.4117647058823529,50,25,28,45,55,15,218,0.0625,0.5
65,63,45,45,45,45,308,0.2595419847328244,68,125,65,65,115,80,518,0.6277372262773723,1.0
70,94,50,94,50,66,424,0.48148148148148145,123,77,72,99,92,58,521,0.4621212121212121,0.5
80,120,79,95,79,70,523,0.5833333333333334,70,100,115,30,65,30,410,0.24390243902439024,1.0
66,41,77,61,87,23,355,0.12096774193548387,80,90,80,130,110,110,600,0.856,0.5
95,155,109,70,130,81,640,0.6788321167883211,100,70,70,65,65,45,415,0.1897810218978102,1.0
50,65,85,35,35,55,325,0.32575757575757575,60,60,60,85,85,85,435,0.631578947368421,0.5
70,105,105,50,40,20,390,0.33587786259541985,65,95,75,55,55,85,430,0.6933333333333334,1.0
75,100,66,60,66,115,482,0.918918918918919,40,45,35,65,55,70,310,0.4482758620689655,1.0
65,63,45,45,45,45,308,0.2595419847328244,89,124,80,55,80,55,483,0.5714285714285714,1.0
55,40,40,65,45,35,280,0.16428571428571428,60,62,50,62,60,40,334,0.18181818181818182,0.5
62,48,66,59,57,49,341,0.33884297520661155,65,65,45,75,45,95,390,0.72,1.0
45,22,60,27,30,29,213,0.07518796992481203,65,150,60,115,60,115,565,0.935251798561151,2.0
45,35,50,70,50,30,280,0.15753424657534246,75,98,63,98,63,101,498,0.849624060150376,2.0
50,65,107,105,107,86,520,0.703125,40,50,45,70,45,70,320,0.5517241379310345,4.0
41,56,40,62,44,71,314,0.568,69,55,45,55,55,15,294,0.11666666666666667,0.5
63,60,55,50,50,71,349,0.5289256198347108,95,65,110,60,130,65,525,0.5275590551181102,1.0
75,100,66,60,66,115,482,0.918918918918919,40,55,70,45,60,30,300,0.10619469026548672,0.5
65,65,65,50,50,90,385,0.72,90,120,100,150,120,100,680,0.7718120805369127,0.25
60,80,50,50,50,40,330,0.23853211009174313,125,120,90,170,100,95,700,0.78125,1.0
39,52,43,60,50,65,309,0.5041322314049587,50,85,55,65,65,90,410,0.7478260869565218,0.5
65,40,50,125,60,30,370,0.07258064516129033,80,185,115,40,105,75,600,0.6230769230769231,1.0
74,48,76,83,81,104,466,0.7913043478260869,80,115,80,65,55,93,488,0.7846153846153846,1.0
45,75,60,40,30,50,300,0.304,55,68,64,45,55,31,318,0.11666666666666667,1.0
70,140,70,110,65,105,560,0.95,41,64,45,50,50,50,300,0.36752136752136755,0.5
65,80,140,40,70,70,465,0.5223880597014925,130,85,80,85,95,60,535,0.43884892086330934,1.0
75,95,125,45,75,95,510,0.8257575757575758,95,100,85,108,70,70,528,0.5652173913043478,1.0
45,30,50,65,50,45,285,0.13821138211382114,60,69,95,69,95,36,424,0.2608695652173913,0.5
40,50,90,30,55,65,330,0.44680851063829785,55,45,50,45,65,80,340,0.5546218487394958,2.0
60,100,85,80,85,100,510,0.7007874015748031,43,80,65,50,35,35,308,0.14193548387096774,1.0
60,90,140,50,50,40,430,0.2535211267605634,60,50,50,60,70,50,340,0.28346456692913385,0.5
100,150,110,95,110,70,635,0.5923076923076923,75,65,55,65,55,69,384,0.43548387096774194,1.0
65,70,60,65,65,115,440,0.8583333333333333,50,160,110,160,110,110,700,0.8854961832061069,0.5
66,117,70,40,50,67,410,0.4573643410852713,106,110,90,154,90,130,680,0.926829268292683,1.0
70,85,140,85,70,20,470,0.272,55,70,55,40,55,85,360,0.7073170731707317,1.0
40,55,99,40,79,47,360,0.26262626262626265,50,75,45,40,45,60,315,0.4380165289256198,1.0
65,60,110,130,95,65,525,0.47761194029850745,130,70,35,70,35,60,400,0.4017857142857143,0.5
150,100,120,100,120,90,680,0.6666666666666666,75,75,55,105,85,30,425,0.1619718309859155,1.0
40,55,30,30,30,60,245,0.43548387096774194,90,132,105,132,105,30,594,0.4246575342465753,2.0
125,130,90,130,90,95,660,0.7734375,65,130,60,75,60,75,465,0.689922480620155,1.0
100,134,110,95,100,61,600,0.4057971014492754,50,52,48,65,50,55,320,0.33098591549295775,1.0
80,50,100,100,200,50,580,0.2357142857142857,80,82,83,100,100,80,525,0.6742424242424242,2.0
60,95,80,60,80,30,405,0.19480519480519481,68,125,65,65,115,80,518,0.6277372262773723,1.0
100,120,100,150,120,90,680,0.728,75,75,60,83,60,60,413,0.39344262295081966,0.5
36,50,50,65,60,44,305,0.16363636363636364,70,94,50,94,50,66,424,0.48148148148148145,2.0
105,140,55,30,55,95,480,0.8195488721804511,109,66,84,81,99,32,471,0.2013888888888889,1.0
55,65,35,60,30,85,330,0.6126126126126126,65,80,65,35,65,60,370,0.38405797101449274,1.0
106,190,100,154,100,130,780,0.9259259259259259,80,160,60,170,130,80,680,0.6180555555555556,0.0
30,40,55,40,55,60,280,0.3237410071942446,60,80,50,50,50,40,330,0.23853211009174313,2.0
60,55,50,40,55,45,305,0.22377622377622378,60,85,42,85,42,91,405,0.8227848101265823,1.0
71,120,95,120,95,99,600,0.8203125,105,125,100,60,100,100,590,0.8359375,1.0
1,90,45,30,30,40,236,0.33064516129032256,65,75,105,35,65,85,430,0.6940298507462687,0.5
54,45,47,75,98,52,371,0.39669421487603307,55,65,95,95,45,85,440,0.6610169491525424,1.0
80,95,82,60,82,75,474,0.6,60,79,105,59,85,36,424,0.17054263565891473,0.5
50,65,85,35,35,55,325,0.32575757575757575,60,70,105,70,120,75,500,0.5983606557377049,1.0
40,35,30,120,70,105,400,0.6692307692307692,62,50,58,73,54,72,369,0.4435483870967742,1.0
60,45,70,75,85,55,390,0.3008130081300813,90,75,85,115,90,55,510,0.3445378151260504,1.0
75,95,125,45,75,95,510,0.8257575757575758,108,170,115,120,95,92,700,0.7083333333333334,1.0
40,45,65,100,120,90,460,0.5588235294117647,60,60,40,65,45,35,305,0.15833333333333333,1.0
43,30,55,40,65,97,330,0.6030534351145038,80,80,80,80,80,80,480,0.5606060606060606,0.5
100,73,83,73,83,55,467,0.371900826446281,100,103,75,120,75,127,600,0.940677966101695,2.0
45,30,40,105,50,20,290,0.031007751937984496,100,90,130,45,65,55,485,0.4253731343283582,1.0
50,150,50,150,50,150,600,0.9339622641509434,50,65,45,85,65,95,405,0.7238095238095238,1.0
71,73,88,120,89,59,500,0.43537414965986393,60,55,145,75,150,40,525,0.2,2.0
78,70,61,50,61,100,420,0.8145161290322581,45,25,50,25,25,35,205,0.13076923076923078,1.0
60,40,50,75,85,95,405,0.6044776119402985,50,70,50,50,50,70,340,0.5645161290322581,0.0
85,80,70,135,75,90,535,0.7006802721088435,40,55,30,30,30,85,270,0.688,1.0
36,50,50,65,60,44,305,0.16363636363636364,50,65,107,105,107,86,520,0.7758620689655172,0.5
83,80,75,70,70,101,479,0.8615384615384616,57,24,86,24,86,23,300,0.12727272727272726,0.25
50,120,53,35,110,87,455,0.640625,38,35,40,27,25,35,200,0.08208955223880597,0.5
40,50,45,70,45,70,320,0.5517241379310345,40,45,40,35,35,56,251,0.373015873015873,1.0
100,100,80,60,60,50,450,0.3050847457627119,70,90,70,60,60,70,420,0.6390977443609023,1.0
65,125,100,60,70,70,490,0.6099290780141844,95,117,184,44,46,28,514,0.2975206611570248,2.0
55,112,45,74,45,70,401,0.559322033898305,79,105,70,145,80,101,580,0.8608695652173913,1.0
100,180,160,150,90,90,770,0.7520661157024794,80,110,120,130,90,70,600,0.6198347107438017,0.5
60,100,85,80,85,100,510,0.7007874015748031,45,50,35,55,75,40,300,0.21367521367521367,1.0
43,30,55,40,65,97,330,0.6030534351145038,35,55,35,30,30,35,220,0.23684210526315788,1.0
55,40,50,65,85,40,335,0.3181818181818182,73,115,60,60,60,90,458,0.6694915254237288,0.0
85,135,130,60,80,25,515,0.40540540540540543,75,80,60,65,90,102,472,0.8625954198473282,1.0
91,134,95,100,100,80,600,0.6304347826086957,38,35,35,65,55,50,278,0.2647058823529412,0.0
70,60,125,115,70,55,495,0.35507246376811596,105,140,55,30,55,95,480,0.8195488721804511,4.0
103,93,67,71,61,84,479,0.7142857142857143,68,65,65,125,115,80,518,0.6461538461538462,2.0
95,117,184,44,46,28,514,0.2975206611570248,59,66,70,44,55,41,335,0.25190839694656486,2.0
55,95,55,35,75,115,430,0.9380530973451328,70,83,50,37,50,60,350,0.3360655737704918,2.0
45,95,50,40,50,75,355,0.54,64,115,65,83,63,65,455,0.5323741007194245,0.5
65,47,55,73,75,85,400,0.65,106,90,130,90,154,110,680,0.8699186991869918,1.0
30,40,70,70,25,60,295,0.41353383458646614,60,90,70,60,120,40,440,0.27419354838709675,1.0
105,95,75,85,75,74,509,0.5714285714285714,50,70,160,70,160,90,600,0.7417218543046358,1.0
60,85,42,85,42,91,405,0.8227848101265823,70,55,75,45,65,60,370,0.45901639344262296,0.5
45,45,35,20,30,20,195,0.07246376811594203,50,65,107,105,107,86,520,0.703125,1.0
60,30,30,36,56,50,262,0.32432432432432434,75,69,72,114,100,104,534,0.8253968253968254,1.0
78,52,60,63,65,23,341,0.06015037593984962,54,45,47,75,98,52,371,0.39669421487603307,1.0
50,65,107,105,107,86,520,0.7313432835820896,110,130,80,70,60,80,530,0.5862068965517241,0.0
110,123,65,100,65,65,528,0.5217391304347826,65,75,105,35,65,85,430,0.6940298507462687,0.5
73,100,60,100,60,65,458,0.42657342657342656,45,30,50,55,65,45,290,0.208,1.0
75,90,140,60,60,40,465,0.3008130081300813,80,80,80,80,80,80,480,0.6015037593984962,2.0
57,24,86,24,86,23,300,0.12727272727272726,50,70,160,70,160,90,600,0.7417218543046358,0.5
105,140,95,55,65,45,505,0.3,45,55,39,35,39,42,255,0.18518518518518517,2.0
35,45,160,30,45,70,385,0.48148148148148145,60,48,45,43,90,42,328,0.21897810218978103,1.0
45,100,135,65,135,45,525,0.29411764705882354,80,82,100,83,100,80,525,0.6821705426356589,1.0
65,47,55,73,75,85,400,0.65,100,50,80,60,80,50,420,0.34375,0.5
70,80,50,35,35,35,305,0.14,100,150,120,120,100,90,680,0.6493506493506493,1.0
70,75,60,105,60,105,475,0.88,60,150,50,150,50,60,520,0.5,1.0
40,60,30,31,31,70,262,0.4492753623188406,91,90,106,130,106,77,600,0.648854961832061,0.25
60,85,49,60,49,60,363,0.4444444444444444,90,85,100,95,125,85,580,0.6834532374100719,2.0
80,80,90,110,130,110,600,0.8721804511278195,40,55,70,45,60,30,300,0.10619469026548672,0.25
110,160,110,80,110,100,670,0.8591549295774648,60,45,50,90,80,70,395,0.625,1.0
45,55,39,35,39,42,255,0.18518518518518517,44,75,35,63,33,45,295,0.2647058823529412,0.0
38,41,40,50,65,65,299,0.4108527131782946,59,74,50,35,50,35,303,0.3125,1.0
65,100,70,80,80,105,500,0.8666666666666667,60,80,50,40,40,30,300,0.15328467153284672,1.0
100,100,125,110,50,50,535,0.384,57,24,86,24,86,23,300,0.12727272727272726,0.5
60,65,60,130,75,110,500,0.7719298245614035,20,15,20,10,55,80,200,0.2682926829268293,1.0
20,10,55,15,20,80,200,0.17985611510791366,75,80,60,65,90,102,472,0.8625954198473282,1.0
75,98,63,98,63,101,498,0.889763779527559,60,50,150,50,150,60,520,0.5206611570247934,2.0
65,110,130,60,65,95,525,0.8278145695364238,170,90,45,90,45,60,500,0.427536231884058,2.0
66,117,70,40,50,67,410,0.4573643410852713,20,40,90,30,90,25,295,0.11363636363636363,1.0
45,90,20,65,20,65,305,0.5116279069767442,65,63,45,45,45,45,308,0.2595419847328244,2.0
100,100,100,100,100,100,600,0.8345864661654135,90,120,120,60,60,50,500,0.35294117647058826,4.0
40,45,35,65,55,70,310,0.4482758620689655,35,70,55,45,55,25,285,0.09420289855072464,0.25
45,45,55,45,55,63,308,0.4594594594594595,80,75,150,75,150,50,580,0.30973451327433627,0.5
65,100,70,80,80,105,500,0.8666666666666667,30,42,118,42,88,30,350,0.112,1.0
55,40,50,65,85,40,335,0.3181818181818182,80,100,80,80,80,100,520,0.9051724137931034,1.0
50,100,150,100,150,50,600,0.37142857142857144,35,64,85,74,55,32,345,0.19827586206896552,1.0
65,55,115,100,40,60,435,0.3798449612403101,115,140,130,55,55,40,535,0.4519230769230769,4.0
50,50,40,50,40,64,294,0.45588235294117646,50,50,50,50,50,50,300,0.30708661417322836,1.0
91,72,90,129,90,108,580,0.8620689655172413,40,60,40,40,40,30,250,0.0948905109489051,0.25
50,80,95,10,45,10,290,0.232,40,30,35,45,40,55,245,0.31496062992125984,2.0
65,55,115,100,40,60,435,0.3798449612403101,75,100,95,40,70,110,490,0.8717948717948718,1.0
80,80,80,80,80,80,480,0.5606060606060606,100,100,100,100,100,100,600,0.8345864661654135,0.5
90,55,75,60,75,30,385,0.13970588235294118,80,160,80,130,80,100,630,0.8455284552845529,1.0
83,106,65,86,65,85,490,0.6640625,30,45,55,70,55,85,340,0.5633802816901409,1.0
72,60,30,20,30,25,237,0.11570247933884298,40,60,30,31,31,70,262,0.4492753623188406,1.0
62,48,66,59,57,49,341,0.33884297520661155,59,66,70,44,55,41,335,0.25190839694656486,1.0
72,85,70,65,70,58,420,0.41304347826086957,80,80,80,55,55,90,440,0.6417910447761194,1.0
97,165,60,65,50,58,495,0.3902439024390244,109,66,84,81,99,32,471,0.2013888888888889,0.5
55,40,40,65,45,35,280,0.16428571428571428,58,64,58,80,65,80,405,0.609271523178808,1.0
55,69,85,32,35,28,304,0.09302325581395349,123,100,62,97,81,68,531,0.4806201550387597,2.0
109,66,84,81,99,32,471,0.2013888888888889,68,125,65,65,115,80,518,0.6277372262773723,1.0
85,105,85,40,50,40,405,0.211864406779661,71,82,64,64,59,112,452,0.9327731092436975,2.0
130,65,60,110,95,65,525,0.5227272727272727,85,70,80,97,80,123,535,0.9304347826086956,0.5
30,42,118,42,88,30,350,0.112,91,129,90,72,90,108,580,0.8536585365853658,1.0
80,82,78,95,80,85,500,0.6869565217391305,50,92,108,92,108,35,485,0.2457627118644068,1.0
90,100,60,90,60,80,480,0.6422764227642277,105,95,75,85,75,74,509,0.5714285714285714,4.0
45,49,49,65,65,45,318,0.2781954887218045,95,75,80,100,110,30,490,0.24242424242424243,2.0
50,52,48,65,50,55,320,0.33098591549295775,89,145,90,105,80,91,600,0.8549618320610687,2.0
95,80,105,40,70,100,490,0.8046875,85,110,90,45,90,80,500,0.6206896551724138,1.0
110,135,60,50,65,88,508,0.7744360902255639,64,88,50,88,50,106,446,0.9111111111111111,1.0
78,130,111,130,85,100,634,0.8561151079136691,85,97,66,105,66,65,484,0.47107438016528924,0.5
60,52,168,47,138,30,495,0.19834710743801653,53,54,53,37,46,45,288,0.3090909090909091,1.0
110,65,105,55,95,80,510,0.6258503401360545,30,40,70,70,25,60,295,0.41353383458646614,1.0
39,52,43,60,50,65,309,0.5041322314049587,50,25,28,45,55,15,218,0.0625,1.0
85,50,95,120,115,80,545,0.5793650793650794,20,25,45,70,90,60,310,0.30833333333333335,1.0
75,75,75,125,95,40,485,0.15671641791044777,50,48,43,46,41,60,288,0.47297297297297297,2.0
126,131,95,131,98,99,680,0.8294573643410853,30,45,55,70,55,85,340,0.5633802816901409,1.0
55,84,105,114,75,52,485,0.2890625,70,43,53,43,53,40,302,0.19090909090909092,1.0
80,110,120,130,90,70,600,0.6198347107438017,86,92,88,68,75,73,482,0.6835443037974683,1.0
80,105,65,60,75,130,515,0.9645390070921985,50,50,62,40,62,65,329,0.4188034188034188,1.0
64,78,52,78,52,81,405,0.6422764227642277,62,55,52,109,94,109,481,0.7833333333333333,2.0
70,45,48,60,65,35,323,0.15748031496062992,63,60,55,50,50,71,349,0.5289256198347108,1.0
65,60,110,130,95,65,525,0.47761194029850745,110,85,95,80,95,50,515,0.2713178294573643,1.0
20,10,230,10,230,5,505,0.0,105,95,75,85,75,74,509,0.5714285714285714,0.5
45,20,50,60,120,50,345,0.24074074074074073,55,55,55,85,55,30,335,0.1320754716981132,1.0
75,95,60,65,60,115,470,0.8778625954198473,105,180,100,180,100,115,780,0.9477611940298507,1.0
50,65,107,105,107,86,520,0.7272727272727273,65,125,100,60,70,70,490,0.6099290780141844,0.5
52,65,50,45,50,38,300,0.27419354838709675,70,130,100,55,80,65,500,0.608,0.5
86,68,72,109,66,106,507,0.8099173553719008,85,70,80,97,80,123,535,0.9304347826086956,0.5
90,70,80,70,95,70,475,0.5190839694656488,130,70,35,70,35,60,400,0.4017857142857143,0.25
41,50,37,50,37,66,281,0.5175438596491229,90,110,80,100,80,95,555,0.7982456140350878,1.0
90,30,15,40,20,15,210,0.043478260869565216,68,85,65,165,135,100,618,0.8083333333333333,1.0
68,165,95,65,115,110,618,0.8615384615384616,66,65,48,62,57,52,350,0.36220472440944884,1.0
80,82,100,83,100,80,525,0.6821705426356589,85,70,80,97,80,123,535,0.9304347826086956,0.25
100,100,80,60,60,50,450,0.3050847457627119,45,63,37,65,55,95,360,0.8055555555555556,2.0
55,20,35,20,45,75,250,0.37681159420289856,70,70,40,60,40,60,340,0.4247787610619469,1.0
75,80,95,90,100,50,490,0.2158273381294964,75,125,70,125,70,115,580,0.9037037037037037,1.0
90,65,65,40,40,15,315,0.19672131147540983,75,125,75,30,75,85,465,0.625,1.0
70,60,70,87,78,85,450,0.6228070175438597,55,95,115,45,45,35,390,0.2116788321167883,4.0
85,115,80,105,80,50,515,0.3063063063063063,108,100,121,81,95,95,600,0.7476635514018691,0.0
76,25,45,67,55,24,292,0.0390625,45,75,60,40,30,50,300,0.304,1.0
40,40,40,70,40,20,250,0.032520325203252036,49,49,56,49,61,66,330,0.5190839694656488,0.5
55,55,50,45,65,55,325,0.37373737373737376,65,50,70,95,80,65,425,0.4262295081967213,1.0
70,84,70,65,70,51,410,0.2949640287769784,35,35,40,35,55,50,250,0.40336134453781514,0.0
65,75,105,35,65,85,430,0.6940298507462687,80,95,82,60,82,75,474,0.6,2.0
52,65,55,58,62,60,352,0.4482758620689655,50,52,48,65,50,55,320,0.33098591549295775,1.0
39,52,43,60,50,65,309,0.5041322314049587,40,30,32,50,52,65,269,0.3671875,1.0
35,85,45,35,35,75,310,0.6492537313432836,65,60,110,130,95,65,525,0.47761194029850745,1.0
40,40,50,30,30,30,220,0.0873015873015873,90,92,75,92,85,60,494,0.49586776859504134,0.5
50,65,107,105,107,86,520,0.7313432835820896,80,100,80,80,80,100,520,0.9051724137931034,0.0
65,63,45,45,45,45,308,0.2595419847328244,71,73,88,120,89,59,500,0.43537414965986393,0.5
85,100,122,58,75,54,494,0.3939393939393939,50,70,100,40,40,30,330,0.2222222222222222,1.0
80,135,85,70,95,150,615,0.9844961240310077,100,75,115,90,115,85,580,0.6446280991735537,1.0
65,95,57,100,85,93,495,0.7441860465116279,73,76,75,81,100,100,505,0.8110236220472441,0.5
75,75,60,83,60,60,413,0.39344262295081966,35,45,160,30,45,70,385,0.48148148148148145,4.0
80,85,95,30,30,25,345,0.2857142857142857,80,82,83,100,100,80,525,0.6742424242424242,1.0
52,65,50,45,50,38,300,0.27419354838709675,50,150,50,150,50,150,600,0.9339622641509434,2.0
41,56,40,62,44,71,314,0.568,61,72,57,55,55,65,365,0.3984375,1.0
55,95,115,45,45,35,390,0.2116788321167883,60,60,50,40,50,75,335,0.5882352941176471,0.5
76,65,45,92,42,91,411,0.7449664429530202,68,165,95,65,115,110,618,0.8615384615384616,2.0
50,25,28,45,55,15,218,0.0625,105,105,75,65,100,50,500,0.37593984962406013,0.5
90,132,105,132,105,30,594,0.4246575342465753,35,20,65,40,65,20,245,0.02459016393442623,1.0
105,140,95,55,65,45,505,0.3,45,85,50,55,50,65,350,0.5076923076923077,1.0
62,77,62,50,42,65,358,0.4838709677419355,100,123,75,57,75,80,510,0.6923076923076923,1.0
75,125,75,30,75,85,465,0.625,60,85,60,50,50,125,430,0.9090909090909091,1.0
1,90,45,30,30,40,236,0.33064516129032256,30,45,135,45,90,30,375,0.09285714285714286,1.0
50,20,40,20,40,20,190,0.0962962962962963,80,70,65,80,120,100,515,0.8034188034188035,0.5
80,100,200,50,100,50,580,0.3472222222222222,70,84,70,65,70,51,410,0.2949640287769784,0.5
50,35,55,25,25,15,205,0.021739130434782608,30,45,135,45,90,30,375,0.09285714285714286,1.0
42,52,67,39,56,50,306,0.2868217054263566,135,85,40,40,85,5,390,0.6864406779661016,1.0
30,45,135,45,90,30,375,0.09285714285714286,55,55,85,65,85,35,380,0.2014388489208633,1.0
20,40,15,35,35,60,205,0.34285714285714286,90,30,15,40,20,15,210,0.043478260869565216,1.0
80,70,70,90,100,70,480,0.5609756097560976,30,40,70,70,25,60,295,0.41353383458646614,1.0
40,40,35,50,100,70,335,0.5031847133757962,61,78,95,56,58,57,405,0.40336134453781514,1.0
62,73,55,56,52,84,382,0.7244094488188977,100,100,80,60,60,50,450,0.3050847457627119,2.0
55,35,50,55,110,85,390,0.6277372262773723,72,60,30,20,30,25,237,0.11570247933884298,1.0
74,100,72,90,72,46,454,0.24561403508771928,35,35,40,35,55,50,250,0.40336134453781514,0.25
65,125,60,95,60,105,510,0.9236641221374046,64,115,65,83,63,65,455,0.5323741007194245,0.0
70,92,65,80,55,98,460,0.8090909090909091,170,90,45,90,45,60,500,0.427536231884058,0.5
100,50,80,60,80,50,420,0.34375,50,53,48,53,48,64,316,0.358974358974359,0.5
40,35,30,20,20,50,195,0.23423423423423423,65,60,70,85,75,40,395,0.1796875,1.0
50,50,62,40,62,65,329,0.4188034188034188,105,150,90,150,90,95,680,0.8285714285714286,1.0
70,84,70,65,70,51,410,0.2949640287769784,80,125,75,40,95,85,500,0.6911764705882353,0.5
80,100,200,50,100,50,580,0.3472222222222222,100,5,5,15,65,30,220,0.07692307692307693,1.0
71,73,88,120,89,59,500,0.43537414965986393,40,80,35,35,45,70,305,0.4661016949152542,1.0
66,41,77,61,87,23,355,0.12096774193548387,103,60,126,80,126,50,545,0.36363636363636365,1.0
130,85,80,85,95,60,535,0.43884892086330934,90,75,75,90,100,70,500,0.5462184873949579,0.25
58,50,145,95,105,30,483,0.2459016393442623,45,85,50,55,50,65,350,0.5076923076923077,1.0
120,120,120,120,120,120,720,0.9344262295081968,61,72,57,55,55,65,365,0.3984375,1.0
60,65,80,170,95,130,600,0.8625954198473282,95,124,78,69,71,58,495,0.37398373983739835,0.5
53,51,53,61,56,40,314,0.14285714285714285,60,85,69,60,69,77,420,0.518796992481203,1.0
109,66,84,81,99,32,471,0.2013888888888889,90,93,55,70,55,55,418,0.3819444444444444,2.0
50,65,107,105,107,86,520,0.7272727272727273,60,55,50,40,55,45,305,0.22377622377622378,2.0
126,131,95,131,98,99,680,0.8294573643410853,40,30,35,45,40,55,245,0.31496062992125984,2.0
85,60,65,135,105,100,550,0.7518248175182481,70,80,65,90,65,85,455,0.578125,2.0
83,80,80,135,80,121,579,0.9444444444444444,85,120,70,50,60,100,485,0.8308823529411765,1.0
100,5,5,15,65,30,220,0.07692307692307693,100,128,90,77,77,128,600,0.959349593495935,1.0
60,60,40,65,45,35,305,0.15833333333333333,114,85,70,85,80,30,464,0.2066115702479339,2.0
70,55,75,45,65,60,370,0.45901639344262296,30,30,42,30,42,70,244,0.4230769230769231,2.0
70,85,70,60,70,50,405,0.28378378378378377,105,140,95,55,65,45,505,0.3,1.0
45,49,65,49,65,45,318,0.275,114,85,70,85,80,30,464,0.2066115702479339,0.25
50,75,35,70,30,40,300,0.21296296296296297,65,80,80,59,63,58,405,0.4411764705882353,2.0
89,125,90,115,80,101,600,0.8725490196078431,65,95,100,60,50,50,420,0.34959349593495936,1.0
63,63,47,41,41,74,329,0.56,35,45,160,30,45,70,385,0.48148148148148145,0.25
80,145,150,105,110,110,700,0.8692307692307693,50,75,70,35,70,48,348,0.29357798165137616,0.0
60,130,80,60,60,70,460,0.5153846153846153,55,47,52,40,40,41,275,0.16806722689075632,0.25
80,120,130,55,65,45,495,0.37037037037037035,70,80,102,80,102,40,474,0.2677165354330709,0.0
75,95,122,58,75,69,494,0.5725806451612904,95,70,73,95,90,60,483,0.3983739837398374,1.0
30,45,135,45,90,30,375,0.09285714285714286,130,70,35,70,35,60,400,0.4017857142857143,1.0
84,71,43,71,43,48,360,0.25874125874125875,90,100,90,125,85,90,580,0.7352941176470589,1.0
40,55,80,35,60,30,300,0.15037593984962405,80,75,150,75,150,50,580,0.30973451327433627,0.25
40,45,35,65,55,70,310,0.4482758620689655,45,90,20,65,20,65,305,0.5116279069767442,2.0
100,120,100,150,120,90,680,0.728,80,120,70,110,70,80,530,0.6422764227642277,0.5
75,80,55,25,35,35,305,0.18666666666666668,45,85,70,40,40,60,340,0.5229357798165137,4.0
59,74,50,35,50,35,303,0.3125,50,53,48,53,48,64,316,0.4076923076923077,0.5
85,105,55,85,50,115,495,0.9032258064516129,38,30,41,30,41,60,240,0.2897196261682243,1.0
45,45,55,45,55,63,308,0.4594594594594595,40,30,32,50,52,65,269,0.3671875,1.0
49,66,70,44,55,51,335,0.4260869565217391,60,82,45,45,45,74,351,0.5752212389380531,1.0
85,80,70,135,75,90,535,0.7006802721088435,100,100,100,100,100,100,600,0.831858407079646,1.0
108,100,121,81,95,95,600,0.7476635514018691,70,65,60,90,75,90,450,0.6571428571428571,1.0
50,60,45,100,80,65,400,0.45689655172413796,40,45,40,65,40,65,295,0.5661764705882353,1.0
51,65,65,80,75,59,395,0.4365079365079365,55,45,45,25,25,15,210,0.048,1.0
170,90,45,90,45,60,500,0.427536231884058,45,85,70,40,40,60,340,0.5229357798165137,1.0
37,25,41,25,41,25,194,0.08870967741935484,120,100,85,30,85,45,465,0.22448979591836735,0.5
64,165,75,93,83,75,555,0.6587301587301587,80,80,80,55,55,90,440,0.6417910447761194,0.0
75,98,63,98,63,101,498,0.8091603053435115,95,85,85,65,65,35,430,0.2571428571428571,4.0
60,90,140,50,50,40,430,0.2535211267605634,40,30,50,55,55,100,330,0.584070796460177,0.5
57,80,91,80,87,75,470,0.5737704918032787,90,100,70,110,150,80,600,0.6037735849056604,2.0
70,92,65,80,55,98,460,0.8090909090909091,83,80,80,135,80,121,579,0.9444444444444444,1.0
105,130,120,45,45,40,485,0.4444444444444444,71,120,95,120,95,99,600,0.8203125,1.0
90,100,70,110,150,80,600,0.6037735849056604,79,100,80,110,90,121,580,0.968,1.0
79,103,120,135,115,78,630,0.5763888888888888,116,55,85,107,95,29,487,0.06818181818181818,1.0
75,98,63,98,63,101,498,0.8091603053435115,55,85,55,50,55,60,360,0.4233576642335766,0.25
62,48,66,59,57,49,341,0.33884297520661155,48,61,40,61,40,50,300,0.2543859649122807,1.0
55,45,43,55,43,72,313,0.5853658536585366,55,70,40,60,40,40,305,0.26956521739130435,1.0
75,125,230,55,95,30,610,0.3448275862068966,54,66,70,44,55,46,335,0.4214876033057851,0.5
45,30,15,85,65,65,305,0.36220472440944884,40,29,45,29,45,36,224,0.14634146341463414,1.0
38,30,41,30,41,60,240,0.2897196261682243,50,85,85,55,55,50,380,0.3902439024390244,0.5
86,68,72,109,66,106,507,0.8099173553719008,65,65,60,110,95,130,525,0.9253731343283582,1.0
65,40,50,125,60,30,370,0.07258064516129033,74,108,133,83,65,32,495,0.32142857142857145,1.0
95,23,48,23,48,23,260,0.046153846153846156,60,100,89,55,69,112,485,0.9298245614035088,2.0
65,60,70,85,75,40,395,0.1796875,61,78,95,56,58,57,405,0.40336134453781514,1.0
76,48,48,57,62,34,325,0.11688311688311688,39,52,43,60,50,65,309,0.49107142857142855,2.0
70,110,75,145,85,145,630,0.9444444444444444,78,65,68,112,154,75,552,0.628099173553719,0.0
40,55,70,45,60,30,300,0.10619469026548672,60,65,70,85,75,40,395,0.21705426356589147,1.0
66,117,70,40,50,67,410,0.4573643410852713,80,80,50,40,50,25,325,0.176056338028169,1.0
70,20,50,20,50,40,250,0.1557377049180328,80,105,65,60,75,130,515,0.9645390070921985,2.0
70,94,50,94,50,66,424,0.48148148148148145,45,63,37,65,55,95,360,0.8055555555555556,0.5
66,65,48,62,57,52,350,0.36220472440944884,70,135,105,60,105,20,495,0.5806451612903226,0.25
60,85,42,85,42,91,405,0.8227848101265823,55,75,60,75,60,103,428,0.7982456140350878,0.5
40,55,30,30,30,85,270,0.688,76,104,71,104,71,108,534,0.912751677852349,2.0
80,70,40,100,60,145,495,0.921875,65,90,120,85,70,60,490,0.43410852713178294,0.5
75,65,55,65,55,69,384,0.43548387096774194,150,160,100,95,65,100,670,0.8866666666666667,1.0
45,95,50,40,50,75,355,0.54,55,70,45,70,50,60,350,0.45,1.0
86,92,88,68,75,73,482,0.6835443037974683,70,55,65,95,85,70,440,0.5307692307692308,1.0
97,165,60,65,50,58,495,0.3902439024390244,55,55,55,85,55,30,335,0.1320754716981132,1.0
20,15,20,10,55,80,200,0.2682926829268293,25,20,15,105,55,90,310,0.32407407407407407,1.0
63,60,55,50,50,71,349,0.5289256198347108,65,65,60,110,95,130,525,0.9253731343283582,0.5
65,40,50,125,60,30,370,0.07258064516129033,65,150,40,15,80,145,495,0.9663865546218487,2.0
90,70,80,70,95,70,475,0.5190839694656488,73,100,60,100,60,65,458,0.42657342657342656,1.0
108,112,118,68,72,47,525,0.2916666666666667,46,87,60,30,40,57,320,0.37777777777777777,1.0
65,100,70,80,80,105,500,0.8666666666666667,73,95,62,85,65,85,465,0.6666666666666666,1.0
45,50,43,40,38,62,278,0.40441176470588236,250,5,5,35,105,50,450,0.15306122448979592,1.0
80,125,75,40,95,85,500,0.6911764705882353,95,145,130,120,90,120,700,0.9398496240601504,0.25
50,72,35,35,35,65,292,0.5373134328358209,100,150,140,100,90,90,670,0.7969924812030075,1.0
85,97,66,105,66,65,484,0.47107438016528924,44,38,39,61,79,42,303,0.2251655629139073,1.0
56,61,65,48,45,38,313,0.17567567567567569,100,180,160,150,90,90,770,0.7520661157024794,1.0
40,40,40,70,40,20,250,0.032520325203252036,58,89,77,45,45,48,362,0.3177570093457944,0.25
60,69,95,69,95,36,424,0.2608695652173913,106,130,90,110,154,90,680,0.719626168224299,0.125
72,58,80,103,80,97,490,0.7171052631578947,59,110,150,45,49,35,448,0.3333333333333333,0.25
64,165,75,93,83,75,555,0.6587301587301587,60,62,50,62,60,40,334,0.18181818181818182,1.0
43,80,65,50,35,35,308,0.14193548387096774,50,150,50,150,50,150,600,0.9339622641509434,1.0
80,75,150,75,150,50,580,0.30973451327433627,255,10,10,75,135,55,540,0.3125,1.0
100,100,100,100,100,100,600,0.8805970149253731,69,55,45,55,55,15,294,0.11666666666666667,0.5
55,85,122,58,75,99,494,0.8099173553719008,80,52,50,90,50,89,411,0.6666666666666666,0.25
97,165,60,65,50,58,495,0.3902439024390244,65,136,94,54,96,135,580,0.9612403100775194,0.5
78,104,78,159,115,100,634,0.8444444444444444,63,120,85,90,55,55,468,0.2809917355371901,0.5
80,120,70,110,70,80,530,0.6422764227642277,45,40,60,40,75,50,310,0.2926829268292683,1.0
38,30,85,55,65,30,303,0.21428571428571427,90,95,95,70,90,70,510,0.5230769230769231,1.0
75,100,63,80,63,116,497,0.9345794392523364,90,110,80,100,80,95,555,0.7982456140350878,1.0
70,92,65,80,55,98,460,0.8090909090909091,41,56,40,62,44,71,314,0.568,0.5
70,75,80,135,80,135,575,0.917910447761194,80,95,82,60,82,75,474,0.6,1.0
50,60,45,100,80,65,400,0.45689655172413796,60,52,168,47,138,30,495,0.19834710743801653,0.0
110,78,73,76,71,60,468,0.3333333333333333,70,70,40,60,40,60,340,0.4247787610619469,0.25
70,50,30,95,135,105,485,0.8040540540540541,40,35,30,20,20,50,195,0.23423423423423423,1.0
50,80,95,10,45,10,290,0.232,41,64,45,50,50,50,300,0.36752136752136755,1.0
64,78,52,78,52,81,405,0.6422764227642277,68,75,53,83,113,60,452,0.45384615384615384,0.5
31,45,90,30,30,40,266,0.21929824561403508,70,20,50,20,50,40,250,0.1557377049180328,0.5
80,120,79,95,79,70,523,0.5833333333333334,60,150,50,150,50,60,520,0.5,1.0
1,90,45,30,30,40,236,0.33064516129032256,45,45,35,20,30,20,195,0.07246376811594203,1.0
60,60,75,60,75,80,410,0.7321428571428571,67,82,62,46,48,43,348,0.22033898305084745,1.0
38,41,40,50,65,65,299,0.4108527131782946,60,100,85,80,85,100,510,0.7007874015748031,1.0
73,76,75,81,100,100,505,0.8110236220472441,60,50,150,50,150,60,520,0.5206611570247934,2.0
75,95,125,45,75,95,510,0.8257575757575758,60,82,45,45,45,74,351,0.5752212389380531,1.0
41,64,45,50,50,50,300,0.36752136752136755,45,30,35,20,20,45,195,0.14782608695652175,1.0
65,50,70,95,80,65,425,0.4262295081967213,90,95,95,70,90,70,510,0.5230769230769231,1.0
50,60,60,60,60,30,320,0.11290322580645161,80,110,120,130,90,70,600,0.6198347107438017,1.0
35,70,55,45,55,25,285,0.09420289855072464,70,95,85,55,65,70,440,0.5,4.0
60,50,100,85,70,65,430,0.47580645161290325,75,140,65,112,65,110,567,0.9140625,1.0
60,62,80,63,80,60,405,0.4336283185840708,65,65,60,110,95,130,525,0.9253731343283582,1.0
89,125,90,115,80,101,600,0.8725490196078431,44,38,33,61,43,70,289,0.5267857142857143,1.0
110,135,60,50,65,88,508,0.7744360902255639,70,60,125,115,70,55,495,0.35507246376811596,2.0
70,70,115,130,90,60,535,0.5338983050847458,65,40,50,125,60,30,370,0.07258064516129033,1.0
50,70,50,50,50,40,310,0.16296296296296298,90,132,105,132,105,30,594,0.4246575342465753,0.5
70,40,50,55,50,25,290,0.061068702290076333,80,100,123,122,120,80,625,0.56,1.0
100,100,100,100,100,100,600,0.8602941176470589,70,80,65,90,65,85,455,0.578125,1.0
110,160,110,80,110,100,670,0.8591549295774648,80,80,80,55,55,90,440,0.6417910447761194,1.0
100,180,160,150,90,90,770,0.7520661157024794,55,40,50,65,85,40,335,0.3181818181818182,0.5
40,45,40,62,60,60,307,0.33884297520661155,25,35,70,95,55,45,325,0.16783216783216784,2.0
70,55,95,95,110,65,490,0.48872180451127817,108,170,115,120,95,92,700,0.7083333333333334,2.0
50,72,35,35,35,65,292,0.5373134328358209,65,70,60,65,65,115,440,0.8583333333333333,1.0
45,22,60,27,30,29,213,0.07518796992481203,82,121,119,69,59,71,521,0.5394736842105263,1.0
53,51,53,61,56,40,314,0.14285714285714285,75,123,67,95,85,95,540,0.7642276422764228,1.0
55,50,40,40,40,75,300,0.5945945945945946,55,50,45,135,95,120,500,0.7714285714285715,1.0
85,73,70,73,115,67,483,0.5126050420168067,52,65,55,58,62,60,352,0.4482758620689655,1.0
105,95,80,40,80,90,490,0.753968253968254,79,115,70,125,80,111,580,0.864,1.0
60,65,80,170,95,130,600,0.8625954198473282,60,45,70,45,90,95,405,0.7304964539007093,1.0
50,60,60,60,60,30,320,0.11290322580645161,78,70,61,50,61,100,420,0.8145161290322581,1.0
50,35,55,25,25,15,205,0.021739130434782608,55,47,52,40,40,41,275,0.16806722689075632,0.5
80,80,80,80,80,80,480,0.6015037593984962,89,145,90,105,80,91,600,0.8549618320610687,4.0
75,125,70,125,70,115,580,0.9037037037037037,100,128,90,77,77,128,600,0.959349593495935,1.0
110,65,75,125,85,30,490,0.15,80,80,50,40,50,25,325,0.176056338028169,2.0
20,25,45,70,90,60,310,0.30833333333333335,50,75,70,35,70,48,348,0.29357798165137616,0.0
50,50,150,50,150,50,500,0.2571428571428571,58,109,112,48,48,109,484,0.8805970149253731,0.5
84,71,43,71,43,48,360,0.25874125874125875,95,100,85,108,70,70,528,0.5652173913043478,1.0
35,45,160,30,45,70,385,0.48148148148148145,100,120,120,150,100,90,680,0.7880794701986755,1.0
64,115,65,83,63,65,455,0.5323741007194245,70,70,70,70,70,70,420,0.5289256198347108,0.0
57,24,86,24,86,23,300,0.12727272727272726,75,87,63,87,63,98,473,0.865546218487395,0.5
30,105,90,25,25,50,325,0.2773722627737226,38,41,40,50,65,65,299,0.4108527131782946,2.0
40,40,55,40,70,55,300,0.40939597315436244,40,55,80,35,60,30,300,0.15037593984962405,0.5
150,80,44,90,54,80,498,0.625,69,55,45,55,55,15,294,0.11666666666666667,2.0
50,75,35,70,30,40,300,0.21296296296296297,70,75,60,105,60,105,475,0.88,1.0
100,75,115,90,115,85,580,0.6446280991735537,65,65,60,130,95,110,525,0.823943661971831,1.0
85,80,70,135,75,90,535,0.7006802721088435,80,135,85,70,95,150,615,0.9844961240310077,0.5
35,35,40,35,55,50,250,0.40336134453781514,44,38,39,61,79,42,303,0.2251655629139073,1.0
40,55,30,30,30,85,270,0.688,44,48,65,50,64,43,314,0.1623931623931624,1.0
67,58,57,81,67,101,431,0.8790322580645161,60,80,95,70,85,50,440,0.2231404958677686,0.5
65,70,60,65,65,115,440,0.8583333333333333,80,80,80,80,80,80,480,0.5606060606060606,1.0
65,90,120,85,70,60,490,0.43410852713178294,106,150,70,194,120,140,780,0.952,1.0
55,95,115,45,45,35,390,0.2116788321167883,45,50,45,115,55,95,405,0.6936936936936937,2.0
50,85,125,85,115,20,480,0.4306569343065693,60,40,50,75,85,95,405,0.6044776119402985,1.0
60,80,50,40,40,30,300,0.15328467153284672,55,130,115,50,50,75,475,0.5982142857142857,1.0
65,40,70,80,140,70,465,0.5954198473282443,80,52,50,90,50,89,411,0.6666666666666666,2.0
45,30,50,65,50,45,285,0.13821138211382114,48,61,40,61,40,50,300,0.2543859649122807,2.0
76,25,45,67,55,24,292,0.0390625,45,65,34,40,34,45,263,0.2589928057553957,1.0
60,60,60,105,105,105,495,0.848,65,70,60,65,65,115,440,0.8583333333333333,0.0
130,65,60,110,95,65,525,0.5227272727272727,45,30,50,65,50,45,285,0.13821138211382114,1.0
65,40,50,125,60,30,370,0.07258064516129033,78,92,75,74,63,118,500,0.8842975206611571,1.0
71,120,95,120,95,99,600,0.8203125,60,65,80,170,95,130,600,0.8625954198473282,0.25
40,30,50,55,55,100,330,0.584070796460177,95,135,80,110,80,100,600,0.8248175182481752,1.0
100,100,100,100,100,100,600,0.8805970149253731,55,50,65,175,95,150,590,0.7818181818181819,1.0
31,45,90,30,30,40,266,0.21929824561403508,60,45,50,90,80,70,395,0.625,0.0
80,100,200,50,100,50,580,0.3472222222222222,78,52,60,63,65,23,341,0.06015037593984962,1.0
65,125,100,60,70,70,490,0.6099290780141844,105,140,55,30,55,95,480,0.8195488721804511,0.5
90,110,80,100,80,95,555,0.7982456140350878,55,75,60,75,60,103,428,0.7982456140350878,1.0
40,50,45,70,45,70,320,0.5517241379310345,40,30,35,50,70,55,280,0.28205128205128205,4.0
60,70,65,125,105,90,515,0.6911764705882353,59,45,40,35,40,31,250,0.14285714285714285,1.0
40,60,40,40,40,30,250,0.0948905109489051,45,90,20,65,20,65,305,0.5116279069767442,2.0
72,105,115,54,86,68,500,0.5149253731343284,50,85,55,65,65,90,410,0.7478260869565218,4.0
56,61,65,48,45,38,313,0.17567567567567569,70,80,50,35,35,35,305,0.14,1.0
100,128,90,77,77,128,600,0.959349593495935,40,55,30,30,30,85,270,0.688,1.0
45,85,70,40,40,60,340,0.5229357798165137,65,105,60,60,70,95,455,63.0,0.5
50,180,20,180,20,150,600,0.9029850746268657,65,90,122,58,75,84,494,0.71875,1.0
95,110,95,40,95,55,490,0.40336134453781514,40,35,30,20,20,50,195,0.23423423423423423,1.0
49,49,56,49,61,66,330,0.5190839694656488,100,100,100,100,100,100,600,0.8602941176470589,0.5
70,140,70,110,65,105,560,0.95,95,110,80,70,80,50,485,0.37209302325581395,1.0
55,65,95,95,45,85,440,0.6610169491525424,40,55,70,45,60,30,300,0.10619469026548672,1.0
45,45,55,45,55,63,308,0.4594594594594595,95,155,109,70,130,81,640,0.6788321167883211,2.0
40,30,35,50,70,55,280,0.28205128205128205,45,45,35,20,30,20,195,0.07246376811594203,0.5
60,55,50,40,55,45,305,0.22377622377622378,65,90,122,58,75,84,494,0.71875,1.0
61,84,65,70,70,70,420,0.5,50,70,50,50,50,70,340,0.5645161290322581,2.0
65,85,70,75,70,40,405,0.203125,100,134,110,95,100,61,600,0.4057971014492754,1.0
55,84,105,114,75,52,485,0.2890625,75,89,85,55,65,36,405,0.29545454545454547,0.5
55,40,85,80,105,40,405,0.23622047244094488,100,150,110,95,110,70,635,0.5923076923076923,1.0
74,108,133,83,65,32,495,0.32142857142857145,49,55,42,42,37,85,310,0.6068376068376068,1.0
60,40,50,75,85,95,405,0.6044776119402985,40,30,30,55,30,85,270,0.4666666666666667,4.0
75,123,67,95,85,95,540,0.7642276422764228,70,85,140,85,70,20,470,0.272,1.0
255,10,10,75,135,55,540,0.3125,65,65,65,50,50,90,385,0.72,1.0
95,80,105,40,70,100,490,0.8046875,72,85,70,65,70,58,420,0.41304347826086957,1.0
50,53,48,53,48,64,316,0.4076923076923077,40,30,35,50,70,55,280,0.28205128205128205,0.25
75,75,75,125,95,40,485,0.15671641791044777,86,81,97,81,107,43,495,0.203125,1.0
80,110,120,130,90,70,600,0.6198347107438017,55,81,60,50,70,97,413,0.7214285714285714,1.0
38,35,35,65,55,50,278,0.2647058823529412,77,120,90,60,90,48,485,0.2785714285714286,2.0
78,104,78,159,115,100,634,0.8444444444444444,76,65,45,92,42,91,411,0.7449664429530202,1.0
60,40,80,60,45,40,325,0.23529411764705882,100,120,100,150,120,90,680,0.728,0.25
68,85,65,165,135,100,618,0.8083333333333333,40,35,30,120,70,105,400,0.6692307692307692,0.5
25,20,15,105,55,90,310,0.32407407407407407,60,48,45,43,90,42,328,0.21897810218978103,0.5
108,170,115,120,95,92,700,0.7083333333333334,105,140,95,55,65,45,505,0.3,1.0
63,60,55,50,50,71,349,0.5289256198347108,60,60,60,60,60,60,360,0.38095238095238093,1.0
60,40,50,75,85,95,405,0.6044776119402985,70,120,40,95,40,95,460,0.8106060606060606,2.0
115,115,85,90,75,100,580,0.8134328358208955,90,93,55,70,55,55,418,0.3819444444444444,0.5
30,45,135,45,90,30,375,0.09285714285714286,75,75,130,75,130,95,580,0.7479674796747967,1.0
25,20,15,105,55,90,310,0.32407407407407407,75,103,80,70,80,92,500,0.7933884297520661,1.0
74,48,76,83,81,104,466,0.7322834645669292,45,49,65,49,65,45,318,0.275,1.0
55,75,85,25,25,15,280,0.1875,85,110,76,65,82,56,474,0.3933333333333333,1.0
110,123,65,100,65,65,528,0.5217391304347826,40,50,90,30,55,65,330,0.44680851063829785,0.5
68,125,65,65,115,80,518,0.6277372262773723,60,115,105,65,70,80,495,0.7181818181818181,2.0
123,100,62,97,81,68,531,0.4806201550387597,72,58,80,103,80,97,490,0.7171052631578947,0.5
90,100,70,110,150,80,600,0.6037735849056604,49,55,42,42,37,85,310,0.6068376068376068,1.0
90,65,65,40,40,15,315,0.19672131147540983,50,55,50,36,30,43,264,0.2922077922077922,1.0
57,80,91,80,87,75,470,0.5737704918032787,60,60,60,35,35,30,280,0.11194029850746269,1.0
90,55,75,60,75,30,385,0.13970588235294118,50,65,85,35,35,55,325,0.32575757575757575,0.5
45,30,50,55,65,45,290,0.208,70,110,180,60,60,50,530,0.4117647058823529,0.5
60,60,50,40,50,75,335,0.5882352941176471,60,75,100,55,80,50,420,0.3088235294117647,0.25
126,131,95,131,98,99,680,0.8294573643410853,70,105,105,50,40,20,390,0.33587786259541985,1.0
110,65,75,125,85,30,490,0.15,80,130,100,160,120,110,700,0.8981481481481481,0.5
90,100,90,125,85,90,580,0.7352941176470589,80,100,123,122,120,80,625,0.56,4.0
150,160,100,95,65,100,670,0.8866666666666667,60,60,60,35,35,30,280,0.11194029850746269,1.0
62,77,62,50,42,65,358,0.4838709677419355,70,60,75,110,75,90,480,0.7165354330708661,2.0
90,60,70,75,70,45,410,0.23880597014925373,69,69,76,69,86,91,460,0.6554621848739496,0.25
55,69,85,32,35,28,304,0.09302325581395349,100,50,50,76,96,70,442,0.5,2.0
110,123,65,100,65,65,528,0.5217391304347826,90,110,80,100,80,95,555,0.7982456140350878,0.5
95,110,80,70,80,50,485,0.37209302325581395,86,76,86,116,56,95,515,0.7982456140350878,2.0
55,75,85,25,25,15,280,0.1875,50,55,50,36,30,43,264,0.2922077922077922,2.0
70,80,102,80,102,40,474,0.2677165354330709,85,80,90,105,95,60,515,0.49074074074074076,1.0
78,52,60,63,65,23,341,0.06015037593984962,55,70,55,40,55,85,360,0.7073170731707317,1.0
46,87,60,30,40,57,320,0.37777777777777777,106,150,70,194,120,140,780,0.952,1.0
65,65,60,130,95,110,525,0.823943661971831,70,70,115,130,90,60,535,0.5338983050847458,0.5
50,75,75,65,65,50,380,0.4049586776859504,35,55,35,30,30,35,220,0.23684210526315788,0.25
55,85,122,58,75,99,494,0.8099173553719008,130,65,60,110,95,65,525,0.5227272727272727,2.0
190,33,58,33,58,33,405,0.13432835820895522,85,115,80,105,80,50,515,0.3063063063063063,1.0
43,30,55,40,65,97,330,0.6030534351145038,105,125,100,60,100,100,590,0.8359375,1.0
50,50,95,40,50,35,320,0.20279720279720279,115,140,130,55,55,40,535,0.4519230769230769,2.0
50,150,50,150,50,150,600,0.9339622641509434,73,100,60,100,60,65,458,0.42657342657342656,2.0
40,30,35,45,40,55,245,0.31496062992125984,60,80,95,70,85,50,440,0.2231404958677686,0.25
91,90,129,90,72,108,580,0.9140625,40,30,50,55,55,100,330,0.584070796460177,0.5
49,49,56,49,61,66,330,0.5190839694656488,54,78,103,53,45,22,355,0.23255813953488372,1.0
75,55,70,55,95,110,460,0.8444444444444444,30,45,59,30,39,57,260,0.2803030303030303,0.5
65,47,55,73,75,85,400,0.65,65,85,70,75,70,40,405,0.203125,1.0
58,50,145,95,105,30,483,0.2459016393442623,60,85,60,50,50,125,430,0.9090909090909091,0.0
55,66,44,44,56,85,350,0.6888888888888889,45,35,45,62,53,35,275,0.11851851851851852,1.0
45,49,65,49,65,45,318,0.275,75,95,125,45,75,95,510,0.8257575757575758,1.0
65,80,80,59,63,58,405,0.4411764705882353,71,73,88,120,89,59,500,0.43537414965986393,0.5
80,90,80,130,110,110,600,0.856,105,140,55,30,55,95,480,0.8195488721804511,1.0
72,105,115,54,86,68,500,0.5149253731343284,100,150,120,120,100,90,680,0.6493506493506493,0.5
70,70,40,60,40,60,340,0.4247787610619469,95,100,85,108,70,70,528,0.5652173913043478,2.0
50,70,50,50,50,40,310,0.16296296296296298,75,65,55,65,55,69,384,0.43548387096774194,1.0
100,100,90,150,140,90,670,0.71875,20,40,90,30,90,25,295,0.11363636363636363,1.0
50,70,50,50,50,70,340,0.5645161290322581,95,117,184,44,46,28,514,0.2975206611570248,1.0
50,65,64,44,48,43,314,0.2196969696969697,80,105,105,105,105,80,580,0.5939849624060151,1.0
45,75,37,70,55,83,365,0.6183206106870229,40,55,30,30,30,60,245,0.43548387096774194,1.0
50,60,60,60,60,30,320,0.11290322580645161,45,25,50,25,25,35,205,0.13076923076923078,0.5
65,125,100,55,70,85,500,0.6532258064516129,85,80,70,135,75,90,535,0.7006802721088435,1.0
40,40,50,30,30,30,220,0.0873015873015873,50,85,125,85,115,20,480,0.4306569343065693,1.0
50,50,40,30,30,50,250,0.2781954887218045,78,104,78,159,115,100,634,0.8444444444444444,0.0
62,48,54,63,60,68,355,0.5178571428571429,44,38,33,61,43,70,289,0.5267857142857143,1.0
55,45,45,25,25,15,210,0.048,40,50,45,70,45,70,320,0.5517241379310345,0.0
75,90,140,60,60,40,465,0.3008130081300813,80,125,75,40,95,85,500,0.6911764705882353,0.5
45,75,60,40,30,50,300,0.304,55,20,35,20,45,75,250,0.37681159420289856,1.0
65,70,60,65,65,115,440,0.8583333333333333,50,40,85,40,65,25,305,0.08870967741935484,1.0
68,72,78,38,42,32,330,0.23809523809523808,35,65,35,65,35,65,300,0.46621621621621623,1.0
70,130,100,55,80,65,500,0.608,65,76,84,54,96,105,480,0.9008264462809917,1.0
60,79,105,59,85,36,424,0.17054263565891473,45,22,60,27,30,29,213,0.07518796992481203,0.5
85,80,90,105,95,60,515,0.49074074074074076,55,50,40,40,40,75,300,0.5945945945945946,1.0
68,165,95,65,115,110,618,0.8615384615384616,50,75,75,65,65,50,380,0.4049586776859504,0.0
40,65,95,60,45,35,340,0.13986013986013987,70,40,50,55,50,25,290,0.061068702290076333,1.0
65,80,80,59,63,58,405,0.4411764705882353,76,104,71,104,71,108,534,0.912751677852349,2.0
80,52,50,90,50,89,411,0.6666666666666666,65,75,70,95,70,95,470,0.7272727272727273,1.0
75,90,50,110,80,95,500,0.7985611510791367,100,100,100,100,100,100,600,0.8602941176470589,2.0
103,60,126,80,126,50,545,0.36363636363636365,70,84,70,65,70,51,410,0.2949640287769784,0.5
80,100,123,122,120,80,625,0.56,75,90,90,140,90,115,600,0.9481481481481482,0.5
75,80,70,65,75,90,455,0.7578125,70,115,60,115,60,55,475,0.4647887323943662,4.0
70,140,230,60,80,50,630,0.32432432432432434,86,92,88,68,75,73,482,0.6835443037974683,1.0
58,64,58,80,65,80,405,0.5423728813559322,40,45,35,30,40,55,245,0.3793103448275862,1.0
45,50,35,55,75,40,300,0.21367521367521367,116,55,85,107,95,29,487,0.06818181818181818,1.0
75,90,140,60,60,40,465,0.3008130081300813,68,72,78,38,42,32,330,0.23809523809523808,1.0
80,80,80,80,80,80,480,0.6015037593984962,60,70,50,100,50,65,395,0.5217391304347826,2.0
65,95,100,60,50,50,420,0.34959349593495936,85,56,77,50,77,78,423,0.53125,1.0
90,55,75,60,75,30,385,0.13970588235294118,35,70,55,45,55,25,285,0.09420289855072464,1.0
95,65,65,110,130,60,525,0.4016393442622951,80,45,65,90,110,80,470,0.5462962962962963,1.0
65,125,100,55,70,85,500,0.6532258064516129,78,84,78,109,85,100,534,0.8620689655172413,0.5
65,65,45,75,45,95,390,0.72,51,65,65,80,75,59,395,0.4365079365079365,1.0
64,165,75,93,83,75,555,0.6587301587301587,30,35,30,100,35,80,310,0.4765625,2.0
80,135,130,95,90,70,600,0.5181818181818182,20,15,20,10,55,80,200,0.2682926829268293,0.5
100,50,50,76,96,70,442,0.5,55,68,64,45,55,31,318,0.11666666666666667,2.0
62,48,54,63,60,68,355,0.5178571428571429,45,60,40,70,50,45,310,0.2846715328467153,1.0
150,80,44,90,54,80,498,0.625,55,65,35,60,30,85,330,0.6126126126126126,1.0
91,129,90,72,90,108,580,0.8536585365853658,55,66,44,44,56,85,350,0.6888888888888889,2.0
45,22,60,27,30,29,213,0.07518796992481203,125,58,58,76,76,67,460,0.515625,1.0
70,60,70,87,78,85,450,0.6228070175438597,49,66,70,44,55,51,335,0.4260869565217391,0.5
50,70,100,40,40,30,330,0.2222222222222222,79,85,60,55,60,71,410,0.60431654676259,0.5
75,85,200,55,65,30,510,0.16778523489932887,61,90,45,50,50,160,456,0.9230769230769231,0.0
255,10,10,75,135,55,540,0.3125,40,45,35,30,40,55,245,0.3793103448275862,1.0
75,103,80,70,80,92,500,0.7933884297520661,50,60,45,100,80,65,400,0.45689655172413796,0.25
55,40,40,65,45,35,280,0.16428571428571428,55,85,122,58,75,99,494,0.8099173553719008,0.5
40,30,50,55,55,100,330,0.584070796460177,20,40,90,30,90,25,295,0.11363636363636363,1.0
45,55,45,65,45,75,330,0.5692307692307692,75,55,70,55,95,110,460,0.8444444444444444,8.0
45,45,35,20,30,20,195,0.07246376811594203,57,80,91,80,87,75,470,0.5737704918032787,0.25
80,52,50,90,50,89,411,0.6666666666666666,78,84,78,109,85,100,534,0.8620689655172413,0.5
79,115,70,125,80,111,580,0.864,165,75,80,40,45,65,470,0.5151515151515151,2.0
100,120,100,150,120,90,680,0.728,90,100,70,110,150,80,600,0.6037735849056604,1.0
70,75,60,105,60,105,475,0.88,48,72,48,72,48,48,336,0.25984251968503935,1.0
50,50,62,40,62,65,329,0.4188034188034188,62,48,54,63,60,68,355,0.5178571428571429,1.0
65,130,60,95,110,65,525,0.5303030303030303,85,90,80,70,80,130,535,0.9262295081967213,1.0
59,66,70,44,55,41,335,0.25190839694656486,49,55,42,42,37,85,310,0.6068376068376068,0.0
70,84,70,65,70,51,410,0.2949640287769784,40,50,90,30,55,65,330,0.44680851063829785,2.0
70,90,90,135,90,125,600,0.9401709401709402,76,65,45,92,42,91,411,0.7449664429530202,1.0
70,60,70,87,78,85,450,0.6228070175438597,60,50,50,60,70,50,340,0.28346456692913385,1.0
75,75,130,75,130,95,580,0.7479674796747967,45,50,45,115,55,95,405,0.6936936936936937,2.0
105,180,100,180,100,115,780,0.9477611940298507,65,80,65,35,65,60,370,0.38405797101449274,1.0
150,80,44,90,54,80,498,0.625,99,68,83,72,87,51,460,0.417910447761194,2.0
100,150,120,120,100,90,680,0.6493506493506493,55,70,45,70,50,60,350,0.45,1.0
55,20,35,20,45,75,250,0.37681159420289856,72,105,115,54,86,68,500,0.5149253731343284,0.5
44,75,35,63,33,45,295,0.2647058823529412,65,40,50,125,60,30,370,0.07258064516129033,2.0
60,50,70,50,90,65,385,0.39568345323741005,55,40,50,65,85,40,335,0.3181818181818182,0.25
83,106,65,86,65,85,490,0.6640625,70,140,230,60,80,50,630,0.32432432432432434,0.0
103,93,67,71,61,84,479,0.7142857142857143,46,87,60,30,40,57,320,0.37777777777777777,1.0
62,77,62,50,42,65,358,0.4838709677419355,75,75,75,125,95,40,485,0.15671641791044777,1.0
40,30,32,50,52,65,269,0.3671875,65,100,70,80,80,105,500,0.8666666666666667,1.0
62,44,50,44,50,55,305,0.3629032258064516,73,100,60,100,60,65,458,0.42657342657342656,1.0
45,60,30,80,50,65,330,0.4603174603174603,40,30,35,50,70,55,280,0.28205128205128205,2.0
40,80,35,35,45,70,305,0.4661016949152542,76,48,48,57,62,34,325,0.11688311688311688,1.0
115,115,85,90,75,100,580,0.8134328358208955,95,80,105,40,70,100,490,0.8046875,1.0
95,109,105,75,85,56,525,0.34513274336283184,80,120,130,55,65,45,495,0.37037037037037035,8.0
70,80,65,90,65,85,455,0.578125,65,90,115,45,115,58,488,0.5041322314049587,0.0
100,110,90,85,90,60,535,0.47794117647058826,123,100,62,97,81,68,531,0.4806201550387597,0.25
40,40,50,30,30,30,220,0.0873015873015873,70,140,70,110,65,105,560,0.95,2.0
150,120,100,120,100,90,680,0.664179104477612,70,110,180,60,60,50,530,0.4117647058823529,0.5
35,65,35,65,35,65,300,0.46621621621621623,125,170,100,120,90,95,700,0.77,0.5
80,100,80,80,80,100,520,0.9051724137931034,92,105,90,125,90,98,600,0.8217054263565892,2.0
50,50,40,30,30,50,250,0.2781954887218045,78,104,78,159,115,100,634,0.8444444444444444,0.0
40,45,65,100,120,90,460,0.5588235294117647,103,93,67,71,61,84,479,0.7142857142857143,0.0
55,70,55,40,55,85,360,0.7073170731707317,57,80,91,80,87,75,470,0.5737704918032787,0.5
20,40,90,30,90,25,295,0.11363636363636363,50,70,100,40,40,30,330,0.2222222222222222,1.0
75,125,100,70,80,45,495,0.33035714285714285,50,85,85,55,55,50,380,0.3902439024390244,0.125
70,65,60,90,75,90,450,0.6571428571428571,76,104,71,104,71,108,534,0.912751677852349,0.25
45,60,40,70,50,45,310,0.2846715328467153,95,65,65,110,130,60,525,0.4016393442622951,1.0
65,75,90,97,123,44,494,0.1987179487179487,70,62,67,55,55,56,365,0.38513513513513514,0.5
76,104,71,104,71,108,534,0.912751677852349,40,30,30,40,50,30,220,0.07936507936507936,1.0
50,50,95,40,50,35,320,0.20279720279720279,95,124,78,69,71,58,495,0.37398373983739835,1.0
42,52,67,39,56,50,306,0.2868217054263566,65,80,80,59,63,58,405,0.4411764705882353,0.5
60,85,69,60,69,77,420,0.518796992481203,50,95,95,35,110,70,455,0.5179856115107914,1.0
65,50,35,115,95,95,455,0.7333333333333333,59,66,70,44,55,41,335,0.25190839694656486,2.0
79,115,70,125,80,111,580,0.8468468468468469,45,75,37,70,55,83,365,0.6183206106870229,1.0
165,75,80,40,45,65,470,0.5151515151515151,50,65,107,105,107,86,520,0.7272727272727273,1.0
70,50,30,95,135,105,485,0.8040540540540541,50,72,35,35,35,65,292,0.5373134328358209,2.0
75,75,130,75,130,95,580,0.7479674796747967,50,50,40,30,30,50,250,0.2781954887218045,2.0
59,110,150,45,49,35,448,0.3333333333333333,40,30,35,50,70,55,280,0.28205128205128205,1.0
80,52,50,90,50,89,411,0.6666666666666666,75,65,55,65,55,69,384,0.43548387096774194,1.0
78,104,78,159,115,100,634,0.8444444444444444,60,40,60,95,60,55,370,0.4222222222222222,0.5
65,105,60,60,70,95,455,63.0,70,60,75,110,75,90,480,0.7165354330708661,1.0
95,117,80,65,70,92,519,0.8409090909090909,80,82,78,95,80,85,500,0.6869565217391305,1.0
78,104,78,159,115,100,634,0.8444444444444444,135,85,40,40,85,5,390,0.6864406779661016,1.0
91,90,72,90,129,108,580,0.896,80,80,80,55,55,90,440,0.6417910447761194,2.0
60,70,65,125,105,90,515,0.6911764705882353,40,55,80,35,60,30,300,0.15037593984962405,0.0
50,80,95,10,45,10,290,0.232,50,35,55,25,25,15,205,0.05263157894736842,2.0
65,95,75,55,55,85,430,0.6933333333333334,60,85,60,50,50,125,430,0.9090909090909091,1.0
95,65,65,110,130,60,525,0.4016393442622951,65,76,84,54,96,105,480,0.9008264462809917,1.0
75,75,95,75,95,113,528,0.9015151515151515,108,100,121,81,95,95,600,0.7476635514018691,1.0
123,100,62,97,81,68,531,0.4806201550387597,65,125,60,95,60,105,510,0.9236641221374046,1.0
40,65,40,80,40,65,330,0.5038167938931297,60,85,42,85,42,91,405,0.8227848101265823,0.5
75,140,65,112,65,110,567,0.9140625,85,80,90,105,95,60,515,0.49074074074074076,1.0
150,160,100,95,65,100,670,0.8866666666666667,95,75,80,100,110,30,490,0.24242424242424243,1.0
45,75,37,70,55,83,365,0.6183206106870229,45,30,40,105,50,20,290,0.031007751937984496,1.0
70,94,50,94,50,66,424,0.48148148148148145,71,120,95,120,95,99,600,0.8203125,0.5
59,63,80,65,80,58,405,0.41843971631205673,80,70,65,80,120,100,515,0.8034188034188035,0.5
45,100,45,45,45,10,290,0.2949640287769784,65,63,45,45,45,45,308,0.2595419847328244,2.0
35,35,35,35,35,35,210,0.13385826771653545,75,89,85,55,65,36,405,0.29545454545454547,1.0
35,55,35,30,30,35,220,0.23684210526315788,50,50,40,30,30,50,250,0.2781954887218045,1.0
95,80,105,40,70,100,490,0.8046875,45,49,65,49,65,45,318,0.275,1.0
60,90,70,60,120,40,440,0.27419354838709675,40,65,95,60,45,35,340,0.13986013986013987,1.0
90,93,55,70,55,55,418,0.3819444444444444,79,115,70,125,80,111,580,0.8468468468468469,0.5
100,90,130,45,65,55,485,0.4253731343283582,48,72,48,72,48,48,336,0.25984251968503935,1.0
126,131,95,131,98,99,680,0.8102189781021898,30,45,55,70,55,85,340,0.5633802816901409,1.0
70,140,70,110,65,105,560,0.95,20,40,15,35,35,60,205,0.34285714285714286,1.0
75,95,122,58,75,69,494,0.5725806451612904,79,115,70,125,80,111,580,0.8468468468468469,0.5
50,95,90,95,90,180,600,0.9172413793103448,64,78,52,78,52,81,405,0.6422764227642277,1.0
95,75,80,100,110,30,490,0.24242424242424243,80,95,82,60,82,75,474,0.6,2.0
125,120,90,170,100,95,700,0.78125,50,75,45,40,45,60,315,0.4380165289256198,1.0
50,95,180,85,45,70,525,0.5298507462686567,83,80,80,135,80,121,579,0.9444444444444444,2.0
65,47,55,73,75,85,400,0.65,85,56,77,50,77,78,423,0.53125,1.0
75,98,63,98,63,101,498,0.849624060150376,95,145,130,120,90,120,700,0.9398496240601504,0.5
65,90,40,45,80,75,395,0.625,50,30,55,65,55,20,275,0.13675213675213677,0.125
71,120,95,120,95,99,600,0.8203125,35,35,35,35,35,35,210,0.13385826771653545,0.5
65,65,60,130,95,110,525,0.823943661971831,75,125,70,125,70,115,580,0.9037037037037037,0.5
106,90,130,90,154,110,680,0.8699186991869918,60,85,40,30,45,68,328,0.6422018348623854,2.0
50,105,79,35,110,76,455,0.6214285714285714,55,40,50,65,85,40,335,0.3181818181818182,0.0
85,76,64,45,55,90,415,0.6739130434782609,40,55,80,35,60,30,300,0.15037593984962405,0.5
48,72,48,72,48,48,336,0.25984251968503935,36,50,50,65,60,44,305,0.16363636363636364,1.0
60,55,90,145,90,80,520,0.6071428571428571,80,92,65,65,80,68,450,0.4824561403508772,0.5
50,65,107,105,107,86,520,0.7313432835820896,62,77,62,50,42,65,358,0.4838709677419355,1.0
95,65,65,110,130,60,525,0.4016393442622951,67,58,57,81,67,101,431,0.8790322580645161,1.0
90,110,80,100,80,95,555,0.7982456140350878,60,62,63,80,80,60,405,0.38016528925619836,2.0
60,100,115,70,85,90,520,0.7557251908396947,40,45,35,40,40,90,290,0.65,1.0
74,48,76,83,81,104,466,0.7322834645669292,55,75,85,25,25,15,280,0.1875,1.0
70,20,50,20,50,40,250,0.1557377049180328,70,145,88,140,70,112,625,0.8888888888888888,1.0
60,59,85,79,105,36,424,0.16666666666666666,110,80,90,95,90,65,530,0.5033557046979866,2.0
106,90,130,90,154,110,680,0.8699186991869918,50,70,160,70,160,90,600,0.7417218543046358,0.5
40,45,40,65,40,65,295,0.5661764705882353,75,89,85,55,65,36,405,0.29545454545454547,0.5
60,45,70,75,85,55,390,0.3008130081300813,55,112,45,74,45,70,401,0.559322033898305,1.0
68,75,53,83,113,60,452,0.45384615384615384,45,60,30,80,50,65,330,0.4603174603174603,1.0
75,70,90,70,105,80,490,0.656,45,85,70,40,40,60,340,0.5229357798165137,0.25
65,65,65,50,50,90,385,0.72,90,120,75,60,60,45,450,0.29411764705882354,1.0
50,65,107,105,107,86,520,0.7758620689655172,64,115,65,83,63,65,455,0.5323741007194245,1.0
45,45,55,45,55,63,308,0.4594594594594595,55,45,45,25,25,15,210,0.048,4.0
55,55,85,65,85,35,380,0.2014388489208633,88,107,122,74,75,64,530,0.4596774193548387,0.25
50,70,50,50,50,40,310,0.16296296296296298,70,120,65,45,85,125,510,0.9747899159663865,1.0
114,85,70,85,80,30,464,0.2066115702479339,70,62,67,55,55,56,365,0.38513513513513514,0.25
75,55,70,55,95,110,460,0.8444444444444444,54,66,70,44,55,46,335,0.4214876033057851,1.0
80,100,80,80,80,100,520,0.9051724137931034,46,87,60,30,40,57,320,0.37777777777777777,2.0
58,89,77,45,45,48,362,0.3177570093457944,60,82,45,45,45,74,351,0.5752212389380531,0.5
77,120,90,60,90,48,485,0.2785714285714286,90,120,75,60,60,45,450,0.29411764705882354,0.0
65,125,60,95,60,105,510,0.9236641221374046,74,94,131,54,116,20,489,0.4485294117647059,2.0
90,60,70,75,70,45,410,0.23880597014925373,70,84,70,65,70,51,410,0.2949640287769784,8.0
68,165,95,65,115,110,618,0.8615384615384616,67,125,40,30,30,58,350,0.3431372549019608,2.0
109,66,84,81,99,32,471,0.2013888888888889,92,105,90,125,90,98,600,0.8217054263565892,0.5
45,60,40,70,50,45,310,0.2846715328467153,45,80,100,35,37,28,325,0.3125,2.0
50,52,48,65,50,55,320,0.33098591549295775,70,65,65,55,55,70,380,0.5,1.0
50,50,150,50,150,50,500,0.2571428571428571,103,60,86,60,86,50,445,0.3458646616541353,1.0
80,115,80,65,55,93,488,0.7846153846153846,71,73,88,120,89,59,500,0.43537414965986393,1.0
45,65,34,40,34,45,263,0.2589928057553957,28,25,25,45,35,40,198,0.16083916083916083,1.0
40,35,30,120,70,105,400,0.6692307692307692,44,75,35,63,33,45,295,0.2647058823529412,1.0
71,82,64,64,59,112,452,0.9327731092436975,50,53,48,53,48,64,316,0.46153846153846156,1.0
120,120,120,120,120,120,720,0.9344262295081968,35,20,65,40,65,20,245,0.02459016393442623,1.0
40,45,40,65,40,65,295,0.5661764705882353,45,67,60,35,50,63,320,0.5128205128205128,2.0
72,95,67,103,71,122,530,0.9606299212598425,61,90,45,50,50,160,456,0.9230769230769231,1.0
105,95,75,85,75,74,509,0.5714285714285714,85,60,65,135,105,100,550,0.7518248175182481,2.0
70,50,30,95,135,105,485,0.8040540540540541,64,115,65,83,63,65,455,0.5323741007194245,1.0
50,50,77,95,77,91,440,0.5916666666666667,43,70,48,50,60,38,309,0.2391304347826087,1.0
55,68,64,45,55,31,318,0.11666666666666667,65,63,45,45,45,45,308,0.2595419847328244,0.5
80,80,80,80,80,80,480,0.6015037593984962,89,124,80,55,80,55,483,0.5714285714285714,2.0
43,30,55,40,65,97,330,0.6030534351145038,49,49,56,49,61,66,330,0.5190839694656488,0.5
100,75,115,90,115,85,580,0.6446280991735537,80,120,80,120,80,100,580,0.8478260869565217,1.0
75,65,55,65,55,69,384,0.43548387096774194,100,90,130,45,65,55,485,0.4253731343283582,2.0
91,134,95,100,100,80,600,0.6304347826086957,75,95,125,45,75,95,510,0.8257575757575758,1.0
70,135,105,60,105,20,495,0.5806451612903226,70,80,50,35,35,35,305,0.14,0.5
70,55,55,80,60,45,365,0.2222222222222222,105,130,120,45,45,40,485,0.4444444444444444,0.0
80,50,100,100,200,50,580,0.2357142857142857,150,120,100,120,100,90,680,0.664179104477612,2.0
95,60,79,100,125,81,540,0.6201550387596899,72,58,80,103,80,97,490,0.7171052631578947,1.0
50,105,79,35,110,76,455,0.6214285714285714,95,117,184,44,46,28,514,0.2975206611570248,2.0
35,65,35,65,35,65,300,0.46621621621621623,80,125,75,40,95,85,500,0.6911764705882353,1.0
75,105,75,105,75,45,480,0.3274336283185841,65,90,40,45,80,75,395,0.625,1.0
67,82,62,46,48,43,348,0.22033898305084745,78,104,78,159,115,100,634,0.8444444444444444,0.5
55,65,95,95,45,85,440,0.6610169491525424,75,95,60,65,60,115,470,0.8778625954198473,1.0
36,50,50,65,60,44,305,0.16363636363636364,60,90,55,90,80,110,485,0.8677685950413223,1.0
70,110,80,55,80,105,500,0.8794326241134752,60,100,85,80,85,100,510,0.7007874015748031,2.0
100,100,90,150,140,90,670,0.71875,105,140,95,55,65,45,505,0.3,1.0
45,60,45,25,45,55,275,0.29,75,100,110,45,55,65,450,0.5333333333333333,1.0
89,124,80,55,80,55,483,0.5714285714285714,45,35,50,70,50,30,280,0.15753424657534246,0.5
70,70,115,130,90,60,535,0.5338983050847458,65,75,90,97,123,44,494,0.1987179487179487,0.5
60,40,80,60,45,40,325,0.23529411764705882,55,68,64,45,55,31,318,0.11666666666666667,0.5
110,80,90,95,90,65,530,0.5033557046979866,75,125,230,55,95,30,610,0.3448275862068966,2.0
70,130,100,55,80,65,500,0.608,35,55,40,50,50,90,320,0.6838235294117647,0.5
110,65,105,55,95,80,510,0.6258503401360545,65,85,70,75,70,40,405,0.203125,0.5
45,50,45,115,55,95,405,0.6936936936936937,95,125,79,60,100,81,540,0.6165413533834586,1.0
20,40,90,30,90,25,295,0.11363636363636363,40,55,80,35,60,30,300,0.15037593984962405,2.0
80,80,50,40,50,25,325,0.176056338028169,75,55,70,55,95,110,460,0.8444444444444444,2.0
80,135,130,95,90,70,600,0.5181818181818182,60,45,70,45,90,95,405,0.7304964539007093,0.5
60,55,50,40,55,45,305,0.22377622377622378,45,55,45,65,45,75,330,0.5692307692307692,0.5
50,53,48,53,48,64,316,0.4076923076923077,50,40,85,40,65,25,305,0.08870967741935484,0.5
65,80,80,59,63,58,405,0.4411764705882353,45,22,60,27,30,29,213,0.07518796992481203,1.0
50,75,35,70,30,40,300,0.21296296296296297,49,55,42,42,37,85,310,0.6068376068376068,1.0
30,35,30,100,35,80,310,0.4765625,60,65,80,170,95,130,600,0.8625954198473282,0.5
91,90,106,130,106,77,600,0.648854961832061,95,23,48,23,48,23,260,0.046153846153846156,1.0
50,55,50,36,30,43,264,0.2922077922077922,75,80,70,65,75,90,455,0.7578125,1.0
60,69,95,69,95,36,424,0.2608695652173913,80,80,80,55,55,90,440,0.6417910447761194,1.0
85,100,122,58,75,54,494,0.3939393939393939,40,30,32,50,52,65,269,0.3671875,1.0
53,54,53,37,46,45,288,0.3090909090909091,70,70,40,60,40,60,340,0.4247787610619469,0.0
35,35,35,35,35,35,210,0.13385826771653545,114,85,70,85,80,30,464,0.2066115702479339,0.5
45,95,50,40,50,75,355,0.54,55,70,45,70,50,60,350,0.45,1.0
55,45,43,55,43,72,313,0.5853658536585366,99,68,83,72,87,51,460,0.417910447761194,2.0
60,62,80,63,80,60,405,0.4336283185840708,123,77,72,99,92,58,521,0.4621212121212121,2.0
50,150,50,150,50,150,600,0.9339622641509434,45,100,135,65,135,45,525,0.29411764705882354,1.0
85,56,77,50,77,78,423,0.53125,50,45,45,35,35,50,260,0.23529411764705882,1.0
55,40,50,65,85,40,335,0.3181818181818182,65,65,60,130,95,110,525,0.823943661971831,2.0
45,53,70,40,60,42,310,0.25735294117647056,45,20,50,60,120,50,345,0.24074074074074073,0.5
75,75,95,75,95,113,528,0.9015151515151515,68,165,95,65,115,110,618,0.8615384615384616,1.0
78,81,71,74,69,126,499,0.9090909090909091,40,80,100,30,30,20,300,0.11851851851851852,0.25
90,100,90,125,85,90,580,0.7352941176470589,45,35,45,62,53,35,275,0.11851851851851852,4.0
90,93,55,70,55,55,418,0.3819444444444444,110,85,95,80,95,50,515,0.2713178294573643,2.0
80,82,83,100,100,80,525,0.6742424242424242,65,75,90,97,123,44,494,0.1987179487179487,0.125
40,80,100,30,30,20,300,0.11851851851851852,58,70,45,40,45,42,300,0.25925925925925924,0.5
91,72,90,129,90,108,580,0.8925619834710744,70,80,50,35,35,35,305,0.14,1.0
50,85,40,85,40,35,335,0.1746031746031746,75,65,55,65,55,69,384,0.43548387096774194,4.0
20,40,90,30,90,25,295,0.11363636363636363,105,95,75,85,75,74,509,0.5714285714285714,1.0
65,65,60,130,95,110,525,0.823943661971831,58,109,112,48,48,109,484,0.8805970149253731,0.5
64,78,52,78,52,81,405,0.6422764227642277,20,10,55,15,20,80,200,0.17985611510791366,0.5
50,30,55,65,55,20,275,0.13675213675213677,90,85,100,95,125,85,580,0.6834532374100719,2.0
30,105,90,25,25,50,325,0.2773722627737226,80,135,85,70,95,150,615,0.9844961240310077,2.0
1,90,45,30,30,40,236,0.33064516129032256,55,112,45,74,45,70,401,0.559322033898305,0.5
80,135,85,70,95,150,615,0.9844961240310077,100,77,77,128,128,90,600,0.6901408450704225,1.0
45,90,20,65,20,65,305,0.5116279069767442,60,50,150,50,150,60,520,0.5206611570247934,2.0
75,90,90,140,90,115,600,0.9481481481481482,45,55,45,65,45,75,330,0.5692307692307692,2.0
75,90,90,140,90,115,600,0.9481481481481482,90,60,60,40,40,40,330,0.29545454545454547,1.0
35,85,45,35,35,75,310,0.6492537313432836,70,70,70,70,70,70,420,0.5289256198347108,1.0
67,82,62,46,48,43,348,0.22033898305084745,74,94,131,54,116,20,489,0.4485294117647059,2.0
20,40,90,30,90,25,295,0.11363636363636363,64,115,65,83,63,65,455,0.5323741007194245,2.0
114,85,70,85,80,30,464,0.2066115702479339,40,45,40,62,60,60,307,0.33884297520661155,0.5
58,89,77,45,45,48,362,0.3177570093457944,45,85,50,55,50,65,350,0.5076923076923077,0.5
70,20,50,20,50,40,250,0.1557377049180328,50,50,62,40,62,65,329,0.4188034188034188,0.5
65,130,60,95,110,65,525,0.5303030303030303,45,90,20,65,20,65,305,0.5116279069767442,0.5
80,92,65,65,80,68,450,0.4824561403508772,126,131,95,131,98,99,680,0.8294573643410853,1.0
85,80,70,135,75,90,535,0.7006802721088435,80,120,130,55,65,45,495,0.37037037037037035,0.5
255,10,10,75,135,55,540,0.3125,80,50,100,100,200,50,580,0.2357142857142857,1.0
60,40,50,75,85,95,405,0.6044776119402985,80,52,50,90,50,89,411,0.6666666666666666,2.0
80,120,80,120,80,100,580,0.8478260869565217,130,70,35,70,35,60,400,0.4017857142857143,0.5
100,120,100,150,120,90,680,0.728,40,30,30,55,30,85,270,0.4666666666666667,0.5
35,70,55,45,55,25,285,0.09420289855072464,123,77,72,99,92,58,521,0.4621212121212121,2.0
130,85,80,85,95,60,535,0.43884892086330934,75,105,75,105,75,45,480,0.3274336283185841,0.25
70,150,140,65,100,75,600,0.55,80,80,80,80,80,80,480,0.6015037593984962,2.0
65,130,60,95,110,65,525,0.5303030303030303,85,115,80,105,80,50,515,0.3063063063063063,1.0
50,50,120,80,80,30,410,0.07258064516129033,67,57,55,77,55,114,425,0.8879310344827587,2.0
56,61,65,48,45,38,313,0.17567567567567569,55,55,85,65,85,35,380,0.2014388489208633,4.0
62,50,58,73,54,72,369,0.4435483870967742,35,64,85,74,55,32,345,0.19827586206896552,0.5
44,38,39,61,79,42,303,0.2251655629139073,50,53,48,53,48,64,316,0.46153846153846156,0.5
106,150,70,194,120,140,780,0.952,55,55,55,85,55,30,335,0.1320754716981132,0.5
46,87,60,30,40,57,320,0.37777777777777777,55,69,85,32,35,28,304,0.09302325581395349,1.0
103,93,67,71,61,84,479,0.7142857142857143,72,85,70,65,70,58,420,0.41304347826086957,0.5
58,50,145,95,105,30,483,0.2459016393442623,82,80,86,85,75,72,480,0.6183206106870229,1.0
66,41,77,61,87,23,355,0.12096774193548387,67,82,62,46,48,43,348,0.22033898305084745,0.5
95,109,105,75,85,56,525,0.34513274336283184,78,130,111,130,85,100,634,0.8561151079136691,0.5
60,50,50,60,70,50,340,0.28346456692913385,55,45,43,55,43,72,313,0.5853658536585366,0.5
70,85,65,105,85,120,530,0.9262295081967213,70,20,50,20,50,40,250,0.1557377049180328,2.0
65,76,84,54,96,105,480,0.9008264462809917,50,50,40,50,40,64,294,0.45588235294117646,1.0
30,56,35,25,35,72,253,0.48148148148148145,85,135,130,60,80,25,515,0.40540540540540543,0.5
114,85,70,85,80,30,464,0.2066115702479339,40,45,35,65,55,70,310,0.4482758620689655,1.0
85,70,80,97,80,123,535,0.9304347826086956,71,120,95,120,95,99,600,0.8203125,0.5
45,100,45,45,45,10,290,0.2949640287769784,75,75,55,105,85,30,425,0.1619718309859155,0.5
95,117,184,44,46,28,514,0.2975206611570248,30,45,135,45,90,30,375,0.09285714285714286,1.0
75,95,95,95,95,85,540,0.6470588235294118,50,35,55,25,25,15,205,0.05263157894736842,1.0
68,165,95,65,115,110,618,0.8615384615384616,170,90,45,90,45,60,500,0.427536231884058,1.0
57,80,91,80,87,75,470,0.5737704918032787,106,150,70,194,120,140,780,0.952,1.0
40,40,55,40,70,55,300,0.40939597315436244,130,70,35,70,35,60,400,0.4017857142857143,1.0
60,60,75,60,75,80,410,0.7321428571428571,55,63,90,50,80,42,380,0.21138211382113822,0.5
44,38,39,61,79,42,303,0.2251655629139073,50,70,50,50,50,70,340,0.5645161290322581,2.0
73,100,60,100,60,65,458,0.42657342657342656,110,65,75,125,85,30,490,0.15,1.0
85,73,70,73,115,67,483,0.5126050420168067,105,130,120,45,45,40,485,0.4444444444444444,2.0
75,105,75,105,75,45,480,0.3274336283185841,103,60,126,80,126,50,545,0.36363636363636365,1.0
70,70,70,70,70,70,420,0.5289256198347108,70,85,140,85,70,20,470,0.272,1.0
60,105,60,120,60,105,510,0.8849557522123894,65,40,70,80,140,70,465,0.5954198473282443,1.0
50,65,45,85,65,95,405,0.7238095238095238,68,65,65,125,115,80,518,0.6461538461538462,1.0
60,60,60,105,105,105,495,0.848,60,40,60,40,60,35,295,0.18055555555555555,1.0
90,95,105,165,110,45,610,0.2890625,70,110,70,115,70,90,525,0.75,0.5
41,56,40,62,44,71,314,0.568,92,105,90,125,90,98,600,0.8217054263565892,0.5
50,50,120,80,80,30,410,0.07258064516129033,55,85,122,58,75,99,494,0.8099173553719008,2.0
40,40,35,50,100,70,335,0.5031847133757962,80,185,115,40,105,75,600,0.6230769230769231,1.0
91,90,72,90,129,108,580,0.896,30,42,118,42,88,30,350,0.112,4.0
70,120,40,95,40,95,460,0.8106060606060606,50,80,95,10,45,10,290,0.232,2.0
100,73,83,73,83,55,467,0.371900826446281,85,76,64,45,55,90,415,0.6739130434782609,1.0
75,125,100,70,80,45,495,0.33035714285714285,45,63,37,65,55,95,360,0.8055555555555556,1.0
67,58,57,81,67,101,431,0.8790322580645161,20,40,15,35,35,60,205,0.34285714285714286,0.5
90,60,60,40,40,40,330,0.29545454545454547,90,65,65,40,40,15,315,0.19672131147540983,1.0
62,50,58,73,54,72,369,0.4435483870967742,31,45,90,30,30,40,266,0.21929824561403508,2.0
71,120,95,120,95,99,600,0.8203125,85,50,95,120,115,80,545,0.5793650793650794,0.125
74,100,72,90,72,46,454,0.24561403508771928,76,48,48,57,62,34,325,0.11688311688311688,2.0
65,65,60,130,95,110,525,0.823943661971831,25,35,70,95,55,45,325,0.16783216783216784,0.5
130,65,60,110,95,65,525,0.5227272727272727,75,95,95,95,95,85,540,0.6470588235294118,0.25
60,55,145,75,150,40,525,0.2,80,90,80,130,110,110,600,0.856,1.0
45,60,30,80,50,65,330,0.4603174603174603,105,105,75,65,100,50,500,0.37593984962406013,1.0
40,27,60,37,50,66,280,0.36220472440944884,60,62,80,63,80,60,405,0.4336283185840708,0.5
78,84,78,109,85,100,534,0.8646616541353384,95,117,184,44,46,28,514,0.2975206611570248,2.0
59,110,150,45,49,35,448,0.3333333333333333,31,45,90,30,30,40,266,0.21929824561403508,1.0
50,120,53,35,110,87,455,0.640625,80,105,105,105,105,80,580,0.5939849624060151,0.5
70,150,140,65,100,75,600,0.55,54,63,52,83,56,97,405,0.7697841726618705,0.5
43,70,48,50,60,38,309,0.2391304347826087,65,65,60,130,95,110,525,0.823943661971831,2.0
35,65,35,65,35,65,300,0.46621621621621623,58,89,77,45,45,48,362,0.3177570093457944,1.0
50,95,180,85,45,70,525,0.5298507462686567,100,120,120,150,100,90,680,0.7880794701986755,0.5
60,55,50,40,55,45,305,0.22377622377622378,125,58,58,76,76,67,460,0.515625,1.0
103,60,126,80,126,50,545,0.36363636363636365,70,105,105,50,40,20,390,0.33587786259541985,0.5
53,51,53,61,56,40,314,0.14285714285714285,50,65,85,35,35,55,325,0.32575757575757575,2.0
80,120,79,95,79,70,523,0.5833333333333334,75,65,55,65,55,69,384,0.43548387096774194,0.0
75,80,95,90,100,50,490,0.2158273381294964,65,65,60,110,95,130,525,0.9253731343283582,1.0
28,25,25,45,35,40,198,0.16083916083916083,80,105,105,105,105,80,580,0.5939849624060151,0.5
75,95,125,45,75,95,510,0.8257575757575758,58,70,45,40,45,42,300,0.25925925925925924,1.0
74,48,76,83,81,104,466,0.7322834645669292,35,60,44,40,54,55,288,0.366412213740458,2.0
95,135,80,110,80,100,600,0.8248175182481752,50,50,62,40,62,65,329,0.4188034188034188,1.0
50,55,50,36,30,43,264,0.2922077922077922,85,105,55,85,50,115,495,0.9032258064516129,1.0
54,78,103,53,45,22,355,0.23255813953488372,76,104,71,104,71,108,534,0.912751677852349,2.0
55,68,64,45,55,31,318,0.11666666666666667,70,140,70,110,65,105,560,0.95,2.0
65,70,60,65,65,115,440,0.8583333333333333,50,80,95,10,45,10,290,0.232,0.5
50,64,50,45,50,41,300,0.22727272727272727,45,25,50,25,25,35,205,0.13076923076923078,2.0
76,65,45,92,42,91,411,0.7449664429530202,60,67,85,77,75,116,480,0.8888888888888888,2.0
106,110,90,154,90,130,680,0.926829268292683,50,80,95,10,45,10,290,0.232,1.0
100,75,115,90,115,85,580,0.6446280991735537,95,75,180,130,80,30,590,0.13793103448275862,0.5
75,125,75,30,75,85,465,0.625,60,40,60,40,60,35,295,0.18055555555555555,1.0
60,90,70,60,120,40,440,0.27419354838709675,78,84,78,109,85,100,534,0.8620689655172413,1.0
75,125,230,55,95,30,610,0.3448275862068966,30,65,100,45,25,40,305,0.1891891891891892,0.5
55,45,43,55,43,72,313,0.5853658536585366,70,77,60,97,60,108,472,0.8394160583941606,1.0
60,80,95,70,85,50,440,0.2231404958677686,91,134,95,100,100,80,600,0.6304347826086957,1.0
80,125,75,40,95,85,500,0.6911764705882353,70,145,88,140,70,112,625,0.8888888888888888,0.5
35,46,34,35,45,20,215,0.072,1,90,45,30,30,40,236,0.33064516129032256,0.0
85,97,66,105,66,65,484,0.47107438016528924,60,60,60,105,105,105,495,0.848,1.0
44,48,65,50,64,43,314,0.1623931623931624,40,45,35,30,40,55,245,0.3793103448275862,1.0
85,105,85,40,50,40,405,0.211864406779661,50,72,35,35,35,65,292,0.5373134328358209,2.0
45,40,60,40,75,50,310,0.2926829268292683,75,98,63,98,63,101,498,0.8091603053435115,2.0
90,110,80,100,80,95,555,0.7982456140350878,50,92,108,92,108,35,485,0.2457627118644068,1.0
78,130,111,130,85,100,634,0.8561151079136691,91,134,95,100,100,80,600,0.6304347826086957,1.0
70,120,65,45,85,125,510,0.9747899159663865,35,40,100,90,55,35,355,0.1796875,0.5
54,78,103,53,45,22,355,0.23255813953488372,45,80,100,35,37,28,325,0.3125,0.5
62,55,52,109,94,109,481,0.7833333333333333,75,125,100,70,80,45,495,0.33035714285714285,0.5
65,95,75,55,55,85,430,0.6933333333333334,20,10,55,15,20,80,200,0.17985611510791366,0.5
50,65,64,44,48,43,314,0.2196969696969697,75,105,75,105,75,45,480,0.3274336283185841,0.5
68,65,65,125,115,80,518,0.6461538461538462,60,65,80,170,95,130,600,0.8625954198473282,1.0
65,60,70,85,75,40,395,0.1796875,100,73,83,73,83,55,467,0.371900826446281,1.0
65,55,115,100,40,60,435,0.3798449612403101,60,60,60,60,60,60,360,0.38095238095238093,1.0
45,60,32,50,32,76,295,0.5925925925925926,62,48,66,59,57,49,341,0.33884297520661155,1.0
50,52,48,65,50,55,320,0.33098591549295775,55,112,45,74,45,70,401,0.559322033898305,2.0
65,65,60,130,95,110,525,0.823943661971831,39,52,43,60,50,65,309,0.49107142857142855,1.0
68,90,65,50,55,82,410,0.6165413533834586,40,45,35,40,40,90,290,0.65,1.0
65,80,140,40,70,70,465,0.5223880597014925,60,79,105,59,85,36,424,0.17054263565891473,2.0
55,40,50,65,85,40,335,0.3181818181818182,75,100,95,40,70,110,490,0.8717948717948718,0.0
62,77,62,50,42,65,358,0.4838709677419355,95,117,80,65,70,92,519,0.8409090909090909,1.0
45,49,65,49,65,45,318,0.275,60,100,85,80,85,100,510,0.7007874015748031,1.0
70,120,40,95,40,95,460,0.8106060606060606,90,75,85,115,90,55,510,0.3445378151260504,1.0
100,100,100,100,100,100,600,0.8602941176470589,55,20,35,20,45,75,250,0.37681159420289856,1.0
45,60,32,50,32,76,295,0.5925925925925926,130,70,35,70,35,60,400,0.4017857142857143,2.0
100,150,90,180,160,90,770,0.7348484848484849,70,80,70,80,70,110,480,0.6594202898550725,1.0
45,75,37,70,55,83,365,0.6183206106870229,80,70,40,100,60,145,495,0.921875,2.0
55,70,45,70,50,60,350,0.45,108,112,118,68,72,47,525,0.2916666666666667,1.0
60,85,69,65,79,80,438,0.576,80,85,95,30,30,25,345,0.2857142857142857,0.25
95,95,85,125,65,55,520,0.3894736842105263,85,110,90,45,90,80,500,0.6206896551724138,1.0
70,60,75,110,75,90,480,0.7165354330708661,45,75,60,40,30,50,300,0.304,0.5
65,80,80,59,63,58,405,0.4411764705882353,80,105,65,60,75,130,515,0.9645390070921985,2.0
55,75,85,25,25,15,280,0.1875,50,50,120,80,80,30,410,0.07258064516129033,2.0
95,70,73,95,90,60,483,0.3983739837398374,85,110,76,65,82,56,474,0.3933333333333333,1.0
45,30,40,105,50,20,290,0.031007751937984496,71,95,85,110,95,79,535,0.664,1.0
91,90,72,90,129,108,580,0.896,105,130,120,45,45,40,485,0.4444444444444444,8.0
60,70,50,100,50,65,395,0.5217391304347826,70,75,60,105,60,105,475,0.88,0.5
65,55,115,100,40,60,435,0.3798449612403101,50,35,55,25,25,15,205,0.05263157894736842,0.5
80,105,65,60,75,130,515,0.9645390070921985,50,45,45,35,35,50,260,0.23529411764705882,1.0
92,105,90,125,90,98,600,0.8217054263565892,100,180,160,150,90,90,770,0.7520661157024794,1.0
65,80,140,40,70,70,465,0.5223880597014925,104,91,63,91,73,68,490,0.5118110236220472,1.0
86,92,88,68,75,73,482,0.6835443037974683,44,48,65,50,64,43,314,0.1623931623931624,1.0
80,90,80,130,110,110,600,0.856,50,65,90,35,35,15,290,0.14678899082568808,1.0
90,90,85,125,90,100,580,0.768595041322314,60,80,50,40,40,30,300,0.15328467153284672,1.0
85,135,130,60,80,25,515,0.40540540540540543,90,60,60,40,40,40,330,0.29545454545454547,0.5
108,170,115,120,95,92,700,0.7083333333333334,70,80,70,80,70,110,480,0.6594202898550725,1.0
70,65,60,90,75,90,450,0.6571428571428571,91,90,129,90,72,108,580,0.9140625,0.0
35,35,35,35,35,35,210,0.13385826771653545,65,155,120,65,90,105,600,0.8677685950413223,0.25
49,55,42,42,37,85,310,0.6068376068376068,90,60,60,40,40,40,330,0.29545454545454547,1.0
60,75,100,55,80,50,420,0.3088235294117647,90,85,100,95,125,85,580,0.6834532374100719,2.0
60,60,60,105,105,105,495,0.848,45,45,55,45,55,63,308,0.4594594594594595,1.0
95,75,180,130,80,30,590,0.13793103448275862,73,76,75,81,100,100,505,0.8110236220472441,2.0
39,52,43,60,50,65,309,0.5041322314049587,80,82,100,83,100,80,525,0.6821705426356589,2.0
75,125,100,70,80,45,495,0.33035714285714285,70,55,95,95,110,65,490,0.48872180451127817,2.0
20,15,20,10,55,80,200,0.2682926829268293,110,160,110,80,110,100,670,0.8591549295774648,1.0
130,85,80,85,95,60,535,0.43884892086330934,100,100,80,60,60,50,450,0.3050847457627119,2.0
60,55,145,75,150,40,525,0.2,70,130,100,55,80,65,500,0.608,0.5
100,100,100,100,100,100,600,0.8778625954198473,95,109,105,75,85,56,525,0.34513274336283184,4.0
91,90,129,90,72,108,580,0.9140625,59,63,80,65,80,58,405,0.41843971631205673,0.5
80,80,90,110,130,110,600,0.8721804511278195,60,85,60,85,60,55,405,0.3673469387755102,1.0
70,140,230,60,80,50,630,0.32432432432432434,130,65,60,110,95,65,525,0.5227272727272727,0.5
50,53,48,53,48,64,316,0.358974358974359,70,83,50,37,50,60,350,0.3360655737704918,1.0
85,76,64,45,55,90,415,0.6739130434782609,63,63,47,41,41,74,329,0.56,1.0
30,45,59,30,39,57,260,0.2803030303030303,70,85,65,105,85,120,530,0.9262295081967213,4.0
103,93,67,71,61,84,479,0.7142857142857143,90,75,85,115,90,55,510,0.3445378151260504,1.0
70,120,65,45,85,125,510,0.9747899159663865,78,65,68,112,154,75,552,0.628099173553719,0.5
70,110,70,115,70,90,525,0.75,80,100,123,122,120,80,625,0.56,0.5
54,78,103,53,45,22,355,0.23255813953488372,50,53,48,53,48,64,316,0.4076923076923077,0.5
105,140,95,55,65,45,505,0.3,70,50,30,95,135,105,485,0.8040540540540541,2.0
60,55,90,145,90,80,520,0.6071428571428571,65,80,65,35,65,60,370,0.38405797101449274,0.0
60,52,168,47,138,30,495,0.19834710743801653,30,30,30,30,30,30,180,0.12612612612612611,1.0
95,125,79,60,100,81,540,0.6165413533834586,38,30,41,30,41,60,240,0.2897196261682243,1.0
85,73,70,73,115,67,483,0.5126050420168067,80,135,85,70,95,150,615,0.9844961240310077,1.0
45,67,60,35,50,63,320,0.5128205128205128,79,85,60,55,60,71,410,0.60431654676259,0.5
80,105,65,60,75,130,515,0.9645390070921985,90,100,90,125,85,90,580,0.7352941176470589,4.0
35,46,34,35,45,20,215,0.072,75,95,125,45,75,95,510,0.8257575757575758,1.0
80,125,75,40,95,85,500,0.6911764705882353,65,50,70,95,80,65,425,0.4262295081967213,1.0
65,90,120,85,70,60,490,0.43410852713178294,43,30,55,40,65,97,330,0.6030534351145038,1.0
72,95,67,103,71,122,530,0.9606299212598425,60,75,85,100,85,115,520,0.8992248062015504,1.0
40,35,30,120,70,105,400,0.6692307692307692,50,75,70,35,70,48,348,0.29357798165137616,0.0
50,65,107,105,107,86,520,0.703125,126,131,95,131,98,99,680,0.8294573643410853,1.0
75,89,85,55,65,36,405,0.29545454545454547,62,73,55,56,52,84,382,0.7244094488188977,0.25
40,80,35,35,45,70,305,0.4661016949152542,50,30,55,65,55,20,275,0.13675213675213677,0.0
65,65,60,130,95,110,525,0.823943661971831,70,77,60,97,60,108,472,0.8394160583941606,1.0
40,30,30,40,50,30,220,0.07936507936507936,50,50,95,40,50,35,320,0.20279720279720279,4.0
80,145,150,105,110,110,700,0.8692307692307693,60,90,55,90,80,110,485,0.8677685950413223,0.5
70,60,62,80,82,60,414,0.4375,78,70,61,50,61,100,420,0.8145161290322581,1.0
100,100,90,150,140,90,670,0.71875,55,40,85,80,105,40,405,0.23622047244094488,1.0
92,105,90,125,90,98,600,0.8217054263565892,70,80,102,80,102,40,474,0.2677165354330709,1.0
50,40,85,40,65,25,305,0.08870967741935484,95,125,79,60,100,81,540,0.6165413533834586,0.5
45,60,30,80,50,65,330,0.4603174603174603,30,30,42,30,42,70,244,0.4230769230769231,2.0
55,69,85,32,35,28,304,0.09302325581395349,79,100,80,110,90,121,580,0.968,2.0
66,41,77,61,87,23,355,0.12096774193548387,78,104,78,159,115,100,634,0.8444444444444444,1.0
55,50,45,135,95,120,500,0.7714285714285715,38,30,41,30,41,60,240,0.2897196261682243,1.0
50,50,40,50,40,64,294,0.45588235294117646,60,85,40,30,45,68,328,0.6422018348623854,2.0
60,55,145,75,150,40,525,0.2,74,94,131,54,116,20,489,0.4485294117647059,0.25
50,105,79,35,110,76,455,0.6214285714285714,78,52,60,63,65,23,341,0.06015037593984962,0.5
55,69,85,32,35,28,304,0.09302325581395349,103,60,126,80,126,50,545,0.36363636363636365,1.0
55,35,50,55,110,85,390,0.6277372262773723,50,30,55,65,55,20,275,0.13675213675213677,0.25
72,58,80,103,80,97,490,0.7171052631578947,105,180,100,180,100,115,780,0.9477611940298507,1.0
68,85,65,165,135,100,618,0.8083333333333333,90,60,60,40,40,40,330,0.29545454545454547,2.0
70,100,70,105,75,40,460,0.23214285714285715,95,80,105,40,70,100,490,0.8046875,1.0
45,35,50,70,50,30,280,0.15753424657534246,60,60,60,105,105,105,495,0.848,1.0
85,110,76,65,82,56,474,0.3933333333333333,55,55,85,65,85,35,380,0.2014388489208633,4.0
38,30,85,55,65,30,303,0.21428571428571427,75,38,38,56,56,67,330,0.5263157894736842,1.0
50,160,110,160,110,110,700,0.8854961832061069,60,67,85,77,75,116,480,0.8888888888888888,1.0
60,100,89,55,69,112,485,0.9298245614035088,50,20,55,25,25,30,205,0.09774436090225563,1.0
60,45,70,45,90,95,405,0.7304964539007093,60,70,105,70,120,75,500,0.5983606557377049,0.0
70,60,62,80,82,60,414,0.4375,90,95,105,165,110,45,610,0.2890625,0.5
100,100,100,100,100,100,600,0.8805970149253731,40,45,40,35,35,56,251,0.373015873015873,1.0
71,120,95,120,95,99,600,0.8203125,20,40,15,35,35,60,205,0.34285714285714286,0.5
85,70,80,97,80,123,535,0.9304347826086956,40,70,40,35,40,60,285,0.392,2.0
30,42,118,42,88,30,350,0.112,37,25,41,25,41,25,194,0.08870967741935484,2.0
20,10,230,10,230,5,505,0.0,95,145,130,120,90,120,700,0.9398496240601504,1.0
67,57,55,77,55,114,425,0.8879310344827587,58,70,45,40,45,42,300,0.25925925925925924,2.0
70,90,110,60,75,95,500,0.7333333333333333,50,100,150,100,150,50,600,0.37142857142857144,0.5
55,112,45,74,45,70,401,0.559322033898305,50,95,95,35,110,70,455,0.5179856115107914,1.0
106,150,70,194,120,140,780,0.952,78,65,68,112,154,75,552,0.628099173553719,1.0
65,90,65,61,61,100,442,0.8373983739837398,95,145,130,120,90,120,700,0.9398496240601504,1.0
91,129,90,72,90,108,580,0.8536585365853658,68,75,53,83,113,60,452,0.45384615384615384,1.0
80,120,80,120,80,100,580,0.8478260869565217,70,120,100,145,105,20,560,0.2824427480916031,1.0
50,20,55,25,25,30,205,0.09774436090225563,45,53,70,40,60,42,310,0.25735294117647056,2.0
50,20,55,25,25,30,205,0.09774436090225563,82,80,86,85,75,72,480,0.6183206106870229,0.5
70,85,65,105,85,120,530,0.9262295081967213,30,30,42,30,42,70,244,0.4230769230769231,0.25
59,63,80,65,80,58,405,0.41843971631205673,78,70,61,50,61,100,420,0.8145161290322581,1.0
97,165,60,65,50,58,495,0.3902439024390244,65,90,115,45,115,58,488,0.5041322314049587,0.5
85,105,100,79,83,78,530,0.5869565217391305,60,59,85,79,105,36,424,0.16666666666666666,0.5
25,35,70,95,55,45,325,0.16783216783216784,70,100,115,30,65,30,410,0.24390243902439024,2.0
50,180,20,180,20,150,600,0.9029850746268657,50,64,50,45,50,41,300,0.22727272727272727,2.0
60,67,85,77,75,116,480,0.8888888888888888,45,100,135,65,135,45,525,0.29411764705882354,1.0
70,120,65,45,85,125,510,0.9747899159663865,105,95,75,85,75,74,509,0.5714285714285714,1.0
110,80,90,95,90,65,530,0.5033557046979866,60,75,100,55,80,50,420,0.3088235294117647,0.5
69,55,45,55,55,15,294,0.11666666666666667,80,160,60,170,130,80,680,0.6180555555555556,1.0
58,109,112,48,48,109,484,0.8805970149253731,80,95,82,60,82,75,474,0.6,0.5
59,63,80,65,80,58,405,0.41843971631205673,55,81,60,50,70,97,413,0.7214285714285714,1.0
60,69,95,69,95,36,424,0.2608695652173913,71,120,95,120,95,99,600,0.8203125,0.25
108,170,115,120,95,92,700,0.7083333333333334,60,90,140,50,50,40,430,0.2535211267605634,2.0
75,125,230,55,95,30,610,0.3448275862068966,50,150,50,150,50,150,600,0.9339622641509434,1.0
72,60,30,20,30,25,237,0.11570247933884298,89,124,80,55,80,55,483,0.5714285714285714,0.0
80,80,50,40,50,25,325,0.176056338028169,31,45,90,30,30,40,266,0.21929824561403508,0.5
60,50,100,85,70,65,430,0.47580645161290325,75,80,95,90,100,50,490,0.2158273381294964,1.0
70,84,70,65,70,51,410,0.2949640287769784,60,70,50,100,50,65,395,0.5217391304347826,0.0
46,87,60,30,40,57,320,0.37777777777777777,62,50,58,73,54,72,369,0.4435483870967742,1.0
103,60,86,60,86,50,445,0.3458646616541353,80,70,40,100,60,145,495,0.921875,1.0
55,40,40,65,45,35,280,0.16428571428571428,45,100,135,65,135,45,525,0.29411764705882354,1.0
64,88,50,88,50,106,446,0.9111111111111111,50,100,150,100,150,50,600,0.37142857142857144,0.5
35,65,35,65,35,65,300,0.46621621621621623,70,90,90,135,90,125,600,0.9401709401709402,1.0
95,65,110,60,130,65,525,0.5275590551181102,60,55,50,40,55,45,305,0.22377622377622378,1.0
55,50,40,40,40,75,300,0.5945945945945946,30,40,55,40,55,60,280,0.3237410071942446,1.0
95,100,85,108,70,70,528,0.5652173913043478,105,30,105,140,105,55,540,0.3524590163934426,2.0
60,90,70,60,120,40,440,0.27419354838709675,38,30,85,55,65,30,303,0.21428571428571427,0.0
64,165,75,93,83,75,555,0.6587301587301587,40,30,30,40,50,30,220,0.07936507936507936,1.0
75,80,70,65,75,90,455,0.7578125,80,160,80,130,80,100,630,0.8455284552845529,2.0
40,70,130,60,130,25,455,0.17355371900826447,65,70,60,65,65,115,440,0.8583333333333333,0.0
55,81,60,50,70,97,413,0.7214285714285714,60,85,42,85,42,91,405,0.8227848101265823,1.0
35,40,100,90,55,35,355,0.1796875,160,110,65,65,110,30,540,0.35714285714285715,1.0
60,85,49,60,49,60,363,0.4444444444444444,80,160,60,170,130,80,680,0.6180555555555556,1.0
95,65,65,110,130,60,525,0.4016393442622951,75,70,90,70,105,80,490,0.656,2.0
65,40,50,125,60,30,370,0.07258064516129033,60,85,69,65,79,80,438,0.576,2.0
90,93,55,70,55,55,418,0.3819444444444444,70,80,50,35,35,35,305,0.14,1.0
60,50,40,85,75,95,405,0.7540983606557377,65,60,110,130,95,65,525,0.47761194029850745,1.0
55,40,40,65,45,35,280,0.16428571428571428,110,78,73,76,71,60,468,0.3333333333333333,0.0
59,66,70,44,55,41,335,0.25190839694656486,65,55,115,100,40,60,435,0.3798449612403101,0.5
40,60,30,31,31,70,262,0.4492753623188406,70,105,105,50,40,20,390,0.33587786259541985,0.25
65,90,115,45,115,58,488,0.5041322314049587,45,50,35,55,75,40,300,0.21367521367521367,1.0
40,45,35,65,55,70,310,0.4482758620689655,65,100,70,80,80,105,500,0.8666666666666667,0.5
50,53,48,53,48,64,316,0.46153846153846156,68,72,78,38,42,32,330,0.23809523809523808,1.0
44,48,65,50,64,43,314,0.1623931623931624,10,55,25,35,45,95,265,0.5396825396825397,2.0
80,135,130,95,90,70,600,0.5181818181818182,85,110,76,65,82,56,474,0.3933333333333333,1.0
79,115,70,125,80,111,580,0.8468468468468469,79,85,60,55,60,71,410,0.60431654676259,1.0
43,30,55,40,65,97,330,0.6030534351145038,65,50,35,115,95,95,455,0.7333333333333333,1.0
41,50,37,50,37,66,281,0.5175438596491229,90,55,75,60,75,30,385,0.13970588235294118,1.0
85,110,76,65,82,56,474,0.3933333333333333,75,70,90,70,105,80,490,0.656,0.25
120,70,120,75,130,85,600,0.6694915254237288,50,65,107,105,107,86,520,0.7313432835820896,1.0
80,80,90,110,130,110,600,0.8721804511278195,70,115,60,115,60,55,475,0.4647887323943662,0.0
80,85,95,30,30,25,345,0.2857142857142857,52,65,50,45,50,38,300,0.27419354838709675,1.0
45,35,50,70,50,30,280,0.15753424657534246,70,55,65,95,85,70,440,0.5307692307692308,2.0
90,65,65,40,40,15,315,0.19672131147540983,75,125,230,55,95,30,610,0.3448275862068966,2.0
60,65,80,170,95,130,600,0.8625954198473282,55,55,45,63,45,45,308,0.25,1.0
45,22,60,27,30,29,213,0.07518796992481203,61,84,65,70,70,70,420,0.5,1.0
67,125,40,30,30,58,350,0.3431372549019608,65,85,70,75,70,40,405,0.203125,1.0
45,85,70,40,40,60,340,0.5229357798165137,45,20,50,60,120,50,345,0.24074074074074073,0.5
90,55,75,60,75,30,385,0.13970588235294118,95,80,105,40,70,100,490,0.8046875,1.0
60,95,80,60,80,30,405,0.19480519480519481,70,135,105,60,105,20,495,0.5806451612903226,0.125
35,45,160,30,45,70,385,0.48148148148148145,70,110,180,60,60,50,530,0.4117647058823529,2.0
38,35,40,27,25,35,200,0.08208955223880597,65,85,70,75,70,40,405,0.203125,1.0
55,68,64,45,55,31,318,0.11666666666666667,115,45,20,45,25,20,270,0.11538461538461539,1.0
70,120,40,95,40,95,460,0.8106060606060606,90,100,90,125,85,90,580,0.7352941176470589,2.0
106,190,100,154,100,130,780,0.9259259259259259,76,147,90,60,70,97,540,0.8267716535433071,1.0
40,30,35,45,40,55,245,0.31496062992125984,35,45,160,30,45,70,385,0.48148148148148145,0.5
65,100,70,80,80,105,500,0.8666666666666667,50,45,45,35,35,50,260,0.23529411764705882,1.0
70,77,60,97,60,108,472,0.8394160583941606,60,59,85,79,105,36,424,0.16666666666666666,1.0
45,50,45,115,55,95,405,0.6936936936936937,28,25,25,45,35,40,198,0.16083916083916083,4.0
123,77,72,99,92,58,521,0.4621212121212121,95,145,130,120,90,120,700,0.9398496240601504,8.0
30,42,118,42,88,30,350,0.112,105,180,100,180,100,115,780,0.9477611940298507,2.0
83,80,80,135,80,121,579,0.9444444444444444,40,45,35,30,40,55,245,0.3793103448275862,1.0
45,40,60,40,75,50,310,0.2926829268292683,40,30,35,50,70,55,280,0.28205128205128205,2.0
50,65,107,105,107,86,520,0.6991150442477876,78,104,78,159,115,100,634,0.8444444444444444,1.0
30,30,42,30,42,70,244,0.4230769230769231,70,65,60,90,75,90,450,0.6571428571428571,1.0
75,125,230,55,95,30,610,0.3448275862068966,40,55,80,35,60,30,300,0.15037593984962405,1.0
75,95,95,95,95,85,540,0.6470588235294118,60,65,70,85,75,40,395,0.21705426356589147,0.5
50,95,95,35,110,70,455,0.5179856115107914,45,60,40,70,50,45,310,0.2846715328467153,1.0
45,49,49,65,65,45,318,0.2781954887218045,90,130,80,65,85,55,505,0.4396551724137931,1.0
54,66,70,44,55,46,335,0.4214876033057851,35,35,35,35,35,35,210,0.13385826771653545,1.0
60,25,35,70,80,60,330,0.3076923076923077,72,105,115,54,86,68,500,0.5149253731343284,1.0
85,97,66,105,66,65,484,0.47107438016528924,95,109,105,75,85,56,525,0.34513274336283184,2.0
80,160,80,130,80,100,630,0.8455284552845529,80,100,70,50,60,45,405,0.25806451612903225,1.0
95,75,80,100,110,30,490,0.24242424242424243,45,100,45,45,45,10,290,0.2949640287769784,4.0
35,55,40,50,50,90,320,0.6838235294117647,55,63,90,50,80,42,380,0.21138211382113822,0.5
49,49,56,49,61,66,330,0.5190839694656488,40,45,65,100,120,90,460,0.5588235294117647,1.0
64,78,52,78,52,81,405,0.6422764227642277,70,55,95,95,110,65,490,0.48872180451127817,0.5
60,55,50,40,55,45,305,0.22377622377622378,50,120,53,35,110,87,455,0.640625,0.5
90,95,105,165,110,45,610,0.2890625,65,40,50,125,60,30,370,0.07258064516129033,1.0
80,80,50,40,50,25,325,0.176056338028169,75,75,75,125,95,40,485,0.15671641791044777,1.0
50,64,50,45,50,41,300,0.22727272727272727,78,70,61,50,61,100,420,0.8145161290322581,1.0
45,95,50,40,50,75,355,0.54,170,90,45,90,45,60,500,0.427536231884058,1.0
54,45,47,75,98,52,371,0.39669421487603307,38,35,35,65,55,50,278,0.2647058823529412,1.0
75,90,50,110,80,95,500,0.7985611510791367,80,105,65,60,75,130,515,0.9645390070921985,0.5
95,100,85,108,70,70,528,0.5652173913043478,65,150,60,115,60,115,565,0.935251798561151,1.0
70,100,115,30,65,30,410,0.24390243902439024,65,76,84,54,96,105,480,0.9008264462809917,1.0
90,130,80,65,85,55,505,0.4396551724137931,55,50,40,40,40,75,300,0.5945945945945946,2.0
80,82,100,83,100,80,525,0.6821705426356589,126,131,95,131,98,99,680,0.8102189781021898,0.5
65,90,115,45,115,58,488,0.5041322314049587,105,150,90,150,90,95,680,0.8285714285714286,0.5
70,84,70,65,70,51,410,0.2949640287769784,70,90,70,60,60,70,420,0.6390977443609023,1.0
50,92,108,92,108,35,485,0.2457627118644068,74,94,131,54,116,20,489,0.4485294117647059,1.0
40,70,40,35,40,60,285,0.392,60,65,60,130,75,110,500,0.7719298245614035,0.0
95,23,48,23,48,23,260,0.046153846153846156,55,112,45,74,45,70,401,0.559322033898305,1.0
65,125,100,55,70,85,500,0.6532258064516129,80,70,40,100,60,145,495,0.921875,1.0
103,93,67,71,61,84,479,0.7142857142857143,65,150,60,115,60,115,565,0.935251798561151,0.5
105,140,55,30,55,95,480,0.8195488721804511,75,65,55,65,55,69,384,0.43548387096774194,0.5
126,131,95,131,98,99,680,0.8102189781021898,30,45,135,45,90,30,375,0.09285714285714286,0.5
50,45,45,35,35,50,260,0.23529411764705882,190,33,58,33,58,33,405,0.13432835820895522,1.0
80,70,70,90,100,70,480,0.5609756097560976,62,73,55,56,52,84,382,0.7244094488188977,0.5
60,60,75,60,75,80,410,0.7321428571428571,30,30,30,30,30,30,180,0.12612612612612611,1.0
100,150,90,180,160,90,770,0.7348484848484849,65,90,122,58,75,84,494,0.71875,0.5
35,65,35,65,35,65,300,0.46621621621621623,100,150,110,95,110,70,635,0.5923076923076923,1.0
70,85,70,60,70,50,405,0.28378378378378377,60,50,40,85,75,95,405,0.7540983606557377,2.0
89,145,90,105,80,91,600,0.8549618320610687,20,10,230,10,230,5,505,0.0,1.0
90,100,70,110,150,80,600,0.6037735849056604,28,25,25,45,35,40,198,0.16083916083916083,0.0
30,105,90,25,25,50,325,0.2773722627737226,40,55,99,40,79,47,360,0.26262626262626265,1.0
80,80,80,80,80,80,480,0.6015037593984962,68,65,65,125,115,80,518,0.6461538461538462,1.0
60,25,35,70,80,60,330,0.3076923076923077,60,85,40,30,45,68,328,0.6422018348623854,2.0
60,60,60,105,105,105,495,0.848,70,110,80,55,80,105,500,0.8794326241134752,1.0
110,135,60,50,65,88,508,0.7744360902255639,59,63,80,65,80,58,405,0.41843971631205673,0.5
95,95,85,125,65,55,520,0.3894736842105263,99,68,83,72,87,51,460,0.417910447761194,0.25
65,90,40,45,80,75,395,0.625,52,65,50,45,50,38,300,0.27419354838709675,2.0
70,140,230,60,80,50,630,0.32432432432432434,60,85,49,60,49,60,363,0.4444444444444444,0.5
55,45,43,55,43,72,313,0.5853658536585366,125,58,58,76,76,67,460,0.515625,0.5
60,80,50,40,40,30,300,0.15328467153284672,80,120,80,120,80,100,580,0.8478260869565217,1.0
60,70,65,125,105,90,515,0.6911764705882353,45,20,50,60,120,50,345,0.24074074074074073,1.0
70,85,65,105,85,120,530,0.9262295081967213,88,107,122,74,75,64,530,0.4596774193548387,0.5
110,85,95,80,95,50,515,0.2713178294573643,70,90,70,60,60,70,420,0.6390977443609023,1.0
95,100,85,108,70,70,528,0.5652173913043478,30,30,30,30,30,30,180,0.12612612612612611,0.5
80,75,150,75,150,50,580,0.30973451327433627,58,89,77,45,45,48,362,0.3177570093457944,2.0
45,53,70,40,60,42,310,0.25735294117647056,60,50,70,50,90,65,385,0.39568345323741005,0.125
65,50,35,115,95,95,455,0.7333333333333333,38,41,40,50,65,65,299,0.4108527131782946,0.5
150,80,44,90,54,80,498,0.625,75,75,60,83,60,60,413,0.39344262295081966,1.0
50,75,75,65,65,50,380,0.4049586776859504,126,131,95,131,98,99,680,0.8102189781021898,0.25
60,60,60,35,35,30,280,0.11194029850746269,90,70,80,70,95,70,475,0.5190839694656488,1.0
75,75,95,75,95,113,528,0.9015151515151515,50,70,100,40,40,30,330,0.2222222222222222,1.0
45,30,50,65,50,45,285,0.13821138211382114,50,105,79,35,110,76,455,0.6214285714285714,1.0
78,81,71,74,69,126,499,0.9090909090909091,45,49,49,65,65,45,318,0.2781954887218045,4.0
78,84,78,109,85,100,534,0.8620689655172413,58,70,45,40,45,42,300,0.25925925925925924,0.5
45,30,50,55,65,45,290,0.208,100,150,90,180,160,90,770,0.7348484848484849,1.0
90,75,75,90,100,70,500,0.5462184873949579,40,50,90,30,55,65,330,0.44680851063829785,1.0
72,60,30,20,30,25,237,0.11570247933884298,74,108,133,83,65,32,495,0.32142857142857145,2.0
60,110,70,60,60,100,460,0.8461538461538461,95,75,80,100,110,30,490,0.24242424242424243,1.0
78,92,75,74,63,118,500,0.8842975206611571,60,79,105,59,85,36,424,0.17054263565891473,1.0
80,82,83,100,100,80,525,0.6742424242424242,150,100,120,100,120,90,680,0.6666666666666666,0.25
20,15,20,10,55,80,200,0.2682926829268293,50,50,50,50,50,50,300,0.30708661417322836,1.0
123,100,62,97,81,68,531,0.4806201550387597,52,65,50,45,50,38,300,0.27419354838709675,0.5
95,60,79,100,125,81,540,0.6201550387596899,65,130,60,95,110,65,525,0.5303030303030303,2.0
70,110,80,55,80,105,500,0.8794326241134752,45,45,35,20,30,20,195,0.07246376811594203,2.0
90,90,85,125,90,100,580,0.768595041322314,46,57,40,40,40,50,273,0.25,1.0
170,90,45,90,45,60,500,0.427536231884058,110,80,90,95,90,65,530,0.5033557046979866,0.5
85,76,64,45,55,90,415,0.6739130434782609,110,78,73,76,71,60,468,0.3333333333333333,1.0
60,130,80,60,60,70,460,0.5153846153846153,46,57,40,40,40,50,273,0.25,0.25
68,75,53,83,113,60,452,0.45384615384615384,54,78,103,53,45,22,355,0.23255813953488372,1.0
100,150,140,100,90,90,670,0.7969924812030075,75,98,63,98,63,101,498,0.8091603053435115,0.5
45,49,49,65,65,45,318,0.2781954887218045,30,45,59,30,39,57,260,0.2803030303030303,0.125
79,115,70,125,80,111,580,0.8468468468468469,65,75,105,35,65,85,430,0.6940298507462687,1.0
55,130,115,50,50,75,475,0.5982142857142857,65,76,84,54,96,105,480,0.9008264462809917,1.0
125,120,90,170,100,95,700,0.78125,59,66,70,44,55,41,335,0.25190839694656486,2.0
72,60,30,20,30,25,237,0.11570247933884298,75,110,110,110,105,80,590,0.656934306569343,0.5
70,90,90,135,90,125,600,0.9401709401709402,75,38,38,56,56,67,330,0.5263157894736842,1.0
45,55,39,35,39,42,255,0.18518518518518517,50,65,64,44,48,43,314,0.2196969696969697,1.0
58,50,145,95,105,30,483,0.2459016393442623,65,60,110,130,95,65,525,0.47761194029850745,1.0
95,75,80,100,110,30,490,0.24242424242424243,58,64,58,80,65,80,405,0.609271523178808,2.0
100,120,100,150,120,90,680,0.728,95,85,85,65,65,35,430,0.2571428571428571,0.5
78,81,71,74,69,126,499,0.9090909090909091,70,120,40,95,40,95,460,0.8106060606060606,0.5
75,75,130,75,130,95,580,0.7479674796747967,106,190,100,154,100,130,780,0.9259259259259259,0.5
35,40,100,90,55,35,355,0.1796875,50,65,107,105,107,86,520,0.703125,2.0
57,24,86,24,86,23,300,0.12727272727272726,95,95,85,125,65,55,520,0.3894736842105263,0.5
60,45,70,45,90,95,405,0.7304964539007093,91,72,90,129,90,108,580,0.8620689655172413,2.0
50,85,125,85,115,20,480,0.4306569343065693,90,65,65,40,40,15,315,0.19672131147540983,4.0
45,40,60,40,75,50,310,0.2926829268292683,85,80,70,135,75,90,535,0.7006802721088435,1.0
69,55,45,55,55,15,294,0.11666666666666667,75,75,95,75,95,113,528,0.9015151515151515,1.0
75,100,66,60,66,115,482,0.918918918918919,30,42,118,42,88,30,350,0.112,0.25
67,57,55,77,55,114,425,0.8879310344827587,65,130,60,75,60,75,465,0.689922480620155,0.0
89,125,90,115,80,101,600,0.8725490196078431,25,35,70,95,55,45,325,0.16783216783216784,1.0
40,40,40,70,40,20,250,0.032520325203252036,55,20,35,20,45,75,250,0.37681159420289856,1.0
100,100,80,60,60,50,450,0.3050847457627119,65,40,70,80,140,70,465,0.5954198473282443,0.0
1,90,45,30,30,40,236,0.33064516129032256,100,134,110,95,100,61,600,0.4057971014492754,1.0
70,90,45,15,45,50,315,0.3629032258064516,60,45,70,45,90,95,405,0.7304964539007093,1.0
60,40,60,40,60,35,295,0.18055555555555555,80,160,80,130,80,100,630,0.8455284552845529,0.5
55,20,35,20,45,75,250,0.37681159420289856,60,90,70,60,120,40,440,0.27419354838709675,1.0
50,105,125,55,95,50,480,0.375886524822695,60,80,50,50,50,40,330,0.23853211009174313,1.0
50,45,45,35,35,50,260,0.23529411764705882,60,50,70,80,80,140,480,0.8449612403100775,1.0
100,50,50,76,96,70,442,0.5,50,70,50,50,50,70,340,0.5645161290322581,1.0
35,35,35,35,35,35,210,0.13385826771653545,95,75,80,100,110,30,490,0.24242424242424243,0.5
45,35,50,70,50,30,280,0.15753424657534246,35,20,65,40,65,20,245,0.02459016393442623,1.0
45,60,32,50,32,76,295,0.5925925925925926,64,51,23,51,23,28,240,0.11363636363636363,1.0
30,40,55,40,55,60,280,0.3237410071942446,60,75,85,100,85,115,520,0.8992248062015504,0.25
45,63,37,65,55,95,360,0.8055555555555556,45,50,55,75,65,30,320,0.06293706293706294,0.5
105,150,90,150,90,95,680,0.8285714285714286,80,135,130,95,90,70,600,0.5181818181818182,0.25
70,110,80,55,80,105,500,0.8794326241134752,80,82,78,95,80,85,500,0.6869565217391305,1.0
50,53,48,53,48,64,316,0.46153846153846156,65,110,130,60,65,95,525,0.8278145695364238,2.0
55,95,55,35,75,115,430,0.9380530973451328,95,23,48,23,48,23,260,0.046153846153846156,2.0
50,65,85,35,35,55,325,0.32575757575757575,60,45,70,75,85,55,390,0.3008130081300813,2.0
65,55,115,100,40,60,435,0.3798449612403101,95,65,65,110,130,60,525,0.4016393442622951,1.0
40,45,35,30,40,55,245,0.3793103448275862,50,25,28,45,55,15,218,0.0625,2.0
30,56,35,25,35,72,253,0.48148148148148145,45,95,50,40,50,75,355,0.54,0.5
70,115,60,115,60,55,475,0.4647887323943662,54,45,47,75,98,52,371,0.39669421487603307,0.5
83,80,75,70,70,101,479,0.8615384615384616,55,70,45,70,50,60,350,0.45,1.0
83,80,80,135,80,121,579,0.9444444444444444,90,120,100,150,120,100,680,0.7718120805369127,1.0
59,66,70,44,55,41,335,0.25190839694656486,50,85,55,65,65,90,410,0.7478260869565218,0.5
40,80,35,35,45,70,305,0.4661016949152542,55,70,55,40,55,85,360,0.7073170731707317,2.0
35,35,35,35,35,35,210,0.13385826771653545,40,70,40,35,40,60,285,0.392,1.0
30,40,55,40,55,60,280,0.3237410071942446,60,150,50,150,50,60,520,0.5,0.0
70,92,65,80,55,98,460,0.8090909090909091,100,100,80,60,60,50,450,0.3050847457627119,2.0
59,63,80,65,80,58,405,0.41843971631205673,70,90,70,60,60,70,420,0.6390977443609023,1.0
28,25,25,45,35,40,198,0.16083916083916083,60,85,60,85,60,55,405,0.3673469387755102,1.0
55,45,43,55,43,72,313,0.5853658536585366,74,94,131,54,116,20,489,0.4485294117647059,0.5
100,150,110,95,110,70,635,0.5923076923076923,60,85,60,85,60,55,405,0.3673469387755102,4.0
105,30,105,140,105,55,540,0.3524590163934426,100,110,90,85,90,60,535,0.47794117647058826,1.0
60,62,63,80,80,60,405,0.38016528925619836,50,53,48,53,48,64,316,0.46153846153846156,0.5
90,90,85,125,90,100,580,0.768595041322314,38,35,35,65,55,50,278,0.2647058823529412,1.0
91,90,129,90,72,108,580,0.9140625,69,55,45,55,55,15,294,0.11666666666666667,0.5
100,5,5,15,65,30,220,0.07692307692307693,44,58,44,58,44,61,309,0.41964285714285715,1.0
65,90,40,45,80,75,395,0.625,44,48,65,50,64,43,314,0.1623931623931624,1.0
60,40,60,40,60,35,295,0.18055555555555555,110,65,75,125,85,30,490,0.15,1.0
76,48,48,57,62,34,325,0.11688311688311688,100,150,110,95,110,70,635,0.5923076923076923,1.0
77,85,51,55,51,65,384,0.5163934426229508,100,75,115,90,115,85,580,0.6446280991735537,1.0
105,150,90,150,90,95,680,0.8285714285714286,75,75,75,125,95,40,485,0.15671641791044777,1.0
55,45,50,45,65,80,340,0.5546218487394958,35,55,40,45,40,60,275,0.35714285714285715,0.5
44,48,65,50,64,43,314,0.1623931623931624,55,55,50,45,65,55,325,0.37373737373737376,1.0
67,57,55,77,55,114,425,0.8879310344827587,60,75,100,55,80,50,420,0.3088235294117647,0.125
50,65,107,105,107,86,520,0.7313432835820896,40,40,40,70,40,20,250,0.032520325203252036,0.5
55,81,60,50,70,97,413,0.7214285714285714,50,95,90,95,90,180,600,0.9172413793103448,1.0
35,35,35,35,35,35,210,0.13385826771653545,45,55,45,65,45,75,330,0.5692307692307692,1.0
50,75,75,65,65,50,380,0.4049586776859504,52,65,55,58,62,60,352,0.4482758620689655,0.0
45,45,35,20,30,20,195,0.07246376811594203,85,56,77,50,77,78,423,0.53125,1.0
75,105,75,105,75,45,480,0.3274336283185841,78,70,61,50,61,100,420,0.8145161290322581,1.0
50,75,70,35,70,48,348,0.29357798165137616,66,65,48,62,57,52,350,0.36220472440944884,1.0
75,90,90,140,90,115,600,0.9481481481481482,65,136,94,54,96,135,580,0.9612403100775194,0.5
40,65,95,60,45,35,340,0.13986013986013987,30,40,55,40,55,60,280,0.3237410071942446,1.0
50,45,45,35,35,50,260,0.23529411764705882,40,35,30,120,70,105,400,0.6692307692307692,1.0
50,75,45,40,45,60,315,0.4380165289256198,100,100,100,100,100,100,600,0.8345864661654135,4.0
75,100,95,40,70,110,490,0.8717948717948718,80,120,79,95,79,70,523,0.5833333333333334,1.0
65,40,50,125,60,30,370,0.07258064516129033,95,70,73,95,90,60,483,0.3983739837398374,1.0
75,87,63,87,63,98,473,0.865546218487395,53,54,53,37,46,45,288,0.3090909090909091,1.0
60,80,110,50,80,45,425,0.2833333333333333,55,104,105,94,75,52,485,0.36363636363636365,1.0
100,100,100,100,100,100,600,0.831858407079646,60,110,70,60,60,100,460,0.8461538461538461,1.0
95,145,130,120,90,120,700,0.9398496240601504,50,53,62,58,63,44,330,0.13709677419354838,1.0
60,55,50,40,55,45,305,0.22377622377622378,55,50,65,175,95,150,590,0.7818181818181819,2.0
88,107,122,74,75,64,530,0.4596774193548387,60,40,60,95,60,55,370,0.4222222222222222,0.0
105,95,75,85,75,74,509,0.5714285714285714,60,75,100,55,80,50,420,0.3088235294117647,2.0
80,125,75,40,95,85,500,0.6911764705882353,41,64,45,50,50,50,300,0.36752136752136755,1.0
80,100,70,60,70,95,475,0.7416666666666667,105,180,100,180,100,115,780,0.9477611940298507,0.25
10,55,25,35,45,95,265,0.5396825396825397,108,100,121,81,95,95,600,0.7476635514018691,1.0
95,75,110,100,80,30,490,0.15267175572519084,80,100,200,50,100,50,580,0.3472222222222222,2.0
60,60,50,40,50,75,335,0.5882352941176471,70,130,100,55,80,65,500,0.608,0.125
60,85,60,85,60,55,405,0.3673469387755102,60,62,63,80,80,60,405,0.38016528925619836,1.0
75,75,55,105,85,30,425,0.1619718309859155,85,90,80,70,80,130,535,0.9262295081967213,0.25
52,65,50,45,50,38,300,0.27419354838709675,100,100,125,110,50,50,535,0.384,1.0
77,59,50,67,63,46,362,0.23140495867768596,50,50,40,50,40,64,294,0.45588235294117646,0.5
35,85,45,35,35,75,310,0.6492537313432836,85,105,85,40,50,40,405,0.211864406779661,2.0
45,65,34,40,34,45,263,0.2589928057553957,45,45,35,20,30,20,195,0.07246376811594203,1.0
55,85,122,58,75,99,494,0.8099173553719008,50,75,35,70,30,40,300,0.21296296296296297,0.25
76,48,48,57,62,34,325,0.11688311688311688,60,85,69,60,69,77,420,0.518796992481203,1.0
46,57,40,40,40,50,273,0.25,100,150,120,120,100,90,680,0.6493506493506493,1.0
65,95,75,55,55,85,430,0.6933333333333334,76,147,90,60,70,97,540,0.8267716535433071,0.5
40,80,35,35,45,70,305,0.4661016949152542,114,85,70,85,80,30,464,0.2066115702479339,0.5
65,95,75,55,55,85,430,0.6933333333333334,61,84,65,70,70,70,420,0.5,0.5
90,100,90,125,85,90,580,0.7352941176470589,37,25,41,25,41,25,194,0.08870967741935484,4.0
126,131,95,131,98,99,680,0.8102189781021898,50,50,120,80,80,30,410,0.07258064516129033,0.5
99,68,83,72,87,51,460,0.417910447761194,80,80,90,110,130,110,600,0.8721804511278195,0.5
52,65,50,45,50,38,300,0.27419354838709675,75,103,80,70,80,92,500,0.7933884297520661,1.0
85,110,90,45,90,80,500,0.6206896551724138,65,90,122,58,75,84,494,0.71875,0.0
61,78,95,56,58,57,405,0.40336134453781514,100,180,160,150,90,90,770,0.7520661157024794,1.0
100,5,5,15,65,30,220,0.07692307692307693,74,94,131,54,116,20,489,0.4485294117647059,0.5
100,100,100,100,100,100,600,0.8778625954198473,75,140,65,112,65,110,567,0.9140625,0.5
60,55,50,40,55,45,305,0.22377622377622378,50,60,45,100,80,65,400,0.45689655172413796,1.0
35,70,55,45,55,25,285,0.09420289855072464,75,89,85,55,65,36,405,0.29545454545454547,1.0
57,80,91,80,87,75,470,0.5737704918032787,64,165,75,93,83,75,555,0.6587301587301587,1.0
90,60,60,40,40,40,330,0.29545454545454547,52,65,55,58,62,60,352,0.4482758620689655,0.0
45,22,60,27,30,29,213,0.07518796992481203,70,130,100,55,80,65,500,0.608,0.5
100,150,140,100,90,90,670,0.7969924812030075,45,25,50,25,25,35,205,0.13076923076923078,1.0
75,90,140,60,60,40,465,0.3008130081300813,74,48,76,83,81,104,466,0.7913043478260869,2.0
57,24,86,24,86,23,300,0.12727272727272726,71,73,88,120,89,59,500,0.43537414965986393,0.5
83,106,65,86,65,85,490,0.6640625,90,120,100,150,120,100,680,0.7718120805369127,1.0
75,69,72,114,100,104,534,0.8253968253968254,80,100,70,60,70,95,475,0.7416666666666667,2.0
80,120,70,110,70,80,530,0.6422764227642277,65,75,90,97,123,44,494,0.1987179487179487,0.25
79,115,70,125,80,111,580,0.864,60,95,80,60,80,30,405,0.19480519480519481,2.0
100,150,110,95,110,70,635,0.5923076923076923,65,70,60,65,65,115,440,0.8583333333333333,1.0
90,55,75,60,75,30,385,0.13970588235294118,50,25,28,45,55,15,218,0.0625,1.0
77,120,90,60,90,48,485,0.2785714285714286,95,75,180,130,80,30,590,0.13793103448275862,1.0
78,65,68,112,154,75,552,0.628099173553719,110,160,110,80,110,100,670,0.8591549295774648,1.0
50,65,107,105,107,86,520,0.6991150442477876,65,125,100,55,70,85,500,0.6532258064516129,2.0
10,55,25,35,45,95,265,0.5396825396825397,50,105,79,35,110,76,455,0.6214285714285714,1.0
35,55,35,30,30,35,220,0.23684210526315788,60,80,95,70,85,50,440,0.2231404958677686,1.0
70,80,70,80,70,110,480,0.6594202898550725,45,60,40,70,50,45,310,0.2846715328467153,0.5
40,40,55,40,70,55,300,0.40939597315436244,68,75,53,83,113,60,452,0.45384615384615384,1.0
30,40,70,70,25,60,295,0.41353383458646614,50,85,40,85,40,35,335,0.1746031746031746,0.5
40,40,50,30,30,30,220,0.0873015873015873,56,61,65,48,45,38,313,0.17567567567567569,0.5
45,50,45,115,55,95,405,0.6936936936936937,91,72,90,129,90,108,580,0.8925619834710744,1.0
43,70,48,50,60,38,309,0.2391304347826087,52,65,55,58,62,60,352,0.4482758620689655,0.0
65,125,100,55,70,85,500,0.6532258064516129,70,90,90,135,90,125,600,0.9401709401709402,2.0
48,61,40,61,40,50,300,0.2543859649122807,55,47,52,40,40,41,275,0.16806722689075632,0.25
45,95,50,40,50,75,355,0.54,76,65,45,92,42,91,411,0.7449664429530202,1.0
75,87,63,87,63,98,473,0.865546218487395,45,85,70,40,40,60,340,0.5229357798165137,0.5
70,80,50,35,35,35,305,0.14,55,50,40,40,40,75,300,0.5945945945945946,2.0
30,105,90,25,25,50,325,0.2773722627737226,103,60,126,80,126,50,545,0.36363636363636365,1.0
55,40,85,80,105,40,405,0.23622047244094488,105,140,55,30,55,95,480,0.8195488721804511,0.5
50,50,40,30,30,50,250,0.2781954887218045,60,55,90,145,90,80,520,0.6071428571428571,1.0
70,43,53,43,53,40,302,0.19090909090909092,70,80,70,80,70,110,480,0.6594202898550725,0.5
40,60,30,31,31,70,262,0.4492753623188406,80,100,80,80,80,100,520,0.9051724137931034,1.0
65,80,65,35,65,60,370,0.38405797101449274,105,95,80,40,80,90,490,0.753968253968254,1.0
80,50,100,100,200,50,580,0.2357142857142857,99,68,83,72,87,51,460,0.417910447761194,4.0
65,125,100,55,70,85,500,0.6532258064516129,65,105,60,60,70,95,455,63.0,0.5
75,110,110,110,105,80,590,0.656934306569343,105,95,80,40,80,90,490,0.753968253968254,1.0
78,104,78,159,115,100,634,0.8444444444444444,100,120,120,150,100,90,680,0.7880794701986755,0.5
77,59,50,67,63,46,362,0.23140495867768596,50,35,55,25,25,15,205,0.021739130434782608,2.0
60,40,50,75,85,95,405,0.6044776119402985,43,30,55,40,65,97,330,0.6030534351145038,2.0
40,60,30,31,31,70,262,0.4492753623188406,55,70,55,40,55,85,360,0.7073170731707317,1.0
250,5,5,35,105,50,450,0.15306122448979592,60,100,85,80,85,100,510,0.7007874015748031,1.0
50,80,95,10,45,10,290,0.232,75,98,63,98,63,101,498,0.849624060150376,1.0
79,115,70,125,80,111,580,0.8468468468468469,165,75,80,40,45,65,470,0.5151515151515151,1.0
45,30,15,85,65,65,305,0.36220472440944884,66,41,77,61,87,23,355,0.12096774193548387,2.0
91,72,90,129,90,108,580,0.8925619834710744,70,60,75,110,75,90,480,0.7165354330708661,0.5
55,75,50,40,40,80,340,0.6302521008403361,67,82,62,46,48,43,348,0.22033898305084745,2.0
83,80,80,135,80,121,579,0.9444444444444444,84,71,43,71,43,48,360,0.25874125874125875,1.0
100,123,75,57,75,80,510,0.6923076923076923,55,85,55,50,55,60,360,0.4233576642335766,2.0
65,150,60,115,60,115,565,0.935251798561151,45,20,50,60,120,50,345,0.24074074074074073,1.0
70,85,140,85,70,20,470,0.272,30,105,90,25,25,50,325,0.2773722627737226,0.5
150,120,100,120,100,90,680,0.664179104477612,100,50,50,76,96,70,442,0.5,0.0
106,190,100,154,100,130,780,0.9259259259259259,55,45,45,25,25,15,210,0.048,2.0
90,60,70,75,70,45,410,0.23880597014925373,70,95,125,65,75,45,475,0.33613445378151263,2.0
85,105,100,79,83,78,530,0.5869565217391305,92,105,90,125,90,98,600,0.8217054263565892,0.5
35,65,35,65,35,65,300,0.46621621621621623,49,49,56,49,61,66,330,0.5190839694656488,0.5
75,75,60,83,60,60,413,0.39344262295081966,61,84,65,70,70,70,420,0.5,0.5
50,30,55,65,55,20,275,0.13675213675213677,40,27,60,37,50,66,280,0.36220472440944884,2.0
71,73,88,120,89,59,500,0.43537414965986393,105,105,75,65,100,50,500,0.37593984962406013,1.0
61,84,65,70,70,70,420,0.5,50,47,50,57,50,65,319,0.463768115942029,1.0
91,134,95,100,100,80,600,0.6304347826086957,73,100,60,100,60,65,458,0.42657342657342656,1.0
59,66,70,44,55,41,335,0.25190839694656486,55,75,85,25,25,15,280,0.1875,2.0
100,128,90,77,77,128,600,0.959349593495935,70,120,40,95,40,95,460,0.8106060606060606,2.0
95,100,85,108,70,70,528,0.5652173913043478,116,55,85,107,95,29,487,0.06818181818181818,1.0
60,50,70,80,80,140,480,0.8449612403100775,75,75,60,83,60,60,413,0.39344262295081966,2.0
80,100,123,122,120,80,625,0.56,60,45,70,75,85,55,390,0.3008130081300813,1.0
70,45,48,60,65,35,323,0.15748031496062992,60,40,80,60,45,40,325,0.23529411764705882,1.0
75,125,75,30,75,85,465,0.625,75,65,55,65,55,69,384,0.43548387096774194,1.0
95,135,80,110,80,100,600,0.8248175182481752,95,110,80,70,80,50,485,0.37209302325581395,1.0
60,55,50,40,55,45,305,0.22377622377622378,95,23,48,23,48,23,260,0.046153846153846156,2.0
64,51,23,51,23,28,240,0.11363636363636363,70,83,50,37,50,60,350,0.3360655737704918,1.0
75,95,95,95,95,85,540,0.6470588235294118,90,65,65,40,40,15,315,0.19672131147540983,0.5
70,94,50,94,50,66,424,0.48148148148148145,40,40,55,40,70,55,300,0.40939597315436244,2.0
75,110,110,110,105,80,590,0.656934306569343,55,45,43,55,43,72,313,0.5853658536585366,1.0
100,50,80,60,80,50,420,0.34375,75,75,95,75,95,113,528,0.9015151515151515,0.5
50,53,48,53,48,64,316,0.358974358974359,105,105,75,65,100,50,500,0.37593984962406013,1.0
44,75,35,63,33,45,295,0.2647058823529412,30,45,59,30,39,57,260,0.2803030303030303,1.0
55,75,60,75,60,103,428,0.7982456140350878,60,50,100,85,70,65,430,0.47580645161290325,4.0
50,180,20,180,20,150,600,0.9029850746268657,90,85,75,115,100,115,580,0.9381443298969072,1.0
30,40,55,40,55,60,280,0.3237410071942446,60,67,85,77,75,116,480,0.8888888888888888,0.5
125,130,90,130,90,95,660,0.7734375,60,85,69,60,69,77,420,0.518796992481203,1.0
68,75,53,83,113,60,452,0.45384615384615384,57,24,86,24,86,23,300,0.12727272727272726,0.5
40,27,60,37,50,66,280,0.36220472440944884,91,90,106,130,106,77,600,0.648854961832061,0.0625
65,65,65,50,50,90,385,0.72,60,40,60,40,60,35,295,0.18055555555555555,0.5
75,125,75,30,75,85,465,0.625,65,75,90,97,123,44,494,0.1987179487179487,0.5
150,160,100,95,65,100,670,0.8866666666666667,46,57,40,40,40,50,273,0.25,1.0
70,55,55,80,60,45,365,0.2222222222222222,30,65,100,45,25,40,305,0.1891891891891892,2.0
70,83,50,37,50,60,350,0.3360655737704918,60,110,70,60,60,100,460,0.8461538461538461,1.0
65,40,70,80,140,70,465,0.5954198473282443,60,150,50,150,50,60,520,0.5,0.5
95,145,130,120,90,120,700,0.9398496240601504,80,110,60,150,130,70,600,0.5042016806722689,1.0
100,120,120,150,100,90,680,0.7880794701986755,110,123,65,100,65,65,528,0.5217391304347826,0.5
50,55,50,36,30,43,264,0.2922077922077922,90,60,70,75,70,45,410,0.23880597014925373,1.0
40,65,95,60,45,35,340,0.13986013986013987,80,70,40,100,60,145,495,0.921875,1.0
70,95,125,65,75,45,475,0.33613445378151263,105,105,75,65,100,50,500,0.37593984962406013,0.5
150,100,120,100,120,90,680,0.6666666666666666,90,50,34,60,44,70,348,0.6283185840707964,2.0
65,40,50,125,60,30,370,0.07258064516129033,60,110,70,60,60,100,460,0.8461538461538461,1.0
55,55,55,85,55,30,335,0.1320754716981132,45,55,45,65,45,75,330,0.5692307692307692,1.0
35,60,44,40,54,55,288,0.366412213740458,45,65,34,40,34,45,263,0.2589928057553957,1.0
40,55,30,30,30,60,245,0.43548387096774194,60,50,70,80,80,140,480,0.8449612403100775,0.5
40,30,35,45,40,55,245,0.31496062992125984,70,83,50,37,50,60,350,0.3360655737704918,1.0
38,30,41,30,41,60,240,0.2897196261682243,75,110,110,110,105,80,590,0.656934306569343,1.0
60,85,60,50,50,125,430,0.9090909090909091,45,45,35,20,30,20,195,0.07246376811594203,2.0
76,48,48,57,62,34,325,0.11688311688311688,72,105,115,54,86,68,500,0.5149253731343284,1.0
61,84,65,70,70,70,420,0.5,64,88,50,88,50,106,446,0.9111111111111111,1.0
123,100,62,97,81,68,531,0.4806201550387597,83,106,65,86,65,85,490,0.6640625,0.5
38,30,41,30,41,60,240,0.2897196261682243,60,85,42,85,42,91,405,0.8227848101265823,1.0
65,76,84,54,96,105,480,0.9008264462809917,56,61,65,48,45,38,313,0.17567567567567569,1.0
70,60,62,80,82,60,414,0.4375,70,55,55,80,60,45,365,0.2222222222222222,0.5
65,95,100,60,50,50,420,0.34959349593495936,31,45,90,30,30,40,266,0.21929824561403508,1.0
50,45,45,35,35,50,260,0.23529411764705882,106,190,100,154,100,130,780,0.9259259259259259,1.0
40,30,50,55,55,100,330,0.584070796460177,60,69,95,69,95,36,424,0.2608695652173913,1.0
85,135,130,60,80,25,515,0.40540540540540543,55,55,55,85,55,30,335,0.1320754716981132,1.0
58,64,58,80,65,80,405,0.609271523178808,35,20,65,40,65,20,245,0.02459016393442623,1.0
105,95,80,40,80,90,490,0.753968253968254,45,49,65,49,65,45,318,0.275,1.0
108,112,118,68,72,47,525,0.2916666666666667,60,90,140,50,50,40,430,0.2535211267605634,4.0
55,45,45,25,25,15,210,0.048,55,50,45,135,95,120,500,0.7714285714285715,1.0
80,45,65,90,110,80,470,0.5462962962962963,54,78,103,53,45,22,355,0.23255813953488372,1.0
95,80,105,40,70,100,490,0.8046875,85,80,70,135,75,90,535,0.7006802721088435,1.0
50,20,40,20,40,20,190,0.0962962962962963,100,123,75,57,75,80,510,0.6923076923076923,1.0
65,95,75,55,55,85,430,0.6933333333333334,60,75,100,55,80,50,420,0.3088235294117647,0.0
70,60,125,115,70,55,495,0.35507246376811596,56,61,65,48,45,38,313,0.17567567567567569,0.5
74,100,72,90,72,46,454,0.24561403508771928,55,84,105,114,75,52,485,0.2890625,2.0
76,48,48,57,62,34,325,0.11688311688311688,38,35,35,65,55,50,278,0.2647058823529412,1.0
45,50,55,75,65,30,320,0.06293706293706294,110,135,60,50,65,88,508,0.7744360902255639,0.0
60,60,60,105,105,105,495,0.848,75,98,63,98,63,101,498,0.8091603053435115,1.0
60,55,50,40,55,45,305,0.22377622377622378,38,35,35,65,55,50,278,0.2647058823529412,2.0
40,55,80,35,60,30,300,0.15037593984962405,40,45,35,40,40,90,290,0.65,1.0
45,35,45,62,53,35,275,0.11851851851851852,65,95,100,60,50,50,420,0.34959349593495936,0.5
70,95,125,65,75,45,475,0.33613445378151263,38,30,85,55,65,30,303,0.21428571428571427,0.5
70,150,140,65,100,75,600,0.55,61,72,57,55,55,65,365,0.3984375,0.5
61,78,95,56,58,57,405,0.40336134453781514,116,55,85,107,95,29,487,0.06818181818181818,1.0
74,48,76,83,81,104,466,0.7322834645669292,90,100,90,125,85,90,580,0.7352941176470589,1.0
50,53,48,53,48,64,316,0.358974358974359,105,180,100,180,100,115,780,0.9477611940298507,0.5
123,77,72,99,92,58,521,0.4621212121212121,60,65,70,85,75,40,395,0.21705426356589147,2.0
70,50,30,95,135,105,485,0.8040540540540541,55,55,85,65,85,35,380,0.2014388489208633,0.5
80,145,150,105,110,110,700,0.8692307692307693,90,85,100,95,125,85,580,0.6834532374100719,2.0
75,55,70,55,95,110,460,0.8444444444444444,70,60,62,80,82,60,414,0.4375,0.5
45,50,45,115,55,95,405,0.6936936936936937,75,123,67,95,85,95,540,0.7642276422764228,1.0
20,15,20,10,55,80,200,0.2682926829268293,105,105,75,65,100,50,500,0.37593984962406013,1.0
75,70,90,70,105,80,490,0.656,85,76,64,45,55,90,415,0.6739130434782609,1.0
90,60,70,75,70,45,410,0.23880597014925373,90,75,75,90,100,70,500,0.5462184873949579,0.25
35,85,45,35,35,75,310,0.6492537313432836,58,64,58,80,65,80,405,0.5423728813559322,1.0
71,120,95,120,95,99,600,0.8203125,85,120,70,50,60,100,485,0.8308823529411765,0.5
60,85,69,60,69,77,420,0.518796992481203,78,70,61,50,61,100,420,0.8145161290322581,1.0
60,70,65,125,105,90,515,0.6911764705882353,50,70,50,50,50,40,310,0.16296296296296298,2.0
50,50,150,50,150,50,500,0.2571428571428571,68,90,65,50,55,82,410,0.6165413533834586,1.0
51,65,65,80,75,59,395,0.4365079365079365,70,60,125,115,70,55,495,0.35507246376811596,0.5
60,80,95,70,85,50,440,0.2231404958677686,75,95,67,125,95,83,540,0.7117117117117117,0.5
80,120,70,110,70,80,530,0.6422764227642277,105,150,90,150,90,95,680,0.8285714285714286,0.25
100,100,80,60,60,50,450,0.3050847457627119,60,59,85,79,105,36,424,0.16666666666666666,0.5
58,89,77,45,45,48,362,0.3177570093457944,100,150,140,100,90,90,670,0.7969924812030075,0.5
95,70,73,95,90,60,483,0.3983739837398374,75,98,63,98,63,101,498,0.8091603053435115,1.0
55,84,105,114,75,52,485,0.2890625,75,89,85,55,65,36,405,0.29545454545454547,0.5
100,77,77,128,128,90,600,0.6901408450704225,65,95,100,60,50,50,420,0.34959349593495936,1.0
62,55,52,109,94,109,481,0.7833333333333333,71,95,85,110,95,79,535,0.664,1.0
90,95,95,70,90,70,510,0.5230769230769231,65,47,55,73,75,85,400,0.65,0.5
64,78,52,78,52,81,405,0.6422764227642277,55,35,50,55,110,85,390,0.6277372262773723,0.5
20,10,230,10,230,5,505,0.0,86,68,72,109,66,106,507,0.8099173553719008,1.0
70,20,50,20,50,40,250,0.1557377049180328,50,75,45,40,45,60,315,0.4380165289256198,1.0
70,62,67,55,55,56,365,0.38513513513513514,150,160,100,95,65,100,670,0.8866666666666667,1.0
70,95,85,55,65,70,440,0.5,100,100,100,100,100,100,600,0.8778625954198473,1.0
115,140,130,55,55,40,535,0.4519230769230769,50,65,107,105,107,86,520,0.7272727272727273,0.0
28,25,25,45,35,40,198,0.16083916083916083,40,30,50,55,55,100,330,0.584070796460177,1.0
40,30,30,55,30,85,270,0.4666666666666667,65,150,60,115,60,115,565,0.935251798561151,1.0
105,140,55,30,55,95,480,0.8195488721804511,114,85,70,85,80,30,464,0.2066115702479339,2.0
78,84,78,109,85,100,534,0.8646616541353384,60,100,115,70,85,90,520,0.7557251908396947,1.0
40,30,30,40,50,30,220,0.07936507936507936,100,50,80,60,80,50,420,0.34375,1.0
70,45,48,60,65,35,323,0.15748031496062992,73,76,75,81,100,100,505,0.8110236220472441,0.5
65,130,60,75,60,75,465,0.689922480620155,78,92,75,74,63,118,500,0.8842975206611571,0.5
50,70,160,70,160,90,600,0.7417218543046358,65,63,45,45,45,45,308,0.2595419847328244,1.0
90,90,85,125,90,100,580,0.768595041322314,68,65,65,125,115,80,518,0.6461538461538462,1.0
108,170,115,120,95,92,700,0.7083333333333334,72,58,80,103,80,97,490,0.7171052631578947,0.0
75,69,72,114,100,104,534,0.8253968253968254,100,103,75,120,75,127,600,0.940677966101695,2.0
50,65,45,85,65,95,405,0.7238095238095238,46,87,60,30,40,57,320,0.37777777777777777,0.5
85,105,55,85,50,115,495,0.9032258064516129,89,145,90,105,80,91,600,0.8549618320610687,2.0
76,25,45,67,55,24,292,0.0390625,50,70,100,40,40,30,330,0.2222222222222222,0.5
100,5,5,15,65,30,220,0.07692307692307693,35,35,40,35,55,50,250,0.40336134453781514,1.0
60,55,90,145,90,80,520,0.6071428571428571,80,105,105,105,105,80,580,0.5939849624060151,2.0
50,50,77,95,77,91,440,0.5916666666666667,60,45,50,90,80,70,395,0.625,2.0
108,170,115,120,95,92,700,0.7083333333333334,95,75,110,100,80,30,490,0.15267175572519084,1.0
60,115,105,65,70,80,495,0.7181818181818181,60,85,69,65,79,80,438,0.576,1.0
97,165,60,65,50,58,495,0.3902439024390244,40,55,99,40,79,47,360,0.26262626262626265,2.0
55,95,55,35,75,115,430,0.9380530973451328,75,95,122,58,75,69,494,0.5725806451612904,4.0
100,100,100,100,100,100,600,0.8778625954198473,45,55,45,65,45,75,330,0.5692307692307692,2.0
95,100,85,108,70,70,528,0.5652173913043478,110,78,73,76,71,60,468,0.3333333333333333,1.0
70,110,75,145,85,145,630,0.9444444444444444,65,95,57,100,85,93,495,0.7441860465116279,0.5
40,65,40,80,40,65,330,0.5038167938931297,60,65,80,170,95,130,600,0.8625954198473282,2.0
68,65,65,125,115,80,518,0.6461538461538462,103,93,67,71,61,84,479,0.7142857142857143,0.0
70,80,70,80,70,110,480,0.6594202898550725,90,85,100,95,125,85,580,0.6834532374100719,1.0
50,65,107,105,107,86,520,0.7313432835820896,108,170,115,120,95,92,700,0.7083333333333334,0.0
45,45,35,20,30,20,195,0.07246376811594203,75,103,80,70,80,92,500,0.7933884297520661,2.0
95,125,79,60,100,81,540,0.6165413533834586,104,91,63,91,73,68,490,0.5118110236220472,1.0
75,110,110,110,105,80,590,0.656934306569343,91,129,90,72,90,108,580,0.8536585365853658,2.0
76,48,48,57,62,34,325,0.11688311688311688,72,95,67,103,71,122,530,0.9606299212598425,0.5
91,129,90,72,90,108,580,0.8536585365853658,55,55,55,85,55,30,335,0.1320754716981132,0.5
40,45,35,40,40,90,290,0.65,65,40,70,80,140,70,465,0.5954198473282443,1.0
50,65,45,85,65,95,405,0.7238095238095238,68,85,65,165,135,100,618,0.8083333333333333,1.0
75,140,65,112,65,110,567,0.9140625,60,90,70,60,120,40,440,0.27419354838709675,1.0
45,45,35,20,30,20,195,0.07246376811594203,80,160,60,170,130,80,680,0.6180555555555556,4.0
84,86,88,111,101,60,530,0.4634146341463415,45,90,20,65,20,65,305,0.5116279069767442,0.25
55,40,40,65,45,35,280,0.16428571428571428,40,60,40,40,40,30,250,0.0948905109489051,1.0
40,80,35,35,45,70,305,0.4661016949152542,45,25,50,25,25,35,205,0.13076923076923078,0.25
50,60,45,100,80,65,400,0.45689655172413796,70,110,75,145,85,145,630,0.9444444444444444,0.5
65,95,100,60,50,50,420,0.34959349593495936,50,85,40,85,40,35,335,0.1746031746031746,1.0
85,56,77,50,77,78,423,0.53125,60,70,65,125,105,90,515,0.6911764705882353,1.0
25,20,15,105,55,90,310,0.32407407407407407,55,81,60,50,70,97,413,0.7214285714285714,1.0
76,104,71,104,71,108,534,0.912751677852349,60,82,45,45,45,74,351,0.5752212389380531,2.0
123,100,62,97,81,68,531,0.4806201550387597,100,150,90,180,160,90,770,0.7348484848484849,2.0
70,75,60,105,60,105,475,0.88,110,135,60,50,65,88,508,0.7744360902255639,0.0
77,120,90,60,90,48,485,0.2785714285714286,40,70,40,35,40,60,285,0.392,1.0
80,135,130,95,90,70,600,0.5181818181818182,95,60,79,100,125,81,540,0.6201550387596899,0.5
100,100,90,150,140,90,670,0.71875,108,100,121,81,95,95,600,0.7476635514018691,1.0
90,93,55,70,55,55,418,0.3819444444444444,55,45,50,45,65,80,340,0.5546218487394958,1.0
99,68,83,72,87,51,460,0.417910447761194,100,100,100,100,100,100,600,0.8602941176470589,1.0
55,70,45,70,50,60,350,0.45,100,100,125,110,50,50,535,0.384,2.0
77,85,51,55,51,65,384,0.5163934426229508,20,10,55,15,20,80,200,0.17985611510791366,1.0
85,110,90,45,90,80,500,0.6206896551724138,123,100,62,97,81,68,531,0.4806201550387597,1.0
80,110,120,130,90,70,600,0.6198347107438017,50,53,62,58,63,44,330,0.13709677419354838,0.25
46,57,40,40,40,50,273,0.25,70,83,50,37,50,60,350,0.3360655737704918,1.0
35,45,160,30,45,70,385,0.48148148148148145,53,51,53,61,56,40,314,0.14285714285714285,1.0
70,70,115,130,90,60,535,0.5338983050847458,45,20,50,60,120,50,345,0.24074074074074073,2.0
85,56,77,50,77,78,423,0.53125,79,115,70,125,80,111,580,0.864,0.0
95,110,80,70,80,50,485,0.37209302325581395,76,48,48,57,62,34,325,0.11688311688311688,0.5
50,60,60,60,60,30,320,0.11290322580645161,78,130,111,130,85,100,634,0.8561151079136691,1.0
100,150,110,95,110,70,635,0.5923076923076923,78,130,111,130,85,100,634,0.8561151079136691,2.0
60,79,105,59,85,36,424,0.17054263565891473,78,92,75,74,63,118,500,0.8842975206611571,0.0
45,35,45,62,53,35,275,0.11851851851851852,75,100,95,40,70,110,490,0.8717948717948718,1.0
55,85,122,58,75,99,494,0.8099173553719008,83,80,80,135,80,121,579,0.9444444444444444,0.0
40,65,95,60,45,35,340,0.13986013986013987,90,60,70,75,70,45,410,0.23880597014925373,1.0
20,15,20,10,55,80,200,0.2682926829268293,75,80,55,25,35,35,305,0.18666666666666668,1.0
55,104,105,94,75,52,485,0.36363636363636365,60,50,50,60,70,50,340,0.28346456692913385,0.25
51,65,65,80,75,59,395,0.4365079365079365,80,120,130,55,65,45,495,0.37037037037037035,2.0
123,77,72,99,92,58,521,0.4621212121212121,95,110,80,70,80,50,485,0.37209302325581395,1.0
110,80,90,95,90,65,530,0.5033557046979866,70,55,95,95,110,65,490,0.48872180451127817,1.0
60,85,49,60,49,60,363,0.4444444444444444,40,40,40,70,40,20,250,0.032520325203252036,1.0
59,63,80,65,80,58,405,0.41843971631205673,60,130,80,60,60,70,460,0.5153846153846153,0.5
40,40,35,50,100,70,335,0.5031847133757962,40,45,35,30,40,55,245,0.3793103448275862,0.5
75,85,200,55,65,30,510,0.16778523489932887,67,125,40,30,30,58,350,0.3431372549019608,4.0
60,50,70,50,90,65,385,0.39568345323741005,80,135,130,95,90,70,600,0.5181818181818182,0.0
75,90,140,60,60,40,465,0.3008130081300813,100,150,140,100,90,90,670,0.7969924812030075,1.0
70,43,53,43,53,40,302,0.19090909090909092,25,35,70,95,55,45,325,0.16783216783216784,0.0
70,110,70,115,70,90,525,0.75,110,85,95,80,95,50,515,0.2713178294573643,2.0
65,40,70,80,140,70,465,0.5954198473282443,70,60,62,80,82,60,414,0.4375,2.0
45,60,40,70,50,45,310,0.2846715328467153,60,52,168,47,138,30,495,0.19834710743801653,1.0
65,95,75,55,55,85,430,0.6933333333333334,70,100,115,30,65,30,410,0.24390243902439024,1.0
59,74,50,35,50,35,303,0.3125,75,125,100,70,80,45,495,0.33035714285714285,1.0
70,85,140,85,70,20,470,0.272,45,20,50,60,120,50,345,0.24074074074074073,0.5
72,58,80,103,80,97,490,0.7171052631578947,30,105,90,25,25,50,325,0.2773722627737226,1.0
71,82,64,64,59,112,452,0.9327731092436975,65,60,70,85,75,40,395,0.1796875,1.0
60,50,70,80,80,140,480,0.8449612403100775,60,50,150,50,150,60,520,0.5206611570247934,1.0
70,84,70,65,70,51,410,0.2949640287769784,50,47,50,57,50,65,319,0.463768115942029,2.0
43,30,55,40,65,97,330,0.6030534351145038,45,60,40,70,50,45,310,0.2846715328467153,2.0
50,25,28,45,55,15,218,0.0625,130,85,80,85,95,60,535,0.43884892086330934,1.0
95,80,105,40,70,100,490,0.8046875,75,95,125,45,75,95,510,0.8257575757575758,1.0
60,62,80,63,80,60,405,0.4336283185840708,68,90,65,50,55,82,410,0.6165413533834586,1.0
65,136,94,54,96,135,580,0.9612403100775194,70,55,55,80,60,45,365,0.2222222222222222,1.0
60,110,70,60,60,100,460,0.8461538461538461,55,81,60,50,70,97,413,0.7214285714285714,1.0
106,110,90,154,90,130,680,0.926829268292683,125,130,90,130,90,95,660,0.7734375,1.0
91,90,106,130,106,77,600,0.648854961832061,70,130,100,55,80,65,500,0.608,2.0
60,60,75,60,75,80,410,0.7321428571428571,125,170,100,120,90,95,700,0.77,2.0
50,120,53,35,110,87,455,0.640625,65,73,55,47,75,85,400,0.6846846846846847,0.5
60,62,63,80,80,60,405,0.38016528925619836,95,155,109,70,130,81,640,0.6788321167883211,2.0
40,27,60,37,50,66,280,0.36220472440944884,80,80,80,80,80,80,480,0.6015037593984962,1.0
65,130,60,95,110,65,525,0.5303030303030303,45,55,39,35,39,42,255,0.18518518518518517,1.0
95,125,79,60,100,81,540,0.6165413533834586,90,95,105,165,110,45,610,0.2890625,0.25
49,49,56,49,61,66,330,0.5190839694656488,83,80,75,70,70,101,479,0.8615384615384616,1.0
60,85,60,85,60,55,405,0.3673469387755102,45,25,50,25,25,35,205,0.13076923076923078,0.5
78,81,71,74,69,126,499,0.9090909090909091,150,160,100,95,65,100,670,0.8866666666666667,1.0
45,45,35,20,30,20,195,0.07246376811594203,95,85,85,65,65,35,430,0.2571428571428571,1.0
108,130,95,80,85,102,600,0.7637795275590551,50,20,55,25,25,30,205,0.09774436090225563,0.5
90,100,90,125,85,90,580,0.7352941176470589,30,30,30,30,30,30,180,0.12612612612612611,4.0
61,84,65,70,70,70,420,0.5,55,85,55,50,55,60,360,0.4233576642335766,1.0
85,135,130,60,80,25,515,0.40540540540540543,160,110,65,65,110,30,540,0.35714285714285715,1.0
80,100,70,60,70,95,475,0.7416666666666667,66,65,48,62,57,52,350,0.36220472440944884,0.5
45,95,50,40,50,75,355,0.54,45,50,45,115,55,95,405,0.6936936936936937,0.25
79,105,70,145,80,101,580,0.8608695652173913,25,20,15,105,55,90,310,0.32407407407407407,1.0
70,80,70,80,70,110,480,0.6594202898550725,45,67,60,35,50,63,320,0.5128205128205128,0.5
75,125,75,30,75,85,465,0.625,90,100,90,125,85,90,580,0.7352941176470589,0.5
36,50,50,65,60,44,305,0.16363636363636364,60,65,80,170,95,130,600,0.8625954198473282,1.0
50,95,95,35,110,70,455,0.5179856115107914,106,150,70,194,120,140,780,0.952,0.5
35,65,35,65,35,65,300,0.46621621621621623,36,50,50,65,60,44,305,0.16363636363636364,1.0
70,80,50,35,35,35,305,0.14,50,55,50,36,30,43,264,0.2922077922077922,1.0
67,58,57,81,67,101,431,0.8790322580645161,50,50,150,50,150,50,500,0.2571428571428571,1.0
88,107,122,74,75,64,530,0.4596774193548387,95,124,78,69,71,58,495,0.37398373983739835,2.0
78,84,78,109,85,100,534,0.8646616541353384,43,70,48,50,60,38,309,0.2391304347826087,4.0
60,55,50,40,55,45,305,0.22377622377622378,60,90,55,90,80,110,485,0.8677685950413223,1.0
100,100,100,100,100,100,600,0.8602941176470589,40,55,30,30,30,85,270,0.688,0.5
72,58,80,103,80,97,490,0.7171052631578947,74,48,76,83,81,104,466,0.7913043478260869,0.5
67,58,57,81,67,101,431,0.8790322580645161,50,75,75,65,65,50,380,0.4049586776859504,2.0
46,87,60,30,40,57,320,0.37777777777777777,90,85,100,95,125,85,580,0.6834532374100719,1.0
100,103,75,120,75,127,600,0.940677966101695,160,110,65,65,110,30,540,0.35714285714285715,1.0
72,85,70,65,70,58,420,0.41304347826086957,75,90,50,110,80,95,500,0.7985611510791367,0.5
50,65,107,105,107,86,520,0.7272727272727273,100,100,90,150,140,90,670,0.71875,2.0
74,100,72,90,72,46,454,0.24561403508771928,82,80,86,85,75,72,480,0.6183206106870229,1.0
82,121,119,69,59,71,521,0.5394736842105263,80,160,60,170,130,80,680,0.6180555555555556,1.0
60,79,105,59,85,36,424,0.17054263565891473,45,100,45,45,45,10,290,0.2949640287769784,1.0
95,85,85,65,65,35,430,0.2571428571428571,125,170,100,120,90,95,700,0.77,0.5
115,45,20,45,25,20,270,0.11538461538461539,75,55,70,55,95,110,460,0.8444444444444444,1.0
110,78,73,76,71,60,468,0.3333333333333333,35,70,55,45,55,25,285,0.09420289855072464,0.125
60,80,110,50,80,45,425,0.2833333333333333,60,130,80,60,60,70,460,0.5153846153846153,0.5
68,85,65,165,135,100,618,0.8083333333333333,60,130,80,60,60,70,460,0.5153846153846153,2.0
57,24,86,24,86,23,300,0.12727272727272726,80,105,65,60,75,130,515,0.9645390070921985,2.0
95,75,80,100,110,30,490,0.24242424242424243,105,125,100,60,100,100,590,0.8359375,1.0
50,50,40,50,40,64,294,0.45588235294117646,80,105,65,60,75,130,515,0.9645390070921985,2.0
67,89,116,79,116,33,500,0.2624113475177305,55,45,45,25,25,15,210,0.048,1.0
70,20,50,20,50,40,250,0.1557377049180328,20,10,230,10,230,5,505,0.0,2.0
80,100,80,80,80,100,520,0.9051724137931034,60,30,30,36,56,50,262,0.32432432432432434,0.0
44,75,35,63,33,45,295,0.2647058823529412,44,48,65,50,64,43,314,0.1623931623931624,1.0
20,10,55,15,20,80,200,0.17985611510791366,116,55,85,107,95,29,487,0.06818181818181818,1.0
58,70,45,40,45,42,300,0.25925925925925924,60,60,60,35,35,30,280,0.11194029850746269,1.0
65,90,115,45,115,58,488,0.5041322314049587,110,78,73,76,71,60,468,0.3333333333333333,1.0
100,134,110,95,100,61,600,0.4057971014492754,60,85,42,85,42,91,405,0.8227848101265823,1.0
108,112,118,68,72,47,525,0.2916666666666667,59,59,58,90,70,73,409,0.5826086956521739,2.0
50,40,85,40,65,25,305,0.08870967741935484,67,57,55,77,55,114,425,0.8879310344827587,1.0
66,65,48,62,57,52,350,0.36220472440944884,40,50,45,70,45,70,320,0.5517241379310345,0.5
85,115,80,105,80,50,515,0.3063063063063063,80,185,115,40,105,75,600,0.6230769230769231,1.0
55,35,50,55,110,85,390,0.6277372262773723,91,72,90,129,90,108,580,0.8925619834710744,1.0
30,80,90,55,45,55,355,0.4295774647887324,108,112,118,68,72,47,525,0.2916666666666667,1.0
70,75,60,105,60,105,475,0.88,45,45,55,45,55,63,308,0.4594594594594595,0.5
95,155,109,70,130,81,640,0.6788321167883211,68,165,95,65,115,110,618,0.8615384615384616,1.0
130,85,80,85,95,60,535,0.43884892086330934,91,90,72,90,129,108,580,0.896,1.0
65,125,60,95,60,105,510,0.9236641221374046,64,78,52,78,52,81,405,0.6422764227642277,1.0
70,70,70,70,70,70,420,0.5289256198347108,60,45,70,45,90,95,405,0.7304964539007093,1.0
90,30,15,40,20,15,210,0.043478260869565216,91,90,106,130,106,77,600,0.648854961832061,0.125
70,85,70,60,70,50,405,0.28378378378378377,50,92,108,92,108,35,485,0.2457627118644068,1.0
86,92,88,68,75,73,482,0.6835443037974683,60,82,45,45,45,74,351,0.5752212389380531,0.0
50,53,62,58,63,44,330,0.13709677419354838,65,75,70,95,70,95,470,0.7272727272727273,1.0
69,55,45,55,55,15,294,0.11666666666666667,40,60,40,40,40,30,250,0.0948905109489051,0.125
80,135,85,70,95,150,615,0.9844961240310077,85,76,64,45,55,90,415,0.6739130434782609,1.0
95,80,105,40,70,100,490,0.8046875,41,56,40,62,44,71,314,0.568,1.0
80,135,85,70,95,150,615,0.9844961240310077,100,90,130,45,65,55,485,0.4253731343283582,0.5
52,65,55,58,62,60,352,0.4482758620689655,40,35,30,120,70,105,400,0.6692307692307692,1.0
78,84,78,109,85,100,534,0.8646616541353384,150,80,44,90,54,80,498,0.625,1.0
70,105,105,50,40,20,390,0.33587786259541985,130,85,80,85,95,60,535,0.43884892086330934,2.0
95,125,79,60,100,81,540,0.6165413533834586,35,55,40,50,50,90,320,0.6838235294117647,0.5
54,63,52,83,56,97,405,0.7697841726618705,44,48,65,50,64,43,314,0.1623931623931624,0.5
85,110,76,65,82,56,474,0.3933333333333333,76,48,48,57,62,34,325,0.11688311688311688,2.0
78,81,71,74,69,126,499,0.9090909090909091,72,60,30,20,30,25,237,0.11570247933884298,2.0
50,85,40,85,40,35,335,0.1746031746031746,41,50,37,50,37,66,281,0.5175438596491229,1.0
65,60,70,85,75,40,395,0.1796875,45,35,50,70,50,30,280,0.15753424657534246,1.0
80,105,65,60,75,130,515,0.9645390070921985,91,90,129,90,72,108,580,0.9140625,0.25
35,45,160,30,45,70,385,0.48148148148148145,70,90,45,15,45,50,315,0.3629032258064516,4.0
60,82,45,45,45,74,351,0.5752212389380531,70,80,70,80,70,110,480,0.6594202898550725,2.0
103,60,86,60,86,50,445,0.3458646616541353,101,72,72,99,89,29,462,0.1937984496124031,1.0
40,40,35,50,100,70,335,0.5031847133757962,70,70,40,60,40,60,340,0.4247787610619469,1.0
65,90,115,45,115,58,488,0.5041322314049587,70,65,60,90,75,90,450,0.6571428571428571,0.25
59,110,150,45,49,35,448,0.3333333333333333,55,84,105,114,75,52,485,0.2890625,0.5
60,60,60,60,60,60,360,0.38095238095238093,80,115,80,65,55,93,488,0.7846153846153846,1.0
80,80,80,80,80,80,480,0.5606060606060606,70,40,50,55,50,25,290,0.061068702290076333,0.5
104,91,63,91,73,68,490,0.5118110236220472,71,120,95,120,95,99,600,0.8203125,0.5
64,51,23,51,23,28,240,0.11363636363636363,58,89,77,45,45,48,362,0.3177570093457944,0.5
100,100,100,100,100,100,600,0.8758169934640523,108,130,95,80,85,102,600,0.7637795275590551,2.0
160,110,65,65,110,30,540,0.35714285714285715,125,130,90,130,90,95,660,0.7734375,1.0
43,70,48,50,60,38,309,0.2391304347826087,46,87,60,30,40,57,320,0.37777777777777777,0.5
50,50,62,40,62,65,329,0.4188034188034188,40,60,30,31,31,70,262,0.4492753623188406,1.0
60,110,70,60,60,100,460,0.8461538461538461,44,38,39,61,79,42,303,0.2251655629139073,1.0
30,45,55,70,55,85,340,0.5633802816901409,70,120,40,95,40,95,460,0.8106060606060606,0.5
70,110,180,60,60,50,530,0.4117647058823529,60,60,60,35,35,30,280,0.11194029850746269,1.0
75,95,125,45,75,95,510,0.8257575757575758,59,59,58,90,70,73,409,0.5826086956521739,2.0
50,47,50,57,50,65,319,0.463768115942029,70,65,60,90,75,90,450,0.6571428571428571,0.5
60,85,42,85,42,91,405,0.8227848101265823,62,44,50,44,50,55,305,0.3629032258064516,1.0
60,60,75,60,75,80,410,0.7321428571428571,45,35,50,70,50,30,280,0.15753424657534246,1.0
78,84,78,109,85,100,534,0.8620689655172413,75,75,60,83,60,60,413,0.39344262295081966,0.5
60,50,100,85,70,65,430,0.47580645161290325,78,52,60,63,65,23,341,0.06015037593984962,1.0
65,130,60,95,110,65,525,0.5303030303030303,59,59,58,90,70,73,409,0.5826086956521739,0.5
40,40,50,30,30,30,220,0.0873015873015873,60,55,145,75,150,40,525,0.2,1.0
85,100,122,58,75,54,494,0.3939393939393939,60,55,145,75,150,40,525,0.2,1.0
45,22,60,27,30,29,213,0.07518796992481203,60,90,55,90,80,110,485,0.8677685950413223,1.0
80,100,123,122,120,80,625,0.56,45,65,34,40,34,45,263,0.2589928057553957,1.0
68,90,65,50,55,82,410,0.6165413533834586,85,76,64,45,55,90,415,0.6739130434782609,1.0
80,185,115,40,105,75,600,0.6230769230769231,65,155,120,65,90,105,600,0.8677685950413223,0.125
70,120,40,95,40,95,460,0.8106060606060606,120,100,85,30,85,45,465,0.22448979591836735,0.5
60,150,50,150,50,60,520,0.5,60,70,50,100,50,65,395,0.5217391304347826,1.0
100,150,110,95,110,70,635,0.5923076923076923,60,85,60,50,50,125,430,0.9090909090909091,0.0
10,55,25,35,45,95,265,0.5396825396825397,50,50,95,40,50,35,320,0.20279720279720279,1.0
75,100,95,40,70,110,490,0.8717948717948718,40,40,55,40,70,55,300,0.40939597315436244,1.0
86,92,88,68,75,73,482,0.6835443037974683,60,150,50,150,50,60,520,0.5,1.0
80,160,80,130,80,100,630,0.8455284552845529,40,45,35,40,40,90,290,0.65,2.0
65,50,70,95,80,65,425,0.4262295081967213,70,105,105,50,40,20,390,0.33587786259541985,1.0
66,41,77,61,87,23,355,0.12096774193548387,70,80,65,90,65,85,455,0.578125,1.0
45,50,45,115,55,95,405,0.6936936936936937,65,100,70,80,80,105,500,0.8666666666666667,1.0
67,89,116,79,116,33,500,0.2624113475177305,50,75,45,40,45,60,315,0.4380165289256198,1.0
77,59,50,67,63,46,362,0.23140495867768596,43,80,65,50,35,35,308,0.14193548387096774,0.5
70,80,50,35,35,35,305,0.14,50,85,40,85,40,35,335,0.1746031746031746,1.0
70,110,180,60,60,50,530,0.4117647058823529,60,45,70,75,85,55,390,0.3008130081300813,1.0
76,104,71,104,71,108,534,0.912751677852349,66,117,70,40,50,67,410,0.4573643410852713,0.5
65,110,130,60,65,95,525,0.8278145695364238,10,55,25,35,45,95,265,0.5396825396825397,2.0
65,83,57,95,85,105,490,0.8914728682170543,70,92,65,80,55,98,460,0.8090909090909091,2.0
45,65,34,40,34,45,263,0.2589928057553957,100,100,125,110,50,50,535,0.384,0.5
65,95,100,60,50,50,420,0.34959349593495936,78,84,78,109,85,100,534,0.8646616541353384,1.0
45,100,135,65,135,45,525,0.29411764705882354,70,84,70,65,70,51,410,0.2949640287769784,1.0
59,59,58,90,70,73,409,0.5826086956521739,60,55,50,40,55,45,305,0.22377622377622378,2.0
60,69,95,69,95,36,424,0.2608695652173913,70,80,70,80,70,110,480,0.6594202898550725,1.0
50,72,35,35,35,65,292,0.5373134328358209,65,73,55,47,75,85,400,0.6846846846846847,0.5
91,72,90,129,90,108,580,0.8620689655172413,55,40,40,65,45,35,280,0.16428571428571428,1.0
60,85,40,30,45,68,328,0.6422018348623854,40,70,40,35,40,60,285,0.392,1.0
46,87,60,30,40,57,320,0.37777777777777777,82,121,119,69,59,71,521,0.5394736842105263,2.0
79,85,60,55,60,71,410,0.60431654676259,45,53,70,40,60,42,310,0.25735294117647056,0.5
35,65,35,65,35,65,300,0.46621621621621623,60,50,50,60,70,50,340,0.28346456692913385,0.25
45,85,50,55,50,65,350,0.5076923076923077,75,55,70,55,95,110,460,0.8444444444444444,0.5
75,125,70,125,70,115,580,0.9037037037037037,100,100,100,100,100,100,600,0.8758169934640523,0.25
75,69,72,114,100,104,534,0.8253968253968254,80,52,50,90,50,89,411,0.6666666666666666,2.0
59,63,80,65,80,58,405,0.41843971631205673,60,65,60,130,75,110,500,0.7719298245614035,1.0
65,90,65,61,61,100,442,0.8373983739837398,106,90,130,90,154,110,680,0.8699186991869918,1.0
90,92,75,92,85,60,494,0.49586776859504134,60,70,105,70,120,75,500,0.5983606557377049,4.0
100,100,125,110,50,50,535,0.384,61,90,45,50,50,160,456,0.9230769230769231,0.25
45,30,35,20,20,45,195,0.14782608695652175,50,55,50,36,30,43,264,0.2922077922077922,0.5
45,65,34,40,34,45,263,0.2589928057553957,49,49,56,49,61,66,330,0.5190839694656488,2.0
70,62,67,55,55,56,365,0.38513513513513514,69,55,45,55,55,15,294,0.11666666666666667,1.0
60,85,42,85,42,91,405,0.8227848101265823,30,65,100,45,25,40,305,0.1891891891891892,1.0
50,65,45,85,65,95,405,0.7238095238095238,83,80,75,70,70,101,479,0.8615384615384616,0.5
50,65,45,85,65,95,405,0.7238095238095238,55,75,60,75,60,103,428,0.7982456140350878,0.5
50,50,50,50,50,50,300,0.30708661417322836,78,130,111,130,85,100,634,0.8561151079136691,1.0
70,110,180,60,60,50,530,0.4117647058823529,60,60,50,40,50,75,335,0.5882352941176471,1.0
70,65,65,55,55,70,380,0.5,108,170,115,120,95,92,700,0.7083333333333334,1.0
70,140,230,60,80,50,630,0.32432432432432434,50,85,85,55,55,50,380,0.3902439024390244,0.25
50,53,62,58,63,44,330,0.13709677419354838,55,47,52,40,40,41,275,0.16806722689075632,1.0
50,85,125,85,115,20,480,0.4306569343065693,70,92,65,80,55,98,460,0.8090909090909091,1.0
55,75,50,40,40,80,340,0.6302521008403361,55,40,40,65,45,35,280,0.16428571428571428,0.5
120,100,85,30,85,45,465,0.22448979591836735,74,48,76,83,81,104,466,0.7322834645669292,0.5
95,70,73,95,90,60,483,0.3983739837398374,90,50,34,60,44,70,348,0.6283185840707964,1.0
45,49,65,49,65,45,318,0.275,50,92,108,92,108,35,485,0.2457627118644068,1.0
100,100,100,100,100,100,600,0.8345864661654135,80,100,200,50,100,50,580,0.3472222222222222,2.0
45,95,50,40,50,75,355,0.54,105,125,100,60,100,100,590,0.8359375,1.0
75,100,63,80,63,116,497,0.9345794392523364,80,120,130,55,65,45,495,0.37037037037037035,0.0
78,52,60,63,65,23,341,0.06015037593984962,90,55,75,60,75,30,385,0.13970588235294118,1.0
86,68,72,109,66,106,507,0.8099173553719008,91,129,90,72,90,108,580,0.8536585365853658,0.25
70,43,53,43,53,40,302,0.19090909090909092,100,90,130,45,65,55,485,0.4253731343283582,0.5
95,60,79,100,125,81,540,0.6201550387596899,50,40,85,40,65,25,305,0.08870967741935484,1.0
77,85,51,55,51,65,384,0.5163934426229508,45,35,50,70,50,30,280,0.15753424657534246,2.0
60,30,30,36,56,50,262,0.32432432432432434,55,68,64,45,55,31,318,0.11666666666666667,2.0
90,60,60,40,40,40,330,0.29545454545454547,70,77,60,97,60,108,472,0.8394160583941606,1.0
70,90,90,135,90,125,600,0.9401709401709402,74,108,133,83,65,32,495,0.32142857142857145,1.0
55,45,45,25,25,15,210,0.048,45,50,35,55,75,40,300,0.21367521367521367,0.5
92,105,90,125,90,98,600,0.8217054263565892,50,50,50,50,50,50,300,0.30708661417322836,1.0
59,63,80,65,80,58,405,0.41843971631205673,103,60,126,80,126,50,545,0.36363636363636365,1.0
60,62,63,80,80,60,405,0.38016528925619836,58,70,45,40,45,42,300,0.25925925925925924,0.5
86,92,88,68,75,73,482,0.6835443037974683,108,100,121,81,95,95,600,0.7476635514018691,2.0
44,50,91,24,86,10,305,0.1981981981981982,103,60,126,80,126,50,545,0.36363636363636365,0.5
67,82,62,46,48,43,348,0.22033898305084745,50,180,20,180,20,150,600,0.9029850746268657,0.5
44,50,91,24,86,10,305,0.1981981981981982,66,117,70,40,50,67,410,0.4573643410852713,0.5
60,65,70,85,75,40,395,0.21705426356589147,50,80,95,10,45,10,290,0.232,1.0
89,124,80,55,80,55,483,0.5714285714285714,59,66,70,44,55,41,335,0.25190839694656486,1.0
65,90,122,58,75,84,494,0.71875,85,115,80,105,80,50,515,0.3063063063063063,1.0
100,150,120,120,100,90,680,0.6493506493506493,35,35,40,35,55,50,250,0.40336134453781514,1.0
70,77,60,97,60,108,472,0.8394160583941606,60,150,50,150,50,60,520,0.5,0.25
70,55,65,95,85,70,440,0.5307692307692308,38,36,38,32,36,57,237,0.3893805309734513,1.0
50,70,160,70,160,90,600,0.7417218543046358,70,60,125,115,70,55,495,0.35507246376811596,1.0
70,100,70,105,75,40,460,0.23214285714285715,60,85,60,85,60,55,405,0.3673469387755102,1.0
70,80,50,35,35,35,305,0.14,100,70,70,65,65,45,415,0.1897810218978102,2.0
55,47,52,40,40,41,275,0.16806722689075632,45,50,45,115,55,95,405,0.6936936936936937,0.25
40,30,50,55,55,100,330,0.584070796460177,95,110,80,70,80,50,485,0.37209302325581395,1.0
70,100,115,30,65,30,410,0.24390243902439024,50,50,150,50,150,50,500,0.2571428571428571,1.0
65,65,65,50,50,90,385,0.72,100,5,5,15,65,30,220,0.07692307692307693,1.0
40,45,35,30,40,55,245,0.3793103448275862,70,90,45,15,45,50,315,0.3629032258064516,1.0
110,85,95,80,95,50,515,0.2713178294573643,80,110,60,150,130,70,600,0.5042016806722689,0.0
70,120,65,45,85,125,510,0.9747899159663865,95,110,95,40,95,55,490,0.40336134453781514,1.0
50,35,55,25,25,15,205,0.05263157894736842,55,69,85,32,35,28,304,0.09302325581395349,1.0
65,90,120,85,70,60,490,0.43410852713178294,50,50,40,30,30,50,250,0.2781954887218045,0.5
40,65,95,60,45,35,340,0.13986013986013987,90,92,87,75,85,76,505,0.5409836065573771,0.25
70,70,70,70,70,70,420,0.5289256198347108,65,150,60,115,60,115,565,0.935251798561151,1.0
75,123,67,95,85,95,540,0.7642276422764228,50,65,107,105,107,86,520,0.703125,0.5
77,120,90,60,90,48,485,0.2785714285714286,91,90,72,90,129,108,580,0.896,1.0
40,50,90,30,55,65,330,0.44680851063829785,80,105,105,105,105,80,580,0.5939849624060151,2.0
75,100,63,80,63,116,497,0.9345794392523364,125,170,100,120,90,95,700,0.77,0.5
110,130,80,70,60,80,530,0.5862068965517241,60,40,60,95,60,55,370,0.4222222222222222,1.0
55,66,44,44,56,85,350,0.6888888888888889,62,48,66,59,57,49,341,0.33884297520661155,1.0
65,60,110,130,95,65,525,0.47761194029850745,75,90,140,60,60,40,465,0.3008130081300813,0.5
65,80,80,59,63,58,405,0.4411764705882353,60,90,140,50,50,40,430,0.2535211267605634,2.0
63,63,47,41,41,74,329,0.56,71,120,95,120,95,99,600,0.8203125,0.0
100,103,75,120,75,127,600,0.940677966101695,48,61,40,61,40,50,300,0.2543859649122807,1.0
60,80,110,50,80,45,425,0.2833333333333333,60,60,40,65,45,35,305,0.15833333333333333,2.0
106,150,70,194,120,140,780,0.952,55,69,85,32,35,28,304,0.09302325581395349,1.0
60,62,63,80,80,60,405,0.38016528925619836,65,55,115,100,40,60,435,0.3798449612403101,1.0
65,95,100,60,50,50,420,0.34959349593495936,72,105,115,54,86,68,500,0.5149253731343284,1.0
60,85,60,85,60,55,405,0.3673469387755102,60,80,50,40,40,30,300,0.15328467153284672,0.5
68,72,78,38,42,32,330,0.23809523809523808,45,75,60,40,30,50,300,0.304,1.0
60,60,50,40,50,75,335,0.5882352941176471,90,50,34,60,44,70,348,0.6283185840707964,0.0
80,120,70,110,70,80,530,0.6422764227642277,75,85,200,55,65,30,510,0.16778523489932887,4.0
95,85,85,65,65,35,430,0.2571428571428571,80,145,150,105,110,110,700,0.8692307692307693,2.0
100,134,110,95,100,61,600,0.4057971014492754,50,53,48,53,48,64,316,0.46153846153846156,2.0
55,75,85,25,25,15,280,0.1875,80,52,50,90,50,89,411,0.6666666666666666,4.0
40,45,35,40,40,90,290,0.65,90,130,80,65,85,55,505,0.4396551724137931,1.0
65,90,40,45,80,75,395,0.625,40,55,30,30,30,60,245,0.43548387096774194,0.5
65,65,45,75,45,95,390,0.72,75,110,110,110,105,80,590,0.656934306569343,0.5
65,90,65,61,61,100,442,0.8373983739837398,73,100,60,100,60,65,458,0.42657342657342656,1.0
75,125,70,125,70,115,580,0.9037037037037037,50,53,48,53,48,64,316,0.358974358974359,1.0
40,29,45,29,45,36,224,0.14634146341463414,69,69,76,69,86,91,460,0.6554621848739496,1.0
85,60,65,135,105,100,550,0.7518248175182481,78,70,61,50,61,100,420,0.8145161290322581,1.0
40,45,35,40,40,90,290,0.65,50,85,40,85,40,35,335,0.1746031746031746,1.0
35,45,160,30,45,70,385,0.48148148148148145,40,40,35,50,100,70,335,0.5031847133757962,2.0
75,98,63,98,63,101,498,0.889763779527559,50,95,95,35,110,70,455,0.5179856115107914,1.0
59,110,150,45,49,35,448,0.3333333333333333,60,62,63,80,80,60,405,0.38016528925619836,1.0
50,50,40,30,30,50,250,0.2781954887218045,89,145,90,105,80,91,600,0.8549618320610687,0.0
40,70,40,35,40,60,285,0.392,80,160,80,130,80,100,630,0.8455284552845529,1.0
78,104,78,159,115,100,634,0.8444444444444444,46,87,60,30,40,57,320,0.37777777777777777,0.5
40,45,65,100,120,90,460,0.5588235294117647,65,150,40,15,80,145,495,0.9663865546218487,1.0
80,80,90,110,130,110,600,0.8721804511278195,40,30,30,40,50,30,220,0.07936507936507936,1.0
60,30,30,36,56,50,262,0.32432432432432434,100,120,120,150,100,90,680,0.7880794701986755,0.25
75,80,55,25,35,35,305,0.18666666666666668,100,100,100,100,100,100,600,0.8345864661654135,0.5
95,100,85,108,70,70,528,0.5652173913043478,55,47,52,40,40,41,275,0.16806722689075632,1.0
65,80,80,59,63,58,405,0.4411764705882353,40,55,70,45,60,30,300,0.10619469026548672,1.0
90,120,75,60,60,45,450,0.29411764705882354,100,100,100,100,100,100,600,0.8602941176470589,1.0
78,65,68,112,154,75,552,0.628099173553719,30,40,70,70,25,60,295,0.41353383458646614,1.0
60,80,50,40,40,30,300,0.15328467153284672,50,48,43,46,41,60,288,0.47297297297297297,1.0
70,80,70,80,70,110,480,0.6594202898550725,55,70,40,60,40,40,305,0.26956521739130435,0.5
72,95,67,103,71,122,530,0.9606299212598425,110,85,95,80,95,50,515,0.2713178294573643,1.0
35,55,35,30,30,35,220,0.23684210526315788,80,125,75,40,95,85,500,0.6911764705882353,0.5
45,30,35,20,20,45,195,0.14782608695652175,70,85,140,85,70,20,470,0.272,0.5
70,20,50,20,50,40,250,0.1557377049180328,80,145,150,105,110,110,700,0.8692307692307693,0.5
100,103,75,120,75,127,600,0.940677966101695,60,65,80,170,95,130,600,0.8625954198473282,0.5
83,106,65,86,65,85,490,0.6640625,70,84,70,65,70,51,410,0.2949640287769784,0.5
91,72,90,129,90,108,580,0.8925619834710744,50,72,35,35,35,65,292,0.5373134328358209,4.0
109,66,84,81,99,32,471,0.2013888888888889,60,55,50,40,55,45,305,0.22377622377622378,1.0
50,20,40,20,40,20,190,0.0962962962962963,60,40,60,95,60,55,370,0.4222222222222222,0.0
79,105,70,145,80,101,580,0.8608695652173913,72,105,115,54,86,68,500,0.5149253731343284,1.0
30,45,55,70,55,85,340,0.5633802816901409,110,130,80,70,60,80,530,0.5862068965517241,2.0
55,95,55,35,75,115,430,0.9380530973451328,90,75,75,90,100,70,500,0.5462184873949579,0.5
100,90,130,45,65,55,485,0.4253731343283582,78,81,71,74,69,126,499,0.9090909090909091,8.0
50,25,28,45,55,15,218,0.0625,64,66,68,81,76,50,405,0.25190839694656486,1.0
40,80,100,30,30,20,300,0.11851851851851852,60,85,60,50,50,125,430,0.9090909090909091,0.0
67,89,116,79,116,33,500,0.2624113475177305,90,100,90,125,85,90,580,0.7352941176470589,0.5
60,130,80,60,60,70,460,0.5153846153846153,150,160,100,95,65,100,670,0.8866666666666667,2.0
90,120,100,150,120,100,680,0.7718120805369127,125,58,58,76,76,67,460,0.515625,0.5
60,50,40,85,75,95,405,0.7540983606557377,50,50,40,30,30,50,250,0.2781954887218045,0.0
38,41,40,50,65,65,299,0.4108527131782946,115,45,20,45,25,20,270,0.11538461538461539,1.0
60,80,50,50,50,40,330,0.23853211009174313,90,70,80,70,95,70,475,0.5190839694656488,1.0
70,80,50,35,35,35,305,0.14,108,130,95,80,85,102,600,0.7637795275590551,1.0
90,75,85,115,90,55,510,0.3445378151260504,50,120,53,35,110,87,455,0.640625,1.0
75,98,63,98,63,101,498,0.849624060150376,65,90,120,85,70,60,490,0.43410852713178294,1.0
70,50,30,95,135,105,485,0.8040540540540541,190,33,58,33,58,33,405,0.13432835820895522,1.0
50,120,53,35,110,87,455,0.640625,70,140,70,110,65,105,560,0.95,2.0
70,110,80,55,80,105,500,0.8794326241134752,83,80,75,70,70,101,479,0.8615384615384616,0.5
74,100,72,90,72,46,454,0.24561403508771928,105,150,90,150,90,95,680,0.8285714285714286,0.25
70,90,45,15,45,50,315,0.3629032258064516,75,98,63,98,63,101,498,0.8091603053435115,2.0
50,40,85,40,65,25,305,0.08870967741935484,80,100,200,50,100,50,580,0.3472222222222222,1.0
95,65,65,110,130,60,525,0.4016393442622951,65,95,57,100,85,93,495,0.7441860465116279,0.5
20,10,230,10,230,5,505,0.0,40,45,40,65,40,65,295,0.5661764705882353,1.0
65,90,115,45,115,58,488,0.5041322314049587,78,130,111,130,85,100,634,0.8561151079136691,1.0
80,82,83,100,100,80,525,0.6742424242424242,70,75,60,105,60,105,475,0.88,1.0
20,10,230,10,230,5,505,0.0,100,100,100,100,100,100,600,0.8602941176470589,2.0
60,40,50,75,85,95,405,0.6044776119402985,45,20,50,60,120,50,345,0.24074074074074073,4.0
55,55,45,63,45,45,308,0.25,80,95,82,60,82,75,474,0.6,1.0
91,90,129,90,72,108,580,0.9140625,71,95,85,110,95,79,535,0.664,4.0
75,100,110,45,55,65,450,0.5333333333333333,70,95,85,55,65,70,440,0.5,2.0
70,150,140,65,100,75,600,0.55,95,124,78,69,71,58,495,0.37398373983739835,1.0
48,72,48,72,48,48,336,0.25984251968503935,70,130,100,55,80,65,500,0.608,0.5
105,140,55,30,55,95,480,0.8195488721804511,90,60,70,75,70,45,410,0.23880597014925373,1.0
120,100,85,30,85,45,465,0.22448979591836735,80,100,70,60,70,95,475,0.7416666666666667,2.0
73,100,60,100,60,65,458,0.42657342657342656,60,50,150,50,150,60,520,0.5206611570247934,0.0
45,45,35,20,30,20,195,0.07246376811594203,50,105,79,35,110,76,455,0.6214285714285714,0.5
80,100,70,60,70,95,475,0.7416666666666667,40,55,99,40,79,47,360,0.26262626262626265,0.25
65,60,110,130,95,65,525,0.47761194029850745,75,95,67,125,95,83,540,0.7117117117117117,0.5
75,105,75,105,75,45,480,0.3274336283185841,91,72,90,129,90,108,580,0.8925619834710744,0.5
100,100,100,100,100,100,600,0.8778625954198473,30,42,118,42,88,30,350,0.112,0.5
53,54,53,37,46,45,288,0.3090909090909091,80,135,130,95,90,70,600,0.5181818181818182,0.5
108,170,115,120,95,92,700,0.7083333333333334,100,120,100,150,120,90,680,0.728,4.0
80,80,80,55,55,90,440,0.6417910447761194,150,120,100,120,100,90,680,0.664179104477612,0.0
50,53,48,53,48,64,316,0.46153846153846156,80,185,115,40,105,75,600,0.6230769230769231,2.0
75,125,75,30,75,85,465,0.625,120,120,120,120,120,120,720,0.9344262295081968,2.0
165,75,80,40,45,65,470,0.5151515151515151,10,55,25,35,45,95,265,0.5396825396825397,2.0
100,100,100,100,100,100,600,0.8758169934640523,115,140,130,55,55,40,535,0.4519230769230769,4.0
95,75,110,100,80,30,490,0.15267175572519084,70,75,80,135,80,135,575,0.917910447761194,1.0
70,65,60,90,75,90,450,0.6571428571428571,60,52,168,47,138,30,495,0.19834710743801653,0.0
61,72,57,55,55,65,365,0.3984375,60,40,50,75,85,95,405,0.6044776119402985,1.0
100,77,77,128,128,90,600,0.6901408450704225,123,100,62,97,81,68,531,0.4806201550387597,1.0
110,65,105,55,95,80,510,0.6258503401360545,65,40,50,125,60,30,370,0.07258064516129033,2.0
70,135,105,60,105,20,495,0.5806451612903226,95,125,79,60,100,81,540,0.6165413533834586,0.25
72,60,30,20,30,25,237,0.11570247933884298,70,70,115,130,90,60,535,0.5338983050847458,2.0
100,123,75,57,75,80,510,0.6923076923076923,110,160,110,80,110,100,670,0.8591549295774648,1.0
60,60,40,65,45,35,305,0.15833333333333333,60,85,60,50,50,125,430,0.9090909090909091,0.0
50,180,20,180,20,150,600,0.9029850746268657,45,100,135,65,135,45,525,0.29411764705882354,1.0
70,85,70,60,70,50,405,0.28378378378378377,75,75,60,83,60,60,413,0.39344262295081966,0.5
40,27,60,37,50,66,280,0.36220472440944884,70,65,65,55,55,70,380,0.5,1.0
100,150,110,95,110,70,635,0.5923076923076923,45,85,70,40,40,60,340,0.5229357798165137,2.0
59,63,80,65,80,58,405,0.41843971631205673,95,117,184,44,46,28,514,0.2975206611570248,1.0
50,45,45,35,35,50,260,0.23529411764705882,20,15,20,10,55,80,200,0.2682926829268293,1.0
45,30,35,20,20,45,195,0.14782608695652175,64,88,50,88,50,106,446,0.9111111111111111,2.0
45,60,40,70,50,45,310,0.2846715328467153,41,50,37,50,37,66,281,0.5175438596491229,1.0
59,63,80,65,80,58,405,0.41843971631205673,100,100,125,110,50,50,535,0.384,0.5
62,48,54,63,60,68,355,0.5178571428571429,43,70,48,50,60,38,309,0.2391304347826087,1.0
50,35,55,25,25,15,205,0.021739130434782608,65,95,57,100,85,93,495,0.7441860465116279,0.5
50,65,107,105,107,86,520,0.7272727272727273,45,40,60,40,75,50,310,0.2926829268292683,2.0
50,70,50,50,50,40,310,0.16296296296296298,70,140,230,60,80,50,630,0.32432432432432434,1.0
50,40,85,40,65,25,305,0.08870967741935484,50,65,107,105,107,86,520,0.703125,1.0
40,45,35,65,55,70,310,0.4482758620689655,50,20,40,20,40,20,190,0.0962962962962963,1.0
40,70,40,35,40,60,285,0.392,50,40,85,40,65,25,305,0.08870967741935484,0.5
45,35,45,62,53,35,275,0.11851851851851852,45,100,135,65,135,45,525,0.29411764705882354,1.0
75,125,100,70,80,45,495,0.33035714285714285,100,100,100,100,100,100,600,0.8345864661654135,4.0
70,55,75,45,65,60,370,0.45901639344262296,55,70,55,40,55,85,360,0.7073170731707317,1.0
40,50,90,30,55,65,330,0.44680851063829785,60,60,60,60,60,60,360,0.38095238095238093,1.0
70,110,70,115,70,90,525,0.75,95,125,79,60,100,81,540,0.6165413533834586,0.25
55,35,50,55,110,85,390,0.6277372262773723,70,100,70,105,75,40,460,0.23214285714285715,0.5
55,85,55,50,55,60,360,0.4233576642335766,40,45,65,100,120,90,460,0.5588235294117647,1.0
74,94,131,54,116,20,489,0.4485294117647059,50,180,20,180,20,150,600,0.9029850746268657,1.0
53,51,53,61,56,40,314,0.14285714285714285,60,62,50,62,60,40,334,0.18181818181818182,0.5
60,70,105,70,120,75,500,0.5983606557377049,45,22,60,27,30,29,213,0.07518796992481203,0.5
100,123,75,57,75,80,510,0.6923076923076923,70,100,70,105,75,40,460,0.23214285714285715,1.0
60,60,50,40,50,75,335,0.5882352941176471,85,73,70,73,115,67,483,0.5126050420168067,1.0
67,58,57,81,67,101,431,0.8790322580645161,75,98,63,98,63,101,498,0.889763779527559,0.5
90,93,55,70,55,55,418,0.3819444444444444,50,35,55,25,25,15,205,0.021739130434782608,1.0
75,100,95,40,70,110,490,0.8717948717948718,80,100,70,50,60,45,405,0.25806451612903225,1.0
120,120,120,120,120,120,720,0.9344262295081968,30,40,70,70,25,60,295,0.41353383458646614,1.0
95,75,110,100,80,30,490,0.15267175572519084,70,110,180,60,60,50,530,0.4117647058823529,1.0
58,50,145,95,105,30,483,0.2459016393442623,50,95,95,35,110,70,455,0.5179856115107914,1.0
95,135,80,110,80,100,600,0.8248175182481752,80,125,75,40,95,85,500,0.6911764705882353,4.0
250,5,5,35,105,50,450,0.15306122448979592,60,55,90,145,90,80,520,0.6071428571428571,0.0
108,170,115,120,95,92,700,0.7083333333333334,88,107,122,74,75,64,530,0.4596774193548387,0.5
40,70,40,35,40,60,285,0.392,78,70,61,50,61,100,420,0.8145161290322581,2.0
83,106,65,86,65,85,490,0.6640625,73,115,60,60,60,90,458,0.6694915254237288,2.0
50,100,150,100,150,50,600,0.37142857142857144,110,78,73,76,71,60,468,0.3333333333333333,0.5
95,109,105,75,85,56,525,0.34513274336283184,62,44,50,44,50,55,305,0.3629032258064516,0.0
100,120,100,150,120,90,680,0.728,125,120,90,170,100,95,700,0.78125,2.0
45,67,60,35,50,63,320,0.5128205128205128,50,25,28,45,55,15,218,0.0625,1.0
60,90,140,50,50,40,430,0.2535211267605634,80,80,80,80,80,80,480,0.6015037593984962,4.0
55,85,55,50,55,60,360,0.4233576642335766,50,70,50,50,50,40,310,0.16296296296296298,0.5
75,69,72,114,100,104,534,0.8253968253968254,80,135,130,95,90,70,600,0.5181818181818182,0.5
50,65,107,105,107,86,520,0.7313432835820896,50,85,125,85,115,20,480,0.4306569343065693,1.0
90,55,75,60,75,30,385,0.13970588235294118,30,80,90,55,45,55,355,0.4295774647887324,0.5
68,65,65,125,115,80,518,0.6461538461538462,106,110,90,154,90,130,680,0.926829268292683,0.5
55,55,55,85,55,30,335,0.1320754716981132,55,63,90,50,80,42,380,0.21138211382113822,1.0
85,56,77,50,77,78,423,0.53125,60,40,60,95,60,55,370,0.4222222222222222,0.0
50,85,85,55,55,50,380,0.3902439024390244,50,65,64,44,48,43,314,0.2196969696969697,0.5
75,98,63,98,63,101,498,0.889763779527559,55,65,95,95,45,85,440,0.6610169491525424,0.5
45,60,40,70,50,45,310,0.2846715328467153,70,55,75,45,65,60,370,0.45901639344262296,1.0
74,48,76,83,81,104,466,0.7913043478260869,70,50,30,95,135,105,485,0.8040540540540541,1.0
40,40,50,30,30,30,220,0.0873015873015873,40,70,40,35,40,60,285,0.392,1.0
100,77,77,128,128,90,600,0.6901408450704225,65,110,130,60,65,95,525,0.8278145695364238,1.0
79,115,70,125,80,111,580,0.864,80,45,65,90,110,80,470,0.5462962962962963,1.0
80,100,70,60,70,95,475,0.7416666666666667,40,30,50,55,55,100,330,0.584070796460177,1.0
79,85,60,55,60,71,410,0.60431654676259,85,135,130,60,80,25,515,0.40540540540540543,1.0
69,69,76,69,86,91,460,0.6554621848739496,50,50,150,50,150,50,500,0.2571428571428571,2.0
68,90,65,50,55,82,410,0.6165413533834586,45,35,45,62,53,35,275,0.11851851851851852,0.5
76,48,48,57,62,34,325,0.11688311688311688,65,125,100,55,70,85,500,0.6532258064516129,1.0
76,147,90,60,70,97,540,0.8267716535433071,55,70,55,40,55,85,360,0.7073170731707317,1.0
61,84,65,70,70,70,420,0.5,28,25,25,45,35,40,198,0.16083916083916083,0.0
53,54,53,37,46,45,288,0.3090909090909091,91,134,95,100,100,80,600,0.6304347826086957,1.0
72,58,80,103,80,97,490,0.7171052631578947,35,46,34,35,45,20,215,0.072,1.0
50,95,180,85,45,70,525,0.5298507462686567,50,85,125,85,115,20,480,0.4306569343065693,1.0
60,60,60,60,60,60,360,0.38095238095238093,50,47,50,57,50,65,319,0.463768115942029,1.0
60,70,105,70,120,75,500,0.5983606557377049,60,100,89,55,69,112,485,0.9298245614035088,2.0
65,80,140,40,70,70,465,0.5223880597014925,90,75,85,115,90,55,510,0.3445378151260504,0.25
95,155,109,70,130,81,640,0.6788321167883211,90,55,75,60,75,30,385,0.13970588235294118,1.0
95,75,180,130,80,30,590,0.13793103448275862,55,35,50,55,110,85,390,0.6277372262773723,1.0
91,134,95,100,100,80,600,0.6304347826086957,78,52,60,63,65,23,341,0.06015037593984962,0.0
70,60,125,115,70,55,495,0.35507246376811596,65,150,40,15,80,145,495,0.9663865546218487,2.0
55,84,105,114,75,52,485,0.2890625,45,40,60,40,75,50,310,0.2926829268292683,1.0
82,121,119,69,59,71,521,0.5394736842105263,55,20,35,20,45,75,250,0.37681159420289856,1.0
150,120,100,120,100,90,680,0.664179104477612,56,61,65,48,45,38,313,0.17567567567567569,1.0
68,65,65,125,115,80,518,0.6461538461538462,75,123,67,95,85,95,540,0.7642276422764228,1.0
80,135,85,70,95,150,615,0.9844961240310077,62,48,54,63,60,68,355,0.5178571428571429,1.0
40,40,50,30,30,30,220,0.0873015873015873,70,95,125,65,75,45,475,0.33613445378151263,1.0
80,70,65,80,120,100,515,0.8034188034188035,67,58,57,81,67,101,431,0.8790322580645161,2.0
50,75,35,70,30,40,300,0.21296296296296297,55,112,45,74,45,70,401,0.559322033898305,0.5
99,68,83,72,87,51,460,0.417910447761194,40,60,30,31,31,70,262,0.4492753623188406,0.5
100,50,80,60,80,50,420,0.34375,59,74,50,35,50,35,303,0.3125,2.0
126,131,95,131,98,99,680,0.8294573643410853,65,75,90,97,123,44,494,0.1987179487179487,1.0
100,100,100,100,100,100,600,0.8758169934640523,80,82,100,83,100,80,525,0.6821705426356589,1.0
50,70,160,70,160,90,600,0.7417218543046358,58,64,58,80,65,80,405,0.5423728813559322,1.0
55,55,45,63,45,45,308,0.25,62,48,66,59,57,49,341,0.33884297520661155,1.0
60,48,45,43,90,42,328,0.21897810218978103,65,130,60,95,110,65,525,0.5303030303030303,1.0
55,70,55,40,55,85,360,0.7073170731707317,65,155,120,65,90,105,600,0.8677685950413223,1.0
45,85,70,40,40,60,340,0.5229357798165137,45,80,100,35,37,28,325,0.3125,1.0
100,100,100,100,100,100,600,0.8345864661654135,75,103,80,70,80,92,500,0.7933884297520661,0.25
40,55,70,45,60,30,300,0.10619469026548672,59,45,40,35,40,31,250,0.14285714285714285,1.0
74,94,131,54,116,20,489,0.4485294117647059,30,42,118,42,88,30,350,0.112,1.0
50,95,90,95,90,180,600,0.9172413793103448,50,50,77,95,77,91,440,0.5916666666666667,1.0
108,130,95,80,85,102,600,0.7637795275590551,65,125,60,95,60,105,510,0.9236641221374046,1.0
57,24,86,24,86,23,300,0.12727272727272726,68,125,65,65,115,80,518,0.6277372262773723,0.5
60,85,69,65,79,80,438,0.576,55,45,43,55,43,72,313,0.5853658536585366,1.0
38,30,41,30,41,60,240,0.2897196261682243,60,50,100,85,70,65,430,0.47580645161290325,1.0
78,104,78,159,115,100,634,0.8444444444444444,65,55,115,100,40,60,435,0.3798449612403101,4.0
59,59,58,90,70,73,409,0.5826086956521739,80,120,79,95,79,70,523,0.5833333333333334,1.0
83,106,65,86,65,85,490,0.6640625,60,100,89,55,69,112,485,0.9298245614035088,0.125
100,100,100,100,100,100,600,0.8778625954198473,40,35,30,120,70,105,400,0.6692307692307692,0.5
52,65,55,58,62,60,352,0.4482758620689655,130,70,35,70,35,60,400,0.4017857142857143,1.0
91,134,95,100,100,80,600,0.6304347826086957,80,80,80,80,80,80,480,0.6015037593984962,1.0
52,65,50,45,50,38,300,0.27419354838709675,50,75,75,65,65,50,380,0.4049586776859504,1.0
65,76,84,54,96,105,480,0.9008264462809917,40,60,40,40,40,30,250,0.0948905109489051,1.0
65,60,110,130,95,65,525,0.47761194029850745,120,100,85,30,85,45,465,0.22448979591836735,1.0
25,35,70,95,55,45,325,0.16783216783216784,70,55,65,95,85,70,440,0.5307692307692308,2.0
70,40,50,55,50,25,290,0.061068702290076333,40,40,40,70,40,20,250,0.032520325203252036,1.0
75,75,75,125,95,40,485,0.15671641791044777,50,95,180,85,45,70,525,0.5298507462686567,1.0
65,73,55,47,75,85,400,0.6846846846846847,30,45,55,70,55,85,340,0.5633802816901409,1.0
70,70,115,130,90,60,535,0.5338983050847458,55,63,90,50,80,42,380,0.21138211382113822,0.5
40,45,35,30,40,55,245,0.3793103448275862,70,70,70,70,70,70,420,0.5289256198347108,1.0
80,115,80,65,55,93,488,0.7846153846153846,75,103,80,70,80,92,500,0.7933884297520661,4.0
55,50,45,135,95,120,500,0.7714285714285715,65,90,122,58,75,84,494,0.71875,1.0
57,24,86,24,86,23,300,0.12727272727272726,75,105,75,105,75,45,480,0.3274336283185841,0.5
95,60,79,100,125,81,540,0.6201550387596899,110,65,75,125,85,30,490,0.15,1.0
150,100,120,100,120,90,680,0.6666666666666666,40,27,60,37,50,66,280,0.36220472440944884,0.0
95,145,130,120,90,120,700,0.9398496240601504,70,84,70,65,70,51,410,0.2949640287769784,0.5
70,95,125,65,75,45,475,0.33613445378151263,70,140,70,110,65,105,560,0.95,2.0
50,50,120,80,80,30,410,0.07258064516129033,50,53,62,58,63,44,330,0.13709677419354838,0.5
88,107,122,74,75,64,530,0.4596774193548387,60,62,63,80,80,60,405,0.38016528925619836,0.125
50,50,150,50,150,50,500,0.2571428571428571,75,95,60,65,60,115,470,0.8778625954198473,1.0
65,130,60,75,60,75,465,0.689922480620155,40,30,32,50,52,65,269,0.3671875,1.0
50,55,50,36,30,43,264,0.2922077922077922,70,83,50,37,50,60,350,0.3360655737704918,1.0
50,65,107,105,107,86,520,0.7313432835820896,100,100,100,100,100,100,600,0.8758169934640523,0.5
49,55,42,42,37,85,310,0.6068376068376068,50,100,150,100,150,50,600,0.37142857142857144,0.5
100,50,80,60,80,50,420,0.34375,90,130,80,65,85,55,505,0.4396551724137931,2.0
75,95,60,65,60,115,470,0.8778625954198473,60,69,95,69,95,36,424,0.2608695652173913,0.5
41,56,40,62,44,71,314,0.568,66,41,77,61,87,23,355,0.12096774193548387,1.0
60,55,90,145,90,80,520,0.6071428571428571,46,57,40,40,40,50,273,0.25,1.0
90,90,85,125,90,100,580,0.768595041322314,70,50,30,95,135,105,485,0.8040540540540541,1.0
45,95,50,40,50,75,355,0.54,78,130,111,130,85,100,634,0.8561151079136691,1.0
86,76,86,116,56,95,515,0.7982456140350878,65,90,50,85,45,55,390,0.371900826446281,2.0
70,55,55,80,60,45,365,0.2222222222222222,100,100,90,150,140,90,670,0.71875,2.0
90,120,100,150,120,100,680,0.7718120805369127,80,82,78,95,80,85,500,0.6869565217391305,0.5
55,70,40,60,40,40,305,0.26956521739130435,50,53,62,58,63,44,330,0.13709677419354838,0.5
30,45,55,70,55,85,340,0.5633802816901409,90,110,80,100,80,95,555,0.7982456140350878,2.0
50,65,107,105,107,86,520,0.7758620689655172,79,103,120,135,115,78,630,0.5763888888888888,1.0
45,95,50,40,50,75,355,0.54,50,25,28,45,55,15,218,0.0625,0.5
74,48,76,83,81,104,466,0.7322834645669292,80,135,130,95,90,70,600,0.5181818181818182,0.25
130,70,35,70,35,60,400,0.4017857142857143,77,120,90,60,90,48,485,0.2785714285714286,0.5
55,69,85,32,35,28,304,0.09302325581395349,95,117,80,65,70,92,519,0.8409090909090909,2.0
30,40,55,40,55,60,280,0.3237410071942446,45,45,55,45,55,63,308,0.4594594594594595,1.0
65,83,57,95,85,105,490,0.8914728682170543,45,60,32,50,32,76,295,0.5925925925925926,0.5
40,45,40,35,35,56,251,0.373015873015873,61,84,65,70,70,70,420,0.5,1.0
45,65,34,40,34,45,263,0.2589928057553957,50,50,40,30,30,50,250,0.2781954887218045,0.0
80,82,78,95,80,85,500,0.6869565217391305,20,40,90,30,90,25,295,0.11363636363636363,1.0
45,55,39,35,39,42,255,0.18518518518518517,45,30,40,105,50,20,290,0.031007751937984496,1.0
50,45,45,35,35,50,260,0.23529411764705882,65,95,100,60,50,50,420,0.34959349593495936,1.0
50,65,85,35,35,55,325,0.32575757575757575,55,55,45,63,45,45,308,0.25,1.0
95,60,79,100,125,81,540,0.6201550387596899,60,75,85,100,85,115,520,0.8992248062015504,0.5
55,50,65,175,95,150,590,0.7818181818181819,90,95,105,165,110,45,610,0.2890625,1.0
70,90,45,15,45,50,315,0.3629032258064516,50,95,90,95,90,180,600,0.9172413793103448,1.0
35,55,35,30,30,35,220,0.23684210526315788,123,77,72,99,92,58,521,0.4621212121212121,1.0
78,65,68,112,154,75,552,0.628099173553719,45,85,50,55,50,65,350,0.5076923076923077,2.0
59,45,40,35,40,31,250,0.14285714285714285,84,86,88,111,101,60,530,0.4634146341463415,0.5
82,121,119,69,59,71,521,0.5394736842105263,65,75,90,97,123,44,494,0.1987179487179487,2.0
60,25,35,70,80,60,330,0.3076923076923077,67,57,55,77,55,114,425,0.8879310344827587,0.5
45,49,49,65,65,45,318,0.2781954887218045,91,72,90,129,90,108,580,0.8620689655172413,2.0
77,120,90,60,90,48,485,0.2785714285714286,50,65,85,35,35,55,325,0.32575757575757575,1.0
52,65,55,58,62,60,352,0.4482758620689655,50,30,55,65,55,20,275,0.13675213675213677,0.0
85,110,90,45,90,80,500,0.6206896551724138,105,125,100,60,100,100,590,0.8359375,1.0
40,50,90,30,55,65,330,0.44680851063829785,45,22,60,27,30,29,213,0.07518796992481203,1.0
60,40,50,75,85,95,405,0.6044776119402985,125,58,58,76,76,67,460,0.515625,1.0
45,50,55,75,65,30,320,0.06293706293706294,65,125,100,55,70,85,500,0.6532258064516129,0.5
76,65,45,92,42,91,411,0.7449664429530202,65,130,60,75,60,75,465,0.689922480620155,1.0
70,55,95,95,110,65,490,0.48872180451127817,55,63,90,50,80,42,380,0.21138211382113822,1.0
52,65,55,58,62,60,352,0.4482758620689655,63,120,85,90,55,55,468,0.2809917355371901,1.0
65,90,50,85,45,55,390,0.371900826446281,45,50,55,75,65,30,320,0.06293706293706294,0.25
58,64,58,80,65,80,405,0.5423728813559322,100,75,115,90,115,85,580,0.6446280991735537,0.5
49,66,70,44,55,51,335,0.4260869565217391,35,85,45,35,35,75,310,0.6492537313432836,0.0
75,100,95,40,70,110,490,0.8717948717948718,35,40,100,90,55,35,355,0.1796875,0.5
30,30,30,30,30,30,180,0.12612612612612611,64,51,23,51,23,28,240,0.11363636363636363,1.0
28,25,25,45,35,40,198,0.16083916083916083,53,54,53,37,46,45,288,0.3090909090909091,0.0
80,120,130,55,65,45,495,0.37037037037037035,60,62,80,63,80,60,405,0.4336283185840708,0.5
100,50,80,60,80,50,420,0.34375,40,30,32,50,52,65,269,0.3671875,0.5
80,185,115,40,105,75,600,0.6230769230769231,50,75,45,40,45,60,315,0.4380165289256198,0.5
40,55,30,30,30,60,245,0.43548387096774194,44,38,33,61,43,70,289,0.5267857142857143,0.5
40,27,60,37,50,66,280,0.36220472440944884,75,125,70,125,70,115,580,0.9037037037037037,1.0
50,20,40,20,40,20,190,0.0962962962962963,73,100,60,100,60,65,458,0.42657342657342656,0.5
65,150,40,15,80,145,495,0.9663865546218487,95,109,105,75,85,56,525,0.34513274336283184,2.0
59,45,40,35,40,31,250,0.14285714285714285,70,110,80,55,80,105,500,0.8794326241134752,1.0
65,65,65,50,50,90,385,0.72,45,45,55,45,55,63,308,0.4594594594594595,0.5
90,70,80,70,95,70,475,0.5190839694656488,100,90,130,45,65,55,485,0.4253731343283582,0.5
70,60,75,110,75,90,480,0.7165354330708661,120,70,120,75,130,85,600,0.6694915254237288,1.0
100,50,50,76,96,70,442,0.5,55,40,85,80,105,40,405,0.23622047244094488,1.0
40,45,40,65,40,65,295,0.5661764705882353,55,20,35,20,45,75,250,0.37681159420289856,1.0
40,45,40,62,60,60,307,0.33884297520661155,65,90,40,45,80,75,395,0.625,2.0
80,120,79,95,79,70,523,0.5833333333333334,65,90,122,58,75,84,494,0.71875,0.5
106,110,90,154,90,130,680,0.926829268292683,64,88,50,88,50,106,446,0.9111111111111111,0.0
70,100,115,30,65,30,410,0.24390243902439024,66,41,77,61,87,23,355,0.12096774193548387,1.0
80,125,75,40,95,85,500,0.6911764705882353,55,50,65,175,95,150,590,0.7818181818181819,1.0
80,82,100,83,100,80,525,0.6821705426356589,75,87,63,87,63,98,473,0.865546218487395,1.0
78,52,60,63,65,23,341,0.06015037593984962,60,40,60,40,60,35,295,0.18055555555555555,1.0
40,70,40,35,40,60,285,0.392,130,85,80,85,95,60,535,0.43884892086330934,2.0
60,65,70,85,75,40,395,0.21705426356589147,58,64,58,80,65,80,405,0.5423728813559322,0.5
83,106,65,86,65,85,490,0.6640625,50,80,95,10,45,10,290,0.232,1.0
45,30,15,85,65,65,305,0.36220472440944884,20,40,15,35,35,60,205,0.34285714285714286,1.0
150,160,100,95,65,100,670,0.8866666666666667,46,87,60,30,40,57,320,0.37777777777777777,1.0
55,50,65,175,95,150,590,0.7818181818181819,65,130,60,95,110,65,525,0.5303030303030303,1.0
90,93,55,70,55,55,418,0.3819444444444444,60,100,85,80,85,100,510,0.7007874015748031,0.5
100,150,110,95,110,70,635,0.5923076923076923,50,50,40,30,30,50,250,0.2781954887218045,2.0
60,95,80,60,80,30,405,0.19480519480519481,61,78,95,56,58,57,405,0.40336134453781514,1.0
90,50,34,60,44,70,348,0.6283185840707964,75,85,200,55,65,30,510,0.16778523489932887,0.5
65,90,115,45,115,58,488,0.5041322314049587,35,60,44,40,54,55,288,0.366412213740458,0.5
45,63,37,65,55,95,360,0.8055555555555556,59,66,70,44,55,41,335,0.25190839694656486,0.5
105,125,100,60,100,100,590,0.8359375,190,33,58,33,58,33,405,0.13432835820895522,1.0
40,55,70,45,60,30,300,0.10619469026548672,100,100,125,110,50,50,535,0.384,1.0
76,147,90,60,70,97,540,0.8267716535433071,70,55,95,95,110,65,490,0.48872180451127817,1.0
54,63,52,83,56,97,405,0.7697841726618705,67,58,57,81,67,101,431,0.8790322580645161,1.0
60,52,168,47,138,30,495,0.19834710743801653,31,45,90,30,30,40,266,0.21929824561403508,1.0
90,60,70,75,70,45,410,0.23880597014925373,70,60,125,115,70,55,495,0.35507246376811596,0.5
110,65,105,55,95,80,510,0.6258503401360545,95,85,85,65,65,35,430,0.2571428571428571,1.0
75,80,55,25,35,35,305,0.18666666666666668,45,30,50,65,50,45,285,0.13821138211382114,0.5
75,95,122,58,75,69,494,0.5725806451612904,95,117,80,65,70,92,519,0.8409090909090909,1.0
64,165,75,93,83,75,555,0.6587301587301587,150,120,100,120,100,90,680,0.664179104477612,2.0
110,85,95,80,95,50,515,0.2713178294573643,95,100,85,108,70,70,528,0.5652173913043478,1.0
65,65,60,110,95,130,525,0.9253731343283582,30,30,42,30,42,70,244,0.4230769230769231,2.0
35,85,45,35,35,75,310,0.6492537313432836,35,46,34,35,45,20,215,0.072,1.0
55,95,55,35,75,115,430,0.9380530973451328,59,74,50,35,50,35,303,0.3125,4.0
65,70,60,65,65,115,440,0.8583333333333333,50,70,160,70,160,90,600,0.7417218543046358,1.0
70,90,110,60,75,95,500,0.7333333333333333,75,75,60,83,60,60,413,0.39344262295081966,1.0
68,72,78,38,42,32,330,0.23809523809523808,60,65,80,170,95,130,600,0.8625954198473282,2.0
100,70,70,65,65,45,415,0.1897810218978102,75,98,63,98,63,101,498,0.8091603053435115,1.0
63,63,47,41,41,74,329,0.56,67,89,116,79,116,33,500,0.2624113475177305,0.0
45,30,15,85,65,65,305,0.36220472440944884,45,85,70,40,40,60,340,0.5229357798165137,0.0
100,134,110,95,100,61,600,0.4057971014492754,110,65,105,55,95,80,510,0.6258503401360545,1.0
50,48,43,46,41,60,288,0.47297297297297297,65,63,45,45,45,45,308,0.2595419847328244,4.0
105,125,100,60,100,100,590,0.8359375,90,85,100,95,125,85,580,0.6834532374100719,1.0
65,136,94,54,96,135,580,0.9612403100775194,54,66,70,44,55,46,335,0.4214876033057851,0.0
45,30,40,105,50,20,290,0.031007751937984496,65,55,115,100,40,60,435,0.3798449612403101,1.0
49,49,56,49,61,66,330,0.5190839694656488,36,50,50,65,60,44,305,0.16363636363636364,1.0
60,45,70,45,90,95,405,0.7304964539007093,60,85,49,60,49,60,363,0.4444444444444444,0.5
58,89,77,45,45,48,362,0.3177570093457944,70,94,50,94,50,66,424,0.48148148148148145,4.0
55,40,40,65,45,35,280,0.16428571428571428,76,25,45,67,55,24,292,0.0390625,1.0
90,100,60,90,60,80,480,0.6422764227642277,46,57,40,40,40,50,273,0.25,0.5
50,40,85,40,65,25,305,0.08870967741935484,95,95,85,125,65,55,520,0.3894736842105263,4.0
80,80,80,55,55,90,440,0.6417910447761194,83,80,75,70,70,101,479,0.8615384615384616,1.0
75,95,60,65,60,115,470,0.8778625954198473,55,75,60,75,60,103,428,0.7982456140350878,1.0
100,134,110,95,100,61,600,0.4057971014492754,45,50,43,40,38,62,278,0.40441176470588236,2.0
60,75,85,100,85,115,520,0.8992248062015504,40,45,40,65,40,65,295,0.5661764705882353,1.0
81,102,77,85,75,85,505,0.5642857142857143,60,55,50,40,55,45,305,0.22377622377622378,0.5
44,58,44,58,44,61,309,0.41964285714285715,71,95,85,110,95,79,535,0.664,2.0
95,60,79,100,125,81,540,0.6201550387596899,30,30,30,30,30,30,180,0.12612612612612611,0.5
40,55,30,30,30,85,270,0.688,90,70,80,70,95,70,475,0.5190839694656488,1.0
95,145,130,120,90,120,700,0.9398496240601504,60,67,85,77,75,116,480,0.8888888888888888,0.0
100,150,140,100,90,90,670,0.7969924812030075,39,52,43,60,50,65,309,0.49107142857142855,2.0
35,46,34,35,45,20,215,0.072,75,90,50,110,80,95,500,0.7985611510791367,1.0
68,90,65,50,55,82,410,0.6165413533834586,35,70,55,45,55,25,285,0.09420289855072464,0.25
50,105,79,35,110,76,455,0.6214285714285714,100,100,100,100,100,100,600,0.8778625954198473,0.5
108,130,95,80,85,102,600,0.7637795275590551,45,35,45,62,53,35,275,0.11851851851851852,0.5
60,85,42,85,42,91,405,0.8227848101265823,80,185,115,40,105,75,600,0.6230769230769231,2.0
65,90,40,45,80,75,395,0.625,60,60,60,60,60,60,360,0.38095238095238093,1.0
45,65,34,40,34,45,263,0.2589928057553957,45,75,37,70,55,83,365,0.6183206106870229,1.0
45,60,45,25,45,55,275,0.29,79,103,120,135,115,78,630,0.5763888888888888,1.0
92,105,90,125,90,98,600,0.8217054263565892,45,95,50,40,50,75,355,0.54,1.0
38,35,35,65,55,50,278,0.2647058823529412,99,68,83,72,87,51,460,0.417910447761194,1.0
50,25,28,45,55,15,218,0.0625,82,121,119,69,59,71,521,0.5394736842105263,2.0
160,110,65,65,110,30,540,0.35714285714285715,105,150,90,150,90,95,680,0.8285714285714286,1.0
55,40,40,65,45,35,280,0.16428571428571428,60,85,69,65,79,80,438,0.576,1.0
50,75,35,70,30,40,300,0.21296296296296297,45,30,50,65,50,45,285,0.13821138211382114,1.0
90,70,80,70,95,70,475,0.5190839694656488,40,60,30,31,31,70,262,0.4492753623188406,2.0
110,65,105,55,95,80,510,0.6258503401360545,89,124,80,55,80,55,483,0.5714285714285714,2.0
55,75,50,40,40,80,340,0.6302521008403361,70,20,50,20,50,40,250,0.1557377049180328,1.0
40,40,40,70,40,20,250,0.032520325203252036,77,85,51,55,51,65,384,0.5163934426229508,2.0
80,80,50,40,50,25,325,0.176056338028169,59,66,70,44,55,41,335,0.25190839694656486,1.0
50,150,50,150,50,150,600,0.9339622641509434,95,65,65,110,130,60,525,0.4016393442622951,1.0
50,95,95,35,110,70,455,0.5179856115107914,40,30,30,55,30,85,270,0.4666666666666667,0.5
150,80,44,90,54,80,498,0.625,100,77,77,128,128,90,600,0.6901408450704225,0.0
30,40,70,70,25,60,295,0.41353383458646614,110,160,110,80,110,100,670,0.8591549295774648,1.0
64,88,50,88,50,106,446,0.9111111111111111,45,30,15,85,65,65,305,0.36220472440944884,2.0
105,140,55,30,55,95,480,0.8195488721804511,55,55,50,45,65,55,325,0.37373737373737376,1.0
70,80,65,90,65,85,455,0.578125,75,125,70,125,70,115,580,0.9037037037037037,0.5
50,70,50,50,50,70,340,0.5645161290322581,45,85,70,40,40,60,340,0.5229357798165137,1.0
45,50,55,75,65,30,320,0.06293706293706294,45,50,45,115,55,95,405,0.6936936936936937,0.125
66,117,70,40,50,67,410,0.4573643410852713,65,47,55,73,75,85,400,0.65,1.0
82,80,86,85,75,72,480,0.6183206106870229,60,150,50,150,50,60,520,0.5,0.5
50,85,40,85,40,35,335,0.1746031746031746,60,40,80,60,45,40,325,0.23529411764705882,0.5
110,80,90,95,90,65,530,0.5033557046979866,255,10,10,75,135,55,540,0.3125,1.0
57,24,86,24,86,23,300,0.12727272727272726,45,35,50,70,50,30,280,0.15753424657534246,1.0
50,100,150,100,150,50,600,0.37142857142857144,50,53,48,53,48,64,316,0.46153846153846156,1.0
65,90,40,45,80,75,395,0.625,54,78,103,53,45,22,355,0.23255813953488372,0.5
50,95,90,95,90,180,600,0.9172413793103448,80,145,150,105,110,110,700,0.8692307692307693,0.25
60,115,105,65,70,80,495,0.7181818181818181,91,134,95,100,100,80,600,0.6304347826086957,1.0
85,105,100,79,83,78,530,0.5869565217391305,65,90,120,85,70,60,490,0.43410852713178294,1.0
60,90,70,60,120,40,440,0.27419354838709675,50,50,120,80,80,30,410,0.07258064516129033,0.5
65,136,94,54,96,135,580,0.9612403100775194,90,55,75,60,75,30,385,0.13970588235294118,2.0
80,80,80,55,55,90,440,0.6417910447761194,150,160,100,95,65,100,670,0.8866666666666667,1.0
65,150,60,115,60,115,565,0.935251798561151,65,95,100,60,50,50,420,0.34959349593495936,1.0
78,84,78,109,85,100,534,0.8620689655172413,70,92,65,80,55,98,460,0.8090909090909091,0.5
60,45,70,75,85,55,390,0.3008130081300813,35,35,40,35,55,50,250,0.40336134453781514,1.0
50,160,110,160,110,110,700,0.8854961832061069,90,75,75,90,100,70,500,0.5462184873949579,1.0
90,120,120,60,60,50,500,0.35294117647058826,95,65,110,60,130,65,525,0.5275590551181102,1.0
100,73,83,73,83,55,467,0.371900826446281,120,70,120,75,130,85,600,0.6694915254237288,1.0
50,50,150,50,150,50,500,0.2571428571428571,80,125,75,40,95,85,500,0.6911764705882353,2.0
55,40,85,80,105,40,405,0.23622047244094488,50,50,150,50,150,50,500,0.2571428571428571,0.5
95,124,78,69,71,58,495,0.37398373983739835,40,55,70,45,60,30,300,0.10619469026548672,2.0
40,60,40,40,40,30,250,0.0948905109489051,60,80,95,70,85,50,440,0.2231404958677686,0.0
50,95,90,95,90,180,600,0.9172413793103448,55,95,55,35,75,115,430,0.9380530973451328,0.0
100,100,100,100,100,100,600,0.8345864661654135,85,73,70,73,115,67,483,0.5126050420168067,0.5
40,30,50,55,55,100,330,0.584070796460177,55,65,35,60,30,85,330,0.6126126126126126,2.0
55,55,85,65,85,35,380,0.2014388489208633,65,90,120,85,70,60,490,0.43410852713178294,1.0
75,98,63,98,63,101,498,0.889763779527559,65,90,115,45,115,58,488,0.5041322314049587,1.0
100,134,110,95,100,61,600,0.4057971014492754,75,65,55,65,55,69,384,0.43548387096774194,0.5
150,120,100,120,100,90,680,0.664179104477612,80,125,75,40,95,85,500,0.6911764705882353,1.0
70,60,62,80,82,60,414,0.4375,75,69,72,114,100,104,534,0.8253968253968254,1.0
30,105,90,25,25,50,325,0.2773722627737226,50,20,55,25,25,30,205,0.09774436090225563,1.0
95,124,78,69,71,58,495,0.37398373983739835,35,64,85,74,55,32,345,0.19827586206896552,1.0
70,60,62,80,82,60,414,0.4375,75,103,80,70,80,92,500,0.7933884297520661,8.0
60,75,100,55,80,50,420,0.3088235294117647,65,60,70,85,75,40,395,0.1796875,1.0
75,75,75,125,95,40,485,0.15671641791044777,45,30,40,105,50,20,290,0.031007751937984496,0.5
55,75,85,25,25,15,280,0.1875,80,115,80,65,55,93,488,0.7846153846153846,2.0
62,77,62,50,42,65,358,0.4838709677419355,108,130,95,80,85,102,600,0.7637795275590551,1.0
63,120,85,90,55,55,468,0.2809917355371901,111,83,68,92,82,39,475,0.1774193548387097,1.0
82,121,119,69,59,71,521,0.5394736842105263,70,60,75,110,75,90,480,0.7165354330708661,1.0
35,85,45,35,35,75,310,0.6492537313432836,40,70,130,60,130,25,455,0.17355371900826447,0.0
100,100,100,100,100,100,600,0.831858407079646,55,69,85,32,35,28,304,0.09302325581395349,1.0
45,40,60,40,75,50,310,0.2926829268292683,85,73,70,73,115,67,483,0.5126050420168067,1.0
55,50,40,40,40,75,300,0.5945945945945946,50,75,35,70,30,40,300,0.21296296296296297,1.0
45,60,40,70,50,45,310,0.2846715328467153,95,100,85,108,70,70,528,0.5652173913043478,0.5
20,10,55,15,20,80,200,0.17985611510791366,65,130,60,95,110,65,525,0.5303030303030303,2.0
74,100,72,90,72,46,454,0.24561403508771928,72,58,80,103,80,97,490,0.7171052631578947,0.5
70,55,55,80,60,45,365,0.2222222222222222,91,129,90,72,90,108,580,0.8536585365853658,1.0
75,123,67,95,85,95,540,0.7642276422764228,70,150,140,65,100,75,600,0.55,1.0
100,90,130,45,65,55,485,0.4253731343283582,80,80,90,110,130,110,600,0.8721804511278195,0.5
190,33,58,33,58,33,405,0.13432835820895522,75,95,67,125,95,83,540,0.7117117117117117,1.0
78,84,78,109,85,100,534,0.8646616541353384,49,66,70,44,55,51,335,0.4260869565217391,4.0
78,130,111,130,85,100,634,0.8561151079136691,70,110,180,60,60,50,530,0.4117647058823529,0.5
53,51,53,61,56,40,314,0.14285714285714285,55,66,44,44,56,85,350,0.6888888888888889,1.0
55,70,55,40,55,85,360,0.7073170731707317,95,125,79,60,100,81,540,0.6165413533834586,1.0
35,40,100,90,55,35,355,0.1796875,75,95,60,65,60,115,470,0.8778625954198473,1.0
50,65,85,35,35,55,325,0.32575757575757575,49,55,42,42,37,85,310,0.6068376068376068,1.0
44,48,65,50,64,43,314,0.1623931623931624,40,35,30,20,20,50,195,0.23423423423423423,1.0
78,52,60,63,65,23,341,0.06015037593984962,90,60,60,40,40,40,330,0.29545454545454547,1.0
80,160,60,170,130,80,680,0.6180555555555556,42,52,67,39,56,50,306,0.2868217054263566,1.0
40,45,40,65,40,65,295,0.5661764705882353,60,45,50,90,80,70,395,0.625,2.0
40,35,30,20,20,50,195,0.23423423423423423,46,57,40,40,40,50,273,0.25,0.25
55,70,45,70,50,60,350,0.45,38,30,85,55,65,30,303,0.21428571428571427,1.0
85,120,70,50,60,100,485,0.8308823529411765,75,125,75,30,75,85,465,0.625,2.0
70,75,60,105,60,105,475,0.88,75,125,75,30,75,85,465,0.625,1.0
60,70,50,100,50,65,395,0.5217391304347826,45,35,45,62,53,35,275,0.11851851851851852,4.0
45,60,45,25,45,55,275,0.29,65,40,70,80,140,70,465,0.5954198473282443,1.0
60,60,60,60,60,60,360,0.38095238095238093,45,30,15,85,65,65,305,0.36220472440944884,1.0
75,125,70,125,70,115,580,0.9037037037037037,40,45,35,65,55,70,310,0.4482758620689655,1.0
75,75,95,75,95,113,528,0.9015151515151515,35,55,40,50,50,90,320,0.6838235294117647,1.0
60,85,49,60,49,60,363,0.4444444444444444,60,90,140,50,50,40,430,0.2535211267605634,1.0
60,62,50,62,60,40,334,0.18181818181818182,80,80,50,40,50,25,325,0.176056338028169,0.5
35,35,35,35,35,35,210,0.13385826771653545,85,135,130,60,80,25,515,0.40540540540540543,2.0
50,65,107,105,107,86,520,0.703125,97,165,60,65,50,58,495,0.3902439024390244,1.0
59,66,70,44,55,41,335,0.25190839694656486,65,80,140,40,70,70,465,0.5223880597014925,0.25
68,75,53,83,113,60,452,0.45384615384615384,55,55,45,63,45,45,308,0.25,1.0
65,95,75,55,55,85,430,0.6933333333333334,80,85,95,30,30,25,345,0.2857142857142857,1.0
40,35,30,20,20,50,195,0.23423423423423423,50,120,53,35,110,87,455,0.640625,0.5
60,90,140,50,50,40,430,0.2535211267605634,65,125,100,55,70,85,500,0.6532258064516129,2.0
45,40,60,40,75,50,310,0.2926829268292683,78,70,61,50,61,100,420,0.8145161290322581,1.0
70,40,50,55,50,25,290,0.061068702290076333,79,115,70,125,80,111,580,0.8468468468468469,2.0
60,100,89,55,69,112,485,0.9298245614035088,105,180,100,180,100,115,780,0.9477611940298507,0.5
50,75,45,40,45,60,315,0.4380165289256198,65,90,115,45,115,58,488,0.5041322314049587,1.0
60,100,89,55,69,112,485,0.9298245614035088,95,23,48,23,48,23,260,0.046153846153846156,2.0
38,36,38,32,36,57,237,0.3893805309734513,80,130,100,160,120,110,700,0.8981481481481481,1.0
255,10,10,75,135,55,540,0.3125,100,128,90,77,77,128,600,0.959349593495935,1.0
85,97,66,105,66,65,484,0.47107438016528924,50,50,62,40,62,65,329,0.4188034188034188,1.0
60,90,70,60,120,40,440,0.27419354838709675,105,150,90,150,90,95,680,0.8285714285714286,1.0
40,30,30,40,50,30,220,0.07936507936507936,65,100,70,80,80,105,500,0.8666666666666667,1.0
73,100,60,100,60,65,458,0.42657342657342656,41,56,40,62,44,71,314,0.568,1.0
54,63,52,83,56,97,405,0.7697841726618705,38,36,38,32,36,57,237,0.3893805309734513,1.0
77,59,50,67,63,46,362,0.23140495867768596,70,110,180,60,60,50,530,0.4117647058823529,0.25
40,40,35,50,100,70,335,0.5031847133757962,95,65,110,60,130,65,525,0.5275590551181102,1.0
45,63,37,65,55,95,360,0.8055555555555556,64,66,68,81,76,50,405,0.25190839694656486,2.0
95,117,80,65,70,92,519,0.8409090909090909,35,65,35,65,35,65,300,0.46621621621621623,1.0
50,180,20,180,20,150,600,0.9029850746268657,50,30,55,65,55,20,275,0.13675213675213677,1.0
30,65,100,45,25,40,305,0.1891891891891892,70,110,75,145,85,145,630,0.9444444444444444,0.25
55,104,105,94,75,52,485,0.36363636363636365,55,50,40,40,40,75,300,0.5945945945945946,1.0
80,80,50,40,50,25,325,0.176056338028169,45,35,50,70,50,30,280,0.15753424657534246,2.0
95,70,73,95,90,60,483,0.3983739837398374,45,60,32,50,32,76,295,0.5925925925925926,1.0
65,75,70,95,70,95,470,0.7272727272727273,70,62,67,55,55,56,365,0.38513513513513514,2.0
60,30,30,36,56,50,262,0.32432432432432434,62,44,50,44,50,55,305,0.3629032258064516,1.0
90,130,80,65,85,55,505,0.4396551724137931,65,65,60,110,95,130,525,0.9253731343283582,1.0
108,170,115,120,95,92,700,0.7083333333333334,100,73,83,73,83,55,467,0.371900826446281,2.0
40,65,40,80,40,65,330,0.5038167938931297,76,65,45,92,42,91,411,0.7449664429530202,1.0
75,100,63,80,63,116,497,0.9345794392523364,105,105,75,65,100,50,500,0.37593984962406013,1.0
100,100,100,100,100,100,600,0.8805970149253731,80,92,65,65,80,68,450,0.4824561403508772,0.5
110,78,73,76,71,60,468,0.3333333333333333,106,110,90,154,90,130,680,0.926829268292683,1.0
60,62,63,80,80,60,405,0.38016528925619836,106,190,100,154,100,130,780,0.9259259259259259,1.0
60,62,80,63,80,60,405,0.4336283185840708,100,180,160,150,90,90,770,0.7520661157024794,1.0
70,55,95,95,110,65,490,0.48872180451127817,55,55,55,85,55,30,335,0.1320754716981132,0.5
59,59,58,90,70,73,409,0.5826086956521739,55,70,55,40,55,85,360,0.7073170731707317,1.0
60,40,80,60,45,40,325,0.23529411764705882,75,95,67,125,95,83,540,0.7117117117117117,0.5
70,110,180,60,60,50,530,0.4117647058823529,40,45,65,100,120,90,460,0.5588235294117647,0.5
83,106,65,86,65,85,490,0.6640625,95,124,78,69,71,58,495,0.37398373983739835,2.0
70,120,65,45,85,125,510,0.9747899159663865,68,75,53,83,113,60,452,0.45384615384615384,2.0
60,105,60,120,60,105,510,0.8849557522123894,70,85,70,60,70,50,405,0.28378378378378377,1.0
55,35,50,55,110,85,390,0.6277372262773723,95,155,109,70,130,81,640,0.6788321167883211,2.0
60,85,69,60,69,77,420,0.518796992481203,105,140,55,30,55,95,480,0.8195488721804511,1.0
45,67,60,35,50,63,320,0.5128205128205128,57,24,86,24,86,23,300,0.12727272727272726,1.0
55,65,35,60,30,85,330,0.6126126126126126,60,65,80,170,95,130,600,0.8625954198473282,1.0
40,30,30,55,30,85,270,0.4666666666666667,100,164,150,95,120,71,700,0.5645161290322581,1.0
40,35,30,120,70,105,400,0.6692307692307692,80,110,120,130,90,70,600,0.6198347107438017,1.0
150,100,120,100,120,90,680,0.6666666666666666,80,160,60,170,130,80,680,0.6180555555555556,1.0
105,140,55,30,55,95,480,0.8195488721804511,65,65,60,110,95,130,525,0.9253731343283582,1.0
40,60,40,40,40,30,250,0.0948905109489051,60,82,45,45,45,74,351,0.5752212389380531,1.0
95,80,105,40,70,100,490,0.8046875,65,83,57,95,85,105,490,0.8914728682170543,1.0
91,90,72,90,129,108,580,0.896,125,130,90,130,90,95,660,0.7734375,1.0
60,48,45,43,90,42,328,0.21897810218978103,100,110,90,85,90,60,535,0.47794117647058826,2.0
64,165,75,93,83,75,555,0.6587301587301587,85,105,85,40,50,40,405,0.211864406779661,1.0
90,95,105,165,110,45,610,0.2890625,80,82,78,95,80,85,500,0.6869565217391305,2.0
80,105,65,60,75,130,515,0.9645390070921985,50,80,95,10,45,10,290,0.232,0.5
67,57,55,77,55,114,425,0.8879310344827587,101,72,72,99,89,29,462,0.1937984496124031,1.0
30,45,59,30,39,57,260,0.2803030303030303,84,71,43,71,43,48,360,0.25874125874125875,1.0
85,110,90,45,90,80,500,0.6206896551724138,60,45,70,45,90,95,405,0.7304964539007093,1.0
71,73,88,120,89,59,500,0.43537414965986393,60,85,40,30,45,68,328,0.6422018348623854,2.0
45,49,49,65,65,45,318,0.2781954887218045,43,70,48,50,60,38,309,0.2391304347826087,0.5
80,85,95,30,30,25,345,0.2857142857142857,75,98,63,98,63,101,498,0.8091603053435115,0.5
110,130,80,70,60,80,530,0.5862068965517241,82,121,119,69,59,71,521,0.5394736842105263,4.0
80,120,70,110,70,80,530,0.6422764227642277,50,180,20,180,20,150,600,0.9029850746268657,0.5
75,100,63,80,63,116,497,0.9345794392523364,85,76,64,45,55,90,415,0.6739130434782609,1.0
60,60,40,65,45,35,305,0.15833333333333333,100,100,100,100,100,100,600,0.8758169934640523,4.0
80,115,80,65,55,93,488,0.7846153846153846,70,95,85,55,65,70,440,0.5,0.25
108,112,118,68,72,47,525,0.2916666666666667,40,45,35,65,55,70,310,0.4482758620689655,0.5
75,98,63,98,63,101,498,0.889763779527559,60,60,50,40,50,75,335,0.5882352941176471,2.0
75,110,110,110,105,80,590,0.656934306569343,75,75,75,125,95,40,485,0.15671641791044777,1.0
45,30,50,55,65,45,290,0.208,60,50,70,80,80,140,480,0.8449612403100775,1.0
60,85,60,50,50,125,430,0.9090909090909091,75,100,110,45,55,65,450,0.5333333333333333,1.0
60,82,45,45,45,74,351,0.5752212389380531,80,95,82,60,82,75,474,0.6,2.0
55,40,40,65,45,35,280,0.16428571428571428,80,80,90,110,130,110,600,0.8721804511278195,0.5
70,20,50,20,50,40,250,0.1557377049180328,60,25,35,70,80,60,330,0.3076923076923077,1.0
55,66,44,44,56,85,350,0.6888888888888889,50,64,50,45,50,41,300,0.22727272727272727,0.5
65,136,94,54,96,135,580,0.9612403100775194,65,60,110,130,95,65,525,0.47761194029850745,2.0
95,95,85,125,65,55,520,0.3894736842105263,70,20,50,20,50,40,250,0.1557377049180328,2.0
40,50,90,30,55,65,330,0.44680851063829785,60,55,145,75,150,40,525,0.2,0.0
58,89,77,45,45,48,362,0.3177570093457944,76,104,71,104,71,108,534,0.912751677852349,1.0
79,100,80,110,90,121,580,0.968,41,50,37,50,37,66,281,0.5175438596491229,1.0
70,65,65,55,55,70,380,0.5,20,10,230,10,230,5,505,0.0,0.5
80,185,115,40,105,75,600,0.6230769230769231,50,50,62,40,62,65,329,0.4188034188034188,0.25
85,97,66,105,66,65,484,0.47107438016528924,64,115,65,83,63,65,455,0.5323741007194245,1.0
90,75,85,115,90,55,510,0.3445378151260504,40,60,30,31,31,70,262,0.4492753623188406,2.0
38,30,85,55,65,30,303,0.21428571428571427,74,48,76,83,81,104,466,0.7322834645669292,2.0
54,63,52,83,56,97,405,0.7697841726618705,90,30,15,40,20,15,210,0.043478260869565216,1.0
45,60,30,80,50,65,330,0.4603174603174603,85,110,76,65,82,56,474,0.3933333333333333,4.0
100,50,50,76,96,70,442,0.5,75,65,55,65,55,69,384,0.43548387096774194,1.0
55,20,35,20,45,75,250,0.37681159420289856,50,70,50,50,50,70,340,0.5645161290322581,1.0
76,48,48,57,62,34,325,0.11688311688311688,126,131,95,131,98,99,680,0.8294573643410853,1.0
76,65,45,92,42,91,411,0.7449664429530202,60,70,50,100,50,65,395,0.5217391304347826,2.0
60,70,105,70,120,75,500,0.5983606557377049,80,120,70,110,70,80,530,0.6422764227642277,2.0
80,45,65,90,110,80,470,0.5462962962962963,36,50,50,65,60,44,305,0.16363636363636364,1.0
35,55,40,45,40,60,275,0.35714285714285715,75,65,55,65,55,69,384,0.43548387096774194,0.0
65,90,50,85,45,55,390,0.371900826446281,40,30,50,55,55,100,330,0.584070796460177,1.0
75,87,63,87,63,98,473,0.865546218487395,70,150,140,65,100,75,600,0.55,1.0
65,155,120,65,90,105,600,0.8677685950413223,30,40,55,40,55,60,280,0.3237410071942446,2.0
60,62,50,62,60,40,334,0.18181818181818182,70,70,70,70,70,70,420,0.5289256198347108,1.0
74,100,72,90,72,46,454,0.24561403508771928,78,130,111,130,85,100,634,0.8561151079136691,0.25
65,65,65,50,50,90,385,0.72,66,117,70,40,50,67,410,0.4573643410852713,0.5
78,104,78,159,115,100,634,0.8444444444444444,67,125,40,30,30,58,350,0.3431372549019608,0.25
30,65,100,45,25,40,305,0.1891891891891892,63,63,47,41,41,74,329,0.56,1.0
50,65,107,105,107,86,520,0.703125,95,65,65,110,130,60,525,0.4016393442622951,1.0
65,110,130,60,65,95,525,0.8278145695364238,60,60,60,85,85,85,435,0.631578947368421,1.0
97,165,60,65,50,58,495,0.3902439024390244,45,60,30,80,50,65,330,0.4603174603174603,2.0
59,74,50,35,50,35,303,0.3125,75,80,55,25,35,35,305,0.18666666666666668,1.0
75,90,90,140,90,115,600,0.9481481481481482,106,90,130,90,154,110,680,0.8699186991869918,2.0
45,40,60,40,75,50,310,0.2926829268292683,50,105,79,35,110,76,455,0.6214285714285714,2.0
40,45,65,100,120,90,460,0.5588235294117647,66,117,70,40,50,67,410,0.4573643410852713,2.0
80,95,82,60,82,75,474,0.6,65,65,60,110,95,130,525,0.9253731343283582,1.0
40,60,30,31,31,70,262,0.4492753623188406,60,55,90,145,90,80,520,0.6071428571428571,0.0
45,95,50,40,50,75,355,0.54,75,80,85,110,90,50,490,0.3548387096774194,1.0
61,84,65,70,70,70,420,0.5,65,40,50,125,60,30,370,0.07258064516129033,1.0
60,45,50,90,80,70,395,0.625,55,40,50,65,85,40,335,0.3181818181818182,0.5
115,115,85,90,75,100,580,0.8134328358208955,50,75,35,70,30,40,300,0.21296296296296297,2.0
45,67,60,35,50,63,320,0.5128205128205128,41,50,37,50,37,66,281,0.5175438596491229,1.0
60,90,70,60,120,40,440,0.27419354838709675,50,20,40,20,40,20,190,0.0962962962962963,1.0
80,70,40,100,60,145,495,0.921875,110,78,73,76,71,60,468,0.3333333333333333,1.0
110,123,65,100,65,65,528,0.5217391304347826,65,90,65,61,61,100,442,0.8373983739837398,1.0
59,45,40,35,40,31,250,0.14285714285714285,50,65,85,35,35,55,325,0.32575757575757575,0.5
150,160,100,95,65,100,670,0.8866666666666667,95,70,73,95,90,60,483,0.3983739837398374,1.0
70,80,70,80,70,110,480,0.6594202898550725,50,50,77,95,77,91,440,0.5916666666666667,2.0
50,53,62,58,63,44,330,0.13709677419354838,54,78,103,53,45,22,355,0.23255813953488372,1.0
40,55,30,30,30,60,245,0.43548387096774194,61,72,57,55,55,65,365,0.3984375,1.0
65,75,70,95,70,95,470,0.7272727272727273,150,80,44,90,54,80,498,0.625,1.0
108,112,118,68,72,47,525,0.2916666666666667,65,40,50,125,60,30,370,0.07258064516129033,1.0
91,72,90,129,90,108,580,0.8925619834710744,70,60,62,80,82,60,414,0.4375,0.25
65,110,130,60,65,95,525,0.8278145695364238,30,40,70,70,25,60,295,0.41353383458646614,2.0
50,105,125,55,95,50,480,0.375886524822695,60,60,60,60,60,60,360,0.38095238095238093,1.0
65,76,84,54,96,105,480,0.9008264462809917,35,70,55,45,55,25,285,0.09420289855072464,1.0
100,128,90,77,77,128,600,0.959349593495935,50,95,180,85,45,70,525,0.5298507462686567,2.0
50,65,85,35,35,55,325,0.32575757575757575,40,45,35,30,40,55,245,0.3793103448275862,0.5
50,50,62,40,62,65,329,0.4188034188034188,80,70,40,100,60,145,495,0.921875,1.0
60,48,45,43,90,42,328,0.21897810218978103,110,85,95,80,95,50,515,0.2713178294573643,1.0
65,65,60,110,95,130,525,0.9253731343283582,75,98,63,98,63,101,498,0.8091603053435115,0.5
105,30,105,140,105,55,540,0.3524590163934426,123,77,72,99,92,58,521,0.4621212121212121,1.0
91,129,90,72,90,108,580,0.8536585365853658,80,80,80,80,80,80,480,0.6015037593984962,4.0
65,90,122,58,75,84,494,0.71875,30,40,55,40,55,60,280,0.3237410071942446,2.0
73,100,60,100,60,65,458,0.42657342657342656,1,90,45,30,30,40,236,0.33064516129032256,0.5
91,72,90,129,90,108,580,0.8925619834710744,50,65,85,35,35,55,325,0.32575757575757575,2.0
65,75,70,95,70,95,470,0.7272727272727273,80,100,80,80,80,100,520,0.9051724137931034,2.0
35,55,40,45,40,60,275,0.35714285714285715,40,70,40,35,40,60,285,0.392,1.0
65,130,60,75,60,75,465,0.689922480620155,80,90,80,130,110,110,600,0.856,2.0
55,84,105,114,75,52,485,0.2890625,95,135,80,110,80,100,600,0.8248175182481752,0.5
65,80,140,40,70,70,465,0.5223880597014925,100,100,90,150,140,90,670,0.71875,0.5
80,100,123,122,120,80,625,0.56,70,70,115,130,90,60,535,0.5338983050847458,0.0
105,150,90,150,90,95,680,0.8285714285714286,80,95,82,60,82,75,474,0.6,1.0
60,90,70,60,120,40,440,0.27419354838709675,65,80,140,40,70,70,465,0.5223880597014925,0.5
91,90,129,90,72,108,580,0.9140625,95,117,80,65,70,92,519,0.8409090909090909,2.0
80,82,78,95,80,85,500,0.6869565217391305,20,15,20,10,55,80,200,0.2682926829268293,0.5
45,30,50,65,50,45,285,0.13821138211382114,85,135,130,60,80,25,515,0.40540540540540543,1.0
35,60,44,40,54,55,288,0.366412213740458,68,125,65,65,115,80,518,0.6277372262773723,1.0
75,100,95,40,70,110,490,0.8717948717948718,36,50,50,65,60,44,305,0.16363636363636364,1.0
40,65,40,80,40,65,330,0.5038167938931297,70,90,110,60,75,95,500,0.7333333333333333,0.5
165,75,80,40,45,65,470,0.5151515151515151,1,90,45,30,30,40,236,0.33064516129032256,1.0
40,45,40,62,60,60,307,0.33884297520661155,61,90,45,50,50,160,456,0.9230769230769231,2.0
75,125,75,30,75,85,465,0.625,95,65,110,60,130,65,525,0.5275590551181102,2.0
106,110,90,154,90,130,680,0.926829268292683,60,100,85,80,85,100,510,0.7007874015748031,0.5
55,40,40,65,45,35,280,0.16428571428571428,116,55,85,107,95,29,487,0.06818181818181818,1.0
45,90,20,65,20,65,305,0.5116279069767442,62,77,62,50,42,65,358,0.4838709677419355,1.0
36,50,50,65,60,44,305,0.16363636363636364,65,130,60,95,110,65,525,0.5303030303030303,0.5
62,77,62,50,42,65,358,0.4838709677419355,115,140,130,55,55,40,535,0.4519230769230769,0.25
60,45,70,45,90,95,405,0.7304964539007093,50,65,107,105,107,86,520,0.7272727272727273,1.0
65,63,45,45,45,45,308,0.2595419847328244,30,42,118,42,88,30,350,0.112,1.0
78,92,75,74,63,118,500,0.8842975206611571,40,50,90,30,55,65,330,0.44680851063829785,0.5
50,65,107,105,107,86,520,0.6991150442477876,35,35,35,35,35,35,210,0.13385826771653545,1.0
60,85,60,85,60,55,405,0.3673469387755102,55,84,105,114,75,52,485,0.2890625,0.5
105,140,95,55,65,45,505,0.3,76,48,48,57,62,34,325,0.11688311688311688,1.0
70,20,50,20,50,40,250,0.1557377049180328,65,90,122,58,75,84,494,0.71875,0.5
40,30,35,50,70,55,280,0.28205128205128205,75,38,38,56,56,67,330,0.5263157894736842,2.0
75,98,63,98,63,101,498,0.8091603053435115,64,115,65,83,63,65,455,0.5323741007194245,1.0
35,55,40,50,50,90,320,0.6838235294117647,90,55,75,60,75,30,385,0.13970588235294118,1.0
40,35,30,20,20,50,195,0.23423423423423423,75,75,55,105,85,30,425,0.1619718309859155,4.0
95,117,184,44,46,28,514,0.2975206611570248,60,40,60,40,60,35,295,0.18055555555555555,2.0
43,70,48,50,60,38,309,0.2391304347826087,67,89,116,79,116,33,500,0.2624113475177305,1.0
100,110,90,85,90,60,535,0.47794117647058826,115,115,85,90,75,100,580,0.8134328358208955,4.0
51,65,65,80,75,59,395,0.4365079365079365,75,80,85,110,90,50,490,0.3548387096774194,2.0
100,100,100,100,100,100,600,0.8778625954198473,44,58,44,58,44,61,309,0.41964285714285715,0.5
49,55,42,42,37,85,310,0.6068376068376068,88,107,122,74,75,64,530,0.4596774193548387,1.0
105,130,120,45,45,40,485,0.4444444444444444,62,50,58,73,54,72,369,0.4435483870967742,4.0
35,35,40,35,55,50,250,0.40336134453781514,100,150,90,180,160,90,770,0.7348484848484849,2.0
100,128,90,77,77,128,600,0.959349593495935,60,60,40,65,45,35,305,0.15833333333333333,1.0
150,120,100,120,100,90,680,0.664179104477612,60,50,150,50,150,60,520,0.5206611570247934,1.0
80,80,50,40,50,25,325,0.176056338028169,41,64,45,50,50,50,300,0.36752136752136755,1.0
106,90,130,90,154,110,680,0.8699186991869918,58,50,145,95,105,30,483,0.2459016393442623,1.0
60,60,50,40,50,75,335,0.5882352941176471,65,60,110,130,95,65,525,0.47761194029850745,1.0
106,130,90,110,154,90,680,0.719626168224299,77,59,50,67,63,46,362,0.23140495867768596,0.5
70,85,140,85,70,20,470,0.272,95,70,73,95,90,60,483,0.3983739837398374,1.0
60,50,50,60,70,50,340,0.28346456692913385,76,147,90,60,70,97,540,0.8267716535433071,0.25
35,55,35,30,30,35,220,0.23684210526315788,75,125,100,70,80,45,495,0.33035714285714285,1.0
60,75,100,55,80,50,420,0.3088235294117647,70,110,75,145,85,145,630,0.9444444444444444,1.0
45,65,34,40,34,45,263,0.2589928057553957,120,70,120,75,130,85,600,0.6694915254237288,1.0
30,105,90,25,25,50,325,0.2773722627737226,75,80,60,65,90,102,472,0.8625954198473282,1.0
85,100,122,58,75,54,494,0.3939393939393939,50,65,64,44,48,43,314,0.2196969696969697,2.0
65,90,115,45,115,58,488,0.5041322314049587,40,60,40,40,40,30,250,0.0948905109489051,0.25
64,51,23,51,23,28,240,0.11363636363636363,75,105,75,105,75,45,480,0.3274336283185841,1.0
55,63,90,50,80,42,380,0.21138211382113822,63,120,85,90,55,55,468,0.2809917355371901,4.0
70,90,70,60,60,70,420,0.6390977443609023,250,5,5,35,105,50,450,0.15306122448979592,1.0
40,45,35,40,40,90,290,0.65,25,35,70,95,55,45,325,0.16783216783216784,0.5
52,65,55,58,62,60,352,0.4482758620689655,80,120,70,110,70,80,530,0.6422764227642277,2.0
50,85,125,85,115,20,480,0.4306569343065693,50,48,43,46,41,60,288,0.47297297297297297,1.0
76,104,71,104,71,108,534,0.912751677852349,39,52,43,60,50,65,309,0.5041322314049587,0.5
68,165,95,65,115,110,618,0.8615384615384616,45,50,43,40,38,62,278,0.40441176470588236,1.0
95,95,85,125,65,55,520,0.3894736842105263,45,25,50,25,25,35,205,0.13076923076923078,0.5
60,55,90,145,90,80,520,0.6071428571428571,78,104,78,159,115,100,634,0.8444444444444444,0.5
100,134,110,95,100,61,600,0.4057971014492754,55,75,85,25,25,15,280,0.1875,1.0
73,115,60,60,60,90,458,0.6694915254237288,59,110,150,45,49,35,448,0.3333333333333333,0.0
50,65,85,35,35,55,325,0.32575757575757575,65,70,60,65,65,115,440,0.8583333333333333,1.0
58,64,58,80,65,80,405,0.609271523178808,65,90,40,45,80,75,395,0.625,2.0
55,50,45,135,95,120,500,0.7714285714285715,100,75,115,90,115,85,580,0.6446280991735537,1.0
82,121,119,69,59,71,521,0.5394736842105263,106,190,100,154,100,130,780,0.9259259259259259,0.5
65,150,40,15,80,145,495,0.9663865546218487,72,58,80,103,80,97,490,0.7171052631578947,1.0
79,115,70,125,80,111,580,0.8468468468468469,50,72,35,35,35,65,292,0.5373134328358209,1.0
30,105,90,25,25,50,325,0.2773722627737226,50,40,85,40,65,25,305,0.08870967741935484,1.0
85,90,80,70,80,130,535,0.9262295081967213,75,123,67,95,85,95,540,0.7642276422764228,0.5
125,120,90,170,100,95,700,0.78125,35,70,55,45,55,25,285,0.09420289855072464,2.0
75,75,60,83,60,60,413,0.39344262295081966,130,65,60,110,95,65,525,0.5227272727272727,0.5
70,95,85,55,65,70,440,0.5,72,105,115,54,86,68,500,0.5149253731343284,1.0
68,125,65,65,115,80,518,0.6277372262773723,78,104,78,159,115,100,634,0.8444444444444444,0.5
91,72,90,129,90,108,580,0.8925619834710744,104,91,63,91,73,68,490,0.5118110236220472,2.0
60,100,89,55,69,112,485,0.9298245614035088,95,60,79,100,125,81,540,0.6201550387596899,1.0
30,45,59,30,39,57,260,0.2803030303030303,95,85,85,65,65,35,430,0.2571428571428571,0.5
43,70,48,50,60,38,309,0.2391304347826087,30,45,135,45,90,30,375,0.09285714285714286,2.0
60,110,70,60,60,100,460,0.8461538461538461,52,65,50,45,50,38,300,0.27419354838709675,1.0
75,95,95,95,95,85,540,0.6470588235294118,90,85,100,95,125,85,580,0.6834532374100719,1.0
106,190,100,154,100,130,780,0.9259259259259259,150,120,100,120,100,90,680,0.664179104477612,0.0
60,55,50,40,55,45,305,0.22377622377622378,100,100,100,100,100,100,600,0.8805970149253731,1.0
50,72,35,35,35,65,292,0.5373134328358209,78,104,78,159,115,100,634,0.8444444444444444,0.0
108,100,121,81,95,95,600,0.7476635514018691,80,80,80,80,80,80,480,0.6015037593984962,1.0
20,10,55,15,20,80,200,0.17985611510791366,91,134,95,100,100,80,600,0.6304347826086957,0.5
60,100,115,70,85,90,520,0.7557251908396947,60,130,80,60,60,70,460,0.5153846153846153,1.0
65,90,65,61,61,100,442,0.8373983739837398,60,40,60,95,60,55,370,0.4222222222222222,0.0
45,75,60,40,30,50,300,0.304,41,64,45,50,50,50,300,0.36752136752136755,2.0
75,105,75,105,75,45,480,0.3274336283185841,60,48,45,43,90,42,328,0.21897810218978103,1.0
64,115,65,83,63,65,455,0.5323741007194245,100,150,90,180,160,90,770,0.7348484848484849,1.0
65,90,115,45,115,58,488,0.5041322314049587,108,112,118,68,72,47,525,0.2916666666666667,1.0
42,52,67,39,56,50,306,0.2868217054263566,35,64,85,74,55,32,345,0.19827586206896552,0.5
40,45,40,35,35,56,251,0.373015873015873,70,120,100,145,105,20,560,0.2824427480916031,1.0
49,49,56,49,61,66,330,0.5190839694656488,55,55,85,65,85,35,380,0.2014388489208633,1.0
80,85,95,30,30,25,345,0.2857142857142857,74,48,76,83,81,104,466,0.7322834645669292,1.0
60,80,95,70,85,50,440,0.2231404958677686,86,68,72,109,66,106,507,0.8099173553719008,0.5
80,100,70,60,70,95,475,0.7416666666666667,73,115,60,60,60,90,458,0.6694915254237288,1.0
95,145,130,120,90,120,700,0.9398496240601504,60,60,60,85,85,85,435,0.631578947368421,1.0
40,35,30,20,20,50,195,0.23423423423423423,61,84,65,70,70,70,420,0.5,1.0
90,75,85,115,90,55,510,0.3445378151260504,95,95,85,125,65,55,520,0.3894736842105263,0.5
30,30,30,30,30,30,180,0.12612612612612611,55,75,50,40,40,80,340,0.6302521008403361,0.5
110,65,105,55,95,80,510,0.6258503401360545,57,24,86,24,86,23,300,0.12727272727272726,1.0
80,135,130,95,90,70,600,0.5181818181818182,75,69,72,114,100,104,534,0.8253968253968254,0.25
50,47,50,57,50,65,319,0.463768115942029,60,60,60,105,105,105,495,0.848,0.5
55,112,45,74,45,70,401,0.559322033898305,75,125,230,55,95,30,610,0.3448275862068966,0.125
105,95,75,85,75,74,509,0.5714285714285714,60,65,70,85,75,40,395,0.21705426356589147,0.5
68,165,95,65,115,110,618,0.8615384615384616,126,131,95,131,98,99,680,0.8102189781021898,0.0
60,80,110,50,80,45,425,0.2833333333333333,75,65,55,65,55,69,384,0.43548387096774194,1.0
45,53,70,40,60,42,310,0.25735294117647056,71,120,95,120,95,99,600,0.8203125,0.125
60,90,55,90,80,110,485,0.8677685950413223,88,107,122,74,75,64,530,0.4596774193548387,0.5
65,55,115,100,40,60,435,0.3798449612403101,59,45,40,35,40,31,250,0.14285714285714285,1.0
95,110,80,70,80,50,485,0.37209302325581395,60,60,60,85,85,85,435,0.631578947368421,1.0
70,100,115,30,65,30,410,0.24390243902439024,55,75,50,40,40,80,340,0.6302521008403361,2.0
80,135,85,70,95,150,615,0.9844961240310077,78,130,111,130,85,100,634,0.8561151079136691,2.0
35,45,160,30,45,70,385,0.48148148148148145,90,100,60,90,60,80,480,0.6422764227642277,0.5
80,125,75,40,95,85,500,0.6911764705882353,100,100,100,100,100,100,600,0.8778625954198473,0.5
50,35,55,25,25,15,205,0.021739130434782608,85,56,77,50,77,78,423,0.53125,1.0
80,135,85,70,95,150,615,0.9844961240310077,35,65,35,65,35,65,300,0.46621621621621623,1.0
55,70,55,40,55,85,360,0.7073170731707317,82,80,86,85,75,72,480,0.6183206106870229,1.0
41,64,45,50,50,50,300,0.36752136752136755,100,150,140,100,90,90,670,0.7969924812030075,1.0
50,50,40,30,30,50,250,0.2781954887218045,64,165,75,93,83,75,555,0.6587301587301587,1.0
58,50,145,95,105,30,483,0.2459016393442623,73,115,60,60,60,90,458,0.6694915254237288,0.0
80,130,100,160,120,110,700,0.8981481481481481,62,44,50,44,50,55,305,0.3629032258064516,1.0
62,55,52,109,94,109,481,0.7833333333333333,80,70,65,80,120,100,515,0.8034188034188035,2.0
75,75,55,105,85,30,425,0.1619718309859155,50,50,62,40,62,65,329,0.4188034188034188,0.5
36,50,50,65,60,44,305,0.16363636363636364,108,112,118,68,72,47,525,0.2916666666666667,2.0
62,48,66,59,57,49,341,0.33884297520661155,40,35,30,120,70,105,400,0.6692307692307692,1.0
50,100,150,100,150,50,600,0.37142857142857144,35,46,34,35,45,20,215,0.072,1.0
60,50,100,85,70,65,430,0.47580645161290325,90,110,80,100,80,95,555,0.7982456140350878,2.0
60,60,60,35,35,30,280,0.11194029850746269,49,55,42,42,37,85,310,0.6068376068376068,1.0
50,35,55,25,25,15,205,0.05263157894736842,105,125,100,60,100,100,590,0.8359375,1.0
110,85,95,80,95,50,515,0.2713178294573643,90,55,75,60,75,30,385,0.13970588235294118,1.0
75,100,66,60,66,115,482,0.918918918918919,90,55,75,60,75,30,385,0.13970588235294118,1.0
35,55,40,50,50,90,320,0.6838235294117647,76,65,45,92,42,91,411,0.7449664429530202,2.0
40,70,40,35,40,60,285,0.392,80,50,100,100,200,50,580,0.2357142857142857,2.0
50,50,95,40,50,35,320,0.20279720279720279,43,70,48,50,60,38,309,0.2391304347826087,0.5
50,60,45,100,80,65,400,0.45689655172413796,50,50,40,50,40,64,294,0.45588235294117646,2.0
50,64,50,45,50,41,300,0.22727272727272727,74,100,72,90,72,46,454,0.24561403508771928,0.5
95,124,78,69,71,58,495,0.37398373983739835,79,85,60,55,60,71,410,0.60431654676259,2.0
97,165,60,65,50,58,495,0.3902439024390244,40,60,30,31,31,70,262,0.4492753623188406,2.0
55,69,85,32,35,28,304,0.09302325581395349,55,65,95,95,45,85,440,0.6610169491525424,0.5
95,85,85,65,65,35,430,0.2571428571428571,85,50,95,120,115,80,545,0.5793650793650794,0.0
95,145,130,120,90,120,700,0.9398496240601504,38,30,85,55,65,30,303,0.21428571428571427,1.0
65,80,80,59,63,58,405,0.4411764705882353,65,130,60,95,110,65,525,0.5303030303030303,2.0
79,103,120,135,115,78,630,0.5763888888888888,61,72,57,55,55,65,365,0.3984375,1.0
76,65,45,92,42,91,411,0.7449664429530202,60,85,42,85,42,91,405,0.8227848101265823,1.0
70,120,100,145,105,20,560,0.2824427480916031,100,120,100,150,120,90,680,0.728,0.5
95,65,65,110,130,60,525,0.4016393442622951,70,60,70,87,78,85,450,0.6228070175438597,1.0
48,72,48,72,48,48,336,0.25984251968503935,56,61,65,48,45,38,313,0.17567567567567569,1.0
80,100,70,60,70,95,475,0.7416666666666667,50,48,43,46,41,60,288,0.47297297297297297,4.0
76,104,71,104,71,108,534,0.912751677852349,70,120,65,45,85,125,510,0.9747899159663865,8.0
50,75,70,35,70,48,348,0.29357798165137616,95,110,95,40,95,55,490,0.40336134453781514,2.0
85,105,55,85,50,115,495,0.9032258064516129,80,80,80,55,55,90,440,0.6417910447761194,1.0
60,59,85,79,105,36,424,0.16666666666666666,103,60,126,80,126,50,545,0.36363636363636365,0.5
105,130,120,45,45,40,485,0.4444444444444444,40,45,40,65,40,65,295,0.5661764705882353,2.0
45,20,50,60,120,50,345,0.24074074074074073,45,75,37,70,55,83,365,0.6183206106870229,2.0
95,80,105,40,70,100,490,0.8046875,50,100,150,100,150,50,600,0.37142857142857144,0.5
77,120,90,60,90,48,485,0.2785714285714286,72,95,67,103,71,122,530,0.9606299212598425,1.0
100,150,120,120,100,90,680,0.6493506493506493,80,82,78,95,80,85,500,0.6869565217391305,2.0
91,134,95,100,100,80,600,0.6304347826086957,75,98,63,98,63,101,498,0.8091603053435115,2.0
70,55,65,95,85,70,440,0.5307692307692308,60,40,60,40,60,35,295,0.18055555555555555,1.0
64,165,75,93,83,75,555,0.6587301587301587,60,67,85,77,75,116,480,0.8888888888888888,1.0
105,150,90,150,90,95,680,0.8285714285714286,89,145,90,105,80,91,600,0.8549618320610687,1.0
60,45,70,45,90,95,405,0.7304964539007093,49,66,70,44,55,51,335,0.4260869565217391,0.5
90,92,75,92,85,60,494,0.49586776859504134,100,100,100,100,100,100,600,0.8758169934640523,0.25
67,57,55,77,55,114,425,0.8879310344827587,64,88,50,88,50,106,446,0.9111111111111111,0.0
80,100,123,122,120,80,625,0.56,55,50,40,40,40,75,300,0.5945945945945946,1.0
85,105,85,40,50,40,405,0.211864406779661,50,65,85,35,35,55,325,0.32575757575757575,1.0
75,80,60,65,90,102,472,0.8625954198473282,40,30,30,40,50,30,220,0.07936507936507936,1.0
100,120,120,150,100,90,680,0.7880794701986755,85,60,65,135,105,100,550,0.7518248175182481,0.5
114,85,70,85,80,30,464,0.2066115702479339,58,64,58,80,65,80,405,0.5423728813559322,0.5
65,130,60,75,60,75,465,0.689922480620155,59,59,58,90,70,73,409,0.5826086956521739,1.0
76,147,90,60,70,97,540,0.8267716535433071,55,66,44,44,56,85,350,0.6888888888888889,1.0
100,150,120,120,100,90,680,0.6493506493506493,55,85,55,50,55,60,360,0.4233576642335766,1.0
80,160,60,170,130,80,680,0.6180555555555556,75,105,75,105,75,45,480,0.3274336283185841,1.0
50,70,160,70,160,90,600,0.7417218543046358,150,160,100,95,65,100,670,0.8866666666666667,1.0
60,50,70,80,80,140,480,0.8449612403100775,55,68,64,45,55,31,318,0.11666666666666667,0.5
41,56,40,62,44,71,314,0.568,40,45,35,30,40,55,245,0.3793103448275862,1.0
70,55,95,95,110,65,490,0.48872180451127817,40,20,30,40,80,55,265,0.22764227642276422,1.0
85,100,122,58,75,54,494,0.3939393939393939,70,70,40,60,40,60,340,0.4247787610619469,0.25
43,70,48,50,60,38,309,0.2391304347826087,83,106,65,86,65,85,490,0.6640625,0.5
55,66,44,44,56,85,350,0.6888888888888889,50,50,40,30,30,50,250,0.2781954887218045,1.0
100,123,75,57,75,80,510,0.6923076923076923,75,75,75,125,95,40,485,0.15671641791044777,1.0
100,120,120,150,100,90,680,0.7880794701986755,75,125,75,30,75,85,465,0.625,1.0
55,50,45,135,95,120,500,0.7714285714285715,90,100,60,90,60,80,480,0.6422764227642277,0.0
56,61,65,48,45,38,313,0.17567567567567569,50,65,107,105,107,86,520,0.7272727272727273,0.5
76,104,71,104,71,108,534,0.912751677852349,100,100,100,100,100,100,600,0.8758169934640523,2.0
70,90,70,60,60,70,420,0.6390977443609023,30,30,30,30,30,30,180,0.12612612612612611,1.0
63,60,55,50,50,71,349,0.5289256198347108,84,71,43,71,43,48,360,0.25874125874125875,1.0
91,134,95,100,100,80,600,0.6304347826086957,57,24,86,24,86,23,300,0.12727272727272726,0.25
85,105,100,79,83,78,530,0.5869565217391305,74,108,133,83,65,32,495,0.32142857142857145,1.0
91,90,129,90,72,108,580,0.9140625,70,92,65,80,55,98,460,0.8090909090909091,0.5
65,76,84,54,96,105,480,0.9008264462809917,95,100,85,108,70,70,528,0.5652173913043478,1.0
71,95,85,110,95,79,535,0.664,95,75,80,100,110,30,490,0.24242424242424243,0.5
44,38,39,61,79,42,303,0.2251655629139073,49,49,56,49,61,66,330,0.5190839694656488,1.0
65,45,55,45,70,45,325,0.24369747899159663,71,120,95,120,95,99,600,0.8203125,1.0
55,130,115,50,50,75,475,0.5982142857142857,60,48,45,43,90,42,328,0.21897810218978103,1.0
75,55,70,55,95,110,460,0.8444444444444444,40,50,90,30,55,65,330,0.44680851063829785,0.5
80,105,65,60,75,130,515,0.9645390070921985,60,50,40,85,75,95,405,0.7540983606557377,0.5
89,125,90,115,80,101,600,0.8725490196078431,75,87,63,87,63,98,473,0.865546218487395,0.0
40,35,30,20,20,50,195,0.23423423423423423,95,95,85,125,65,55,520,0.3894736842105263,8.0
44,38,39,61,79,42,303,0.2251655629139073,65,130,60,95,110,65,525,0.5303030303030303,0.5
70,60,125,115,70,55,495,0.35507246376811596,60,50,50,60,70,50,340,0.28346456692913385,0.25
60,45,70,75,85,55,390,0.3008130081300813,52,65,50,45,50,38,300,0.27419354838709675,0.0
60,45,50,90,80,70,395,0.625,1,90,45,30,30,40,236,0.33064516129032256,1.0
39,52,43,60,50,65,309,0.5041322314049587,50,65,85,35,35,55,325,0.32575757575757575,1.0
55,75,60,75,60,103,428,0.7982456140350878,85,56,77,50,77,78,423,0.53125,0.0
60,50,70,50,90,65,385,0.39568345323741005,60,150,50,150,50,60,520,0.5,0.0
108,112,118,68,72,47,525,0.2916666666666667,40,55,70,45,60,30,300,0.10619469026548672,2.0
60,82,45,45,45,74,351,0.5752212389380531,80,80,90,110,130,110,600,0.8721804511278195,2.0
79,105,70,145,80,101,580,0.8608695652173913,35,35,35,35,35,35,210,0.13385826771653545,2.0
85,76,64,45,55,90,415,0.6739130434782609,60,65,60,130,75,110,500,0.7719298245614035,0.0
100,50,80,60,80,50,420,0.34375,45,67,60,35,50,63,320,0.5128205128205128,0.5
75,103,80,70,80,92,500,0.7933884297520661,95,110,80,70,80,50,485,0.37209302325581395,1.0
85,73,70,73,115,67,483,0.5126050420168067,78,130,111,130,85,100,634,0.8561151079136691,1.0
50,70,50,50,50,40,310,0.16296296296296298,95,145,130,120,90,120,700,0.9398496240601504,0.5
105,95,75,85,75,74,509,0.5714285714285714,50,75,75,65,65,50,380,0.4049586776859504,1.0
150,160,100,95,65,100,670,0.8866666666666667,91,90,129,90,72,108,580,0.9140625,0.5
125,58,58,76,76,67,460,0.515625,78,81,71,74,69,126,499,0.9090909090909091,4.0
50,95,90,95,90,180,600,0.9172413793103448,95,117,80,65,70,92,519,0.8409090909090909,0.0
61,84,65,70,70,70,420,0.5,62,48,66,59,57,49,341,0.33884297520661155,0.0
60,60,60,35,35,30,280,0.11194029850746269,100,100,100,100,100,100,600,0.8805970149253731,1.0
58,70,45,40,45,42,300,0.25925925925925924,105,125,100,60,100,100,590,0.8359375,1.0
80,145,150,105,110,110,700,0.8692307692307693,115,115,85,90,75,100,580,0.8134328358208955,0.5
75,140,65,112,65,110,567,0.9140625,61,90,45,50,50,160,456,0.9230769230769231,8.0
100,103,75,120,75,127,600,0.940677966101695,100,100,125,110,50,50,535,0.384,1.0
41,64,45,50,50,50,300,0.36752136752136755,30,35,30,100,35,80,310,0.4765625,1.0
80,160,60,170,130,80,680,0.6180555555555556,41,50,37,50,37,66,281,0.5175438596491229,0.0
78,130,111,130,85,100,634,0.8561151079136691,75,90,90,140,90,115,600,0.9481481481481482,0.5
75,95,125,45,75,95,510,0.8257575757575758,69,55,45,55,55,15,294,0.11666666666666667,2.0
90,130,80,65,85,55,505,0.4396551724137931,89,124,80,55,80,55,483,0.5714285714285714,0.0
71,95,85,110,95,79,535,0.664,60,40,60,40,60,35,295,0.18055555555555555,2.0
55,65,95,95,45,85,440,0.6610169491525424,91,72,90,129,90,108,580,0.8925619834710744,0.5
70,77,60,97,60,108,472,0.8394160583941606,80,80,50,40,50,25,325,0.176056338028169,0.5
116,55,85,107,95,29,487,0.06818181818181818,50,180,20,180,20,150,600,0.9029850746268657,0.5
75,90,50,110,80,95,500,0.7985611510791367,70,40,50,55,50,25,290,0.061068702290076333,1.0
91,90,72,90,129,108,580,0.896,50,95,90,95,90,180,600,0.9172413793103448,0.5
83,80,75,70,70,101,479,0.8615384615384616,110,65,105,55,95,80,510,0.6258503401360545,1.0
80,120,130,55,65,45,495,0.37037037037037035,58,109,112,48,48,109,484,0.8805970149253731,1.0
80,100,70,60,70,95,475,0.7416666666666667,45,95,50,40,50,75,355,0.54,0.5
80,100,123,122,120,80,625,0.56,70,110,70,115,70,90,525,0.75,0.0
35,70,55,45,55,25,285,0.09420289855072464,55,66,44,44,56,85,350,0.6888888888888889,1.0
60,95,80,60,80,30,405,0.19480519480519481,80,120,79,95,79,70,523,0.5833333333333334,1.0
60,60,40,65,45,35,305,0.15833333333333333,44,75,35,63,33,45,295,0.2647058823529412,1.0
75,95,125,45,75,95,510,0.8257575757575758,75,95,122,58,75,69,494,0.5725806451612904,1.0
80,145,150,105,110,110,700,0.8692307692307693,45,35,45,62,53,35,275,0.11851851851851852,1.0
40,55,80,35,60,30,300,0.15037593984962405,58,89,77,45,45,48,362,0.3177570093457944,2.0
55,85,122,58,75,99,494,0.8099173553719008,105,105,75,65,100,50,500,0.37593984962406013,0.5
75,103,80,70,80,92,500,0.7933884297520661,60,60,60,35,35,30,280,0.11194029850746269,1.0
85,50,95,120,115,80,545,0.5793650793650794,90,120,100,150,120,100,680,0.7718120805369127,2.0
109,66,84,81,99,32,471,0.2013888888888889,50,120,53,35,110,87,455,0.640625,1.0
70,120,40,95,40,95,460,0.8106060606060606,70,80,102,80,102,40,474,0.2677165354330709,1.0
74,94,131,54,116,20,489,0.4485294117647059,45,67,60,35,50,63,320,0.5128205128205128,1.0
65,60,70,85,75,40,395,0.1796875,80,120,70,110,70,80,530,0.6422764227642277,1.0
45,65,34,40,34,45,263,0.2589928057553957,20,40,90,30,90,25,295,0.11363636363636363,1.0
50,45,45,35,35,50,260,0.23529411764705882,50,150,50,150,50,150,600,0.9339622641509434,1.0
79,115,70,125,80,111,580,0.864,60,60,60,35,35,30,280,0.11194029850746269,1.0
85,60,65,135,105,100,550,0.7518248175182481,75,100,110,45,55,65,450,0.5333333333333333,1.0
60,50,70,50,90,65,385,0.39568345323741005,65,125,100,60,70,70,490,0.6099290780141844,0.0
71,73,88,120,89,59,500,0.43537414965986393,100,77,77,128,128,90,600,0.6901408450704225,1.0
60,60,40,65,45,35,305,0.15833333333333333,60,50,100,85,70,65,430,0.47580645161290325,0.0
50,65,64,44,48,43,314,0.2196969696969697,70,70,70,70,70,70,420,0.5289256198347108,1.0
49,49,56,49,61,66,330,0.5190839694656488,78,65,68,112,154,75,552,0.628099173553719,1.0
40,35,30,120,70,105,400,0.6692307692307692,84,71,43,71,43,48,360,0.25874125874125875,1.0
103,60,126,80,126,50,545,0.36363636363636365,255,10,10,75,135,55,540,0.3125,1.0
130,65,60,110,95,65,525,0.5227272727272727,55,40,40,65,45,35,280,0.16428571428571428,1.0
50,105,79,35,110,76,455,0.6214285714285714,65,90,115,45,115,58,488,0.5041322314049587,2.0
78,65,68,112,154,75,552,0.628099173553719,90,110,80,100,80,95,555,0.7982456140350878,0.5
76,147,90,60,70,97,540,0.8267716535433071,50,50,40,30,30,50,250,0.2781954887218045,1.0
60,65,80,170,95,130,600,0.8625954198473282,106,130,90,110,154,90,680,0.719626168224299,1.0
55,66,44,44,56,85,350,0.6888888888888889,100,150,120,120,100,90,680,0.6493506493506493,1.0
45,60,32,50,32,76,295,0.5925925925925926,45,85,70,40,40,60,340,0.5229357798165137,1.0
100,100,90,150,140,90,670,0.71875,40,45,65,100,120,90,460,0.5588235294117647,1.0
65,65,60,130,95,110,525,0.823943661971831,79,103,120,135,115,78,630,0.5763888888888888,1.0
60,52,168,47,138,30,495,0.19834710743801653,75,95,95,95,95,85,540,0.6470588235294118,0.5
55,45,50,45,65,80,340,0.5546218487394958,106,110,90,154,90,130,680,0.926829268292683,1.0
75,80,85,110,90,50,490,0.3548387096774194,75,85,200,55,65,30,510,0.16778523489932887,0.0
90,95,95,70,90,70,510,0.5230769230769231,67,89,116,79,116,33,500,0.2624113475177305,1.0
85,80,70,135,75,90,535,0.7006802721088435,80,82,78,95,80,85,500,0.6869565217391305,1.0
45,49,49,65,65,45,318,0.2781954887218045,95,95,85,125,65,55,520,0.3894736842105263,1.0
40,40,40,70,40,20,250,0.032520325203252036,37,25,41,25,41,25,194,0.08870967741935484,2.0
75,90,90,140,90,115,600,0.9481481481481482,70,60,70,87,78,85,450,0.6228070175438597,2.0
50,85,55,65,65,90,410,0.7478260869565218,72,60,30,20,30,25,237,0.11570247933884298,1.0
60,70,105,70,120,75,500,0.5983606557377049,40,45,35,40,40,90,290,0.65,1.0
70,77,60,97,60,108,472,0.8394160583941606,45,60,32,50,32,76,295,0.5925925925925926,0.5
44,75,35,63,33,45,295,0.2647058823529412,90,93,55,70,55,55,418,0.3819444444444444,1.0
100,100,125,110,50,50,535,0.384,55,66,44,44,56,85,350,0.6888888888888889,1.0
95,135,80,110,80,100,600,0.8248175182481752,80,85,95,30,30,25,345,0.2857142857142857,0.5
65,63,45,45,45,45,308,0.2595419847328244,65,75,70,95,70,95,470,0.7272727272727273,1.0
95,117,80,65,70,92,519,0.8409090909090909,60,85,49,60,49,60,363,0.4444444444444444,2.0
50,72,35,35,35,65,292,0.5373134328358209,65,75,70,95,70,95,470,0.7272727272727273,0.0
60,80,95,70,85,50,440,0.2231404958677686,105,180,100,180,100,115,780,0.9477611940298507,1.0
45,65,34,40,34,45,263,0.2589928057553957,50,35,55,25,25,15,205,0.021739130434782608,1.0
35,65,35,65,35,65,300,0.46621621621621623,95,65,65,110,130,60,525,0.4016393442622951,1.0
65,90,115,45,115,58,488,0.5041322314049587,45,60,45,25,45,55,275,0.29,2.0
60,40,60,95,60,55,370,0.4222222222222222,65,90,122,58,75,84,494,0.71875,4.0
85,135,130,60,80,25,515,0.40540540540540543,109,66,84,81,99,32,471,0.2013888888888889,0.5
75,80,55,25,35,35,305,0.18666666666666668,65,90,65,61,61,100,442,0.8373983739837398,1.0
77,85,51,55,51,65,384,0.5163934426229508,35,65,35,65,35,65,300,0.46621621621621623,1.0
60,105,60,120,60,105,510,0.8849557522123894,75,80,85,110,90,50,490,0.3548387096774194,1.0
66,41,77,61,87,23,355,0.12096774193548387,75,55,70,55,95,110,460,0.8444444444444444,0.5
65,65,45,75,45,95,390,0.72,65,80,140,40,70,70,465,0.5223880597014925,0.125
85,115,80,105,80,50,515,0.3063063063063063,50,47,50,57,50,65,319,0.463768115942029,0.5
150,120,100,120,100,90,680,0.664179104477612,65,90,65,61,61,100,442,0.8373983739837398,0.0
70,55,65,95,85,70,440,0.5307692307692308,95,70,73,95,90,60,483,0.3983739837398374,1.0
60,60,60,105,105,105,495,0.848,78,65,68,112,154,75,552,0.628099173553719,1.0
50,65,90,35,35,15,290,0.14678899082568808,70,95,85,55,65,70,440,0.5,2.0
43,80,65,50,35,35,308,0.14193548387096774,91,129,90,72,90,108,580,0.8536585365853658,2.0
125,130,90,130,90,95,660,0.7734375,100,123,75,57,75,80,510,0.6923076923076923,2.0
60,105,60,120,60,105,510,0.8849557522123894,72,85,70,65,70,58,420,0.41304347826086957,0.5
35,35,35,35,35,35,210,0.13385826771653545,100,103,75,120,75,127,600,0.940677966101695,0.5
78,52,60,63,65,23,341,0.06015037593984962,42,52,67,39,56,50,306,0.2868217054263566,1.0
45,75,60,40,30,50,300,0.304,78,130,111,130,85,100,634,0.8561151079136691,2.0
30,45,55,70,55,85,340,0.5633802816901409,125,170,100,120,90,95,700,0.77,0.5
60,65,70,85,75,40,395,0.21705426356589147,59,74,50,35,50,35,303,0.3125,0.5
63,63,47,41,41,74,329,0.56,123,77,72,99,92,58,521,0.4621212121212121,0.5
65,60,70,85,75,40,395,0.1796875,65,80,65,35,65,60,370,0.38405797101449274,1.0
80,135,85,70,95,150,615,0.9844961240310077,60,85,69,60,69,77,420,0.518796992481203,1.0
40,30,30,55,30,85,270,0.4666666666666667,65,65,60,130,95,110,525,0.823943661971831,1.0
74,108,133,83,65,32,495,0.32142857142857145,70,92,65,80,55,98,460,0.8090909090909091,0.5
67,125,40,30,30,58,350,0.3431372549019608,90,70,80,70,95,70,475,0.5190839694656488,2.0
70,145,88,140,70,112,625,0.8888888888888888,78,81,71,74,69,126,499,0.9090909090909091,0.25
20,10,55,15,20,80,200,0.17985611510791366,60,85,40,30,45,68,328,0.6422018348623854,2.0
45,30,50,65,50,45,285,0.13821138211382114,62,77,62,50,42,65,358,0.4838709677419355,1.0
45,25,50,25,25,35,205,0.13076923076923078,40,29,45,29,45,36,224,0.14634146341463414,1.0
90,60,60,40,40,40,330,0.29545454545454547,80,105,105,105,105,80,580,0.5939849624060151,1.0
45,50,45,115,55,95,405,0.6936936936936937,35,35,35,35,35,35,210,0.13385826771653545,1.0
85,76,64,45,55,90,415,0.6739130434782609,20,40,15,35,35,60,205,0.34285714285714286,1.0
99,68,83,72,87,51,460,0.417910447761194,60,65,60,130,75,110,500,0.7719298245614035,0.5
90,110,80,100,80,95,555,0.7982456140350878,100,150,110,95,110,70,635,0.5923076923076923,0.5
35,55,35,30,30,35,220,0.23684210526315788,75,38,38,56,56,67,330,0.5263157894736842,1.0
50,35,55,25,25,15,205,0.05263157894736842,70,110,75,145,85,145,630,0.9444444444444444,2.0
105,95,80,40,80,90,490,0.753968253968254,100,123,75,57,75,80,510,0.6923076923076923,1.0
56,61,65,48,45,38,313,0.17567567567567569,41,64,45,50,50,50,300,0.36752136752136755,0.5
90,130,80,65,85,55,505,0.4396551724137931,70,75,80,135,80,135,575,0.917910447761194,1.0
70,55,65,95,85,70,440,0.5307692307692308,48,72,48,72,48,48,336,0.25984251968503935,0.5
55,75,60,75,60,103,428,0.7982456140350878,89,145,90,105,80,91,600,0.8549618320610687,0.0
70,150,140,65,100,75,600,0.55,95,155,109,70,130,81,640,0.6788321167883211,1.0
55,69,85,32,35,28,304,0.09302325581395349,79,100,80,110,90,121,580,0.968,2.0
50,70,100,40,40,30,330,0.2222222222222222,50,65,85,35,35,55,325,0.32575757575757575,4.0
92,105,90,125,90,98,600,0.8217054263565892,75,90,140,60,60,40,465,0.3008130081300813,0.5
50,150,50,150,50,150,600,0.9339622641509434,80,90,80,130,110,110,600,0.856,0.5
86,81,97,81,107,43,495,0.203125,123,100,62,97,81,68,531,0.4806201550387597,0.5
126,131,95,131,98,99,680,0.8102189781021898,55,50,45,135,95,120,500,0.7714285714285715,2.0
83,106,65,86,65,85,490,0.6640625,125,130,90,130,90,95,660,0.7734375,2.0
90,85,100,95,125,85,580,0.6834532374100719,60,80,50,40,40,30,300,0.15328467153284672,1.0
55,95,115,45,45,35,390,0.2116788321167883,75,140,65,112,65,110,567,0.9140625,0.0
120,120,120,120,120,120,720,0.9344262295081968,65,65,60,130,95,110,525,0.823943661971831,1.0
65,40,50,125,60,30,370,0.07258064516129033,95,117,80,65,70,92,519,0.8409090909090909,0.0
45,30,35,20,20,45,195,0.14782608695652175,70,110,180,60,60,50,530,0.4117647058823529,0.5
43,70,48,50,60,38,309,0.2391304347826087,90,75,85,115,90,55,510,0.3445378151260504,1.0
50,50,95,40,50,35,320,0.20279720279720279,90,65,65,40,40,15,315,0.19672131147540983,1.0
82,121,119,69,59,71,521,0.5394736842105263,83,106,65,86,65,85,490,0.6640625,0.5
89,125,90,115,80,101,600,0.8725490196078431,50,75,45,40,45,60,315,0.4380165289256198,1.0
65,63,45,45,45,45,308,0.2595419847328244,70,80,70,80,70,110,480,0.6594202898550725,2.0
130,70,35,70,35,60,400,0.4017857142857143,75,100,110,45,55,65,450,0.5333333333333333,2.0
79,100,80,110,90,121,580,0.968,50,150,50,150,50,150,600,0.9339622641509434,1.0
45,49,49,65,65,45,318,0.2781954887218045,70,120,65,45,85,125,510,0.9747899159663865,1.0
85,73,70,73,115,67,483,0.5126050420168067,80,80,90,110,130,110,600,0.8721804511278195,0.5
60,65,80,170,95,130,600,0.8625954198473282,100,150,140,100,90,90,670,0.7969924812030075,0.5
150,120,100,120,100,90,680,0.664179104477612,80,120,130,55,65,45,495,0.37037037037037035,1.0
49,49,56,49,61,66,330,0.5190839694656488,75,89,85,55,65,36,405,0.29545454545454547,0.5
65,80,80,59,63,58,405,0.4411764705882353,65,73,55,47,75,85,400,0.6846846846846847,1.0
68,85,65,165,135,100,618,0.8083333333333333,50,75,45,40,45,60,315,0.4380165289256198,1.0
35,70,55,45,55,25,285,0.09420289855072464,84,71,43,71,43,48,360,0.25874125874125875,1.0
65,150,60,115,60,115,565,0.935251798561151,55,66,44,44,56,85,350,0.6888888888888889,1.0
80,80,50,40,50,25,325,0.176056338028169,60,52,168,47,138,30,495,0.19834710743801653,0.0
38,36,38,32,36,57,237,0.3893805309734513,90,120,120,60,60,50,500,0.35294117647058826,1.0
79,85,60,55,60,71,410,0.60431654676259,40,40,55,40,70,55,300,0.40939597315436244,2.0
60,110,70,60,60,100,460,0.8461538461538461,50,50,77,95,77,91,440,0.5916666666666667,0.0
66,65,48,62,57,52,350,0.36220472440944884,78,92,75,74,63,118,500,0.8842975206611571,0.5
95,75,180,130,80,30,590,0.13793103448275862,80,185,115,40,105,75,600,0.6230769230769231,1.0
60,70,50,100,50,65,395,0.5217391304347826,75,95,60,65,60,115,470,0.8778625954198473,1.0
73,115,60,60,60,90,458,0.6694915254237288,80,110,120,130,90,70,600,0.6198347107438017,1.0
80,50,100,100,200,50,580,0.2357142857142857,60,45,70,45,90,95,405,0.7304964539007093,1.0
100,150,90,180,160,90,770,0.7348484848484849,80,80,50,40,50,25,325,0.176056338028169,1.0
75,95,122,58,75,69,494,0.5725806451612904,45,100,135,65,135,45,525,0.29411764705882354,2.0
65,47,55,73,75,85,400,0.65,50,35,55,25,25,15,205,0.05263157894736842,1.0
78,104,78,159,115,100,634,0.8444444444444444,72,60,30,20,30,25,237,0.11570247933884298,2.0
50,47,50,57,50,65,319,0.463768115942029,40,45,35,30,40,55,245,0.3793103448275862,0.5
65,100,70,80,80,105,500,0.8666666666666667,68,85,65,165,135,100,618,0.8083333333333333,1.0
65,75,90,97,123,44,494,0.1987179487179487,63,63,47,41,41,74,329,0.56,0.5
65,95,75,55,55,85,430,0.6933333333333334,60,85,60,85,60,55,405,0.3673469387755102,2.0
95,75,80,100,110,30,490,0.24242424242424243,30,45,135,45,90,30,375,0.09285714285714286,2.0
95,125,79,60,100,81,540,0.6165413533834586,60,55,145,75,150,40,525,0.2,0.5
66,41,77,61,87,23,355,0.12096774193548387,120,120,120,120,120,120,720,0.9344262295081968,1.0
65,95,100,60,50,50,420,0.34959349593495936,46,57,40,40,40,50,273,0.25,1.0
55,40,50,65,85,40,335,0.3181818181818182,80,130,100,160,120,110,700,0.8981481481481481,1.0
78,84,78,109,85,100,534,0.8646616541353384,75,98,63,98,63,101,498,0.889763779527559,0.5
44,58,44,58,44,61,309,0.41964285714285715,65,110,130,60,65,95,525,0.8278145695364238,2.0
55,75,50,40,40,80,340,0.6302521008403361,75,80,95,90,100,50,490,0.2158273381294964,2.0
105,180,100,180,100,115,780,0.9477611940298507,67,82,62,46,48,43,348,0.22033898305084745,2.0
50,70,100,40,40,30,330,0.2222222222222222,50,65,64,44,48,43,314,0.2196969696969697,0.5
60,100,85,80,85,100,510,0.7007874015748031,55,20,35,20,45,75,250,0.37681159420289856,2.0
55,40,85,80,105,40,405,0.23622047244094488,100,100,100,100,100,100,600,0.8602941176470589,2.0
90,85,100,95,125,85,580,0.6834532374100719,80,105,105,105,105,80,580,0.5939849624060151,1.0
45,75,60,40,30,50,300,0.304,55,85,55,50,55,60,360,0.4233576642335766,1.0
75,98,63,98,63,101,498,0.849624060150376,105,140,95,55,65,45,505,0.3,1.0
77,85,51,55,51,65,384,0.5163934426229508,65,80,65,35,65,60,370,0.38405797101449274,1.0
20,40,90,30,90,25,295,0.11363636363636363,70,130,100,55,80,65,500,0.608,1.0
100,100,100,100,100,100,600,0.8778625954198473,65,60,110,130,95,65,525,0.47761194029850745,2.0
75,75,55,105,85,30,425,0.1619718309859155,50,20,55,25,25,30,205,0.09774436090225563,0.5
126,131,95,131,98,99,680,0.8294573643410853,85,105,100,79,83,78,530,0.5869565217391305,1.0
100,90,130,45,65,55,485,0.4253731343283582,45,75,60,40,30,50,300,0.304,0.5
75,75,130,75,130,95,580,0.7479674796747967,70,105,105,50,40,20,390,0.33587786259541985,1.0
61,78,95,56,58,57,405,0.40336134453781514,55,45,43,55,43,72,313,0.5853658536585366,0.5
70,75,60,105,60,105,475,0.88,89,124,80,55,80,55,483,0.5714285714285714,0.0
59,45,40,35,40,31,250,0.14285714285714285,58,89,77,45,45,48,362,0.3177570093457944,0.5
80,120,79,95,79,70,523,0.5833333333333334,80,115,80,65,55,93,488,0.7846153846153846,2.0
55,85,55,50,55,60,360,0.4233576642335766,70,90,45,15,45,50,315,0.3629032258064516,0.25
60,40,60,40,60,35,295,0.18055555555555555,50,180,20,180,20,150,600,0.9029850746268657,1.0
38,35,35,65,55,50,278,0.2647058823529412,75,103,80,70,80,92,500,0.7933884297520661,1.0
60,100,85,80,85,100,510,0.7007874015748031,59,59,58,90,70,73,409,0.5826086956521739,1.0
50,35,55,25,25,15,205,0.021739130434782608,55,47,52,40,40,41,275,0.16806722689075632,0.5
40,55,70,45,60,30,300,0.10619469026548672,89,125,90,115,80,101,600,0.8725490196078431,1.0
74,100,72,90,72,46,454,0.24561403508771928,52,65,50,45,50,38,300,0.27419354838709675,0.5
52,65,50,45,50,38,300,0.27419354838709675,30,45,55,70,55,85,340,0.5633802816901409,1.0
105,150,90,150,90,95,680,0.8285714285714286,85,100,122,58,75,54,494,0.3939393939393939,2.0
76,147,90,60,70,97,540,0.8267716535433071,50,95,180,85,45,70,525,0.5298507462686567,1.0
55,70,55,40,55,85,360,0.7073170731707317,35,40,100,90,55,35,355,0.1796875,0.5
100,150,110,95,110,70,635,0.5923076923076923,30,45,135,45,90,30,375,0.09285714285714286,4.0
67,58,57,81,67,101,431,0.8790322580645161,40,20,30,40,80,55,265,0.22764227642276422,2.0
100,100,90,150,140,90,670,0.71875,70,62,67,55,55,56,365,0.38513513513513514,1.0
40,40,50,30,30,30,220,0.0873015873015873,45,65,34,40,34,45,263,0.2589928057553957,1.0
45,30,50,55,65,45,290,0.208,43,70,48,50,60,38,309,0.2391304347826087,1.0
40,45,35,30,40,55,245,0.3793103448275862,60,100,115,70,85,90,520,0.7557251908396947,0.0
45,63,37,65,55,95,360,0.8055555555555556,62,48,66,59,57,49,341,0.33884297520661155,1.0
92,105,90,125,90,98,600,0.8217054263565892,65,63,45,45,45,45,308,0.2595419847328244,1.0
72,105,115,54,86,68,500,0.5149253731343284,75,90,50,110,80,95,500,0.7985611510791367,4.0
103,60,86,60,86,50,445,0.3458646616541353,60,90,55,90,80,110,485,0.8677685950413223,1.0
30,30,42,30,42,70,244,0.4230769230769231,80,90,80,130,110,110,600,0.856,2.0
95,85,85,65,65,35,430,0.2571428571428571,60,82,45,45,45,74,351,0.5752212389380531,2.0
80,120,70,110,70,80,530,0.6422764227642277,125,58,58,76,76,67,460,0.515625,0.5
58,64,58,80,65,80,405,0.609271523178808,95,23,48,23,48,23,260,0.046153846153846156,1.0
50,25,28,45,55,15,218,0.0625,100,50,50,76,96,70,442,0.5,1.0
85,70,80,97,80,123,535,0.9304347826086956,40,40,40,70,40,20,250,0.032520325203252036,1.0
70,85,140,85,70,20,470,0.272,55,50,65,175,95,150,590,0.7818181818181819,1.0
110,80,90,95,90,65,530,0.5033557046979866,80,95,82,60,82,75,474,0.6,1.0
30,105,90,25,25,50,325,0.2773722627737226,76,48,48,57,62,34,325,0.11688311688311688,0.5
105,150,90,150,90,95,680,0.8285714285714286,60,80,110,50,80,45,425,0.2833333333333333,1.0
70,75,60,105,60,105,475,0.88,78,52,60,63,65,23,341,0.06015037593984962,1.0
60,82,45,45,45,74,351,0.5752212389380531,48,61,40,61,40,50,300,0.2543859649122807,1.0
69,55,45,55,55,15,294,0.11666666666666667,50,53,48,53,48,64,316,0.358974358974359,2.0
65,40,70,80,140,70,465,0.5954198473282443,75,75,95,75,95,113,528,0.9015151515151515,1.0
60,85,49,60,49,60,363,0.4444444444444444,70,70,70,70,70,70,420,0.5289256198347108,1.0
50,120,53,35,110,87,455,0.640625,70,43,53,43,53,40,302,0.19090909090909092,0.5
80,82,78,95,80,85,500,0.6869565217391305,55,55,85,65,85,35,380,0.2014388489208633,1.0
115,45,20,45,25,20,270,0.11538461538461539,50,95,90,95,90,180,600,0.9172413793103448,1.0
75,100,66,60,66,115,482,0.918918918918919,50,72,35,35,35,65,292,0.5373134328358209,1.0
65,110,130,60,65,95,525,0.8278145695364238,115,45,20,45,25,20,270,0.11538461538461539,1.0
100,180,160,150,90,90,770,0.7520661157024794,45,55,45,65,45,75,330,0.5692307692307692,0.0
60,75,85,100,85,115,520,0.8992248062015504,59,74,50,35,50,35,303,0.3125,4.0
40,50,90,30,55,65,330,0.44680851063829785,30,45,135,45,90,30,375,0.09285714285714286,0.5
80,125,75,40,95,85,500,0.6911764705882353,55,20,35,20,45,75,250,0.37681159420289856,2.0
91,90,106,130,106,77,600,0.648854961832061,40,45,35,30,40,55,245,0.3793103448275862,1.0
106,190,100,154,100,130,780,0.9259259259259259,45,25,50,25,25,35,205,0.13076923076923078,0.5
55,55,85,65,85,35,380,0.2014388489208633,90,110,80,100,80,95,555,0.7982456140350878,4.0
75,95,125,45,75,95,510,0.8257575757575758,110,80,90,95,90,65,530,0.5033557046979866,1.0
45,25,50,25,25,35,205,0.13076923076923078,55,20,35,20,45,75,250,0.37681159420289856,1.0
41,50,37,50,37,66,281,0.5175438596491229,75,90,140,60,60,40,465,0.3008130081300813,1.0
85,120,70,50,60,100,485,0.8308823529411765,100,77,77,128,128,90,600,0.6901408450704225,1.0
105,95,80,40,80,90,490,0.753968253968254,74,48,76,83,81,104,466,0.7322834645669292,1.0
84,86,88,111,101,60,530,0.4634146341463415,65,90,120,85,70,60,490,0.43410852713178294,1.0
60,40,80,60,45,40,325,0.23529411764705882,46,87,60,30,40,57,320,0.37777777777777777,0.5
83,80,80,135,80,121,579,0.9444444444444444,50,65,107,105,107,86,520,0.7313432835820896,1.0
70,84,70,65,70,51,410,0.2949640287769784,62,48,54,63,60,68,355,0.5178571428571429,1.0
60,55,145,75,150,40,525,0.2,91,72,90,129,90,108,580,0.8620689655172413,0.25
75,80,55,25,35,35,305,0.18666666666666668,90,95,95,70,90,70,510,0.5230769230769231,1.0
50,75,75,65,65,50,380,0.4049586776859504,60,48,45,43,90,42,328,0.21897810218978103,4.0
85,76,64,45,55,90,415,0.6739130434782609,65,50,35,115,95,95,455,0.7333333333333333,1.0
103,60,86,60,86,50,445,0.3458646616541353,70,110,180,60,60,50,530,0.4117647058823529,0.25
76,48,48,57,62,34,325,0.11688311688311688,72,60,30,20,30,25,237,0.11570247933884298,1.0
108,100,121,81,95,95,600,0.7476635514018691,110,85,95,80,95,50,515,0.2713178294573643,1.0
135,85,40,40,85,5,390,0.6864406779661016,64,66,68,81,76,50,405,0.25190839694656486,1.0
90,130,80,65,85,55,505,0.4396551724137931,65,90,65,61,61,100,442,0.8373983739837398,1.0
40,35,30,120,70,105,400,0.6692307692307692,60,100,115,70,85,90,520,0.7557251908396947,0.5
30,105,90,25,25,50,325,0.2773722627737226,64,66,68,81,76,50,405,0.25190839694656486,0.5
75,125,75,30,75,85,465,0.625,56,61,65,48,45,38,313,0.17567567567567569,1.0
110,135,60,50,65,88,508,0.7744360902255639,95,60,79,100,125,81,540,0.6201550387596899,0.5
70,140,230,60,80,50,630,0.32432432432432434,80,135,130,95,90,70,600,0.5181818181818182,0.5
38,30,85,55,65,30,303,0.21428571428571427,65,130,60,95,110,65,525,0.5303030303030303,1.0
65,75,70,95,70,95,470,0.7272727272727273,50,105,125,55,95,50,480,0.375886524822695,0.25
80,80,50,40,50,25,325,0.176056338028169,108,112,118,68,72,47,525,0.2916666666666667,0.5
45,55,39,35,39,42,255,0.18518518518518517,58,64,58,80,65,80,405,0.609271523178808,1.0
90,65,65,40,40,15,315,0.19672131147540983,40,30,35,45,40,55,245,0.31496062992125984,0.5
130,65,60,110,95,65,525,0.5227272727272727,74,94,131,54,116,20,489,0.4485294117647059,0.5
60,62,50,62,60,40,334,0.18181818181818182,40,55,30,30,30,85,270,0.688,1.0
95,125,79,60,100,81,540,0.6165413533834586,97,165,60,65,50,58,495,0.3902439024390244,1.0
74,108,133,83,65,32,495,0.32142857142857145,45,50,55,75,65,30,320,0.06293706293706294,0.5
69,69,76,69,86,91,460,0.6554621848739496,70,105,105,50,40,20,390,0.33587786259541985,2.0
75,100,95,40,70,110,490,0.8717948717948718,50,92,108,92,108,35,485,0.2457627118644068,0.0
78,65,68,112,154,75,552,0.628099173553719,50,20,55,25,25,30,205,0.09774436090225563,1.0
67,125,40,30,30,58,350,0.3431372549019608,85,115,80,105,80,50,515,0.3063063063063063,1.0
89,124,80,55,80,55,483,0.5714285714285714,55,85,122,58,75,99,494,0.8099173553719008,1.0
40,65,95,60,45,35,340,0.13986013986013987,58,70,45,40,45,42,300,0.25925925925925924,0.5
40,30,30,55,30,85,270,0.4666666666666667,50,60,60,60,60,30,320,0.11290322580645161,0.5
59,45,40,35,40,31,250,0.14285714285714285,85,80,70,135,75,90,535,0.7006802721088435,1.0
68,85,65,165,135,100,618,0.8083333333333333,60,65,80,170,95,130,600,0.8625954198473282,1.0
60,80,50,40,40,30,300,0.15328467153284672,70,120,100,145,105,20,560,0.2824427480916031,0.5
30,56,35,25,35,72,253,0.48148148148148145,100,50,80,60,80,50,420,0.34375,1.0
60,75,100,55,80,50,420,0.3088235294117647,65,95,57,100,85,93,495,0.7441860465116279,0.5
50,35,55,25,25,15,205,0.021739130434782608,84,71,43,71,43,48,360,0.25874125874125875,1.0
170,90,45,90,45,60,500,0.427536231884058,60,90,70,60,120,40,440,0.27419354838709675,1.0
75,140,65,112,65,110,567,0.9140625,123,77,72,99,92,58,521,0.4621212121212121,1.0
50,65,107,105,107,86,520,0.7313432835820896,60,69,95,69,95,36,424,0.2608695652173913,0.25
110,80,90,95,90,65,530,0.5033557046979866,75,98,63,98,63,101,498,0.8091603053435115,1.0
65,85,70,75,70,40,405,0.203125,90,120,100,150,120,100,680,0.7718120805369127,1.0
35,35,35,35,35,35,210,0.13385826771653545,60,90,70,60,120,40,440,0.27419354838709675,2.0
60,79,105,59,85,36,424,0.17054263565891473,75,70,90,70,105,80,490,0.656,0.0
100,103,75,120,75,127,600,0.940677966101695,74,100,72,90,72,46,454,0.24561403508771928,1.0
74,48,76,83,81,104,466,0.7322834645669292,55,75,60,75,60,103,428,0.7982456140350878,1.0
100,50,50,76,96,70,442,0.5,30,45,55,70,55,85,340,0.5633802816901409,1.0
45,67,60,35,50,63,320,0.5128205128205128,77,59,50,67,63,46,362,0.23140495867768596,2.0
50,20,40,20,40,20,190,0.0962962962962963,55,66,44,44,56,85,350,0.6888888888888889,1.0
41,50,37,50,37,66,281,0.5175438596491229,50,65,64,44,48,43,314,0.2196969696969697,1.0
123,77,72,99,92,58,521,0.4621212121212121,75,98,63,98,63,101,498,0.8091603053435115,2.0
95,117,184,44,46,28,514,0.2975206611570248,82,121,119,69,59,71,521,0.5394736842105263,2.0
75,98,63,98,63,101,498,0.849624060150376,80,80,90,110,130,110,600,0.8721804511278195,0.5
90,65,65,40,40,15,315,0.19672131147540983,100,100,125,110,50,50,535,0.384,0.5
80,45,65,90,110,80,470,0.5462962962962963,111,83,68,92,82,39,475,0.1774193548387097,2.0
45,90,20,65,20,65,305,0.5116279069767442,70,100,115,30,65,30,410,0.24390243902439024,2.0
70,45,48,60,65,35,323,0.15748031496062992,103,93,67,71,61,84,479,0.7142857142857143,1.0
81,102,77,85,75,85,505,0.5642857142857143,65,50,35,115,95,95,455,0.7333333333333333,1.0
40,55,30,30,30,60,245,0.43548387096774194,45,75,37,70,55,83,365,0.6183206106870229,1.0
70,120,40,95,40,95,460,0.8106060606060606,48,72,48,72,48,48,336,0.25984251968503935,2.0
40,65,40,80,40,65,330,0.5038167938931297,120,70,120,75,130,85,600,0.6694915254237288,2.0
70,140,230,60,80,50,630,0.32432432432432434,85,97,66,105,66,65,484,0.47107438016528924,0.5
100,70,70,65,65,45,415,0.1897810218978102,75,110,110,110,105,80,590,0.656934306569343,1.0
60,60,60,85,85,85,435,0.631578947368421,65,65,45,75,45,95,390,0.72,1.0
60,75,85,100,85,115,520,0.8992248062015504,40,65,95,60,45,35,340,0.13986013986013987,2.0
100,150,140,100,90,90,670,0.7969924812030075,61,78,95,56,58,57,405,0.40336134453781514,0.5
101,72,72,99,89,29,462,0.1937984496124031,80,100,200,50,100,50,580,0.3472222222222222,1.0
80,185,115,40,105,75,600,0.6230769230769231,45,100,45,45,45,10,290,0.2949640287769784,1.0
75,55,70,55,95,110,460,0.8444444444444444,74,48,76,83,81,104,466,0.7913043478260869,1.0
55,104,105,94,75,52,485,0.36363636363636365,40,65,40,80,40,65,330,0.5038167938931297,1.0
40,40,35,50,100,70,335,0.5031847133757962,80,70,70,90,100,70,480,0.5609756097560976,0.5
42,52,67,39,56,50,306,0.2868217054263566,50,70,50,50,50,40,310,0.16296296296296298,0.5
75,80,95,90,100,50,490,0.2158273381294964,85,120,70,50,60,100,485,0.8308823529411765,0.5
50,48,43,46,41,60,288,0.47297297297297297,40,55,70,45,60,30,300,0.10619469026548672,2.0
49,55,42,42,37,85,310,0.6068376068376068,106,150,70,194,120,140,780,0.952,1.0
58,109,112,48,48,109,484,0.8805970149253731,60,85,69,60,69,77,420,0.518796992481203,1.0
40,40,50,30,30,30,220,0.0873015873015873,75,125,230,55,95,30,610,0.3448275862068966,1.0
40,35,30,120,70,105,400,0.6692307692307692,60,80,95,70,85,50,440,0.2231404958677686,0.5
95,135,80,110,80,100,600,0.8248175182481752,95,75,80,100,110,30,490,0.24242424242424243,1.0
106,150,70,194,120,140,780,0.952,125,170,100,120,90,95,700,0.77,1.0
60,25,35,70,80,60,330,0.3076923076923077,86,92,88,68,75,73,482,0.6835443037974683,0.0
81,102,77,85,75,85,505,0.5642857142857143,60,65,80,170,95,130,600,0.8625954198473282,0.5
80,80,80,55,55,90,440,0.6417910447761194,110,65,105,55,95,80,510,0.6258503401360545,1.0
44,50,91,24,86,10,305,0.1981981981981982,65,75,70,95,70,95,470,0.7272727272727273,0.5
40,27,60,37,50,66,280,0.36220472440944884,55,65,35,60,30,85,330,0.6126126126126126,2.0
90,120,120,60,60,50,500,0.35294117647058826,60,50,40,85,75,95,405,0.7540983606557377,2.0
74,100,72,90,72,46,454,0.24561403508771928,65,150,60,115,60,115,565,0.935251798561151,1.0
250,5,5,35,105,50,450,0.15306122448979592,35,35,35,35,35,35,210,0.13385826771653545,1.0
125,120,90,170,100,95,700,0.78125,65,60,110,130,95,65,525,0.47761194029850745,0.5
75,90,90,140,90,115,600,0.9481481481481482,74,48,76,83,81,104,466,0.7322834645669292,2.0
50,85,85,55,55,50,380,0.3902439024390244,75,90,50,110,80,95,500,0.7985611510791367,0.5
40,80,35,35,45,70,305,0.4661016949152542,43,80,65,50,35,35,308,0.14193548387096774,1.0
100,150,140,100,90,90,670,0.7969924812030075,54,66,70,44,55,46,335,0.4214876033057851,0.5
65,125,60,95,60,105,510,0.9236641221374046,65,76,84,54,96,105,480,0.9008264462809917,2.0
60,50,100,85,70,65,430,0.47580645161290325,35,55,40,45,40,60,275,0.35714285714285715,0.5
40,50,45,70,45,70,320,0.5517241379310345,82,121,119,69,59,71,521,0.5394736842105263,0.5
50,50,40,30,30,50,250,0.2781954887218045,109,66,84,81,99,32,471,0.2013888888888889,4.0
48,61,40,61,40,50,300,0.2543859649122807,40,60,30,31,31,70,262,0.4492753623188406,1.0
60,75,100,55,80,50,420,0.3088235294117647,55,50,65,175,95,150,590,0.7818181818181819,0.5
65,95,75,55,55,85,430,0.6933333333333334,80,120,130,55,65,45,495,0.37037037037037035,1.0
170,90,45,90,45,60,500,0.427536231884058,95,117,80,65,70,92,519,0.8409090909090909,2.0
30,30,30,30,30,30,180,0.12612612612612611,70,100,70,105,75,40,460,0.23214285714285715,1.0
45,30,15,85,65,65,305,0.36220472440944884,58,64,58,80,65,80,405,0.609271523178808,0.5
45,75,60,40,30,50,300,0.304,106,130,90,110,154,90,680,0.719626168224299,1.0
70,75,60,105,60,105,475,0.88,25,35,70,95,55,45,325,0.16783216783216784,0.5
125,130,90,130,90,95,660,0.7734375,100,180,160,150,90,90,770,0.7520661157024794,1.0
50,64,50,45,50,41,300,0.22727272727272727,40,45,35,65,55,70,310,0.4482758620689655,0.5
60,110,70,60,60,100,460,0.8461538461538461,65,65,65,50,50,90,385,0.72,1.0
35,64,85,74,55,32,345,0.19827586206896552,65,130,60,75,60,75,465,0.689922480620155,1.0
100,120,120,150,100,90,680,0.7880794701986755,65,80,80,59,63,58,405,0.4411764705882353,0.5
55,85,122,58,75,99,494,0.8099173553719008,58,64,58,80,65,80,405,0.609271523178808,0.5
95,75,80,100,110,30,490,0.24242424242424243,70,100,70,105,75,40,460,0.23214285714285715,8.0
54,63,52,83,56,97,405,0.7697841726618705,89,125,90,115,80,101,600,0.8725490196078431,2.0
50,53,48,53,48,64,316,0.358974358974359,65,136,94,54,96,135,580,0.9612403100775194,1.0
74,48,76,83,81,104,466,0.7322834645669292,20,10,55,15,20,80,200,0.17985611510791366,1.0
74,48,76,83,81,104,466,0.7322834645669292,106,110,90,154,90,130,680,0.926829268292683,0.5
110,85,95,80,95,50,515,0.2713178294573643,78,84,78,109,85,100,534,0.8620689655172413,1.0
37,25,41,25,41,25,194,0.08870967741935484,40,55,30,30,30,60,245,0.43548387096774194,0.5
45,60,30,80,50,65,330,0.4603174603174603,64,165,75,93,83,75,555,0.6587301587301587,2.0
50,75,70,35,70,48,348,0.29357798165137616,60,85,49,60,49,60,363,0.4444444444444444,1.0
95,135,80,110,80,100,600,0.8248175182481752,60,50,70,80,80,140,480,0.8449612403100775,0.5
45,53,70,40,60,42,310,0.25735294117647056,108,170,115,120,95,92,700,0.7083333333333334,1.0
105,150,90,150,90,95,680,0.8285714285714286,108,112,118,68,72,47,525,0.2916666666666667,1.0
50,70,50,50,50,70,340,0.5645161290322581,97,165,60,65,50,58,495,0.3902439024390244,2.0
50,70,100,40,40,30,330,0.2222222222222222,30,40,55,40,55,60,280,0.3237410071942446,0.5
59,74,50,35,50,35,303,0.3125,50,160,110,160,110,110,700,0.8854961832061069,2.0
70,120,65,45,85,125,510,0.9747899159663865,61,72,57,55,55,65,365,0.3984375,1.0
38,30,41,30,41,60,240,0.2897196261682243,60,60,60,105,105,105,495,0.848,0.0
80,160,80,130,80,100,630,0.8455284552845529,95,110,80,70,80,50,485,0.37209302325581395,4.0
100,5,5,15,65,30,220,0.07692307692307693,90,92,75,92,85,60,494,0.49586776859504134,1.0
62,55,52,109,94,109,481,0.7833333333333333,60,60,40,65,45,35,305,0.15833333333333333,0.0
40,55,30,30,30,85,270,0.688,55,70,55,40,55,85,360,0.7073170731707317,1.0
95,60,79,100,125,81,540,0.6201550387596899,85,90,80,70,80,130,535,0.9262295081967213,1.0
95,23,48,23,48,23,260,0.046153846153846156,95,125,79,60,100,81,540,0.6165413533834586,1.0
95,110,80,70,80,50,485,0.37209302325581395,95,145,130,120,90,120,700,0.9398496240601504,4.0
85,105,100,79,83,78,530,0.5869565217391305,49,55,42,42,37,85,310,0.6068376068376068,1.0
116,55,85,107,95,29,487,0.06818181818181818,50,40,85,40,65,25,305,0.08870967741935484,1.0
60,50,70,50,90,65,385,0.39568345323741005,60,130,80,60,60,70,460,0.5153846153846153,2.0
72,85,70,65,70,58,420,0.41304347826086957,60,90,55,90,80,110,485,0.8677685950413223,1.0
55,69,85,32,35,28,304,0.09302325581395349,100,50,80,60,80,50,420,0.34375,0.5
80,95,82,60,82,75,474,0.6,80,120,130,55,65,45,495,0.37037037037037035,0.25
45,50,43,40,38,62,278,0.40441176470588236,50,50,77,95,77,91,440,0.5916666666666667,0.0
100,100,100,100,100,100,600,0.8602941176470589,50,35,55,25,25,15,205,0.05263157894736842,0.5
89,124,80,55,80,55,483,0.5714285714285714,90,100,60,90,60,80,480,0.6422764227642277,0.25
72,105,115,54,86,68,500,0.5149253731343284,70,94,50,94,50,66,424,0.48148148148148145,4.0
106,110,90,154,90,130,680,0.926829268292683,56,61,65,48,45,38,313,0.17567567567567569,1.0
38,30,41,30,41,60,240,0.2897196261682243,60,70,50,100,50,65,395,0.5217391304347826,1.0
40,60,40,40,40,30,250,0.0948905109489051,65,90,122,58,75,84,494,0.71875,1.0
60,55,50,40,55,45,305,0.22377622377622378,45,55,39,35,39,42,255,0.18518518518518517,1.0
45,60,40,70,50,45,310,0.2846715328467153,60,62,80,63,80,60,405,0.4336283185840708,2.0
50,60,60,60,60,30,320,0.11290322580645161,50,50,40,30,30,50,250,0.2781954887218045,1.0
55,85,55,50,55,60,360,0.4233576642335766,72,60,30,20,30,25,237,0.11570247933884298,0.5
20,40,90,30,90,25,295,0.11363636363636363,60,60,50,40,50,75,335,0.5882352941176471,0.0
58,89,77,45,45,48,362,0.3177570093457944,55,69,85,32,35,28,304,0.09302325581395349,2.0
30,30,30,30,30,30,180,0.12612612612612611,45,75,37,70,55,83,365,0.6183206106870229,0.5
20,15,20,10,55,80,200,0.2682926829268293,77,85,51,55,51,65,384,0.5163934426229508,1.0
75,69,72,114,100,104,534,0.8253968253968254,70,70,70,70,70,70,420,0.5289256198347108,1.0
50,80,95,10,45,10,290,0.232,90,90,85,125,90,100,580,0.768595041322314,2.0
40,50,45,70,45,70,320,0.5517241379310345,105,140,55,30,55,95,480,0.8195488721804511,1.0
55,84,105,114,75,52,485,0.2890625,78,92,75,74,63,118,500,0.8842975206611571,1.0
130,70,35,70,35,60,400,0.4017857142857143,35,55,35,30,30,35,220,0.23684210526315788,1.0
110,123,65,100,65,65,528,0.5217391304347826,75,87,63,87,63,98,473,0.865546218487395,0.25
105,105,75,65,100,50,500,0.37593984962406013,75,80,55,25,35,35,305,0.18666666666666668,1.0
58,89,77,45,45,48,362,0.3177570093457944,50,105,79,35,110,76,455,0.6214285714285714,0.5
50,70,160,70,160,90,600,0.7417218543046358,95,75,110,100,80,30,490,0.15267175572519084,0.5
80,75,150,75,150,50,580,0.30973451327433627,60,70,105,70,120,75,500,0.5983606557377049,1.0
75,65,55,65,55,69,384,0.43548387096774194,76,65,45,92,42,91,411,0.7449664429530202,0.0
60,50,100,85,70,65,430,0.47580645161290325,50,53,48,53,48,64,316,0.46153846153846156,2.0
65,80,65,35,65,60,370,0.38405797101449274,86,92,88,68,75,73,482,0.6835443037974683,1.0
50,92,108,92,108,35,485,0.2457627118644068,35,60,44,40,54,55,288,0.366412213740458,1.0
67,89,116,79,116,33,500,0.2624113475177305,65,65,45,75,45,95,390,0.72,1.0
50,72,35,35,35,65,292,0.5373134328358209,50,55,50,36,30,43,264,0.2922077922077922,0.0
90,50,34,60,44,70,348,0.6283185840707964,70,60,125,115,70,55,495,0.35507246376811596,0.5
95,110,80,70,80,50,485,0.37209302325581395,80,82,83,100,100,80,525,0.6742424242424242,2.0
103,60,126,80,126,50,545,0.36363636363636365,60,59,85,79,105,36,424,0.16666666666666666,1.0
10,55,25,35,45,95,265,0.5396825396825397,75,125,70,125,70,115,580,0.9037037037037037,1.0
71,73,88,120,89,59,500,0.43537414965986393,75,80,85,110,90,50,490,0.3548387096774194,0.5
44,58,44,58,44,61,309,0.41964285714285715,40,50,90,30,55,65,330,0.44680851063829785,2.0
106,110,90,154,90,130,680,0.926829268292683,70,77,60,97,60,108,472,0.8394160583941606,1.0
60,85,60,85,60,55,405,0.3673469387755102,55,70,45,70,50,60,350,0.45,0.5
50,65,85,35,35,55,325,0.32575757575757575,130,65,60,110,95,65,525,0.5227272727272727,1.0
50,50,40,50,40,64,294,0.45588235294117646,75,140,65,112,65,110,567,0.9140625,2.0
50,65,107,105,107,86,520,0.703125,65,45,55,45,70,45,325,0.24369747899159663,1.0
80,82,100,83,100,80,525,0.6821705426356589,55,70,40,60,40,40,305,0.26956521739130435,1.0
70,120,100,145,105,20,560,0.2824427480916031,85,110,76,65,82,56,474,0.3933333333333333,1.0
75,125,100,70,80,45,495,0.33035714285714285,65,95,75,55,55,85,430,0.6933333333333334,0.5
55,95,55,35,75,115,430,0.9380530973451328,48,72,48,72,48,48,336,0.25984251968503935,2.0
90,110,80,100,80,95,555,0.7982456140350878,40,45,40,65,40,65,295,0.5661764705882353,1.0
60,48,45,43,90,42,328,0.21897810218978103,62,48,54,63,60,68,355,0.5178571428571429,0.5
60,75,100,55,80,50,420,0.3088235294117647,50,95,95,35,110,70,455,0.5179856115107914,1.0
55,95,115,45,45,35,390,0.2116788321167883,100,100,100,100,100,100,600,0.8345864661654135,0.5
35,46,34,35,45,20,215,0.072,76,147,90,60,70,97,540,0.8267716535433071,1.0
80,110,60,150,130,70,600,0.5042016806722689,59,66,70,44,55,41,335,0.25190839694656486,2.0
99,68,83,72,87,51,460,0.417910447761194,72,85,70,65,70,58,420,0.41304347826086957,0.5
80,120,130,55,65,45,495,0.37037037037037035,91,134,95,100,100,80,600,0.6304347826086957,0.0
70,90,45,15,45,50,315,0.3629032258064516,65,47,55,73,75,85,400,0.65,2.0
55,75,85,25,25,15,280,0.1875,50,65,90,35,35,15,290,0.14678899082568808,2.0
75,95,95,95,95,85,540,0.6470588235294118,65,125,60,95,60,105,510,0.9236641221374046,1.0
50,20,40,20,40,20,190,0.0962962962962963,55,47,52,40,40,41,275,0.16806722689075632,0.5
45,25,50,25,25,35,205,0.13076923076923078,109,66,84,81,99,32,471,0.2013888888888889,0.5
50,75,45,40,45,60,315,0.4380165289256198,50,120,53,35,110,87,455,0.640625,0.5
53,51,53,61,56,40,314,0.14285714285714285,80,115,80,65,55,93,488,0.7846153846153846,1.0
58,70,45,40,45,42,300,0.25925925925925924,35,35,40,35,55,50,250,0.40336134453781514,0.0
59,66,70,44,55,41,335,0.25190839694656486,70,100,70,105,75,40,460,0.23214285714285715,1.0
44,75,35,63,33,45,295,0.2647058823529412,50,52,48,65,50,55,320,0.33098591549295775,1.0
50,105,125,55,95,50,480,0.375886524822695,64,51,23,51,23,28,240,0.11363636363636363,1.0
60,85,49,60,49,60,363,0.4444444444444444,65,95,57,100,85,93,495,0.7441860465116279,1.0
80,70,40,100,60,145,495,0.921875,50,85,85,55,55,50,380,0.3902439024390244,0.25
70,75,80,135,80,135,575,0.917910447761194,70,90,70,60,60,70,420,0.6390977443609023,1.0
70,60,75,110,75,90,480,0.7165354330708661,55,85,55,50,55,60,360,0.4233576642335766,0.25
100,70,70,65,65,45,415,0.1897810218978102,79,103,120,135,115,78,630,0.5763888888888888,1.0
65,90,40,45,80,75,395,0.625,90,75,75,90,100,70,500,0.5462184873949579,1.0
111,83,68,92,82,39,475,0.1774193548387097,45,60,32,50,32,76,295,0.5925925925925926,2.0
35,80,50,50,70,120,405,0.84375,80,45,65,90,110,80,470,0.5462962962962963,1.0
50,70,100,40,40,30,330,0.2222222222222222,50,65,64,44,48,43,314,0.2196969696969697,0.5
60,80,50,40,40,30,300,0.15328467153284672,30,45,55,70,55,85,340,0.5633802816901409,1.0
65,63,45,45,45,45,308,0.2595419847328244,60,70,65,125,105,90,515,0.6911764705882353,2.0
50,85,85,55,55,50,380,0.3902439024390244,55,40,40,65,45,35,280,0.16428571428571428,0.5
60,60,50,40,50,75,335,0.5882352941176471,65,65,60,130,95,110,525,0.823943661971831,1.0
40,55,99,40,79,47,360,0.26262626262626265,60,69,95,69,95,36,424,0.2608695652173913,0.0
75,80,60,65,90,102,472,0.8625954198473282,60,55,90,145,90,80,520,0.6071428571428571,0.0
80,135,130,95,90,70,600,0.5181818181818182,106,190,100,154,100,130,780,0.9259259259259259,0.5
50,47,50,57,50,65,319,0.463768115942029,45,75,37,70,55,83,365,0.6183206106870229,0.5
70,84,70,65,70,51,410,0.2949640287769784,85,80,90,105,95,60,515,0.49074074074074076,1.0
60,45,70,45,90,95,405,0.7304964539007093,65,80,65,35,65,60,370,0.38405797101449274,1.0
65,100,70,80,80,105,500,0.8666666666666667,60,50,70,50,90,65,385,0.39568345323741005,2.0
45,53,70,40,60,42,310,0.25735294117647056,95,135,80,110,80,100,600,0.8248175182481752,0.125
45,49,65,49,65,45,318,0.275,65,60,70,85,75,40,395,0.1796875,1.0
50,53,62,58,63,44,330,0.13709677419354838,75,65,55,65,55,69,384,0.43548387096774194,1.0
60,50,70,50,90,65,385,0.39568345323741005,65,65,60,110,95,130,525,0.9253731343283582,1.0
20,15,20,10,55,80,200,0.2682926829268293,50,70,50,50,50,70,340,0.5645161290322581,1.0
60,75,100,55,80,50,420,0.3088235294117647,106,190,100,154,100,130,780,0.9259259259259259,0.5
90,120,75,60,60,45,450,0.29411764705882354,50,53,48,53,48,64,316,0.46153846153846156,0.5
45,49,49,65,65,45,318,0.2781954887218045,60,75,85,100,85,115,520,0.8992248062015504,2.0
45,75,37,70,55,83,365,0.6183206106870229,80,45,65,90,110,80,470,0.5462962962962963,1.0
150,160,100,95,65,100,670,0.8866666666666667,73,76,75,81,100,100,505,0.8110236220472441,1.0
65,60,110,130,95,65,525,0.47761194029850745,80,50,100,100,200,50,580,0.2357142857142857,0.5
50,150,50,150,50,150,600,0.9339622641509434,40,40,35,50,100,70,335,0.5031847133757962,2.0
115,115,85,90,75,100,580,0.8134328358208955,80,45,65,90,110,80,470,0.5462962962962963,1.0
70,90,110,60,75,95,500,0.7333333333333333,40,80,35,35,45,70,305,0.4661016949152542,0.5
100,73,83,73,83,55,467,0.371900826446281,48,61,40,61,40,50,300,0.2543859649122807,0.5
60,67,85,77,75,116,480,0.8888888888888888,30,40,70,70,25,60,295,0.41353383458646614,2.0
40,40,35,50,100,70,335,0.5031847133757962,52,65,55,58,62,60,352,0.4482758620689655,1.0
100,120,120,150,100,90,680,0.7880794701986755,74,108,133,83,65,32,495,0.32142857142857145,1.0
72,85,70,65,70,58,420,0.41304347826086957,79,103,120,135,115,78,630,0.5763888888888888,1.0
90,92,75,92,85,60,494,0.49586776859504134,70,80,50,35,35,35,305,0.14,1.0
71,95,85,110,95,79,535,0.664,100,180,160,150,90,90,770,0.7520661157024794,1.0
65,95,75,55,55,85,430,0.6933333333333334,105,30,105,140,105,55,540,0.3524590163934426,2.0
91,129,90,72,90,108,580,0.8536585365853658,120,120,120,120,120,120,720,0.9344262295081968,2.0
108,170,115,120,95,92,700,0.7083333333333334,150,160,100,95,65,100,670,0.8866666666666667,1.0
83,106,65,86,65,85,490,0.6640625,70,70,115,130,90,60,535,0.5338983050847458,0.0
78,70,61,50,61,100,420,0.8145161290322581,120,70,120,75,130,85,600,0.6694915254237288,1.0
53,51,53,61,56,40,314,0.14285714285714285,45,53,70,40,60,42,310,0.25735294117647056,0.5
50,85,55,65,65,90,410,0.7478260869565218,38,35,40,27,25,35,200,0.08208955223880597,2.0
40,30,30,40,50,30,220,0.07936507936507936,38,35,35,65,55,50,278,0.2647058823529412,1.0
55,81,60,50,70,97,413,0.7214285714285714,64,78,52,78,52,81,405,0.6422764227642277,1.0
80,100,70,50,60,45,405,0.25806451612903225,68,72,78,38,42,32,330,0.23809523809523808,1.0
60,150,50,150,50,60,520,0.5,255,10,10,75,135,55,540,0.3125,0.0
86,68,72,109,66,106,507,0.8099173553719008,50,65,90,35,35,15,290,0.14678899082568808,2.0
80,105,65,60,75,130,515,0.9645390070921985,65,70,60,65,65,115,440,0.8583333333333333,1.0
50,20,40,20,40,20,190,0.0962962962962963,60,100,89,55,69,112,485,0.9298245614035088,0.5
45,60,30,80,50,65,330,0.4603174603174603,91,90,106,130,106,77,600,0.648854961832061,1.0
60,67,85,77,75,116,480,0.8888888888888888,85,56,77,50,77,78,423,0.53125,2.0
46,87,60,30,40,57,320,0.37777777777777777,42,52,67,39,56,50,306,0.2868217054263566,1.0
80,70,70,90,100,70,480,0.5609756097560976,75,95,95,95,95,85,540,0.6470588235294118,0.25
83,80,75,70,70,101,479,0.8615384615384616,70,95,125,65,75,45,475,0.33613445378151263,0.5
30,40,70,70,25,60,295,0.41353383458646614,130,65,60,110,95,65,525,0.5227272727272727,0.5
95,60,79,100,125,81,540,0.6201550387596899,70,43,53,43,53,40,302,0.19090909090909092,1.0
70,45,48,60,65,35,323,0.15748031496062992,60,85,42,85,42,91,405,0.8227848101265823,2.0
83,106,65,86,65,85,490,0.6640625,78,52,60,63,65,23,341,0.06015037593984962,1.0
70,60,75,110,75,90,480,0.7165354330708661,50,85,85,55,55,50,380,0.3902439024390244,0.5
95,110,80,70,80,50,485,0.37209302325581395,54,63,52,83,56,97,405,0.7697841726618705,0.5
110,123,65,100,65,65,528,0.5217391304347826,70,55,95,95,110,65,490,0.48872180451127817,0.5
60,60,75,60,75,80,410,0.7321428571428571,70,85,140,85,70,20,470,0.272,1.0
40,45,40,65,40,65,295,0.5661764705882353,40,45,40,35,35,56,251,0.373015873015873,2.0
90,50,34,60,44,70,348,0.6283185840707964,61,78,95,56,58,57,405,0.40336134453781514,2.0
50,53,62,58,63,44,330,0.13709677419354838,78,65,68,112,154,75,552,0.628099173553719,1.0
85,110,90,45,90,80,500,0.6206896551724138,80,85,95,30,30,25,345,0.2857142857142857,0.5
95,117,80,65,70,92,519,0.8409090909090909,45,35,50,70,50,30,280,0.15753424657534246,0.5
70,85,70,60,70,50,405,0.28378378378378377,55,104,105,94,75,52,485,0.36363636363636365,0.5
44,58,44,58,44,61,309,0.41964285714285715,100,75,115,90,115,85,580,0.6446280991735537,0.5
50,50,40,30,30,50,250,0.2781954887218045,60,67,85,77,75,116,480,0.8888888888888888,1.0
60,85,42,85,42,91,405,0.8227848101265823,86,92,88,68,75,73,482,0.6835443037974683,1.0
75,85,200,55,65,30,510,0.16778523489932887,30,30,30,30,30,30,180,0.12612612612612611,0.5
78,70,61,50,61,100,420,0.8145161290322581,70,145,88,140,70,112,625,0.8888888888888888,0.5
85,90,80,70,80,130,535,0.9262295081967213,135,85,40,40,85,5,390,0.6864406779661016,1.0
55,65,95,95,45,85,440,0.6610169491525424,60,40,50,75,85,95,405,0.6044776119402985,1.0
54,66,70,44,55,46,335,0.4214876033057851,65,60,110,130,95,65,525,0.47761194029850745,1.0
85,115,80,105,80,50,515,0.3063063063063063,100,103,75,120,75,127,600,0.940677966101695,1.0
45,60,40,70,50,45,310,0.2846715328467153,60,60,60,35,35,30,280,0.11194029850746269,1.0
77,120,90,60,90,48,485,0.2785714285714286,78,65,68,112,154,75,552,0.628099173553719,0.0
68,165,95,65,115,110,618,0.8615384615384616,90,65,65,40,40,15,315,0.19672131147540983,0.25
105,105,75,65,100,50,500,0.37593984962406013,35,80,50,50,70,120,405,0.84375,0.5
71,95,85,110,95,79,535,0.664,56,61,65,48,45,38,313,0.17567567567567569,2.0
75,87,63,87,63,98,473,0.865546218487395,60,90,55,90,80,110,485,0.8677685950413223,0.5
105,95,80,40,80,90,490,0.753968253968254,90,95,95,70,90,70,510,0.5230769230769231,1.0
106,130,90,110,154,90,680,0.719626168224299,45,53,70,40,60,42,310,0.25735294117647056,16.0
85,120,70,50,60,100,485,0.8308823529411765,50,50,40,50,40,64,294,0.45588235294117646,1.0
55,45,50,45,65,80,340,0.5546218487394958,75,85,200,55,65,30,510,0.16778523489932887,0.5
50,60,60,60,60,30,320,0.11290322580645161,30,40,70,70,25,60,295,0.41353383458646614,0.5
50,85,125,85,115,20,480,0.4306569343065693,59,110,150,45,49,35,448,0.3333333333333333,4.0
20,10,55,15,20,80,200,0.17985611510791366,60,85,60,85,60,55,405,0.3673469387755102,2.0
54,45,47,75,98,52,371,0.39669421487603307,60,115,105,65,70,80,495,0.7181818181818181,1.0
35,65,35,65,35,65,300,0.46621621621621623,50,45,45,35,35,50,260,0.23529411764705882,1.0
75,87,63,87,63,98,473,0.865546218487395,45,90,20,65,20,65,305,0.5116279069767442,0.5
60,62,50,62,60,40,334,0.18181818181818182,86,81,97,81,107,43,495,0.203125,2.0
75,75,75,125,95,40,485,0.15671641791044777,100,100,100,100,100,100,600,0.8778625954198473,0.5
68,65,65,125,115,80,518,0.6461538461538462,40,60,40,40,40,30,250,0.0948905109489051,1.0
78,104,78,159,115,100,634,0.8444444444444444,125,120,90,170,100,95,700,0.78125,1.0
65,85,70,75,70,40,405,0.203125,100,150,120,120,100,90,680,0.6493506493506493,0.25
170,90,45,90,45,60,500,0.427536231884058,60,70,105,70,120,75,500,0.5983606557377049,2.0
50,50,77,95,77,91,440,0.5916666666666667,100,100,125,110,50,50,535,0.384,0.5
80,80,80,55,55,90,440,0.6417910447761194,59,45,40,35,40,31,250,0.14285714285714285,1.0
123,77,72,99,92,58,521,0.4621212121212121,74,108,133,83,65,32,495,0.32142857142857145,0.5
83,80,80,135,80,121,579,0.9444444444444444,40,35,30,20,20,50,195,0.23423423423423423,2.0
109,66,84,81,99,32,471,0.2013888888888889,30,30,30,30,30,30,180,0.12612612612612611,0.25
86,92,88,68,75,73,482,0.6835443037974683,255,10,10,75,135,55,540,0.3125,1.0
78,65,68,112,154,75,552,0.628099173553719,50,53,62,58,63,44,330,0.13709677419354838,1.0
100,164,150,95,120,71,700,0.5645161290322581,108,130,95,80,85,102,600,0.7637795275590551,0.5
105,150,90,150,90,95,680,0.8285714285714286,50,85,85,55,55,50,380,0.3902439024390244,0.0
50,20,40,20,40,20,190,0.0962962962962963,50,65,107,105,107,86,520,0.7313432835820896,1.0
80,80,80,55,55,90,440,0.6417910447761194,50,50,40,50,40,64,294,0.45588235294117646,1.0
60,50,70,80,80,140,480,0.8449612403100775,82,121,119,69,59,71,521,0.5394736842105263,0.5
70,55,95,95,110,65,490,0.48872180451127817,45,60,45,25,45,55,275,0.29,1.0
59,45,40,35,40,31,250,0.14285714285714285,80,82,100,83,100,80,525,0.6821705426356589,1.0
82,80,86,85,75,72,480,0.6183206106870229,45,25,50,25,25,35,205,0.13076923076923078,0.5
55,70,40,60,40,40,305,0.26956521739130435,78,92,75,74,63,118,500,0.8842975206611571,2.0
60,50,40,85,75,95,405,0.7540983606557377,70,60,62,80,82,60,414,0.4375,2.0
62,50,58,73,54,72,369,0.4435483870967742,68,85,65,165,135,100,618,0.8083333333333333,1.0
85,100,122,58,75,54,494,0.3939393939393939,60,85,40,30,45,68,328,0.6422018348623854,2.0
40,45,40,65,40,65,295,0.5661764705882353,90,100,70,110,150,80,600,0.6037735849056604,0.5
50,95,180,85,45,70,525,0.5298507462686567,50,20,55,25,25,30,205,0.09774436090225563,1.0
60,95,80,60,80,30,405,0.19480519480519481,70,140,70,110,65,105,560,0.95,4.0
70,65,60,90,75,90,450,0.6571428571428571,255,10,10,75,135,55,540,0.3125,1.0
65,63,45,45,45,45,308,0.2595419847328244,72,58,80,103,80,97,490,0.7171052631578947,1.0
50,25,28,45,55,15,218,0.0625,100,120,120,150,100,90,680,0.7880794701986755,1.0
115,115,85,90,75,100,580,0.8134328358208955,50,65,107,105,107,86,520,0.7272727272727273,1.0
49,49,56,49,61,66,330,0.5190839694656488,95,155,109,70,130,81,640,0.6788321167883211,0.5
52,65,50,45,50,38,300,0.27419354838709675,80,50,100,100,200,50,580,0.2357142857142857,1.0
68,85,65,165,135,100,618,0.8083333333333333,90,65,65,40,40,15,315,0.19672131147540983,0.5
123,77,72,99,92,58,521,0.4621212121212121,85,110,90,45,90,80,500,0.6206896551724138,1.0
105,30,105,140,105,55,540,0.3524590163934426,40,35,30,120,70,105,400,0.6692307692307692,0.5
105,95,80,40,80,90,490,0.753968253968254,100,123,75,57,75,80,510,0.6923076923076923,1.0
91,90,129,90,72,108,580,0.9140625,80,110,120,130,90,70,600,0.6198347107438017,0.25
60,150,50,150,50,60,520,0.5,106,130,90,110,154,90,680,0.719626168224299,0.5
45,30,15,85,65,65,305,0.36220472440944884,90,30,15,40,20,15,210,0.043478260869565216,1.0
35,35,40,35,55,50,250,0.40336134453781514,48,72,48,72,48,48,336,0.25984251968503935,1.0
38,41,40,50,65,65,299,0.4108527131782946,40,55,30,30,30,60,245,0.43548387096774194,1.0
60,60,75,60,75,80,410,0.7321428571428571,65,80,65,35,65,60,370,0.38405797101449274,2.0
40,65,40,80,40,65,330,0.5038167938931297,35,70,55,45,55,25,285,0.09420289855072464,1.0
95,70,73,95,90,60,483,0.3983739837398374,76,147,90,60,70,97,540,0.8267716535433071,2.0
75,90,140,60,60,40,465,0.3008130081300813,95,75,110,100,80,30,490,0.15267175572519084,1.0
75,98,63,98,63,101,498,0.8091603053435115,80,100,200,50,100,50,580,0.3472222222222222,2.0
95,85,85,65,65,35,430,0.2571428571428571,50,50,150,50,150,50,500,0.2571428571428571,4.0
50,65,64,44,48,43,314,0.2196969696969697,76,65,45,92,42,91,411,0.7449664429530202,1.0
50,64,50,45,50,41,300,0.22727272727272727,45,30,35,20,20,45,195,0.14782608695652175,1.0
50,35,55,25,25,15,205,0.05263157894736842,115,115,85,90,75,100,580,0.8134328358208955,0.5
65,125,100,55,70,85,500,0.6532258064516129,80,80,80,80,80,80,480,0.5606060606060606,1.0
108,130,95,80,85,102,600,0.7637795275590551,70,40,50,55,50,25,290,0.061068702290076333,1.0
55,104,105,94,75,52,485,0.36363636363636365,65,65,65,50,50,90,385,0.72,0.5
74,48,76,83,81,104,466,0.7322834645669292,60,55,145,75,150,40,525,0.2,0.5
60,40,80,60,45,40,325,0.23529411764705882,90,120,120,60,60,50,500,0.35294117647058826,4.0
40,45,65,100,120,90,460,0.5588235294117647,40,70,40,35,40,60,285,0.392,2.0
60,40,50,75,85,95,405,0.6044776119402985,70,70,70,70,70,70,420,0.5289256198347108,1.0
50,50,40,50,40,64,294,0.45588235294117646,43,80,65,50,35,35,308,0.14193548387096774,0.5
55,70,55,40,55,85,360,0.7073170731707317,45,75,60,40,30,50,300,0.304,1.0
65,70,60,65,65,115,440,0.8583333333333333,65,40,70,80,140,70,465,0.5954198473282443,1.0
60,80,50,40,40,30,300,0.15328467153284672,60,90,70,60,120,40,440,0.27419354838709675,1.0
75,125,75,30,75,85,465,0.625,78,84,78,109,85,100,534,0.8646616541353384,0.5
75,70,90,70,105,80,490,0.656,40,30,32,50,52,65,269,0.3671875,2.0
99,68,83,72,87,51,460,0.417910447761194,77,120,90,60,90,48,485,0.2785714285714286,0.5
70,140,70,110,65,105,560,0.95,90,100,70,110,150,80,600,0.6037735849056604,0.5
70,60,62,80,82,60,414,0.4375,50,92,108,92,108,35,485,0.2457627118644068,1.0
60,82,45,45,45,74,351,0.5752212389380531,81,102,77,85,75,85,505,0.5642857142857143,2.0
85,70,80,97,80,123,535,0.9304347826086956,88,107,122,74,75,64,530,0.4596774193548387,4.0
150,80,44,90,54,80,498,0.625,123,77,72,99,92,58,521,0.4621212121212121,0.5
75,100,66,60,66,115,482,0.918918918918919,80,92,65,65,80,68,450,0.4824561403508772,1.0
50,95,90,95,90,180,600,0.9172413793103448,45,30,50,55,65,45,290,0.208,0.5
45,85,50,55,50,65,350,0.5076923076923077,95,117,184,44,46,28,514,0.2975206611570248,2.0
35,35,40,35,55,50,250,0.40336134453781514,50,105,79,35,110,76,455,0.6214285714285714,2.0
80,120,79,95,79,70,523,0.5833333333333334,60,40,80,60,45,40,325,0.23529411764705882,0.5
95,117,80,65,70,92,519,0.8409090909090909,100,75,115,90,115,85,580,0.6446280991735537,1.0
75,80,55,25,35,35,305,0.18666666666666668,75,125,75,30,75,85,465,0.625,1.0
70,80,65,90,65,85,455,0.578125,75,105,75,105,75,45,480,0.3274336283185841,1.0
45,50,45,115,55,95,405,0.6936936936936937,150,120,100,120,100,90,680,0.664179104477612,1.0
45,85,50,55,50,65,350,0.5076923076923077,110,135,60,50,65,88,508,0.7744360902255639,2.0
70,80,50,35,35,35,305,0.14,65,150,40,15,80,145,495,0.9663865546218487,0.25
91,90,106,130,106,77,600,0.648854961832061,30,45,59,30,39,57,260,0.2803030303030303,2.0
44,38,33,61,43,70,289,0.5267857142857143,50,40,85,40,65,25,305,0.08870967741935484,1.0
45,50,35,55,75,40,300,0.21367521367521367,50,20,40,20,40,20,190,0.0962962962962963,0.0
70,75,80,135,80,135,575,0.917910447761194,75,103,80,70,80,92,500,0.7933884297520661,0.5
74,48,76,83,81,104,466,0.7322834645669292,50,95,90,95,90,180,600,0.9172413793103448,0.5
50,40,85,40,65,25,305,0.08870967741935484,68,72,78,38,42,32,330,0.23809523809523808,1.0
65,45,55,45,70,45,325,0.24369747899159663,40,60,40,40,40,30,250,0.0948905109489051,1.0
75,125,230,55,95,30,610,0.3448275862068966,53,51,53,61,56,40,314,0.14285714285714285,0.5
45,95,50,40,50,75,355,0.54,65,63,45,45,45,45,308,0.2595419847328244,1.0
30,42,118,42,88,30,350,0.112,60,80,50,40,40,30,300,0.15328467153284672,0.5
80,70,70,90,100,70,480,0.5609756097560976,62,73,55,56,52,84,382,0.7244094488188977,0.5
65,90,120,85,70,60,490,0.43410852713178294,85,110,90,45,90,80,500,0.6206896551724138,1.0
25,35,70,95,55,45,325,0.16783216783216784,108,112,118,68,72,47,525,0.2916666666666667,0.0
130,65,60,110,95,65,525,0.5227272727272727,54,45,47,75,98,52,371,0.39669421487603307,1.0
60,85,69,60,69,77,420,0.518796992481203,40,30,35,45,40,55,245,0.31496062992125984,1.0
100,120,120,150,100,90,680,0.7880794701986755,170,90,45,90,45,60,500,0.427536231884058,0.5
79,115,70,125,80,111,580,0.864,80,160,60,170,130,80,680,0.6180555555555556,1.0
95,75,80,100,110,30,490,0.24242424242424243,60,105,60,120,60,105,510,0.8849557522123894,0.0
79,85,60,55,60,71,410,0.60431654676259,75,125,75,30,75,85,465,0.625,1.0
44,50,91,24,86,10,305,0.1981981981981982,104,91,63,91,73,68,490,0.5118110236220472,1.0
65,105,60,60,70,95,455,63.0,75,55,70,55,95,110,460,0.8444444444444444,0.5
45,63,37,65,55,95,360,0.8055555555555556,38,35,40,27,25,35,200,0.08208955223880597,1.0
70,90,45,15,45,50,315,0.3629032258064516,108,170,115,120,95,92,700,0.7083333333333334,0.5
35,85,45,35,35,75,310,0.6492537313432836,50,70,100,40,40,30,330,0.2222222222222222,0.0625
75,123,67,95,85,95,540,0.7642276422764228,114,85,70,85,80,30,464,0.2066115702479339,0.5
45,60,45,25,45,55,275,0.29,38,35,40,27,25,35,200,0.08208955223880597,1.0
103,60,126,80,126,50,545,0.36363636363636365,75,123,67,95,85,95,540,0.7642276422764228,1.0
67,125,40,30,30,58,350,0.3431372549019608,39,52,43,60,50,65,309,0.5041322314049587,2.0
65,65,60,110,95,130,525,0.9253731343283582,130,85,80,85,95,60,535,0.43884892086330934,2.0
80,100,70,60,70,95,475,0.7416666666666667,92,105,90,125,90,98,600,0.8217054263565892,0.5
60,85,49,60,49,60,363,0.4444444444444444,67,89,116,79,116,33,500,0.2624113475177305,1.0
40,30,35,45,40,55,245,0.31496062992125984,70,60,75,110,75,90,480,0.7165354330708661,2.0
80,135,85,70,95,150,615,0.9844961240310077,190,33,58,33,58,33,405,0.13432835820895522,1.0
60,100,85,80,85,100,510,0.7007874015748031,170,90,45,90,45,60,500,0.427536231884058,1.0
60,80,50,50,50,40,330,0.23853211009174313,50,105,79,35,110,76,455,0.6214285714285714,1.0
70,75,80,135,80,135,575,0.917910447761194,28,25,25,45,35,40,198,0.16083916083916083,1.0
55,63,90,50,80,42,380,0.21138211382113822,65,90,40,45,80,75,395,0.625,0.125
106,110,90,154,90,130,680,0.926829268292683,105,140,95,55,65,45,505,0.3,1.0
70,60,70,87,78,85,450,0.6228070175438597,67,57,55,77,55,114,425,0.8879310344827587,0.5
31,45,90,30,30,40,266,0.21929824561403508,40,27,60,37,50,66,280,0.36220472440944884,0.5
80,70,70,90,100,70,480,0.5609756097560976,79,100,80,110,90,121,580,0.968,0.5
45,95,50,40,50,75,355,0.54,41,50,37,50,37,66,281,0.5175438596491229,2.0
58,109,112,48,48,109,484,0.8805970149253731,91,90,72,90,129,108,580,0.896,1.0
60,60,60,60,60,60,360,0.38095238095238093,78,70,61,50,61,100,420,0.8145161290322581,1.0
60,85,60,50,50,125,430,0.9090909090909091,100,150,90,180,160,90,770,0.7348484848484849,1.0
50,20,40,20,40,20,190,0.0962962962962963,45,90,20,65,20,65,305,0.5116279069767442,2.0
54,66,70,44,55,46,335,0.4214876033057851,76,25,45,67,55,24,292,0.0390625,2.0
50,50,150,50,150,50,500,0.2571428571428571,50,53,62,58,63,44,330,0.13709677419354838,1.0
70,65,60,90,75,90,450,0.6571428571428571,40,60,30,31,31,70,262,0.4492753623188406,0.5
80,115,80,65,55,93,488,0.7846153846153846,80,80,90,110,130,110,600,0.8721804511278195,1.0
60,75,85,100,85,115,520,0.8992248062015504,40,45,40,62,60,60,307,0.33884297520661155,2.0
71,73,88,120,89,59,500,0.43537414965986393,60,79,105,59,85,36,424,0.17054263565891473,2.0
20,40,15,35,35,60,205,0.34285714285714286,41,56,40,62,44,71,314,0.568,2.0
60,115,105,65,70,80,495,0.7181818181818181,111,83,68,92,82,39,475,0.1774193548387097,0.5
76,48,48,57,62,34,325,0.11688311688311688,38,30,41,30,41,60,240,0.2897196261682243,1.0
80,100,123,122,120,80,625,0.56,91,134,95,100,100,80,600,0.6304347826086957,0.25
89,124,80,55,80,55,483,0.5714285714285714,70,90,90,135,90,125,600,0.9401709401709402,0.5
40,35,30,120,70,105,400,0.6692307692307692,71,73,88,120,89,59,500,0.43537414965986393,1.0
100,100,125,110,50,50,535,0.384,45,45,35,20,30,20,195,0.07246376811594203,0.5
40,80,100,30,30,20,300,0.11851851851851852,40,70,130,60,130,25,455,0.17355371900826447,1.0
65,65,65,50,50,90,385,0.72,100,70,70,65,65,45,415,0.1897810218978102,1.0
75,98,63,98,63,101,498,0.8091603053435115,91,72,90,129,90,108,580,0.8620689655172413,2.0
100,5,5,15,65,30,220,0.07692307692307693,70,90,90,135,90,125,600,0.9401709401709402,1.0
70,92,65,80,55,98,460,0.8090909090909091,65,110,130,60,65,95,525,0.8278145695364238,0.5
125,120,90,170,100,95,700,0.78125,1,90,45,30,30,40,236,0.33064516129032256,1.0
66,117,70,40,50,67,410,0.4573643410852713,70,60,70,87,78,85,450,0.6228070175438597,1.0
63,60,55,50,50,71,349,0.5289256198347108,55,69,85,32,35,28,304,0.09302325581395349,1.0
50,50,95,40,50,35,320,0.20279720279720279,70,45,48,60,65,35,323,0.15748031496062992,1.0
68,125,65,65,115,80,518,0.6277372262773723,90,120,75,60,60,45,450,0.29411764705882354,0.5
80,80,80,80,80,80,480,0.5606060606060606,40,60,30,31,31,70,262,0.4492753623188406,1.0
65,150,40,15,80,145,495,0.9663865546218487,108,170,115,120,95,92,700,0.7083333333333334,0.5
60,60,50,40,50,75,335,0.5882352941176471,100,100,100,100,100,100,600,0.8758169934640523,0.25
60,60,75,60,75,80,410,0.7321428571428571,45,25,50,25,25,35,205,0.13076923076923078,0.5
60,90,140,50,50,40,430,0.2535211267605634,62,48,54,63,60,68,355,0.5178571428571429,1.0
50,65,90,35,35,15,290,0.14678899082568808,65,47,55,73,75,85,400,0.65,1.0
70,85,140,85,70,20,470,0.272,100,100,100,100,100,100,600,0.8602941176470589,2.0
54,66,70,44,55,46,335,0.4214876033057851,75,65,55,65,55,69,384,0.43548387096774194,4.0
55,65,95,95,45,85,440,0.6610169491525424,35,55,35,30,30,35,220,0.23684210526315788,1.0
70,110,75,145,85,145,630,0.9444444444444444,45,50,35,55,75,40,300,0.21367521367521367,1.0
55,68,64,45,55,31,318,0.11666666666666667,65,90,115,45,115,58,488,0.5041322314049587,1.0
91,72,90,129,90,108,580,0.8620689655172413,30,30,42,30,42,70,244,0.4230769230769231,0.25
70,65,60,90,75,90,450,0.6571428571428571,60,80,50,50,50,40,330,0.23853211009174313,1.0
39,52,43,60,50,65,309,0.49107142857142855,60,85,60,85,60,55,405,0.3673469387755102,0.5
108,100,121,81,95,95,600,0.7476635514018691,64,78,52,78,52,81,405,0.6422764227642277,2.0
79,85,60,55,60,71,410,0.60431654676259,60,40,60,40,60,35,295,0.18055555555555555,0.5
65,80,80,59,63,58,405,0.4411764705882353,110,65,105,55,95,80,510,0.6258503401360545,1.0
75,125,100,70,80,45,495,0.33035714285714285,70,55,95,95,110,65,490,0.48872180451127817,2.0
80,80,80,55,55,90,440,0.6417910447761194,70,60,70,87,78,85,450,0.6228070175438597,1.0
30,35,30,100,35,80,310,0.4765625,75,98,63,98,63,101,498,0.849624060150376,1.0
90,65,65,40,40,15,315,0.19672131147540983,50,47,50,57,50,65,319,0.463768115942029,1.0
65,100,70,80,80,105,500,0.8666666666666667,63,60,55,50,50,71,349,0.5289256198347108,1.0
75,90,50,110,80,95,500,0.7985611510791367,70,60,125,115,70,55,495,0.35507246376811596,0.25
100,75,115,90,115,85,580,0.6446280991735537,60,60,60,35,35,30,280,0.11194029850746269,1.0
70,75,80,135,80,135,575,0.917910447761194,60,130,80,60,60,70,460,0.5153846153846153,0.5
58,89,77,45,45,48,362,0.3177570093457944,50,70,160,70,160,90,600,0.7417218543046358,1.0
95,75,110,100,80,30,490,0.15267175572519084,73,76,75,81,100,100,505,0.8110236220472441,2.0
55,50,45,135,95,120,500,0.7714285714285715,67,125,40,30,30,58,350,0.3431372549019608,1.0
75,100,63,80,63,116,497,0.9345794392523364,100,120,120,150,100,90,680,0.7880794701986755,0.5
55,40,85,80,105,40,405,0.23622047244094488,41,64,45,50,50,50,300,0.36752136752136755,2.0
255,10,10,75,135,55,540,0.3125,60,80,95,70,85,50,440,0.2231404958677686,0.5
31,45,90,30,30,40,266,0.21929824561403508,55,95,115,45,45,35,390,0.2116788321167883,2.0
45,85,70,40,40,60,340,0.5229357798165137,50,50,120,80,80,30,410,0.07258064516129033,1.0
100,73,83,73,83,55,467,0.371900826446281,50,65,107,105,107,86,520,0.6991150442477876,1.0
106,190,100,154,100,130,780,0.9259259259259259,65,80,140,40,70,70,465,0.5223880597014925,0.5
105,105,75,65,100,50,500,0.37593984962406013,75,100,110,45,55,65,450,0.5333333333333333,0.5
86,76,86,116,56,95,515,0.7982456140350878,85,105,85,40,50,40,405,0.211864406779661,1.0
100,100,100,100,100,100,600,0.831858407079646,90,100,70,110,150,80,600,0.6037735849056604,1.0
50,120,53,35,110,87,455,0.640625,50,95,90,95,90,180,600,0.9172413793103448,0.5
90,100,90,125,85,90,580,0.7352941176470589,70,85,65,105,85,120,530,0.9262295081967213,4.0
90,110,80,100,80,95,555,0.7982456140350878,76,48,48,57,62,34,325,0.11688311688311688,0.5
100,180,160,150,90,90,770,0.7520661157024794,50,52,48,65,50,55,320,0.33098591549295775,0.5
86,68,72,109,66,106,507,0.8099173553719008,49,55,42,42,37,85,310,0.6068376068376068,1.0
65,70,60,65,65,115,440,0.8583333333333333,79,103,120,135,115,78,630,0.5763888888888888,1.0
103,60,86,60,86,50,445,0.3458646616541353,126,131,95,131,98,99,680,0.8294573643410853,1.0
125,58,58,76,76,67,460,0.515625,125,170,100,120,90,95,700,0.77,0.25
70,80,70,80,70,110,480,0.6594202898550725,125,58,58,76,76,67,460,0.515625,0.5
65,125,60,95,60,105,510,0.9236641221374046,80,70,70,90,100,70,480,0.5609756097560976,1.0
114,85,70,85,80,30,464,0.2066115702479339,45,30,50,55,65,45,290,0.208,1.0
80,135,130,95,90,70,600,0.5181818181818182,85,70,80,97,80,123,535,0.9304347826086956,1.0
75,100,66,60,66,115,482,0.918918918918919,50,65,85,35,35,55,325,0.32575757575757575,0.5
106,130,90,110,154,90,680,0.719626168224299,80,145,150,105,110,110,700,0.8692307692307693,1.0
70,55,75,45,65,60,370,0.45901639344262296,75,80,55,25,35,35,305,0.18666666666666668,1.0
65,45,55,45,70,45,325,0.24369747899159663,110,123,65,100,65,65,528,0.5217391304347826,2.0
70,40,50,55,50,25,290,0.061068702290076333,70,60,125,115,70,55,495,0.35507246376811596,0.5
50,48,43,46,41,60,288,0.47297297297297297,77,85,51,55,51,65,384,0.5163934426229508,0.5
75,80,70,65,75,90,455,0.7578125,75,125,75,30,75,85,465,0.625,2.0
38,41,40,50,65,65,299,0.4108527131782946,50,50,50,50,50,50,300,0.30708661417322836,2.0
65,150,40,15,80,145,495,0.9663865546218487,65,65,45,75,45,95,390,0.72,0.5
50,85,40,85,40,35,335,0.1746031746031746,100,100,80,60,60,50,450,0.3050847457627119,2.0
55,50,40,40,40,75,300,0.5945945945945946,90,100,60,90,60,80,480,0.6422764227642277,1.0
60,60,75,60,75,80,410,0.7321428571428571,65,60,110,130,95,65,525,0.47761194029850745,2.0
28,25,25,45,35,40,198,0.16083916083916083,55,75,50,40,40,80,340,0.6302521008403361,1.0
20,15,20,10,55,80,200,0.2682926829268293,45,30,40,105,50,20,290,0.031007751937984496,1.0
60,40,80,60,45,40,325,0.23529411764705882,78,130,111,130,85,100,634,0.8561151079136691,0.25
90,100,60,90,60,80,480,0.6422764227642277,60,50,70,80,80,140,480,0.8449612403100775,1.0
62,55,52,109,94,109,481,0.7833333333333333,25,35,70,95,55,45,325,0.16783216783216784,0.25
80,100,123,122,120,80,625,0.56,40,35,30,20,20,50,195,0.23423423423423423,0.125
76,147,90,60,70,97,540,0.8267716535433071,77,85,51,55,51,65,384,0.5163934426229508,1.0
100,100,100,100,100,100,600,0.8805970149253731,65,90,50,85,45,55,390,0.371900826446281,0.5
50,20,40,20,40,20,190,0.0962962962962963,45,80,100,35,37,28,325,0.3125,0.0
30,105,90,25,25,50,325,0.2773722627737226,50,65,107,105,107,86,520,0.7272727272727273,1.0
85,135,130,60,80,25,515,0.40540540540540543,45,60,45,25,45,55,275,0.29,1.0
40,20,30,40,80,55,265,0.22764227642276422,50,45,45,35,35,50,260,0.23529411764705882,1.0
55,55,55,85,55,30,335,0.1320754716981132,70,75,60,105,60,105,475,0.88,1.0
45,65,34,40,34,45,263,0.2589928057553957,58,64,58,80,65,80,405,0.5423728813559322,1.0
70,20,50,20,50,40,250,0.1557377049180328,130,85,80,85,95,60,535,0.43884892086330934,0.5
50,53,48,53,48,64,316,0.46153846153846156,20,15,20,10,55,80,200,0.2682926829268293,0.5
99,68,83,72,87,51,460,0.417910447761194,70,55,55,80,60,45,365,0.2222222222222222,0.5
50,150,50,150,50,150,600,0.9339622641509434,79,115,70,125,80,111,580,0.8468468468468469,1.0
80,120,79,95,79,70,523,0.5833333333333334,55,85,122,58,75,99,494,0.8099173553719008,0.5
50,65,107,105,107,86,520,0.7313432835820896,116,55,85,107,95,29,487,0.06818181818181818,1.0
30,45,59,30,39,57,260,0.2803030303030303,110,135,60,50,65,88,508,0.7744360902255639,0.0
20,10,230,10,230,5,505,0.0,70,40,50,55,50,25,290,0.061068702290076333,2.0
95,23,48,23,48,23,260,0.046153846153846156,108,112,118,68,72,47,525,0.2916666666666667,2.0
80,160,80,130,80,100,630,0.8455284552845529,100,5,5,15,65,30,220,0.07692307692307693,2.0
45,30,50,65,50,45,285,0.13821138211382114,20,25,45,70,90,60,310,0.30833333333333335,0.5
38,36,38,32,36,57,237,0.3893805309734513,73,115,60,60,60,90,458,0.6694915254237288,1.0
120,70,120,75,130,85,600,0.6694915254237288,60,85,60,85,60,55,405,0.3673469387755102,1.0
45,75,37,70,55,83,365,0.6183206106870229,105,95,75,85,75,74,509,0.5714285714285714,0.5
70,110,70,115,70,90,525,0.75,39,52,43,60,50,65,309,0.49107142857142855,0.5
55,50,65,175,95,150,590,0.7818181818181819,44,75,35,63,33,45,295,0.2647058823529412,1.0
65,125,100,55,70,85,500,0.6532258064516129,31,45,90,30,30,40,266,0.21929824561403508,1.0
40,80,35,35,45,70,305,0.4661016949152542,40,60,40,40,40,30,250,0.0948905109489051,0.25
50,45,45,35,35,50,260,0.23529411764705882,80,100,80,80,80,100,520,0.9051724137931034,1.0
125,120,90,170,100,95,700,0.78125,60,100,89,55,69,112,485,0.9298245614035088,1.0
79,105,70,145,80,101,580,0.8608695652173913,35,55,35,30,30,35,220,0.23684210526315788,1.0
50,65,107,105,107,86,520,0.7272727272727273,60,65,70,85,75,40,395,0.21705426356589147,1.0
40,65,40,80,40,65,330,0.5038167938931297,95,65,65,110,130,60,525,0.4016393442622951,0.5
100,180,160,150,90,90,770,0.7520661157024794,40,70,130,60,130,25,455,0.17355371900826447,1.0
50,50,62,40,62,65,329,0.4188034188034188,35,85,45,35,35,75,310,0.6492537313432836,1.0
50,48,43,46,41,60,288,0.47297297297297297,70,60,62,80,82,60,414,0.4375,0.0
45,45,55,45,55,63,308,0.4594594594594595,35,85,45,35,35,75,310,0.6492537313432836,0.5
60,60,50,40,50,75,335,0.5882352941176471,65,60,110,130,95,65,525,0.47761194029850745,1.0
45,30,35,20,20,45,195,0.14782608695652175,50,52,48,65,50,55,320,0.33098591549295775,1.0
100,100,100,100,100,100,600,0.831858407079646,106,90,130,90,154,110,680,0.8699186991869918,0.5
95,75,180,130,80,30,590,0.13793103448275862,150,120,100,120,100,90,680,0.664179104477612,0.5
80,75,150,75,150,50,580,0.30973451327433627,30,45,59,30,39,57,260,0.2803030303030303,1.0
57,80,91,80,87,75,470,0.5737704918032787,83,80,75,70,70,101,479,0.8615384615384616,1.0
58,64,58,80,65,80,405,0.609271523178808,75,100,95,40,70,110,490,0.8717948717948718,1.0
62,48,54,63,60,68,355,0.5178571428571429,63,120,85,90,55,55,468,0.2809917355371901,0.0
40,40,40,70,40,20,250,0.032520325203252036,100,100,100,100,100,100,600,0.8602941176470589,2.0
70,55,95,95,110,65,490,0.48872180451127817,65,130,60,75,60,75,465,0.689922480620155,0.0
43,70,48,50,60,38,309,0.2391304347826087,40,45,35,30,40,55,245,0.3793103448275862,0.25
65,76,84,54,96,105,480,0.9008264462809917,60,55,50,40,55,45,305,0.22377622377622378,1.0
50,40,85,40,65,25,305,0.08870967741935484,60,105,60,120,60,105,510,0.8849557522123894,2.0
50,47,50,57,50,65,319,0.463768115942029,50,25,28,45,55,15,218,0.0625,0.5
78,92,75,74,63,118,500,0.8842975206611571,78,52,60,63,65,23,341,0.06015037593984962,0.5
65,90,120,85,70,60,490,0.43410852713178294,30,40,70,70,25,60,295,0.41353383458646614,1.0
55,35,50,55,110,85,390,0.6277372262773723,55,40,50,65,85,40,335,0.3181818181818182,0.5
95,95,85,125,65,55,520,0.3894736842105263,60,50,40,85,75,95,405,0.7540983606557377,1.0
110,123,65,100,65,65,528,0.5217391304347826,95,155,109,70,130,81,640,0.6788321167883211,1.0
20,40,90,30,90,25,295,0.11363636363636363,35,35,35,35,35,35,210,0.13385826771653545,1.0
120,70,120,75,130,85,600,0.6694915254237288,75,125,70,125,70,115,580,0.9037037037037037,0.5
80,130,100,160,120,110,700,0.8981481481481481,80,100,70,50,60,45,405,0.25806451612903225,1.0
50,30,55,65,55,20,275,0.13675213675213677,55,40,40,65,45,35,280,0.16428571428571428,1.0
100,123,75,57,75,80,510,0.6923076923076923,105,140,55,30,55,95,480,0.8195488721804511,1.0
95,155,109,70,130,81,640,0.6788321167883211,79,105,70,145,80,101,580,0.8608695652173913,1.0
20,40,15,35,35,60,205,0.34285714285714286,60,45,70,45,90,95,405,0.7304964539007093,0.5
50,60,45,100,80,65,400,0.45689655172413796,60,40,60,95,60,55,370,0.4222222222222222,0.25
60,60,50,40,50,75,335,0.5882352941176471,55,75,50,40,40,80,340,0.6302521008403361,0.5
70,65,65,55,55,70,380,0.5,65,130,60,75,60,75,465,0.689922480620155,1.0
76,48,48,57,62,34,325,0.11688311688311688,45,49,49,65,65,45,318,0.2781954887218045,0.5
66,117,70,40,50,67,410,0.4573643410852713,68,90,65,50,55,82,410,0.6165413533834586,2.0
80,45,65,90,110,80,470,0.5462962962962963,20,40,90,30,90,25,295,0.11363636363636363,1.0
60,80,50,50,50,40,330,0.23853211009174313,65,47,55,73,75,85,400,0.65,1.0
63,63,47,41,41,74,329,0.56,40,29,45,29,45,36,224,0.14634146341463414,1.0
86,76,86,116,56,95,515,0.7982456140350878,65,125,100,60,70,70,490,0.6099290780141844,0.5
45,60,30,80,50,65,330,0.4603174603174603,90,50,34,60,44,70,348,0.6283185840707964,2.0
50,120,53,35,110,87,455,0.640625,114,85,70,85,80,30,464,0.2066115702479339,0.5
65,90,40,45,80,75,395,0.625,30,45,55,70,55,85,340,0.5633802816901409,1.0
85,56,77,50,77,78,423,0.53125,40,65,95,60,45,35,340,0.13986013986013987,2.0
44,38,39,61,79,42,303,0.2251655629139073,68,85,65,165,135,100,618,0.8083333333333333,1.0
120,120,120,120,120,120,720,0.9344262295081968,50,48,43,46,41,60,288,0.47297297297297297,1.0
56,61,65,48,45,38,313,0.17567567567567569,70,65,60,90,75,90,450,0.6571428571428571,0.25
70,70,40,60,40,60,340,0.4247787610619469,60,95,80,60,80,30,405,0.19480519480519481,0.25
45,75,60,40,30,50,300,0.304,30,45,135,45,90,30,375,0.09285714285714286,1.0
60,65,80,170,95,130,600,0.8625954198473282,45,45,55,45,55,63,308,0.4594594594594595,2.0
95,100,85,108,70,70,528,0.5652173913043478,60,25,35,70,80,60,330,0.3076923076923077,1.0
70,85,65,105,85,120,530,0.9262295081967213,83,106,65,86,65,85,490,0.6640625,0.5
90,75,85,115,90,55,510,0.3445378151260504,95,65,110,60,130,65,525,0.5275590551181102,1.0
50,105,79,35,110,76,455,0.6214285714285714,80,120,130,55,65,45,495,0.37037037037037035,2.0
43,70,48,50,60,38,309,0.2391304347826087,85,50,95,120,115,80,545,0.5793650793650794,0.5
80,80,50,40,50,25,325,0.176056338028169,50,20,55,25,25,30,205,0.09774436090225563,1.0
70,65,60,90,75,90,450,0.6571428571428571,70,110,70,115,70,90,525,0.75,0.0
35,70,55,45,55,25,285,0.09420289855072464,86,81,97,81,107,43,495,0.203125,2.0
90,95,105,165,110,45,610,0.2890625,45,49,65,49,65,45,318,0.275,0.5
100,164,150,95,120,71,700,0.5645161290322581,85,73,70,73,115,67,483,0.5126050420168067,2.0
115,45,20,45,25,20,270,0.11538461538461539,60,40,60,95,60,55,370,0.4222222222222222,0.0
70,135,105,60,105,20,495,0.5806451612903226,70,77,60,97,60,108,472,0.8394160583941606,0.5
30,42,118,42,88,30,350,0.112,65,110,130,60,65,95,525,0.8278145695364238,1.0
90,75,75,90,100,70,500,0.5462184873949579,60,70,105,70,120,75,500,0.5983606557377049,2.0
40,30,50,55,55,100,330,0.584070796460177,45,20,50,60,120,50,345,0.24074074074074073,4.0
120,70,120,75,130,85,600,0.6694915254237288,45,20,50,60,120,50,345,0.24074074074074073,1.0
76,104,71,104,71,108,534,0.912751677852349,65,70,60,65,65,115,440,0.8583333333333333,2.0
45,60,40,70,50,45,310,0.2846715328467153,70,115,60,115,60,55,475,0.4647887323943662,2.0
75,95,122,58,75,69,494,0.5725806451612904,75,80,70,65,75,90,455,0.7578125,0.25
91,90,106,130,106,77,600,0.648854961832061,35,85,45,35,35,75,310,0.6492537313432836,1.0
100,100,100,100,100,100,600,0.8758169934640523,65,65,45,75,45,95,390,0.72,1.0
44,75,35,63,33,45,295,0.2647058823529412,48,61,40,61,40,50,300,0.2543859649122807,1.0
76,147,90,60,70,97,540,0.8267716535433071,62,73,55,56,52,84,382,0.7244094488188977,1.0
70,100,115,30,65,30,410,0.24390243902439024,70,60,125,115,70,55,495,0.35507246376811596,1.0
50,53,48,53,48,64,316,0.46153846153846156,30,65,100,45,25,40,305,0.1891891891891892,0.5
75,80,95,90,100,50,490,0.2158273381294964,111,83,68,92,82,39,475,0.1774193548387097,4.0
50,53,48,53,48,64,316,0.4076923076923077,115,115,85,90,75,100,580,0.8134328358208955,0.5
59,110,150,45,49,35,448,0.3333333333333333,100,150,110,95,110,70,635,0.5923076923076923,0.5
65,40,50,125,60,30,370,0.07258064516129033,70,62,67,55,55,56,365,0.38513513513513514,2.0
75,95,122,58,75,69,494,0.5725806451612904,55,45,50,45,65,80,340,0.5546218487394958,0.25
50,85,125,85,115,20,480,0.4306569343065693,160,110,65,65,110,30,540,0.35714285714285715,0.0
85,110,76,65,82,56,474,0.3933333333333333,40,45,35,30,40,55,245,0.3793103448275862,0.25
55,55,50,45,65,55,325,0.37373737373737376,65,155,120,65,90,105,600,0.8677685950413223,1.0
60,65,60,130,75,110,500,0.7719298245614035,60,80,110,50,80,45,425,0.2833333333333333,0.5
91,72,90,129,90,108,580,0.8620689655172413,50,92,108,92,108,35,485,0.2457627118644068,0.0
58,64,58,80,65,80,405,0.609271523178808,75,125,75,30,75,85,465,0.625,1.0
35,55,40,45,40,60,275,0.35714285714285715,43,70,48,50,60,38,309,0.2391304347826087,0.5
90,132,105,132,105,30,594,0.4246575342465753,105,125,100,60,100,100,590,0.8359375,1.0
65,85,70,75,70,40,405,0.203125,60,105,60,120,60,105,510,0.8849557522123894,1.0
68,85,65,165,135,100,618,0.8083333333333333,30,56,35,25,35,72,253,0.48148148148148145,1.0
67,89,116,79,116,33,500,0.2624113475177305,111,83,68,92,82,39,475,0.1774193548387097,1.0
85,60,65,135,105,100,550,0.7518248175182481,25,35,70,95,55,45,325,0.16783216783216784,1.0
80,110,120,130,90,70,600,0.6198347107438017,73,100,60,100,60,65,458,0.42657342657342656,1.0
44,58,44,58,44,61,309,0.41964285714285715,65,75,105,35,65,85,430,0.6940298507462687,1.0
80,95,82,60,82,75,474,0.6,110,80,90,95,90,65,530,0.5033557046979866,1.0
75,65,55,65,55,69,384,0.43548387096774194,83,80,80,135,80,121,579,0.9444444444444444,0.0
165,75,80,40,45,65,470,0.5151515151515151,50,65,107,105,107,86,520,0.7272727272727273,1.0
50,180,20,180,20,150,600,0.9029850746268657,45,30,35,20,20,45,195,0.14782608695652175,1.0
50,105,125,55,95,50,480,0.375886524822695,60,52,168,47,138,30,495,0.19834710743801653,0.5
40,35,30,120,70,105,400,0.6692307692307692,30,42,118,42,88,30,350,0.112,0.5
75,105,75,105,75,45,480,0.3274336283185841,70,80,50,35,35,35,305,0.14,1.0
55,75,60,75,60,103,428,0.7982456140350878,78,84,78,109,85,100,534,0.8620689655172413,1.0
85,100,122,58,75,54,494,0.3939393939393939,150,100,120,100,120,90,680,0.6666666666666666,1.0
60,85,40,30,45,68,328,0.6422018348623854,35,55,40,45,40,60,275,0.35714285714285715,2.0
55,75,85,25,25,15,280,0.1875,50,35,55,25,25,15,205,0.05263157894736842,2.0
70,95,125,65,75,45,475,0.33613445378151263,70,60,70,87,78,85,450,0.6228070175438597,2.0
108,100,121,81,95,95,600,0.7476635514018691,115,140,130,55,55,40,535,0.4519230769230769,2.0
62,73,55,56,52,84,382,0.7244094488188977,100,100,100,100,100,100,600,0.831858407079646,1.0
90,92,87,75,85,76,505,0.5409836065573771,100,100,100,100,100,100,600,0.8758169934640523,0.0
55,70,40,60,40,40,305,0.26956521739130435,80,105,105,105,105,80,580,0.5939849624060151,1.0
65,90,115,45,115,58,488,0.5041322314049587,70,110,180,60,60,50,530,0.4117647058823529,4.0
45,50,35,55,75,40,300,0.21367521367521367,99,68,83,72,87,51,460,0.417910447761194,1.0
50,55,50,36,30,43,264,0.2922077922077922,77,120,90,60,90,48,485,0.2785714285714286,1.0
65,150,40,15,80,145,495,0.9663865546218487,75,55,70,55,95,110,460,0.8444444444444444,2.0
70,43,53,43,53,40,302,0.19090909090909092,54,63,52,83,56,97,405,0.7697841726618705,1.0
62,55,52,109,94,109,481,0.7833333333333333,89,145,90,105,80,91,600,0.8549618320610687,0.0
60,60,60,35,35,30,280,0.11194029850746269,60,45,50,90,80,70,395,0.625,1.0
85,60,65,135,105,100,550,0.7518248175182481,97,165,60,65,50,58,495,0.3902439024390244,0.5
59,74,50,35,50,35,303,0.3125,50,35,55,25,25,15,205,0.05263157894736842,0.5
62,44,50,44,50,55,305,0.3629032258064516,40,60,30,31,31,70,262,0.4492753623188406,1.0
91,90,106,130,106,77,600,0.648854961832061,150,160,100,95,65,100,670,0.8866666666666667,1.0
90,100,90,125,85,90,580,0.7352941176470589,40,80,100,30,30,20,300,0.11851851851851852,0.25
60,110,70,60,60,100,460,0.8461538461538461,70,120,100,145,105,20,560,0.2824427480916031,1.0
50,70,50,50,50,70,340,0.5645161290322581,66,117,70,40,50,67,410,0.4573643410852713,2.0
70,80,65,90,65,85,455,0.578125,40,20,30,40,80,55,265,0.22764227642276422,1.0
75,98,63,98,63,101,498,0.889763779527559,95,117,80,65,70,92,519,0.8409090909090909,1.0
40,30,30,40,50,30,220,0.07936507936507936,100,150,110,95,110,70,635,0.5923076923076923,4.0
100,100,100,100,100,100,600,0.8778625954198473,61,72,57,55,55,65,365,0.3984375,2.0
55,85,122,58,75,99,494,0.8099173553719008,59,63,80,65,80,58,405,0.41843971631205673,2.0
50,53,48,53,48,64,316,0.46153846153846156,92,105,90,125,90,98,600,0.8217054263565892,0.5
78,92,75,74,63,118,500,0.8842975206611571,45,30,15,85,65,65,305,0.36220472440944884,1.0
95,110,80,70,80,50,485,0.37209302325581395,75,69,72,114,100,104,534,0.8253968253968254,0.5
60,80,95,70,85,50,440,0.2231404958677686,65,80,140,40,70,70,465,0.5223880597014925,0.5
109,66,84,81,99,32,471,0.2013888888888889,55,70,40,60,40,40,305,0.26956521739130435,1.0
40,55,30,30,30,60,245,0.43548387096774194,75,55,70,55,95,110,460,0.8444444444444444,2.0
170,90,45,90,45,60,500,0.427536231884058,106,130,90,110,154,90,680,0.719626168224299,2.0
80,80,90,110,130,110,600,0.8721804511278195,55,63,90,50,80,42,380,0.21138211382113822,1.0
60,60,60,60,60,60,360,0.38095238095238093,90,95,105,165,110,45,610,0.2890625,1.0
55,55,45,63,45,45,308,0.25,50,20,55,25,25,30,205,0.09774436090225563,1.0
55,45,50,45,65,80,340,0.5546218487394958,55,81,60,50,70,97,413,0.7214285714285714,1.0
59,45,40,35,40,31,250,0.14285714285714285,90,120,120,60,60,50,500,0.35294117647058826,1.0
79,85,60,55,60,71,410,0.60431654676259,56,61,65,48,45,38,313,0.17567567567567569,0.5
50,65,107,105,107,86,520,0.6991150442477876,70,85,140,85,70,20,470,0.272,0.5
40,65,95,60,45,35,340,0.13986013986013987,116,55,85,107,95,29,487,0.06818181818181818,1.0
45,53,70,40,60,42,310,0.25735294117647056,85,60,65,135,105,100,550,0.7518248175182481,0.125
20,25,45,70,90,60,310,0.30833333333333335,126,131,95,131,98,99,680,0.8102189781021898,0.0
70,65,60,90,75,90,450,0.6571428571428571,61,78,95,56,58,57,405,0.40336134453781514,4.0
105,30,105,140,105,55,540,0.3524590163934426,25,35,70,95,55,45,325,0.16783216783216784,1.0
59,63,80,65,80,58,405,0.41843971631205673,150,80,44,90,54,80,498,0.625,1.0
85,120,70,50,60,100,485,0.8308823529411765,80,70,65,80,120,100,515,0.8034188034188035,1.0
110,130,80,70,60,80,530,0.5862068965517241,75,65,55,65,55,69,384,0.43548387096774194,1.0
165,75,80,40,45,65,470,0.5151515151515151,28,25,25,45,35,40,198,0.16083916083916083,1.0
40,65,95,60,45,35,340,0.13986013986013987,95,100,85,108,70,70,528,0.5652173913043478,1.0
50,30,55,65,55,20,275,0.13675213675213677,76,104,71,104,71,108,534,0.912751677852349,0.5
35,20,65,40,65,20,245,0.02459016393442623,100,110,90,85,90,60,535,0.47794117647058826,1.0
65,75,70,95,70,95,470,0.7272727272727273,60,65,60,130,75,110,500,0.7719298245614035,2.0
52,65,55,58,62,60,352,0.4482758620689655,108,100,121,81,95,95,600,0.7476635514018691,1.0
70,110,75,145,85,145,630,0.9444444444444444,75,55,70,55,95,110,460,0.8444444444444444,0.25
74,100,72,90,72,46,454,0.24561403508771928,70,80,50,35,35,35,305,0.14,1.0
88,107,122,74,75,64,530,0.4596774193548387,60,90,140,50,50,40,430,0.2535211267605634,4.0
70,90,110,60,75,95,500,0.7333333333333333,55,45,45,25,25,15,210,0.048,0.5
70,85,70,60,70,50,405,0.28378378378378377,40,45,35,30,40,55,245,0.3793103448275862,0.0
90,60,70,75,70,45,410,0.23880597014925373,89,124,80,55,80,55,483,0.5714285714285714,4.0
40,45,40,35,35,56,251,0.373015873015873,66,65,48,62,57,52,350,0.36220472440944884,2.0
70,150,140,65,100,75,600,0.55,25,20,15,105,55,90,310,0.32407407407407407,2.0
75,90,90,140,90,115,600,0.9481481481481482,45,100,135,65,135,45,525,0.29411764705882354,2.0
79,115,70,125,80,111,580,0.8468468468468469,80,160,60,170,130,80,680,0.6180555555555556,1.0
62,77,62,50,42,65,358,0.4838709677419355,108,170,115,120,95,92,700,0.7083333333333334,1.0
30,45,135,45,90,30,375,0.09285714285714286,55,95,115,45,45,35,390,0.2116788321167883,0.5
90,93,55,70,55,55,418,0.3819444444444444,50,70,160,70,160,90,600,0.7417218543046358,0.5
65,85,70,75,70,40,405,0.203125,70,92,65,80,55,98,460,0.8090909090909091,2.0
100,100,125,110,50,50,535,0.384,79,105,70,145,80,101,580,0.8608695652173913,0.5
71,120,95,120,95,99,600,0.8203125,65,95,57,100,85,93,495,0.7441860465116279,0.25
106,110,90,154,90,130,680,0.926829268292683,50,65,90,35,35,15,290,0.14678899082568808,1.0
75,90,90,140,90,115,600,0.9481481481481482,80,75,150,75,150,50,580,0.30973451327433627,2.0
95,95,85,125,65,55,520,0.3894736842105263,80,75,150,75,150,50,580,0.30973451327433627,0.25
85,76,64,45,55,90,415,0.6739130434782609,45,80,100,35,37,28,325,0.3125,0.0
30,105,90,25,25,50,325,0.2773722627737226,75,80,70,65,75,90,455,0.7578125,1.0
60,60,75,60,75,80,410,0.7321428571428571,103,93,67,71,61,84,479,0.7142857142857143,0.0
123,100,62,97,81,68,531,0.4806201550387597,73,100,60,100,60,65,458,0.42657342657342656,0.5
77,120,90,60,90,48,485,0.2785714285714286,40,40,55,40,70,55,300,0.40939597315436244,1.0
71,73,88,120,89,59,500,0.43537414965986393,45,30,35,20,20,45,195,0.14782608695652175,1.0
100,100,100,100,100,100,600,0.8758169934640523,50,85,40,85,40,35,335,0.1746031746031746,1.0
80,145,150,105,110,110,700,0.8692307692307693,116,55,85,107,95,29,487,0.06818181818181818,0.5
45,35,50,70,50,30,280,0.15753424657534246,165,75,80,40,45,65,470,0.5151515151515151,2.0
100,100,125,110,50,50,535,0.384,80,92,65,65,80,68,450,0.4824561403508772,2.0
65,110,130,60,65,95,525,0.8278145695364238,70,55,65,95,85,70,440,0.5307692307692308,2.0
90,110,80,100,80,95,555,0.7982456140350878,60,70,50,100,50,65,395,0.5217391304347826,2.0
50,95,90,95,90,180,600,0.9172413793103448,100,100,100,100,100,100,600,0.8345864661654135,0.5
60,62,50,62,60,40,334,0.18181818181818182,60,45,70,75,85,55,390,0.3008130081300813,1.0
126,131,95,131,98,99,680,0.8102189781021898,74,48,76,83,81,104,466,0.7322834645669292,2.0
106,110,90,154,90,130,680,0.926829268292683,60,60,60,60,60,60,360,0.38095238095238093,1.0
57,24,86,24,86,23,300,0.12727272727272726,50,95,90,95,90,180,600,0.9172413793103448,0.5
78,65,68,112,154,75,552,0.628099173553719,70,115,60,115,60,55,475,0.4647887323943662,2.0
76,25,45,67,55,24,292,0.0390625,68,90,65,50,55,82,410,0.6165413533834586,2.0
75,98,63,98,63,101,498,0.8091603053435115,65,80,80,59,63,58,405,0.4411764705882353,2.0
105,180,100,180,100,115,780,0.9477611940298507,38,35,40,27,25,35,200,0.08208955223880597,2.0
40,35,30,20,20,50,195,0.23423423423423423,37,25,41,25,41,25,194,0.08870967741935484,1.0
80,82,83,100,100,80,525,0.6742424242424242,79,115,70,125,80,111,580,0.864,0.5
100,77,77,128,128,90,600,0.6901408450704225,70,95,125,65,75,45,475,0.33613445378151263,0.5
57,80,91,80,87,75,470,0.5737704918032787,50,65,85,35,35,55,325,0.32575757575757575,2.0
95,80,105,40,70,100,490,0.8046875,65,75,90,97,123,44,494,0.1987179487179487,1.0
130,85,80,85,95,60,535,0.43884892086330934,45,67,60,35,50,63,320,0.5128205128205128,0.25
65,80,65,35,65,60,370,0.38405797101449274,62,44,50,44,50,55,305,0.3629032258064516,1.0
76,65,45,92,42,91,411,0.7449664429530202,90,120,100,150,120,100,680,0.7718120805369127,1.0
70,55,95,95,110,65,490,0.48872180451127817,75,85,200,55,65,30,510,0.16778523489932887,1.0
91,134,95,100,100,80,600,0.6304347826086957,78,92,75,74,63,118,500,0.8842975206611571,2.0
70,40,50,55,50,25,290,0.061068702290076333,106,110,90,154,90,130,680,0.926829268292683,1.0
50,95,95,35,110,70,455,0.5179856115107914,60,90,70,60,120,40,440,0.27419354838709675,2.0
95,60,79,100,125,81,540,0.6201550387596899,65,40,50,125,60,30,370,0.07258064516129033,1.0
55,50,40,40,40,75,300,0.5945945945945946,74,48,76,83,81,104,466,0.7322834645669292,1.0
55,112,45,74,45,70,401,0.559322033898305,108,130,95,80,85,102,600,0.7637795275590551,0.5
67,82,62,46,48,43,348,0.22033898305084745,85,97,66,105,66,65,484,0.47107438016528924,1.0
76,25,45,67,55,24,292,0.0390625,80,110,60,150,130,70,600,0.5042016806722689,0.5
40,40,40,70,40,20,250,0.032520325203252036,106,190,100,154,100,130,780,0.9259259259259259,1.0
20,10,230,10,230,5,505,0.0,105,105,75,65,100,50,500,0.37593984962406013,0.5
70,65,65,55,55,70,380,0.5,60,100,115,70,85,90,520,0.7557251908396947,0.5
25,35,70,95,55,45,325,0.16783216783216784,44,58,44,58,44,61,309,0.41964285714285715,0.5
90,120,100,150,120,100,680,0.7718120805369127,75,38,38,56,56,67,330,0.5263157894736842,0.5
90,95,105,165,110,45,610,0.2890625,55,55,55,85,55,30,335,0.1320754716981132,1.0
73,100,60,100,60,65,458,0.42657342657342656,73,115,60,60,60,90,458,0.6694915254237288,1.0
40,80,35,35,45,70,305,0.4661016949152542,65,45,55,45,70,45,325,0.24369747899159663,1.0
99,68,83,72,87,51,460,0.417910447761194,30,45,59,30,39,57,260,0.2803030303030303,0.5
95,110,95,40,95,55,490,0.40336134453781514,80,185,115,40,105,75,600,0.6230769230769231,1.0
40,40,55,40,70,55,300,0.40939597315436244,65,83,57,95,85,105,490,0.8914728682170543,2.0
75,80,95,90,100,50,490,0.2158273381294964,42,52,67,39,56,50,306,0.2868217054263566,4.0
74,94,131,54,116,20,489,0.4485294117647059,110,123,65,100,65,65,528,0.5217391304347826,0.25
75,80,70,65,75,90,455,0.7578125,40,45,65,100,120,90,460,0.5588235294117647,2.0
40,35,30,20,20,50,195,0.23423423423423423,95,110,95,40,95,55,490,0.40336134453781514,1.0
100,100,80,60,60,50,450,0.3050847457627119,80,80,80,55,55,90,440,0.6417910447761194,1.0
67,125,40,30,30,58,350,0.3431372549019608,50,50,77,95,77,91,440,0.5916666666666667,1.0
95,110,95,40,95,55,490,0.40336134453781514,160,110,65,65,110,30,540,0.35714285714285715,1.0
45,85,70,40,40,60,340,0.5229357798165137,50,53,48,53,48,64,316,0.358974358974359,0.5
72,105,115,54,86,68,500,0.5149253731343284,65,95,100,60,50,50,420,0.34959349593495936,0.5
35,70,55,45,55,25,285,0.09420289855072464,85,73,70,73,115,67,483,0.5126050420168067,2.0
114,85,70,85,80,30,464,0.2066115702479339,120,120,120,120,120,120,720,0.9344262295081968,1.0
38,35,35,65,55,50,278,0.2647058823529412,59,59,58,90,70,73,409,0.5826086956521739,0.5
58,70,45,40,45,42,300,0.25925925925925924,50,53,48,53,48,64,316,0.358974358974359,1.0
50,65,107,105,107,86,520,0.7272727272727273,35,55,40,45,40,60,275,0.35714285714285715,0.25
80,100,123,122,120,80,625,0.56,65,105,60,60,70,95,455,63.0,1.0
55,65,95,95,45,85,440,0.6610169491525424,255,10,10,75,135,55,540,0.3125,1.0
75,110,110,110,105,80,590,0.656934306569343,40,40,50,30,30,30,220,0.0873015873015873,1.0
54,63,52,83,56,97,405,0.7697841726618705,95,145,130,120,90,120,700,0.9398496240601504,0.5
38,41,40,50,65,65,299,0.4108527131782946,170,90,45,90,45,60,500,0.427536231884058,0.5
75,38,38,56,56,67,330,0.5263157894736842,35,80,50,50,70,120,405,0.84375,0.0
75,123,67,95,85,95,540,0.7642276422764228,73,95,62,85,65,85,465,0.6666666666666666,1.0
99,68,83,72,87,51,460,0.417910447761194,125,58,58,76,76,67,460,0.515625,1.0
91,72,90,129,90,108,580,0.8620689655172413,89,124,80,55,80,55,483,0.5714285714285714,0.0
65,65,60,130,95,110,525,0.823943661971831,61,78,95,56,58,57,405,0.40336134453781514,1.0
80,82,83,100,100,80,525,0.6742424242424242,60,67,85,77,75,116,480,0.8888888888888888,2.0
75,123,67,95,85,95,540,0.7642276422764228,40,60,40,40,40,30,250,0.0948905109489051,1.0
85,90,80,70,80,130,535,0.9262295081967213,79,115,70,125,80,111,580,0.8468468468468469,1.0
70,100,70,105,75,40,460,0.23214285714285715,37,25,41,25,41,25,194,0.08870967741935484,1.0
80,82,100,83,100,80,525,0.6821705426356589,60,79,105,59,85,36,424,0.17054263565891473,1.0
123,77,72,99,92,58,521,0.4621212121212121,55,55,85,65,85,35,380,0.2014388489208633,0.5
75,140,65,112,65,110,567,0.9140625,60,70,105,70,120,75,500,0.5983606557377049,0.5
65,75,90,97,123,44,494,0.1987179487179487,50,60,45,100,80,65,400,0.45689655172413796,1.0
90,85,75,115,100,115,580,0.9381443298969072,70,135,105,60,105,20,495,0.5806451612903226,1.0
250,5,5,35,105,50,450,0.15306122448979592,75,95,95,95,95,85,540,0.6470588235294118,1.0
71,120,95,120,95,99,600,0.8203125,110,85,95,80,95,50,515,0.2713178294573643,1.0
54,63,52,83,56,97,405,0.7697841726618705,45,20,50,60,120,50,345,0.24074074074074073,0.5
105,150,90,150,90,95,680,0.8285714285714286,95,75,110,100,80,30,490,0.15267175572519084,1.0
91,90,129,90,72,108,580,0.9140625,105,140,95,55,65,45,505,0.3,1.0
60,52,168,47,138,30,495,0.19834710743801653,85,105,100,79,83,78,530,0.5869565217391305,0.5
40,55,70,45,60,30,300,0.10619469026548672,45,50,35,55,75,40,300,0.21367521367521367,1.0
71,82,64,64,59,112,452,0.9327731092436975,70,60,62,80,82,60,414,0.4375,1.0
40,30,30,55,30,85,270,0.4666666666666667,90,100,70,110,150,80,600,0.6037735849056604,0.5
70,40,50,55,50,25,290,0.061068702290076333,76,65,45,92,42,91,411,0.7449664429530202,2.0
50,53,62,58,63,44,330,0.13709677419354838,75,75,60,83,60,60,413,0.39344262295081966,0.5
45,85,70,40,40,60,340,0.5229357798165137,78,84,78,109,85,100,534,0.8620689655172413,0.5
49,49,56,49,61,66,330,0.5190839694656488,90,120,100,150,120,100,680,0.7718120805369127,0.25
90,100,60,90,60,80,480,0.6422764227642277,80,100,123,122,120,80,625,0.56,0.25
80,45,65,90,110,80,470,0.5462962962962963,65,105,60,60,70,95,455,63.0,1.0
40,55,30,30,30,85,270,0.688,40,45,40,62,60,60,307,0.33884297520661155,1.0
60,100,115,70,85,90,520,0.7557251908396947,50,75,35,70,30,40,300,0.21296296296296297,1.0
75,110,110,110,105,80,590,0.656934306569343,60,80,50,40,40,30,300,0.15328467153284672,0.0
80,160,60,170,130,80,680,0.6180555555555556,55,50,65,175,95,150,590,0.7818181818181819,1.0
60,79,105,59,85,36,424,0.17054263565891473,70,65,65,55,55,70,380,0.5,1.0
60,55,145,75,150,40,525,0.2,105,130,120,45,45,40,485,0.4444444444444444,1.0
95,95,85,125,65,55,520,0.3894736842105263,55,55,55,85,55,30,335,0.1320754716981132,0.5
66,65,48,62,57,52,350,0.36220472440944884,55,40,40,65,45,35,280,0.16428571428571428,1.0
40,80,100,30,30,20,300,0.11851851851851852,80,120,130,55,65,45,495,0.37037037037037035,1.0
97,165,60,65,50,58,495,0.3902439024390244,55,85,55,50,55,60,360,0.4233576642335766,4.0
95,75,110,100,80,30,490,0.15267175572519084,50,60,60,60,60,30,320,0.11290322580645161,1.0
20,10,230,10,230,5,505,0.0,80,125,75,40,95,85,500,0.6911764705882353,0.5
70,60,75,110,75,90,480,0.7165354330708661,70,85,65,105,85,120,530,0.9262295081967213,0.5
20,25,45,70,90,60,310,0.30833333333333335,100,150,120,120,100,90,680,0.6493506493506493,2.0
50,180,20,180,20,150,600,0.9029850746268657,110,160,110,80,110,100,670,0.8591549295774648,1.0
60,110,70,60,60,100,460,0.8461538461538461,45,100,45,45,45,10,290,0.2949640287769784,1.0
40,60,30,31,31,70,262,0.4492753623188406,45,75,37,70,55,83,365,0.6183206106870229,1.0
75,125,70,125,70,115,580,0.9037037037037037,91,90,72,90,129,108,580,0.896,1.0
125,130,90,130,90,95,660,0.7734375,73,100,60,100,60,65,458,0.42657342657342656,1.0
60,30,30,36,56,50,262,0.32432432432432434,115,45,20,45,25,20,270,0.11538461538461539,1.0
60,40,80,60,45,40,325,0.23529411764705882,55,70,40,60,40,40,305,0.26956521739130435,1.0
70,75,80,135,80,135,575,0.917910447761194,50,50,40,50,40,64,294,0.45588235294117646,2.0
80,50,100,100,200,50,580,0.2357142857142857,75,90,50,110,80,95,500,0.7985611510791367,0.5
50,48,43,46,41,60,288,0.47297297297297297,71,82,64,64,59,112,452,0.9327731092436975,1.0
75,75,75,125,95,40,485,0.15671641791044777,60,50,70,80,80,140,480,0.8449612403100775,1.0
65,90,50,85,45,55,390,0.371900826446281,40,55,30,30,30,60,245,0.43548387096774194,0.5
31,45,90,30,30,40,266,0.21929824561403508,105,150,90,150,90,95,680,0.8285714285714286,0.0
40,60,40,40,40,30,250,0.0948905109489051,40,70,40,35,40,60,285,0.392,0.5
45,35,50,70,50,30,280,0.15753424657534246,80,80,50,40,50,25,325,0.176056338028169,0.5
45,50,45,115,55,95,405,0.6936936936936937,75,75,55,105,85,30,425,0.1619718309859155,2.0
55,85,55,50,55,60,360,0.4233576642335766,75,75,75,125,95,40,485,0.15671641791044777,2.0
61,84,65,70,70,70,420,0.5,55,50,40,40,40,75,300,0.5945945945945946,1.0
38,41,40,50,65,65,299,0.4108527131782946,105,130,120,45,45,40,485,0.4444444444444444,0.5
45,95,50,40,50,75,355,0.54,40,45,35,40,40,90,290,0.65,1.0
55,47,52,40,40,41,275,0.16806722689075632,60,60,60,60,60,60,360,0.38095238095238093,1.0
86,81,97,81,107,43,495,0.203125,65,90,40,45,80,75,395,0.625,0.5
120,100,85,30,85,45,465,0.22448979591836735,40,80,100,30,30,20,300,0.11851851851851852,2.0
70,40,50,55,50,25,290,0.061068702290076333,70,135,105,60,105,20,495,0.5806451612903226,0.5
50,53,48,53,48,64,316,0.4076923076923077,60,100,89,55,69,112,485,0.9298245614035088,0.25
65,80,65,35,65,60,370,0.38405797101449274,62,48,66,59,57,49,341,0.33884297520661155,1.0
50,160,110,160,110,110,700,0.8854961832061069,59,110,150,45,49,35,448,0.3333333333333333,0.25
91,72,90,129,90,108,580,0.8925619834710744,82,121,119,69,59,71,521,0.5394736842105263,2.0
85,105,100,79,83,78,530,0.5869565217391305,45,49,65,49,65,45,318,0.275,0.5
60,80,50,40,40,30,300,0.15328467153284672,45,60,40,70,50,45,310,0.2846715328467153,0.5
80,95,82,60,82,75,474,0.6,110,65,75,125,85,30,490,0.15,1.0
84,86,88,111,101,60,530,0.4634146341463415,38,35,40,27,25,35,200,0.08208955223880597,1.0
10,55,25,35,45,95,265,0.5396825396825397,75,110,110,110,105,80,590,0.656934306569343,1.0
115,45,20,45,25,20,270,0.11538461538461539,56,61,65,48,45,38,313,0.17567567567567569,1.0
95,60,79,100,125,81,540,0.6201550387596899,75,110,110,110,105,80,590,0.656934306569343,0.5
39,52,43,60,50,65,309,0.5041322314049587,75,105,75,105,75,45,480,0.3274336283185841,0.5
65,155,120,65,90,105,600,0.8677685950413223,60,79,105,59,85,36,424,0.17054263565891473,2.0
80,82,83,100,100,80,525,0.6742424242424242,55,95,55,35,75,115,430,0.9380530973451328,1.0
71,95,85,110,95,79,535,0.664,60,105,60,120,60,105,510,0.8849557522123894,1.0
75,75,60,83,60,60,413,0.39344262295081966,100,100,80,60,60,50,450,0.3050847457627119,2.0
84,71,43,71,43,48,360,0.25874125874125875,55,50,40,40,40,75,300,0.5945945945945946,1.0
55,47,52,40,40,41,275,0.16806722689075632,64,115,65,83,63,65,455,0.5323741007194245,0.5
38,30,85,55,65,30,303,0.21428571428571427,80,120,130,55,65,45,495,0.37037037037037035,1.0
35,60,44,40,54,55,288,0.366412213740458,28,25,25,45,35,40,198,0.16083916083916083,2.0
35,60,44,40,54,55,288,0.366412213740458,60,45,70,45,90,95,405,0.7304964539007093,1.0
50,40,85,40,65,25,305,0.08870967741935484,90,75,75,90,100,70,500,0.5462184873949579,1.0
80,75,150,75,150,50,580,0.30973451327433627,60,67,85,77,75,116,480,0.8888888888888888,0.5
78,52,60,63,65,23,341,0.06015037593984962,60,85,60,85,60,55,405,0.3673469387755102,1.0
105,150,90,150,90,95,680,0.8285714285714286,70,55,65,95,85,70,440,0.5307692307692308,0.5
80,100,123,122,120,80,625,0.56,70,55,65,95,85,70,440,0.5307692307692308,1.0
65,95,100,60,50,50,420,0.34959349593495936,70,45,48,60,65,35,323,0.15748031496062992,0.0
65,95,57,100,85,93,495,0.7441860465116279,80,110,60,150,130,70,600,0.5042016806722689,1.0
55,75,85,25,25,15,280,0.1875,80,95,82,60,82,75,474,0.6,1.0
45,35,45,62,53,35,275,0.11851851851851852,48,61,40,61,40,50,300,0.2543859649122807,0.5
70,90,110,60,75,95,500,0.7333333333333333,40,27,60,37,50,66,280,0.36220472440944884,2.0
55,55,55,85,55,30,335,0.1320754716981132,40,29,45,29,45,36,224,0.14634146341463414,1.0
70,100,115,30,65,30,410,0.24390243902439024,65,90,65,61,61,100,442,0.8373983739837398,2.0
75,95,95,95,95,85,540,0.6470588235294118,70,92,65,80,55,98,460,0.8090909090909091,0.5
65,80,80,59,63,58,405,0.4411764705882353,71,95,85,110,95,79,535,0.664,1.0
40,45,35,30,40,55,245,0.3793103448275862,103,93,67,71,61,84,479,0.7142857142857143,0.5
75,87,63,87,63,98,473,0.865546218487395,45,22,60,27,30,29,213,0.07518796992481203,2.0
125,58,58,76,76,67,460,0.515625,80,82,83,100,100,80,525,0.6742424242424242,0.25
45,60,30,80,50,65,330,0.4603174603174603,76,104,71,104,71,108,534,0.912751677852349,0.25
106,90,130,90,154,110,680,0.8699186991869918,64,66,68,81,76,50,405,0.25190839694656486,1.0
85,110,76,65,82,56,474,0.3933333333333333,50,50,40,30,30,50,250,0.2781954887218045,2.0
60,70,50,100,50,65,395,0.5217391304347826,89,145,90,105,80,91,600,0.8549618320610687,0.5
45,50,35,55,75,40,300,0.21367521367521367,40,27,60,37,50,66,280,0.36220472440944884,0.0
38,36,38,32,36,57,237,0.3893805309734513,90,92,87,75,85,76,505,0.5409836065573771,1.0
95,70,73,95,90,60,483,0.3983739837398374,50,30,55,65,55,20,275,0.13675213675213677,0.5
109,66,84,81,99,32,471,0.2013888888888889,35,80,50,50,70,120,405,0.84375,0.0
150,80,44,90,54,80,498,0.625,60,100,85,80,85,100,510,0.7007874015748031,4.0
65,83,57,95,85,105,490,0.8914728682170543,83,106,65,86,65,85,490,0.6640625,1.0
95,110,95,40,95,55,490,0.40336134453781514,74,108,133,83,65,32,495,0.32142857142857145,0.5
45,30,15,85,65,65,305,0.36220472440944884,125,58,58,76,76,67,460,0.515625,0.5
70,20,50,20,50,40,250,0.1557377049180328,105,130,120,45,45,40,485,0.4444444444444444,4.0
55,68,64,45,55,31,318,0.11666666666666667,95,80,105,40,70,100,490,0.8046875,1.0
165,75,80,40,45,65,470,0.5151515151515151,30,56,35,25,35,72,253,0.48148148148148145,1.0
25,35,70,95,55,45,325,0.16783216783216784,70,60,125,115,70,55,495,0.35507246376811596,2.0
50,50,150,50,150,50,500,0.2571428571428571,55,47,52,40,40,41,275,0.16806722689075632,0.5
60,130,80,60,60,70,460,0.5153846153846153,110,80,90,95,90,65,530,0.5033557046979866,4.0
73,100,60,100,60,65,458,0.42657342657342656,50,50,50,50,50,50,300,0.30708661417322836,1.0
45,49,49,65,65,45,318,0.2781954887218045,40,65,40,80,40,65,330,0.5038167938931297,1.0
49,66,70,44,55,51,335,0.4260869565217391,60,52,168,47,138,30,495,0.19834710743801653,1.0
95,100,85,108,70,70,528,0.5652173913043478,65,70,60,65,65,115,440,0.8583333333333333,1.0
43,80,65,50,35,35,308,0.14193548387096774,30,105,90,25,25,50,325,0.2773722627737226,0.5
125,130,90,130,90,95,660,0.7734375,80,82,100,83,100,80,525,0.6821705426356589,2.0
45,50,45,115,55,95,405,0.6936936936936937,76,104,71,104,71,108,534,0.912751677852349,1.0
60,65,80,170,95,130,600,0.8625954198473282,90,100,90,125,85,90,580,0.7352941176470589,1.0
35,55,40,45,40,60,275,0.35714285714285715,80,85,95,30,30,25,345,0.2857142857142857,0.0
75,100,110,45,55,65,450,0.5333333333333333,35,55,40,50,50,90,320,0.6838235294117647,2.0
65,75,70,95,70,95,470,0.7272727272727273,75,125,230,55,95,30,610,0.3448275862068966,0.5
55,45,43,55,43,72,313,0.5853658536585366,85,100,122,58,75,54,494,0.3939393939393939,2.0
60,55,145,75,150,40,525,0.2,75,95,125,45,75,95,510,0.8257575757575758,1.0
85,100,122,58,75,54,494,0.3939393939393939,85,135,130,60,80,25,515,0.40540540540540543,2.0
70,55,55,80,60,45,365,0.2222222222222222,125,130,90,130,90,95,660,0.7734375,0.5
70,140,230,60,80,50,630,0.32432432432432434,60,52,168,47,138,30,495,0.19834710743801653,1.0
70,110,75,145,85,145,630,0.9444444444444444,63,120,85,90,55,55,468,0.2809917355371901,2.0
45,63,37,65,55,95,360,0.8055555555555556,28,25,25,45,35,40,198,0.16083916083916083,1.0
50,20,55,25,25,30,205,0.09774436090225563,77,59,50,67,63,46,362,0.23140495867768596,1.0
65,80,140,40,70,70,465,0.5223880597014925,79,103,120,135,115,78,630,0.5763888888888888,0.5
78,70,61,50,61,100,420,0.8145161290322581,30,45,135,45,90,30,375,0.09285714285714286,0.5
60,25,35,70,80,60,330,0.3076923076923077,65,63,45,45,45,45,308,0.2595419847328244,1.0
41,56,40,62,44,71,314,0.568,95,80,105,40,70,100,490,0.8046875,1.0
75,103,80,70,80,92,500,0.7933884297520661,84,86,88,111,101,60,530,0.4634146341463415,0.5
45,55,45,65,45,75,330,0.5692307692307692,60,80,50,40,40,30,300,0.15328467153284672,1.0
95,95,85,125,65,55,520,0.3894736842105263,55,95,55,35,75,115,430,0.9380530973451328,0.0
50,53,48,53,48,64,316,0.46153846153846156,123,77,72,99,92,58,521,0.4621212121212121,1.0
55,65,35,60,30,85,330,0.6126126126126126,61,84,65,70,70,70,420,0.5,0.5
81,102,77,85,75,85,505,0.5642857142857143,60,60,60,105,105,105,495,0.848,0.5
50,45,45,35,35,50,260,0.23529411764705882,70,65,65,55,55,70,380,0.5,1.0
105,105,75,65,100,50,500,0.37593984962406013,103,60,126,80,126,50,545,0.36363636363636365,2.0
70,40,50,55,50,25,290,0.061068702290076333,60,79,105,59,85,36,424,0.17054263565891473,4.0
50,92,108,92,108,35,485,0.2457627118644068,91,129,90,72,90,108,580,0.8536585365853658,0.5
65,80,65,35,65,60,370,0.38405797101449274,90,130,80,65,85,55,505,0.4396551724137931,1.0
105,140,55,30,55,95,480,0.8195488721804511,103,60,86,60,86,50,445,0.3458646616541353,1.0
70,100,115,30,65,30,410,0.24390243902439024,78,92,75,74,63,118,500,0.8842975206611571,1.0
95,80,105,40,70,100,490,0.8046875,100,100,90,150,140,90,670,0.71875,1.0
40,45,35,40,40,90,290,0.65,59,110,150,45,49,35,448,0.3333333333333333,0.0
75,100,95,40,70,110,490,0.8717948717948718,62,48,66,59,57,49,341,0.33884297520661155,1.0
65,130,60,75,60,75,465,0.689922480620155,86,81,97,81,107,43,495,0.203125,1.0
45,30,15,85,65,65,305,0.36220472440944884,60,50,70,50,90,65,385,0.39568345323741005,2.0
75,75,75,125,95,40,485,0.15671641791044777,20,10,55,15,20,80,200,0.17985611510791366,1.0
85,105,85,40,50,40,405,0.211864406779661,54,78,103,53,45,22,355,0.23255813953488372,2.0
86,76,86,116,56,95,515,0.7982456140350878,100,90,130,45,65,55,485,0.4253731343283582,0.5
80,45,65,90,110,80,470,0.5462962962962963,95,117,184,44,46,28,514,0.2975206611570248,1.0
67,125,40,30,30,58,350,0.3431372549019608,60,45,70,45,90,95,405,0.7304964539007093,1.0
65,80,80,59,63,58,405,0.4411764705882353,50,75,70,35,70,48,348,0.29357798165137616,1.0
80,145,150,105,110,110,700,0.8692307692307693,70,77,60,97,60,108,472,0.8394160583941606,0.5
170,90,45,90,45,60,500,0.427536231884058,45,49,49,65,65,45,318,0.2781954887218045,0.5
41,50,37,50,37,66,281,0.5175438596491229,95,95,85,125,65,55,520,0.3894736842105263,2.0
65,95,75,55,55,85,430,0.6933333333333334,60,90,55,90,80,110,485,0.8677685950413223,1.0
90,90,85,125,90,100,580,0.768595041322314,65,40,70,80,140,70,465,0.5954198473282443,4.0
80,120,79,95,79,70,523,0.5833333333333334,82,121,119,69,59,71,521,0.5394736842105263,0.5
68,85,65,165,135,100,618,0.8083333333333333,85,100,122,58,75,54,494,0.3939393939393939,1.0
100,180,160,150,90,90,770,0.7520661157024794,70,130,100,55,80,65,500,0.608,4.0
62,55,52,109,94,109,481,0.7833333333333333,50,95,95,35,110,70,455,0.5179856115107914,1.0
60,55,145,75,150,40,525,0.2,95,155,109,70,130,81,640,0.6788321167883211,0.5
90,132,105,132,105,30,594,0.4246575342465753,85,56,77,50,77,78,423,0.53125,4.0
75,105,75,105,75,45,480,0.3274336283185841,90,95,105,165,110,45,610,0.2890625,0.5
73,95,62,85,65,85,465,0.6666666666666666,50,65,107,105,107,86,520,0.7758620689655172,1.0
20,25,45,70,90,60,310,0.30833333333333335,50,50,62,40,62,65,329,0.4188034188034188,1.0
65,136,94,54,96,135,580,0.9612403100775194,60,59,85,79,105,36,424,0.16666666666666666,0.5
126,131,95,131,98,99,680,0.8102189781021898,70,60,75,110,75,90,480,0.7165354330708661,2.0
110,78,73,76,71,60,468,0.3333333333333333,100,100,100,100,100,100,600,0.8602941176470589,0.25
73,95,62,85,65,85,465,0.6666666666666666,130,65,60,110,95,65,525,0.5227272727272727,1.0
20,10,230,10,230,5,505,0.0,165,75,80,40,45,65,470,0.5151515151515151,1.0
42,52,67,39,56,50,306,0.2868217054263566,44,50,91,24,86,10,305,0.1981981981981982,0.25
40,30,35,50,70,55,280,0.28205128205128205,50,53,62,58,63,44,330,0.13709677419354838,2.0
40,60,40,40,40,30,250,0.0948905109489051,62,44,50,44,50,55,305,0.3629032258064516,0.5
60,60,60,60,60,60,360,0.38095238095238093,85,56,77,50,77,78,423,0.53125,1.0
75,123,67,95,85,95,540,0.7642276422764228,85,60,65,135,105,100,550,0.7518248175182481,1.0
80,120,70,110,70,80,530,0.6422764227642277,60,25,35,70,80,60,330,0.3076923076923077,0.5
40,40,35,50,100,70,335,0.5031847133757962,75,98,63,98,63,101,498,0.849624060150376,0.5
75,75,130,75,130,95,580,0.7479674796747967,65,65,60,110,95,130,525,0.9253731343283582,1.0
71,120,95,120,95,99,600,0.8203125,90,70,80,70,95,70,475,0.5190839694656488,1.0
44,58,44,58,44,61,309,0.41964285714285715,110,85,95,80,95,50,515,0.2713178294573643,1.0
70,90,70,60,60,70,420,0.6390977443609023,42,52,67,39,56,50,306,0.2868217054263566,1.0
100,100,100,100,100,100,600,0.8758169934640523,95,117,80,65,70,92,519,0.8409090909090909,0.0
91,129,90,72,90,108,580,0.8536585365853658,40,30,30,55,30,85,270,0.4666666666666667,1.0
50,160,110,160,110,110,700,0.8854961832061069,50,52,48,65,50,55,320,0.33098591549295775,1.0
60,55,50,40,55,45,305,0.22377622377622378,50,50,77,95,77,91,440,0.5916666666666667,0.25
55,45,45,25,25,15,210,0.048,60,70,65,125,105,90,515,0.6911764705882353,0.5
45,67,60,35,50,63,320,0.5128205128205128,75,95,122,58,75,69,494,0.5725806451612904,0.5
58,109,112,48,48,109,484,0.8805970149253731,83,80,75,70,70,101,479,0.8615384615384616,0.5
50,160,110,160,110,110,700,0.8854961832061069,50,60,60,60,60,30,320,0.11290322580645161,0.5
86,81,97,81,107,43,495,0.203125,40,27,60,37,50,66,280,0.36220472440944884,0.5
75,75,75,125,95,40,485,0.15671641791044777,70,85,70,60,70,50,405,0.28378378378378377,2.0
65,95,100,60,50,50,420,0.34959349593495936,55,130,115,50,50,75,475,0.5982142857142857,1.0
20,25,45,70,90,60,310,0.30833333333333335,41,56,40,62,44,71,314,0.568,1.0
103,60,126,80,126,50,545,0.36363636363636365,20,40,15,35,35,60,205,0.34285714285714286,1.0
80,50,100,100,200,50,580,0.2357142857142857,72,58,80,103,80,97,490,0.7171052631578947,2.0
40,60,40,40,40,30,250,0.0948905109489051,99,68,83,72,87,51,460,0.417910447761194,2.0
75,125,230,55,95,30,610,0.3448275862068966,65,85,70,75,70,40,405,0.203125,1.0
110,78,73,76,71,60,468,0.3333333333333333,84,86,88,111,101,60,530,0.4634146341463415,1.0
40,40,55,40,70,55,300,0.40939597315436244,38,30,41,30,41,60,240,0.2897196261682243,1.0
71,95,85,110,95,79,535,0.664,100,100,100,100,100,100,600,0.8602941176470589,2.0
64,165,75,93,83,75,555,0.6587301587301587,45,30,15,85,65,65,305,0.36220472440944884,2.0
55,81,60,50,70,97,413,0.7214285714285714,59,74,50,35,50,35,303,0.3125,0.0
80,185,115,40,105,75,600,0.6230769230769231,90,100,60,90,60,80,480,0.6422764227642277,8.0
65,73,55,47,75,85,400,0.6846846846846847,60,80,50,50,50,40,330,0.23853211009174313,1.0
50,53,62,58,63,44,330,0.13709677419354838,40,29,45,29,45,36,224,0.14634146341463414,1.0
45,60,30,80,50,65,330,0.4603174603174603,68,125,65,65,115,80,518,0.6277372262773723,1.0
65,125,100,60,70,70,490,0.6099290780141844,86,68,72,109,66,106,507,0.8099173553719008,0.5
99,68,83,72,87,51,460,0.417910447761194,50,64,50,45,50,41,300,0.22727272727272727,2.0
85,120,70,50,60,100,485,0.8308823529411765,85,90,80,70,80,130,535,0.9262295081967213,1.0
80,80,80,80,80,80,480,0.6015037593984962,70,110,80,55,80,105,500,0.8794326241134752,2.0
72,58,80,103,80,97,490,0.7171052631578947,72,60,30,20,30,25,237,0.11570247933884298,2.0
39,52,43,60,50,65,309,0.49107142857142855,106,110,90,154,90,130,680,0.926829268292683,1.0
105,140,55,30,55,95,480,0.8195488721804511,110,65,105,55,95,80,510,0.6258503401360545,1.0
40,60,40,40,40,30,250,0.0948905109489051,65,80,140,40,70,70,465,0.5223880597014925,0.0
59,66,70,44,55,41,335,0.25190839694656486,65,80,80,59,63,58,405,0.4411764705882353,2.0
60,85,49,60,49,60,363,0.4444444444444444,55,69,85,32,35,28,304,0.09302325581395349,1.0
95,75,180,130,80,30,590,0.13793103448275862,60,85,60,50,50,125,430,0.9090909090909091,1.0
60,85,42,85,42,91,405,0.8227848101265823,50,150,50,150,50,150,600,0.9339622641509434,2.0
84,71,43,71,43,48,360,0.25874125874125875,90,90,85,125,90,100,580,0.768595041322314,1.0
80,100,70,50,60,45,405,0.25806451612903225,35,70,55,45,55,25,285,0.09420289855072464,0.5
65,90,65,61,61,100,442,0.8373983739837398,40,20,30,40,80,55,265,0.22764227642276422,2.0
60,80,50,40,40,30,300,0.15328467153284672,60,50,40,85,75,95,405,0.7540983606557377,1.0
50,47,50,57,50,65,319,0.463768115942029,80,100,200,50,100,50,580,0.3472222222222222,1.0
45,30,35,20,20,45,195,0.14782608695652175,85,105,100,79,83,78,530,0.5869565217391305,1.0
106,110,90,154,90,130,680,0.926829268292683,76,104,71,104,71,108,534,0.912751677852349,1.0
74,48,76,83,81,104,466,0.7913043478260869,114,85,70,85,80,30,464,0.2066115702479339,2.0
50,30,55,65,55,20,275,0.13675213675213677,70,70,115,130,90,60,535,0.5338983050847458,2.0
65,75,105,35,65,85,430,0.6940298507462687,55,65,35,60,30,85,330,0.6126126126126126,1.0
70,130,100,55,80,65,500,0.608,95,65,110,60,130,65,525,0.5275590551181102,2.0
50,50,40,50,40,64,294,0.45588235294117646,65,125,60,95,60,105,510,0.9236641221374046,1.0
50,160,110,160,110,110,700,0.8854961832061069,70,80,102,80,102,40,474,0.2677165354330709,4.0
50,20,55,25,25,30,205,0.09774436090225563,68,72,78,38,42,32,330,0.23809523809523808,1.0
70,83,50,37,50,60,350,0.3360655737704918,100,75,115,90,115,85,580,0.6446280991735537,1.0
81,102,77,85,75,85,505,0.5642857142857143,78,65,68,112,154,75,552,0.628099173553719,2.0
95,117,184,44,46,28,514,0.2975206611570248,60,60,60,105,105,105,495,0.848,1.0
95,117,80,65,70,92,519,0.8409090909090909,80,100,200,50,100,50,580,0.3472222222222222,2.0
65,65,60,130,95,110,525,0.823943661971831,40,40,40,70,40,20,250,0.032520325203252036,1.0
30,45,55,70,55,85,340,0.5633802816901409,45,20,50,60,120,50,345,0.24074074074074073,0.5
40,50,45,70,45,70,320,0.5517241379310345,30,80,90,55,45,55,355,0.4295774647887324,0.5
50,53,48,53,48,64,316,0.46153846153846156,30,40,55,40,55,60,280,0.3237410071942446,1.0
40,30,30,55,30,85,270,0.4666666666666667,45,90,20,65,20,65,305,0.5116279069767442,0.5
110,130,80,70,60,80,530,0.5862068965517241,90,95,105,165,110,45,610,0.2890625,4.0
91,72,90,129,90,108,580,0.8620689655172413,65,90,50,85,45,55,390,0.371900826446281,0.25
50,65,85,35,35,55,325,0.32575757575757575,60,48,45,43,90,42,328,0.21897810218978103,2.0
40,20,30,40,80,55,265,0.22764227642276422,70,20,50,20,50,40,250,0.1557377049180328,0.5
65,73,55,47,75,85,400,0.6846846846846847,82,80,86,85,75,72,480,0.6183206106870229,0.5
54,66,70,44,55,46,335,0.4214876033057851,70,43,53,43,53,40,302,0.19090909090909092,0.5
65,47,55,73,75,85,400,0.65,150,120,100,120,100,90,680,0.664179104477612,0.5
70,84,70,65,70,51,410,0.2949640287769784,95,125,79,60,100,81,540,0.6165413533834586,0.0
50,50,77,95,77,91,440,0.5916666666666667,60,82,45,45,45,74,351,0.5752212389380531,0.0
60,65,70,85,75,40,395,0.21705426356589147,60,45,50,90,80,70,395,0.625,0.25
91,134,95,100,100,80,600,0.6304347826086957,56,61,65,48,45,38,313,0.17567567567567569,2.0
60,95,80,60,80,30,405,0.19480519480519481,20,25,45,70,90,60,310,0.30833333333333335,1.0
100,128,90,77,77,128,600,0.959349593495935,75,65,55,65,55,69,384,0.43548387096774194,1.0
70,60,125,115,70,55,495,0.35507246376811596,79,105,70,145,80,101,580,0.8608695652173913,2.0
85,110,76,65,82,56,474,0.3933333333333333,70,80,50,35,35,35,305,0.14,1.0
79,115,70,125,80,111,580,0.864,51,65,65,80,75,59,395,0.4365079365079365,1.0
63,63,47,41,41,74,329,0.56,80,125,75,40,95,85,500,0.6911764705882353,0.5
70,110,80,55,80,105,500,0.8794326241134752,70,70,70,70,70,70,420,0.5289256198347108,1.0
49,55,42,42,37,85,310,0.6068376068376068,65,100,70,80,80,105,500,0.8666666666666667,1.0
45,60,40,70,50,45,310,0.2846715328467153,80,105,65,60,75,130,515,0.9645390070921985,0.5
80,70,65,80,120,100,515,0.8034188034188035,40,65,40,80,40,65,330,0.5038167938931297,1.0
95,23,48,23,48,23,260,0.046153846153846156,65,80,65,35,65,60,370,0.38405797101449274,1.0
95,70,73,95,90,60,483,0.3983739837398374,95,65,65,110,130,60,525,0.4016393442622951,1.0
80,110,120,130,90,70,600,0.6198347107438017,62,73,55,56,52,84,382,0.7244094488188977,1.0
250,5,5,35,105,50,450,0.15306122448979592,100,100,100,100,100,100,600,0.8805970149253731,1.0
95,135,80,110,80,100,600,0.8248175182481752,75,125,70,125,70,115,580,0.9037037037037037,1.0
65,63,45,45,45,45,308,0.2595419847328244,65,136,94,54,96,135,580,0.9612403100775194,1.0
110,123,65,100,65,65,528,0.5217391304347826,100,100,100,100,100,100,600,0.8778625954198473,0.25
75,80,55,25,35,35,305,0.18666666666666668,35,35,35,35,35,35,210,0.13385826771653545,1.0
65,63,45,45,45,45,308,0.2595419847328244,55,75,50,40,40,80,340,0.6302521008403361,1.0
65,65,60,110,95,130,525,0.9253731343283582,35,65,35,65,35,65,300,0.46621621621621623,2.0
90,93,55,70,55,55,418,0.3819444444444444,60,105,60,120,60,105,510,0.8849557522123894,2.0
40,45,35,30,40,55,245,0.3793103448275862,45,30,35,20,20,45,195,0.14782608695652175,2.0
50,65,107,105,107,86,520,0.7272727272727273,30,56,35,25,35,72,253,0.48148148148148145,1.0
89,145,90,105,80,91,600,0.8549618320610687,77,85,51,55,51,65,384,0.5163934426229508,1.0
75,100,66,60,66,115,482,0.918918918918919,80,100,123,122,120,80,625,0.56,1.0
85,120,70,50,60,100,485,0.8308823529411765,70,110,70,115,70,90,525,0.75,0.5
80,115,80,65,55,93,488,0.7846153846153846,58,109,112,48,48,109,484,0.8805970149253731,0.5
40,30,30,55,30,85,270,0.4666666666666667,74,94,131,54,116,20,489,0.4485294117647059,0.5
60,80,50,50,50,40,330,0.23853211009174313,44,58,44,58,44,61,309,0.41964285714285715,1.0
50,50,120,80,80,30,410,0.07258064516129033,85,70,80,97,80,123,535,0.9304347826086956,1.0
40,55,30,30,30,60,245,0.43548387096774194,50,50,77,95,77,91,440,0.5916666666666667,0.0
60,85,40,30,45,68,328,0.6422018348623854,68,85,65,165,135,100,618,0.8083333333333333,1.0
55,104,105,94,75,52,485,0.36363636363636365,30,35,30,100,35,80,310,0.4765625,1.0
100,100,100,100,100,100,600,0.8805970149253731,77,120,90,60,90,48,485,0.2785714285714286,0.5
50,60,45,100,80,65,400,0.45689655172413796,71,73,88,120,89,59,500,0.43537414965986393,2.0
100,75,115,90,115,85,580,0.6446280991735537,72,60,30,20,30,25,237,0.11570247933884298,1.0
40,65,40,80,40,65,330,0.5038167938931297,80,80,80,80,80,80,480,0.5606060606060606,1.0
40,60,40,40,40,30,250,0.0948905109489051,55,68,64,45,55,31,318,0.11666666666666667,4.0
100,100,90,150,140,90,670,0.71875,90,85,75,115,100,115,580,0.9381443298969072,1.0
60,48,45,43,90,42,328,0.21897810218978103,45,100,135,65,135,45,525,0.29411764705882354,1.0
75,75,55,105,85,30,425,0.1619718309859155,60,55,90,145,90,80,520,0.6071428571428571,0.5
65,75,70,95,70,95,470,0.7272727272727273,42,52,67,39,56,50,306,0.2868217054263566,0.5
70,85,140,85,70,20,470,0.272,64,78,52,78,52,81,405,0.6422764227642277,0.5
90,100,70,110,150,80,600,0.6037735849056604,80,160,80,130,80,100,630,0.8455284552845529,1.0
100,120,120,150,100,90,680,0.7880794701986755,92,105,90,125,90,98,600,0.8217054263565892,2.0
60,85,49,60,49,60,363,0.4444444444444444,120,70,120,75,130,85,600,0.6694915254237288,1.0
78,65,68,112,154,75,552,0.628099173553719,64,66,68,81,76,50,405,0.25190839694656486,1.0
30,45,55,70,55,85,340,0.5633802816901409,75,80,85,110,90,50,490,0.3548387096774194,0.5
100,100,100,100,100,100,600,0.8778625954198473,43,80,65,50,35,35,308,0.14193548387096774,0.5
95,135,80,110,80,100,600,0.8248175182481752,95,65,65,110,130,60,525,0.4016393442622951,0.0
60,60,50,40,50,75,335,0.5882352941176471,51,65,65,80,75,59,395,0.4365079365079365,1.0
100,123,75,57,75,80,510,0.6923076923076923,44,75,35,63,33,45,295,0.2647058823529412,0.0
106,110,90,154,90,130,680,0.926829268292683,68,75,53,83,113,60,452,0.45384615384615384,1.0
30,30,30,30,30,30,180,0.12612612612612611,50,35,55,25,25,15,205,0.05263157894736842,0.5
10,55,25,35,45,95,265,0.5396825396825397,106,150,70,194,120,140,780,0.952,1.0
60,60,60,85,85,85,435,0.631578947368421,60,70,105,70,120,75,500,0.5983606557377049,2.0
90,100,70,110,150,80,600,0.6037735849056604,75,95,67,125,95,83,540,0.7117117117117117,1.0
40,29,45,29,45,36,224,0.14634146341463414,45,35,50,70,50,30,280,0.15753424657534246,2.0
108,100,121,81,95,95,600,0.7476635514018691,75,95,60,65,60,115,470,0.8778625954198473,1.0
50,120,53,35,110,87,455,0.640625,78,52,60,63,65,23,341,0.06015037593984962,0.5
110,80,90,95,90,65,530,0.5033557046979866,125,58,58,76,76,67,460,0.515625,0.25
95,117,80,65,70,92,519,0.8409090909090909,35,65,35,65,35,65,300,0.46621621621621623,1.0
165,75,80,40,45,65,470,0.5151515151515151,70,60,70,87,78,85,450,0.6228070175438597,0.5
60,70,105,70,120,75,500,0.5983606557377049,95,145,130,120,90,120,700,0.9398496240601504,0.0
90,60,60,40,40,40,330,0.29545454545454547,35,55,40,45,40,60,275,0.35714285714285715,2.0
35,35,35,35,35,35,210,0.13385826771653545,40,45,40,65,40,65,295,0.5661764705882353,1.0
64,78,52,78,52,81,405,0.6422764227642277,56,61,65,48,45,38,313,0.17567567567567569,2.0
59,66,70,44,55,41,335,0.25190839694656486,60,60,60,105,105,105,495,0.848,2.0
60,105,60,120,60,105,510,0.8849557522123894,45,49,49,65,65,45,318,0.2781954887218045,1.0
67,89,116,79,116,33,500,0.2624113475177305,70,80,102,80,102,40,474,0.2677165354330709,1.0
30,30,30,30,30,30,180,0.12612612612612611,58,109,112,48,48,109,484,0.8805970149253731,0.25
62,48,66,59,57,49,341,0.33884297520661155,83,106,65,86,65,85,490,0.6640625,1.0
70,83,50,37,50,60,350,0.3360655737704918,80,70,65,80,120,100,515,0.8034188034188035,1.0
65,65,45,75,45,95,390,0.72,63,60,55,50,50,71,349,0.5289256198347108,0.5
80,85,95,30,30,25,345,0.2857142857142857,90,120,100,150,120,100,680,0.7718120805369127,1.0
60,110,70,60,60,100,460,0.8461538461538461,39,52,43,60,50,65,309,0.5041322314049587,1.0
103,60,86,60,86,50,445,0.3458646616541353,80,80,80,55,55,90,440,0.6417910447761194,1.0
50,75,35,70,30,40,300,0.21296296296296297,78,65,68,112,154,75,552,0.628099173553719,2.0
85,120,70,50,60,100,485,0.8308823529411765,60,70,50,100,50,65,395,0.5217391304347826,2.0
120,120,120,120,120,120,720,0.9344262295081968,90,75,85,115,90,55,510,0.3445378151260504,1.0
62,55,52,109,94,109,481,0.7833333333333333,90,100,90,125,85,90,580,0.7352941176470589,2.0
80,110,60,150,130,70,600,0.5042016806722689,40,30,35,45,40,55,245,0.31496062992125984,1.0
80,105,105,105,105,80,580,0.5939849624060151,120,100,85,30,85,45,465,0.22448979591836735,1.0
60,60,60,60,60,60,360,0.38095238095238093,75,125,230,55,95,30,610,0.3448275862068966,0.5
30,65,100,45,25,40,305,0.1891891891891892,45,50,45,115,55,95,405,0.6936936936936937,1.0
106,110,90,154,90,130,680,0.926829268292683,45,75,37,70,55,83,365,0.6183206106870229,1.0
75,87,63,87,63,98,473,0.865546218487395,60,85,69,60,69,77,420,0.518796992481203,1.0
55,40,50,65,85,40,335,0.3181818181818182,60,55,90,145,90,80,520,0.6071428571428571,4.0
40,45,40,65,40,65,295,0.5661764705882353,30,30,42,30,42,70,244,0.4230769230769231,2.0
30,45,55,70,55,85,340,0.5633802816901409,45,35,50,70,50,30,280,0.15753424657534246,0.5
100,164,150,95,120,71,700,0.5645161290322581,100,50,50,76,96,70,442,0.5,2.0
41,50,37,50,37,66,281,0.5175438596491229,70,105,105,50,40,20,390,0.33587786259541985,1.0
60,60,60,105,105,105,495,0.848,60,50,70,50,90,65,385,0.39568345323741005,1.0
54,78,103,53,45,22,355,0.23255813953488372,55,65,95,95,45,85,440,0.6610169491525424,0.5
65,55,115,100,40,60,435,0.3798449612403101,86,76,86,116,56,95,515,0.7982456140350878,0.25
75,125,70,125,70,115,580,0.9037037037037037,41,56,40,62,44,71,314,0.568,1.0
35,35,40,35,55,50,250,0.40336134453781514,100,90,130,45,65,55,485,0.4253731343283582,2.0
82,121,119,69,59,71,521,0.5394736842105263,35,46,34,35,45,20,215,0.072,1.0
65,80,140,40,70,70,465,0.5223880597014925,59,74,50,35,50,35,303,0.3125,1.0
40,29,45,29,45,36,224,0.14634146341463414,45,55,39,35,39,42,255,0.18518518518518517,1.0
60,48,45,43,90,42,328,0.21897810218978103,95,80,105,40,70,100,490,0.8046875,1.0
60,62,50,62,60,40,334,0.18181818181818182,75,87,63,87,63,98,473,0.865546218487395,1.0
78,84,78,109,85,100,534,0.8646616541353384,120,100,85,30,85,45,465,0.22448979591836735,2.0
70,75,80,135,80,135,575,0.917910447761194,20,40,15,35,35,60,205,0.34285714285714286,0.5
65,65,60,130,95,110,525,0.823943661971831,50,105,79,35,110,76,455,0.6214285714285714,1.0
70,90,45,15,45,50,315,0.3629032258064516,50,45,45,35,35,50,260,0.23529411764705882,1.0
70,70,70,70,70,70,420,0.5289256198347108,60,40,60,40,60,35,295,0.18055555555555555,1.0
103,60,86,60,86,50,445,0.3458646616541353,55,40,85,80,105,40,405,0.23622047244094488,1.0
50,53,62,58,63,44,330,0.13709677419354838,57,80,91,80,87,75,470,0.5737704918032787,1.0
60,110,70,60,60,100,460,0.8461538461538461,55,50,45,135,95,120,500,0.7714285714285715,1.0
65,75,105,35,65,85,430,0.6940298507462687,50,60,45,100,80,65,400,0.45689655172413796,2.0
99,68,83,72,87,51,460,0.417910447761194,76,65,45,92,42,91,411,0.7449664429530202,0.5
58,70,45,40,45,42,300,0.25925925925925924,80,120,70,110,70,80,530,0.6422764227642277,2.0
60,60,40,65,45,35,305,0.15833333333333333,75,100,63,80,63,116,497,0.9345794392523364,2.0
92,105,90,125,90,98,600,0.8217054263565892,65,130,60,95,110,65,525,0.5303030303030303,1.0
89,145,90,105,80,91,600,0.8549618320610687,50,70,50,50,50,40,310,0.16296296296296298,1.0
65,65,65,50,50,90,385,0.72,68,90,65,50,55,82,410,0.6165413533834586,1.0
50,30,55,65,55,20,275,0.13675213675213677,55,40,40,65,45,35,280,0.16428571428571428,1.0
35,85,45,35,35,75,310,0.6492537313432836,80,125,75,40,95,85,500,0.6911764705882353,4.0
75,38,38,56,56,67,330,0.5263157894736842,45,80,100,35,37,28,325,0.3125,1.0
100,120,120,150,100,90,680,0.7880794701986755,80,120,70,110,70,80,530,0.6422764227642277,0.5
35,60,44,40,54,55,288,0.366412213740458,60,85,60,50,50,125,430,0.9090909090909091,1.0
49,66,70,44,55,51,335,0.4260869565217391,75,90,90,140,90,115,600,0.9481481481481482,0.25
40,30,30,40,50,30,220,0.07936507936507936,55,50,40,40,40,75,300,0.5945945945945946,1.0
90,110,80,100,80,95,555,0.7982456140350878,50,35,55,25,25,15,205,0.021739130434782608,2.0
75,90,50,110,80,95,500,0.7985611510791367,65,50,35,115,95,95,455,0.7333333333333333,4.0
75,80,60,65,90,102,472,0.8625954198473282,54,45,47,75,98,52,371,0.39669421487603307,1.0
38,35,35,65,55,50,278,0.2647058823529412,80,82,100,83,100,80,525,0.6821705426356589,1.0
75,75,130,75,130,95,580,0.7479674796747967,120,70,120,75,130,85,600,0.6694915254237288,0.5
100,75,115,90,115,85,580,0.6446280991735537,72,60,30,20,30,25,237,0.11570247933884298,1.0
80,70,70,90,100,70,480,0.5609756097560976,44,50,91,24,86,10,305,0.1981981981981982,0.125
40,70,40,35,40,60,285,0.392,20,10,230,10,230,5,505,0.0,1.0
250,5,5,35,105,50,450,0.15306122448979592,48,72,48,72,48,48,336,0.25984251968503935,1.0
75,95,67,125,95,83,540,0.7117117117117117,64,88,50,88,50,106,446,0.9111111111111111,1.0
65,76,84,54,96,105,480,0.9008264462809917,76,65,45,92,42,91,411,0.7449664429530202,1.0
70,130,100,55,80,65,500,0.608,50,65,90,35,35,15,290,0.14678899082568808,1.0
74,48,76,83,81,104,466,0.7322834645669292,10,55,25,35,45,95,265,0.5396825396825397,2.0
100,90,130,45,65,55,485,0.4253731343283582,60,55,145,75,150,40,525,0.2,1.0
80,115,80,65,55,93,488,0.7846153846153846,65,75,90,97,123,44,494,0.1987179487179487,1.0
70,70,115,130,90,60,535,0.5338983050847458,50,50,40,30,30,50,250,0.2781954887218045,0.0
90,85,75,115,100,115,580,0.9381443298969072,90,65,65,40,40,15,315,0.19672131147540983,2.0
50,85,85,55,55,50,380,0.3902439024390244,55,47,52,40,40,41,275,0.16806722689075632,0.5
60,55,50,40,55,45,305,0.22377622377622378,70,40,50,55,50,25,290,0.061068702290076333,1.0
71,73,88,120,89,59,500,0.43537414965986393,75,80,95,90,100,50,490,0.2158273381294964,0.5
40,60,30,31,31,70,262,0.4492753623188406,70,145,88,140,70,112,625,0.8888888888888888,0.5
79,103,120,135,115,78,630,0.5763888888888888,80,120,70,110,70,80,530,0.6422764227642277,2.0
108,100,121,81,95,95,600,0.7476635514018691,65,60,70,85,75,40,395,0.1796875,1.0
68,75,53,83,113,60,452,0.45384615384615384,60,70,65,125,105,90,515,0.6911764705882353,1.0
66,117,70,40,50,67,410,0.4573643410852713,30,105,90,25,25,50,325,0.2773722627737226,1.0
67,82,62,46,48,43,348,0.22033898305084745,90,85,100,95,125,85,580,0.6834532374100719,1.0
60,65,70,85,75,40,395,0.21705426356589147,108,112,118,68,72,47,525,0.2916666666666667,1.0
56,61,65,48,45,38,313,0.17567567567567569,45,49,49,65,65,45,318,0.2781954887218045,0.25
40,45,35,65,55,70,310,0.4482758620689655,60,95,80,60,80,30,405,0.19480519480519481,0.25
72,58,80,103,80,97,490,0.7171052631578947,50,160,110,160,110,110,700,0.8854961832061069,0.5
70,90,90,135,90,125,600,0.9401709401709402,30,56,35,25,35,72,253,0.48148148148148145,1.0
53,54,53,37,46,45,288,0.3090909090909091,80,70,70,90,100,70,480,0.5609756097560976,1.0
90,120,100,150,120,100,680,0.7718120805369127,41,64,45,50,50,50,300,0.36752136752136755,1.0
55,45,43,55,43,72,313,0.5853658536585366,60,65,70,85,75,40,395,0.21705426356589147,4.0
55,65,35,60,30,85,330,0.6126126126126126,115,115,85,90,75,100,580,0.8134328358208955,2.0
45,20,50,60,120,50,345,0.24074074074074073,60,90,140,50,50,40,430,0.2535211267605634,0.5
60,75,85,100,85,115,520,0.8992248062015504,55,55,85,65,85,35,380,0.2014388489208633,1.0
50,85,40,85,40,35,335,0.1746031746031746,58,50,145,95,105,30,483,0.2459016393442623,1.0
75,90,50,110,80,95,500,0.7985611510791367,100,50,80,60,80,50,420,0.34375,0.25
35,64,85,74,55,32,345,0.19827586206896552,65,65,65,50,50,90,385,0.72,0.5
90,85,75,115,100,115,580,0.9381443298969072,95,23,48,23,48,23,260,0.046153846153846156,1.0
60,115,105,65,70,80,495,0.7181818181818181,38,30,85,55,65,30,303,0.21428571428571427,1.0
60,40,60,95,60,55,370,0.4222222222222222,50,53,48,53,48,64,316,0.4076923076923077,2.0
55,63,90,50,80,42,380,0.21138211382113822,40,55,70,45,60,30,300,0.10619469026548672,0.25
70,85,140,85,70,20,470,0.272,75,103,80,70,80,92,500,0.7933884297520661,4.0
70,50,30,95,135,105,485,0.8040540540540541,89,145,90,105,80,91,600,0.8549618320610687,4.0
60,48,45,43,90,42,328,0.21897810218978103,40,29,45,29,45,36,224,0.14634146341463414,1.0
100,75,115,90,115,85,580,0.6446280991735537,55,65,95,95,45,85,440,0.6610169491525424,0.5
35,35,35,35,35,35,210,0.13385826771653545,100,120,100,150,120,90,680,0.728,1.0
80,110,120,130,90,70,600,0.6198347107438017,80,92,65,65,80,68,450,0.4824561403508772,0.25
59,110,150,45,49,35,448,0.3333333333333333,70,105,105,50,40,20,390,0.33587786259541985,2.0
100,50,50,76,96,70,442,0.5,60,85,42,85,42,91,405,0.8227848101265823,1.0
40,45,35,65,55,70,310,0.4482758620689655,120,120,120,120,120,120,720,0.9344262295081968,1.0
72,85,70,65,70,58,420,0.41304347826086957,100,110,90,85,90,60,535,0.47794117647058826,1.0
50,50,40,50,40,64,294,0.45588235294117646,80,100,70,50,60,45,405,0.25806451612903225,1.0
60,45,50,90,80,70,395,0.625,91,90,72,90,129,108,580,0.896,4.0
50,70,160,70,160,90,600,0.7417218543046358,90,95,95,70,90,70,510,0.5230769230769231,1.0
50,70,100,40,40,30,330,0.2222222222222222,45,35,45,62,53,35,275,0.11851851851851852,1.0
95,100,85,108,70,70,528,0.5652173913043478,35,35,35,35,35,35,210,0.13385826771653545,1.0
78,84,78,109,85,100,534,0.8646616541353384,60,85,42,85,42,91,405,0.8227848101265823,1.0
85,80,70,135,75,90,535,0.7006802721088435,85,105,85,40,50,40,405,0.211864406779661,1.0
75,89,85,55,65,36,405,0.29545454545454547,20,15,20,10,55,80,200,0.2682926829268293,2.0
80,100,200,50,100,50,580,0.3472222222222222,75,98,63,98,63,101,498,0.889763779527559,2.0
65,90,115,45,115,58,488,0.5041322314049587,30,45,59,30,39,57,260,0.2803030303030303,0.25
40,65,95,60,45,35,340,0.13986013986013987,65,90,115,45,115,58,488,0.5041322314049587,1.0
38,41,40,50,65,65,299,0.4108527131782946,100,164,150,95,120,71,700,0.5645161290322581,0.5
86,92,88,68,75,73,482,0.6835443037974683,65,40,70,80,140,70,465,0.5954198473282443,1.0
65,65,65,50,50,90,385,0.72,90,70,80,70,95,70,475,0.5190839694656488,0.5
89,145,90,105,80,91,600,0.8549618320610687,95,65,65,110,130,60,525,0.4016393442622951,1.0
80,110,60,150,130,70,600,0.5042016806722689,60,50,40,85,75,95,405,0.7540983606557377,1.0
80,125,75,40,95,85,500,0.6911764705882353,50,35,55,25,25,15,205,0.05263157894736842,0.5
45,22,60,27,30,29,213,0.07518796992481203,70,90,90,135,90,125,600,0.9401709401709402,2.0
43,80,65,50,35,35,308,0.14193548387096774,50,70,50,50,50,40,310,0.16296296296296298,0.5
40,45,40,35,35,56,251,0.373015873015873,64,66,68,81,76,50,405,0.25190839694656486,1.0
65,80,65,35,65,60,370,0.38405797101449274,60,60,60,35,35,30,280,0.11194029850746269,1.0
70,70,40,60,40,60,340,0.4247787610619469,80,185,115,40,105,75,600,0.6230769230769231,0.25
95,110,95,40,95,55,490,0.40336134453781514,50,80,95,10,45,10,290,0.232,0.5
90,120,75,60,60,45,450,0.29411764705882354,90,70,80,70,95,70,475,0.5190839694656488,1.0
86,76,86,116,56,95,515,0.7982456140350878,55,95,115,45,45,35,390,0.2116788321167883,0.5
106,110,90,154,90,130,680,0.926829268292683,65,90,122,58,75,84,494,0.71875,1.0
45,22,60,27,30,29,213,0.07518796992481203,65,40,70,80,140,70,465,0.5954198473282443,0.5
60,40,60,40,60,35,295,0.18055555555555555,80,120,130,55,65,45,495,0.37037037037037035,4.0
90,120,100,150,120,100,680,0.7718120805369127,95,85,85,65,65,35,430,0.2571428571428571,1.0
84,71,43,71,43,48,360,0.25874125874125875,55,95,115,45,45,35,390,0.2116788321167883,0.5
50,50,95,40,50,35,320,0.20279720279720279,70,65,60,90,75,90,450,0.6571428571428571,1.0
70,90,70,60,60,70,420,0.6390977443609023,100,100,100,100,100,100,600,0.8805970149253731,1.0
110,160,110,80,110,100,670,0.8591549295774648,100,75,115,90,115,85,580,0.6446280991735537,1.0
60,79,105,59,85,36,424,0.17054263565891473,78,84,78,109,85,100,534,0.8646616541353384,0.0
108,130,95,80,85,102,600,0.7637795275590551,95,85,85,65,65,35,430,0.2571428571428571,1.0
86,92,88,68,75,73,482,0.6835443037974683,65,50,70,95,80,65,425,0.4262295081967213,1.0
30,40,70,70,25,60,295,0.41353383458646614,75,80,70,65,75,90,455,0.7578125,1.0
70,110,80,55,80,105,500,0.8794326241134752,70,62,67,55,55,56,365,0.38513513513513514,0.5
50,65,85,35,35,55,325,0.32575757575757575,85,135,130,60,80,25,515,0.40540540540540543,1.0
67,58,57,81,67,101,431,0.8790322580645161,43,70,48,50,60,38,309,0.2391304347826087,0.5
60,130,80,60,60,70,460,0.5153846153846153,70,55,65,95,85,70,440,0.5307692307692308,2.0
70,60,75,110,75,90,480,0.7165354330708661,75,125,75,30,75,85,465,0.625,1.0
85,105,100,79,83,78,530,0.5869565217391305,58,50,145,95,105,30,483,0.2459016393442623,1.0
64,51,23,51,23,28,240,0.11363636363636363,59,63,80,65,80,58,405,0.41843971631205673,1.0
64,51,23,51,23,28,240,0.11363636363636363,41,56,40,62,44,71,314,0.568,1.0
80,45,65,90,110,80,470,0.5462962962962963,50,65,107,105,107,86,520,0.6991150442477876,1.0
70,140,70,110,65,105,560,0.95,64,78,52,78,52,81,405,0.6422764227642277,1.0
51,65,65,80,75,59,395,0.4365079365079365,65,50,70,95,80,65,425,0.4262295081967213,1.0
108,130,95,80,85,102,600,0.7637795275590551,100,110,90,85,90,60,535,0.47794117647058826,1.0
40,65,40,80,40,65,330,0.5038167938931297,70,115,60,115,60,55,475,0.4647887323943662,0.5
95,75,110,100,80,30,490,0.15267175572519084,60,60,60,35,35,30,280,0.11194029850746269,1.0
90,95,95,70,90,70,510,0.5230769230769231,44,50,91,24,86,10,305,0.1981981981981982,1.0
65,90,122,58,75,84,494,0.71875,50,60,60,60,60,30,320,0.11290322580645161,1.0
109,66,84,81,99,32,471,0.2013888888888889,255,10,10,75,135,55,540,0.3125,1.0
50,53,48,53,48,64,316,0.4076923076923077,50,53,48,53,48,64,316,0.46153846153846156,0.5
65,130,60,75,60,75,465,0.689922480620155,70,90,45,15,45,50,315,0.3629032258064516,1.0
59,63,80,65,80,58,405,0.41843971631205673,95,80,105,40,70,100,490,0.8046875,1.0
90,90,85,125,90,100,580,0.768595041322314,35,65,35,65,35,65,300,0.46621621621621623,2.0
95,109,105,75,85,56,525,0.34513274336283184,70,90,110,60,75,95,500,0.7333333333333333,1.0
70,60,70,87,78,85,450,0.6228070175438597,45,30,40,105,50,20,290,0.031007751937984496,1.0
50,95,95,35,110,70,455,0.5179856115107914,55,85,122,58,75,99,494,0.8099173553719008,0.0
44,75,35,63,33,45,295,0.2647058823529412,80,80,80,80,80,80,480,0.5606060606060606,1.0
150,120,100,120,100,90,680,0.664179104477612,91,90,106,130,106,77,600,0.648854961832061,0.5
90,92,87,75,85,76,505,0.5409836065573771,85,90,80,70,80,130,535,0.9262295081967213,0.0
80,100,200,50,100,50,580,0.3472222222222222,75,55,70,55,95,110,460,0.8444444444444444,2.0
75,125,75,30,75,85,465,0.625,45,80,100,35,37,28,325,0.3125,0.0
40,35,30,120,70,105,400,0.6692307692307692,80,100,70,60,70,95,475,0.7416666666666667,1.0
90,60,70,75,70,45,410,0.23880597014925373,80,50,100,100,200,50,580,0.2357142857142857,0.5
40,60,40,40,40,30,250,0.0948905109489051,95,110,95,40,95,55,490,0.40336134453781514,1.0
45,60,30,80,50,65,330,0.4603174603174603,90,75,85,115,90,55,510,0.3445378151260504,1.0
60,75,85,100,85,115,520,0.8992248062015504,55,50,65,175,95,150,590,0.7818181818181819,0.5
88,107,122,74,75,64,530,0.4596774193548387,91,90,129,90,72,108,580,0.9140625,1.0
53,51,53,61,56,40,314,0.14285714285714285,80,80,90,110,130,110,600,0.8721804511278195,0.5
45,63,37,65,55,95,360,0.8055555555555556,108,112,118,68,72,47,525,0.2916666666666667,0.0
55,55,45,63,45,45,308,0.25,85,115,80,105,80,50,515,0.3063063063063063,1.0
65,125,100,60,70,70,490,0.6099290780141844,40,30,30,55,30,85,270,0.4666666666666667,0.5
45,50,35,55,75,40,300,0.21367521367521367,60,59,85,79,105,36,424,0.16666666666666666,1.0
100,100,100,100,100,100,600,0.8345864661654135,40,70,40,35,40,60,285,0.392,1.0
110,80,90,95,90,65,530,0.5033557046979866,60,80,50,40,40,30,300,0.15328467153284672,1.0
80,110,60,150,130,70,600,0.5042016806722689,45,20,50,60,120,50,345,0.24074074074074073,1.0
80,75,150,75,150,50,580,0.30973451327433627,50,85,40,85,40,35,335,0.1746031746031746,1.0
65,80,80,59,63,58,405,0.4411764705882353,65,40,50,125,60,30,370,0.07258064516129033,1.0
58,64,58,80,65,80,405,0.609271523178808,49,55,42,42,37,85,310,0.6068376068376068,1.0
20,15,20,10,55,80,200,0.2682926829268293,54,63,52,83,56,97,405,0.7697841726618705,0.5
70,110,180,60,60,50,530,0.4117647058823529,105,150,90,150,90,95,680,0.8285714285714286,2.0
75,55,70,55,95,110,460,0.8444444444444444,75,75,130,75,130,95,580,0.7479674796747967,1.0
80,80,80,80,80,80,480,0.6015037593984962,70,140,230,60,80,50,630,0.32432432432432434,0.5
100,110,90,85,90,60,535,0.47794117647058826,100,73,83,73,83,55,467,0.371900826446281,2.0
75,80,95,90,100,50,490,0.2158273381294964,71,95,85,110,95,79,535,0.664,1.0
50,70,50,50,50,70,340,0.5645161290322581,65,47,55,73,75,85,400,0.65,0.5
50,65,107,105,107,86,520,0.7758620689655172,65,90,40,45,80,75,395,0.625,1.0
55,47,52,40,40,41,275,0.16806722689075632,40,40,35,50,100,70,335,0.5031847133757962,0.5
50,65,107,105,107,86,520,0.7272727272727273,126,131,95,131,98,99,680,0.8294573643410853,1.0
40,70,130,60,130,25,455,0.17355371900826447,97,165,60,65,50,58,495,0.3902439024390244,1.0
65,47,55,73,75,85,400,0.65,90,120,120,60,60,50,500,0.35294117647058826,1.0
38,35,40,27,25,35,200,0.08208955223880597,42,52,67,39,56,50,306,0.2868217054263566,1.0
95,117,80,65,70,92,519,0.8409090909090909,40,45,35,40,40,90,290,0.65,1.0
45,95,50,40,50,75,355,0.54,90,100,90,125,85,90,580,0.7352941176470589,1.0
55,70,55,40,55,85,360,0.7073170731707317,45,45,35,20,30,20,195,0.07246376811594203,1.0
95,75,110,100,80,30,490,0.15267175572519084,70,85,140,85,70,20,470,0.272,2.0
70,80,65,90,65,85,455,0.578125,90,55,75,60,75,30,385,0.13970588235294118,1.0
50,65,107,105,107,86,520,0.7272727272727273,75,140,65,112,65,110,567,0.9140625,1.0
100,103,75,120,75,127,600,0.940677966101695,40,27,60,37,50,66,280,0.36220472440944884,1.0
38,30,41,30,41,60,240,0.2897196261682243,75,69,72,114,100,104,534,0.8253968253968254,1.0
100,134,110,95,100,61,600,0.4057971014492754,75,75,55,105,85,30,425,0.1619718309859155,1.0
70,90,110,60,75,95,500,0.7333333333333333,59,66,70,44,55,41,335,0.25190839694656486,2.0
38,36,38,32,36,57,237,0.3893805309734513,80,82,83,100,100,80,525,0.6742424242424242,1.0
68,165,95,65,115,110,618,0.8615384615384616,45,85,50,55,50,65,350,0.5076923076923077,1.0
70,80,50,35,35,35,305,0.14,78,84,78,109,85,100,534,0.8646616541353384,0.5
100,134,110,95,100,61,600,0.4057971014492754,80,110,60,150,130,70,600,0.5042016806722689,4.0
41,56,40,62,44,71,314,0.568,100,50,80,60,80,50,420,0.34375,0.5
79,100,80,110,90,121,580,0.968,40,55,30,30,30,60,245,0.43548387096774194,1.0
55,85,55,50,55,60,360,0.4233576642335766,78,104,78,159,115,100,634,0.8444444444444444,0.125
100,75,115,90,115,85,580,0.6446280991735537,100,128,90,77,77,128,600,0.959349593495935,1.0
55,55,55,85,55,30,335,0.1320754716981132,110,135,60,50,65,88,508,0.7744360902255639,1.0
55,65,35,60,30,85,330,0.6126126126126126,108,130,95,80,85,102,600,0.7637795275590551,1.0
50,35,55,25,25,15,205,0.05263157894736842,60,62,50,62,60,40,334,0.18181818181818182,2.0
74,108,133,83,65,32,495,0.32142857142857145,100,150,110,95,110,70,635,0.5923076923076923,0.5
76,25,45,67,55,24,292,0.0390625,50,20,55,25,25,30,205,0.09774436090225563,1.0
60,30,30,36,56,50,262,0.32432432432432434,75,110,110,110,105,80,590,0.656934306569343,1.0
50,45,45,35,35,50,260,0.23529411764705882,80,70,40,100,60,145,495,0.921875,1.0
75,98,63,98,63,101,498,0.8091603053435115,67,57,55,77,55,114,425,0.8879310344827587,0.5
58,70,45,40,45,42,300,0.25925925925925924,70,60,62,80,82,60,414,0.4375,0.0
90,75,75,90,100,70,500,0.5462184873949579,45,40,60,40,75,50,310,0.2926829268292683,1.0
64,115,65,83,63,65,455,0.5323741007194245,70,70,70,70,70,70,420,0.5289256198347108,0.0
67,89,116,79,116,33,500,0.2624113475177305,100,180,160,150,90,90,770,0.7520661157024794,1.0
90,120,75,60,60,45,450,0.29411764705882354,50,48,43,46,41,60,288,0.47297297297297297,1.0
85,80,90,105,95,60,515,0.49074074074074076,78,84,78,109,85,100,534,0.8620689655172413,1.0
50,160,110,160,110,110,700,0.8854961832061069,70,60,125,115,70,55,495,0.35507246376811596,1.0
90,100,90,125,85,90,580,0.7352941176470589,20,40,90,30,90,25,295,0.11363636363636363,1.0
90,95,95,70,90,70,510,0.5230769230769231,30,105,90,25,25,50,325,0.2773722627737226,0.5
65,55,115,100,40,60,435,0.3798449612403101,85,56,77,50,77,78,423,0.53125,2.0
40,50,90,30,55,65,330,0.44680851063829785,46,57,40,40,40,50,273,0.25,0.25
65,65,60,130,95,110,525,0.823943661971831,123,77,72,99,92,58,521,0.4621212121212121,1.0
61,78,95,56,58,57,405,0.40336134453781514,68,65,65,125,115,80,518,0.6461538461538462,1.0
106,110,90,154,90,130,680,0.926829268292683,50,75,70,35,70,48,348,0.29357798165137616,0.0
51,65,65,80,75,59,395,0.4365079365079365,78,84,78,109,85,100,534,0.8620689655172413,0.5
109,66,84,81,99,32,471,0.2013888888888889,100,50,50,76,96,70,442,0.5,0.0
65,85,70,75,70,40,405,0.203125,45,30,15,85,65,65,305,0.36220472440944884,1.0
45,75,37,70,55,83,365,0.6183206106870229,55,55,85,65,85,35,380,0.2014388489208633,0.25
48,72,48,72,48,48,336,0.25984251968503935,50,53,48,53,48,64,316,0.358974358974359,1.0
100,100,80,60,60,50,450,0.3050847457627119,60,65,70,85,75,40,395,0.21705426356589147,2.0
86,68,72,109,66,106,507,0.8099173553719008,100,134,110,95,100,61,600,0.4057971014492754,0.25
41,56,40,62,44,71,314,0.568,85,56,77,50,77,78,423,0.53125,2.0
78,81,71,74,69,126,499,0.9090909090909091,50,35,55,25,25,15,205,0.021739130434782608,4.0
35,55,35,30,30,35,220,0.23684210526315788,57,24,86,24,86,23,300,0.12727272727272726,2.0
55,69,85,32,35,28,304,0.09302325581395349,30,40,55,40,55,60,280,0.3237410071942446,1.0
64,78,52,78,52,81,405,0.6422764227642277,44,75,35,63,33,45,295,0.2647058823529412,0.0
70,80,65,90,65,85,455,0.578125,20,25,45,70,90,60,310,0.30833333333333335,0.5
100,100,100,100,100,100,600,0.8805970149253731,105,95,75,85,75,74,509,0.5714285714285714,1.0
55,85,55,50,55,60,360,0.4233576642335766,45,30,40,105,50,20,290,0.031007751937984496,2.0
64,88,50,88,50,106,446,0.9111111111111111,123,100,62,97,81,68,531,0.4806201550387597,1.0
84,71,43,71,43,48,360,0.25874125874125875,65,75,90,97,123,44,494,0.1987179487179487,1.0
116,55,85,107,95,29,487,0.06818181818181818,95,65,65,110,130,60,525,0.4016393442622951,1.0
55,112,45,74,45,70,401,0.559322033898305,30,40,70,70,25,60,295,0.41353383458646614,1.0
75,75,75,125,95,40,485,0.15671641791044777,55,55,45,63,45,45,308,0.25,1.0
105,95,80,40,80,90,490,0.753968253968254,70,100,70,105,75,40,460,0.23214285714285715,1.0
35,45,160,30,45,70,385,0.48148148148148145,30,40,55,40,55,60,280,0.3237410071942446,0.5
60,40,80,60,45,40,325,0.23529411764705882,50,64,50,45,50,41,300,0.22727272727272727,8.0
80,160,80,130,80,100,630,0.8455284552845529,105,180,100,180,100,115,780,0.9477611940298507,0.25
80,135,85,70,95,150,615,0.9844961240310077,58,64,58,80,65,80,405,0.609271523178808,2.0
54,45,47,75,98,52,371,0.39669421487603307,100,100,80,60,60,50,450,0.3050847457627119,1.0
40,27,60,37,50,66,280,0.36220472440944884,60,85,49,60,49,60,363,0.4444444444444444,1.0
55,63,90,50,80,42,380,0.21138211382113822,70,90,110,60,75,95,500,0.7333333333333333,0.5
80,120,79,95,79,70,523,0.5833333333333334,90,100,60,90,60,80,480,0.6422764227642277,0.5
60,90,140,50,50,40,430,0.2535211267605634,60,100,89,55,69,112,485,0.9298245614035088,2.0
30,35,30,100,35,80,310,0.4765625,90,100,90,125,85,90,580,0.7352941176470589,1.0
65,155,120,65,90,105,600,0.8677685950413223,78,52,60,63,65,23,341,0.06015037593984962,0.5
85,120,70,50,60,100,485,0.8308823529411765,82,80,86,85,75,72,480,0.6183206106870229,1.0
85,120,70,50,60,100,485,0.8308823529411765,90,60,70,75,70,45,410,0.23880597014925373,1.0
100,50,80,60,80,50,420,0.34375,60,69,95,69,95,36,424,0.2608695652173913,0.5
90,55,75,60,75,30,385,0.13970588235294118,60,79,105,59,85,36,424,0.17054263565891473,1.0
62,77,62,50,42,65,358,0.4838709677419355,65,110,130,60,65,95,525,0.8278145695364238,2.0
59,66,70,44,55,41,335,0.25190839694656486,95,117,184,44,46,28,514,0.2975206611570248,1.0
80,120,80,120,80,100,580,0.8478260869565217,70,145,88,140,70,112,625,0.8888888888888888,0.5
25,35,70,95,55,45,325,0.16783216783216784,75,95,60,65,60,115,470,0.8778625954198473,1.0
86,76,86,116,56,95,515,0.7982456140350878,62,48,54,63,60,68,355,0.5178571428571429,2.0
95,109,105,75,85,56,525,0.34513274336283184,75,95,122,58,75,69,494,0.5725806451612904,0.25
70,20,50,20,50,40,250,0.1557377049180328,60,55,50,40,55,45,305,0.22377622377622378,0.5
65,90,122,58,75,84,494,0.71875,51,65,65,80,75,59,395,0.4365079365079365,1.0
45,90,20,65,20,65,305,0.5116279069767442,60,48,45,43,90,42,328,0.21897810218978103,2.0
50,45,45,35,35,50,260,0.23529411764705882,50,50,40,30,30,50,250,0.2781954887218045,1.0
43,80,65,50,35,35,308,0.14193548387096774,60,55,50,40,55,45,305,0.22377622377622378,1.0
70,145,88,140,70,112,625,0.8888888888888888,90,55,75,60,75,30,385,0.13970588235294118,2.0
45,60,32,50,32,76,295,0.5925925925925926,50,80,95,10,45,10,290,0.232,1.0
105,140,55,30,55,95,480,0.8195488721804511,110,65,105,55,95,80,510,0.6258503401360545,1.0
50,35,55,25,25,15,205,0.05263157894736842,80,70,40,100,60,145,495,0.921875,1.0
110,123,65,100,65,65,528,0.5217391304347826,100,134,110,95,100,61,600,0.4057971014492754,2.0
60,75,100,55,80,50,420,0.3088235294117647,45,30,35,20,20,45,195,0.14782608695652175,1.0
90,130,80,65,85,55,505,0.4396551724137931,50,50,95,40,50,35,320,0.20279720279720279,1.0
50,72,35,35,35,65,292,0.5373134328358209,55,50,65,175,95,150,590,0.7818181818181819,2.0
35,46,34,35,45,20,215,0.072,80,110,60,150,130,70,600,0.5042016806722689,0.0
30,42,118,42,88,30,350,0.112,91,90,129,90,72,108,580,0.9140625,0.125
70,55,95,95,110,65,490,0.48872180451127817,60,40,60,40,60,35,295,0.18055555555555555,1.0
50,70,160,70,160,90,600,0.7417218543046358,30,80,90,55,45,55,355,0.4295774647887324,1.0
70,110,80,55,80,105,500,0.8794326241134752,50,85,55,65,65,90,410,0.7478260869565218,0.5
78,81,71,74,69,126,499,0.9090909090909091,120,100,85,30,85,45,465,0.22448979591836735,2.0
78,52,60,63,65,23,341,0.06015037593984962,70,85,65,105,85,120,530,0.9262295081967213,1.0
71,82,64,64,59,112,452,0.9327731092436975,68,72,78,38,42,32,330,0.23809523809523808,1.0
80,80,80,80,80,80,480,0.6015037593984962,106,190,100,154,100,130,780,0.9259259259259259,1.0
40,50,45,70,45,70,320,0.5517241379310345,45,25,50,25,25,35,205,0.13076923076923078,4.0
65,50,70,95,80,65,425,0.4262295081967213,90,110,80,100,80,95,555,0.7982456140350878,1.0
75,75,60,83,60,60,413,0.39344262295081966,52,65,55,58,62,60,352,0.4482758620689655,1.0
75,75,60,83,60,60,413,0.39344262295081966,135,85,40,40,85,5,390,0.6864406779661016,1.0
40,30,30,55,30,85,270,0.4666666666666667,59,59,58,90,70,73,409,0.5826086956521739,2.0
100,100,90,150,140,90,670,0.71875,55,81,60,50,70,97,413,0.7214285714285714,1.0
44,38,33,61,43,70,289,0.5267857142857143,91,72,90,129,90,108,580,0.8620689655172413,2.0
55,50,65,175,95,150,590,0.7818181818181819,30,40,70,70,25,60,295,0.41353383458646614,1.0
55,40,50,65,85,40,335,0.3181818181818182,90,30,15,40,20,15,210,0.043478260869565216,0.0
85,80,70,135,75,90,535,0.7006802721088435,85,50,95,120,115,80,545,0.5793650793650794,1.0
49,49,56,49,61,66,330,0.5190839694656488,75,95,125,45,75,95,510,0.8257575757575758,2.0
75,80,55,25,35,35,305,0.18666666666666668,62,50,58,73,54,72,369,0.4435483870967742,2.0
65,155,120,65,90,105,600,0.8677685950413223,60,79,105,59,85,36,424,0.17054263565891473,2.0
40,45,35,40,40,90,290,0.65,75,90,90,140,90,115,600,0.9481481481481482,1.0
72,105,115,54,86,68,500,0.5149253731343284,60,80,95,70,85,50,440,0.2231404958677686,0.5
110,123,65,100,65,65,528,0.5217391304347826,95,155,109,70,130,81,640,0.6788321167883211,1.0
40,50,45,70,45,70,320,0.5517241379310345,55,55,45,63,45,45,308,0.25,1.0
68,85,65,165,135,100,618,0.8083333333333333,101,72,72,99,89,29,462,0.1937984496124031,1.0
90,70,80,70,95,70,475,0.5190839694656488,85,105,55,85,50,115,495,0.9032258064516129,0.25
60,40,60,40,60,35,295,0.18055555555555555,70,60,70,87,78,85,450,0.6228070175438597,0.5
50,35,55,25,25,15,205,0.05263157894736842,80,110,120,130,90,70,600,0.6198347107438017,0.5
55,55,55,85,55,30,335,0.1320754716981132,45,50,55,75,65,30,320,0.06293706293706294,2.0
45,63,37,65,55,95,360,0.8055555555555556,55,85,55,50,55,60,360,0.4233576642335766,1.0
100,77,77,128,128,90,600,0.6901408450704225,73,95,62,85,65,85,465,0.6666666666666666,1.0
75,55,70,55,95,110,460,0.8444444444444444,75,75,95,75,95,113,528,0.9015151515151515,1.0
76,65,45,92,42,91,411,0.7449664429530202,55,50,65,175,95,150,590,0.7818181818181819,1.0
70,105,105,50,40,20,390,0.33587786259541985,100,100,100,100,100,100,600,0.8805970149253731,1.0
100,73,83,73,83,55,467,0.371900826446281,65,150,40,15,80,145,495,0.9663865546218487,0.5
80,145,150,105,110,110,700,0.8692307692307693,55,50,65,175,95,150,590,0.7818181818181819,0.5
75,100,95,40,70,110,490,0.8717948717948718,85,100,122,58,75,54,494,0.3939393939393939,0.0
35,60,44,40,54,55,288,0.366412213740458,40,30,50,55,55,100,330,0.584070796460177,1.0
80,110,60,150,130,70,600,0.5042016806722689,46,87,60,30,40,57,320,0.37777777777777777,1.0
78,65,68,112,154,75,552,0.628099173553719,95,65,65,110,130,60,525,0.4016393442622951,1.0
55,65,35,60,30,85,330,0.6126126126126126,45,100,135,65,135,45,525,0.29411764705882354,1.0
150,100,120,100,120,90,680,0.6666666666666666,60,110,70,60,60,100,460,0.8461538461538461,0.0
55,68,64,45,55,31,318,0.11666666666666667,80,160,60,170,130,80,680,0.6180555555555556,1.0
78,70,61,50,61,100,420,0.8145161290322581,75,95,125,45,75,95,510,0.8257575757575758,1.0
55,84,105,114,75,52,485,0.2890625,65,125,100,60,70,70,490,0.6099290780141844,1.0
105,140,55,30,55,95,480,0.8195488721804511,70,77,60,97,60,108,472,0.8394160583941606,2.0
45,53,70,40,60,42,310,0.25735294117647056,150,80,44,90,54,80,498,0.625,0.125
50,85,55,65,65,90,410,0.7478260869565218,85,110,90,45,90,80,500,0.6206896551724138,1.0
68,125,65,65,115,80,518,0.6277372262773723,50,105,125,55,95,50,480,0.375886524822695,0.5
65,70,60,65,65,115,440,0.8583333333333333,40,45,65,100,120,90,460,0.5588235294117647,1.0
60,50,100,85,70,65,430,0.47580645161290325,73,115,60,60,60,90,458,0.6694915254237288,1.0
95,80,105,40,70,100,490,0.8046875,55,65,35,60,30,85,330,0.6126126126126126,1.0
40,30,50,55,55,100,330,0.584070796460177,120,100,85,30,85,45,465,0.22448979591836735,1.0
45,60,32,50,32,76,295,0.5925925925925926,91,90,72,90,129,108,580,0.896,0.5
65,50,35,115,95,95,455,0.7333333333333333,73,95,62,85,65,85,465,0.6666666666666666,1.0
70,45,48,60,65,35,323,0.15748031496062992,45,80,100,35,37,28,325,0.3125,0.5
65,75,90,97,123,44,494,0.1987179487179487,75,95,95,95,95,85,540,0.6470588235294118,2.0
50,50,120,80,80,30,410,0.07258064516129033,150,160,100,95,65,100,670,0.8866666666666667,1.0
73,100,60,100,60,65,458,0.42657342657342656,76,104,71,104,71,108,534,0.912751677852349,1.0
45,22,60,27,30,29,213,0.07518796992481203,79,85,60,55,60,71,410,0.60431654676259,1.0
55,104,105,94,75,52,485,0.36363636363636365,70,80,102,80,102,40,474,0.2677165354330709,1.0
115,115,85,90,75,100,580,0.8134328358208955,66,41,77,61,87,23,355,0.12096774193548387,1.0
57,80,91,80,87,75,470,0.5737704918032787,105,95,75,85,75,74,509,0.5714285714285714,0.5
105,30,105,140,105,55,540,0.3524590163934426,50,85,40,85,40,35,335,0.1746031746031746,2.0
106,110,90,154,90,130,680,0.926829268292683,45,60,45,25,45,55,275,0.29,1.0
50,85,85,55,55,50,380,0.3902439024390244,25,20,15,105,55,90,310,0.32407407407407407,1.0
89,145,90,105,80,91,600,0.8549618320610687,70,80,65,90,65,85,455,0.578125,1.0
60,80,95,70,85,50,440,0.2231404958677686,54,66,70,44,55,46,335,0.4214876033057851,1.0
85,105,100,79,83,78,530,0.5869565217391305,28,25,25,45,35,40,198,0.16083916083916083,1.0
78,52,60,63,65,23,341,0.06015037593984962,105,95,75,85,75,74,509,0.5714285714285714,1.0
60,45,70,45,90,95,405,0.7304964539007093,123,77,72,99,92,58,521,0.4621212121212121,1.0
110,65,75,125,85,30,490,0.15,30,65,100,45,25,40,305,0.1891891891891892,1.0
70,40,50,55,50,25,290,0.061068702290076333,75,75,130,75,130,95,580,0.7479674796747967,1.0
60,110,70,60,60,100,460,0.8461538461538461,90,65,65,40,40,15,315,0.19672131147540983,1.0
65,40,50,125,60,30,370,0.07258064516129033,90,100,90,125,85,90,580,0.7352941176470589,1.0
60,65,80,170,95,130,600,0.8625954198473282,55,40,50,65,85,40,335,0.3181818181818182,1.0
75,95,60,65,60,115,470,0.8778625954198473,65,70,60,65,65,115,440,0.8583333333333333,1.0
25,20,15,105,55,90,310,0.32407407407407407,80,115,80,65,55,93,488,0.7846153846153846,1.0
45,50,55,75,65,30,320,0.06293706293706294,90,132,105,132,105,30,594,0.4246575342465753,1.0
40,60,30,31,31,70,262,0.4492753623188406,90,55,75,60,75,30,385,0.13970588235294118,1.0
40,50,90,30,55,65,330,0.44680851063829785,59,66,70,44,55,41,335,0.25190839694656486,1.0
49,55,42,42,37,85,310,0.6068376068376068,80,135,130,95,90,70,600,0.5181818181818182,0.5
85,70,80,97,80,123,535,0.9304347826086956,75,80,95,90,100,50,490,0.2158273381294964,2.0
82,80,86,85,75,72,480,0.6183206106870229,50,65,90,35,35,15,290,0.14678899082568808,1.0
100,128,90,77,77,128,600,0.959349593495935,50,95,180,85,45,70,525,0.5298507462686567,2.0
70,120,100,145,105,20,560,0.2824427480916031,25,20,15,105,55,90,310,0.32407407407407407,1.0
50,70,160,70,160,90,600,0.7417218543046358,105,30,105,140,105,55,540,0.3524590163934426,0.5
116,55,85,107,95,29,487,0.06818181818181818,150,100,120,100,120,90,680,0.6666666666666666,1.0
75,98,63,98,63,101,498,0.849624060150376,61,84,65,70,70,70,420,0.5,0.5
100,134,110,95,100,61,600,0.4057971014492754,100,123,75,57,75,80,510,0.6923076923076923,2.0
84,71,43,71,43,48,360,0.25874125874125875,66,65,48,62,57,52,350,0.36220472440944884,1.0
35,55,35,30,30,35,220,0.23684210526315788,60,60,60,85,85,85,435,0.631578947368421,2.0
100,100,100,100,100,100,600,0.8758169934640523,50,50,50,50,50,50,300,0.30708661417322836,2.0
75,89,85,55,65,36,405,0.29545454545454547,65,125,100,55,70,85,500,0.6532258064516129,0.5
90,93,55,70,55,55,418,0.3819444444444444,60,110,70,60,60,100,460,0.8461538461538461,1.0
38,36,38,32,36,57,237,0.3893805309734513,70,115,60,115,60,55,475,0.4647887323943662,1.0
70,90,70,60,60,70,420,0.6390977443609023,80,145,150,105,110,110,700,0.8692307692307693,2.0
76,48,48,57,62,34,325,0.11688311688311688,70,70,115,130,90,60,535,0.5338983050847458,1.0
53,54,53,37,46,45,288,0.3090909090909091,110,135,60,50,65,88,508,0.7744360902255639,1.0
59,74,50,35,50,35,303,0.3125,30,35,30,100,35,80,310,0.4765625,4.0
60,50,70,50,90,65,385,0.39568345323741005,52,65,50,45,50,38,300,0.27419354838709675,2.0
45,50,45,115,55,95,405,0.6936936936936937,60,55,90,145,90,80,520,0.6071428571428571,1.0
75,75,130,75,130,95,580,0.7479674796747967,40,50,90,30,55,65,330,0.44680851063829785,2.0
65,125,100,60,70,70,490,0.6099290780141844,45,90,20,65,20,65,305,0.5116279069767442,0.25
70,110,80,55,80,105,500,0.8794326241134752,80,120,70,110,70,80,530,0.6422764227642277,0.5
50,80,95,10,45,10,290,0.232,45,40,60,40,75,50,310,0.2926829268292683,2.0
59,66,70,44,55,41,335,0.25190839694656486,60,85,42,85,42,91,405,0.8227848101265823,0.25
100,134,110,95,100,61,600,0.4057971014492754,105,140,55,30,55,95,480,0.8195488721804511,2.0
90,60,60,40,40,40,330,0.29545454545454547,50,35,55,25,25,15,205,0.05263157894736842,0.5
65,50,70,95,80,65,425,0.4262295081967213,80,70,65,80,120,100,515,0.8034188034188035,2.0
67,89,116,79,116,33,500,0.2624113475177305,106,190,100,154,100,130,780,0.9259259259259259,0.5
60,62,63,80,80,60,405,0.38016528925619836,45,50,45,115,55,95,405,0.6936936936936937,0.125
50,50,62,40,62,65,329,0.4188034188034188,54,66,70,44,55,46,335,0.4214876033057851,1.0
60,90,55,90,80,110,485,0.8677685950413223,80,135,85,70,95,150,615,0.9844961240310077,2.0
55,55,55,85,55,30,335,0.1320754716981132,65,125,100,55,70,85,500,0.6532258064516129,1.0
77,85,51,55,51,65,384,0.5163934426229508,31,45,90,30,30,40,266,0.21929824561403508,1.0
49,55,42,42,37,85,310,0.6068376068376068,41,50,37,50,37,66,281,0.5175438596491229,1.0
100,120,120,150,100,90,680,0.7880794701986755,45,30,50,55,65,45,290,0.208,1.0
85,70,80,97,80,123,535,0.9304347826086956,70,55,65,95,85,70,440,0.5307692307692308,0.5
250,5,5,35,105,50,450,0.15306122448979592,50,53,48,53,48,64,316,0.4076923076923077,1.0
95,117,184,44,46,28,514,0.2975206611570248,55,70,40,60,40,40,305,0.26956521739130435,0.5
72,105,115,54,86,68,500,0.5149253731343284,65,130,60,95,110,65,525,0.5303030303030303,4.0
62,44,50,44,50,55,305,0.3629032258064516,110,78,73,76,71,60,468,0.3333333333333333,1.0
75,95,60,65,60,115,470,0.8778625954198473,75,80,70,65,75,90,455,0.7578125,1.0
48,72,48,72,48,48,336,0.25984251968503935,60,75,100,55,80,50,420,0.3088235294117647,0.25
56,61,65,48,45,38,313,0.17567567567567569,40,45,40,65,40,65,295,0.5661764705882353,1.0
55,45,45,25,25,15,210,0.048,70,90,90,135,90,125,600,0.9401709401709402,1.0
65,85,70,75,70,40,405,0.203125,57,24,86,24,86,23,300,0.12727272727272726,1.0
40,55,80,35,60,30,300,0.15037593984962405,30,80,90,55,45,55,355,0.4295774647887324,1.0
100,75,115,90,115,85,580,0.6446280991735537,59,45,40,35,40,31,250,0.14285714285714285,1.0
43,80,65,50,35,35,308,0.14193548387096774,65,60,70,85,75,40,395,0.1796875,1.0
60,75,85,100,85,115,520,0.8992248062015504,65,40,70,80,140,70,465,0.5954198473282443,0.5
100,100,100,100,100,100,600,0.831858407079646,48,61,40,61,40,50,300,0.2543859649122807,2.0
100,123,75,57,75,80,510,0.6923076923076923,100,103,75,120,75,127,600,0.940677966101695,2.0
50,65,90,35,35,15,290,0.14678899082568808,39,52,43,60,50,65,309,0.5041322314049587,0.5
89,145,90,105,80,91,600,0.8549618320610687,45,20,50,60,120,50,345,0.24074074074074073,0.0
89,124,80,55,80,55,483,0.5714285714285714,50,65,45,85,65,95,405,0.7238095238095238,0.5
75,90,50,110,80,95,500,0.7985611510791367,55,40,40,65,45,35,280,0.16428571428571428,1.0
64,66,68,81,76,50,405,0.25190839694656486,75,90,90,140,90,115,600,0.9481481481481482,2.0
123,100,62,97,81,68,531,0.4806201550387597,92,105,90,125,90,98,600,0.8217054263565892,0.5
90,95,105,165,110,45,610,0.2890625,45,60,30,80,50,65,330,0.4603174603174603,1.0
67,82,62,46,48,43,348,0.22033898305084745,80,130,100,160,120,110,700,0.8981481481481481,0.5
70,55,55,80,60,45,365,0.2222222222222222,55,40,50,65,85,40,335,0.3181818181818182,2.0
60,70,105,70,120,75,500,0.5983606557377049,80,120,70,110,70,80,530,0.6422764227642277,2.0
50,70,50,50,50,70,340,0.5645161290322581,70,55,65,95,85,70,440,0.5307692307692308,2.0
80,185,115,40,105,75,600,0.6230769230769231,50,60,45,100,80,65,400,0.45689655172413796,0.5
76,65,45,92,42,91,411,0.7449664429530202,70,95,125,65,75,45,475,0.33613445378151263,0.5
100,150,140,100,90,90,670,0.7969924812030075,81,102,77,85,75,85,505,0.5642857142857143,2.0
80,100,70,50,60,45,405,0.25806451612903225,40,60,30,31,31,70,262,0.4492753623188406,1.0
49,66,70,44,55,51,335,0.4260869565217391,64,51,23,51,23,28,240,0.11363636363636363,0.0
62,44,50,44,50,55,305,0.3629032258064516,68,85,65,165,135,100,618,0.8083333333333333,1.0
60,48,45,43,90,42,328,0.21897810218978103,80,82,100,83,100,80,525,0.6821705426356589,1.0
60,50,50,60,70,50,340,0.28346456692913385,100,100,100,100,100,100,600,0.8345864661654135,0.25
60,60,50,40,50,75,335,0.5882352941176471,80,125,75,40,95,85,500,0.6911764705882353,0.5
55,75,85,25,25,15,280,0.1875,40,20,30,40,80,55,265,0.22764227642276422,4.0
52,65,55,58,62,60,352,0.4482758620689655,50,47,50,57,50,65,319,0.463768115942029,1.0
75,90,90,140,90,115,600,0.9481481481481482,85,135,130,60,80,25,515,0.40540540540540543,0.5
65,65,65,50,50,90,385,0.72,190,33,58,33,58,33,405,0.13432835820895522,1.0
57,80,91,80,87,75,470,0.5737704918032787,48,72,48,72,48,48,336,0.25984251968503935,1.0
46,87,60,30,40,57,320,0.37777777777777777,59,59,58,90,70,73,409,0.5826086956521739,1.0
135,85,40,40,85,5,390,0.6864406779661016,82,121,119,69,59,71,521,0.5394736842105263,0.5
50,105,125,55,95,50,480,0.375886524822695,41,64,45,50,50,50,300,0.36752136752136755,2.0
50,35,55,25,25,15,205,0.021739130434782608,50,25,28,45,55,15,218,0.0625,0.5
45,80,100,35,37,28,325,0.3125,68,90,65,50,55,82,410,0.6165413533834586,1.0
95,100,85,108,70,70,528,0.5652173913043478,70,43,53,43,53,40,302,0.19090909090909092,1.0
90,132,105,132,105,30,594,0.4246575342465753,50,35,55,25,25,15,205,0.05263157894736842,0.5
80,100,200,50,100,50,580,0.3472222222222222,110,160,110,80,110,100,670,0.8591549295774648,1.0
95,80,105,40,70,100,490,0.8046875,75,90,140,60,60,40,465,0.3008130081300813,0.5
70,85,140,85,70,20,470,0.272,100,180,160,150,90,90,770,0.7520661157024794,0.5
50,95,90,95,90,180,600,0.9172413793103448,75,80,70,65,75,90,455,0.7578125,2.0
20,10,55,15,20,80,200,0.17985611510791366,75,98,63,98,63,101,498,0.849624060150376,0.5
55,75,60,75,60,103,428,0.7982456140350878,55,45,50,45,65,80,340,0.5546218487394958,2.0
70,150,140,65,100,75,600,0.55,30,45,59,30,39,57,260,0.2803030303030303,0.5
50,65,107,105,107,86,520,0.7272727272727273,65,60,110,130,95,65,525,0.47761194029850745,1.0
80,85,95,30,30,25,345,0.2857142857142857,85,60,65,135,105,100,550,0.7518248175182481,4.0
81,102,77,85,75,85,505,0.5642857142857143,50,120,53,35,110,87,455,0.640625,1.0
50,105,125,55,95,50,480,0.375886524822695,55,75,50,40,40,80,340,0.6302521008403361,1.0
59,66,70,44,55,41,335,0.25190839694656486,95,85,85,65,65,35,430,0.2571428571428571,4.0
80,80,80,80,80,80,480,0.6015037593984962,40,80,35,35,45,70,305,0.4661016949152542,1.0
60,85,69,65,79,80,438,0.576,75,80,95,90,100,50,490,0.2158273381294964,2.0
45,63,37,65,55,95,360,0.8055555555555556,41,64,45,50,50,50,300,0.36752136752136755,0.5
70,60,125,115,70,55,495,0.35507246376811596,80,95,82,60,82,75,474,0.6,1.0
170,90,45,90,45,60,500,0.427536231884058,45,80,100,35,37,28,325,0.3125,1.0
71,82,64,64,59,112,452,0.9327731092436975,95,117,80,65,70,92,519,0.8409090909090909,1.0
51,65,65,80,75,59,395,0.4365079365079365,45,90,20,65,20,65,305,0.5116279069767442,0.5
50,53,48,53,48,64,316,0.46153846153846156,85,80,90,105,95,60,515,0.49074074074074076,1.0
70,110,180,60,60,50,530,0.4117647058823529,60,150,50,150,50,60,520,0.5,0.25
75,75,75,125,95,40,485,0.15671641791044777,70,43,53,43,53,40,302,0.19090909090909092,2.0
90,30,15,40,20,15,210,0.043478260869565216,60,45,50,90,80,70,395,0.625,1.0
95,75,80,100,110,30,490,0.24242424242424243,110,65,105,55,95,80,510,0.6258503401360545,0.0
70,50,30,95,135,105,485,0.8040540540540541,60,55,145,75,150,40,525,0.2,0.5
63,60,55,50,50,71,349,0.5289256198347108,165,75,80,40,45,65,470,0.5151515151515151,1.0
55,70,45,70,50,60,350,0.45,78,130,111,130,85,100,634,0.8561151079136691,0.25
75,87,63,87,63,98,473,0.865546218487395,75,69,72,114,100,104,534,0.8253968253968254,2.0
60,70,65,125,105,90,515,0.6911764705882353,35,60,44,40,54,55,288,0.366412213740458,0.25
130,85,80,85,95,60,535,0.43884892086330934,38,35,40,27,25,35,200,0.08208955223880597,1.0
55,50,45,135,95,120,500,0.7714285714285715,79,100,80,110,90,121,580,0.968,1.0
45,65,34,40,34,45,263,0.2589928057553957,70,120,40,95,40,95,460,0.8106060606060606,2.0
65,90,122,58,75,84,494,0.71875,40,30,32,50,52,65,269,0.3671875,1.0
55,70,40,60,40,40,305,0.26956521739130435,70,130,100,55,80,65,500,0.608,0.5
70,90,110,60,75,95,500,0.7333333333333333,46,87,60,30,40,57,320,0.37777777777777777,1.0
64,165,75,93,83,75,555,0.6587301587301587,90,92,75,92,85,60,494,0.49586776859504134,1.0
90,100,90,125,85,90,580,0.7352941176470589,45,60,45,25,45,55,275,0.29,1.0
83,80,80,135,80,121,579,0.9444444444444444,65,90,50,85,45,55,390,0.371900826446281,2.0
74,94,131,54,116,20,489,0.4485294117647059,45,22,60,27,30,29,213,0.07518796992481203,0.5
65,75,70,95,70,95,470,0.7272727272727273,45,55,45,65,45,75,330,0.5692307692307692,1.0
65,60,70,85,75,40,395,0.1796875,70,50,30,95,135,105,485,0.8040540540540541,1.0
67,58,57,81,67,101,431,0.8790322580645161,78,84,78,109,85,100,534,0.8646616541353384,1.0
71,82,64,64,59,112,452,0.9327731092436975,95,155,109,70,130,81,640,0.6788321167883211,1.0
105,95,75,85,75,74,509,0.5714285714285714,90,85,75,115,100,115,580,0.9381443298969072,2.0
250,5,5,35,105,50,450,0.15306122448979592,40,80,35,35,45,70,305,0.4661016949152542,1.0
103,60,126,80,126,50,545,0.36363636363636365,65,130,60,75,60,75,465,0.689922480620155,2.0
70,75,80,135,80,135,575,0.917910447761194,39,52,43,60,50,65,309,0.49107142857142855,1.0
85,110,76,65,82,56,474,0.3933333333333333,80,100,123,122,120,80,625,0.56,0.25
40,29,45,29,45,36,224,0.14634146341463414,80,80,90,110,130,110,600,0.8721804511278195,2.0
46,87,60,30,40,57,320,0.37777777777777777,70,55,95,95,110,65,490,0.48872180451127817,1.0
35,60,44,40,54,55,288,0.366412213740458,90,60,70,75,70,45,410,0.23880597014925373,1.0
100,120,100,150,120,90,680,0.728,40,80,100,30,30,20,300,0.11851851851851852,0.5
45,95,50,40,50,75,355,0.54,70,60,62,80,82,60,414,0.4375,2.0
50,50,62,40,62,65,329,0.4188034188034188,70,55,55,80,60,45,365,0.2222222222222222,1.0
80,70,65,80,120,100,515,0.8034188034188035,50,50,40,30,30,50,250,0.2781954887218045,1.0
60,70,50,100,50,65,395,0.5217391304347826,55,66,44,44,56,85,350,0.6888888888888889,1.0
55,40,40,65,45,35,280,0.16428571428571428,60,85,42,85,42,91,405,0.8227848101265823,2.0
83,80,75,70,70,101,479,0.8615384615384616,40,50,45,70,45,70,320,0.5517241379310345,1.0
65,47,55,73,75,85,400,0.65,48,61,40,61,40,50,300,0.2543859649122807,0.25
100,150,90,180,160,90,770,0.7348484848484849,45,55,45,65,45,75,330,0.5692307692307692,1.0
60,50,40,85,75,95,405,0.7540983606557377,60,80,110,50,80,45,425,0.2833333333333333,0.0
58,70,45,40,45,42,300,0.25925925925925924,35,80,50,50,70,120,405,0.84375,1.0
50,85,40,85,40,35,335,0.1746031746031746,80,50,100,100,200,50,580,0.2357142857142857,1.0
31,45,90,30,30,40,266,0.21929824561403508,62,77,62,50,42,65,358,0.4838709677419355,0.0
35,35,35,35,35,35,210,0.13385826771653545,40,50,90,30,55,65,330,0.44680851063829785,0.25
59,110,150,45,49,35,448,0.3333333333333333,45,50,45,115,55,95,405,0.6936936936936937,2.0
62,44,50,44,50,55,305,0.3629032258064516,108,130,95,80,85,102,600,0.7637795275590551,1.0
45,60,30,80,50,65,330,0.4603174603174603,81,102,77,85,75,85,505,0.5642857142857143,1.0
81,102,77,85,75,85,505,0.5642857142857143,55,66,44,44,56,85,350,0.6888888888888889,1.0
60,150,50,150,50,60,520,0.5,77,120,90,60,90,48,485,0.2785714285714286,1.0
65,75,90,97,123,44,494,0.1987179487179487,75,100,110,45,55,65,450,0.5333333333333333,0.5
79,115,70,125,80,111,580,0.8468468468468469,69,55,45,55,55,15,294,0.11666666666666667,2.0
65,90,120,85,70,60,490,0.43410852713178294,35,45,160,30,45,70,385,0.48148148148148145,0.25
90,110,80,100,80,95,555,0.7982456140350878,65,60,110,130,95,65,525,0.47761194029850745,2.0
95,125,79,60,100,81,540,0.6165413533834586,90,85,75,115,100,115,580,0.9381443298969072,0.5
105,140,95,55,65,45,505,0.3,60,70,50,100,50,65,395,0.5217391304347826,0.25
69,69,76,69,86,91,460,0.6554621848739496,72,58,80,103,80,97,490,0.7171052631578947,1.0
40,55,80,35,60,30,300,0.15037593984962405,55,40,85,80,105,40,405,0.23622047244094488,0.5
95,117,80,65,70,92,519,0.8409090909090909,37,25,41,25,41,25,194,0.08870967741935484,0.5
45,50,55,75,65,30,320,0.06293706293706294,90,92,87,75,85,76,505,0.5409836065573771,0.25
61,90,45,50,50,160,456,0.9230769230769231,95,117,184,44,46,28,514,0.2975206611570248,1.0
70,60,125,115,70,55,495,0.35507246376811596,45,40,60,40,75,50,310,0.2926829268292683,2.0
95,23,48,23,48,23,260,0.046153846153846156,63,60,55,50,50,71,349,0.5289256198347108,1.0
71,73,88,120,89,59,500,0.43537414965986393,65,85,70,75,70,40,405,0.203125,1.0
90,70,80,70,95,70,475,0.5190839694656488,90,92,87,75,85,76,505,0.5409836065573771,4.0
75,100,110,45,55,65,450,0.5333333333333333,50,85,125,85,115,20,480,0.4306569343065693,1.0
80,80,50,40,50,25,325,0.176056338028169,170,90,45,90,45,60,500,0.427536231884058,1.0
60,50,40,85,75,95,405,0.7540983606557377,60,60,50,40,50,75,335,0.5882352941176471,0.5
50,60,45,100,80,65,400,0.45689655172413796,60,40,60,95,60,55,370,0.4222222222222222,0.25
70,140,230,60,80,50,630,0.32432432432432434,55,84,105,114,75,52,485,0.2890625,0.5
80,185,115,40,105,75,600,0.6230769230769231,50,70,100,40,40,30,330,0.2222222222222222,2.0
106,130,90,110,154,90,680,0.719626168224299,10,55,25,35,45,95,265,0.5396825396825397,1.0
60,82,45,45,45,74,351,0.5752212389380531,60,40,60,95,60,55,370,0.4222222222222222,4.0
65,125,100,60,70,70,490,0.6099290780141844,70,145,88,140,70,112,625,0.8888888888888888,0.25
60,70,65,125,105,90,515,0.6911764705882353,45,30,50,65,50,45,285,0.13821138211382114,1.0
40,45,40,65,40,65,295,0.5661764705882353,60,40,80,60,45,40,325,0.23529411764705882,0.5
70,110,80,55,80,105,500,0.8794326241134752,81,102,77,85,75,85,505,0.5642857142857143,0.5
100,150,90,180,160,90,770,0.7348484848484849,30,65,100,45,25,40,305,0.1891891891891892,0.5
30,42,118,42,88,30,350,0.112,45,30,50,55,65,45,290,0.208,1.0
70,40,50,55,50,25,290,0.061068702290076333,85,105,85,40,50,40,405,0.211864406779661,1.0
68,165,95,65,115,110,618,0.8615384615384616,95,75,80,100,110,30,490,0.24242424242424243,0.25
38,35,40,27,25,35,200,0.08208955223880597,60,80,50,40,40,30,300,0.15328467153284672,0.5
70,55,95,95,110,65,490,0.48872180451127817,95,155,109,70,130,81,640,0.6788321167883211,0.0
60,100,115,70,85,90,520,0.7557251908396947,55,50,40,40,40,75,300,0.5945945945945946,1.0
40,50,45,70,45,70,320,0.5517241379310345,28,25,25,45,35,40,198,0.16083916083916083,0.5
60,55,50,40,55,45,305,0.22377622377622378,78,130,111,130,85,100,634,0.8561151079136691,0.5
70,45,48,60,65,35,323,0.15748031496062992,65,75,105,35,65,85,430,0.6940298507462687,1.0
103,93,67,71,61,84,479,0.7142857142857143,95,110,80,70,80,50,485,0.37209302325581395,1.0
80,120,70,110,70,80,530,0.6422764227642277,85,56,77,50,77,78,423,0.53125,2.0
68,65,65,125,115,80,518,0.6461538461538462,95,125,79,60,100,81,540,0.6165413533834586,1.0
67,57,55,77,55,114,425,0.8879310344827587,75,100,95,40,70,110,490,0.8717948717948718,1.0
75,65,55,65,55,69,384,0.43548387096774194,75,140,65,112,65,110,567,0.9140625,0.0
55,50,40,40,40,75,300,0.5945945945945946,100,50,50,76,96,70,442,0.5,1.0
90,95,95,70,90,70,510,0.5230769230769231,45,63,37,65,55,95,360,0.8055555555555556,1.0
65,90,40,45,80,75,395,0.625,76,104,71,104,71,108,534,0.912751677852349,0.25
50,45,45,35,35,50,260,0.23529411764705882,65,125,100,60,70,70,490,0.6099290780141844,0.5
60,62,80,63,80,60,405,0.4336283185840708,40,65,95,60,45,35,340,0.13986013986013987,0.5
80,80,80,80,80,80,480,0.6015037593984962,57,80,91,80,87,75,470,0.5737704918032787,0.5
100,50,50,76,96,70,442,0.5,55,63,90,50,80,42,380,0.21138211382113822,4.0
80,110,60,150,130,70,600,0.5042016806722689,40,30,35,50,70,55,280,0.28205128205128205,2.0
130,85,80,85,95,60,535,0.43884892086330934,90,60,60,40,40,40,330,0.29545454545454547,4.0
45,100,45,45,45,10,290,0.2949640287769784,65,105,60,60,70,95,455,63.0,1.0
40,65,40,80,40,65,330,0.5038167938931297,125,58,58,76,76,67,460,0.515625,1.0
45,100,45,45,45,10,290,0.2949640287769784,55,112,45,74,45,70,401,0.559322033898305,0.0
62,48,54,63,60,68,355,0.5178571428571429,55,75,85,25,25,15,280,0.1875,1.0
30,35,30,100,35,80,310,0.4765625,105,125,100,60,100,100,590,0.8359375,0.0
70,120,65,45,85,125,510,0.9747899159663865,70,115,60,115,60,55,475,0.4647887323943662,1.0
70,90,45,15,45,50,315,0.3629032258064516,69,55,45,55,55,15,294,0.11666666666666667,2.0
64,165,75,93,83,75,555,0.6587301587301587,75,90,140,60,60,40,465,0.3008130081300813,1.0
103,60,86,60,86,50,445,0.3458646616541353,65,60,70,85,75,40,395,0.1796875,1.0
25,20,15,105,55,90,310,0.32407407407407407,65,80,65,35,65,60,370,0.38405797101449274,1.0
40,30,30,55,30,85,270,0.4666666666666667,65,100,70,80,80,105,500,0.8666666666666667,2.0
100,75,115,90,115,85,580,0.6446280991735537,75,95,67,125,95,83,540,0.7117117117117117,2.0
54,63,52,83,56,97,405,0.7697841726618705,80,185,115,40,105,75,600,0.6230769230769231,1.0
63,120,85,90,55,55,468,0.2809917355371901,110,160,110,80,110,100,670,0.8591549295774648,1.0
55,84,105,114,75,52,485,0.2890625,106,150,70,194,120,140,780,0.952,1.0
70,85,70,60,70,50,405,0.28378378378378377,75,80,70,65,75,90,455,0.7578125,0.0
79,115,70,125,80,111,580,0.864,65,50,35,115,95,95,455,0.7333333333333333,1.0
45,60,40,70,50,45,310,0.2846715328467153,75,75,60,83,60,60,413,0.39344262295081966,0.5
45,95,50,40,50,75,355,0.54,55,95,55,35,75,115,430,0.9380530973451328,4.0
70,110,75,145,85,145,630,0.9444444444444444,130,85,80,85,95,60,535,0.43884892086330934,2.0
123,77,72,99,92,58,521,0.4621212121212121,90,65,65,40,40,15,315,0.19672131147540983,0.5
100,90,130,45,65,55,485,0.4253731343283582,30,40,55,40,55,60,280,0.3237410071942446,0.5
85,110,90,45,90,80,500,0.6206896551724138,30,40,70,70,25,60,295,0.41353383458646614,1.0
109,66,84,81,99,32,471,0.2013888888888889,64,51,23,51,23,28,240,0.11363636363636363,1.0
55,55,85,65,85,35,380,0.2014388489208633,70,43,53,43,53,40,302,0.19090909090909092,1.0
85,110,76,65,82,56,474,0.3933333333333333,55,81,60,50,70,97,413,0.7214285714285714,0.0
50,50,62,40,62,65,329,0.4188034188034188,80,115,80,65,55,93,488,0.7846153846153846,1.0
75,69,72,114,100,104,534,0.8253968253968254,105,125,100,60,100,100,590,0.8359375,1.0
50,40,85,40,65,25,305,0.08870967741935484,80,160,60,170,130,80,680,0.6180555555555556,4.0
58,64,58,80,65,80,405,0.5423728813559322,55,20,35,20,45,75,250,0.37681159420289856,1.0
70,115,60,115,60,55,475,0.4647887323943662,82,80,86,85,75,72,480,0.6183206106870229,0.5
70,94,50,94,50,66,424,0.48148148148148145,90,110,80,100,80,95,555,0.7982456140350878,0.5
75,75,60,83,60,60,413,0.39344262295081966,50,50,40,30,30,50,250,0.2781954887218045,2.0
79,100,80,110,90,121,580,0.968,45,35,50,70,50,30,280,0.15753424657534246,2.0
60,65,60,130,75,110,500,0.7719298245614035,75,70,90,70,105,80,490,0.656,1.0
82,121,119,69,59,71,521,0.5394736842105263,75,65,55,65,55,69,384,0.43548387096774194,0.5
40,55,30,30,30,85,270,0.688,45,55,45,65,45,75,330,0.5692307692307692,1.0
45,63,37,65,55,95,360,0.8055555555555556,60,100,85,80,85,100,510,0.7007874015748031,1.0
55,50,40,40,40,75,300,0.5945945945945946,40,40,40,70,40,20,250,0.032520325203252036,1.0
35,64,85,74,55,32,345,0.19827586206896552,70,100,115,30,65,30,410,0.24390243902439024,2.0
66,41,77,61,87,23,355,0.12096774193548387,60,65,70,85,75,40,395,0.21705426356589147,0.25
50,105,79,35,110,76,455,0.6214285714285714,50,25,28,45,55,15,218,0.0625,0.5
65,50,70,95,80,65,425,0.4262295081967213,67,82,62,46,48,43,348,0.22033898305084745,1.0
50,50,95,40,50,35,320,0.20279720279720279,95,145,130,120,90,120,700,0.9398496240601504,0.0
55,70,45,70,50,60,350,0.45,65,50,70,95,80,65,425,0.4262295081967213,1.0
72,58,80,103,80,97,490,0.7171052631578947,60,85,42,85,42,91,405,0.8227848101265823,0.0
75,95,95,95,95,85,540,0.6470588235294118,60,25,35,70,80,60,330,0.3076923076923077,1.0
75,75,55,105,85,30,425,0.1619718309859155,48,61,40,61,40,50,300,0.2543859649122807,0.5
46,87,60,30,40,57,320,0.37777777777777777,75,89,85,55,65,36,405,0.29545454545454547,1.0
50,50,40,30,30,50,250,0.2781954887218045,60,150,50,150,50,60,520,0.5,1.0
39,52,43,60,50,65,309,0.5041322314049587,20,10,230,10,230,5,505,0.0,1.0
74,48,76,83,81,104,466,0.7913043478260869,55,55,85,65,85,35,380,0.2014388489208633,1.0
86,68,72,109,66,106,507,0.8099173553719008,75,75,60,83,60,60,413,0.39344262295081966,0.5
75,75,75,125,95,40,485,0.15671641791044777,74,48,76,83,81,104,466,0.7322834645669292,0.5
65,50,35,115,95,95,455,0.7333333333333333,40,45,40,35,35,56,251,0.373015873015873,2.0
20,40,90,30,90,25,295,0.11363636363636363,50,92,108,92,108,35,485,0.2457627118644068,1.0
70,110,70,115,70,90,525,0.75,75,103,80,70,80,92,500,0.7933884297520661,0.5
104,91,63,91,73,68,490,0.5118110236220472,60,50,150,50,150,60,520,0.5206611570247934,0.0
64,78,52,78,52,81,405,0.6422764227642277,65,60,70,85,75,40,395,0.1796875,2.0
60,60,60,105,105,105,495,0.848,46,57,40,40,40,50,273,0.25,1.0
60,82,45,45,45,74,351,0.5752212389380531,72,60,30,20,30,25,237,0.11570247933884298,0.5
60,70,105,70,120,75,500,0.5983606557377049,65,95,100,60,50,50,420,0.34959349593495936,1.0
76,104,71,104,71,108,534,0.912751677852349,89,145,90,105,80,91,600,0.8549618320610687,0.5
80,95,82,60,82,75,474,0.6,60,150,50,150,50,60,520,0.5,0.0
20,40,90,30,90,25,295,0.11363636363636363,79,103,120,135,115,78,630,0.5763888888888888,1.0
75,75,55,105,85,30,425,0.1619718309859155,106,110,90,154,90,130,680,0.926829268292683,1.0
100,123,75,57,75,80,510,0.6923076923076923,75,70,90,70,105,80,490,0.656,1.0
40,40,50,30,30,30,220,0.0873015873015873,65,150,60,115,60,115,565,0.935251798561151,1.0
70,43,53,43,53,40,302,0.19090909090909092,30,35,30,100,35,80,310,0.4765625,0.25
65,83,57,95,85,105,490,0.8914728682170543,43,70,48,50,60,38,309,0.2391304347826087,0.5
60,65,70,85,75,40,395,0.21705426356589147,40,45,40,35,35,56,251,0.373015873015873,0.5
85,56,77,50,77,78,423,0.53125,100,103,75,120,75,127,600,0.940677966101695,0.0
65,95,75,55,55,85,430,0.6933333333333334,80,70,40,100,60,145,495,0.921875,1.0
100,150,120,120,100,90,680,0.6493506493506493,100,134,110,95,100,61,600,0.4057971014492754,1.0
50,53,48,53,48,64,316,0.46153846153846156,50,53,48,53,48,64,316,0.358974358974359,0.5
75,125,230,55,95,30,610,0.3448275862068966,65,130,60,95,110,65,525,0.5303030303030303,1.0
38,41,40,50,65,65,299,0.4108527131782946,60,85,69,65,79,80,438,0.576,1.0
74,94,131,54,116,20,489,0.4485294117647059,55,104,105,94,75,52,485,0.36363636363636365,1.0
50,75,70,35,70,48,348,0.29357798165137616,10,55,25,35,45,95,265,0.5396825396825397,1.0
95,65,110,60,130,65,525,0.5275590551181102,75,125,70,125,70,115,580,0.9037037037037037,2.0
60,80,50,50,50,40,330,0.23853211009174313,55,81,60,50,70,97,413,0.7214285714285714,1.0
64,78,52,78,52,81,405,0.6422764227642277,95,65,110,60,130,65,525,0.5275590551181102,2.0
95,125,79,60,100,81,540,0.6165413533834586,70,55,75,45,65,60,370,0.45901639344262296,1.0
65,110,130,60,65,95,525,0.8278145695364238,76,25,45,67,55,24,292,0.0390625,1.0
65,125,100,55,70,85,500,0.6532258064516129,65,100,70,80,80,105,500,0.8666666666666667,0.5
68,125,65,65,115,80,518,0.6277372262773723,50,65,107,105,107,86,520,0.7272727272727273,0.5
50,45,45,35,35,50,260,0.23529411764705882,80,185,115,40,105,75,600,0.6230769230769231,1.0
56,61,65,48,45,38,313,0.17567567567567569,25,20,15,105,55,90,310,0.32407407407407407,1.0
40,80,35,35,45,70,305,0.4661016949152542,78,130,111,130,85,100,634,0.8561151079136691,1.0
50,72,35,35,35,65,292,0.5373134328358209,50,75,70,35,70,48,348,0.29357798165137616,0.25
55,45,43,55,43,72,313,0.5853658536585366,60,100,89,55,69,112,485,0.9298245614035088,4.0
75,95,60,65,60,115,470,0.8778625954198473,65,47,55,73,75,85,400,0.65,1.0
50,180,20,180,20,150,600,0.9029850746268657,20,10,230,10,230,5,505,0.0,1.0
43,70,48,50,60,38,309,0.2391304347826087,55,40,40,65,45,35,280,0.16428571428571428,1.0
84,71,43,71,43,48,360,0.25874125874125875,88,107,122,74,75,64,530,0.4596774193548387,1.0
65,45,55,45,70,45,325,0.24369747899159663,90,92,75,92,85,60,494,0.49586776859504134,0.5
100,100,100,100,100,100,600,0.831858407079646,60,85,69,65,79,80,438,0.576,2.0
100,128,90,77,77,128,600,0.959349593495935,60,95,80,60,80,30,405,0.19480519480519481,0.5
104,91,63,91,73,68,490,0.5118110236220472,78,81,71,74,69,126,499,0.9090909090909091,1.0
60,45,70,45,90,95,405,0.7304964539007093,65,100,70,80,80,105,500,0.8666666666666667,1.0
49,66,70,44,55,51,335,0.4260869565217391,50,48,43,46,41,60,288,0.47297297297297297,4.0
30,45,55,70,55,85,340,0.5633802816901409,60,50,40,85,75,95,405,0.7540983606557377,1.0
110,78,73,76,71,60,468,0.3333333333333333,90,93,55,70,55,55,418,0.3819444444444444,4.0
35,85,45,35,35,75,310,0.6492537313432836,75,110,110,110,105,80,590,0.656934306569343,1.0
55,84,105,114,75,52,485,0.2890625,100,134,110,95,100,61,600,0.4057971014492754,2.0
70,70,40,60,40,60,340,0.4247787610619469,65,90,65,61,61,100,442,0.8373983739837398,0.5
85,50,95,120,115,80,545,0.5793650793650794,70,95,85,55,65,70,440,0.5,0.5
65,150,60,115,60,115,565,0.935251798561151,70,70,115,130,90,60,535,0.5338983050847458,1.0
45,45,35,20,30,20,195,0.07246376811594203,55,69,85,32,35,28,304,0.09302325581395349,1.0
40,40,50,30,30,30,220,0.0873015873015873,100,90,130,45,65,55,485,0.4253731343283582,4.0
40,30,32,50,52,65,269,0.3671875,77,120,90,60,90,48,485,0.2785714285714286,0.5
75,90,140,60,60,40,465,0.3008130081300813,50,65,64,44,48,43,314,0.2196969696969697,0.5
55,47,52,40,40,41,275,0.16806722689075632,35,65,35,65,35,65,300,0.46621621621621623,1.0
109,66,84,81,99,32,471,0.2013888888888889,54,78,103,53,45,22,355,0.23255813953488372,4.0
50,95,180,85,45,70,525,0.5298507462686567,80,185,115,40,105,75,600,0.6230769230769231,1.0
65,100,70,80,80,105,500,0.8666666666666667,44,38,39,61,79,42,303,0.2251655629139073,1.0
45,60,30,80,50,65,330,0.4603174603174603,78,84,78,109,85,100,534,0.8646616541353384,0.5
125,58,58,76,76,67,460,0.515625,65,83,57,95,85,105,490,0.8914728682170543,0.5
110,123,65,100,65,65,528,0.5217391304347826,97,165,60,65,50,58,495,0.3902439024390244,1.0
70,140,70,110,65,105,560,0.95,60,50,40,85,75,95,405,0.7540983606557377,1.0
73,76,75,81,100,100,505,0.8110236220472441,50,75,75,65,65,50,380,0.4049586776859504,1.0
83,106,65,86,65,85,490,0.6640625,45,35,50,70,50,30,280,0.15753424657534246,2.0
70,70,70,70,70,70,420,0.5289256198347108,80,160,80,130,80,100,630,0.8455284552845529,1.0
60,100,115,70,85,90,520,0.7557251908396947,45,100,45,45,45,10,290,0.2949640287769784,1.0
90,95,95,70,90,70,510,0.5230769230769231,60,82,45,45,45,74,351,0.5752212389380531,4.0
70,94,50,94,50,66,424,0.48148148148148145,50,180,20,180,20,150,600,0.9029850746268657,2.0
85,90,80,70,80,130,535,0.9262295081967213,60,95,80,60,80,30,405,0.19480519480519481,8.0
75,98,63,98,63,101,498,0.889763779527559,95,75,110,100,80,30,490,0.15267175572519084,0.5
60,150,50,150,50,60,520,0.5,100,100,90,150,140,90,670,0.71875,0.5
60,60,60,85,85,85,435,0.631578947368421,50,47,50,57,50,65,319,0.463768115942029,1.0
65,45,55,45,70,45,325,0.24369747899159663,75,69,72,114,100,104,534,0.8253968253968254,2.0
30,40,70,70,25,60,295,0.41353383458646614,50,85,40,85,40,35,335,0.1746031746031746,0.5
45,35,50,70,50,30,280,0.15753424657534246,65,90,65,61,61,100,442,0.8373983739837398,0.5
50,30,55,65,55,20,275,0.13675213675213677,80,120,70,110,70,80,530,0.6422764227642277,0.5
45,49,65,49,65,45,318,0.275,61,90,45,50,50,160,456,0.9230769230769231,0.25
60,79,105,59,85,36,424,0.17054263565891473,70,55,75,45,65,60,370,0.45901639344262296,0.0
62,44,50,44,50,55,305,0.3629032258064516,100,90,130,45,65,55,485,0.4253731343283582,0.5
70,105,105,50,40,20,390,0.33587786259541985,55,35,50,55,110,85,390,0.6277372262773723,4.0
70,65,60,90,75,90,450,0.6571428571428571,100,100,125,110,50,50,535,0.384,4.0
75,95,122,58,75,69,494,0.5725806451612904,75,105,75,105,75,45,480,0.3274336283185841,2.0
100,90,130,45,65,55,485,0.4253731343283582,126,131,95,131,98,99,680,0.8294573643410853,1.0
110,85,95,80,95,50,515,0.2713178294573643,86,92,88,68,75,73,482,0.6835443037974683,1.0
55,95,115,45,45,35,390,0.2116788321167883,70,110,180,60,60,50,530,0.4117647058823529,2.0
126,131,95,131,98,99,680,0.8102189781021898,60,48,45,43,90,42,328,0.21897810218978103,2.0
60,90,55,90,80,110,485,0.8677685950413223,75,90,50,110,80,95,500,0.7985611510791367,1.0
73,76,75,81,100,100,505,0.8110236220472441,83,106,65,86,65,85,490,0.6640625,1.0
40,45,35,65,55,70,310,0.4482758620689655,95,124,78,69,71,58,495,0.37398373983739835,1.0
50,105,79,35,110,76,455,0.6214285714285714,45,85,50,55,50,65,350,0.5076923076923077,1.0
20,25,45,70,90,60,310,0.30833333333333335,45,85,50,55,50,65,350,0.5076923076923077,2.0
40,45,40,65,40,65,295,0.5661764705882353,190,33,58,33,58,33,405,0.13432835820895522,1.0
60,67,85,77,75,116,480,0.8888888888888888,100,50,50,76,96,70,442,0.5,0.5
126,131,95,131,98,99,680,0.8294573643410853,80,130,100,160,120,110,700,0.8981481481481481,2.0
40,80,100,30,30,20,300,0.11851851851851852,86,76,86,116,56,95,515,0.7982456140350878,0.0
30,40,55,40,55,60,280,0.3237410071942446,45,60,32,50,32,76,295,0.5925925925925926,1.0
50,25,28,45,55,15,218,0.0625,80,105,65,60,75,130,515,0.9645390070921985,1.0
100,180,160,150,90,90,770,0.7520661157024794,64,115,65,83,63,65,455,0.5323741007194245,1.0
45,22,60,27,30,29,213,0.07518796992481203,80,110,120,130,90,70,600,0.6198347107438017,0.5
30,45,135,45,90,30,375,0.09285714285714286,60,105,60,120,60,105,510,0.8849557522123894,1.0
50,160,110,160,110,110,700,0.8854961832061069,63,120,85,90,55,55,468,0.2809917355371901,2.0
76,65,45,92,42,91,411,0.7449664429530202,45,85,50,55,50,65,350,0.5076923076923077,2.0
50,30,55,65,55,20,275,0.13675213675213677,65,50,70,95,80,65,425,0.4262295081967213,2.0
70,120,100,145,105,20,560,0.2824427480916031,70,65,60,90,75,90,450,0.6571428571428571,2.0
100,100,100,100,100,100,600,0.8778625954198473,40,50,45,70,45,70,320,0.5517241379310345,0.5
50,35,55,25,25,15,205,0.021739130434782608,55,70,40,60,40,40,305,0.26956521739130435,1.0
60,85,40,30,45,68,328,0.6422018348623854,110,123,65,100,65,65,528,0.5217391304347826,2.0
64,88,50,88,50,106,446,0.9111111111111111,65,63,45,45,45,45,308,0.2595419847328244,1.0
95,117,80,65,70,92,519,0.8409090909090909,39,52,43,60,50,65,309,0.5041322314049587,2.0
84,71,43,71,43,48,360,0.25874125874125875,74,100,72,90,72,46,454,0.24561403508771928,1.0
74,48,76,83,81,104,466,0.7913043478260869,70,55,65,95,85,70,440,0.5307692307692308,0.5
110,80,90,95,90,65,530,0.5033557046979866,85,73,70,73,115,67,483,0.5126050420168067,1.0
70,55,95,95,110,65,490,0.48872180451127817,70,92,65,80,55,98,460,0.8090909090909091,1.0
91,90,129,90,72,108,580,0.9140625,66,41,77,61,87,23,355,0.12096774193548387,4.0
45,50,35,55,75,40,300,0.21367521367521367,50,180,20,180,20,150,600,0.9029850746268657,1.0
45,100,45,45,45,10,290,0.2949640287769784,60,85,60,50,50,125,430,0.9090909090909091,0.0
50,65,107,105,107,86,520,0.7313432835820896,44,38,33,61,43,70,289,0.5267857142857143,0.5
65,55,115,100,40,60,435,0.3798449612403101,50,150,50,150,50,150,600,0.9339622641509434,1.0
65,90,120,85,70,60,490,0.43410852713178294,86,81,97,81,107,43,495,0.203125,1.0
62,44,50,44,50,55,305,0.3629032258064516,125,130,90,130,90,95,660,0.7734375,0.5
35,46,34,35,45,20,215,0.072,43,30,55,40,65,97,330,0.6030534351145038,1.0
39,52,43,60,50,65,309,0.5041322314049587,60,50,150,50,150,60,520,0.5206611570247934,2.0
126,131,95,131,98,99,680,0.8102189781021898,55,104,105,94,75,52,485,0.36363636363636365,1.0
40,55,30,30,30,85,270,0.688,114,85,70,85,80,30,464,0.2066115702479339,2.0
45,25,50,25,25,35,205,0.13076923076923078,150,160,100,95,65,100,670,0.8866666666666667,1.0
38,41,40,50,65,65,299,0.4108527131782946,43,80,65,50,35,35,308,0.14193548387096774,0.5
50,50,150,50,150,50,500,0.2571428571428571,55,55,50,45,65,55,325,0.37373737373737376,1.0
80,115,80,65,55,93,488,0.7846153846153846,90,100,60,90,60,80,480,0.6422764227642277,2.0
70,145,88,140,70,112,625,0.8888888888888888,50,70,50,50,50,40,310,0.16296296296296298,0.5
40,40,35,50,100,70,335,0.5031847133757962,65,50,70,95,80,65,425,0.4262295081967213,1.0
45,80,100,35,37,28,325,0.3125,65,125,60,95,60,105,510,0.9236641221374046,1.0
110,65,105,55,95,80,510,0.6258503401360545,40,35,30,20,20,50,195,0.23423423423423423,2.0
80,92,65,65,80,68,450,0.4824561403508772,72,60,30,20,30,25,237,0.11570247933884298,1.0
60,55,90,145,90,80,520,0.6071428571428571,70,105,105,50,40,20,390,0.33587786259541985,0.5
75,98,63,98,63,101,498,0.8091603053435115,100,5,5,15,65,30,220,0.07692307692307693,1.0
90,60,70,75,70,45,410,0.23880597014925373,123,77,72,99,92,58,521,0.4621212121212121,1.0
75,75,75,125,95,40,485,0.15671641791044777,40,55,99,40,79,47,360,0.26262626262626265,2.0
95,85,85,65,65,35,430,0.2571428571428571,65,155,120,65,90,105,600,0.8677685950413223,0.0
55,65,35,60,30,85,330,0.6126126126126126,100,50,50,76,96,70,442,0.5,1.0
40,55,30,30,30,60,245,0.43548387096774194,75,55,70,55,95,110,460,0.8444444444444444,2.0
90,85,100,95,125,85,580,0.6834532374100719,75,98,63,98,63,101,498,0.849624060150376,0.5
65,90,120,85,70,60,490,0.43410852713178294,75,55,70,55,95,110,460,0.8444444444444444,2.0
90,30,15,40,20,15,210,0.043478260869565216,38,30,85,55,65,30,303,0.21428571428571427,0.0
60,50,150,50,150,60,520,0.5206611570247934,50,30,55,65,55,20,275,0.13675213675213677,1.0
65,136,94,54,96,135,580,0.9612403100775194,50,85,40,85,40,35,335,0.1746031746031746,1.0
40,40,50,30,30,30,220,0.0873015873015873,40,50,90,30,55,65,330,0.44680851063829785,0.25
80,135,85,70,95,150,615,0.9844961240310077,40,45,40,65,40,65,295,0.5661764705882353,0.5
105,130,120,45,45,40,485,0.4444444444444444,115,115,85,90,75,100,580,0.8134328358208955,4.0
80,145,150,105,110,110,700,0.8692307692307693,55,65,35,60,30,85,330,0.6126126126126126,0.5
35,40,100,90,55,35,355,0.1796875,255,10,10,75,135,55,540,0.3125,1.0
45,30,15,85,65,65,305,0.36220472440944884,70,65,60,90,75,90,450,0.6571428571428571,2.0
100,123,75,57,75,80,510,0.6923076923076923,74,108,133,83,65,32,495,0.32142857142857145,0.25
31,45,90,30,30,40,266,0.21929824561403508,50,120,53,35,110,87,455,0.640625,0.5
100,180,160,150,90,90,770,0.7520661157024794,72,85,70,65,70,58,420,0.41304347826086957,0.5
75,90,90,140,90,115,600,0.9481481481481482,65,95,100,60,50,50,420,0.34959349593495936,0.5
75,90,50,110,80,95,500,0.7985611510791367,85,115,80,105,80,50,515,0.3063063063063063,1.0
50,105,79,35,110,76,455,0.6214285714285714,89,124,80,55,80,55,483,0.5714285714285714,0.0
50,40,85,40,65,25,305,0.08870967741935484,55,75,85,25,25,15,280,0.1875,1.0
40,30,35,45,40,55,245,0.31496062992125984,65,100,70,80,80,105,500,0.8666666666666667,1.0
73,115,60,60,60,90,458,0.6694915254237288,70,135,105,60,105,20,495,0.5806451612903226,0.5
90,85,100,95,125,85,580,0.6834532374100719,78,84,78,109,85,100,534,0.8620689655172413,0.5
49,55,42,42,37,85,310,0.6068376068376068,40,45,40,65,40,65,295,0.5661764705882353,1.0
100,100,90,150,140,90,670,0.71875,58,64,58,80,65,80,405,0.5423728813559322,2.0
95,65,65,110,130,60,525,0.4016393442622951,50,70,160,70,160,90,600,0.7417218543046358,1.0
90,130,80,65,85,55,505,0.4396551724137931,85,120,70,50,60,100,485,0.8308823529411765,1.0
70,55,55,80,60,45,365,0.2222222222222222,78,104,78,159,115,100,634,0.8444444444444444,2.0
60,90,70,60,120,40,440,0.27419354838709675,100,110,90,85,90,60,535,0.47794117647058826,1.0
80,82,78,95,80,85,500,0.6869565217391305,10,55,25,35,45,95,265,0.5396825396825397,2.0
150,160,100,95,65,100,670,0.8866666666666667,80,105,105,105,105,80,580,0.5939849624060151,1.0
65,110,130,60,65,95,525,0.8278145695364238,84,71,43,71,43,48,360,0.25874125874125875,1.0
75,90,90,140,90,115,600,0.9481481481481482,30,45,55,70,55,85,340,0.5633802816901409,0.5
60,50,70,50,90,65,385,0.39568345323741005,73,95,62,85,65,85,465,0.6666666666666666,1.0
78,92,75,74,63,118,500,0.8842975206611571,106,130,90,110,154,90,680,0.719626168224299,0.5
75,55,70,55,95,110,460,0.8444444444444444,73,95,62,85,65,85,465,0.6666666666666666,1.0
40,45,35,65,55,70,310,0.4482758620689655,73,115,60,60,60,90,458,0.6694915254237288,1.0
80,145,150,105,110,110,700,0.8692307692307693,91,72,90,129,90,108,580,0.8925619834710744,0.5
40,40,55,40,70,55,300,0.40939597315436244,61,84,65,70,70,70,420,0.5,1.0
60,25,35,70,80,60,330,0.3076923076923077,70,120,40,95,40,95,460,0.8106060606060606,0.0
75,95,122,58,75,69,494,0.5725806451612904,70,110,180,60,60,50,530,0.4117647058823529,1.0
44,50,91,24,86,10,305,0.1981981981981982,60,40,80,60,45,40,325,0.23529411764705882,0.5
70,95,85,55,65,70,440,0.5,105,150,90,150,90,95,680,0.8285714285714286,2.0
150,120,100,120,100,90,680,0.664179104477612,75,98,63,98,63,101,498,0.8091603053435115,1.0
50,150,50,150,50,150,600,0.9339622641509434,55,55,45,63,45,45,308,0.25,1.0
45,50,55,75,65,30,320,0.06293706293706294,76,147,90,60,70,97,540,0.8267716535433071,0.5
50,65,45,85,65,95,405,0.7238095238095238,55,35,50,55,110,85,390,0.6277372262773723,0.25
70,105,105,50,40,20,390,0.33587786259541985,50,65,107,105,107,86,520,0.7758620689655172,1.0
82,80,86,85,75,72,480,0.6183206106870229,55,70,40,60,40,40,305,0.26956521739130435,1.0
60,65,60,130,75,110,500,0.7719298245614035,70,55,95,95,110,65,490,0.48872180451127817,2.0
55,69,85,32,35,28,304,0.09302325581395349,110,80,90,95,90,65,530,0.5033557046979866,0.25
70,110,75,145,85,145,630,0.9444444444444444,62,50,58,73,54,72,369,0.4435483870967742,0.5
30,45,135,45,90,30,375,0.09285714285714286,40,30,30,40,50,30,220,0.07936507936507936,1.0
50,53,48,53,48,64,316,0.4076923076923077,75,80,60,65,90,102,472,0.8625954198473282,1.0
130,70,35,70,35,60,400,0.4017857142857143,75,123,67,95,85,95,540,0.7642276422764228,1.0
20,10,230,10,230,5,505,0.0,114,85,70,85,80,30,464,0.2066115702479339,1.0
70,55,55,80,60,45,365,0.2222222222222222,40,29,45,29,45,36,224,0.14634146341463414,1.0
40,30,32,50,52,65,269,0.3671875,80,100,70,60,70,95,475,0.7416666666666667,1.0
35,20,65,40,65,20,245,0.02459016393442623,50,95,95,35,110,70,455,0.5179856115107914,2.0
60,62,50,62,60,40,334,0.18181818181818182,85,135,130,60,80,25,515,0.40540540540540543,2.0
50,53,48,53,48,64,316,0.358974358974359,90,120,75,60,60,45,450,0.29411764705882354,1.0
55,84,105,114,75,52,485,0.2890625,60,70,105,70,120,75,500,0.5983606557377049,2.0
100,100,80,60,60,50,450,0.3050847457627119,41,64,45,50,50,50,300,0.36752136752136755,2.0
75,95,122,58,75,69,494,0.5725806451612904,70,50,30,95,135,105,485,0.8040540540540541,1.0
40,60,40,40,40,30,250,0.0948905109489051,126,131,95,131,98,99,680,0.8102189781021898,1.0
105,140,95,55,65,45,505,0.3,60,50,150,50,150,60,520,0.5206611570247934,0.0
45,95,50,40,50,75,355,0.54,91,90,72,90,129,108,580,0.896,0.5
100,100,100,100,100,100,600,0.8805970149253731,60,55,50,40,55,45,305,0.22377622377622378,1.0
44,38,39,61,79,42,303,0.2251655629139073,55,69,85,32,35,28,304,0.09302325581395349,1.0
91,72,90,129,90,108,580,0.8925619834710744,30,30,42,30,42,70,244,0.4230769230769231,0.25
54,63,52,83,56,97,405,0.7697841726618705,105,95,75,85,75,74,509,0.5714285714285714,1.0
80,130,100,160,120,110,700,0.8981481481481481,80,75,150,75,150,50,580,0.30973451327433627,0.25
89,145,90,105,80,91,600,0.8549618320610687,80,110,60,150,130,70,600,0.5042016806722689,1.0
60,50,150,50,150,60,520,0.5206611570247934,55,50,40,40,40,75,300,0.5945945945945946,0.0
60,50,100,85,70,65,430,0.47580645161290325,50,65,85,35,35,55,325,0.32575757575757575,2.0
83,80,80,135,80,121,579,0.9444444444444444,40,30,32,50,52,65,269,0.3671875,2.0
100,100,80,60,60,50,450,0.3050847457627119,95,109,105,75,85,56,525,0.34513274336283184,2.0
39,52,43,60,50,65,309,0.5041322314049587,50,50,95,40,50,35,320,0.20279720279720279,1.0
64,66,68,81,76,50,405,0.25190839694656486,76,147,90,60,70,97,540,0.8267716535433071,0.5
74,48,76,83,81,104,466,0.7913043478260869,75,75,95,75,95,113,528,0.9015151515151515,1.0
43,30,55,40,65,97,330,0.6030534351145038,86,68,72,109,66,106,507,0.8099173553719008,2.0
70,50,30,95,135,105,485,0.8040540540540541,50,53,48,53,48,64,316,0.358974358974359,0.5
70,45,48,60,65,35,323,0.15748031496062992,40,45,35,65,55,70,310,0.4482758620689655,1.0
80,120,130,55,65,45,495,0.37037037037037035,75,95,60,65,60,115,470,0.8778625954198473,1.0
100,150,90,180,160,90,770,0.7348484848484849,108,100,121,81,95,95,600,0.7476635514018691,1.0
50,65,107,105,107,86,520,0.7313432835820896,61,78,95,56,58,57,405,0.40336134453781514,0.25
65,45,55,45,70,45,325,0.24369747899159663,120,70,120,75,130,85,600,0.6694915254237288,1.0
110,65,105,55,95,80,510,0.6258503401360545,40,45,35,30,40,55,245,0.3793103448275862,1.0
65,130,60,75,60,75,465,0.689922480620155,53,51,53,61,56,40,314,0.14285714285714285,1.0
76,25,45,67,55,24,292,0.0390625,95,75,80,100,110,30,490,0.24242424242424243,0.5
75,90,140,60,60,40,465,0.3008130081300813,70,80,65,90,65,85,455,0.578125,2.0
60,85,60,50,50,125,430,0.9090909090909091,50,35,55,25,25,15,205,0.021739130434782608,2.0
40,55,30,30,30,85,270,0.688,103,93,67,71,61,84,479,0.7142857142857143,1.0
91,72,90,129,90,108,580,0.8925619834710744,65,65,45,75,45,95,390,0.72,0.25
100,77,77,128,128,90,600,0.6901408450704225,75,75,130,75,130,95,580,0.7479674796747967,0.5
45,55,39,35,39,42,255,0.18518518518518517,80,105,65,60,75,130,515,0.9645390070921985,0.5
97,165,60,65,50,58,495,0.3902439024390244,40,45,40,62,60,60,307,0.33884297520661155,2.0
30,56,35,25,35,72,253,0.48148148148148145,85,110,90,45,90,80,500,0.6206896551724138,1.0
125,170,100,120,90,95,700,0.77,85,73,70,73,115,67,483,0.5126050420168067,1.0
65,90,120,85,70,60,490,0.43410852713178294,76,48,48,57,62,34,325,0.11688311688311688,1.0
70,135,105,60,105,20,495,0.5806451612903226,40,80,100,30,30,20,300,0.11851851851851852,2.0
30,30,42,30,42,70,244,0.4230769230769231,65,65,45,75,45,95,390,0.72,1.0
83,80,75,70,70,101,479,0.8615384615384616,68,90,65,50,55,82,410,0.6165413533834586,1.0
55,75,85,25,25,15,280,0.1875,45,60,32,50,32,76,295,0.5925925925925926,1.0
50,75,70,35,70,48,348,0.29357798165137616,70,95,85,55,65,70,440,0.5,2.0
120,70,120,75,130,85,600,0.6694915254237288,70,60,70,87,78,85,450,0.6228070175438597,1.0
68,72,78,38,42,32,330,0.23809523809523808,55,85,55,50,55,60,360,0.4233576642335766,1.0
55,50,65,175,95,150,590,0.7818181818181819,64,115,65,83,63,65,455,0.5323741007194245,1.0
126,131,95,131,98,99,680,0.8102189781021898,50,55,50,36,30,43,264,0.2922077922077922,1.0
115,45,20,45,25,20,270,0.11538461538461539,30,45,135,45,90,30,375,0.09285714285714286,0.5
64,115,65,83,63,65,455,0.5323741007194245,125,120,90,170,100,95,700,0.78125,1.0
88,107,122,74,75,64,530,0.4596774193548387,45,60,32,50,32,76,295,0.5925925925925926,1.0
55,70,40,60,40,40,305,0.26956521739130435,100,5,5,15,65,30,220,0.07692307692307693,1.0
50,35,55,25,25,15,205,0.05263157894736842,62,48,54,63,60,68,355,0.5178571428571429,2.0
80,110,120,130,90,70,600,0.6198347107438017,65,75,90,97,123,44,494,0.1987179487179487,0.25
59,110,150,45,49,35,448,0.3333333333333333,90,85,75,115,100,115,580,0.9381443298969072,0.5
55,84,105,114,75,52,485,0.2890625,69,69,76,69,86,91,460,0.6554621848739496,0.5
80,75,150,75,150,50,580,0.30973451327433627,80,52,50,90,50,89,411,0.6666666666666666,1.0
50,70,50,50,50,70,340,0.5645161290322581,60,80,50,50,50,40,330,0.23853211009174313,1.0
100,150,120,120,100,90,680,0.6493506493506493,76,104,71,104,71,108,534,0.912751677852349,1.0
60,95,80,60,80,30,405,0.19480519480519481,65,47,55,73,75,85,400,0.65,0.5
70,130,100,55,80,65,500,0.608,45,85,50,55,50,65,350,0.5076923076923077,0.5
62,77,62,50,42,65,358,0.4838709677419355,55,104,105,94,75,52,485,0.36363636363636365,1.0
90,55,75,60,75,30,385,0.13970588235294118,40,30,30,55,30,85,270,0.4666666666666667,1.0
110,130,80,70,60,80,530,0.5862068965517241,70,110,180,60,60,50,530,0.4117647058823529,2.0
70,90,110,60,75,95,500,0.7333333333333333,85,60,65,135,105,100,550,0.7518248175182481,1.0
58,64,58,80,65,80,405,0.609271523178808,103,93,67,71,61,84,479,0.7142857142857143,1.0
75,80,85,110,90,50,490,0.3548387096774194,68,72,78,38,42,32,330,0.23809523809523808,1.0
80,120,80,120,80,100,580,0.8478260869565217,70,85,65,105,85,120,530,0.9262295081967213,2.0
60,115,105,65,70,80,495,0.7181818181818181,95,75,110,100,80,30,490,0.15267175572519084,0.5
68,65,65,125,115,80,518,0.6461538461538462,72,105,115,54,86,68,500,0.5149253731343284,1.0
60,67,85,77,75,116,480,0.8888888888888888,68,65,65,125,115,80,518,0.6461538461538462,1.0
60,82,45,45,45,74,351,0.5752212389380531,65,80,65,35,65,60,370,0.38405797101449274,1.0
45,49,65,49,65,45,318,0.275,79,115,70,125,80,111,580,0.864,0.5
40,27,60,37,50,66,280,0.36220472440944884,75,90,50,110,80,95,500,0.7985611510791367,0.5
65,90,115,45,115,58,488,0.5041322314049587,65,155,120,65,90,105,600,0.8677685950413223,0.25
40,55,30,30,30,60,245,0.43548387096774194,91,134,95,100,100,80,600,0.6304347826086957,1.0
75,103,80,70,80,92,500,0.7933884297520661,83,106,65,86,65,85,490,0.6640625,0.125
58,64,58,80,65,80,405,0.5423728813559322,75,80,95,90,100,50,490,0.2158273381294964,2.0
64,115,65,83,63,65,455,0.5323741007194245,46,87,60,30,40,57,320,0.37777777777777777,1.0
64,51,23,51,23,28,240,0.11363636363636363,38,30,85,55,65,30,303,0.21428571428571427,0.0
190,33,58,33,58,33,405,0.13432835820895522,110,130,80,70,60,80,530,0.5862068965517241,2.0
54,45,47,75,98,52,371,0.39669421487603307,81,102,77,85,75,85,505,0.5642857142857143,0.5
40,40,35,50,100,70,335,0.5031847133757962,75,123,67,95,85,95,540,0.7642276422764228,1.0
62,48,54,63,60,68,355,0.5178571428571429,60,55,50,40,55,45,305,0.22377622377622378,2.0
75,90,90,140,90,115,600,0.9481481481481482,40,55,80,35,60,30,300,0.15037593984962405,4.0
50,52,48,65,50,55,320,0.33098591549295775,100,150,120,120,100,90,680,0.6493506493506493,0.5
100,100,80,60,60,50,450,0.3050847457627119,40,55,30,30,30,60,245,0.43548387096774194,0.0
75,75,95,75,95,113,528,0.9015151515151515,74,48,76,83,81,104,466,0.7322834645669292,1.0
65,125,100,60,70,70,490,0.6099290780141844,60,60,60,60,60,60,360,0.38095238095238093,1.0
60,50,70,50,90,65,385,0.39568345323741005,38,35,35,65,55,50,278,0.2647058823529412,2.0
30,30,42,30,42,70,244,0.4230769230769231,20,10,55,15,20,80,200,0.17985611510791366,1.0
80,135,130,95,90,70,600,0.5181818181818182,30,40,55,40,55,60,280,0.3237410071942446,0.5
65,95,75,55,55,85,430,0.6933333333333334,60,110,70,60,60,100,460,0.8461538461538461,1.0
61,78,95,56,58,57,405,0.40336134453781514,55,70,55,40,55,85,360,0.7073170731707317,1.0
95,65,65,110,130,60,525,0.4016393442622951,61,78,95,56,58,57,405,0.40336134453781514,1.0
65,60,110,130,95,65,525,0.47761194029850745,100,123,75,57,75,80,510,0.6923076923076923,2.0
58,64,58,80,65,80,405,0.609271523178808,65,65,45,75,45,95,390,0.72,2.0
69,69,76,69,86,91,460,0.6554621848739496,80,160,60,170,130,80,680,0.6180555555555556,1.0
45,80,100,35,37,28,325,0.3125,70,75,60,105,60,105,475,0.88,0.5
40,45,35,40,40,90,290,0.65,80,125,75,40,95,85,500,0.6911764705882353,1.0
70,83,50,37,50,60,350,0.3360655737704918,83,106,65,86,65,85,490,0.6640625,2.0
60,67,85,77,75,116,480,0.8888888888888888,55,65,35,60,30,85,330,0.6126126126126126,2.0
61,90,45,50,50,160,456,0.9230769230769231,35,65,35,65,35,65,300,0.46621621621621623,1.0
76,104,71,104,71,108,534,0.912751677852349,80,82,78,95,80,85,500,0.6869565217391305,0.5
73,100,60,100,60,65,458,0.42657342657342656,40,40,40,70,40,20,250,0.032520325203252036,1.0
65,63,45,45,45,45,308,0.2595419847328244,90,55,75,60,75,30,385,0.13970588235294118,1.0
52,65,55,58,62,60,352,0.4482758620689655,45,30,15,85,65,65,305,0.36220472440944884,1.0
74,48,76,83,81,104,466,0.7322834645669292,60,85,42,85,42,91,405,0.8227848101265823,0.0
30,35,30,100,35,80,310,0.4765625,73,95,62,85,65,85,465,0.6666666666666666,0.0
85,90,80,70,80,130,535,0.9262295081967213,83,80,75,70,70,101,479,0.8615384615384616,1.0
45,53,70,40,60,42,310,0.25735294117647056,67,58,57,81,67,101,431,0.8790322580645161,0.5
100,100,100,100,100,100,600,0.8805970149253731,80,80,80,55,55,90,440,0.6417910447761194,1.0
60,40,60,40,60,35,295,0.18055555555555555,81,102,77,85,75,85,505,0.5642857142857143,1.0
44,50,91,24,86,10,305,0.1981981981981982,95,95,85,125,65,55,520,0.3894736842105263,0.5
90,132,105,132,105,30,594,0.4246575342465753,35,80,50,50,70,120,405,0.84375,4.0
50,48,43,46,41,60,288,0.47297297297297297,170,90,45,90,45,60,500,0.427536231884058,0.5
65,65,65,50,50,90,385,0.72,95,75,80,100,110,30,490,0.24242424242424243,0.5
80,145,150,105,110,110,700,0.8692307692307693,40,30,32,50,52,65,269,0.3671875,0.5
45,53,70,40,60,42,310,0.25735294117647056,75,100,110,45,55,65,450,0.5333333333333333,2.0
25,35,70,95,55,45,325,0.16783216783216784,80,105,105,105,105,80,580,0.5939849624060151,1.0
75,98,63,98,63,101,498,0.8091603053435115,45,75,37,70,55,83,365,0.6183206106870229,0.5
77,120,90,60,90,48,485,0.2785714285714286,120,70,120,75,130,85,600,0.6694915254237288,1.0
38,30,41,30,41,60,240,0.2897196261682243,65,80,80,59,63,58,405,0.4411764705882353,1.0
91,90,72,90,129,108,580,0.896,95,135,80,110,80,100,600,0.8248175182481752,0.125
68,85,65,165,135,100,618,0.8083333333333333,108,112,118,68,72,47,525,0.2916666666666667,2.0
110,65,105,55,95,80,510,0.6258503401360545,65,130,60,75,60,75,465,0.689922480620155,0.5
68,125,65,65,115,80,518,0.6277372262773723,60,60,75,60,75,80,410,0.7321428571428571,0.25
49,49,56,49,61,66,330,0.5190839694656488,45,50,43,40,38,62,278,0.40441176470588236,1.0
50,64,50,45,50,41,300,0.22727272727272727,44,38,33,61,43,70,289,0.5267857142857143,2.0
65,95,75,55,55,85,430,0.6933333333333334,38,36,38,32,36,57,237,0.3893805309734513,1.0
38,35,35,65,55,50,278,0.2647058823529412,65,80,140,40,70,70,465,0.5223880597014925,0.25
75,103,80,70,80,92,500,0.7933884297520661,90,92,75,92,85,60,494,0.49586776859504134,1.0
20,40,90,30,90,25,295,0.11363636363636363,108,170,115,120,95,92,700,0.7083333333333334,1.0
80,52,50,90,50,89,411,0.6666666666666666,45,50,43,40,38,62,278,0.40441176470588236,0.5
90,95,95,70,90,70,510,0.5230769230769231,78,70,61,50,61,100,420,0.8145161290322581,2.0
62,44,50,44,50,55,305,0.3629032258064516,110,123,65,100,65,65,528,0.5217391304347826,4.0
60,100,85,80,85,100,510,0.7007874015748031,50,50,40,30,30,50,250,0.2781954887218045,4.0
30,45,135,45,90,30,375,0.09285714285714286,60,60,60,35,35,30,280,0.11194029850746269,1.0
40,30,35,45,40,55,245,0.31496062992125984,25,35,70,95,55,45,325,0.16783216783216784,0.125
55,81,60,50,70,97,413,0.7214285714285714,45,85,70,40,40,60,340,0.5229357798165137,0.5
80,50,100,100,200,50,580,0.2357142857142857,90,100,90,125,85,90,580,0.7352941176470589,1.0
60,60,50,40,50,75,335,0.5882352941176471,70,50,30,95,135,105,485,0.8040540540540541,1.0
39,52,43,60,50,65,309,0.5041322314049587,70,55,75,45,65,60,370,0.45901639344262296,1.0
100,100,100,100,100,100,600,0.8602941176470589,72,58,80,103,80,97,490,0.7171052631578947,0.5
95,110,95,40,95,55,490,0.40336134453781514,30,105,90,25,25,50,325,0.2773722627737226,1.0
90,100,60,90,60,80,480,0.6422764227642277,105,30,105,140,105,55,540,0.3524590163934426,1.0
70,130,100,55,80,65,500,0.608,67,58,57,81,67,101,431,0.8790322580645161,0.125
44,38,39,61,79,42,303,0.2251655629139073,70,85,65,105,85,120,530,0.9262295081967213,1.0
80,70,65,80,120,100,515,0.8034188034188035,40,55,70,45,60,30,300,0.10619469026548672,0.0
80,45,65,90,110,80,470,0.5462962962962963,90,65,65,40,40,15,315,0.19672131147540983,0.5
53,51,53,61,56,40,314,0.14285714285714285,85,110,90,45,90,80,500,0.6206896551724138,1.0
73,95,62,85,65,85,465,0.6666666666666666,100,120,120,150,100,90,680,0.7880794701986755,0.5
50,53,48,53,48,64,316,0.46153846153846156,35,65,35,65,35,65,300,0.46621621621621623,0.5
90,110,80,100,80,95,555,0.7982456140350878,50,65,64,44,48,43,314,0.2196969696969697,0.5
85,105,55,85,50,115,495,0.9032258064516129,62,48,66,59,57,49,341,0.33884297520661155,1.0
65,65,65,50,50,90,385,0.72,75,87,63,87,63,98,473,0.865546218487395,0.5
80,100,70,60,70,95,475,0.7416666666666667,106,190,100,154,100,130,780,0.9259259259259259,1.0
45,30,15,85,65,65,305,0.36220472440944884,95,117,80,65,70,92,519,0.8409090909090909,0.0
103,60,86,60,86,50,445,0.3458646616541353,55,130,115,50,50,75,475,0.5982142857142857,1.0
55,95,55,35,75,115,430,0.9380530973451328,55,75,60,75,60,103,428,0.7982456140350878,2.0
125,120,90,170,100,95,700,0.78125,126,131,95,131,98,99,680,0.8102189781021898,2.0
35,40,100,90,55,35,355,0.1796875,63,63,47,41,41,74,329,0.56,1.0
116,55,85,107,95,29,487,0.06818181818181818,72,85,70,65,70,58,420,0.41304347826086957,0.0
50,53,48,53,48,64,316,0.46153846153846156,40,40,55,40,70,55,300,0.40939597315436244,1.0
101,72,72,99,89,29,462,0.1937984496124031,65,130,60,95,110,65,525,0.5303030303030303,0.5
55,63,90,50,80,42,380,0.21138211382113822,45,45,55,45,55,63,308,0.4594594594594595,1.0
60,30,30,36,56,50,262,0.32432432432432434,70,20,50,20,50,40,250,0.1557377049180328,1.0
110,65,105,55,95,80,510,0.6258503401360545,58,70,45,40,45,42,300,0.25925925925925924,1.0
95,60,79,100,125,81,540,0.6201550387596899,65,75,90,97,123,44,494,0.1987179487179487,0.5
45,35,45,62,53,35,275,0.11851851851851852,50,65,107,105,107,86,520,0.6991150442477876,0.5
74,94,131,54,116,20,489,0.4485294117647059,35,64,85,74,55,32,345,0.19827586206896552,1.0
75,100,66,60,66,115,482,0.918918918918919,60,70,50,100,50,65,395,0.5217391304347826,1.0
60,40,60,95,60,55,370,0.4222222222222222,95,60,79,100,125,81,540,0.6201550387596899,0.5
60,65,60,130,75,110,500,0.7719298245614035,75,90,50,110,80,95,500,0.7985611510791367,0.5
60,79,105,59,85,36,424,0.17054263565891473,45,40,60,40,75,50,310,0.2926829268292683,0.0
60,90,70,60,120,40,440,0.27419354838709675,70,75,80,135,80,135,575,0.917910447761194,1.0
30,105,90,25,25,50,325,0.2773722627737226,100,100,100,100,100,100,600,0.8805970149253731,0.5
91,90,129,90,72,108,580,0.9140625,45,35,45,62,53,35,275,0.11851851851851852,1.0
76,65,45,92,42,91,411,0.7449664429530202,44,58,44,58,44,61,309,0.41964285714285715,1.0
70,65,60,90,75,90,450,0.6571428571428571,52,65,55,58,62,60,352,0.4482758620689655,0.5
60,55,90,145,90,80,520,0.6071428571428571,55,55,55,85,55,30,335,0.1320754716981132,2.0
80,70,40,100,60,145,495,0.921875,59,59,58,90,70,73,409,0.5826086956521739,0.5
50,85,85,55,55,50,380,0.3902439024390244,50,92,108,92,108,35,485,0.2457627118644068,2.0
20,40,15,35,35,60,205,0.34285714285714286,90,130,80,65,85,55,505,0.4396551724137931,1.0
70,45,48,60,65,35,323,0.15748031496062992,79,105,70,145,80,101,580,0.8608695652173913,1.0
65,150,40,15,80,145,495,0.9663865546218487,40,65,95,60,45,35,340,0.13986013986013987,0.25
60,90,55,90,80,110,485,0.8677685950413223,70,55,95,95,110,65,490,0.48872180451127817,1.0
80,80,50,40,50,25,325,0.176056338028169,35,64,85,74,55,32,345,0.19827586206896552,1.0
65,130,60,75,60,75,465,0.689922480620155,110,160,110,80,110,100,670,0.8591549295774648,1.0
80,95,82,60,82,75,474,0.6,50,85,40,85,40,35,335,0.1746031746031746,2.0
40,60,30,31,31,70,262,0.4492753623188406,45,65,34,40,34,45,263,0.2589928057553957,0.5
105,140,55,30,55,95,480,0.8195488721804511,62,48,66,59,57,49,341,0.33884297520661155,1.0
65,65,60,130,95,110,525,0.823943661971831,50,35,55,25,25,15,205,0.021739130434782608,1.0
50,65,107,105,107,86,520,0.7758620689655172,50,48,43,46,41,60,288,0.47297297297297297,0.0
57,24,86,24,86,23,300,0.12727272727272726,50,30,55,65,55,20,275,0.13675213675213677,0.5
70,94,50,94,50,66,424,0.48148148148148145,80,160,60,170,130,80,680,0.6180555555555556,4.0
40,45,65,100,120,90,460,0.5588235294117647,165,75,80,40,45,65,470,0.5151515151515151,1.0
38,30,85,55,65,30,303,0.21428571428571427,255,10,10,75,135,55,540,0.3125,0.0
85,97,66,105,66,65,484,0.47107438016528924,67,58,57,81,67,101,431,0.8790322580645161,1.0
90,90,85,125,90,100,580,0.768595041322314,74,94,131,54,116,20,489,0.4485294117647059,0.5
50,47,50,57,50,65,319,0.463768115942029,45,85,50,55,50,65,350,0.5076923076923077,0.5
72,60,30,20,30,25,237,0.11570247933884298,66,41,77,61,87,23,355,0.12096774193548387,2.0
95,100,85,108,70,70,528,0.5652173913043478,70,65,65,55,55,70,380,0.5,1.0
45,100,135,65,135,45,525,0.29411764705882354,64,78,52,78,52,81,405,0.6422764227642277,1.0
110,80,90,95,90,65,530,0.5033557046979866,100,150,120,120,100,90,680,0.6493506493506493,1.0
65,70,60,65,65,115,440,0.8583333333333333,50,65,85,35,35,55,325,0.32575757575757575,0.5
81,102,77,85,75,85,505,0.5642857142857143,60,75,100,55,80,50,420,0.3088235294117647,0.0
72,58,80,103,80,97,490,0.7171052631578947,71,120,95,120,95,99,600,0.8203125,0.5
80,120,130,55,65,45,495,0.37037037037037035,45,20,50,60,120,50,345,0.24074074074074073,0.0
38,35,40,27,25,35,200,0.08208955223880597,90,93,55,70,55,55,418,0.3819444444444444,0.25
25,20,15,105,55,90,310,0.32407407407407407,40,30,30,55,30,85,270,0.4666666666666667,1.0
91,134,95,100,100,80,600,0.6304347826086957,30,35,30,100,35,80,310,0.4765625,1.0
68,65,65,125,115,80,518,0.6461538461538462,35,20,65,40,65,20,245,0.02459016393442623,1.0
55,50,45,135,95,120,500,0.7714285714285715,30,40,70,70,25,60,295,0.41353383458646614,1.0
80,80,80,80,80,80,480,0.6015037593984962,78,92,75,74,63,118,500,0.8842975206611571,2.0
95,155,109,70,130,81,640,0.6788321167883211,105,140,55,30,55,95,480,0.8195488721804511,2.0
60,80,110,50,80,45,425,0.2833333333333333,82,121,119,69,59,71,521,0.5394736842105263,2.0
50,40,85,40,65,25,305,0.08870967741935484,106,190,100,154,100,130,780,0.9259259259259259,1.0
70,80,65,90,65,85,455,0.578125,60,100,85,80,85,100,510,0.7007874015748031,0.5
40,60,40,40,40,30,250,0.0948905109489051,70,140,230,60,80,50,630,0.32432432432432434,0.0
105,130,120,45,45,40,485,0.4444444444444444,45,49,65,49,65,45,318,0.275,0.5
67,58,57,81,67,101,431,0.8790322580645161,70,77,60,97,60,108,472,0.8394160583941606,0.5
250,5,5,35,105,50,450,0.15306122448979592,67,57,55,77,55,114,425,0.8879310344827587,1.0
67,58,57,81,67,101,431,0.8790322580645161,130,70,35,70,35,60,400,0.4017857142857143,2.0
50,65,107,105,107,86,520,0.7313432835820896,60,85,60,50,50,125,430,0.9090909090909091,1.0
80,125,75,40,95,85,500,0.6911764705882353,65,60,110,130,95,65,525,0.47761194029850745,2.0
50,55,50,36,30,43,264,0.2922077922077922,75,90,50,110,80,95,500,0.7985611510791367,1.0
100,70,70,65,65,45,415,0.1897810218978102,71,82,64,64,59,112,452,0.9327731092436975,1.0
49,49,56,49,61,66,330,0.5190839694656488,90,55,75,60,75,30,385,0.13970588235294118,1.0
57,24,86,24,86,23,300,0.12727272727272726,66,41,77,61,87,23,355,0.12096774193548387,2.0
91,129,90,72,90,108,580,0.8536585365853658,61,84,65,70,70,70,420,0.5,1.0
70,85,70,60,70,50,405,0.28378378378378377,40,45,40,65,40,65,295,0.5661764705882353,2.0
75,75,75,125,95,40,485,0.15671641791044777,90,60,70,75,70,45,410,0.23880597014925373,1.0
80,70,65,80,120,100,515,0.8034188034188035,40,50,90,30,55,65,330,0.44680851063829785,0.5
75,65,55,65,55,69,384,0.43548387096774194,50,65,107,105,107,86,520,0.7313432835820896,0.5
40,70,40,35,40,60,285,0.392,40,55,30,30,30,60,245,0.43548387096774194,1.0
60,82,45,45,45,74,351,0.5752212389380531,105,130,120,45,45,40,485,0.4444444444444444,2.0
106,110,90,154,90,130,680,0.926829268292683,70,95,125,65,75,45,475,0.33613445378151263,1.0
70,90,90,135,90,125,600,0.9401709401709402,100,70,70,65,65,45,415,0.1897810218978102,1.0
60,115,105,65,70,80,495,0.7181818181818181,59,110,150,45,49,35,448,0.3333333333333333,0.5
40,35,30,120,70,105,400,0.6692307692307692,60,45,70,75,85,55,390,0.3008130081300813,0.5
40,70,40,35,40,60,285,0.392,90,60,60,40,40,40,330,0.29545454545454547,1.0
70,83,50,37,50,60,350,0.3360655737704918,68,125,65,65,115,80,518,0.6277372262773723,2.0
70,60,70,87,78,85,450,0.6228070175438597,44,38,33,61,43,70,289,0.5267857142857143,1.0
45,55,39,35,39,42,255,0.18518518518518517,60,75,85,100,85,115,520,0.8992248062015504,1.0
71,95,85,110,95,79,535,0.664,95,23,48,23,48,23,260,0.046153846153846156,1.0
68,90,65,50,55,82,410,0.6165413533834586,45,49,65,49,65,45,318,0.275,0.5
85,97,66,105,66,65,484,0.47107438016528924,70,100,70,105,75,40,460,0.23214285714285715,0.5
75,125,70,125,70,115,580,0.9037037037037037,150,100,120,100,120,90,680,0.6666666666666666,1.0
61,78,95,56,58,57,405,0.40336134453781514,30,42,118,42,88,30,350,0.112,1.0
60,100,85,80,85,100,510,0.7007874015748031,50,85,40,85,40,35,335,0.1746031746031746,1.0
79,85,60,55,60,71,410,0.60431654676259,59,66,70,44,55,41,335,0.25190839694656486,0.0
53,51,53,61,56,40,314,0.14285714285714285,70,20,50,20,50,40,250,0.1557377049180328,0.5
60,48,45,43,90,42,328,0.21897810218978103,50,65,107,105,107,86,520,0.7758620689655172,1.0
85,135,130,60,80,25,515,0.40540540540540543,80,105,65,60,75,130,515,0.9645390070921985,2.0
80,105,65,60,75,130,515,0.9645390070921985,75,90,90,140,90,115,600,0.9481481481481482,2.0
50,35,55,25,25,15,205,0.05263157894736842,99,68,83,72,87,51,460,0.417910447761194,1.0
77,85,51,55,51,65,384,0.5163934426229508,35,70,55,45,55,25,285,0.09420289855072464,2.0
70,90,90,135,90,125,600,0.9401709401709402,40,45,40,35,35,56,251,0.373015873015873,1.0
70,55,75,45,65,60,370,0.45901639344262296,78,84,78,109,85,100,534,0.8646616541353384,1.0
80,100,70,60,70,95,475,0.7416666666666667,91,129,90,72,90,108,580,0.8536585365853658,1.0
46,87,60,30,40,57,320,0.37777777777777777,70,75,80,135,80,135,575,0.917910447761194,1.0
160,110,65,65,110,30,540,0.35714285714285715,125,58,58,76,76,67,460,0.515625,1.0
89,125,90,115,80,101,600,0.8725490196078431,60,45,70,75,85,55,390,0.3008130081300813,1.0
50,120,53,35,110,87,455,0.640625,60,30,30,36,56,50,262,0.32432432432432434,1.0
55,55,85,65,85,35,380,0.2014388489208633,60,60,60,105,105,105,495,0.848,1.0
50,65,107,105,107,86,520,0.7758620689655172,103,60,126,80,126,50,545,0.36363636363636365,1.0
95,110,80,70,80,50,485,0.37209302325581395,60,130,80,60,60,70,460,0.5153846153846153,2.0
60,85,40,30,45,68,328,0.6422018348623854,55,40,50,65,85,40,335,0.3181818181818182,1.0
70,115,60,115,60,55,475,0.4647887323943662,55,65,35,60,30,85,330,0.6126126126126126,2.0
68,75,53,83,113,60,452,0.45384615384615384,45,45,35,20,30,20,195,0.07246376811594203,1.0
110,65,105,55,95,80,510,0.6258503401360545,110,80,90,95,90,65,530,0.5033557046979866,1.0
100,100,100,100,100,100,600,0.8758169934640523,60,40,50,75,85,95,405,0.6044776119402985,0.5
80,145,150,105,110,110,700,0.8692307692307693,69,55,45,55,55,15,294,0.11666666666666667,2.0
45,35,50,70,50,30,280,0.15753424657534246,71,95,85,110,95,79,535,0.664,1.0
40,40,35,50,100,70,335,0.5031847133757962,61,78,95,56,58,57,405,0.40336134453781514,1.0
70,92,65,80,55,98,460,0.8090909090909091,105,180,100,180,100,115,780,0.9477611940298507,0.5
150,80,44,90,54,80,498,0.625,60,55,50,40,55,45,305,0.22377622377622378,2.0
90,50,34,60,44,70,348,0.6283185840707964,44,38,33,61,43,70,289,0.5267857142857143,0.0
80,100,123,122,120,80,625,0.56,75,80,60,65,90,102,472,0.8625954198473282,1.0
60,60,60,60,60,60,360,0.38095238095238093,50,65,64,44,48,43,314,0.2196969696969697,1.0
85,110,76,65,82,56,474,0.3933333333333333,66,65,48,62,57,52,350,0.36220472440944884,0.5
55,50,40,40,40,75,300,0.5945945945945946,59,110,150,45,49,35,448,0.3333333333333333,0.0
250,5,5,35,105,50,450,0.15306122448979592,64,88,50,88,50,106,446,0.9111111111111111,1.0
50,45,45,35,35,50,260,0.23529411764705882,66,117,70,40,50,67,410,0.4573643410852713,1.0
78,81,71,74,69,126,499,0.9090909090909091,101,72,72,99,89,29,462,0.1937984496124031,1.0
40,35,30,120,70,105,400,0.6692307692307692,45,50,55,75,65,30,320,0.06293706293706294,2.0
255,10,10,75,135,55,540,0.3125,50,70,50,50,50,70,340,0.5645161290322581,1.0
100,77,77,128,128,90,600,0.6901408450704225,35,55,40,45,40,60,275,0.35714285714285715,1.0
70,80,70,80,70,110,480,0.6594202898550725,55,55,45,63,45,45,308,0.25,0.5
50,180,20,180,20,150,600,0.9029850746268657,95,125,79,60,100,81,540,0.6165413533834586,1.0
61,78,95,56,58,57,405,0.40336134453781514,110,123,65,100,65,65,528,0.5217391304347826,0.5
80,80,50,40,50,25,325,0.176056338028169,70,85,65,105,85,120,530,0.9262295081967213,2.0
100,50,80,60,80,50,420,0.34375,72,105,115,54,86,68,500,0.5149253731343284,1.0
40,80,100,30,30,20,300,0.11851851851851852,40,35,30,120,70,105,400,0.6692307692307692,1.0
58,109,112,48,48,109,484,0.8805970149253731,60,90,140,50,50,40,430,0.2535211267605634,0.5
69,69,76,69,86,91,460,0.6554621848739496,89,125,90,115,80,101,600,0.8725490196078431,2.0
70,20,50,20,50,40,250,0.1557377049180328,71,120,95,120,95,99,600,0.8203125,0.5
25,20,15,105,55,90,310,0.32407407407407407,65,65,60,130,95,110,525,0.823943661971831,0.5
66,41,77,61,87,23,355,0.12096774193548387,83,106,65,86,65,85,490,0.6640625,0.25
70,55,65,95,85,70,440,0.5307692307692308,31,45,90,30,30,40,266,0.21929824561403508,2.0
66,65,48,62,57,52,350,0.36220472440944884,90,100,90,125,85,90,580,0.7352941176470589,0.25
70,120,100,145,105,20,560,0.2824427480916031,59,110,150,45,49,35,448,0.3333333333333333,4.0
55,45,45,25,25,15,210,0.048,103,60,126,80,126,50,545,0.36363636363636365,1.0
80,80,50,40,50,25,325,0.176056338028169,80,110,120,130,90,70,600,0.6198347107438017,1.0
62,48,66,59,57,49,341,0.33884297520661155,77,59,50,67,63,46,362,0.23140495867768596,1.0
75,98,63,98,63,101,498,0.8091603053435115,60,50,100,85,70,65,430,0.47580645161290325,1.0
90,120,100,150,120,100,680,0.7718120805369127,45,65,34,40,34,45,263,0.2589928057553957,1.0
62,73,55,56,52,84,382,0.7244094488188977,85,100,122,58,75,54,494,0.3939393939393939,4.0
40,80,100,30,30,20,300,0.11851851851851852,80,80,90,110,130,110,600,0.8721804511278195,1.0
110,85,95,80,95,50,515,0.2713178294573643,75,75,60,83,60,60,413,0.39344262295081966,1.0
45,90,20,65,20,65,305,0.5116279069767442,55,84,105,114,75,52,485,0.2890625,0.5
90,65,65,40,40,15,315,0.19672131147540983,60,70,105,70,120,75,500,0.5983606557377049,2.0
85,135,130,60,80,25,515,0.40540540540540543,75,38,38,56,56,67,330,0.5263157894736842,1.0
130,70,35,70,35,60,400,0.4017857142857143,80,100,70,60,70,95,475,0.7416666666666667,0.5
116,55,85,107,95,29,487,0.06818181818181818,75,80,55,25,35,35,305,0.18666666666666668,1.0
60,90,55,90,80,110,485,0.8677685950413223,90,85,75,115,100,115,580,0.9381443298969072,0.5
65,40,70,80,140,70,465,0.5954198473282443,80,50,100,100,200,50,580,0.2357142857142857,1.0
110,85,95,80,95,50,515,0.2713178294573643,78,104,78,159,115,100,634,0.8444444444444444,1.0
90,65,65,40,40,15,315,0.19672131147540983,130,70,35,70,35,60,400,0.4017857142857143,0.5
80,95,82,60,82,75,474,0.6,55,70,55,40,55,85,360,0.7073170731707317,1.0
40,30,35,45,40,55,245,0.31496062992125984,60,130,80,60,60,70,460,0.5153846153846153,4.0
80,125,75,40,95,85,500,0.6911764705882353,110,130,80,70,60,80,530,0.5862068965517241,2.0
38,30,85,55,65,30,303,0.21428571428571427,95,145,130,120,90,120,700,0.9398496240601504,1.0
100,70,70,65,65,45,415,0.1897810218978102,85,110,90,45,90,80,500,0.6206896551724138,1.0
70,90,90,135,90,125,600,0.9401709401709402,63,60,55,50,50,71,349,0.5289256198347108,1.0
72,85,70,65,70,58,420,0.41304347826086957,70,135,105,60,105,20,495,0.5806451612903226,0.5
60,45,50,90,80,70,395,0.625,79,105,70,145,80,101,580,0.8608695652173913,0.25
40,55,99,40,79,47,360,0.26262626262626265,120,100,85,30,85,45,465,0.22448979591836735,0.5
65,83,57,95,85,105,490,0.8914728682170543,30,40,70,70,25,60,295,0.41353383458646614,2.0
55,85,122,58,75,99,494,0.8099173553719008,45,75,37,70,55,83,365,0.6183206106870229,0.5
40,55,70,45,60,30,300,0.10619469026548672,80,130,100,160,120,110,700,0.8981481481481481,1.0
30,65,100,45,25,40,305,0.1891891891891892,10,55,25,35,45,95,265,0.5396825396825397,2.0
90,55,75,60,75,30,385,0.13970588235294118,70,140,230,60,80,50,630,0.32432432432432434,0.5
70,55,75,45,65,60,370,0.45901639344262296,65,50,35,115,95,95,455,0.7333333333333333,2.0
50,48,43,46,41,60,288,0.47297297297297297,40,60,30,31,31,70,262,0.4492753623188406,0.0
255,10,10,75,135,55,540,0.3125,70,100,70,105,75,40,460,0.23214285714285715,1.0
55,65,95,95,45,85,440,0.6610169491525424,60,82,45,45,45,74,351,0.5752212389380531,2.0
100,77,77,128,128,90,600,0.6901408450704225,40,50,45,70,45,70,320,0.5517241379310345,0.5
70,65,65,55,55,70,380,0.5,65,125,60,95,60,105,510,0.9236641221374046,1.0
44,58,44,58,44,61,309,0.41964285714285715,105,125,100,60,100,100,590,0.8359375,1.0
60,65,60,130,75,110,500,0.7719298245614035,65,65,60,130,95,110,525,0.823943661971831,2.0
75,80,95,90,100,50,490,0.2158273381294964,70,83,50,37,50,60,350,0.3360655737704918,0.5
65,75,70,95,70,95,470,0.7272727272727273,50,75,45,40,45,60,315,0.4380165289256198,2.0
40,60,30,31,31,70,262,0.4492753623188406,70,120,100,145,105,20,560,0.2824427480916031,1.0
100,90,130,45,65,55,485,0.4253731343283582,90,93,55,70,55,55,418,0.3819444444444444,2.0
100,100,80,60,60,50,450,0.3050847457627119,65,130,60,95,110,65,525,0.5303030303030303,1.0
80,82,78,95,80,85,500,0.6869565217391305,45,45,55,45,55,63,308,0.4594594594594595,0.5
40,55,99,40,79,47,360,0.26262626262626265,40,40,55,40,70,55,300,0.40939597315436244,1.0
45,75,37,70,55,83,365,0.6183206106870229,54,66,70,44,55,46,335,0.4214876033057851,2.0
90,120,120,60,60,50,500,0.35294117647058826,57,80,91,80,87,75,470,0.5737704918032787,2.0
70,85,140,85,70,20,470,0.272,60,100,85,80,85,100,510,0.7007874015748031,1.0
65,65,60,110,95,130,525,0.9253731343283582,65,155,120,65,90,105,600,0.8677685950413223,2.0
76,48,48,57,62,34,325,0.11688311688311688,100,100,90,150,140,90,670,0.71875,0.5
70,135,105,60,105,20,495,0.5806451612903226,65,75,90,97,123,44,494,0.1987179487179487,0.5
50,20,55,25,25,30,205,0.09774436090225563,55,55,55,85,55,30,335,0.1320754716981132,2.0
90,65,65,40,40,15,315,0.19672131147540983,85,105,85,40,50,40,405,0.211864406779661,1.0
30,105,90,25,25,50,325,0.2773722627737226,69,55,45,55,55,15,294,0.11666666666666667,0.5
90,75,75,90,100,70,500,0.5462184873949579,75,75,130,75,130,95,580,0.7479674796747967,1.0
78,84,78,109,85,100,534,0.8646616541353384,101,72,72,99,89,29,462,0.1937984496124031,1.0
55,50,45,135,95,120,500,0.7714285714285715,60,50,50,60,70,50,340,0.28346456692913385,1.0
100,70,70,65,65,45,415,0.1897810218978102,30,35,30,100,35,80,310,0.4765625,0.0
70,90,110,60,75,95,500,0.7333333333333333,60,75,100,55,80,50,420,0.3088235294117647,0.0
75,95,67,125,95,83,540,0.7117117117117117,69,55,45,55,55,15,294,0.11666666666666667,2.0
65,125,100,60,70,70,490,0.6099290780141844,59,110,150,45,49,35,448,0.3333333333333333,1.0
55,81,60,50,70,97,413,0.7214285714285714,85,120,70,50,60,100,485,0.8308823529411765,1.0
69,69,76,69,86,91,460,0.6554621848739496,70,110,75,145,85,145,630,0.9444444444444444,0.25
50,65,45,85,65,95,405,0.7238095238095238,75,90,140,60,60,40,465,0.3008130081300813,0.25
50,53,48,53,48,64,316,0.358974358974359,100,120,120,150,100,90,680,0.7880794701986755,0.5
50,65,107,105,107,86,520,0.7313432835820896,58,89,77,45,45,48,362,0.3177570093457944,0.5
63,120,85,90,55,55,468,0.2809917355371901,50,65,107,105,107,86,520,0.7758620689655172,0.5
108,100,121,81,95,95,600,0.7476635514018691,59,110,150,45,49,35,448,0.3333333333333333,1.0
50,70,50,50,50,40,310,0.16296296296296298,50,95,180,85,45,70,525,0.5298507462686567,0.5
80,82,100,83,100,80,525,0.6821705426356589,99,68,83,72,87,51,460,0.417910447761194,0.25
90,132,105,132,105,30,594,0.4246575342465753,35,80,50,50,70,120,405,0.84375,4.0
60,30,30,36,56,50,262,0.32432432432432434,45,30,50,55,65,45,290,0.208,1.0
54,66,70,44,55,46,335,0.4214876033057851,70,100,70,105,75,40,460,0.23214285714285715,1.0
50,75,70,35,70,48,348,0.29357798165137616,103,60,126,80,126,50,545,0.36363636363636365,0.5
50,70,50,50,50,40,310,0.16296296296296298,70,80,102,80,102,40,474,0.2677165354330709,1.0
55,50,40,40,40,75,300,0.5945945945945946,65,125,100,60,70,70,490,0.6099290780141844,0.5
30,35,30,100,35,80,310,0.4765625,45,60,45,25,45,55,275,0.29,0.0
106,130,90,110,154,90,680,0.719626168224299,100,5,5,15,65,30,220,0.07692307692307693,1.0
48,72,48,72,48,48,336,0.25984251968503935,40,45,35,30,40,55,245,0.3793103448275862,2.0
67,57,55,77,55,114,425,0.8879310344827587,63,120,85,90,55,55,468,0.2809917355371901,0.0
126,131,95,131,98,99,680,0.8102189781021898,91,134,95,100,100,80,600,0.6304347826086957,1.0
80,120,70,110,70,80,530,0.6422764227642277,100,100,100,100,100,100,600,0.8345864661654135,1.0
75,75,95,75,95,113,528,0.9015151515151515,30,56,35,25,35,72,253,0.48148148148148145,1.0
45,53,70,40,60,42,310,0.25735294117647056,100,110,90,85,90,60,535,0.47794117647058826,4.0
95,75,180,130,80,30,590,0.13793103448275862,45,30,40,105,50,20,290,0.031007751937984496,0.5
60,40,60,95,60,55,370,0.4222222222222222,50,50,150,50,150,50,500,0.2571428571428571,0.5
80,52,50,90,50,89,411,0.6666666666666666,55,20,35,20,45,75,250,0.37681159420289856,1.0
60,105,60,120,60,105,510,0.8849557522123894,60,45,70,45,90,95,405,0.7304964539007093,1.0
68,65,65,125,115,80,518,0.6461538461538462,83,80,75,70,70,101,479,0.8615384615384616,1.0
103,93,67,71,61,84,479,0.7142857142857143,120,100,85,30,85,45,465,0.22448979591836735,0.5
80,52,50,90,50,89,411,0.6666666666666666,90,100,70,110,150,80,600,0.6037735849056604,1.0
60,85,42,85,42,91,405,0.8227848101265823,65,60,70,85,75,40,395,0.1796875,1.0
80,80,80,80,80,80,480,0.5606060606060606,45,50,55,75,65,30,320,0.06293706293706294,0.5
53,51,53,61,56,40,314,0.14285714285714285,75,80,70,65,75,90,455,0.7578125,1.0
72,85,70,65,70,58,420,0.41304347826086957,40,45,65,100,120,90,460,0.5588235294117647,0.0
72,95,67,103,71,122,530,0.9606299212598425,73,76,75,81,100,100,505,0.8110236220472441,2.0
70,110,75,145,85,145,630,0.9444444444444444,20,10,230,10,230,5,505,0.0,1.0
50,75,35,70,30,40,300,0.21296296296296297,80,120,70,110,70,80,530,0.6422764227642277,0.5
75,70,90,70,105,80,490,0.656,83,80,75,70,70,101,479,0.8615384615384616,1.0
50,20,40,20,40,20,190,0.0962962962962963,70,70,40,60,40,60,340,0.4247787610619469,2.0
109,66,84,81,99,32,471,0.2013888888888889,65,65,45,75,45,95,390,0.72,0.0
85,135,130,60,80,25,515,0.40540540540540543,75,98,63,98,63,101,498,0.889763779527559,2.0
72,85,70,65,70,58,420,0.41304347826086957,79,85,60,55,60,71,410,0.60431654676259,1.0
97,165,60,65,50,58,495,0.3902439024390244,65,80,65,35,65,60,370,0.38405797101449274,1.0
80,92,65,65,80,68,450,0.4824561403508772,59,45,40,35,40,31,250,0.14285714285714285,1.0
105,140,55,30,55,95,480,0.8195488721804511,72,58,80,103,80,97,490,0.7171052631578947,1.0
50,50,50,50,50,50,300,0.30708661417322836,71,73,88,120,89,59,500,0.43537414965986393,0.5
54,66,70,44,55,46,335,0.4214876033057851,1,90,45,30,30,40,236,0.33064516129032256,1.0
40,55,70,45,60,30,300,0.10619469026548672,80,120,70,110,70,80,530,0.6422764227642277,0.5
62,48,54,63,60,68,355,0.5178571428571429,55,130,115,50,50,75,475,0.5982142857142857,1.0
65,65,60,110,95,130,525,0.9253731343283582,50,160,110,160,110,110,700,0.8854961832061069,1.0
115,140,130,55,55,40,535,0.4519230769230769,170,90,45,90,45,60,500,0.427536231884058,1.0
100,100,100,100,100,100,600,0.831858407079646,110,160,110,80,110,100,670,0.8591549295774648,1.0
95,65,110,60,130,65,525,0.5275590551181102,60,50,100,85,70,65,430,0.47580645161290325,1.0
150,160,100,95,65,100,670,0.8866666666666667,64,78,52,78,52,81,405,0.6422764227642277,1.0
50,105,79,35,110,76,455,0.6214285714285714,40,40,55,40,70,55,300,0.40939597315436244,0.5
40,50,90,30,55,65,330,0.44680851063829785,76,104,71,104,71,108,534,0.912751677852349,0.25
82,121,119,69,59,71,521,0.5394736842105263,50,85,55,65,65,90,410,0.7478260869565218,2.0
78,65,68,112,154,75,552,0.628099173553719,84,71,43,71,43,48,360,0.25874125874125875,1.0
65,40,70,80,140,70,465,0.5954198473282443,67,82,62,46,48,43,348,0.22033898305084745,2.0
45,50,55,75,65,30,320,0.06293706293706294,50,85,40,85,40,35,335,0.1746031746031746,1.0
100,100,125,110,50,50,535,0.384,108,170,115,120,95,92,700,0.7083333333333334,1.0
100,150,110,95,110,70,635,0.5923076923076923,61,78,95,56,58,57,405,0.40336134453781514,0.25
65,55,115,100,40,60,435,0.3798449612403101,70,110,80,55,80,105,500,0.8794326241134752,0.25
100,150,110,95,110,70,635,0.5923076923076923,75,69,72,114,100,104,534,0.8253968253968254,4.0
64,115,65,83,63,65,455,0.5323741007194245,90,92,87,75,85,76,505,0.5409836065573771,1.0
65,63,45,45,45,45,308,0.2595419847328244,30,80,90,55,45,55,355,0.4295774647887324,0.25
90,60,60,40,40,40,330,0.29545454545454547,45,50,35,55,75,40,300,0.21367521367521367,1.0
55,68,64,45,55,31,318,0.11666666666666667,110,80,90,95,90,65,530,0.5033557046979866,2.0
106,130,90,110,154,90,680,0.719626168224299,40,45,35,30,40,55,245,0.3793103448275862,1.0
61,90,45,50,50,160,456,0.9230769230769231,104,91,63,91,73,68,490,0.5118110236220472,1.0
50,150,50,150,50,150,600,0.9339622641509434,45,55,45,65,45,75,330,0.5692307692307692,1.0
40,70,40,35,40,60,285,0.392,38,41,40,50,65,65,299,0.4108527131782946,1.0
50,55,50,36,30,43,264,0.2922077922077922,65,73,55,47,75,85,400,0.6846846846846847,2.0
55,81,60,50,70,97,413,0.7214285714285714,30,30,42,30,42,70,244,0.4230769230769231,1.0
78,81,71,74,69,126,499,0.9090909090909091,100,150,90,180,160,90,770,0.7348484848484849,0.5
77,85,51,55,51,65,384,0.5163934426229508,45,49,65,49,65,45,318,0.275,2.0
40,60,30,31,31,70,262,0.4492753623188406,62,73,55,56,52,84,382,0.7244094488188977,1.0
40,55,99,40,79,47,360,0.26262626262626265,50,105,125,55,95,50,480,0.375886524822695,0.0
45,50,45,115,55,95,405,0.6936936936936937,85,80,70,135,75,90,535,0.7006802721088435,0.0
55,75,85,25,25,15,280,0.1875,60,80,110,50,80,45,425,0.2833333333333333,0.5
67,82,62,46,48,43,348,0.22033898305084745,60,40,50,75,85,95,405,0.6044776119402985,1.0
40,40,35,50,100,70,335,0.5031847133757962,50,50,40,50,40,64,294,0.45588235294117646,0.5
106,90,130,90,154,110,680,0.8699186991869918,100,90,130,45,65,55,485,0.4253731343283582,0.5
72,105,115,54,86,68,500,0.5149253731343284,55,50,45,135,95,120,500,0.7714285714285715,1.0
80,110,60,150,130,70,600,0.5042016806722689,45,35,45,62,53,35,275,0.11851851851851852,1.0
35,20,65,40,65,20,245,0.02459016393442623,100,100,100,100,100,100,600,0.8758169934640523,0.5
120,100,85,30,85,45,465,0.22448979591836735,83,106,65,86,65,85,490,0.6640625,0.5
70,65,60,90,75,90,450,0.6571428571428571,70,75,60,105,60,105,475,0.88,1.0
30,105,90,25,25,50,325,0.2773722627737226,130,85,80,85,95,60,535,0.43884892086330934,0.5
55,85,55,50,55,60,360,0.4233576642335766,63,60,55,50,50,71,349,0.5289256198347108,0.5
75,75,75,125,95,40,485,0.15671641791044777,80,120,130,55,65,45,495,0.37037037037037035,2.0
89,125,90,115,80,101,600,0.8725490196078431,45,50,43,40,38,62,278,0.40441176470588236,0.0
80,100,80,80,80,100,520,0.9051724137931034,50,50,150,50,150,50,500,0.2571428571428571,0.0
79,100,80,110,90,121,580,0.968,50,64,50,45,50,41,300,0.22727272727272727,0.5
80,50,100,100,200,50,580,0.2357142857142857,40,30,32,50,52,65,269,0.3671875,0.5
30,30,42,30,42,70,244,0.4230769230769231,95,75,110,100,80,30,490,0.15267175572519084,2.0
85,80,90,105,95,60,515,0.49074074074074076,37,25,41,25,41,25,194,0.08870967741935484,1.0
116,55,85,107,95,29,487,0.06818181818181818,60,80,50,50,50,40,330,0.23853211009174313,1.0
49,55,42,42,37,85,310,0.6068376068376068,45,63,37,65,55,95,360,0.8055555555555556,1.0
45,100,45,45,45,10,290,0.2949640287769784,90,92,87,75,85,76,505,0.5409836065573771,2.0
50,120,53,35,110,87,455,0.640625,75,98,63,98,63,101,498,0.849624060150376,1.0
65,75,105,35,65,85,430,0.6940298507462687,55,40,40,65,45,35,280,0.16428571428571428,1.0
84,71,43,71,43,48,360,0.25874125874125875,105,30,105,140,105,55,540,0.3524590163934426,1.0
57,24,86,24,86,23,300,0.12727272727272726,84,86,88,111,101,60,530,0.4634146341463415,0.125
64,66,68,81,76,50,405,0.25190839694656486,60,50,150,50,150,60,520,0.5206611570247934,1.0
45,45,55,45,55,63,308,0.4594594594594595,75,95,95,95,95,85,540,0.6470588235294118,1.0
62,77,62,50,42,65,358,0.4838709677419355,75,125,230,55,95,30,610,0.3448275862068966,0.25
63,63,47,41,41,74,329,0.56,50,20,40,20,40,20,190,0.0962962962962963,1.0
50,105,79,35,110,76,455,0.6214285714285714,60,48,45,43,90,42,328,0.21897810218978103,0.5
35,35,40,35,55,50,250,0.40336134453781514,70,60,75,110,75,90,480,0.7165354330708661,1.0
76,48,48,57,62,34,325,0.11688311688311688,60,40,60,40,60,35,295,0.18055555555555555,0.5
108,130,95,80,85,102,600,0.7637795275590551,50,20,40,20,40,20,190,0.0962962962962963,0.0
40,70,40,35,40,60,285,0.392,75,95,122,58,75,69,494,0.5725806451612904,0.0
88,107,122,74,75,64,530,0.4596774193548387,65,136,94,54,96,135,580,0.9612403100775194,2.0
35,20,65,40,65,20,245,0.02459016393442623,78,65,68,112,154,75,552,0.628099173553719,1.0
70,60,125,115,70,55,495,0.35507246376811596,150,160,100,95,65,100,670,0.8866666666666667,1.0
35,46,34,35,45,20,215,0.072,50,55,50,36,30,43,264,0.2922077922077922,1.0
85,120,70,50,60,100,485,0.8308823529411765,28,25,25,45,35,40,198,0.16083916083916083,1.0
65,95,75,55,55,85,430,0.6933333333333334,68,165,95,65,115,110,618,0.8615384615384616,1.0
75,100,110,45,55,65,450,0.5333333333333333,78,130,111,130,85,100,634,0.8561151079136691,2.0
90,110,80,100,80,95,555,0.7982456140350878,30,35,30,100,35,80,310,0.4765625,1.0
35,45,160,30,45,70,385,0.48148148148148145,48,72,48,72,48,48,336,0.25984251968503935,1.0
60,50,40,85,75,95,405,0.7540983606557377,150,80,44,90,54,80,498,0.625,2.0
79,85,60,55,60,71,410,0.60431654676259,85,50,95,120,115,80,545,0.5793650793650794,1.0
28,25,25,45,35,40,198,0.16083916083916083,65,45,55,45,70,45,325,0.24369747899159663,1.0
31,45,90,30,30,40,266,0.21929824561403508,38,35,40,27,25,35,200,0.08208955223880597,0.5
100,100,100,100,100,100,600,0.8805970149253731,55,65,35,60,30,85,330,0.6126126126126126,0.5
70,90,45,15,45,50,315,0.3629032258064516,110,123,65,100,65,65,528,0.5217391304347826,0.5
66,41,77,61,87,23,355,0.12096774193548387,50,100,150,100,150,50,600,0.37142857142857144,2.0
116,55,85,107,95,29,487,0.06818181818181818,65,90,115,45,115,58,488,0.5041322314049587,0.0
110,65,105,55,95,80,510,0.6258503401360545,50,30,55,65,55,20,275,0.13675213675213677,2.0
65,47,55,73,75,85,400,0.65,20,25,45,70,90,60,310,0.30833333333333335,1.0
40,30,30,40,50,30,220,0.07936507936507936,80,75,150,75,150,50,580,0.30973451327433627,0.5
60,75,85,100,85,115,520,0.8992248062015504,50,85,85,55,55,50,380,0.3902439024390244,0.5
45,100,135,65,135,45,525,0.29411764705882354,50,180,20,180,20,150,600,0.9029850746268657,2.0
100,134,110,95,100,61,600,0.4057971014492754,85,105,55,85,50,115,495,0.9032258064516129,1.0
80,85,95,30,30,25,345,0.2857142857142857,75,103,80,70,80,92,500,0.7933884297520661,0.5
65,155,120,65,90,105,600,0.8677685950413223,75,123,67,95,85,95,540,0.7642276422764228,0.5
45,90,20,65,20,65,305,0.5116279069767442,100,150,90,180,160,90,770,0.7348484848484849,0.5
90,110,80,100,80,95,555,0.7982456140350878,70,145,88,140,70,112,625,0.8888888888888888,2.0
45,30,35,20,20,45,195,0.14782608695652175,75,100,95,40,70,110,490,0.8717948717948718,1.0
106,110,90,154,90,130,680,0.926829268292683,105,180,100,180,100,115,780,0.9477611940298507,1.0
91,90,129,90,72,108,580,0.9140625,45,50,55,75,65,30,320,0.06293706293706294,0.5
250,5,5,35,105,50,450,0.15306122448979592,100,164,150,95,120,71,700,0.5645161290322581,0.5
72,85,70,65,70,58,420,0.41304347826086957,35,85,45,35,35,75,310,0.6492537313432836,1.0
10,55,25,35,45,95,265,0.5396825396825397,70,60,125,115,70,55,495,0.35507246376811596,2.0
42,52,67,39,56,50,306,0.2868217054263566,40,45,40,62,60,60,307,0.33884297520661155,4.0
85,76,64,45,55,90,415,0.6739130434782609,60,115,105,65,70,80,495,0.7181818181818181,0.5
60,48,45,43,90,42,328,0.21897810218978103,59,63,80,65,80,58,405,0.41843971631205673,1.0
85,56,77,50,77,78,423,0.53125,60,60,60,35,35,30,280,0.11194029850746269,1.0
40,45,40,35,35,56,251,0.373015873015873,50,52,48,65,50,55,320,0.33098591549295775,1.0
40,60,40,40,40,30,250,0.0948905109489051,30,42,118,42,88,30,350,0.112,0.0
79,85,60,55,60,71,410,0.60431654676259,86,68,72,109,66,106,507,0.8099173553719008,2.0
70,60,75,110,75,90,480,0.7165354330708661,50,50,62,40,62,65,329,0.4188034188034188,0.5
75,103,80,70,80,92,500,0.7933884297520661,30,40,55,40,55,60,280,0.3237410071942446,1.0
70,120,100,145,105,20,560,0.2824427480916031,90,100,90,125,85,90,580,0.7352941176470589,0.0
75,100,110,45,55,65,450,0.5333333333333333,40,20,30,40,80,55,265,0.22764227642276422,0.0
92,105,90,125,90,98,600,0.8217054263565892,57,80,91,80,87,75,470,0.5737704918032787,0.0
79,85,60,55,60,71,410,0.60431654676259,100,100,80,60,60,50,450,0.3050847457627119,2.0
135,85,40,40,85,5,390,0.6864406779661016,67,89,116,79,116,33,500,0.2624113475177305,0.5
70,80,70,80,70,110,480,0.6594202898550725,60,60,60,105,105,105,495,0.848,2.0
38,30,85,55,65,30,303,0.21428571428571427,30,65,100,45,25,40,305,0.1891891891891892,1.0
70,94,50,94,50,66,424,0.48148148148148145,45,95,50,40,50,75,355,0.54,1.0
75,90,90,140,90,115,600,0.9481481481481482,40,60,40,40,40,30,250,0.0948905109489051,2.0
45,30,50,55,65,45,290,0.208,60,150,50,150,50,60,520,0.5,0.5
95,109,105,75,85,56,525,0.34513274336283184,65,95,57,100,85,93,495,0.7441860465116279,1.0
31,45,90,30,30,40,266,0.21929824561403508,60,90,55,90,80,110,485,0.8677685950413223,2.0
85,90,80,70,80,130,535,0.9262295081967213,85,56,77,50,77,78,423,0.53125,0.5
40,45,40,35,35,56,251,0.373015873015873,75,123,67,95,85,95,540,0.7642276422764228,0.5
50,30,55,65,55,20,275,0.13675213675213677,100,150,140,100,90,90,670,0.7969924812030075,1.0
95,75,80,100,110,30,490,0.24242424242424243,80,92,65,65,80,68,450,0.4824561403508772,0.5
40,40,40,70,40,20,250,0.032520325203252036,80,52,50,90,50,89,411,0.6666666666666666,2.0
77,59,50,67,63,46,362,0.23140495867768596,30,45,55,70,55,85,340,0.5633802816901409,0.5
70,85,65,105,85,120,530,0.9262295081967213,60,90,140,50,50,40,430,0.2535211267605634,1.0
35,40,100,90,55,35,355,0.1796875,70,85,140,85,70,20,470,0.272,4.0
60,40,50,75,85,95,405,0.6044776119402985,70,85,70,60,70,50,405,0.28378378378378377,0.0
72,85,70,65,70,58,420,0.41304347826086957,10,55,25,35,45,95,265,0.5396825396825397,1.0
90,75,75,90,100,70,500,0.5462184873949579,43,80,65,50,35,35,308,0.14193548387096774,0.5
60,130,80,60,60,70,460,0.5153846153846153,50,35,55,25,25,15,205,0.021739130434782608,0.25
165,75,80,40,45,65,470,0.5151515151515151,58,64,58,80,65,80,405,0.5423728813559322,2.0
20,25,45,70,90,60,310,0.30833333333333335,75,38,38,56,56,67,330,0.5263157894736842,1.0
75,80,60,65,90,102,472,0.8625954198473282,78,70,61,50,61,100,420,0.8145161290322581,1.0
65,40,50,125,60,30,370,0.07258064516129033,72,85,70,65,70,58,420,0.41304347826086957,0.0
55,68,64,45,55,31,318,0.11666666666666667,73,115,60,60,60,90,458,0.6694915254237288,1.0
80,92,65,65,80,68,450,0.4824561403508772,60,50,70,80,80,140,480,0.8449612403100775,1.0
70,60,75,110,75,90,480,0.7165354330708661,58,50,145,95,105,30,483,0.2459016393442623,1.0
105,130,120,45,45,40,485,0.4444444444444444,60,40,60,95,60,55,370,0.4222222222222222,4.0
49,66,70,44,55,51,335,0.4260869565217391,90,100,60,90,60,80,480,0.6422764227642277,0.25
30,35,30,100,35,80,310,0.4765625,75,125,230,55,95,30,610,0.3448275862068966,0.0
108,100,121,81,95,95,600,0.7476635514018691,75,80,60,65,90,102,472,0.8625954198473282,1.0
65,80,80,59,63,58,405,0.4411764705882353,80,105,65,60,75,130,515,0.9645390070921985,2.0
75,90,140,60,60,40,465,0.3008130081300813,75,80,60,65,90,102,472,0.8625954198473282,1.0
50,85,85,55,55,50,380,0.3902439024390244,38,41,40,50,65,65,299,0.4108527131782946,0.25
65,95,75,55,55,85,430,0.6933333333333334,105,150,90,150,90,95,680,0.8285714285714286,0.5
67,89,116,79,116,33,500,0.2624113475177305,100,100,100,100,100,100,600,0.8345864661654135,0.5
40,30,35,45,40,55,245,0.31496062992125984,60,60,60,85,85,85,435,0.631578947368421,1.0
100,150,90,180,160,90,770,0.7348484848484849,70,105,105,50,40,20,390,0.33587786259541985,2.0
150,100,120,100,120,90,680,0.6666666666666666,80,120,79,95,79,70,523,0.5833333333333334,1.0
50,70,50,50,50,40,310,0.16296296296296298,70,80,65,90,65,85,455,0.578125,1.0
45,49,65,49,65,45,318,0.275,90,30,15,40,20,15,210,0.043478260869565216,1.0
65,90,120,85,70,60,490,0.43410852713178294,57,24,86,24,86,23,300,0.12727272727272726,0.0
60,85,49,60,49,60,363,0.4444444444444444,160,110,65,65,110,30,540,0.35714285714285715,1.0
78,70,61,50,61,100,420,0.8145161290322581,85,60,65,135,105,100,550,0.7518248175182481,1.0
70,60,75,110,75,90,480,0.7165354330708661,100,70,70,65,65,45,415,0.1897810218978102,1.0
90,75,85,115,90,55,510,0.3445378151260504,80,100,70,50,60,45,405,0.25806451612903225,1.0
40,45,35,65,55,70,310,0.4482758620689655,50,65,107,105,107,86,520,0.7272727272727273,0.5
135,85,40,40,85,5,390,0.6864406779661016,50,30,55,65,55,20,275,0.13675213675213677,0.0
65,80,65,35,65,60,370,0.38405797101449274,50,53,48,53,48,64,316,0.4076923076923077,1.0
40,40,50,30,30,30,220,0.0873015873015873,55,45,45,25,25,15,210,0.048,4.0
60,115,105,65,70,80,495,0.7181818181818181,70,130,100,55,80,65,500,0.608,1.0
50,65,64,44,48,43,314,0.2196969696969697,40,40,40,70,40,20,250,0.032520325203252036,2.0
60,85,40,30,45,68,328,0.6422018348623854,105,150,90,150,90,95,680,0.8285714285714286,0.0
100,103,75,120,75,127,600,0.940677966101695,77,59,50,67,63,46,362,0.23140495867768596,1.0
79,115,70,125,80,111,580,0.8468468468468469,170,90,45,90,45,60,500,0.427536231884058,1.0
90,120,120,60,60,50,500,0.35294117647058826,40,40,55,40,70,55,300,0.40939597315436244,1.0
30,105,90,25,25,50,325,0.2773722627737226,40,45,65,100,120,90,460,0.5588235294117647,1.0
80,160,80,130,80,100,630,0.8455284552845529,50,35,55,25,25,15,205,0.021739130434782608,1.0
105,95,75,85,75,74,509,0.5714285714285714,50,105,125,55,95,50,480,0.375886524822695,2.0
90,50,34,60,44,70,348,0.6283185840707964,50,53,48,53,48,64,316,0.4076923076923077,2.0
65,65,65,50,50,90,385,0.72,80,45,65,90,110,80,470,0.5462962962962963,1.0
30,45,135,45,90,30,375,0.09285714285714286,72,60,30,20,30,25,237,0.11570247933884298,0.5
50,20,55,25,25,30,205,0.09774436090225563,65,130,60,75,60,75,465,0.689922480620155,2.0
104,91,63,91,73,68,490,0.5118110236220472,70,55,65,95,85,70,440,0.5307692307692308,0.5
48,72,48,72,48,48,336,0.25984251968503935,90,120,75,60,60,45,450,0.29411764705882354,1.0
91,90,129,90,72,108,580,0.9140625,100,50,80,60,80,50,420,0.34375,0.125
50,120,53,35,110,87,455,0.640625,50,80,95,10,45,10,290,0.232,2.0
64,88,50,88,50,106,446,0.9111111111111111,75,98,63,98,63,101,498,0.8091603053435115,1.0
45,55,39,35,39,42,255,0.18518518518518517,60,60,40,65,45,35,305,0.15833333333333333,1.0
60,50,70,80,80,140,480,0.8449612403100775,46,87,60,30,40,57,320,0.37777777777777777,0.5
110,135,60,50,65,88,508,0.7744360902255639,70,120,100,145,105,20,560,0.2824427480916031,1.0
65,95,57,100,85,93,495,0.7441860465116279,91,129,90,72,90,108,580,0.8536585365853658,0.5
100,134,110,95,100,61,600,0.4057971014492754,100,100,100,100,100,100,600,0.8805970149253731,1.0
60,67,85,77,75,116,480,0.8888888888888888,50,120,53,35,110,87,455,0.640625,2.0
91,129,90,72,90,108,580,0.8536585365853658,59,45,40,35,40,31,250,0.14285714285714285,2.0
72,60,30,20,30,25,237,0.11570247933884298,50,25,28,45,55,15,218,0.0625,0.5
70,55,55,80,60,45,365,0.2222222222222222,65,47,55,73,75,85,400,0.65,1.0
71,120,95,120,95,99,600,0.8203125,85,60,65,135,105,100,550,0.7518248175182481,0.25
45,30,40,105,50,20,290,0.031007751937984496,62,55,52,109,94,109,481,0.7833333333333333,1.0
72,58,80,103,80,97,490,0.7171052631578947,80,85,95,30,30,25,345,0.2857142857142857,1.0
88,107,122,74,75,64,530,0.4596774193548387,44,38,39,61,79,42,303,0.2251655629139073,0.5
90,50,34,60,44,70,348,0.6283185840707964,100,75,115,90,115,85,580,0.6446280991735537,1.0
40,55,70,45,60,30,300,0.10619469026548672,65,125,100,60,70,70,490,0.6099290780141844,0.5
78,130,111,130,85,100,634,0.8561151079136691,68,65,65,125,115,80,518,0.6461538461538462,0.0
52,65,55,58,62,60,352,0.4482758620689655,111,83,68,92,82,39,475,0.1774193548387097,1.0
40,45,40,35,35,56,251,0.373015873015873,65,83,57,95,85,105,490,0.8914728682170543,0.5
95,85,85,65,65,35,430,0.2571428571428571,78,104,78,159,115,100,634,0.8444444444444444,0.0
70,85,65,105,85,120,530,0.9262295081967213,65,85,70,75,70,40,405,0.203125,1.0
65,90,50,85,45,55,390,0.371900826446281,54,45,47,75,98,52,371,0.39669421487603307,2.0
65,75,70,95,70,95,470,0.7272727272727273,68,72,78,38,42,32,330,0.23809523809523808,2.0
70,75,80,135,80,135,575,0.917910447761194,35,45,160,30,45,70,385,0.48148148148148145,0.0
40,55,30,30,30,85,270,0.688,79,100,80,110,90,121,580,0.968,1.0
75,80,70,65,75,90,455,0.7578125,110,65,75,125,85,30,490,0.15,1.0
85,105,55,85,50,115,495,0.9032258064516129,95,65,65,110,130,60,525,0.4016393442622951,1.0
86,92,88,68,75,73,482,0.6835443037974683,80,92,65,65,80,68,450,0.4824561403508772,1.0
60,60,60,105,105,105,495,0.848,91,129,90,72,90,108,580,0.8536585365853658,1.0
95,80,105,40,70,100,490,0.8046875,45,30,35,20,20,45,195,0.14782608695652175,1.0
82,121,119,69,59,71,521,0.5394736842105263,65,75,105,35,65,85,430,0.6940298507462687,1.0
75,75,60,83,60,60,413,0.39344262295081966,55,45,45,25,25,15,210,0.048,1.0
80,82,100,83,100,80,525,0.6821705426356589,130,70,35,70,35,60,400,0.4017857142857143,2.0
40,40,50,30,30,30,220,0.0873015873015873,45,50,45,115,55,95,405,0.6936936936936937,0.5
65,40,50,125,60,30,370,0.07258064516129033,60,59,85,79,105,36,424,0.16666666666666666,1.0
65,150,60,115,60,115,565,0.935251798561151,60,85,69,60,69,77,420,0.518796992481203,1.0
89,145,90,105,80,91,600,0.8549618320610687,60,67,85,77,75,116,480,0.8888888888888888,1.0
90,65,65,40,40,15,315,0.19672131147540983,50,30,55,65,55,20,275,0.13675213675213677,2.0
90,100,60,90,60,80,480,0.6422764227642277,44,38,33,61,43,70,289,0.5267857142857143,1.0
75,85,200,55,65,30,510,0.16778523489932887,110,123,65,100,65,65,528,0.5217391304347826,1.0
35,60,44,40,54,55,288,0.366412213740458,83,80,75,70,70,101,479,0.8615384615384616,1.0
80,160,80,130,80,100,630,0.8455284552845529,90,70,80,70,95,70,475,0.5190839694656488,2.0
100,100,100,100,100,100,600,0.8602941176470589,35,70,55,45,55,25,285,0.09420289855072464,0.25
60,75,100,55,80,50,420,0.3088235294117647,100,110,90,85,90,60,535,0.47794117647058826,1.0
75,123,67,95,85,95,540,0.7642276422764228,50,65,85,35,35,55,325,0.32575757575757575,1.0
72,58,80,103,80,97,490,0.7171052631578947,90,100,60,90,60,80,480,0.6422764227642277,0.0
165,75,80,40,45,65,470,0.5151515151515151,60,55,145,75,150,40,525,0.2,2.0
30,80,90,55,45,55,355,0.4295774647887324,51,65,65,80,75,59,395,0.4365079365079365,2.0
30,56,35,25,35,72,253,0.48148148148148145,55,55,55,85,55,30,335,0.1320754716981132,1.0
68,90,65,50,55,82,410,0.6165413533834586,85,110,90,45,90,80,500,0.6206896551724138,1.0
80,80,80,55,55,90,440,0.6417910447761194,90,100,70,110,150,80,600,0.6037735849056604,1.0
50,120,53,35,110,87,455,0.640625,84,71,43,71,43,48,360,0.25874125874125875,2.0
55,112,45,74,45,70,401,0.559322033898305,75,75,55,105,85,30,425,0.1619718309859155,2.0
75,65,55,65,55,69,384,0.43548387096774194,55,81,60,50,70,97,413,0.7214285714285714,1.0
100,50,50,76,96,70,442,0.5,38,36,38,32,36,57,237,0.3893805309734513,1.0
106,130,90,110,154,90,680,0.719626168224299,70,130,100,55,80,65,500,0.608,4.0
65,50,70,95,80,65,425,0.4262295081967213,105,125,100,60,100,100,590,0.8359375,1.0
35,55,35,30,30,35,220,0.23684210526315788,55,20,35,20,45,75,250,0.37681159420289856,1.0
65,65,60,130,95,110,525,0.823943661971831,62,55,52,109,94,109,481,0.7833333333333333,1.0
100,100,100,100,100,100,600,0.831858407079646,45,35,45,62,53,35,275,0.11851851851851852,1.0
150,100,120,100,120,90,680,0.6666666666666666,150,160,100,95,65,100,670,0.8866666666666667,0.0
30,45,59,30,39,57,260,0.2803030303030303,70,75,60,105,60,105,475,0.88,1.0
85,80,90,105,95,60,515,0.49074074074074076,95,110,95,40,95,55,490,0.40336134453781514,1.0
45,45,35,20,30,20,195,0.07246376811594203,65,90,122,58,75,84,494,0.71875,1.0
86,81,97,81,107,43,495,0.203125,75,75,130,75,130,95,580,0.7479674796747967,1.0
74,108,133,83,65,32,495,0.32142857142857145,71,82,64,64,59,112,452,0.9327731092436975,1.0
105,140,55,30,55,95,480,0.8195488721804511,61,78,95,56,58,57,405,0.40336134453781514,2.0
45,22,60,27,30,29,213,0.07518796992481203,60,85,42,85,42,91,405,0.8227848101265823,1.0
72,95,67,103,71,122,530,0.9606299212598425,50,25,28,45,55,15,218,0.0625,0.5
75,100,63,80,63,116,497,0.9345794392523364,58,64,58,80,65,80,405,0.5423728813559322,1.0
75,90,50,110,80,95,500,0.7985611510791367,100,100,100,100,100,100,600,0.8805970149253731,0.5
80,105,65,60,75,130,515,0.9645390070921985,79,103,120,135,115,78,630,0.5763888888888888,1.0
45,35,45,62,53,35,275,0.11851851851851852,54,63,52,83,56,97,405,0.7697841726618705,2.0
65,75,70,95,70,95,470,0.7272727272727273,65,95,75,55,55,85,430,0.6933333333333334,2.0
100,100,90,150,140,90,670,0.71875,50,52,48,65,50,55,320,0.33098591549295775,0.5
40,60,30,31,31,70,262,0.4492753623188406,66,117,70,40,50,67,410,0.4573643410852713,1.0
60,45,50,90,80,70,395,0.625,70,65,60,90,75,90,450,0.6571428571428571,1.0
60,100,115,70,85,90,520,0.7557251908396947,60,50,150,50,150,60,520,0.5206611570247934,0.5
45,35,45,62,53,35,275,0.11851851851851852,100,180,160,150,90,90,770,0.7520661157024794,1.0
70,92,65,80,55,98,460,0.8090909090909091,62,48,66,59,57,49,341,0.33884297520661155,1.0
52,65,55,58,62,60,352,0.4482758620689655,75,95,122,58,75,69,494,0.5725806451612904,0.0
95,23,48,23,48,23,260,0.046153846153846156,104,91,63,91,73,68,490,0.5118110236220472,1.0
79,115,70,125,80,111,580,0.864,60,150,50,150,50,60,520,0.5,0.5
104,91,63,91,73,68,490,0.5118110236220472,110,135,60,50,65,88,508,0.7744360902255639,0.5
45,45,35,20,30,20,195,0.07246376811594203,60,110,70,60,60,100,460,0.8461538461538461,0.5
38,36,38,32,36,57,237,0.3893805309734513,95,110,80,70,80,50,485,0.37209302325581395,1.0
85,73,70,73,115,67,483,0.5126050420168067,48,72,48,72,48,48,336,0.25984251968503935,0.5
95,95,85,125,65,55,520,0.3894736842105263,100,123,75,57,75,80,510,0.6923076923076923,0.5
125,130,90,130,90,95,660,0.7734375,72,85,70,65,70,58,420,0.41304347826086957,4.0
58,50,145,95,105,30,483,0.2459016393442623,85,110,76,65,82,56,474,0.3933333333333333,2.0
90,75,75,90,100,70,500,0.5462184873949579,45,67,60,35,50,63,320,0.5128205128205128,0.5
90,60,70,75,70,45,410,0.23880597014925373,65,130,60,75,60,75,465,0.689922480620155,1.0
45,67,60,35,50,63,320,0.5128205128205128,45,49,49,65,65,45,318,0.2781954887218045,0.5
41,64,45,50,50,50,300,0.36752136752136755,30,45,135,45,90,30,375,0.09285714285714286,1.0
91,90,106,130,106,77,600,0.648854961832061,71,120,95,120,95,99,600,0.8203125,2.0
40,45,40,62,60,60,307,0.33884297520661155,70,60,62,80,82,60,414,0.4375,2.0
105,140,55,30,55,95,480,0.8195488721804511,75,90,140,60,60,40,465,0.3008130081300813,4.0
90,93,55,70,55,55,418,0.3819444444444444,60,40,50,75,85,95,405,0.6044776119402985,1.0
60,100,115,70,85,90,520,0.7557251908396947,65,73,55,47,75,85,400,0.6846846846846847,1.0
40,55,80,35,60,30,300,0.15037593984962405,50,52,48,65,50,55,320,0.33098591549295775,0.5
75,89,85,55,65,36,405,0.29545454545454547,50,53,48,53,48,64,316,0.4076923076923077,0.5
90,100,60,90,60,80,480,0.6422764227642277,73,95,62,85,65,85,465,0.6666666666666666,1.0
40,65,95,60,45,35,340,0.13986013986013987,60,80,110,50,80,45,425,0.2833333333333333,0.5
50,72,35,35,35,65,292,0.5373134328358209,80,80,80,55,55,90,440,0.6417910447761194,1.0
60,60,60,85,85,85,435,0.631578947368421,70,70,70,70,70,70,420,0.5289256198347108,0.0
41,50,37,50,37,66,281,0.5175438596491229,50,65,107,105,107,86,520,0.703125,1.0
105,140,55,30,55,95,480,0.8195488721804511,20,25,45,70,90,60,310,0.30833333333333335,1.0
65,50,70,95,80,65,425,0.4262295081967213,70,85,65,105,85,120,530,0.9262295081967213,1.0
45,95,50,40,50,75,355,0.54,44,75,35,63,33,45,295,0.2647058823529412,0.5
55,50,65,175,95,150,590,0.7818181818181819,60,48,45,43,90,42,328,0.21897810218978103,0.5
50,72,35,35,35,65,292,0.5373134328358209,90,50,34,60,44,70,348,0.6283185840707964,0.0
55,69,85,32,35,28,304,0.09302325581395349,70,85,70,60,70,50,405,0.28378378378378377,1.0
30,30,30,30,30,30,180,0.12612612612612611,20,10,230,10,230,5,505,0.0,1.0
40,35,30,20,20,50,195,0.23423423423423423,65,55,115,100,40,60,435,0.3798449612403101,4.0
62,48,66,59,57,49,341,0.33884297520661155,60,70,65,125,105,90,515,0.6911764705882353,0.5
60,150,50,150,50,60,520,0.5,44,75,35,63,33,45,295,0.2647058823529412,2.0
250,5,5,35,105,50,450,0.15306122448979592,40,40,50,30,30,30,220,0.0873015873015873,1.0
50,53,48,53,48,64,316,0.4076923076923077,70,65,60,90,75,90,450,0.6571428571428571,0.25
75,65,55,65,55,69,384,0.43548387096774194,108,130,95,80,85,102,600,0.7637795275590551,1.0
45,49,49,65,65,45,318,0.2781954887218045,60,115,105,65,70,80,495,0.7181818181818181,2.0
60,70,105,70,120,75,500,0.5983606557377049,55,65,35,60,30,85,330,0.6126126126126126,1.0
106,110,90,154,90,130,680,0.926829268292683,60,70,65,125,105,90,515,0.6911764705882353,2.0
80,75,150,75,150,50,580,0.30973451327433627,80,110,60,150,130,70,600,0.5042016806722689,1.0
60,85,69,65,79,80,438,0.576,110,85,95,80,95,50,515,0.2713178294573643,1.0
45,60,32,50,32,76,295,0.5925925925925926,100,150,140,100,90,90,670,0.7969924812030075,0.0
38,35,35,65,55,50,278,0.2647058823529412,100,75,115,90,115,85,580,0.6446280991735537,1.0
55,55,50,45,65,55,325,0.37373737373737376,65,130,60,95,110,65,525,0.5303030303030303,1.0
86,81,97,81,107,43,495,0.203125,43,70,48,50,60,38,309,0.2391304347826087,0.5
75,69,72,114,100,104,534,0.8253968253968254,105,95,80,40,80,90,490,0.753968253968254,1.0
89,145,90,105,80,91,600,0.8549618320610687,70,95,85,55,65,70,440,0.5,1.0
75,98,63,98,63,101,498,0.889763779527559,55,112,45,74,45,70,401,0.559322033898305,0.5
60,90,70,60,120,40,440,0.27419354838709675,50,20,40,20,40,20,190,0.0962962962962963,1.0
75,90,140,60,60,40,465,0.3008130081300813,65,55,115,100,40,60,435,0.3798449612403101,2.0
73,115,60,60,60,90,458,0.6694915254237288,55,47,52,40,40,41,275,0.16806722689075632,1.0
70,95,85,55,65,70,440,0.5,80,100,200,50,100,50,580,0.3472222222222222,1.0
40,60,30,31,31,70,262,0.4492753623188406,20,10,55,15,20,80,200,0.17985611510791366,1.0
35,65,35,65,35,65,300,0.46621621621621623,65,125,100,55,70,85,500,0.6532258064516129,1.0
60,90,70,60,120,40,440,0.27419354838709675,30,45,135,45,90,30,375,0.09285714285714286,0.5
70,55,55,80,60,45,365,0.2222222222222222,110,80,90,95,90,65,530,0.5033557046979866,2.0
50,85,125,85,115,20,480,0.4306569343065693,60,85,42,85,42,91,405,0.8227848101265823,0.25
68,125,65,65,115,80,518,0.6277372262773723,60,62,80,63,80,60,405,0.4336283185840708,1.0
58,64,58,80,65,80,405,0.5423728813559322,65,125,60,95,60,105,510,0.9236641221374046,1.0
68,75,53,83,113,60,452,0.45384615384615384,95,70,73,95,90,60,483,0.3983739837398374,0.0
75,100,63,80,63,116,497,0.9345794392523364,78,84,78,109,85,100,534,0.8620689655172413,1.0
90,120,100,150,120,100,680,0.7718120805369127,45,35,45,62,53,35,275,0.11851851851851852,0.5
58,89,77,45,45,48,362,0.3177570093457944,70,45,48,60,65,35,323,0.15748031496062992,0.0
60,60,60,60,60,60,360,0.38095238095238093,97,165,60,65,50,58,495,0.3902439024390244,0.5
40,30,35,45,40,55,245,0.31496062992125984,50,75,75,65,65,50,380,0.4049586776859504,1.0
65,130,60,95,110,65,525,0.5303030303030303,50,85,40,85,40,35,335,0.1746031746031746,2.0
60,45,70,45,90,95,405,0.7304964539007093,55,55,85,65,85,35,380,0.2014388489208633,2.0
45,35,45,62,53,35,275,0.11851851851851852,54,45,47,75,98,52,371,0.39669421487603307,1.0
50,75,75,65,65,50,380,0.4049586776859504,90,100,70,110,150,80,600,0.6037735849056604,1.0
68,90,65,50,55,82,410,0.6165413533834586,80,80,50,40,50,25,325,0.176056338028169,2.0
60,90,70,60,120,40,440,0.27419354838709675,68,90,65,50,55,82,410,0.6165413533834586,1.0
79,115,70,125,80,111,580,0.8468468468468469,110,78,73,76,71,60,468,0.3333333333333333,1.0
59,59,58,90,70,73,409,0.5826086956521739,71,95,85,110,95,79,535,0.664,2.0
50,53,48,53,48,64,316,0.46153846153846156,55,45,45,25,25,15,210,0.048,0.5
80,82,100,83,100,80,525,0.6821705426356589,50,35,55,25,25,15,205,0.05263157894736842,0.5
45,55,39,35,39,42,255,0.18518518518518517,90,120,100,150,120,100,680,0.7718120805369127,1.0
80,52,50,90,50,89,411,0.6666666666666666,75,75,95,75,95,113,528,0.9015151515151515,4.0
100,123,75,57,75,80,510,0.6923076923076923,45,100,45,45,45,10,290,0.2949640287769784,1.0
45,50,45,115,55,95,405,0.6936936936936937,110,65,75,125,85,30,490,0.15,2.0
90,70,80,70,95,70,475,0.5190839694656488,55,75,50,40,40,80,340,0.6302521008403361,2.0
50,53,48,53,48,64,316,0.4076923076923077,50,64,50,45,50,41,300,0.22727272727272727,4.0
109,66,84,81,99,32,471,0.2013888888888889,91,90,106,130,106,77,600,0.648854961832061,4.0
49,55,42,42,37,85,310,0.6068376068376068,50,70,160,70,160,90,600,0.7417218543046358,1.0
30,40,70,70,25,60,295,0.41353383458646614,45,45,35,20,30,20,195,0.07246376811594203,1.0
70,120,65,45,85,125,510,0.9747899159663865,75,69,72,114,100,104,534,0.8253968253968254,1.0
75,75,95,75,95,113,528,0.9015151515151515,70,94,50,94,50,66,424,0.48148148148148145,0.25
65,130,60,95,110,65,525,0.5303030303030303,56,61,65,48,45,38,313,0.17567567567567569,2.0
50,65,64,44,48,43,314,0.2196969696969697,62,55,52,109,94,109,481,0.7833333333333333,1.0
68,165,95,65,115,110,618,0.8615384615384616,40,55,80,35,60,30,300,0.15037593984962405,0.25
68,65,65,125,115,80,518,0.6461538461538462,100,100,100,100,100,100,600,0.8778625954198473,0.25
45,50,45,115,55,95,405,0.6936936936936937,65,90,122,58,75,84,494,0.71875,2.0
68,65,65,125,115,80,518,0.6461538461538462,100,100,100,100,100,100,600,0.831858407079646,0.5
20,10,55,15,20,80,200,0.17985611510791366,65,110,130,60,65,95,525,0.8278145695364238,0.5
50,47,50,57,50,65,319,0.463768115942029,45,100,45,45,45,10,290,0.2949640287769784,0.0
55,95,115,45,45,35,390,0.2116788321167883,86,68,72,109,66,106,507,0.8099173553719008,4.0
75,75,75,125,95,40,485,0.15671641791044777,60,85,60,50,50,125,430,0.9090909090909091,1.0
70,62,67,55,55,56,365,0.38513513513513514,68,85,65,165,135,100,618,0.8083333333333333,2.0
20,40,15,35,35,60,205,0.34285714285714286,100,150,120,120,100,90,680,0.6493506493506493,0.25
80,145,150,105,110,110,700,0.8692307692307693,65,125,100,55,70,85,500,0.6532258064516129,1.0
50,75,35,70,30,40,300,0.21296296296296297,50,105,125,55,95,50,480,0.375886524822695,0.0
40,45,35,65,55,70,310,0.4482758620689655,50,100,150,100,150,50,600,0.37142857142857144,2.0
70,150,140,65,100,75,600,0.55,65,110,130,60,65,95,525,0.8278145695364238,2.0
60,60,60,85,85,85,435,0.631578947368421,55,81,60,50,70,97,413,0.7214285714285714,0.0
72,85,70,65,70,58,420,0.41304347826086957,65,40,50,125,60,30,370,0.07258064516129033,2.0
65,155,120,65,90,105,600,0.8677685950413223,58,70,45,40,45,42,300,0.25925925925925924,1.0
60,85,49,60,49,60,363,0.4444444444444444,20,40,90,30,90,25,295,0.11363636363636363,1.0
95,75,180,130,80,30,590,0.13793103448275862,64,88,50,88,50,106,446,0.9111111111111111,0.0
75,75,75,125,95,40,485,0.15671641791044777,45,63,37,65,55,95,360,0.8055555555555556,1.0
75,125,75,30,75,85,465,0.625,83,106,65,86,65,85,490,0.6640625,0.5
100,100,125,110,50,50,535,0.384,85,110,76,65,82,56,474,0.3933333333333333,0.5
80,90,80,130,110,110,600,0.856,85,70,80,97,80,123,535,0.9304347826086956,2.0
100,100,100,100,100,100,600,0.8805970149253731,70,145,88,140,70,112,625,0.8888888888888888,1.0
65,83,57,95,85,105,490,0.8914728682170543,40,70,130,60,130,25,455,0.17355371900826447,1.0
105,140,95,55,65,45,505,0.3,110,123,65,100,65,65,528,0.5217391304347826,1.0
80,82,83,100,100,80,525,0.6742424242424242,70,50,30,95,135,105,485,0.8040540540540541,1.0
150,80,44,90,54,80,498,0.625,52,65,50,45,50,38,300,0.27419354838709675,0.5
80,100,70,60,70,95,475,0.7416666666666667,75,125,75,30,75,85,465,0.625,1.0
65,150,40,15,80,145,495,0.9663865546218487,48,61,40,61,40,50,300,0.2543859649122807,0.125
57,24,86,24,86,23,300,0.12727272727272726,55,75,85,25,25,15,280,0.1875,2.0
82,80,86,85,75,72,480,0.6183206106870229,35,55,40,45,40,60,275,0.35714285714285715,1.0
80,160,60,170,130,80,680,0.6180555555555556,66,41,77,61,87,23,355,0.12096774193548387,1.0
55,50,45,135,95,120,500,0.7714285714285715,105,105,75,65,100,50,500,0.37593984962406013,2.0
40,45,40,62,60,60,307,0.33884297520661155,40,20,30,40,80,55,265,0.22764227642276422,2.0
64,88,50,88,50,106,446,0.9111111111111111,60,80,110,50,80,45,425,0.2833333333333333,1.0
70,90,70,60,60,70,420,0.6390977443609023,114,85,70,85,80,30,464,0.2066115702479339,1.0
90,93,55,70,55,55,418,0.3819444444444444,80,100,123,122,120,80,625,0.56,1.0
65,90,65,61,61,100,442,0.8373983739837398,75,125,100,70,80,45,495,0.33035714285714285,0.5
43,80,65,50,35,35,308,0.14193548387096774,95,117,80,65,70,92,519,0.8409090909090909,2.0
91,72,90,129,90,108,580,0.8925619834710744,85,110,90,45,90,80,500,0.6206896551724138,2.0
80,160,80,130,80,100,630,0.8455284552845529,95,117,80,65,70,92,519,0.8409090909090909,2.0
45,90,20,65,20,65,305,0.5116279069767442,70,85,70,60,70,50,405,0.28378378378378377,1.0
55,20,35,20,45,75,250,0.37681159420289856,95,145,130,120,90,120,700,0.9398496240601504,1.0
71,73,88,120,89,59,500,0.43537414965986393,70,70,70,70,70,70,420,0.5289256198347108,1.0
58,64,58,80,65,80,405,0.609271523178808,50,65,45,85,65,95,405,0.7238095238095238,2.0
90,92,75,92,85,60,494,0.49586776859504134,70,80,70,80,70,110,480,0.6594202898550725,0.5
95,110,80,70,80,50,485,0.37209302325581395,40,60,40,40,40,30,250,0.0948905109489051,1.0
60,40,60,40,60,35,295,0.18055555555555555,65,95,100,60,50,50,420,0.34959349593495936,0.5
52,65,50,45,50,38,300,0.27419354838709675,35,64,85,74,55,32,345,0.19827586206896552,1.0
50,95,95,35,110,70,455,0.5179856115107914,52,65,50,45,50,38,300,0.27419354838709675,2.0
76,48,48,57,62,34,325,0.11688311688311688,60,100,89,55,69,112,485,0.9298245614035088,1.0
44,58,44,58,44,61,309,0.41964285714285715,70,145,88,140,70,112,625,0.8888888888888888,2.0
45,90,20,65,20,65,305,0.5116279069767442,90,110,80,100,80,95,555,0.7982456140350878,2.0
45,100,45,45,45,10,290,0.2949640287769784,60,75,100,55,80,50,420,0.3088235294117647,2.0
51,65,65,80,75,59,395,0.4365079365079365,81,102,77,85,75,85,505,0.5642857142857143,2.0
60,50,70,50,90,65,385,0.39568345323741005,110,85,95,80,95,50,515,0.2713178294573643,1.0
45,30,40,105,50,20,290,0.031007751937984496,30,45,55,70,55,85,340,0.5633802816901409,1.0
125,120,90,170,100,95,700,0.78125,58,50,145,95,105,30,483,0.2459016393442623,1.0
100,100,100,100,100,100,600,0.8345864661654135,70,140,230,60,80,50,630,0.32432432432432434,0.25
60,60,60,105,105,105,495,0.848,40,45,35,30,40,55,245,0.3793103448275862,1.0
49,66,70,44,55,51,335,0.4260869565217391,75,125,230,55,95,30,610,0.3448275862068966,1.0
95,125,79,60,100,81,540,0.6165413533834586,65,55,115,100,40,60,435,0.3798449612403101,1.0
30,80,90,55,45,55,355,0.4295774647887324,65,155,120,65,90,105,600,0.8677685950413223,4.0
80,130,100,160,120,110,700,0.8981481481481481,45,50,45,115,55,95,405,0.6936936936936937,2.0
50,50,120,80,80,30,410,0.07258064516129033,100,150,120,120,100,90,680,0.6493506493506493,0.5
60,62,50,62,60,40,334,0.18181818181818182,100,123,75,57,75,80,510,0.6923076923076923,1.0
60,50,150,50,150,60,520,0.5206611570247934,81,102,77,85,75,85,505,0.5642857142857143,1.0
45,65,34,40,34,45,263,0.2589928057553957,110,85,95,80,95,50,515,0.2713178294573643,1.0
79,115,70,125,80,111,580,0.8468468468468469,80,85,95,30,30,25,345,0.2857142857142857,0.5
115,140,130,55,55,40,535,0.4519230769230769,90,60,60,40,40,40,330,0.29545454545454547,0.5
30,30,30,30,30,30,180,0.12612612612612611,70,120,40,95,40,95,460,0.8106060606060606,2.0
75,75,95,75,95,113,528,0.9015151515151515,70,65,60,90,75,90,450,0.6571428571428571,0.25
50,60,45,100,80,65,400,0.45689655172413796,84,86,88,111,101,60,530,0.4634146341463415,0.0
70,80,50,35,35,35,305,0.14,67,125,40,30,30,58,350,0.3431372549019608,2.0
60,25,35,70,80,60,330,0.3076923076923077,90,120,100,150,120,100,680,0.7718120805369127,1.0
85,76,64,45,55,90,415,0.6739130434782609,45,95,50,40,50,75,355,0.54,0.5
65,85,70,75,70,40,405,0.203125,65,60,110,130,95,65,525,0.47761194029850745,1.0
25,35,70,95,55,45,325,0.16783216783216784,60,50,70,80,80,140,480,0.8449612403100775,0.25
85,105,85,40,50,40,405,0.211864406779661,100,180,160,150,90,90,770,0.7520661157024794,1.0
85,80,70,135,75,90,535,0.7006802721088435,60,48,45,43,90,42,328,0.21897810218978103,1.0
45,55,45,65,45,75,330,0.5692307692307692,40,35,30,20,20,50,195,0.23423423423423423,2.0
51,65,65,80,75,59,395,0.4365079365079365,100,134,110,95,100,61,600,0.4057971014492754,1.0
60,55,90,145,90,80,520,0.6071428571428571,110,160,110,80,110,100,670,0.8591549295774648,0.0
120,120,120,120,120,120,720,0.9344262295081968,90,130,80,65,85,55,505,0.4396551724137931,1.0
72,58,80,103,80,97,490,0.7171052631578947,100,5,5,15,65,30,220,0.07692307692307693,1.0
65,95,75,55,55,85,430,0.6933333333333334,110,135,60,50,65,88,508,0.7744360902255639,0.0
35,85,45,35,35,75,310,0.6492537313432836,80,145,150,105,110,110,700,0.8692307692307693,0.25
75,70,90,70,105,80,490,0.656,45,30,50,55,65,45,290,0.208,1.0
89,145,90,105,80,91,600,0.8549618320610687,95,65,65,110,130,60,525,0.4016393442622951,1.0
40,80,100,30,30,20,300,0.11851851851851852,80,100,200,50,100,50,580,0.3472222222222222,2.0
50,105,79,35,110,76,455,0.6214285714285714,60,79,105,59,85,36,424,0.17054263565891473,0.5
74,94,131,54,116,20,489,0.4485294117647059,55,85,122,58,75,99,494,0.8099173553719008,0.5
70,60,62,80,82,60,414,0.4375,54,63,52,83,56,97,405,0.7697841726618705,1.0
20,40,90,30,90,25,295,0.11363636363636363,54,63,52,83,56,97,405,0.7697841726618705,1.0
103,60,86,60,86,50,445,0.3458646616541353,39,52,43,60,50,65,309,0.5041322314049587,1.0
65,90,115,45,115,58,488,0.5041322314049587,48,61,40,61,40,50,300,0.2543859649122807,0.25
60,69,95,69,95,36,424,0.2608695652173913,40,30,32,50,52,65,269,0.3671875,0.5
95,155,109,70,130,81,640,0.6788321167883211,70,60,70,87,78,85,450,0.6228070175438597,0.5
50,75,35,70,30,40,300,0.21296296296296297,125,58,58,76,76,67,460,0.515625,2.0
45,50,45,115,55,95,405,0.6936936936936937,70,120,65,45,85,125,510,0.9747899159663865,0.5
40,35,30,120,70,105,400,0.6692307692307692,50,180,20,180,20,150,600,0.9029850746268657,0.5
78,84,78,109,85,100,534,0.8620689655172413,65,70,60,65,65,115,440,0.8583333333333333,1.0
90,110,80,100,80,95,555,0.7982456140350878,38,35,40,27,25,35,200,0.08208955223880597,2.0
44,38,33,61,43,70,289,0.5267857142857143,50,55,50,36,30,43,264,0.2922077922077922,2.0
59,63,80,65,80,58,405,0.41843971631205673,70,70,70,70,70,70,420,0.5289256198347108,1.0
92,105,90,125,90,98,600,0.8217054263565892,65,75,105,35,65,85,430,0.6940298507462687,1.0
30,40,70,70,25,60,295,0.41353383458646614,85,110,76,65,82,56,474,0.3933333333333333,0.5
45,49,65,49,65,45,318,0.275,111,83,68,92,82,39,475,0.1774193548387097,4.0
80,120,79,95,79,70,523,0.5833333333333334,65,60,110,130,95,65,525,0.47761194029850745,1.0
57,80,91,80,87,75,470,0.5737704918032787,50,35,55,25,25,15,205,0.021739130434782608,1.0
90,30,15,40,20,15,210,0.043478260869565216,45,90,20,65,20,65,305,0.5116279069767442,2.0
80,80,90,110,130,110,600,0.8721804511278195,105,105,75,65,100,50,500,0.37593984962406013,2.0
90,50,34,60,44,70,348,0.6283185840707964,70,110,75,145,85,145,630,0.9444444444444444,2.0
50,20,55,25,25,30,205,0.09774436090225563,70,90,45,15,45,50,315,0.3629032258064516,0.5
70,60,125,115,70,55,495,0.35507246376811596,60,48,45,43,90,42,328,0.21897810218978103,1.0
45,63,37,65,55,95,360,0.8055555555555556,45,95,50,40,50,75,355,0.54,1.0
41,64,45,50,50,50,300,0.36752136752136755,110,160,110,80,110,100,670,0.8591549295774648,1.0
125,58,58,76,76,67,460,0.515625,55,55,50,45,65,55,325,0.37373737373737376,1.0
72,58,80,103,80,97,490,0.7171052631578947,80,90,80,130,110,110,600,0.856,0.5
65,95,100,60,50,50,420,0.34959349593495936,30,80,90,55,45,55,355,0.4295774647887324,1.0
135,85,40,40,85,5,390,0.6864406779661016,54,63,52,83,56,97,405,0.7697841726618705,1.0
85,110,90,45,90,80,500,0.6206896551724138,65,60,110,130,95,65,525,0.47761194029850745,1.0
85,110,76,65,82,56,474,0.3933333333333333,91,134,95,100,100,80,600,0.6304347826086957,0.25
90,92,75,92,85,60,494,0.49586776859504134,75,80,70,65,75,90,455,0.7578125,0.5
60,85,69,65,79,80,438,0.576,65,150,40,15,80,145,495,0.9663865546218487,0.5
80,52,50,90,50,89,411,0.6666666666666666,60,60,60,105,105,105,495,0.848,0.5
60,55,145,75,150,40,525,0.2,70,85,65,105,85,120,530,0.9262295081967213,1.0
45,90,20,65,20,65,305,0.5116279069767442,60,90,55,90,80,110,485,0.8677685950413223,1.0
90,132,105,132,105,30,594,0.4246575342465753,40,45,40,35,35,56,251,0.373015873015873,1.0
68,165,95,65,115,110,618,0.8615384615384616,126,131,95,131,98,99,680,0.8294573643410853,0.5
60,70,65,125,105,90,515,0.6911764705882353,90,92,75,92,85,60,494,0.49586776859504134,1.0
106,110,90,154,90,130,680,0.926829268292683,50,105,79,35,110,76,455,0.6214285714285714,1.0
77,59,50,67,63,46,362,0.23140495867768596,50,75,45,40,45,60,315,0.4380165289256198,2.0
50,50,62,40,62,65,329,0.4188034188034188,20,10,55,15,20,80,200,0.17985611510791366,1.0
105,150,90,150,90,95,680,0.8285714285714286,65,90,65,61,61,100,442,0.8373983739837398,1.0
60,85,40,30,45,68,328,0.6422018348623854,63,60,55,50,50,71,349,0.5289256198347108,0.0
35,80,50,50,70,120,405,0.84375,55,84,105,114,75,52,485,0.2890625,1.0
70,45,48,60,65,35,323,0.15748031496062992,95,85,85,65,65,35,430,0.2571428571428571,1.0
76,48,48,57,62,34,325,0.11688311688311688,70,55,65,95,85,70,440,0.5307692307692308,2.0
85,70,80,97,80,123,535,0.9304347826086956,100,150,120,120,100,90,680,0.6493506493506493,1.0
74,48,76,83,81,104,466,0.7322834645669292,85,76,64,45,55,90,415,0.6739130434782609,1.0
70,120,65,45,85,125,510,0.9747899159663865,75,55,70,55,95,110,460,0.8444444444444444,4.0
46,87,60,30,40,57,320,0.37777777777777777,60,100,115,70,85,90,520,0.7557251908396947,0.5
50,50,40,30,30,50,250,0.2781954887218045,40,45,35,30,40,55,245,0.3793103448275862,0.0
55,84,105,114,75,52,485,0.2890625,80,90,80,130,110,110,600,0.856,0.5
59,110,150,45,49,35,448,0.3333333333333333,50,75,75,65,65,50,380,0.4049586776859504,1.0
70,62,67,55,55,56,365,0.38513513513513514,100,100,100,100,100,100,600,0.831858407079646,1.0
65,90,120,85,70,60,490,0.43410852713178294,80,100,70,50,60,45,405,0.25806451612903225,1.0
70,95,125,65,75,45,475,0.33613445378151263,45,49,49,65,65,45,318,0.2781954887218045,1.0
80,82,100,83,100,80,525,0.6821705426356589,40,65,95,60,45,35,340,0.13986013986013987,0.5
91,134,95,100,100,80,600,0.6304347826086957,53,51,53,61,56,40,314,0.14285714285714285,1.0
30,56,35,25,35,72,253,0.48148148148148145,90,100,60,90,60,80,480,0.6422764227642277,1.0
49,66,70,44,55,51,335,0.4260869565217391,35,85,45,35,35,75,310,0.6492537313432836,0.0
45,65,34,40,34,45,263,0.2589928057553957,39,52,43,60,50,65,309,0.5041322314049587,1.0
50,30,55,65,55,20,275,0.13675213675213677,65,65,60,110,95,130,525,0.9253731343283582,1.0
60,85,42,85,42,91,405,0.8227848101265823,52,65,50,45,50,38,300,0.27419354838709675,0.5
60,100,85,80,85,100,510,0.7007874015748031,45,35,45,62,53,35,275,0.11851851851851852,1.0
100,100,100,100,100,100,600,0.8758169934640523,60,80,95,70,85,50,440,0.2231404958677686,0.25
60,55,90,145,90,80,520,0.6071428571428571,108,112,118,68,72,47,525,0.2916666666666667,1.0
60,50,150,50,150,60,520,0.5206611570247934,80,80,80,55,55,90,440,0.6417910447761194,0.0
76,65,45,92,42,91,411,0.7449664429530202,70,20,50,20,50,40,250,0.1557377049180328,1.0
50,92,108,92,108,35,485,0.2457627118644068,75,80,85,110,90,50,490,0.3548387096774194,1.0
81,102,77,85,75,85,505,0.5642857142857143,67,57,55,77,55,114,425,0.8879310344827587,0.0
40,55,70,45,60,30,300,0.10619469026548672,64,115,65,83,63,65,455,0.5323741007194245,1.0
46,57,40,40,40,50,273,0.25,80,70,70,90,100,70,480,0.5609756097560976,2.0
45,53,70,40,60,42,310,0.25735294117647056,55,70,40,60,40,40,305,0.26956521739130435,1.0
82,80,86,85,75,72,480,0.6183206106870229,79,115,70,125,80,111,580,0.864,1.0
40,30,50,55,55,100,330,0.584070796460177,60,30,30,36,56,50,262,0.32432432432432434,2.0
65,80,65,35,65,60,370,0.38405797101449274,60,40,60,95,60,55,370,0.4222222222222222,0.0
75,80,85,110,90,50,490,0.3548387096774194,79,115,70,125,80,111,580,0.8468468468468469,0.5
100,120,120,150,100,90,680,0.7880794701986755,65,65,45,75,45,95,390,0.72,1.0
79,105,70,145,80,101,580,0.8608695652173913,103,93,67,71,61,84,479,0.7142857142857143,1.0
45,63,37,65,55,95,360,0.8055555555555556,60,80,50,40,40,30,300,0.15328467153284672,1.0
60,67,85,77,75,116,480,0.8888888888888888,61,84,65,70,70,70,420,0.5,1.0
35,85,45,35,35,75,310,0.6492537313432836,108,112,118,68,72,47,525,0.2916666666666667,1.0
50,50,77,95,77,91,440,0.5916666666666667,65,150,60,115,60,115,565,0.935251798561151,0.5
65,50,70,95,80,65,425,0.4262295081967213,70,84,70,65,70,51,410,0.2949640287769784,2.0
95,70,73,95,90,60,483,0.3983739837398374,90,120,120,60,60,50,500,0.35294117647058826,1.0
72,58,80,103,80,97,490,0.7171052631578947,75,80,85,110,90,50,490,0.3548387096774194,4.0
60,50,70,50,90,65,385,0.39568345323741005,35,55,35,30,30,35,220,0.23684210526315788,2.0
80,100,80,80,80,100,520,0.9051724137931034,60,80,50,40,40,30,300,0.15328467153284672,0.0
95,125,79,60,100,81,540,0.6165413533834586,92,105,90,125,90,98,600,0.8217054263565892,0.5
105,180,100,180,100,115,780,0.9477611940298507,60,115,105,65,70,80,495,0.7181818181818181,0.5
70,55,55,80,60,45,365,0.2222222222222222,72,95,67,103,71,122,530,0.9606299212598425,2.0
85,135,130,60,80,25,515,0.40540540540540543,50,53,62,58,63,44,330,0.13709677419354838,1.0
50,65,107,105,107,86,520,0.703125,55,50,40,40,40,75,300,0.5945945945945946,1.0
75,95,125,45,75,95,510,0.8257575757575758,55,112,45,74,45,70,401,0.559322033898305,0.0
130,65,60,110,95,65,525,0.5227272727272727,90,93,55,70,55,55,418,0.3819444444444444,2.0
76,48,48,57,62,34,325,0.11688311688311688,50,48,43,46,41,60,288,0.47297297297297297,1.0
20,10,230,10,230,5,505,0.0,52,65,50,45,50,38,300,0.27419354838709675,2.0
62,44,50,44,50,55,305,0.3629032258064516,100,50,80,60,80,50,420,0.34375,0.5
78,65,68,112,154,75,552,0.628099173553719,95,85,85,65,65,35,430,0.2571428571428571,1.0
91,72,90,129,90,108,580,0.8620689655172413,35,45,160,30,45,70,385,0.48148148148148145,8.0
150,80,44,90,54,80,498,0.625,90,50,34,60,44,70,348,0.6283185840707964,2.0
100,100,100,100,100,100,600,0.8805970149253731,40,45,40,62,60,60,307,0.33884297520661155,2.0
45,50,43,40,38,62,278,0.40441176470588236,40,55,30,30,30,85,270,0.688,1.0
150,80,44,90,54,80,498,0.625,150,100,120,100,120,90,680,0.6666666666666666,2.0
58,64,58,80,65,80,405,0.5423728813559322,105,105,75,65,100,50,500,0.37593984962406013,1.0
115,140,130,55,55,40,535,0.4519230769230769,95,85,85,65,65,35,430,0.2571428571428571,0.5
45,30,35,20,20,45,195,0.14782608695652175,85,105,100,79,83,78,530,0.5869565217391305,1.0
75,100,66,60,66,115,482,0.918918918918919,85,73,70,73,115,67,483,0.5126050420168067,1.0
90,70,80,70,95,70,475,0.5190839694656488,80,80,80,80,80,80,480,0.5606060606060606,0.25
55,75,50,40,40,80,340,0.6302521008403361,50,53,62,58,63,44,330,0.13709677419354838,1.0
50,75,35,70,30,40,300,0.21296296296296297,60,52,168,47,138,30,495,0.19834710743801653,0.0
45,60,30,80,50,65,330,0.4603174603174603,85,70,80,97,80,123,535,0.9304347826086956,0.5
43,80,65,50,35,35,308,0.14193548387096774,50,95,95,35,110,70,455,0.5179856115107914,1.0
60,45,70,75,85,55,390,0.3008130081300813,80,120,80,120,80,100,580,0.8478260869565217,1.0
135,85,40,40,85,5,390,0.6864406779661016,65,65,45,75,45,95,390,0.72,1.0
60,60,60,35,35,30,280,0.11194029850746269,90,120,75,60,60,45,450,0.29411764705882354,1.0
80,110,60,150,130,70,600,0.5042016806722689,95,145,130,120,90,120,700,0.9398496240601504,1.0
60,80,50,50,50,40,330,0.23853211009174313,35,35,40,35,55,50,250,0.40336134453781514,1.0
55,81,60,50,70,97,413,0.7214285714285714,75,100,95,40,70,110,490,0.8717948717948718,1.0
120,100,85,30,85,45,465,0.22448979591836735,65,90,40,45,80,75,395,0.625,0.25
70,120,65,45,85,125,510,0.9747899159663865,57,80,91,80,87,75,470,0.5737704918032787,0.25
106,110,90,154,90,130,680,0.926829268292683,97,165,60,65,50,58,495,0.3902439024390244,1.0
35,35,35,35,35,35,210,0.13385826771653545,50,75,75,65,65,50,380,0.4049586776859504,0.0
71,95,85,110,95,79,535,0.664,75,100,66,60,66,115,482,0.918918918918919,1.0
45,60,32,50,32,76,295,0.5925925925925926,55,35,50,55,110,85,390,0.6277372262773723,2.0
20,25,45,70,90,60,310,0.30833333333333335,108,100,121,81,95,95,600,0.7476635514018691,4.0
70,120,100,145,105,20,560,0.2824427480916031,77,120,90,60,90,48,485,0.2785714285714286,0.5
75,90,140,60,60,40,465,0.3008130081300813,35,45,160,30,45,70,385,0.48148148148148145,2.0
60,65,60,130,75,110,500,0.7719298245614035,40,50,90,30,55,65,330,0.44680851063829785,0.5
64,115,65,83,63,65,455,0.5323741007194245,89,125,90,115,80,101,600,0.8725490196078431,1.0
91,72,90,129,90,108,580,0.8620689655172413,60,105,60,120,60,105,510,0.8849557522123894,2.0
75,103,80,70,80,92,500,0.7933884297520661,75,90,50,110,80,95,500,0.7985611510791367,0.5
53,51,53,61,56,40,314,0.14285714285714285,55,65,95,95,45,85,440,0.6610169491525424,0.5
59,66,70,44,55,41,335,0.25190839694656486,70,115,60,115,60,55,475,0.4647887323943662,0.25
45,60,40,70,50,45,310,0.2846715328467153,60,50,50,60,70,50,340,0.28346456692913385,1.0
90,30,15,40,20,15,210,0.043478260869565216,80,120,130,55,65,45,495,0.37037037037037035,0.5
80,115,80,65,55,93,488,0.7846153846153846,48,61,40,61,40,50,300,0.2543859649122807,2.0
40,55,80,35,60,30,300,0.15037593984962405,61,84,65,70,70,70,420,0.5,1.0
114,85,70,85,80,30,464,0.2066115702479339,100,100,100,100,100,100,600,0.8602941176470589,1.0
38,35,40,27,25,35,200,0.08208955223880597,45,49,49,65,65,45,318,0.2781954887218045,1.0
60,90,55,90,80,110,485,0.8677685950413223,70,110,75,145,85,145,630,0.9444444444444444,0.25
50,50,150,50,150,50,500,0.2571428571428571,70,20,50,20,50,40,250,0.1557377049180328,1.0
25,35,70,95,55,45,325,0.16783216783216784,85,115,80,105,80,50,515,0.3063063063063063,0.25
30,56,35,25,35,72,253,0.48148148148148145,95,109,105,75,85,56,525,0.34513274336283184,1.0
65,150,40,15,80,145,495,0.9663865546218487,40,30,35,50,70,55,280,0.28205128205128205,1.0
40,30,35,50,70,55,280,0.28205128205128205,65,50,35,115,95,95,455,0.7333333333333333,1.0
90,95,95,70,90,70,510,0.5230769230769231,126,131,95,131,98,99,680,0.8102189781021898,1.0
69,55,45,55,55,15,294,0.11666666666666667,75,90,90,140,90,115,600,0.9481481481481482,0.5
110,65,105,55,95,80,510,0.6258503401360545,55,45,43,55,43,72,313,0.5853658536585366,2.0
65,65,45,75,45,95,390,0.72,80,70,70,90,100,70,480,0.5609756097560976,4.0
65,60,70,85,75,40,395,0.1796875,85,105,100,79,83,78,530,0.5869565217391305,1.0
100,75,115,90,115,85,580,0.6446280991735537,40,45,65,100,120,90,460,0.5588235294117647,1.0
75,80,60,65,90,102,472,0.8625954198473282,45,49,65,49,65,45,318,0.275,1.0
40,55,99,40,79,47,360,0.26262626262626265,80,115,80,65,55,93,488,0.7846153846153846,0.5
190,33,58,33,58,33,405,0.13432835820895522,35,55,35,30,30,35,220,0.23684210526315788,0.0
190,33,58,33,58,33,405,0.13432835820895522,79,115,70,125,80,111,580,0.8468468468468469,1.0
70,145,88,140,70,112,625,0.8888888888888888,82,121,119,69,59,71,521,0.5394736842105263,4.0
46,87,60,30,40,57,320,0.37777777777777777,30,80,90,55,45,55,355,0.4295774647887324,1.0
55,45,50,45,65,80,340,0.5546218487394958,105,105,75,65,100,50,500,0.37593984962406013,0.5
65,90,115,45,115,58,488,0.5041322314049587,54,45,47,75,98,52,371,0.39669421487603307,0.25
70,50,30,95,135,105,485,0.8040540540540541,54,78,103,53,45,22,355,0.23255813953488372,0.5
105,140,95,55,65,45,505,0.3,20,10,230,10,230,5,505,0.0,1.0
50,75,70,35,70,48,348,0.29357798165137616,38,30,41,30,41,60,240,0.2897196261682243,2.0
58,50,145,95,105,30,483,0.2459016393442623,65,50,35,115,95,95,455,0.7333333333333333,2.0
77,85,51,55,51,65,384,0.5163934426229508,28,25,25,45,35,40,198,0.16083916083916083,1.0
50,85,125,85,115,20,480,0.4306569343065693,60,85,69,65,79,80,438,0.576,1.0
50,50,50,50,50,50,300,0.30708661417322836,50,25,28,45,55,15,218,0.0625,1.0
60,69,95,69,95,36,424,0.2608695652173913,100,5,5,15,65,30,220,0.07692307692307693,1.0
106,190,100,154,100,130,780,0.9259259259259259,53,54,53,37,46,45,288,0.3090909090909091,0.0
66,41,77,61,87,23,355,0.12096774193548387,86,92,88,68,75,73,482,0.6835443037974683,1.0
91,129,90,72,90,108,580,0.8536585365853658,65,60,110,130,95,65,525,0.47761194029850745,4.0
65,80,65,35,65,60,370,0.38405797101449274,50,53,48,53,48,64,316,0.358974358974359,1.0
190,33,58,33,58,33,405,0.13432835820895522,110,130,80,70,60,80,530,0.5862068965517241,2.0
64,115,65,83,63,65,455,0.5323741007194245,80,95,82,60,82,75,474,0.6,1.0
95,85,85,65,65,35,430,0.2571428571428571,75,87,63,87,63,98,473,0.865546218487395,0.0
60,75,85,100,85,115,520,0.8992248062015504,49,55,42,42,37,85,310,0.6068376068376068,1.0
55,70,45,70,50,60,350,0.45,65,45,55,45,70,45,325,0.24369747899159663,0.5
80,105,105,105,105,80,580,0.5939849624060151,52,65,55,58,62,60,352,0.4482758620689655,1.0
86,76,86,116,56,95,515,0.7982456140350878,28,25,25,45,35,40,198,0.16083916083916083,1.0
80,110,120,130,90,70,600,0.6198347107438017,110,65,75,125,85,30,490,0.15,1.0
35,55,40,45,40,60,275,0.35714285714285715,40,65,40,80,40,65,330,0.5038167938931297,1.0
100,75,115,90,115,85,580,0.6446280991735537,90,100,90,125,85,90,580,0.7352941176470589,2.0
50,65,107,105,107,86,520,0.7313432835820896,100,73,83,73,83,55,467,0.371900826446281,0.5
55,20,35,20,45,75,250,0.37681159420289856,50,48,43,46,41,60,288,0.47297297297297297,1.0
59,66,70,44,55,41,335,0.25190839694656486,85,97,66,105,66,65,484,0.47107438016528924,0.5
41,50,37,50,37,66,281,0.5175438596491229,50,95,180,85,45,70,525,0.5298507462686567,1.0
50,75,35,70,30,40,300,0.21296296296296297,54,78,103,53,45,22,355,0.23255813953488372,2.0
60,62,50,62,60,40,334,0.18181818181818182,55,70,45,70,50,60,350,0.45,0.25
95,117,184,44,46,28,514,0.2975206611570248,89,125,90,115,80,101,600,0.8725490196078431,4.0
60,115,105,65,70,80,495,0.7181818181818181,64,78,52,78,52,81,405,0.6422764227642277,2.0
65,60,70,85,75,40,395,0.1796875,75,125,70,125,70,115,580,0.9037037037037037,1.0
25,35,70,95,55,45,325,0.16783216783216784,65,95,57,100,85,93,495,0.7441860465116279,0.5
106,190,100,154,100,130,780,0.9259259259259259,45,75,37,70,55,83,365,0.6183206106870229,1.0
150,160,100,95,65,100,670,0.8866666666666667,95,60,79,100,125,81,540,0.6201550387596899,1.0
123,100,62,97,81,68,531,0.4806201550387597,45,50,55,75,65,30,320,0.06293706293706294,0.25
52,65,50,45,50,38,300,0.27419354838709675,38,30,41,30,41,60,240,0.2897196261682243,1.0
88,107,122,74,75,64,530,0.4596774193548387,90,120,120,60,60,50,500,0.35294117647058826,2.0
60,67,85,77,75,116,480,0.8888888888888888,45,95,50,40,50,75,355,0.54,1.0
20,40,90,30,90,25,295,0.11363636363636363,60,79,105,59,85,36,424,0.17054263565891473,1.0
50,85,40,85,40,35,335,0.1746031746031746,100,110,90,85,90,60,535,0.47794117647058826,4.0
80,100,200,50,100,50,580,0.3472222222222222,165,75,80,40,45,65,470,0.5151515151515151,1.0
108,112,118,68,72,47,525,0.2916666666666667,40,55,99,40,79,47,360,0.26262626262626265,1.0
50,20,55,25,25,30,205,0.09774436090225563,55,63,90,50,80,42,380,0.21138211382113822,2.0
55,55,45,63,45,45,308,0.25,100,103,75,120,75,127,600,0.940677966101695,0.5
70,77,60,97,60,108,472,0.8394160583941606,45,30,35,20,20,45,195,0.14782608695652175,1.0
65,40,70,80,140,70,465,0.5954198473282443,123,100,62,97,81,68,531,0.4806201550387597,1.0
86,92,88,68,75,73,482,0.6835443037974683,50,52,48,65,50,55,320,0.33098591549295775,1.0
35,20,65,40,65,20,245,0.02459016393442623,85,115,80,105,80,50,515,0.3063063063063063,1.0
75,100,110,45,55,65,450,0.5333333333333333,20,10,230,10,230,5,505,0.0,1.0
95,75,180,130,80,30,590,0.13793103448275862,50,50,50,50,50,50,300,0.30708661417322836,1.0
55,75,50,40,40,80,340,0.6302521008403361,100,120,100,150,120,90,680,0.728,1.0
80,120,130,55,65,45,495,0.37037037037037035,50,85,40,85,40,35,335,0.1746031746031746,0.5
64,66,68,81,76,50,405,0.25190839694656486,110,135,60,50,65,88,508,0.7744360902255639,2.0
60,85,69,65,79,80,438,0.576,110,78,73,76,71,60,468,0.3333333333333333,0.5
50,64,50,45,50,41,300,0.22727272727272727,62,48,54,63,60,68,355,0.5178571428571429,1.0
40,40,40,70,40,20,250,0.032520325203252036,100,134,110,95,100,61,600,0.4057971014492754,0.5
43,30,55,40,65,97,330,0.6030534351145038,84,71,43,71,43,48,360,0.25874125874125875,1.0
55,75,50,40,40,80,340,0.6302521008403361,66,65,48,62,57,52,350,0.36220472440944884,2.0
60,75,100,55,80,50,420,0.3088235294117647,85,90,80,70,80,130,535,0.9262295081967213,2.0
95,110,80,70,80,50,485,0.37209302325581395,50,35,55,25,25,15,205,0.05263157894736842,1.0
65,125,100,55,70,85,500,0.6532258064516129,110,130,80,70,60,80,530,0.5862068965517241,1.0
95,117,80,65,70,92,519,0.8409090909090909,65,125,100,60,70,70,490,0.6099290780141844,1.0
30,56,35,25,35,72,253,0.48148148148148145,70,20,50,20,50,40,250,0.1557377049180328,1.0
30,30,42,30,42,70,244,0.4230769230769231,50,65,107,105,107,86,520,0.703125,0.5
65,90,122,58,75,84,494,0.71875,79,115,70,125,80,111,580,0.8468468468468469,0.5
50,65,85,35,35,55,325,0.32575757575757575,85,90,80,70,80,130,535,0.9262295081967213,0.5
64,66,68,81,76,50,405,0.25190839694656486,65,80,140,40,70,70,465,0.5223880597014925,1.0
30,105,90,25,25,50,325,0.2773722627737226,100,123,75,57,75,80,510,0.6923076923076923,1.0
65,155,120,65,90,105,600,0.8677685950413223,55,35,50,55,110,85,390,0.6277372262773723,1.0
80,50,100,100,200,50,580,0.2357142857142857,50,70,100,40,40,30,330,0.2222222222222222,0.5
70,80,70,80,70,110,480,0.6594202898550725,50,105,79,35,110,76,455,0.6214285714285714,1.0
100,100,100,100,100,100,600,0.8602941176470589,45,55,39,35,39,42,255,0.18518518518518517,1.0
85,105,100,79,83,78,530,0.5869565217391305,65,90,115,45,115,58,488,0.5041322314049587,1.0
36,50,50,65,60,44,305,0.16363636363636364,92,105,90,125,90,98,600,0.8217054263565892,2.0
30,65,100,45,25,40,305,0.1891891891891892,35,70,55,45,55,25,285,0.09420289855072464,0.5
100,100,100,100,100,100,600,0.8758169934640523,35,20,65,40,65,20,245,0.02459016393442623,0.5
75,85,200,55,65,30,510,0.16778523489932887,80,80,90,110,130,110,600,0.8721804511278195,1.0
90,85,100,95,125,85,580,0.6834532374100719,48,72,48,72,48,48,336,0.25984251968503935,1.0
100,150,120,120,100,90,680,0.6493506493506493,40,50,90,30,55,65,330,0.44680851063829785,1.0
60,50,70,50,90,65,385,0.39568345323741005,75,80,95,90,100,50,490,0.2158273381294964,4.0
55,50,40,40,40,75,300,0.5945945945945946,60,80,110,50,80,45,425,0.2833333333333333,1.0
80,100,70,50,60,45,405,0.25806451612903225,75,125,75,30,75,85,465,0.625,1.0
61,84,65,70,70,70,420,0.5,45,35,45,62,53,35,275,0.11851851851851852,1.0
130,70,35,70,35,60,400,0.4017857142857143,65,80,65,35,65,60,370,0.38405797101449274,1.0
75,55,70,55,95,110,460,0.8444444444444444,85,110,76,65,82,56,474,0.3933333333333333,1.0
50,60,60,60,60,30,320,0.11290322580645161,60,62,50,62,60,40,334,0.18181818181818182,1.0
100,103,75,120,75,127,600,0.940677966101695,50,120,53,35,110,87,455,0.640625,2.0
100,100,100,100,100,100,600,0.8758169934640523,125,120,90,170,100,95,700,0.78125,2.0
85,60,65,135,105,100,550,0.7518248175182481,68,90,65,50,55,82,410,0.6165413533834586,0.5
52,65,55,58,62,60,352,0.4482758620689655,65,105,60,60,70,95,455,63.0,2.0
70,60,62,80,82,60,414,0.4375,50,50,40,30,30,50,250,0.2781954887218045,1.0
50,70,100,40,40,30,330,0.2222222222222222,95,109,105,75,85,56,525,0.34513274336283184,0.5
100,100,100,100,100,100,600,0.8345864661654135,50,65,64,44,48,43,314,0.2196969696969697,2.0
59,66,70,44,55,41,335,0.25190839694656486,75,85,200,55,65,30,510,0.16778523489932887,1.0
65,90,65,61,61,100,442,0.8373983739837398,125,130,90,130,90,95,660,0.7734375,1.0
55,45,50,45,65,80,340,0.5546218487394958,28,25,25,45,35,40,198,0.16083916083916083,1.0
115,115,85,90,75,100,580,0.8134328358208955,20,10,230,10,230,5,505,0.0,1.0
65,76,84,54,96,105,480,0.9008264462809917,62,55,52,109,94,109,481,0.7833333333333333,1.0
82,80,86,85,75,72,480,0.6183206106870229,55,75,60,75,60,103,428,0.7982456140350878,1.0
125,170,100,120,90,95,700,0.77,95,80,105,40,70,100,490,0.8046875,1.0
62,55,52,109,94,109,481,0.7833333333333333,50,75,35,70,30,40,300,0.21296296296296297,0.5
106,110,90,154,90,130,680,0.926829268292683,60,55,50,40,55,45,305,0.22377622377622378,2.0
80,100,123,122,120,80,625,0.56,65,47,55,73,75,85,400,0.65,0.5
60,130,80,60,60,70,460,0.5153846153846153,75,105,75,105,75,45,480,0.3274336283185841,2.0
45,50,55,75,65,30,320,0.06293706293706294,80,105,65,60,75,130,515,0.9645390070921985,0.5
50,65,90,35,35,15,290,0.14678899082568808,50,50,50,50,50,50,300,0.30708661417322836,1.0
55,40,85,80,105,40,405,0.23622047244094488,45,60,40,70,50,45,310,0.2846715328467153,0.5
60,105,60,120,60,105,510,0.8849557522123894,82,80,86,85,75,72,480,0.6183206106870229,0.5
60,100,115,70,85,90,520,0.7557251908396947,70,80,65,90,65,85,455,0.578125,1.0
90,70,80,70,95,70,475,0.5190839694656488,45,50,35,55,75,40,300,0.21367521367521367,1.0
80,82,78,95,80,85,500,0.6869565217391305,80,120,80,120,80,100,580,0.8478260869565217,1.0
64,51,23,51,23,28,240,0.11363636363636363,70,80,65,90,65,85,455,0.578125,1.0
75,125,230,55,95,30,610,0.3448275862068966,110,123,65,100,65,65,528,0.5217391304347826,1.0
90,90,85,125,90,100,580,0.768595041322314,50,70,50,50,50,40,310,0.16296296296296298,2.0
50,50,62,40,62,65,329,0.4188034188034188,40,45,40,35,35,56,251,0.373015873015873,1.0
100,90,130,45,65,55,485,0.4253731343283582,55,84,105,114,75,52,485,0.2890625,0.5
50,52,48,65,50,55,320,0.33098591549295775,65,76,84,54,96,105,480,0.9008264462809917,1.0
80,80,90,110,130,110,600,0.8721804511278195,70,55,55,80,60,45,365,0.2222222222222222,1.0
79,105,70,145,80,101,580,0.8608695652173913,44,38,39,61,79,42,303,0.2251655629139073,1.0
49,66,70,44,55,51,335,0.4260869565217391,60,59,85,79,105,36,424,0.16666666666666666,0.25
78,65,68,112,154,75,552,0.628099173553719,75,140,65,112,65,110,567,0.9140625,1.0
85,73,70,73,115,67,483,0.5126050420168067,50,120,53,35,110,87,455,0.640625,1.0
70,140,230,60,80,50,630,0.32432432432432434,68,75,53,83,113,60,452,0.45384615384615384,1.0
101,72,72,99,89,29,462,0.1937984496124031,70,40,50,55,50,25,290,0.061068702290076333,1.0
50,25,28,45,55,15,218,0.0625,80,145,150,105,110,110,700,0.8692307692307693,0.5
100,5,5,15,65,30,220,0.07692307692307693,85,115,80,105,80,50,515,0.3063063063063063,1.0
30,40,55,40,55,60,280,0.3237410071942446,63,60,55,50,50,71,349,0.5289256198347108,1.0
75,90,140,60,60,40,465,0.3008130081300813,60,62,50,62,60,40,334,0.18181818181818182,4.0
44,75,35,63,33,45,295,0.2647058823529412,40,65,40,80,40,65,330,0.5038167938931297,0.5
70,55,75,45,65,60,370,0.45901639344262296,70,62,67,55,55,56,365,0.38513513513513514,1.0
62,44,50,44,50,55,305,0.3629032258064516,60,45,50,90,80,70,395,0.625,2.0
60,69,95,69,95,36,424,0.2608695652173913,110,160,110,80,110,100,670,0.8591549295774648,1.0
76,25,45,67,55,24,292,0.0390625,70,50,30,95,135,105,485,0.8040540540540541,1.0
80,120,70,110,70,80,530,0.6422764227642277,65,125,60,95,60,105,510,0.9236641221374046,1.0
70,150,140,65,100,75,600,0.55,70,65,65,55,55,70,380,0.5,1.0
45,75,60,40,30,50,300,0.304,44,38,33,61,43,70,289,0.5267857142857143,1.0
105,140,95,55,65,45,505,0.3,60,100,85,80,85,100,510,0.7007874015748031,0.5
55,75,60,75,60,103,428,0.7982456140350878,80,80,80,55,55,90,440,0.6417910447761194,1.0
106,90,130,90,154,110,680,0.8699186991869918,40,45,35,65,55,70,310,0.4482758620689655,2.0
108,170,115,120,95,92,700,0.7083333333333334,30,45,135,45,90,30,375,0.09285714285714286,2.0
40,60,40,40,40,30,250,0.0948905109489051,45,100,45,45,45,10,290,0.2949640287769784,0.5
106,150,70,194,120,140,780,0.952,60,60,60,35,35,30,280,0.11194029850746269,1.0
82,80,86,85,75,72,480,0.6183206106870229,50,150,50,150,50,150,600,0.9339622641509434,1.0
123,100,62,97,81,68,531,0.4806201550387597,45,63,37,65,55,95,360,0.8055555555555556,1.0
60,67,85,77,75,116,480,0.8888888888888888,80,110,120,130,90,70,600,0.6198347107438017,0.5
74,100,72,90,72,46,454,0.24561403508771928,75,100,66,60,66,115,482,0.918918918918919,1.0
50,50,95,40,50,35,320,0.20279720279720279,35,35,35,35,35,35,210,0.13385826771653545,1.0
30,45,59,30,39,57,260,0.2803030303030303,150,120,100,120,100,90,680,0.664179104477612,0.25
40,30,32,50,52,65,269,0.3671875,76,104,71,104,71,108,534,0.912751677852349,0.5
45,30,15,85,65,65,305,0.36220472440944884,110,65,75,125,85,30,490,0.15,0.5
45,60,45,25,45,55,275,0.29,58,64,58,80,65,80,405,0.609271523178808,1.0
105,95,75,85,75,74,509,0.5714285714285714,50,65,107,105,107,86,520,0.7313432835820896,0.5
60,95,80,60,80,30,405,0.19480519480519481,90,92,75,92,85,60,494,0.49586776859504134,1.0
90,130,80,65,85,55,505,0.4396551724137931,95,65,65,110,130,60,525,0.4016393442622951,0.5
50,40,85,40,65,25,305,0.08870967741935484,46,87,60,30,40,57,320,0.37777777777777777,1.0
50,55,50,36,30,43,264,0.2922077922077922,108,170,115,120,95,92,700,0.7083333333333334,1.0
79,103,120,135,115,78,630,0.5763888888888888,108,100,121,81,95,95,600,0.7476635514018691,1.0
55,130,115,50,50,75,475,0.5982142857142857,35,35,40,35,55,50,250,0.40336134453781514,0.5
80,45,65,90,110,80,470,0.5462962962962963,60,45,70,75,85,55,390,0.3008130081300813,0.5
100,100,100,100,100,100,600,0.8778625954198473,38,30,41,30,41,60,240,0.2897196261682243,1.0
65,65,60,130,95,110,525,0.823943661971831,57,24,86,24,86,23,300,0.12727272727272726,0.25
100,73,83,73,83,55,467,0.371900826446281,40,30,35,50,70,55,280,0.28205128205128205,1.0
30,35,30,100,35,80,310,0.4765625,30,105,90,25,25,50,325,0.2773722627737226,1.0
60,55,50,40,55,45,305,0.22377622377622378,65,65,45,75,45,95,390,0.72,0.5
65,75,105,35,65,85,430,0.6940298507462687,75,80,55,25,35,35,305,0.18666666666666668,2.0
64,115,65,83,63,65,455,0.5323741007194245,60,85,49,60,49,60,363,0.4444444444444444,1.0
106,110,90,154,90,130,680,0.926829268292683,49,49,56,49,61,66,330,0.5190839694656488,1.0
60,40,60,95,60,55,370,0.4222222222222222,67,89,116,79,116,33,500,0.2624113475177305,4.0
80,75,150,75,150,50,580,0.30973451327433627,43,80,65,50,35,35,308,0.14193548387096774,0.5
80,95,82,60,82,75,474,0.6,65,75,105,35,65,85,430,0.6940298507462687,0.5
80,100,123,122,120,80,625,0.56,70,65,65,55,55,70,380,0.5,1.0
90,95,95,70,90,70,510,0.5230769230769231,65,130,60,75,60,75,465,0.689922480620155,2.0
123,77,72,99,92,58,521,0.4621212121212121,60,90,70,60,120,40,440,0.27419354838709675,1.0
100,77,77,128,128,90,600,0.6901408450704225,38,35,35,65,55,50,278,0.2647058823529412,0.5
126,131,95,131,98,99,680,0.8294573643410853,75,70,90,70,105,80,490,0.656,2.0
70,43,53,43,53,40,302,0.19090909090909092,63,120,85,90,55,55,468,0.2809917355371901,1.0
75,100,63,80,63,116,497,0.9345794392523364,126,131,95,131,98,99,680,0.8102189781021898,2.0
60,100,85,80,85,100,510,0.7007874015748031,40,40,40,70,40,20,250,0.032520325203252036,1.0
55,55,50,45,65,55,325,0.37373737373737376,86,81,97,81,107,43,495,0.203125,0.5
60,60,50,40,50,75,335,0.5882352941176471,45,60,40,70,50,45,310,0.2846715328467153,0.5
150,80,44,90,54,80,498,0.625,42,52,67,39,56,50,306,0.2868217054263566,0.5
165,75,80,40,45,65,470,0.5151515151515151,90,85,100,95,125,85,580,0.6834532374100719,1.0
30,35,30,100,35,80,310,0.4765625,46,57,40,40,40,50,273,0.25,0.5
65,100,70,80,80,105,500,0.8666666666666667,70,150,140,65,100,75,600,0.55,4.0
50,70,100,40,40,30,330,0.2222222222222222,60,80,50,40,40,30,300,0.15328467153284672,0.5
75,125,230,55,95,30,610,0.3448275862068966,105,105,75,65,100,50,500,0.37593984962406013,2.0
50,47,50,57,50,65,319,0.463768115942029,55,75,60,75,60,103,428,0.7982456140350878,0.5
106,130,90,110,154,90,680,0.719626168224299,41,64,45,50,50,50,300,0.36752136752136755,0.5
95,75,110,100,80,30,490,0.15267175572519084,1,90,45,30,30,40,236,0.33064516129032256,1.0
65,50,35,115,95,95,455,0.7333333333333333,62,44,50,44,50,55,305,0.3629032258064516,1.0
95,65,110,60,130,65,525,0.5275590551181102,90,95,95,70,90,70,510,0.5230769230769231,0.5
50,40,85,40,65,25,305,0.08870967741935484,39,52,43,60,50,65,309,0.5041322314049587,0.5
70,80,65,90,65,85,455,0.578125,92,105,90,125,90,98,600,0.8217054263565892,0.0
65,80,65,35,65,60,370,0.38405797101449274,50,70,100,40,40,30,330,0.2222222222222222,0.25
39,52,43,60,50,65,309,0.49107142857142855,55,75,50,40,40,80,340,0.6302521008403361,1.0
65,60,70,85,75,40,395,0.1796875,80,145,150,105,110,110,700,0.8692307692307693,0.5
64,51,23,51,23,28,240,0.11363636363636363,41,50,37,50,37,66,281,0.5175438596491229,1.0
40,40,40,70,40,20,250,0.032520325203252036,90,75,75,90,100,70,500,0.5462184873949579,0.5
25,20,15,105,55,90,310,0.32407407407407407,120,70,120,75,130,85,600,0.6694915254237288,0.5
40,35,30,20,20,50,195,0.23423423423423423,45,35,50,70,50,30,280,0.15753424657534246,4.0
150,80,44,90,54,80,498,0.625,125,170,100,120,90,95,700,0.77,1.0
72,85,70,65,70,58,420,0.41304347826086957,85,100,122,58,75,54,494,0.3939393939393939,2.0
74,100,72,90,72,46,454,0.24561403508771928,60,70,50,100,50,65,395,0.5217391304347826,0.25
70,140,230,60,80,50,630,0.32432432432432434,60,69,95,69,95,36,424,0.2608695652173913,0.5
85,105,100,79,83,78,530,0.5869565217391305,50,53,48,53,48,64,316,0.4076923076923077,0.5
60,40,50,75,85,95,405,0.6044776119402985,35,46,34,35,45,20,215,0.072,1.0
95,155,109,70,130,81,640,0.6788321167883211,86,92,88,68,75,73,482,0.6835443037974683,1.0
85,110,90,45,90,80,500,0.6206896551724138,52,65,50,45,50,38,300,0.27419354838709675,1.0
65,130,60,95,110,65,525,0.5303030303030303,79,105,70,145,80,101,580,0.8608695652173913,1.0
60,95,80,60,80,30,405,0.19480519480519481,60,80,50,50,50,40,330,0.23853211009174313,1.0
35,45,160,30,45,70,385,0.48148148148148145,75,125,100,70,80,45,495,0.33035714285714285,2.0
54,66,70,44,55,46,335,0.4214876033057851,46,87,60,30,40,57,320,0.37777777777777777,0.5
53,51,53,61,56,40,314,0.14285714285714285,70,120,65,45,85,125,510,0.9747899159663865,1.0
77,120,90,60,90,48,485,0.2785714285714286,50,92,108,92,108,35,485,0.2457627118644068,1.0
45,30,50,65,50,45,285,0.13821138211382114,40,30,30,55,30,85,270,0.4666666666666667,1.0
75,70,90,70,105,80,490,0.656,80,80,50,40,50,25,325,0.176056338028169,1.0
150,120,100,120,100,90,680,0.664179104477612,65,100,70,80,80,105,500,0.8666666666666667,1.0
65,60,110,130,95,65,525,0.47761194029850745,40,45,65,100,120,90,460,0.5588235294117647,1.0
75,75,95,75,95,113,528,0.9015151515151515,35,55,35,30,30,35,220,0.23684210526315788,1.0
70,60,62,80,82,60,414,0.4375,50,92,108,92,108,35,485,0.2457627118644068,1.0
92,105,90,125,90,98,600,0.8217054263565892,80,82,100,83,100,80,525,0.6821705426356589,1.0
70,90,45,15,45,50,315,0.3629032258064516,100,70,70,65,65,45,415,0.1897810218978102,1.0
60,75,100,55,80,50,420,0.3088235294117647,60,85,49,60,49,60,363,0.4444444444444444,0.5
80,82,83,100,100,80,525,0.6742424242424242,90,92,87,75,85,76,505,0.5409836065573771,0.25
80,95,82,60,82,75,474,0.6,41,56,40,62,44,71,314,0.568,1.0
61,72,57,55,55,65,365,0.3984375,79,115,70,125,80,111,580,0.8468468468468469,1.0
75,75,95,75,95,113,528,0.9015151515151515,35,55,40,50,50,90,320,0.6838235294117647,1.0
95,75,110,100,80,30,490,0.15267175572519084,62,48,54,63,60,68,355,0.5178571428571429,0.5
100,100,125,110,50,50,535,0.384,43,70,48,50,60,38,309,0.2391304347826087,0.5
70,85,70,60,70,50,405,0.28378378378378377,50,65,107,105,107,86,520,0.703125,2.0
95,124,78,69,71,58,495,0.37398373983739835,50,53,48,53,48,64,316,0.46153846153846156,1.0
66,117,70,40,50,67,410,0.4573643410852713,71,82,64,64,59,112,452,0.9327731092436975,1.0
55,75,85,25,25,15,280,0.1875,35,60,44,40,54,55,288,0.366412213740458,1.0
76,65,45,92,42,91,411,0.7449664429530202,50,50,50,50,50,50,300,0.30708661417322836,1.0
65,75,90,97,123,44,494,0.1987179487179487,95,65,65,110,130,60,525,0.4016393442622951,0.0
73,115,60,60,60,90,458,0.6694915254237288,70,150,140,65,100,75,600,0.55,0.5
90,100,70,110,150,80,600,0.6037735849056604,60,90,70,60,120,40,440,0.27419354838709675,1.0
60,67,85,77,75,116,480,0.8888888888888888,100,90,130,45,65,55,485,0.4253731343283582,4.0
90,95,105,165,110,45,610,0.2890625,150,80,44,90,54,80,498,0.625,2.0
90,93,55,70,55,55,418,0.3819444444444444,65,125,60,95,60,105,510,0.9236641221374046,1.0
80,80,80,80,80,80,480,0.5606060606060606,80,90,80,130,110,110,600,0.856,0.5
150,160,100,95,65,100,670,0.8866666666666667,78,104,78,159,115,100,634,0.8444444444444444,1.0
50,70,160,70,160,90,600,0.7417218543046358,50,65,107,105,107,86,520,0.7313432835820896,1.0
125,58,58,76,76,67,460,0.515625,65,65,45,75,45,95,390,0.72,2.0
70,50,30,95,135,105,485,0.8040540540540541,55,84,105,114,75,52,485,0.2890625,0.5
70,135,105,60,105,20,495,0.5806451612903226,50,85,125,85,115,20,480,0.4306569343065693,1.0
44,50,91,24,86,10,305,0.1981981981981982,55,45,50,45,65,80,340,0.5546218487394958,0.25
45,55,39,35,39,42,255,0.18518518518518517,100,180,160,150,90,90,770,0.7520661157024794,1.0
85,90,80,70,80,130,535,0.9262295081967213,35,65,35,65,35,65,300,0.46621621621621623,1.0
95,85,85,65,65,35,430,0.2571428571428571,91,129,90,72,90,108,580,0.8536585365853658,4.0
40,40,40,70,40,20,250,0.032520325203252036,78,104,78,159,115,100,634,0.8444444444444444,0.5
60,50,100,85,70,65,430,0.47580645161290325,80,125,75,40,95,85,500,0.6911764705882353,4.0
46,87,60,30,40,57,320,0.37777777777777777,45,35,45,62,53,35,275,0.11851851851851852,1.0
75,75,55,105,85,30,425,0.1619718309859155,36,50,50,65,60,44,305,0.16363636363636364,1.0
50,64,50,45,50,41,300,0.22727272727272727,60,85,49,60,49,60,363,0.4444444444444444,2.0
70,70,70,70,70,70,420,0.5289256198347108,50,65,107,105,107,86,520,0.6991150442477876,1.0
50,45,45,35,35,50,260,0.23529411764705882,40,45,35,30,40,55,245,0.3793103448275862,1.0
110,78,73,76,71,60,468,0.3333333333333333,50,70,100,40,40,30,330,0.2222222222222222,8.0
20,10,230,10,230,5,505,0.0,50,65,107,105,107,86,520,0.7758620689655172,1.0
106,90,130,90,154,110,680,0.8699186991869918,70,95,85,55,65,70,440,0.5,0.25
90,95,95,70,90,70,510,0.5230769230769231,100,100,100,100,100,100,600,0.8805970149253731,0.5
61,78,95,56,58,57,405,0.40336134453781514,86,81,97,81,107,43,495,0.203125,1.0
65,65,65,50,50,90,385,0.72,66,65,48,62,57,52,350,0.36220472440944884,0.5
106,150,70,194,120,140,780,0.952,80,130,100,160,120,110,700,0.8981481481481481,0.5
70,135,105,60,105,20,495,0.5806451612903226,37,25,41,25,41,25,194,0.08870967741935484,1.0
50,65,107,105,107,86,520,0.6991150442477876,40,45,35,40,40,90,290,0.65,1.0
55,130,115,50,50,75,475,0.5982142857142857,41,56,40,62,44,71,314,0.568,0.5
60,95,80,60,80,30,405,0.19480519480519481,75,103,80,70,80,92,500,0.7933884297520661,0.5
70,60,75,110,75,90,480,0.7165354330708661,45,50,35,55,75,40,300,0.21367521367521367,0.5
70,83,50,37,50,60,350,0.3360655737704918,65,80,140,40,70,70,465,0.5223880597014925,0.25
50,85,40,85,40,35,335,0.1746031746031746,65,95,100,60,50,50,420,0.34959349593495936,0.5
50,70,100,40,40,30,330,0.2222222222222222,35,60,44,40,54,55,288,0.366412213740458,1.0
50,52,48,65,50,55,320,0.33098591549295775,85,110,76,65,82,56,474,0.3933333333333333,0.5
70,40,50,55,50,25,290,0.061068702290076333,115,45,20,45,25,20,270,0.11538461538461539,1.0
30,105,90,25,25,50,325,0.2773722627737226,70,110,80,55,80,105,500,0.8794326241134752,1.0
78,104,78,159,115,100,634,0.8444444444444444,40,55,30,30,30,85,270,0.688,1.0
58,109,112,48,48,109,484,0.8805970149253731,95,95,85,125,65,55,520,0.3894736842105263,4.0
75,125,70,125,70,115,580,0.9037037037037037,45,55,39,35,39,42,255,0.18518518518518517,1.0
65,40,70,80,140,70,465,0.5954198473282443,20,10,230,10,230,5,505,0.0,2.0
50,60,60,60,60,30,320,0.11290322580645161,80,70,65,80,120,100,515,0.8034188034188035,0.25
60,95,80,60,80,30,405,0.19480519480519481,65,100,70,80,80,105,500,0.8666666666666667,0.25
100,100,100,100,100,100,600,0.8758169934640523,55,70,55,40,55,85,360,0.7073170731707317,1.0
40,40,35,50,100,70,335,0.5031847133757962,80,52,50,90,50,89,411,0.6666666666666666,1.0
75,85,200,55,65,30,510,0.16778523489932887,36,50,50,65,60,44,305,0.16363636363636364,2.0
38,41,40,50,65,65,299,0.4108527131782946,28,25,25,45,35,40,198,0.16083916083916083,1.0
80,105,65,60,75,130,515,0.9645390070921985,72,85,70,65,70,58,420,0.41304347826086957,1.0
60,95,80,60,80,30,405,0.19480519480519481,43,80,65,50,35,35,308,0.14193548387096774,2.0
20,10,230,10,230,5,505,0.0,80,80,80,55,55,90,440,0.6417910447761194,1.0
50,150,50,150,50,150,600,0.9339622641509434,90,120,100,150,120,100,680,0.7718120805369127,1.0
40,35,30,20,20,50,195,0.23423423423423423,58,70,45,40,45,42,300,0.25925925925925924,0.5
75,98,63,98,63,101,498,0.849624060150376,45,35,45,62,53,35,275,0.11851851851851852,0.5
45,30,15,85,65,65,305,0.36220472440944884,40,45,40,65,40,65,295,0.5661764705882353,1.0
120,100,85,30,85,45,465,0.22448979591836735,50,60,60,60,60,30,320,0.11290322580645161,0.5
90,50,34,60,44,70,348,0.6283185840707964,50,75,45,40,45,60,315,0.4380165289256198,2.0
76,48,48,57,62,34,325,0.11688311688311688,55,104,105,94,75,52,485,0.36363636363636365,0.5
110,65,105,55,95,80,510,0.6258503401360545,65,125,100,55,70,85,500,0.6532258064516129,2.0
86,76,86,116,56,95,515,0.7982456140350878,90,130,80,65,85,55,505,0.4396551724137931,1.0
50,65,85,35,35,55,325,0.32575757575757575,63,120,85,90,55,55,468,0.2809917355371901,2.0
40,30,35,45,40,55,245,0.31496062992125984,49,66,70,44,55,51,335,0.4260869565217391,2.0
68,65,65,125,115,80,518,0.6461538461538462,100,103,75,120,75,127,600,0.940677966101695,1.0
65,155,120,65,90,105,600,0.8677685950413223,62,48,54,63,60,68,355,0.5178571428571429,2.0
100,50,80,60,80,50,420,0.34375,55,81,60,50,70,97,413,0.7214285714285714,1.0
60,45,70,45,90,95,405,0.7304964539007093,80,75,150,75,150,50,580,0.30973451327433627,1.0
58,50,145,95,105,30,483,0.2459016393442623,79,115,70,125,80,111,580,0.8468468468468469,1.0
108,170,115,120,95,92,700,0.7083333333333334,110,85,95,80,95,50,515,0.2713178294573643,1.0
85,120,70,50,60,100,485,0.8308823529411765,30,40,55,40,55,60,280,0.3237410071942446,2.0
50,53,48,53,48,64,316,0.46153846153846156,50,50,150,50,150,50,500,0.2571428571428571,0.5
60,52,168,47,138,30,495,0.19834710743801653,65,110,130,60,65,95,525,0.8278145695364238,1.0
40,45,35,40,40,90,290,0.65,40,45,65,100,120,90,460,0.5588235294117647,1.0
100,150,140,100,90,90,670,0.7969924812030075,91,72,90,129,90,108,580,0.8925619834710744,1.0
61,78,95,56,58,57,405,0.40336134453781514,38,35,40,27,25,35,200,0.08208955223880597,0.5
75,85,200,55,65,30,510,0.16778523489932887,40,29,45,29,45,36,224,0.14634146341463414,0.5
45,35,50,70,50,30,280,0.15753424657534246,78,130,111,130,85,100,634,0.8561151079136691,0.25
53,51,53,61,56,40,314,0.14285714285714285,65,60,110,130,95,65,525,0.47761194029850745,1.0
105,140,55,30,55,95,480,0.8195488721804511,100,123,75,57,75,80,510,0.6923076923076923,1.0
40,55,70,45,60,30,300,0.10619469026548672,75,85,200,55,65,30,510,0.16778523489932887,0.5
70,83,50,37,50,60,350,0.3360655737704918,150,160,100,95,65,100,670,0.8866666666666667,1.0
70,80,65,90,65,85,455,0.578125,40,65,95,60,45,35,340,0.13986013986013987,2.0
30,80,90,55,45,55,355,0.4295774647887324,50,50,50,50,50,50,300,0.30708661417322836,2.0
90,85,100,95,125,85,580,0.6834532374100719,95,125,79,60,100,81,540,0.6165413533834586,1.0
55,104,105,94,75,52,485,0.36363636363636365,51,65,65,80,75,59,395,0.4365079365079365,1.0
40,50,90,30,55,65,330,0.44680851063829785,70,62,67,55,55,56,365,0.38513513513513514,0.25
62,50,58,73,54,72,369,0.4435483870967742,60,50,70,80,80,140,480,0.8449612403100775,1.0
100,134,110,95,100,61,600,0.4057971014492754,95,124,78,69,71,58,495,0.37398373983739835,0.125
65,85,70,75,70,40,405,0.203125,75,69,72,114,100,104,534,0.8253968253968254,1.0
65,73,55,47,75,85,400,0.6846846846846847,37,25,41,25,41,25,194,0.08870967741935484,1.0
60,150,50,150,50,60,520,0.5,50,65,85,35,35,55,325,0.32575757575757575,2.0
40,70,130,60,130,25,455,0.17355371900826447,100,100,100,100,100,100,600,0.831858407079646,2.0
62,73,55,56,52,84,382,0.7244094488188977,55,55,85,65,85,35,380,0.2014388489208633,0.125
80,75,150,75,150,50,580,0.30973451327433627,59,59,58,90,70,73,409,0.5826086956521739,0.5
70,85,70,60,70,50,405,0.28378378378378377,40,40,35,50,100,70,335,0.5031847133757962,1.0
60,115,105,65,70,80,495,0.7181818181818181,65,90,122,58,75,84,494,0.71875,0.5
108,112,118,68,72,47,525,0.2916666666666667,100,100,100,100,100,100,600,0.831858407079646,1.0
60,60,50,40,50,75,335,0.5882352941176471,35,65,35,65,35,65,300,0.46621621621621623,2.0
77,120,90,60,90,48,485,0.2785714285714286,75,100,63,80,63,116,497,0.9345794392523364,1.0
58,64,58,80,65,80,405,0.5423728813559322,62,73,55,56,52,84,382,0.7244094488188977,0.5
50,55,50,36,30,43,264,0.2922077922077922,85,70,80,97,80,123,535,0.9304347826086956,1.0
70,43,53,43,53,40,302,0.19090909090909092,65,45,55,45,70,45,325,0.24369747899159663,1.0
50,50,120,80,80,30,410,0.07258064516129033,250,5,5,35,105,50,450,0.15306122448979592,1.0
40,80,35,35,45,70,305,0.4661016949152542,65,90,122,58,75,84,494,0.71875,0.0
90,95,105,165,110,45,610,0.2890625,40,50,90,30,55,65,330,0.44680851063829785,1.0
30,80,90,55,45,55,355,0.4295774647887324,73,115,60,60,60,90,458,0.6694915254237288,1.0
60,79,105,59,85,36,424,0.17054263565891473,45,53,70,40,60,42,310,0.25735294117647056,0.5
20,10,230,10,230,5,505,0.0,79,115,70,125,80,111,580,0.8468468468468469,1.0
65,40,70,80,140,70,465,0.5954198473282443,40,40,50,30,30,30,220,0.0873015873015873,1.0
80,160,80,130,80,100,630,0.8455284552845529,100,150,120,120,100,90,680,0.6493506493506493,0.5
50,72,35,35,35,65,292,0.5373134328358209,62,55,52,109,94,109,481,0.7833333333333333,2.0
55,55,50,45,65,55,325,0.37373737373737376,30,45,135,45,90,30,375,0.09285714285714286,0.5
100,134,110,95,100,61,600,0.4057971014492754,84,86,88,111,101,60,530,0.4634146341463415,0.5
55,112,45,74,45,70,401,0.559322033898305,70,100,115,30,65,30,410,0.24390243902439024,0.5
70,90,45,15,45,50,315,0.3629032258064516,40,55,99,40,79,47,360,0.26262626262626265,2.0
50,53,48,53,48,64,316,0.358974358974359,50,25,28,45,55,15,218,0.0625,1.0
60,90,55,90,80,110,485,0.8677685950413223,40,55,80,35,60,30,300,0.15037593984962405,1.0
50,72,35,35,35,65,292,0.5373134328358209,50,65,85,35,35,55,325,0.32575757575757575,1.0
85,110,76,65,82,56,474,0.3933333333333333,60,62,80,63,80,60,405,0.4336283185840708,0.5
78,84,78,109,85,100,534,0.8620689655172413,50,55,50,36,30,43,264,0.2922077922077922,1.0
72,95,67,103,71,122,530,0.9606299212598425,40,50,45,70,45,70,320,0.5517241379310345,2.0
75,100,95,40,70,110,490,0.8717948717948718,70,75,60,105,60,105,475,0.88,1.0
55,40,85,80,105,40,405,0.23622047244094488,91,90,106,130,106,77,600,0.648854961832061,0.125
81,102,77,85,75,85,505,0.5642857142857143,46,87,60,30,40,57,320,0.37777777777777777,1.0
109,66,84,81,99,32,471,0.2013888888888889,90,120,100,150,120,100,680,0.7718120805369127,1.0
45,67,60,35,50,63,320,0.5128205128205128,50,30,55,65,55,20,275,0.13675213675213677,2.0
60,45,50,90,80,70,395,0.625,60,85,49,60,49,60,363,0.4444444444444444,0.5
79,115,70,125,80,111,580,0.864,70,60,62,80,82,60,414,0.4375,4.0
40,20,30,40,80,55,265,0.22764227642276422,55,84,105,114,75,52,485,0.2890625,1.0
70,80,102,80,102,40,474,0.2677165354330709,75,89,85,55,65,36,405,0.29545454545454547,4.0
100,150,110,95,110,70,635,0.5923076923076923,85,100,122,58,75,54,494,0.3939393939393939,0.25
45,75,37,70,55,83,365,0.6183206106870229,50,65,107,105,107,86,520,0.7758620689655172,0.5
70,84,70,65,70,51,410,0.2949640287769784,60,100,89,55,69,112,485,0.9298245614035088,2.0
45,90,20,65,20,65,305,0.5116279069767442,80,100,70,50,60,45,405,0.25806451612903225,0.5
50,70,50,50,50,70,340,0.5645161290322581,86,92,88,68,75,73,482,0.6835443037974683,1.0
30,40,70,70,25,60,295,0.41353383458646614,55,70,40,60,40,40,305,0.26956521739130435,1.0
130,65,60,110,95,65,525,0.5227272727272727,80,100,80,80,80,100,520,0.9051724137931034,1.0
60,105,60,120,60,105,510,0.8849557522123894,30,80,90,55,45,55,355,0.4295774647887324,1.0
110,123,65,100,65,65,528,0.5217391304347826,75,125,75,30,75,85,465,0.625,1.0
45,90,20,65,20,65,305,0.5116279069767442,61,90,45,50,50,160,456,0.9230769230769231,1.0
60,65,60,130,75,110,500,0.7719298245614035,95,60,79,100,125,81,540,0.6201550387596899,1.0
45,30,50,55,65,45,290,0.208,40,45,65,100,120,90,460,0.5588235294117647,0.5
55,40,40,65,45,35,280,0.16428571428571428,70,55,65,95,85,70,440,0.5307692307692308,1.0
70,55,95,95,110,65,490,0.48872180451127817,95,75,180,130,80,30,590,0.13793103448275862,0.5
70,135,105,60,105,20,495,0.5806451612903226,50,65,64,44,48,43,314,0.2196969696969697,0.5
50,85,55,65,65,90,410,0.7478260869565218,75,90,140,60,60,40,465,0.3008130081300813,4.0
73,100,60,100,60,65,458,0.42657342657342656,60,60,60,35,35,30,280,0.11194029850746269,1.0
35,55,35,30,30,35,220,0.23684210526315788,65,150,40,15,80,145,495,0.9663865546218487,1.0
53,51,53,61,56,40,314,0.14285714285714285,55,66,44,44,56,85,350,0.6888888888888889,1.0
70,92,65,80,55,98,460,0.8090909090909091,120,100,85,30,85,45,465,0.22448979591836735,1.0
40,45,35,40,40,90,290,0.65,69,55,45,55,55,15,294,0.11666666666666667,1.0
65,80,80,59,63,58,405,0.4411764705882353,73,76,75,81,100,100,505,0.8110236220472441,2.0
40,40,55,40,70,55,300,0.40939597315436244,95,110,95,40,95,55,490,0.40336134453781514,1.0
75,75,60,83,60,60,413,0.39344262295081966,60,70,65,125,105,90,515,0.6911764705882353,0.5
75,125,230,55,95,30,610,0.3448275862068966,95,75,110,100,80,30,490,0.15267175572519084,0.5
30,35,30,100,35,80,310,0.4765625,57,24,86,24,86,23,300,0.12727272727272726,0.0
67,82,62,46,48,43,348,0.22033898305084745,103,60,86,60,86,50,445,0.3458646616541353,2.0
65,90,122,58,75,84,494,0.71875,65,47,55,73,75,85,400,0.65,0.5
72,105,115,54,86,68,500,0.5149253731343284,103,60,86,60,86,50,445,0.3458646616541353,1.0
60,85,69,60,69,77,420,0.518796992481203,105,140,55,30,55,95,480,0.8195488721804511,1.0
115,45,20,45,25,20,270,0.11538461538461539,80,135,130,95,90,70,600,0.5181818181818182,0.25
35,55,40,50,50,90,320,0.6838235294117647,60,79,105,59,85,36,424,0.17054263565891473,0.0
60,100,115,70,85,90,520,0.7557251908396947,50,70,160,70,160,90,600,0.7417218543046358,1.0
40,40,50,30,30,30,220,0.0873015873015873,74,48,76,83,81,104,466,0.7913043478260869,1.0
65,80,65,35,65,60,370,0.38405797101449274,83,106,65,86,65,85,490,0.6640625,1.0
54,45,47,75,98,52,371,0.39669421487603307,45,65,34,40,34,45,263,0.2589928057553957,1.0
90,92,75,92,85,60,494,0.49586776859504134,40,30,35,45,40,55,245,0.31496062992125984,1.0
40,30,35,45,40,55,245,0.31496062992125984,70,90,45,15,45,50,315,0.3629032258064516,1.0
67,57,55,77,55,114,425,0.8879310344827587,60,50,150,50,150,60,520,0.5206611570247934,0.25
65,90,65,61,61,100,442,0.8373983739837398,25,20,15,105,55,90,310,0.32407407407407407,1.0
55,20,35,20,45,75,250,0.37681159420289856,54,78,103,53,45,22,355,0.23255813953488372,0.5
60,90,140,50,50,40,430,0.2535211267605634,70,115,60,115,60,55,475,0.4647887323943662,1.0
70,62,67,55,55,56,365,0.38513513513513514,85,115,80,105,80,50,515,0.3063063063063063,1.0
100,180,160,150,90,90,770,0.7520661157024794,55,55,85,65,85,35,380,0.2014388489208633,0.5
70,55,65,95,85,70,440,0.5307692307692308,55,45,43,55,43,72,313,0.5853658536585366,1.0
110,160,110,80,110,100,670,0.8591549295774648,50,95,90,95,90,180,600,0.9172413793103448,1.0
85,73,70,73,115,67,483,0.5126050420168067,60,62,63,80,80,60,405,0.38016528925619836,2.0
35,64,85,74,55,32,345,0.19827586206896552,30,42,118,42,88,30,350,0.112,2.0
70,60,75,110,75,90,480,0.7165354330708661,50,160,110,160,110,110,700,0.8854961832061069,2.0
75,98,63,98,63,101,498,0.849624060150376,40,45,40,65,40,65,295,0.5661764705882353,1.0
90,92,87,75,85,76,505,0.5409836065573771,79,100,80,110,90,121,580,0.968,0.0
90,120,75,60,60,45,450,0.29411764705882354,75,75,95,75,95,113,528,0.9015151515151515,1.0
1,90,45,30,30,40,236,0.33064516129032256,10,55,25,35,45,95,265,0.5396825396825397,1.0
45,60,30,80,50,65,330,0.4603174603174603,91,90,129,90,72,108,580,0.9140625,1.0
80,70,40,100,60,145,495,0.921875,60,59,85,79,105,36,424,0.16666666666666666,2.0
85,135,130,60,80,25,515,0.40540540540540543,75,80,55,25,35,35,305,0.18666666666666668,0.5
45,65,34,40,34,45,263,0.2589928057553957,40,35,30,120,70,105,400,0.6692307692307692,1.0
71,120,95,120,95,99,600,0.8203125,20,25,45,70,90,60,310,0.30833333333333335,0.5
20,25,45,70,90,60,310,0.30833333333333335,75,80,85,110,90,50,490,0.3548387096774194,1.0
40,45,40,35,35,56,251,0.373015873015873,95,109,105,75,85,56,525,0.34513274336283184,2.0
50,75,70,35,70,48,348,0.29357798165137616,55,95,115,45,45,35,390,0.2116788321167883,2.0
50,35,55,25,25,15,205,0.05263157894736842,95,145,130,120,90,120,700,0.9398496240601504,0.5
75,95,125,45,75,95,510,0.8257575757575758,72,85,70,65,70,58,420,0.41304347826086957,1.0
80,120,79,95,79,70,523,0.5833333333333334,60,50,70,50,90,65,385,0.39568345323741005,1.0
70,55,75,45,65,60,370,0.45901639344262296,46,87,60,30,40,57,320,0.37777777777777777,1.0
50,50,95,40,50,35,320,0.20279720279720279,255,10,10,75,135,55,540,0.3125,1.0
90,95,105,165,110,45,610,0.2890625,65,130,60,75,60,75,465,0.689922480620155,1.0
65,90,120,85,70,60,490,0.43410852713178294,71,95,85,110,95,79,535,0.664,1.0
86,92,88,68,75,73,482,0.6835443037974683,30,30,30,30,30,30,180,0.12612612612612611,1.0
90,92,87,75,85,76,505,0.5409836065573771,80,100,70,50,60,45,405,0.25806451612903225,1.0
40,60,40,40,40,30,250,0.0948905109489051,70,135,105,60,105,20,495,0.5806451612903226,0.0
130,70,35,70,35,60,400,0.4017857142857143,60,60,60,35,35,30,280,0.11194029850746269,1.0
70,60,125,115,70,55,495,0.35507246376811596,100,128,90,77,77,128,600,0.959349593495935,0.5
90,30,15,40,20,15,210,0.043478260869565216,80,120,79,95,79,70,523,0.5833333333333334,1.0
70,40,50,55,50,25,290,0.061068702290076333,79,100,80,110,90,121,580,0.968,2.0
46,87,60,30,40,57,320,0.37777777777777777,100,110,90,85,90,60,535,0.47794117647058826,1.0
50,52,48,65,50,55,320,0.33098591549295775,55,85,55,50,55,60,360,0.4233576642335766,2.0
95,124,78,69,71,58,495,0.37398373983739835,64,78,52,78,52,81,405,0.6422764227642277,0.5
43,70,48,50,60,38,309,0.2391304347826087,103,93,67,71,61,84,479,0.7142857142857143,0.25
90,30,15,40,20,15,210,0.043478260869565216,55,47,52,40,40,41,275,0.16806722689075632,0.5
55,65,95,95,45,85,440,0.6610169491525424,60,50,50,60,70,50,340,0.28346456692913385,0.25
55,70,45,70,50,60,350,0.45,65,80,140,40,70,70,465,0.5223880597014925,2.0
54,45,47,75,98,52,371,0.39669421487603307,90,75,75,90,100,70,500,0.5462184873949579,1.0
60,80,95,70,85,50,440,0.2231404958677686,100,50,80,60,80,50,420,0.34375,0.25
45,60,30,80,50,65,330,0.4603174603174603,80,80,80,80,80,80,480,0.6015037593984962,2.0
60,90,140,50,50,40,430,0.2535211267605634,65,125,60,95,60,105,510,0.9236641221374046,0.5
50,47,50,57,50,65,319,0.463768115942029,100,100,90,150,140,90,670,0.71875,2.0
30,45,59,30,39,57,260,0.2803030303030303,30,45,55,70,55,85,340,0.5633802816901409,1.0
80,125,75,40,95,85,500,0.6911764705882353,100,90,130,45,65,55,485,0.4253731343283582,2.0
80,80,80,80,80,80,480,0.6015037593984962,80,185,115,40,105,75,600,0.6230769230769231,1.0
40,40,40,70,40,20,250,0.032520325203252036,50,53,48,53,48,64,316,0.4076923076923077,2.0
72,58,80,103,80,97,490,0.7171052631578947,76,147,90,60,70,97,540,0.8267716535433071,1.0
75,125,230,55,95,30,610,0.3448275862068966,85,105,100,79,83,78,530,0.5869565217391305,0.5
50,65,107,105,107,86,520,0.703125,70,60,75,110,75,90,480,0.7165354330708661,1.0
65,50,70,95,80,65,425,0.4262295081967213,105,105,75,65,100,50,500,0.37593984962406013,2.0
91,90,129,90,72,108,580,0.9140625,100,110,90,85,90,60,535,0.47794117647058826,0.5
80,95,82,60,82,75,474,0.6,55,55,45,63,45,45,308,0.25,1.0
41,56,40,62,44,71,314,0.568,75,95,60,65,60,115,470,0.8778625954198473,1.0
69,69,76,69,86,91,460,0.6554621848739496,70,150,140,65,100,75,600,0.55,1.0
90,100,90,125,85,90,580,0.7352941176470589,115,115,85,90,75,100,580,0.8134328358208955,0.5
104,91,63,91,73,68,490,0.5118110236220472,45,60,40,70,50,45,310,0.2846715328467153,1.0
30,65,100,45,25,40,305,0.1891891891891892,40,55,70,45,60,30,300,0.10619469026548672,1.0
25,35,70,95,55,45,325,0.16783216783216784,30,45,59,30,39,57,260,0.2803030303030303,1.0
50,65,107,105,107,86,520,0.6991150442477876,60,45,70,45,90,95,405,0.7304964539007093,0.5
63,63,47,41,41,74,329,0.56,59,45,40,35,40,31,250,0.14285714285714285,1.0
50,53,48,53,48,64,316,0.4076923076923077,85,50,95,120,115,80,545,0.5793650793650794,0.5
35,80,50,50,70,120,405,0.84375,75,103,80,70,80,92,500,0.7933884297520661,0.25
76,104,71,104,71,108,534,0.912751677852349,40,70,40,35,40,60,285,0.392,1.0
70,94,50,94,50,66,424,0.48148148148148145,60,85,60,85,60,55,405,0.3673469387755102,0.5
103,60,86,60,86,50,445,0.3458646616541353,60,85,42,85,42,91,405,0.8227848101265823,1.0
59,63,80,65,80,58,405,0.41843971631205673,55,63,90,50,80,42,380,0.21138211382113822,0.5
83,80,75,70,70,101,479,0.8615384615384616,90,120,100,150,120,100,680,0.7718120805369127,1.0
100,134,110,95,100,61,600,0.4057971014492754,100,120,100,150,120,90,680,0.728,2.0
51,65,65,80,75,59,395,0.4365079365079365,70,95,125,65,75,45,475,0.33613445378151263,1.0
45,100,45,45,45,10,290,0.2949640287769784,60,50,100,85,70,65,430,0.47580645161290325,0.0
68,85,65,165,135,100,618,0.8083333333333333,50,50,95,40,50,35,320,0.20279720279720279,2.0
70,120,65,45,85,125,510,0.9747899159663865,50,65,45,85,65,95,405,0.7238095238095238,2.0
73,95,62,85,65,85,465,0.6666666666666666,70,50,30,95,135,105,485,0.8040540540540541,1.0
110,80,90,95,90,65,530,0.5033557046979866,48,61,40,61,40,50,300,0.2543859649122807,1.0
50,65,64,44,48,43,314,0.2196969696969697,75,98,63,98,63,101,498,0.849624060150376,0.5
70,65,60,90,75,90,450,0.6571428571428571,95,117,80,65,70,92,519,0.8409090909090909,1.0
80,82,78,95,80,85,500,0.6869565217391305,100,100,125,110,50,50,535,0.384,0.5
150,80,44,90,54,80,498,0.625,52,65,50,45,50,38,300,0.27419354838709675,0.5
50,53,62,58,63,44,330,0.13709677419354838,81,102,77,85,75,85,505,0.5642857142857143,2.0
125,120,90,170,100,95,700,0.78125,62,44,50,44,50,55,305,0.3629032258064516,1.0
60,82,45,45,45,74,351,0.5752212389380531,46,57,40,40,40,50,273,0.25,2.0
80,80,80,55,55,90,440,0.6417910447761194,45,30,15,85,65,65,305,0.36220472440944884,1.0
60,85,60,85,60,55,405,0.3673469387755102,70,90,45,15,45,50,315,0.3629032258064516,0.5
83,80,80,135,80,121,579,0.9444444444444444,63,120,85,90,55,55,468,0.2809917355371901,1.0
40,30,30,40,50,30,220,0.07936507936507936,90,75,85,115,90,55,510,0.3445378151260504,1.0
90,60,70,75,70,45,410,0.23880597014925373,115,115,85,90,75,100,580,0.8134328358208955,1.0
70,75,80,135,80,135,575,0.917910447761194,100,128,90,77,77,128,600,0.959349593495935,1.0
190,33,58,33,58,33,405,0.13432835820895522,60,40,60,95,60,55,370,0.4222222222222222,1.0
105,140,95,55,65,45,505,0.3,70,85,140,85,70,20,470,0.272,1.0
70,90,90,135,90,125,600,0.9401709401709402,40,27,60,37,50,66,280,0.36220472440944884,0.5
60,85,40,30,45,68,328,0.6422018348623854,100,103,75,120,75,127,600,0.940677966101695,0.0
50,65,107,105,107,86,520,0.7272727272727273,60,45,70,45,90,95,405,0.7304964539007093,0.25
57,80,91,80,87,75,470,0.5737704918032787,64,51,23,51,23,28,240,0.11363636363636363,1.0
65,65,45,75,45,95,390,0.72,90,55,75,60,75,30,385,0.13970588235294118,1.0
80,120,70,110,70,80,530,0.6422764227642277,71,73,88,120,89,59,500,0.43537414965986393,0.5
70,110,75,145,85,145,630,0.9444444444444444,50,65,85,35,35,55,325,0.32575757575757575,1.0
55,65,35,60,30,85,330,0.6126126126126126,74,48,76,83,81,104,466,0.7913043478260869,1.0
75,100,95,40,70,110,490,0.8717948717948718,60,45,70,45,90,95,405,0.7304964539007093,1.0
150,120,100,120,100,90,680,0.664179104477612,20,40,90,30,90,25,295,0.11363636363636363,2.0
65,75,105,35,65,85,430,0.6940298507462687,73,115,60,60,60,90,458,0.6694915254237288,1.0
28,25,25,45,35,40,198,0.16083916083916083,80,80,50,40,50,25,325,0.176056338028169,1.0
100,50,50,76,96,70,442,0.5,37,25,41,25,41,25,194,0.08870967741935484,2.0
100,100,125,110,50,50,535,0.384,90,100,90,125,85,90,580,0.7352941176470589,0.25
100,150,140,100,90,90,670,0.7969924812030075,70,94,50,94,50,66,424,0.48148148148148145,0.0
50,85,40,85,40,35,335,0.1746031746031746,90,100,60,90,60,80,480,0.6422764227642277,0.5
35,35,40,35,55,50,250,0.40336134453781514,40,45,35,40,40,90,290,0.65,1.0
126,131,95,131,98,99,680,0.8102189781021898,73,76,75,81,100,100,505,0.8110236220472441,1.0
75,100,63,80,63,116,497,0.9345794392523364,30,35,30,100,35,80,310,0.4765625,1.0
65,80,65,35,65,60,370,0.38405797101449274,65,40,50,125,60,30,370,0.07258064516129033,1.0
110,160,110,80,110,100,670,0.8591549295774648,60,50,70,80,80,140,480,0.8449612403100775,1.0
60,55,90,145,90,80,520,0.6071428571428571,83,80,80,135,80,121,579,0.9444444444444444,0.0
95,109,105,75,85,56,525,0.34513274336283184,85,90,80,70,80,130,535,0.9262295081967213,0.0
60,115,105,65,70,80,495,0.7181818181818181,65,150,60,115,60,115,565,0.935251798561151,1.0
53,54,53,37,46,45,288,0.3090909090909091,60,50,70,50,90,65,385,0.39568345323741005,2.0
80,120,79,95,79,70,523,0.5833333333333334,60,90,55,90,80,110,485,0.8677685950413223,0.5
75,98,63,98,63,101,498,0.8091603053435115,72,105,115,54,86,68,500,0.5149253731343284,4.0
95,75,110,100,80,30,490,0.15267175572519084,30,30,30,30,30,30,180,0.12612612612612611,0.5
50,85,125,85,115,20,480,0.4306569343065693,79,100,80,110,90,121,580,0.968,1.0
55,66,44,44,56,85,350,0.6888888888888889,80,145,150,105,110,110,700,0.8692307692307693,0.5
60,100,89,55,69,112,485,0.9298245614035088,40,70,40,35,40,60,285,0.392,0.5
150,120,100,120,100,90,680,0.664179104477612,91,72,90,129,90,108,580,0.8925619834710744,1.0
95,65,65,110,130,60,525,0.4016393442622951,60,75,85,100,85,115,520,0.8992248062015504,1.0
90,92,75,92,85,60,494,0.49586776859504134,110,85,95,80,95,50,515,0.2713178294573643,1.0
90,90,85,125,90,100,580,0.768595041322314,40,60,30,31,31,70,262,0.4492753623188406,2.0
55,85,55,50,55,60,360,0.4233576642335766,80,120,80,120,80,100,580,0.8478260869565217,2.0
70,110,70,115,70,90,525,0.75,55,84,105,114,75,52,485,0.2890625,0.5
60,40,80,60,45,40,325,0.23529411764705882,70,70,70,70,70,70,420,0.5289256198347108,1.0
100,73,83,73,83,55,467,0.371900826446281,60,45,70,45,90,95,405,0.7304964539007093,1.0
45,63,37,65,55,95,360,0.8055555555555556,90,55,75,60,75,30,385,0.13970588235294118,1.0
45,30,35,20,20,45,195,0.14782608695652175,60,85,69,65,79,80,438,0.576,0.5
45,85,50,55,50,65,350,0.5076923076923077,40,55,99,40,79,47,360,0.26262626262626265,0.25
85,70,80,97,80,123,535,0.9304347826086956,46,87,60,30,40,57,320,0.37777777777777777,2.0
80,82,83,100,100,80,525,0.6742424242424242,110,80,90,95,90,65,530,0.5033557046979866,2.0
64,66,68,81,76,50,405,0.25190839694656486,95,155,109,70,130,81,640,0.6788321167883211,0.5
100,50,80,60,80,50,420,0.34375,83,106,65,86,65,85,490,0.6640625,1.0
60,50,70,80,80,140,480,0.8449612403100775,70,45,48,60,65,35,323,0.15748031496062992,1.0
40,30,50,55,55,100,330,0.584070796460177,70,85,140,85,70,20,470,0.272,1.0
50,50,40,50,40,64,294,0.45588235294117646,70,84,70,65,70,51,410,0.2949640287769784,4.0
150,80,44,90,54,80,498,0.625,69,69,76,69,86,91,460,0.6554621848739496,1.0
60,50,70,80,80,140,480,0.8449612403100775,100,110,90,85,90,60,535,0.47794117647058826,0.0
85,100,122,58,75,54,494,0.3939393939393939,45,90,20,65,20,65,305,0.5116279069767442,1.0
101,72,72,99,89,29,462,0.1937984496124031,45,53,70,40,60,42,310,0.25735294117647056,1.0
49,49,56,49,61,66,330,0.5190839694656488,65,65,65,50,50,90,385,0.72,0.5
70,95,85,55,65,70,440,0.5,70,55,75,45,65,60,370,0.45901639344262296,0.0
40,55,30,30,30,85,270,0.688,85,110,90,45,90,80,500,0.6206896551724138,1.0
65,65,60,130,95,110,525,0.823943661971831,48,61,40,61,40,50,300,0.2543859649122807,2.0
30,30,30,30,30,30,180,0.12612612612612611,55,40,40,65,45,35,280,0.16428571428571428,1.0
111,83,68,92,82,39,475,0.1774193548387097,60,100,85,80,85,100,510,0.7007874015748031,1.0
65,83,57,95,85,105,490,0.8914728682170543,95,75,110,100,80,30,490,0.15267175572519084,2.0
65,95,57,100,85,93,495,0.7441860465116279,95,70,73,95,90,60,483,0.3983739837398374,1.0
49,49,56,49,61,66,330,0.5190839694656488,75,95,95,95,95,85,540,0.6470588235294118,0.25
60,67,85,77,75,116,480,0.8888888888888888,50,65,85,35,35,55,325,0.32575757575757575,1.0
83,80,75,70,70,101,479,0.8615384615384616,51,65,65,80,75,59,395,0.4365079365079365,1.0
110,65,75,125,85,30,490,0.15,50,48,43,46,41,60,288,0.47297297297297297,2.0
50,120,53,35,110,87,455,0.640625,97,165,60,65,50,58,495,0.3902439024390244,2.0
75,75,130,75,130,95,580,0.7479674796747967,60,62,50,62,60,40,334,0.18181818181818182,1.0
108,100,121,81,95,95,600,0.7476635514018691,100,100,100,100,100,100,600,0.8805970149253731,1.0
126,131,95,131,98,99,680,0.8294573643410853,68,165,95,65,115,110,618,0.8615384615384616,2.0
110,123,65,100,65,65,528,0.5217391304347826,44,75,35,63,33,45,295,0.2647058823529412,0.0
70,80,102,80,102,40,474,0.2677165354330709,20,10,230,10,230,5,505,0.0,1.0
100,128,90,77,77,128,600,0.959349593495935,100,100,90,150,140,90,670,0.71875,1.0
48,61,40,61,40,50,300,0.2543859649122807,75,87,63,87,63,98,473,0.865546218487395,0.5
62,77,62,50,42,65,358,0.4838709677419355,90,93,55,70,55,55,418,0.3819444444444444,2.0
60,85,49,60,49,60,363,0.4444444444444444,60,50,70,80,80,140,480,0.8449612403100775,0.5
66,117,70,40,50,67,410,0.4573643410852713,75,69,72,114,100,104,534,0.8253968253968254,1.0
45,40,60,40,75,50,310,0.2926829268292683,105,105,75,65,100,50,500,0.37593984962406013,1.0
30,30,42,30,42,70,244,0.4230769230769231,95,109,105,75,85,56,525,0.34513274336283184,4.0
68,165,95,65,115,110,618,0.8615384615384616,60,80,50,50,50,40,330,0.23853211009174313,2.0
75,125,70,125,70,115,580,0.9037037037037037,76,65,45,92,42,91,411,0.7449664429530202,1.0
80,52,50,90,50,89,411,0.6666666666666666,75,89,85,55,65,36,405,0.29545454545454547,4.0
60,82,45,45,45,74,351,0.5752212389380531,60,40,50,75,85,95,405,0.6044776119402985,2.0
64,165,75,93,83,75,555,0.6587301587301587,76,147,90,60,70,97,540,0.8267716535433071,1.0
40,45,40,35,35,56,251,0.373015873015873,65,125,60,95,60,105,510,0.9236641221374046,2.0
75,100,66,60,66,115,482,0.918918918918919,60,60,60,60,60,60,360,0.38095238095238093,1.0
65,75,105,35,65,85,430,0.6940298507462687,110,160,110,80,110,100,670,0.8591549295774648,1.0
80,85,95,30,30,25,345,0.2857142857142857,89,145,90,105,80,91,600,0.8549618320610687,0.0
77,59,50,67,63,46,362,0.23140495867768596,70,85,140,85,70,20,470,0.272,1.0
65,63,45,45,45,45,308,0.2595419847328244,45,63,37,65,55,95,360,0.8055555555555556,1.0
70,85,70,60,70,50,405,0.28378378378378377,30,45,59,30,39,57,260,0.2803030303030303,1.0
111,83,68,92,82,39,475,0.1774193548387097,95,60,79,100,125,81,540,0.6201550387596899,0.5
70,60,75,110,75,90,480,0.7165354330708661,48,61,40,61,40,50,300,0.2543859649122807,0.5
65,40,50,125,60,30,370,0.07258064516129033,86,92,88,68,75,73,482,0.6835443037974683,0.0
104,91,63,91,73,68,490,0.5118110236220472,65,75,90,97,123,44,494,0.1987179487179487,1.0
109,66,84,81,99,32,471,0.2013888888888889,38,36,38,32,36,57,237,0.3893805309734513,1.0
40,30,30,55,30,85,270,0.4666666666666667,42,52,67,39,56,50,306,0.2868217054263566,0.5
110,135,60,50,65,88,508,0.7744360902255639,35,35,35,35,35,35,210,0.13385826771653545,1.0
75,75,130,75,130,95,580,0.7479674796747967,60,85,49,60,49,60,363,0.4444444444444444,1.0
80,160,60,170,130,80,680,0.6180555555555556,70,40,50,55,50,25,290,0.061068702290076333,1.0
50,53,48,53,48,64,316,0.358974358974359,62,48,66,59,57,49,341,0.33884297520661155,1.0
74,48,76,83,81,104,466,0.7913043478260869,50,48,43,46,41,60,288,0.47297297297297297,2.0
60,75,100,55,80,50,420,0.3088235294117647,70,110,75,145,85,145,630,0.9444444444444444,1.0
68,75,53,83,113,60,452,0.45384615384615384,60,90,70,60,120,40,440,0.27419354838709675,1.0
65,47,55,73,75,85,400,0.65,80,120,130,55,65,45,495,0.37037037037037035,1.0
64,88,50,88,50,106,446,0.9111111111111111,106,130,90,110,154,90,680,0.719626168224299,1.0
30,56,35,25,35,72,253,0.48148148148148145,63,60,55,50,50,71,349,0.5289256198347108,1.0
80,85,95,30,30,25,345,0.2857142857142857,70,60,62,80,82,60,414,0.4375,0.0
78,52,60,63,65,23,341,0.06015037593984962,75,90,90,140,90,115,600,0.9481481481481482,1.0
55,68,64,45,55,31,318,0.11666666666666667,100,100,80,60,60,50,450,0.3050847457627119,2.0
105,130,120,45,45,40,485,0.4444444444444444,80,80,80,80,80,80,480,0.6015037593984962,2.0
35,55,40,45,40,60,275,0.35714285714285715,65,75,105,35,65,85,430,0.6940298507462687,0.0
50,50,150,50,150,50,500,0.2571428571428571,73,115,60,60,60,90,458,0.6694915254237288,1.0
75,95,122,58,75,69,494,0.5725806451612904,75,87,63,87,63,98,473,0.865546218487395,1.0
60,150,50,150,50,60,520,0.5,59,74,50,35,50,35,303,0.3125,2.0
30,40,70,70,25,60,295,0.41353383458646614,100,180,160,150,90,90,770,0.7520661157024794,4.0
100,164,150,95,120,71,700,0.5645161290322581,44,38,33,61,43,70,289,0.5267857142857143,1.0
67,58,57,81,67,101,431,0.8790322580645161,125,120,90,170,100,95,700,0.78125,1.0
35,20,65,40,65,20,245,0.02459016393442623,35,55,40,50,50,90,320,0.6838235294117647,1.0
67,58,57,81,67,101,431,0.8790322580645161,40,30,30,55,30,85,270,0.4666666666666667,4.0
120,100,85,30,85,45,465,0.22448979591836735,20,40,15,35,35,60,205,0.34285714285714286,1.0
31,45,90,30,30,40,266,0.21929824561403508,85,56,77,50,77,78,423,0.53125,1.0
50,105,79,35,110,76,455,0.6214285714285714,45,50,35,55,75,40,300,0.21367521367521367,1.0
50,65,85,35,35,55,325,0.32575757575757575,50,70,160,70,160,90,600,0.7417218543046358,2.0
100,103,75,120,75,127,600,0.940677966101695,108,130,95,80,85,102,600,0.7637795275590551,1.0
50,50,120,80,80,30,410,0.07258064516129033,75,90,90,140,90,115,600,0.9481481481481482,1.0
50,65,107,105,107,86,520,0.7758620689655172,75,75,55,105,85,30,425,0.1619718309859155,0.25
60,45,70,45,90,95,405,0.7304964539007093,45,50,43,40,38,62,278,0.40441176470588236,2.0
60,52,168,47,138,30,495,0.19834710743801653,20,15,20,10,55,80,200,0.2682926829268293,0.5
81,102,77,85,75,85,505,0.5642857142857143,91,72,90,129,90,108,580,0.8925619834710744,1.0
70,150,140,65,100,75,600,0.55,57,24,86,24,86,23,300,0.12727272727272726,0.5
55,40,85,80,105,40,405,0.23622047244094488,45,85,50,55,50,65,350,0.5076923076923077,4.0
100,150,90,180,160,90,770,0.7348484848484849,40,50,45,70,45,70,320,0.5517241379310345,1.0
50,55,50,36,30,43,264,0.2922077922077922,80,70,70,90,100,70,480,0.5609756097560976,2.0
50,35,55,25,25,15,205,0.05263157894736842,77,120,90,60,90,48,485,0.2785714285714286,1.0
35,35,35,35,35,35,210,0.13385826771653545,55,20,35,20,45,75,250,0.37681159420289856,2.0
45,75,37,70,55,83,365,0.6183206106870229,69,55,45,55,55,15,294,0.11666666666666667,2.0
79,103,120,135,115,78,630,0.5763888888888888,65,85,70,75,70,40,405,0.203125,1.0
50,70,160,70,160,90,600,0.7417218543046358,50,95,95,35,110,70,455,0.5179856115107914,1.0
45,25,50,25,25,35,205,0.13076923076923078,90,95,95,70,90,70,510,0.5230769230769231,0.5
66,117,70,40,50,67,410,0.4573643410852713,40,70,130,60,130,25,455,0.17355371900826447,1.0
100,120,100,150,120,90,680,0.728,60,50,50,60,70,50,340,0.28346456692913385,1.0
65,95,75,55,55,85,430,0.6933333333333334,30,40,55,40,55,60,280,0.3237410071942446,1.0
85,70,80,97,80,123,535,0.9304347826086956,61,84,65,70,70,70,420,0.5,2.0
100,50,80,60,80,50,420,0.34375,115,45,20,45,25,20,270,0.11538461538461539,1.0
100,100,100,100,100,100,600,0.8805970149253731,68,75,53,83,113,60,452,0.45384615384615384,0.5
60,50,40,85,75,95,405,0.7540983606557377,90,120,120,60,60,50,500,0.35294117647058826,0.0
123,77,72,99,92,58,521,0.4621212121212121,78,84,78,109,85,100,534,0.8646616541353384,4.0
50,64,50,45,50,41,300,0.22727272727272727,105,150,90,150,90,95,680,0.8285714285714286,0.0
85,56,77,50,77,78,423,0.53125,79,105,70,145,80,101,580,0.8608695652173913,0.0
50,48,43,46,41,60,288,0.47297297297297297,30,40,55,40,55,60,280,0.3237410071942446,1.0
65,50,35,115,95,95,455,0.7333333333333333,100,100,100,100,100,100,600,0.8602941176470589,2.0
100,180,160,150,90,90,770,0.7520661157024794,50,65,45,85,65,95,405,0.7238095238095238,1.0
70,77,60,97,60,108,472,0.8394160583941606,88,107,122,74,75,64,530,0.4596774193548387,0.5
49,49,56,49,61,66,330,0.5190839694656488,75,80,85,110,90,50,490,0.3548387096774194,0.5
45,90,20,65,20,65,305,0.5116279069767442,57,80,91,80,87,75,470,0.5737704918032787,0.5
60,55,145,75,150,40,525,0.2,80,130,100,160,120,110,700,0.8981481481481481,1.0
45,100,135,65,135,45,525,0.29411764705882354,55,40,40,65,45,35,280,0.16428571428571428,1.0
86,81,97,81,107,43,495,0.203125,50,60,45,100,80,65,400,0.45689655172413796,0.25
65,65,65,50,50,90,385,0.72,75,98,63,98,63,101,498,0.889763779527559,2.0
66,65,48,62,57,52,350,0.36220472440944884,68,75,53,83,113,60,452,0.45384615384615384,0.5
75,125,100,70,80,45,495,0.33035714285714285,50,52,48,65,50,55,320,0.33098591549295775,1.0
50,75,70,35,70,48,348,0.29357798165137616,104,91,63,91,73,68,490,0.5118110236220472,2.0
50,75,75,65,65,50,380,0.4049586776859504,95,75,110,100,80,30,490,0.15267175572519084,4.0
80,145,150,105,110,110,700,0.8692307692307693,50,95,90,95,90,180,600,0.9172413793103448,0.5
75,87,63,87,63,98,473,0.865546218487395,65,63,45,45,45,45,308,0.2595419847328244,2.0
70,55,75,45,65,60,370,0.45901639344262296,100,100,80,60,60,50,450,0.3050847457627119,1.0
60,65,60,130,75,110,500,0.7719298245614035,45,95,50,40,50,75,355,0.54,0.5
76,147,90,60,70,97,540,0.8267716535433071,92,105,90,125,90,98,600,0.8217054263565892,2.0
70,80,102,80,102,40,474,0.2677165354330709,55,75,60,75,60,103,428,0.7982456140350878,0.25
70,80,102,80,102,40,474,0.2677165354330709,60,150,50,150,50,60,520,0.5,0.125
75,125,70,125,70,115,580,0.9037037037037037,110,85,95,80,95,50,515,0.2713178294573643,1.0
50,50,95,40,50,35,320,0.20279720279720279,86,81,97,81,107,43,495,0.203125,1.0
100,77,77,128,128,90,600,0.6901408450704225,40,70,130,60,130,25,455,0.17355371900826447,0.0
80,82,83,100,100,80,525,0.6742424242424242,45,50,43,40,38,62,278,0.40441176470588236,0.5
85,60,65,135,105,100,550,0.7518248175182481,59,110,150,45,49,35,448,0.3333333333333333,0.5
92,105,90,125,90,98,600,0.8217054263565892,55,85,122,58,75,99,494,0.8099173553719008,2.0
65,50,35,115,95,95,455,0.7333333333333333,45,35,45,62,53,35,275,0.11851851851851852,2.0
55,75,60,75,60,103,428,0.7982456140350878,70,83,50,37,50,60,350,0.3360655737704918,2.0
54,66,70,44,55,46,335,0.4214876033057851,65,40,50,125,60,30,370,0.07258064516129033,2.0
55,40,50,65,85,40,335,0.3181818181818182,60,50,150,50,150,60,520,0.5206611570247934,2.0
44,50,91,24,86,10,305,0.1981981981981982,77,59,50,67,63,46,362,0.23140495867768596,8.0
45,60,30,80,50,65,330,0.4603174603174603,40,30,35,45,40,55,245,0.31496062992125984,0.5
61,90,45,50,50,160,456,0.9230769230769231,50,50,40,50,40,64,294,0.45588235294117646,1.0
70,20,50,20,50,40,250,0.1557377049180328,80,82,83,100,100,80,525,0.6742424242424242,0.25
78,65,68,112,154,75,552,0.628099173553719,77,85,51,55,51,65,384,0.5163934426229508,1.0
45,85,50,55,50,65,350,0.5076923076923077,74,108,133,83,65,32,495,0.32142857142857145,2.0
70,43,53,43,53,40,302,0.19090909090909092,78,65,68,112,154,75,552,0.628099173553719,2.0
90,30,15,40,20,15,210,0.043478260869565216,50,105,125,55,95,50,480,0.375886524822695,0.25
85,105,85,40,50,40,405,0.211864406779661,85,73,70,73,115,67,483,0.5126050420168067,0.5
45,50,35,55,75,40,300,0.21367521367521367,90,92,87,75,85,76,505,0.5409836065573771,1.0
65,75,105,35,65,85,430,0.6940298507462687,108,130,95,80,85,102,600,0.7637795275590551,1.0
125,170,100,120,90,95,700,0.77,60,85,49,60,49,60,363,0.4444444444444444,1.0
70,90,70,60,60,70,420,0.6390977443609023,160,110,65,65,110,30,540,0.35714285714285715,1.0
110,130,80,70,60,80,530,0.5862068965517241,30,80,90,55,45,55,355,0.4295774647887324,1.0
65,70,60,65,65,115,440,0.8583333333333333,68,165,95,65,115,110,618,0.8615384615384616,1.0
77,120,90,60,90,48,485,0.2785714285714286,30,30,30,30,30,30,180,0.12612612612612611,1.0
100,100,100,100,100,100,600,0.8778625954198473,56,61,65,48,45,38,313,0.17567567567567569,2.0
126,131,95,131,98,99,680,0.8294573643410853,55,75,50,40,40,80,340,0.6302521008403361,1.0
108,170,115,120,95,92,700,0.7083333333333334,40,40,40,70,40,20,250,0.032520325203252036,2.0
89,124,80,55,80,55,483,0.5714285714285714,55,84,105,114,75,52,485,0.2890625,1.0
120,70,120,75,130,85,600,0.6694915254237288,89,145,90,105,80,91,600,0.8549618320610687,2.0
40,80,100,30,30,20,300,0.11851851851851852,90,30,15,40,20,15,210,0.043478260869565216,1.0
103,93,67,71,61,84,479,0.7142857142857143,55,75,50,40,40,80,340,0.6302521008403361,1.0
45,50,35,55,75,40,300,0.21367521367521367,46,87,60,30,40,57,320,0.37777777777777777,2.0
60,40,80,60,45,40,325,0.23529411764705882,50,95,90,95,90,180,600,0.9172413793103448,0.5
75,70,90,70,105,80,490,0.656,79,103,120,135,115,78,630,0.5763888888888888,1.0
65,47,55,73,75,85,400,0.65,95,65,65,110,130,60,525,0.4016393442622951,0.5
75,125,100,70,80,45,495,0.33035714285714285,106,90,130,90,154,110,680,0.8699186991869918,2.0
91,90,106,130,106,77,600,0.648854961832061,70,55,55,80,60,45,365,0.2222222222222222,0.5
55,81,60,50,70,97,413,0.7214285714285714,95,65,65,110,130,60,525,0.4016393442622951,1.0
40,40,55,40,70,55,300,0.40939597315436244,60,100,115,70,85,90,520,0.7557251908396947,1.0
65,90,40,45,80,75,395,0.625,115,45,20,45,25,20,270,0.11538461538461539,1.0
54,45,47,75,98,52,371,0.39669421487603307,58,70,45,40,45,42,300,0.25925925925925924,2.0
126,131,95,131,98,99,680,0.8294573643410853,62,48,54,63,60,68,355,0.5178571428571429,1.0
40,65,95,60,45,35,340,0.13986013986013987,60,105,60,120,60,105,510,0.8849557522123894,1.0
80,70,65,80,120,100,515,0.8034188034188035,105,95,75,85,75,74,509,0.5714285714285714,0.5
95,65,65,110,130,60,525,0.4016393442622951,60,70,65,125,105,90,515,0.6911764705882353,0.5
40,30,35,50,70,55,280,0.28205128205128205,75,125,230,55,95,30,610,0.3448275862068966,0.0
66,65,48,62,57,52,350,0.36220472440944884,110,160,110,80,110,100,670,0.8591549295774648,1.0
55,75,85,25,25,15,280,0.1875,65,63,45,45,45,45,308,0.2595419847328244,2.0
65,40,70,80,140,70,465,0.5954198473282443,74,94,131,54,116,20,489,0.4485294117647059,0.5
75,110,110,110,105,80,590,0.656934306569343,85,105,100,79,83,78,530,0.5869565217391305,1.0
50,65,45,85,65,95,405,0.7238095238095238,100,50,50,76,96,70,442,0.5,0.5
50,25,28,45,55,15,218,0.0625,73,115,60,60,60,90,458,0.6694915254237288,1.0
74,48,76,83,81,104,466,0.7322834645669292,63,60,55,50,50,71,349,0.5289256198347108,1.0
70,110,180,60,60,50,530,0.4117647058823529,60,70,50,100,50,65,395,0.5217391304347826,4.0
73,76,75,81,100,100,505,0.8110236220472441,82,121,119,69,59,71,521,0.5394736842105263,0.25
110,160,110,80,110,100,670,0.8591549295774648,40,50,45,70,45,70,320,0.5517241379310345,1.0
48,72,48,72,48,48,336,0.25984251968503935,65,125,100,60,70,70,490,0.6099290780141844,0.0
37,25,41,25,41,25,194,0.08870967741935484,50,52,48,65,50,55,320,0.33098591549295775,1.0
65,80,140,40,70,70,465,0.5223880597014925,66,65,48,62,57,52,350,0.36220472440944884,2.0
50,105,79,35,110,76,455,0.6214285714285714,78,81,71,74,69,126,499,0.9090909090909091,0.5
100,100,100,100,100,100,600,0.8805970149253731,88,107,122,74,75,64,530,0.4596774193548387,0.5
77,120,90,60,90,48,485,0.2785714285714286,65,40,70,80,140,70,465,0.5954198473282443,1.0
70,70,70,70,70,70,420,0.5289256198347108,80,160,60,170,130,80,680,0.6180555555555556,1.0
55,45,50,45,65,80,340,0.5546218487394958,50,95,90,95,90,180,600,0.9172413793103448,1.0
110,65,105,55,95,80,510,0.6258503401360545,40,30,50,55,55,100,330,0.584070796460177,0.5
110,65,75,125,85,30,490,0.15,60,67,85,77,75,116,480,0.8888888888888888,1.0
91,72,90,129,90,108,580,0.8620689655172413,106,130,90,110,154,90,680,0.719626168224299,1.0
40,30,30,55,30,85,270,0.4666666666666667,64,88,50,88,50,106,446,0.9111111111111111,1.0
54,63,52,83,56,97,405,0.7697841726618705,58,64,58,80,65,80,405,0.5423728813559322,2.0
83,80,80,135,80,121,579,0.9444444444444444,65,80,80,59,63,58,405,0.4411764705882353,1.0
70,45,48,60,65,35,323,0.15748031496062992,79,85,60,55,60,71,410,0.60431654676259,1.0
37,25,41,25,41,25,194,0.08870967741935484,60,85,42,85,42,91,405,0.8227848101265823,1.0
95,135,80,110,80,100,600,0.8248175182481752,55,70,55,40,55,85,360,0.7073170731707317,1.0
51,65,65,80,75,59,395,0.4365079365079365,95,110,80,70,80,50,485,0.37209302325581395,0.5
75,98,63,98,63,101,498,0.889763779527559,126,131,95,131,98,99,680,0.8102189781021898,1.0
70,120,100,145,105,20,560,0.2824427480916031,65,150,60,115,60,115,565,0.935251798561151,1.0
50,20,40,20,40,20,190,0.0962962962962963,45,49,49,65,65,45,318,0.2781954887218045,0.5
50,50,150,50,150,50,500,0.2571428571428571,70,60,125,115,70,55,495,0.35507246376811596,1.0
80,100,70,50,60,45,405,0.25806451612903225,70,43,53,43,53,40,302,0.19090909090909092,0.5
50,120,53,35,110,87,455,0.640625,67,125,40,30,30,58,350,0.3431372549019608,2.0
50,64,50,45,50,41,300,0.22727272727272727,55,85,55,50,55,60,360,0.4233576642335766,4.0
85,70,80,97,80,123,535,0.9304347826086956,55,55,55,85,55,30,335,0.1320754716981132,1.0
37,25,41,25,41,25,194,0.08870967741935484,59,110,150,45,49,35,448,0.3333333333333333,0.25
60,59,85,79,105,36,424,0.16666666666666666,82,80,86,85,75,72,480,0.6183206106870229,0.5
75,80,95,90,100,50,490,0.2158273381294964,65,80,65,35,65,60,370,0.38405797101449274,1.0
20,25,45,70,90,60,310,0.30833333333333335,75,55,70,55,95,110,460,0.8444444444444444,1.0
70,100,115,30,65,30,410,0.24390243902439024,50,85,40,85,40,35,335,0.1746031746031746,1.0
65,75,90,97,123,44,494,0.1987179487179487,57,24,86,24,86,23,300,0.12727272727272726,0.0
100,120,100,150,120,90,680,0.728,91,90,72,90,129,108,580,0.896,2.0
70,115,60,115,60,55,475,0.4647887323943662,45,60,30,80,50,65,330,0.4603174603174603,0.25
60,30,30,36,56,50,262,0.32432432432432434,100,150,110,95,110,70,635,0.5923076923076923,1.0
75,80,95,90,100,50,490,0.2158273381294964,50,85,125,85,115,20,480,0.4306569343065693,1.0
60,62,63,80,80,60,405,0.38016528925619836,65,65,60,130,95,110,525,0.823943661971831,1.0
45,40,60,40,75,50,310,0.2926829268292683,65,130,60,75,60,75,465,0.689922480620155,1.0
70,45,48,60,65,35,323,0.15748031496062992,25,20,15,105,55,90,310,0.32407407407407407,1.0
83,80,75,70,70,101,479,0.8615384615384616,75,95,60,65,60,115,470,0.8778625954198473,1.0
60,30,30,36,56,50,262,0.32432432432432434,59,110,150,45,49,35,448,0.3333333333333333,0.0
54,66,70,44,55,46,335,0.4214876033057851,65,95,100,60,50,50,420,0.34959349593495936,0.5
60,62,63,80,80,60,405,0.38016528925619836,35,20,65,40,65,20,245,0.02459016393442623,2.0
90,85,100,95,125,85,580,0.6834532374100719,75,70,90,70,105,80,490,0.656,4.0
55,45,50,45,65,80,340,0.5546218487394958,55,85,55,50,55,60,360,0.4233576642335766,0.5
83,80,80,135,80,121,579,0.9444444444444444,74,100,72,90,72,46,454,0.24561403508771928,2.0
100,128,90,77,77,128,600,0.959349593495935,38,30,85,55,65,30,303,0.21428571428571427,0.0
45,49,65,49,65,45,318,0.275,70,60,75,110,75,90,480,0.7165354330708661,0.5
50,105,125,55,95,50,480,0.375886524822695,38,35,35,65,55,50,278,0.2647058823529412,0.5
55,130,115,50,50,75,475,0.5982142857142857,65,55,115,100,40,60,435,0.3798449612403101,0.5
75,98,63,98,63,101,498,0.849624060150376,86,76,86,116,56,95,515,0.7982456140350878,1.0
80,82,78,95,80,85,500,0.6869565217391305,43,30,55,40,65,97,330,0.6030534351145038,0.5
95,60,79,100,125,81,540,0.6201550387596899,85,120,70,50,60,100,485,0.8308823529411765,1.0
30,30,30,30,30,30,180,0.12612612612612611,71,120,95,120,95,99,600,0.8203125,0.25
60,79,105,59,85,36,424,0.17054263565891473,70,65,60,90,75,90,450,0.6571428571428571,0.5
50,75,35,70,30,40,300,0.21296296296296297,52,65,50,45,50,38,300,0.27419354838709675,0.5
60,100,85,80,85,100,510,0.7007874015748031,60,60,50,40,50,75,335,0.5882352941176471,2.0
50,95,180,85,45,70,525,0.5298507462686567,70,95,125,65,75,45,475,0.33613445378151263,2.0
30,105,90,25,25,50,325,0.2773722627737226,78,52,60,63,65,23,341,0.06015037593984962,1.0
50,20,55,25,25,30,205,0.09774436090225563,60,55,50,40,55,45,305,0.22377622377622378,0.5
126,131,95,131,98,99,680,0.8102189781021898,90,100,60,90,60,80,480,0.6422764227642277,1.0
60,70,65,125,105,90,515,0.6911764705882353,70,70,115,130,90,60,535,0.5338983050847458,0.0
92,105,90,125,90,98,600,0.8217054263565892,78,84,78,109,85,100,534,0.8646616541353384,1.0
75,103,80,70,80,92,500,0.7933884297520661,110,65,105,55,95,80,510,0.6258503401360545,0.5
95,110,80,70,80,50,485,0.37209302325581395,50,95,90,95,90,180,600,0.9172413793103448,1.0
75,105,75,105,75,45,480,0.3274336283185841,60,85,69,65,79,80,438,0.576,1.0
95,110,95,40,95,55,490,0.40336134453781514,59,59,58,90,70,73,409,0.5826086956521739,1.0
71,82,64,64,59,112,452,0.9327731092436975,60,65,60,130,75,110,500,0.7719298245614035,0.0
65,63,45,45,45,45,308,0.2595419847328244,100,100,100,100,100,100,600,0.8758169934640523,2.0
90,30,15,40,20,15,210,0.043478260869565216,70,55,55,80,60,45,365,0.2222222222222222,1.0
55,95,115,45,45,35,390,0.2116788321167883,50,65,107,105,107,86,520,0.6991150442477876,8.0
95,124,78,69,71,58,495,0.37398373983739835,105,140,95,55,65,45,505,0.3,0.5
110,65,105,55,95,80,510,0.6258503401360545,75,100,63,80,63,116,497,0.9345794392523364,0.5
90,100,70,110,150,80,600,0.6037735849056604,130,85,80,85,95,60,535,0.43884892086330934,1.0
60,55,50,40,55,45,305,0.22377622377622378,150,120,100,120,100,90,680,0.664179104477612,0.25
40,29,45,29,45,36,224,0.14634146341463414,90,95,105,165,110,45,610,0.2890625,1.0
30,30,30,30,30,30,180,0.12612612612612611,30,30,42,30,42,70,244,0.4230769230769231,0.25
41,50,37,50,37,66,281,0.5175438596491229,40,40,40,70,40,20,250,0.032520325203252036,1.0
63,120,85,90,55,55,468,0.2809917355371901,85,110,76,65,82,56,474,0.3933333333333333,1.0
100,150,110,95,110,70,635,0.5923076923076923,48,72,48,72,48,48,336,0.25984251968503935,1.0
78,104,78,159,115,100,634,0.8444444444444444,65,80,65,35,65,60,370,0.38405797101449274,1.0
65,70,60,65,65,115,440,0.8583333333333333,30,40,55,40,55,60,280,0.3237410071942446,1.0
90,75,75,90,100,70,500,0.5462184873949579,45,75,60,40,30,50,300,0.304,0.5
30,65,100,45,25,40,305,0.1891891891891892,40,30,32,50,52,65,269,0.3671875,0.5
75,95,122,58,75,69,494,0.5725806451612904,45,67,60,35,50,63,320,0.5128205128205128,2.0
50,85,40,85,40,35,335,0.1746031746031746,65,95,57,100,85,93,495,0.7441860465116279,0.5
68,75,53,83,113,60,452,0.45384615384615384,65,40,70,80,140,70,465,0.5954198473282443,1.0
65,80,65,35,65,60,370,0.38405797101449274,90,100,60,90,60,80,480,0.6422764227642277,1.0
60,65,80,170,95,130,600,0.8625954198473282,100,100,100,100,100,100,600,0.8778625954198473,2.0
45,85,50,55,50,65,350,0.5076923076923077,126,131,95,131,98,99,680,0.8102189781021898,1.0
50,60,60,60,60,30,320,0.11290322580645161,78,70,61,50,61,100,420,0.8145161290322581,1.0
80,115,80,65,55,93,488,0.7846153846153846,82,80,86,85,75,72,480,0.6183206106870229,1.0
95,155,109,70,130,81,640,0.6788321167883211,80,105,105,105,105,80,580,0.5939849624060151,2.0
95,109,105,75,85,56,525,0.34513274336283184,50,105,79,35,110,76,455,0.6214285714285714,1.0
55,40,40,65,45,35,280,0.16428571428571428,80,100,70,50,60,45,405,0.25806451612903225,1.0
50,53,48,53,48,64,316,0.46153846153846156,40,45,35,40,40,90,290,0.65,1.0
60,75,100,55,80,50,420,0.3088235294117647,60,62,80,63,80,60,405,0.4336283185840708,1.0
46,87,60,30,40,57,320,0.37777777777777777,44,38,33,61,43,70,289,0.5267857142857143,1.0
60,115,105,65,70,80,495,0.7181818181818181,50,55,50,36,30,43,264,0.2922077922077922,2.0
35,40,100,90,55,35,355,0.1796875,75,75,95,75,95,113,528,0.9015151515151515,0.5
84,71,43,71,43,48,360,0.25874125874125875,59,66,70,44,55,41,335,0.25190839694656486,0.0
65,130,60,75,60,75,465,0.689922480620155,40,45,35,65,55,70,310,0.4482758620689655,1.0
30,30,42,30,42,70,244,0.4230769230769231,80,185,115,40,105,75,600,0.6230769230769231,2.0
40,70,130,60,130,25,455,0.17355371900826447,80,135,130,95,90,70,600,0.5181818181818182,2.0
45,50,35,55,75,40,300,0.21367521367521367,90,100,90,125,85,90,580,0.7352941176470589,1.0
55,75,50,40,40,80,340,0.6302521008403361,65,90,40,45,80,75,395,0.625,2.0
45,67,60,35,50,63,320,0.5128205128205128,69,55,45,55,55,15,294,0.11666666666666667,0.5
105,30,105,140,105,55,540,0.3524590163934426,115,115,85,90,75,100,580,0.8134328358208955,0.5
80,160,60,170,130,80,680,0.6180555555555556,85,115,80,105,80,50,515,0.3063063063063063,1.0
55,85,122,58,75,99,494,0.8099173553719008,76,48,48,57,62,34,325,0.11688311688311688,2.0
90,65,65,40,40,15,315,0.19672131147540983,70,145,88,140,70,112,625,0.8888888888888888,0.5
95,117,184,44,46,28,514,0.2975206611570248,80,70,65,80,120,100,515,0.8034188034188035,0.5
103,93,67,71,61,84,479,0.7142857142857143,10,55,25,35,45,95,265,0.5396825396825397,0.5
60,100,89,55,69,112,485,0.9298245614035088,59,74,50,35,50,35,303,0.3125,0.125
1,90,45,30,30,40,236,0.33064516129032256,84,86,88,111,101,60,530,0.4634146341463415,0.5
120,70,120,75,130,85,600,0.6694915254237288,56,61,65,48,45,38,313,0.17567567567567569,1.0
45,85,50,55,50,65,350,0.5076923076923077,41,56,40,62,44,71,314,0.568,1.0
80,100,123,122,120,80,625,0.56,60,60,40,65,45,35,305,0.15833333333333333,0.5
75,75,130,75,130,95,580,0.7479674796747967,50,85,125,85,115,20,480,0.4306569343065693,0.0
76,65,45,92,42,91,411,0.7449664429530202,75,85,200,55,65,30,510,0.16778523489932887,0.25
45,60,40,70,50,45,310,0.2846715328467153,75,38,38,56,56,67,330,0.5263157894736842,0.5
60,40,80,60,45,40,325,0.23529411764705882,80,70,70,90,100,70,480,0.5609756097560976,1.0
40,35,30,20,20,50,195,0.23423423423423423,108,112,118,68,72,47,525,0.2916666666666667,0.5
60,60,60,60,60,60,360,0.38095238095238093,45,25,50,25,25,35,205,0.13076923076923078,1.0
65,76,84,54,96,105,480,0.9008264462809917,50,75,75,65,65,50,380,0.4049586776859504,0.0
125,58,58,76,76,67,460,0.515625,40,45,40,62,60,60,307,0.33884297520661155,2.0
50,60,45,100,80,65,400,0.45689655172413796,111,83,68,92,82,39,475,0.1774193548387097,2.0
50,50,40,30,30,50,250,0.2781954887218045,45,63,37,65,55,95,360,0.8055555555555556,2.0
100,100,100,100,100,100,600,0.8805970149253731,55,65,95,95,45,85,440,0.6610169491525424,0.5
85,105,100,79,83,78,530,0.5869565217391305,110,135,60,50,65,88,508,0.7744360902255639,2.0
100,50,80,60,80,50,420,0.34375,100,100,100,100,100,100,600,0.831858407079646,1.0
85,110,76,65,82,56,474,0.3933333333333333,55,104,105,94,75,52,485,0.36363636363636365,2.0
45,63,37,65,55,95,360,0.8055555555555556,70,100,115,30,65,30,410,0.24390243902439024,1.0
100,100,100,100,100,100,600,0.831858407079646,50,70,160,70,160,90,600,0.7417218543046358,0.5
40,80,35,35,45,70,305,0.4661016949152542,76,25,45,67,55,24,292,0.0390625,0.5
45,50,45,115,55,95,405,0.6936936936936937,75,100,63,80,63,116,497,0.9345794392523364,1.0
86,92,88,68,75,73,482,0.6835443037974683,95,100,85,108,70,70,528,0.5652173913043478,1.0
60,85,40,30,45,68,328,0.6422018348623854,54,63,52,83,56,97,405,0.7697841726618705,1.0
40,20,30,40,80,55,265,0.22764227642276422,70,80,70,80,70,110,480,0.6594202898550725,0.5
45,100,135,65,135,45,525,0.29411764705882354,150,100,120,100,120,90,680,0.6666666666666666,2.0
60,80,95,70,85,50,440,0.2231404958677686,39,52,43,60,50,65,309,0.49107142857142855,0.5
100,150,90,180,160,90,770,0.7348484848484849,75,95,125,45,75,95,510,0.8257575757575758,2.0
65,65,60,130,95,110,525,0.823943661971831,75,100,95,40,70,110,490,0.8717948717948718,1.0
114,85,70,85,80,30,464,0.2066115702479339,100,100,100,100,100,100,600,0.8345864661654135,1.0
37,25,41,25,41,25,194,0.08870967741935484,90,30,15,40,20,15,210,0.043478260869565216,0.5
58,50,145,95,105,30,483,0.2459016393442623,80,160,80,130,80,100,630,0.8455284552845529,1.0
76,48,48,57,62,34,325,0.11688311688311688,20,10,230,10,230,5,505,0.0,2.0
55,55,50,45,65,55,325,0.37373737373737376,86,76,86,116,56,95,515,0.7982456140350878,1.0
75,125,75,30,75,85,465,0.625,55,70,45,70,50,60,350,0.45,1.0
77,120,90,60,90,48,485,0.2785714285714286,70,60,62,80,82,60,414,0.4375,1.0
30,30,42,30,42,70,244,0.4230769230769231,40,30,32,50,52,65,269,0.3671875,2.0
105,95,80,40,80,90,490,0.753968253968254,55,55,55,85,55,30,335,0.1320754716981132,1.0
64,51,23,51,23,28,240,0.11363636363636363,100,128,90,77,77,128,600,0.959349593495935,1.0
65,110,130,60,65,95,525,0.8278145695364238,40,60,30,31,31,70,262,0.4492753623188406,0.5
40,40,40,70,40,20,250,0.032520325203252036,52,65,55,58,62,60,352,0.4482758620689655,1.0
40,27,60,37,50,66,280,0.36220472440944884,70,140,230,60,80,50,630,0.32432432432432434,0.25
35,60,44,40,54,55,288,0.366412213740458,65,65,60,130,95,110,525,0.823943661971831,1.0
41,64,45,50,50,50,300,0.36752136752136755,65,65,60,130,95,110,525,0.823943661971831,1.0
75,80,60,65,90,102,472,0.8625954198473282,52,65,55,58,62,60,352,0.4482758620689655,1.0
61,78,95,56,58,57,405,0.40336134453781514,80,45,65,90,110,80,470,0.5462962962962963,1.0
55,55,50,45,65,55,325,0.37373737373737376,59,59,58,90,70,73,409,0.5826086956521739,1.0
70,94,50,94,50,66,424,0.48148148148148145,28,25,25,45,35,40,198,0.16083916083916083,1.0
55,40,40,65,45,35,280,0.16428571428571428,30,40,70,70,25,60,295,0.41353383458646614,2.0
60,80,110,50,80,45,425,0.2833333333333333,60,65,80,170,95,130,600,0.8625954198473282,2.0
74,48,76,83,81,104,466,0.7913043478260869,52,65,50,45,50,38,300,0.27419354838709675,0.0
70,43,53,43,53,40,302,0.19090909090909092,50,25,28,45,55,15,218,0.0625,2.0
61,84,65,70,70,70,420,0.5,95,65,110,60,130,65,525,0.5275590551181102,1.0
60,59,85,79,105,36,424,0.16666666666666666,10,55,25,35,45,95,265,0.5396825396825397,2.0
70,70,70,70,70,70,420,0.5289256198347108,105,180,100,180,100,115,780,0.9477611940298507,1.0
75,125,70,125,70,115,580,0.9037037037037037,38,35,35,65,55,50,278,0.2647058823529412,0.5
70,77,60,97,60,108,472,0.8394160583941606,126,131,95,131,98,99,680,0.8294573643410853,0.5
70,110,180,60,60,50,530,0.4117647058823529,10,55,25,35,45,95,265,0.5396825396825397,0.5
65,45,55,45,70,45,325,0.24369747899159663,45,45,35,20,30,20,195,0.07246376811594203,1.0
60,45,70,45,90,95,405,0.7304964539007093,79,103,120,135,115,78,630,0.5763888888888888,2.0
67,89,116,79,116,33,500,0.2624113475177305,68,75,53,83,113,60,452,0.45384615384615384,1.0
100,120,100,150,120,90,680,0.728,60,82,45,45,45,74,351,0.5752212389380531,1.0
67,57,55,77,55,114,425,0.8879310344827587,90,70,80,70,95,70,475,0.5190839694656488,1.0
100,100,100,100,100,100,600,0.8602941176470589,55,50,45,135,95,120,500,0.7714285714285715,1.0
68,90,65,50,55,82,410,0.6165413533834586,60,65,60,130,75,110,500,0.7719298245614035,2.0
50,53,48,53,48,64,316,0.46153846153846156,50,85,55,65,65,90,410,0.7478260869565218,0.5
35,40,100,90,55,35,355,0.1796875,70,43,53,43,53,40,302,0.19090909090909092,1.0
90,85,100,95,125,85,580,0.6834532374100719,105,180,100,180,100,115,780,0.9477611940298507,4.0
75,95,67,125,95,83,540,0.7117117117117117,76,65,45,92,42,91,411,0.7449664429530202,1.0
60,40,60,40,60,35,295,0.18055555555555555,50,25,28,45,55,15,218,0.0625,1.0
45,30,40,105,50,20,290,0.031007751937984496,65,90,122,58,75,84,494,0.71875,1.0
75,95,67,125,95,83,540,0.7117117117117117,100,110,90,85,90,60,535,0.47794117647058826,0.5
40,60,30,31,31,70,262,0.4492753623188406,59,74,50,35,50,35,303,0.3125,0.0
100,77,77,128,128,90,600,0.6901408450704225,62,55,52,109,94,109,481,0.7833333333333333,1.0
55,20,35,20,45,75,250,0.37681159420289856,75,110,110,110,105,80,590,0.656934306569343,1.0
55,75,60,75,60,103,428,0.7982456140350878,70,75,80,135,80,135,575,0.917910447761194,0.25
35,60,44,40,54,55,288,0.366412213740458,55,55,55,85,55,30,335,0.1320754716981132,1.0
50,50,50,50,50,50,300,0.30708661417322836,95,75,80,100,110,30,490,0.24242424242424243,0.5
82,121,119,69,59,71,521,0.5394736842105263,55,63,90,50,80,42,380,0.21138211382113822,2.0
65,65,65,50,50,90,385,0.72,92,105,90,125,90,98,600,0.8217054263565892,0.5
85,90,80,70,80,130,535,0.9262295081967213,85,110,90,45,90,80,500,0.6206896551724138,1.0
70,75,60,105,60,105,475,0.88,40,30,35,50,70,55,280,0.28205128205128205,0.5
60,40,60,95,60,55,370,0.4222222222222222,130,65,60,110,95,65,525,0.5227272727272727,0.5
38,30,85,55,65,30,303,0.21428571428571427,78,84,78,109,85,100,534,0.8646616541353384,1.0
70,70,40,60,40,60,340,0.4247787610619469,65,40,50,125,60,30,370,0.07258064516129033,2.0
64,88,50,88,50,106,446,0.9111111111111111,60,70,50,100,50,65,395,0.5217391304347826,1.0
90,92,87,75,85,76,505,0.5409836065573771,45,53,70,40,60,42,310,0.25735294117647056,0.5
60,62,50,62,60,40,334,0.18181818181818182,55,95,115,45,45,35,390,0.2116788321167883,8.0
40,55,80,35,60,30,300,0.15037593984962405,60,80,50,40,40,30,300,0.15328467153284672,0.5
45,63,37,65,55,95,360,0.8055555555555556,35,35,35,35,35,35,210,0.13385826771653545,1.0
50,53,48,53,48,64,316,0.46153846153846156,40,45,40,35,35,56,251,0.373015873015873,1.0
60,25,35,70,80,60,330,0.3076923076923077,40,55,80,35,60,30,300,0.15037593984962405,0.25
100,75,115,90,115,85,580,0.6446280991735537,40,30,30,55,30,85,270,0.4666666666666667,0.5
100,150,140,100,90,90,670,0.7969924812030075,55,55,55,85,55,30,335,0.1320754716981132,1.0
45,80,100,35,37,28,325,0.3125,100,73,83,73,83,55,467,0.371900826446281,1.0
45,45,55,45,55,63,308,0.4594594594594595,80,82,100,83,100,80,525,0.6821705426356589,0.5
106,190,100,154,100,130,780,0.9259259259259259,65,125,60,95,60,105,510,0.9236641221374046,1.0
70,77,60,97,60,108,472,0.8394160583941606,70,83,50,37,50,60,350,0.3360655737704918,1.0
60,50,40,85,75,95,405,0.7540983606557377,44,48,65,50,64,43,314,0.1623931623931624,2.0
38,30,41,30,41,60,240,0.2897196261682243,100,150,90,180,160,90,770,0.7348484848484849,1.0
50,53,48,53,48,64,316,0.358974358974359,85,115,80,105,80,50,515,0.3063063063063063,1.0
90,75,75,90,100,70,500,0.5462184873949579,92,105,90,125,90,98,600,0.8217054263565892,0.5
35,20,65,40,65,20,245,0.02459016393442623,63,63,47,41,41,74,329,0.56,1.0
79,115,70,125,80,111,580,0.8468468468468469,100,70,70,65,65,45,415,0.1897810218978102,1.0
60,52,168,47,138,30,495,0.19834710743801653,45,53,70,40,60,42,310,0.25735294117647056,2.0
75,125,100,70,80,45,495,0.33035714285714285,61,78,95,56,58,57,405,0.40336134453781514,2.0
80,160,80,130,80,100,630,0.8455284552845529,45,30,15,85,65,65,305,0.36220472440944884,2.0
116,55,85,107,95,29,487,0.06818181818181818,99,68,83,72,87,51,460,0.417910447761194,1.0
58,50,145,95,105,30,483,0.2459016393442623,90,95,95,70,90,70,510,0.5230769230769231,1.0
48,61,40,61,40,50,300,0.2543859649122807,45,60,32,50,32,76,295,0.5925925925925926,1.0
123,100,62,97,81,68,531,0.4806201550387597,35,80,50,50,70,120,405,0.84375,2.0
49,55,42,42,37,85,310,0.6068376068376068,80,120,70,110,70,80,530,0.6422764227642277,1.0
80,75,150,75,150,50,580,0.30973451327433627,40,29,45,29,45,36,224,0.14634146341463414,1.0
65,130,60,95,110,65,525,0.5303030303030303,45,100,45,45,45,10,290,0.2949640287769784,1.0
40,40,35,50,100,70,335,0.5031847133757962,60,75,100,55,80,50,420,0.3088235294117647,0.0
50,65,107,105,107,86,520,0.7313432835820896,65,90,50,85,45,55,390,0.371900826446281,0.125
50,55,50,36,30,43,264,0.2922077922077922,80,50,100,100,200,50,580,0.2357142857142857,1.0
50,20,40,20,40,20,190,0.0962962962962963,55,70,55,40,55,85,360,0.7073170731707317,1.0
50,55,50,36,30,43,264,0.2922077922077922,95,110,80,70,80,50,485,0.37209302325581395,1.0
44,75,35,63,33,45,295,0.2647058823529412,95,65,110,60,130,65,525,0.5275590551181102,0.5
110,85,95,80,95,50,515,0.2713178294573643,60,85,69,65,79,80,438,0.576,1.0
70,120,65,45,85,125,510,0.9747899159663865,38,30,41,30,41,60,240,0.2897196261682243,1.0
50,30,55,65,55,20,275,0.13675213675213677,85,120,70,50,60,100,485,0.8308823529411765,0.0
79,103,120,135,115,78,630,0.5763888888888888,50,72,35,35,35,65,292,0.5373134328358209,2.0
130,70,35,70,35,60,400,0.4017857142857143,60,55,50,40,55,45,305,0.22377622377622378,1.0
100,75,115,90,115,85,580,0.6446280991735537,35,35,35,35,35,35,210,0.13385826771653545,1.0
86,68,72,109,66,106,507,0.8099173553719008,80,80,50,40,50,25,325,0.176056338028169,1.0
62,73,55,56,52,84,382,0.7244094488188977,55,40,40,65,45,35,280,0.16428571428571428,0.5
79,105,70,145,80,101,580,0.8608695652173913,115,115,85,90,75,100,580,0.8134328358208955,1.0
85,90,80,70,80,130,535,0.9262295081967213,75,110,110,110,105,80,590,0.656934306569343,2.0
50,92,108,92,108,35,485,0.2457627118644068,38,35,40,27,25,35,200,0.08208955223880597,1.0
60,65,70,85,75,40,395,0.21705426356589147,45,50,45,115,55,95,405,0.6936936936936937,0.125
55,50,65,175,95,150,590,0.7818181818181819,85,73,70,73,115,67,483,0.5126050420168067,0.5
48,72,48,72,48,48,336,0.25984251968503935,75,95,125,45,75,95,510,0.8257575757575758,2.0
55,68,64,45,55,31,318,0.11666666666666667,90,95,95,70,90,70,510,0.5230769230769231,2.0
71,73,88,120,89,59,500,0.43537414965986393,78,70,61,50,61,100,420,0.8145161290322581,1.0
75,98,63,98,63,101,498,0.8091603053435115,35,40,100,90,55,35,355,0.1796875,4.0
30,80,90,55,45,55,355,0.4295774647887324,60,60,60,85,85,85,435,0.631578947368421,1.0
45,55,39,35,39,42,255,0.18518518518518517,45,85,70,40,40,60,340,0.5229357798165137,0.5
85,135,130,60,80,25,515,0.40540540540540543,58,89,77,45,45,48,362,0.3177570093457944,1.0
95,60,79,100,125,81,540,0.6201550387596899,80,90,80,130,110,110,600,0.856,0.5
65,90,50,85,45,55,390,0.371900826446281,67,57,55,77,55,114,425,0.8879310344827587,0.5
75,75,130,75,130,95,580,0.7479674796747967,80,100,70,50,60,45,405,0.25806451612903225,1.0
55,95,115,45,45,35,390,0.2116788321167883,110,65,105,55,95,80,510,0.6258503401360545,0.0
91,134,95,100,100,80,600,0.6304347826086957,75,75,55,105,85,30,425,0.1619718309859155,2.0
70,60,75,110,75,90,480,0.7165354330708661,125,130,90,130,90,95,660,0.7734375,0.5
38,41,40,50,65,65,299,0.4108527131782946,65,125,100,55,70,85,500,0.6532258064516129,2.0
75,103,80,70,80,92,500,0.7933884297520661,61,90,45,50,50,160,456,0.9230769230769231,0.125
73,95,62,85,65,85,465,0.6666666666666666,90,75,75,90,100,70,500,0.5462184873949579,1.0
67,82,62,46,48,43,348,0.22033898305084745,68,165,95,65,115,110,618,0.8615384615384616,0.5
90,92,87,75,85,76,505,0.5409836065573771,41,50,37,50,37,66,281,0.5175438596491229,1.0
72,105,115,54,86,68,500,0.5149253731343284,50,65,64,44,48,43,314,0.2196969696969697,0.5
85,56,77,50,77,78,423,0.53125,61,78,95,56,58,57,405,0.40336134453781514,0.5
66,65,48,62,57,52,350,0.36220472440944884,50,72,35,35,35,65,292,0.5373134328358209,2.0
90,95,95,70,90,70,510,0.5230769230769231,50,50,150,50,150,50,500,0.2571428571428571,2.0
45,55,39,35,39,42,255,0.18518518518518517,170,90,45,90,45,60,500,0.427536231884058,1.0
71,95,85,110,95,79,535,0.664,85,120,70,50,60,100,485,0.8308823529411765,2.0
65,125,60,95,60,105,510,0.9236641221374046,70,90,70,60,60,70,420,0.6390977443609023,2.0
40,55,30,30,30,60,245,0.43548387096774194,95,109,105,75,85,56,525,0.34513274336283184,2.0
50,55,50,36,30,43,264,0.2922077922077922,108,130,95,80,85,102,600,0.7637795275590551,1.0
35,55,40,45,40,60,275,0.35714285714285715,55,70,40,60,40,40,305,0.26956521739130435,1.0
60,85,40,30,45,68,328,0.6422018348623854,95,117,80,65,70,92,519,0.8409090909090909,1.0
40,45,35,40,40,90,290,0.65,99,68,83,72,87,51,460,0.417910447761194,1.0
108,130,95,80,85,102,600,0.7637795275590551,75,95,95,95,95,85,540,0.6470588235294118,2.0
60,80,50,50,50,40,330,0.23853211009174313,50,50,62,40,62,65,329,0.4188034188034188,1.0
40,45,65,100,120,90,460,0.5588235294117647,135,85,40,40,85,5,390,0.6864406779661016,1.0
45,30,40,105,50,20,290,0.031007751937984496,60,85,60,85,60,55,405,0.3673469387755102,1.0
75,90,50,110,80,95,500,0.7985611510791367,40,60,40,40,40,30,250,0.0948905109489051,2.0
75,95,60,65,60,115,470,0.8778625954198473,62,48,66,59,57,49,341,0.33884297520661155,1.0
190,33,58,33,58,33,405,0.13432835820895522,60,105,60,120,60,105,510,0.8849557522123894,0.0
60,115,105,65,70,80,495,0.7181818181818181,78,70,61,50,61,100,420,0.8145161290322581,1.0
43,30,55,40,65,97,330,0.6030534351145038,111,83,68,92,82,39,475,0.1774193548387097,1.0
75,75,75,125,95,40,485,0.15671641791044777,65,65,60,110,95,130,525,0.9253731343283582,1.0
73,100,60,100,60,65,458,0.42657342657342656,20,25,45,70,90,60,310,0.30833333333333335,2.0
80,45,65,90,110,80,470,0.5462962962962963,65,130,60,95,110,65,525,0.5303030303030303,1.0
77,120,90,60,90,48,485,0.2785714285714286,91,90,106,130,106,77,600,0.648854961832061,0.5
74,48,76,83,81,104,466,0.7913043478260869,70,77,60,97,60,108,472,0.8394160583941606,1.0
70,80,50,35,35,35,305,0.14,40,65,40,80,40,65,330,0.5038167938931297,2.0
55,40,50,65,85,40,335,0.3181818181818182,71,120,95,120,95,99,600,0.8203125,1.0
80,100,80,80,80,100,520,0.9051724137931034,60,70,105,70,120,75,500,0.5983606557377049,1.0
95,135,80,110,80,100,600,0.8248175182481752,30,30,42,30,42,70,244,0.4230769230769231,2.0
110,80,90,95,90,65,530,0.5033557046979866,66,65,48,62,57,52,350,0.36220472440944884,1.0
95,135,80,110,80,100,600,0.8248175182481752,106,110,90,154,90,130,680,0.926829268292683,1.0
72,85,70,65,70,58,420,0.41304347826086957,70,70,70,70,70,70,420,0.5289256198347108,1.0
50,150,50,150,50,150,600,0.9339622641509434,63,120,85,90,55,55,468,0.2809917355371901,0.0
80,50,100,100,200,50,580,0.2357142857142857,78,130,111,130,85,100,634,0.8561151079136691,1.0
50,65,107,105,107,86,520,0.6991150442477876,65,90,115,45,115,58,488,0.5041322314049587,1.0
70,80,50,35,35,35,305,0.14,59,63,80,65,80,58,405,0.41843971631205673,1.0
35,55,40,50,50,90,320,0.6838235294117647,65,70,60,65,65,115,440,0.8583333333333333,1.0
80,92,65,65,80,68,450,0.4824561403508772,60,85,60,85,60,55,405,0.3673469387755102,2.0
60,50,50,60,70,50,340,0.28346456692913385,85,110,76,65,82,56,474,0.3933333333333333,0.25
100,120,100,150,120,90,680,0.728,90,95,95,70,90,70,510,0.5230769230769231,0.5
90,60,60,40,40,40,330,0.29545454545454547,100,77,77,128,128,90,600,0.6901408450704225,1.0
80,105,65,60,75,130,515,0.9645390070921985,70,120,40,95,40,95,460,0.8106060606060606,1.0
62,48,66,59,57,49,341,0.33884297520661155,55,55,45,63,45,45,308,0.25,1.0
65,73,55,47,75,85,400,0.6846846846846847,60,50,100,85,70,65,430,0.47580645161290325,0.5
45,50,55,75,65,30,320,0.06293706293706294,60,70,105,70,120,75,500,0.5983606557377049,1.0
55,69,85,32,35,28,304,0.09302325581395349,73,76,75,81,100,100,505,0.8110236220472441,0.5
75,65,55,65,55,69,384,0.43548387096774194,84,71,43,71,43,48,360,0.25874125874125875,1.0
90,70,80,70,95,70,475,0.5190839694656488,80,160,60,170,130,80,680,0.6180555555555556,1.0
60,85,40,30,45,68,328,0.6422018348623854,78,130,111,130,85,100,634,0.8561151079136691,2.0
123,100,62,97,81,68,531,0.4806201550387597,70,110,75,145,85,145,630,0.9444444444444444,0.25
62,48,66,59,57,49,341,0.33884297520661155,50,100,150,100,150,50,600,0.37142857142857144,1.0
76,25,45,67,55,24,292,0.0390625,50,85,55,65,65,90,410,0.7478260869565218,1.0
55,47,52,40,40,41,275,0.16806722689075632,75,103,80,70,80,92,500,0.7933884297520661,2.0
75,80,85,110,90,50,490,0.3548387096774194,35,80,50,50,70,120,405,0.84375,1.0
60,75,85,100,85,115,520,0.8992248062015504,70,75,80,135,80,135,575,0.917910447761194,1.0
40,27,60,37,50,66,280,0.36220472440944884,44,50,91,24,86,10,305,0.1981981981981982,0.125
78,52,60,63,65,23,341,0.06015037593984962,50,50,95,40,50,35,320,0.20279720279720279,1.0
95,65,65,110,130,60,525,0.4016393442622951,50,30,55,65,55,20,275,0.13675213675213677,0.5
45,35,50,70,50,30,280,0.15753424657534246,45,53,70,40,60,42,310,0.25735294117647056,0.25
75,80,70,65,75,90,455,0.7578125,50,150,50,150,50,150,600,0.9339622641509434,1.0
30,30,30,30,30,30,180,0.12612612612612611,105,105,75,65,100,50,500,0.37593984962406013,0.5
80,160,60,170,130,80,680,0.6180555555555556,100,73,83,73,83,55,467,0.371900826446281,2.0
70,60,62,80,82,60,414,0.4375,95,75,180,130,80,30,590,0.13793103448275862,2.0
95,95,85,125,65,55,520,0.3894736842105263,55,112,45,74,45,70,401,0.559322033898305,1.0
66,65,48,62,57,52,350,0.36220472440944884,105,130,120,45,45,40,485,0.4444444444444444,4.0
45,60,40,70,50,45,310,0.2846715328467153,76,147,90,60,70,97,540,0.8267716535433071,0.5
65,155,120,65,90,105,600,0.8677685950413223,77,59,50,67,63,46,362,0.23140495867768596,0.5
50,65,107,105,107,86,520,0.7313432835820896,95,117,184,44,46,28,514,0.2975206611570248,1.0
100,50,80,60,80,50,420,0.34375,67,58,57,81,67,101,431,0.8790322580645161,1.0
40,45,65,100,120,90,460,0.5588235294117647,58,64,58,80,65,80,405,0.609271523178808,0.5
60,60,60,105,105,105,495,0.848,65,150,40,15,80,145,495,0.9663865546218487,1.0
135,85,40,40,85,5,390,0.6864406779661016,74,48,76,83,81,104,466,0.7322834645669292,1.0
100,100,100,100,100,100,600,0.8758169934640523,40,55,99,40,79,47,360,0.26262626262626265,2.0
65,50,70,95,80,65,425,0.4262295081967213,51,65,65,80,75,59,395,0.4365079365079365,1.0
31,45,90,30,30,40,266,0.21929824561403508,80,125,75,40,95,85,500,0.6911764705882353,0.25
60,55,90,145,90,80,520,0.6071428571428571,66,65,48,62,57,52,350,0.36220472440944884,2.0
150,160,100,95,65,100,670,0.8866666666666667,35,65,35,65,35,65,300,0.46621621621621623,1.0
70,55,75,45,65,60,370,0.45901639344262296,65,80,140,40,70,70,465,0.5223880597014925,0.5
85,105,55,85,50,115,495,0.9032258064516129,65,70,60,65,65,115,440,0.8583333333333333,1.0
60,130,80,60,60,70,460,0.5153846153846153,44,38,39,61,79,42,303,0.2251655629139073,0.5
75,125,75,30,75,85,465,0.625,45,60,30,80,50,65,330,0.4603174603174603,2.0
90,92,75,92,85,60,494,0.49586776859504134,63,120,85,90,55,55,468,0.2809917355371901,1.0
60,85,69,65,79,80,438,0.576,90,85,100,95,125,85,580,0.6834532374100719,1.0
50,60,60,60,60,30,320,0.11290322580645161,110,80,90,95,90,65,530,0.5033557046979866,0.5
57,80,91,80,87,75,470,0.5737704918032787,80,85,95,30,30,25,345,0.2857142857142857,2.0
65,100,70,80,80,105,500,0.8666666666666667,90,120,75,60,60,45,450,0.29411764705882354,1.0
45,50,55,75,65,30,320,0.06293706293706294,60,100,115,70,85,90,520,0.7557251908396947,0.0
60,80,50,50,50,40,330,0.23853211009174313,75,125,75,30,75,85,465,0.625,1.0
40,30,35,45,40,55,245,0.31496062992125984,35,35,40,35,55,50,250,0.40336134453781514,2.0
70,145,88,140,70,112,625,0.8888888888888888,55,75,50,40,40,80,340,0.6302521008403361,1.0
38,30,41,30,41,60,240,0.2897196261682243,70,85,65,105,85,120,530,0.9262295081967213,1.0
95,60,79,100,125,81,540,0.6201550387596899,80,95,82,60,82,75,474,0.6,1.0
75,95,60,65,60,115,470,0.8778625954198473,65,150,60,115,60,115,565,0.935251798561151,1.0
65,95,75,55,55,85,430,0.6933333333333334,105,150,90,150,90,95,680,0.8285714285714286,0.5
70,140,230,60,80,50,630,0.32432432432432434,50,70,100,40,40,30,330,0.2222222222222222,1.0
42,52,67,39,56,50,306,0.2868217054263566,70,70,40,60,40,60,340,0.4247787610619469,0.5
105,125,100,60,100,100,590,0.8359375,70,135,105,60,105,20,495,0.5806451612903226,0.5
60,62,80,63,80,60,405,0.4336283185840708,80,85,95,30,30,25,345,0.2857142857142857,4.0
90,120,120,60,60,50,500,0.35294117647058826,40,20,30,40,80,55,265,0.22764227642276422,0.0
60,30,30,36,56,50,262,0.32432432432432434,65,90,115,45,115,58,488,0.5041322314049587,2.0
70,115,60,115,60,55,475,0.4647887323943662,60,25,35,70,80,60,330,0.3076923076923077,2.0
60,50,70,50,90,65,385,0.39568345323741005,65,125,60,95,60,105,510,0.9236641221374046,0.5
68,65,65,125,115,80,518,0.6461538461538462,90,60,70,75,70,45,410,0.23880597014925373,1.0
40,35,30,20,20,50,195,0.23423423423423423,70,70,115,130,90,60,535,0.5338983050847458,0.0
30,30,30,30,30,30,180,0.12612612612612611,45,30,40,105,50,20,290,0.031007751937984496,1.0
40,55,30,30,30,85,270,0.688,55,84,105,114,75,52,485,0.2890625,1.0
80,70,65,80,120,100,515,0.8034188034188035,65,90,40,45,80,75,395,0.625,0.5
60,45,70,45,90,95,405,0.7304964539007093,50,150,50,150,50,150,600,0.9339622641509434,1.0
40,40,55,40,70,55,300,0.40939597315436244,78,65,68,112,154,75,552,0.628099173553719,1.0
55,50,40,40,40,75,300,0.5945945945945946,66,41,77,61,87,23,355,0.12096774193548387,0.5
90,100,90,125,85,90,580,0.7352941176470589,110,135,60,50,65,88,508,0.7744360902255639,1.0
165,75,80,40,45,65,470,0.5151515151515151,70,75,60,105,60,105,475,0.88,1.0
65,75,70,95,70,95,470,0.7272727272727273,40,65,40,80,40,65,330,0.5038167938931297,0.0
84,86,88,111,101,60,530,0.4634146341463415,70,130,100,55,80,65,500,0.608,0.5
25,35,70,95,55,45,325,0.16783216783216784,70,140,230,60,80,50,630,0.32432432432432434,0.5
79,105,70,145,80,101,580,0.8608695652173913,73,100,60,100,60,65,458,0.42657342657342656,1.0
53,54,53,37,46,45,288,0.3090909090909091,45,65,34,40,34,45,263,0.2589928057553957,1.0
105,30,105,140,105,55,540,0.3524590163934426,35,64,85,74,55,32,345,0.19827586206896552,0.5
40,50,90,30,55,65,330,0.44680851063829785,46,87,60,30,40,57,320,0.37777777777777777,1.0
50,105,79,35,110,76,455,0.6214285714285714,64,88,50,88,50,106,446,0.9111111111111111,2.0
75,80,60,65,90,102,472,0.8625954198473282,108,170,115,120,95,92,700,0.7083333333333334,1.0
95,95,85,125,65,55,520,0.3894736842105263,72,58,80,103,80,97,490,0.7171052631578947,0.25
61,90,45,50,50,160,456,0.9230769230769231,95,75,180,130,80,30,590,0.13793103448275862,2.0
60,25,35,70,80,60,330,0.3076923076923077,110,135,60,50,65,88,508,0.7744360902255639,1.0
83,106,65,86,65,85,490,0.6640625,30,80,90,55,45,55,355,0.4295774647887324,1.0
45,25,50,25,25,35,205,0.13076923076923078,54,66,70,44,55,46,335,0.4214876033057851,1.0
60,52,168,47,138,30,495,0.19834710743801653,80,70,70,90,100,70,480,0.5609756097560976,0.5
45,60,45,25,45,55,275,0.29,40,80,35,35,45,70,305,0.4661016949152542,1.0
78,81,71,74,69,126,499,0.9090909090909091,45,60,32,50,32,76,295,0.5925925925925926,0.5
70,75,80,135,80,135,575,0.917910447761194,110,78,73,76,71,60,468,0.3333333333333333,0.0
50,85,125,85,115,20,480,0.4306569343065693,70,80,70,80,70,110,480,0.6594202898550725,4.0
63,63,47,41,41,74,329,0.56,50,95,95,35,110,70,455,0.5179856115107914,0.5
100,123,75,57,75,80,510,0.6923076923076923,116,55,85,107,95,29,487,0.06818181818181818,1.0
30,40,55,40,55,60,280,0.3237410071942446,45,30,50,65,50,45,285,0.13821138211382114,0.25
65,125,100,55,70,85,500,0.6532258064516129,170,90,45,90,45,60,500,0.427536231884058,1.0
40,45,35,30,40,55,245,0.3793103448275862,125,130,90,130,90,95,660,0.7734375,1.0
50,95,180,85,45,70,525,0.5298507462686567,58,109,112,48,48,109,484,0.8805970149253731,0.5
50,50,150,50,150,50,500,0.2571428571428571,91,72,90,129,90,108,580,0.8925619834710744,1.0
30,45,135,45,90,30,375,0.09285714285714286,105,150,90,150,90,95,680,0.8285714285714286,2.0
65,73,55,47,75,85,400,0.6846846846846847,50,75,70,35,70,48,348,0.29357798165137616,1.0
65,60,110,130,95,65,525,0.47761194029850745,60,69,95,69,95,36,424,0.2608695652173913,0.5
70,90,110,60,75,95,500,0.7333333333333333,65,50,70,95,80,65,425,0.4262295081967213,2.0
85,100,122,58,75,54,494,0.3939393939393939,48,72,48,72,48,48,336,0.25984251968503935,2.0
150,80,44,90,54,80,498,0.625,40,60,30,31,31,70,262,0.4492753623188406,0.0
53,51,53,61,56,40,314,0.14285714285714285,53,54,53,37,46,45,288,0.3090909090909091,1.0
36,50,50,65,60,44,305,0.16363636363636364,70,85,140,85,70,20,470,0.272,0.5
45,65,34,40,34,45,263,0.2589928057553957,58,109,112,48,48,109,484,0.8805970149253731,1.0
60,55,50,40,55,45,305,0.22377622377622378,65,80,140,40,70,70,465,0.5223880597014925,0.0
50,35,55,25,25,15,205,0.05263157894736842,65,125,60,95,60,105,510,0.9236641221374046,0.5
54,66,70,44,55,46,335,0.4214876033057851,80,90,80,130,110,110,600,0.856,1.0
64,165,75,93,83,75,555,0.6587301587301587,55,70,45,70,50,60,350,0.45,1.0
67,125,40,30,30,58,350,0.3431372549019608,78,81,71,74,69,126,499,0.9090909090909091,4.0
67,89,116,79,116,33,500,0.2624113475177305,80,82,83,100,100,80,525,0.6742424242424242,2.0
60,80,95,70,85,50,440,0.2231404958677686,50,105,125,55,95,50,480,0.375886524822695,0.25
31,45,90,30,30,40,266,0.21929824561403508,83,80,80,135,80,121,579,0.9444444444444444,0.0
50,40,85,40,65,25,305,0.08870967741935484,40,45,40,65,40,65,295,0.5661764705882353,1.0
75,69,72,114,100,104,534,0.8253968253968254,120,100,85,30,85,45,465,0.22448979591836735,1.0
111,83,68,92,82,39,475,0.1774193548387097,106,150,70,194,120,140,780,0.952,1.0
70,85,70,60,70,50,405,0.28378378378378377,60,65,60,130,75,110,500,0.7719298245614035,2.0
70,90,90,135,90,125,600,0.9401709401709402,60,95,80,60,80,30,405,0.19480519480519481,1.0
55,65,95,95,45,85,440,0.6610169491525424,80,70,40,100,60,145,495,0.921875,1.0
90,90,85,125,90,100,580,0.768595041322314,106,150,70,194,120,140,780,0.952,1.0
85,50,95,120,115,80,545,0.5793650793650794,40,65,40,80,40,65,330,0.5038167938931297,2.0
50,50,40,30,30,50,250,0.2781954887218045,80,100,70,50,60,45,405,0.25806451612903225,1.0
70,40,50,55,50,25,290,0.061068702290076333,64,88,50,88,50,106,446,0.9111111111111111,1.0
65,95,100,60,50,50,420,0.34959349593495936,70,105,105,50,40,20,390,0.33587786259541985,1.0
75,100,63,80,63,116,497,0.9345794392523364,40,70,40,35,40,60,285,0.392,1.0
65,83,57,95,85,105,490,0.8914728682170543,65,85,70,75,70,40,405,0.203125,0.5
85,60,65,135,105,100,550,0.7518248175182481,75,80,70,65,75,90,455,0.7578125,0.25
62,73,55,56,52,84,382,0.7244094488188977,40,27,60,37,50,66,280,0.36220472440944884,4.0
45,65,34,40,34,45,263,0.2589928057553957,55,50,45,135,95,120,500,0.7714285714285715,1.0
110,85,95,80,95,50,515,0.2713178294573643,77,120,90,60,90,48,485,0.2785714285714286,1.0
70,90,110,60,75,95,500,0.7333333333333333,70,85,65,105,85,120,530,0.9262295081967213,2.0
35,45,160,30,45,70,385,0.48148148148148145,64,165,75,93,83,75,555,0.6587301587301587,1.0
83,80,80,135,80,121,579,0.9444444444444444,58,64,58,80,65,80,405,0.609271523178808,1.0
68,65,65,125,115,80,518,0.6461538461538462,60,50,70,80,80,140,480,0.8449612403100775,1.0
90,100,60,90,60,80,480,0.6422764227642277,100,100,80,60,60,50,450,0.3050847457627119,2.0
114,85,70,85,80,30,464,0.2066115702479339,70,120,40,95,40,95,460,0.8106060606060606,2.0
72,85,70,65,70,58,420,0.41304347826086957,79,100,80,110,90,121,580,0.968,1.0
90,85,100,95,125,85,580,0.6834532374100719,78,52,60,63,65,23,341,0.06015037593984962,1.0
45,50,55,75,65,30,320,0.06293706293706294,73,115,60,60,60,90,458,0.6694915254237288,1.0
55,70,40,60,40,40,305,0.26956521739130435,86,92,88,68,75,73,482,0.6835443037974683,1.0
50,47,50,57,50,65,319,0.463768115942029,80,120,79,95,79,70,523,0.5833333333333334,0.5
61,78,95,56,58,57,405,0.40336134453781514,95,109,105,75,85,56,525,0.34513274336283184,1.0
50,95,180,85,45,70,525,0.5298507462686567,75,100,95,40,70,110,490,0.8717948717948718,1.0
35,55,40,45,40,60,275,0.35714285714285715,72,58,80,103,80,97,490,0.7171052631578947,2.0
100,70,70,65,65,45,415,0.1897810218978102,104,91,63,91,73,68,490,0.5118110236220472,1.0
50,70,100,40,40,30,330,0.2222222222222222,70,65,60,90,75,90,450,0.6571428571428571,2.0
50,60,60,60,60,30,320,0.11290322580645161,40,20,30,40,80,55,265,0.22764227642276422,1.0
60,80,50,50,50,40,330,0.23853211009174313,65,95,75,55,55,85,430,0.6933333333333334,1.0
90,60,60,40,40,40,330,0.29545454545454547,78,65,68,112,154,75,552,0.628099173553719,1.0
108,100,121,81,95,95,600,0.7476635514018691,65,125,100,60,70,70,490,0.6099290780141844,1.0
45,30,50,65,50,45,285,0.13821138211382114,91,90,72,90,129,108,580,0.896,1.0
60,67,85,77,75,116,480,0.8888888888888888,43,70,48,50,60,38,309,0.2391304347826087,0.5
50,45,45,35,35,50,260,0.23529411764705882,65,45,55,45,70,45,325,0.24369747899159663,1.0
30,65,100,45,25,40,305,0.1891891891891892,70,135,105,60,105,20,495,0.5806451612903226,1.0
75,125,230,55,95,30,610,0.3448275862068966,60,40,50,75,85,95,405,0.6044776119402985,1.0
75,80,60,65,90,102,472,0.8625954198473282,40,30,30,55,30,85,270,0.4666666666666667,1.0
55,130,115,50,50,75,475,0.5982142857142857,116,55,85,107,95,29,487,0.06818181818181818,1.0
72,60,30,20,30,25,237,0.11570247933884298,55,130,115,50,50,75,475,0.5982142857142857,1.0
40,35,30,120,70,105,400,0.6692307692307692,50,35,55,25,25,15,205,0.05263157894736842,1.0
37,25,41,25,41,25,194,0.08870967741935484,43,80,65,50,35,35,308,0.14193548387096774,1.0
40,30,35,50,70,55,280,0.28205128205128205,85,76,64,45,55,90,415,0.6739130434782609,1.0
60,85,60,50,50,125,430,0.9090909090909091,40,60,40,40,40,30,250,0.0948905109489051,2.0
50,160,110,160,110,110,700,0.8854961832061069,70,60,125,115,70,55,495,0.35507246376811596,1.0
70,55,95,95,110,65,490,0.48872180451127817,60,82,45,45,45,74,351,0.5752212389380531,0.0
50,20,40,20,40,20,190,0.0962962962962963,60,65,60,130,75,110,500,0.7719298245614035,0.0
40,45,35,30,40,55,245,0.3793103448275862,60,25,35,70,80,60,330,0.3076923076923077,1.0
86,81,97,81,107,43,495,0.203125,70,94,50,94,50,66,424,0.48148148148148145,1.0
78,92,75,74,63,118,500,0.8842975206611571,70,60,62,80,82,60,414,0.4375,0.5
43,80,65,50,35,35,308,0.14193548387096774,20,10,55,15,20,80,200,0.17985611510791366,0.5
60,55,90,145,90,80,520,0.6071428571428571,65,110,130,60,65,95,525,0.8278145695364238,2.0
60,70,50,100,50,65,395,0.5217391304347826,20,40,90,30,90,25,295,0.11363636363636363,0.5
95,110,80,70,80,50,485,0.37209302325581395,50,65,45,85,65,95,405,0.7238095238095238,2.0
90,30,15,40,20,15,210,0.043478260869565216,45,45,35,20,30,20,195,0.07246376811594203,1.0
60,30,30,36,56,50,262,0.32432432432432434,41,56,40,62,44,71,314,0.568,1.0
80,70,70,90,100,70,480,0.5609756097560976,40,55,30,30,30,60,245,0.43548387096774194,0.5
130,70,35,70,35,60,400,0.4017857142857143,80,75,150,75,150,50,580,0.30973451327433627,1.0
135,85,40,40,85,5,390,0.6864406779661016,50,35,55,25,25,15,205,0.05263157894736842,1.0
80,45,65,90,110,80,470,0.5462962962962963,67,125,40,30,30,58,350,0.3431372549019608,1.0
38,41,40,50,65,65,299,0.4108527131782946,60,85,60,50,50,125,430,0.9090909090909091,1.0
37,25,41,25,41,25,194,0.08870967741935484,60,85,60,85,60,55,405,0.3673469387755102,0.25
60,48,45,43,90,42,328,0.21897810218978103,70,77,60,97,60,108,472,0.8394160583941606,1.0
190,33,58,33,58,33,405,0.13432835820895522,50,48,43,46,41,60,288,0.47297297297297297,2.0
75,123,67,95,85,95,540,0.7642276422764228,30,56,35,25,35,72,253,0.48148148148148145,1.0
70,130,100,55,80,65,500,0.608,80,120,130,55,65,45,495,0.37037037037037035,2.0
60,50,70,50,90,65,385,0.39568345323741005,45,40,60,40,75,50,310,0.2926829268292683,0.5
40,45,35,65,55,70,310,0.4482758620689655,72,95,67,103,71,122,530,0.9606299212598425,2.0
70,55,65,95,85,70,440,0.5307692307692308,108,130,95,80,85,102,600,0.7637795275590551,1.0
85,80,70,135,75,90,535,0.7006802721088435,125,120,90,170,100,95,700,0.78125,1.0
80,110,120,130,90,70,600,0.6198347107438017,80,120,79,95,79,70,523,0.5833333333333334,1.0
75,75,95,75,95,113,528,0.9015151515151515,100,70,70,65,65,45,415,0.1897810218978102,1.0
85,105,100,79,83,78,530,0.5869565217391305,79,103,120,135,115,78,630,0.5763888888888888,0.5
50,95,95,35,110,70,455,0.5179856115107914,70,40,50,55,50,25,290,0.061068702290076333,2.0
62,50,58,73,54,72,369,0.4435483870967742,80,82,100,83,100,80,525,0.6821705426356589,2.0
106,150,70,194,120,140,780,0.952,70,90,45,15,45,50,315,0.3629032258064516,1.0
70,75,60,105,60,105,475,0.88,60,45,70,45,90,95,405,0.7304964539007093,0.5
65,136,94,54,96,135,580,0.9612403100775194,25,35,70,95,55,45,325,0.16783216783216784,1.0
20,15,20,10,55,80,200,0.2682926829268293,50,65,107,105,107,86,520,0.7272727272727273,1.0
45,85,50,55,50,65,350,0.5076923076923077,100,100,100,100,100,100,600,0.8345864661654135,0.5
115,115,85,90,75,100,580,0.8134328358208955,70,85,65,105,85,120,530,0.9262295081967213,2.0
70,110,80,55,80,105,500,0.8794326241134752,75,98,63,98,63,101,498,0.849624060150376,1.0
35,20,65,40,65,20,245,0.02459016393442623,50,75,45,40,45,60,315,0.4380165289256198,1.0
35,46,34,35,45,20,215,0.072,79,85,60,55,60,71,410,0.60431654676259,1.0
35,40,100,90,55,35,355,0.1796875,40,65,95,60,45,35,340,0.13986013986013987,1.0
70,70,115,130,90,60,535,0.5338983050847458,46,57,40,40,40,50,273,0.25,1.0
95,70,73,95,90,60,483,0.3983739837398374,75,89,85,55,65,36,405,0.29545454545454547,1.0
75,125,75,30,75,85,465,0.625,70,80,102,80,102,40,474,0.2677165354330709,0.25
60,130,80,60,60,70,460,0.5153846153846153,76,65,45,92,42,91,411,0.7449664429530202,0.5
95,85,85,65,65,35,430,0.2571428571428571,70,120,65,45,85,125,510,0.9747899159663865,1.0
40,30,32,50,52,65,269,0.3671875,70,40,50,55,50,25,290,0.061068702290076333,0.5
40,45,35,40,40,90,290,0.65,110,123,65,100,65,65,528,0.5217391304347826,1.0
64,165,75,93,83,75,555,0.6587301587301587,65,136,94,54,96,135,580,0.9612403100775194,0.0
80,82,83,100,100,80,525,0.6742424242424242,40,65,40,80,40,65,330,0.5038167938931297,1.0
50,72,35,35,35,65,292,0.5373134328358209,70,70,115,130,90,60,535,0.5338983050847458,4.0
40,45,35,65,55,70,310,0.4482758620689655,95,75,80,100,110,30,490,0.24242424242424243,2.0
40,30,35,45,40,55,245,0.31496062992125984,66,117,70,40,50,67,410,0.4573643410852713,2.0
85,76,64,45,55,90,415,0.6739130434782609,65,65,60,110,95,130,525,0.9253731343283582,1.0
92,105,90,125,90,98,600,0.8217054263565892,90,120,100,150,120,100,680,0.7718120805369127,2.0
60,45,70,75,85,55,390,0.3008130081300813,55,55,45,63,45,45,308,0.25,1.0
90,92,75,92,85,60,494,0.49586776859504134,90,110,80,100,80,95,555,0.7982456140350878,0.25
54,45,47,75,98,52,371,0.39669421487603307,80,80,80,80,80,80,480,0.5606060606060606,1.0
65,95,100,60,50,50,420,0.34959349593495936,78,81,71,74,69,126,499,0.9090909090909091,1.0
80,160,80,130,80,100,630,0.8455284552845529,45,49,49,65,65,45,318,0.2781954887218045,1.0
79,85,60,55,60,71,410,0.60431654676259,88,107,122,74,75,64,530,0.4596774193548387,0.5
43,80,65,50,35,35,308,0.14193548387096774,100,100,80,60,60,50,450,0.3050847457627119,2.0
20,25,45,70,90,60,310,0.30833333333333335,74,94,131,54,116,20,489,0.4485294117647059,0.25
80,105,65,60,75,130,515,0.9645390070921985,59,74,50,35,50,35,303,0.3125,0.5
105,125,100,60,100,100,590,0.8359375,44,48,65,50,64,43,314,0.1623931623931624,1.0
65,90,50,85,45,55,390,0.371900826446281,70,94,50,94,50,66,424,0.48148148148148145,0.25
72,85,70,65,70,58,420,0.41304347826086957,70,80,102,80,102,40,474,0.2677165354330709,1.0
40,45,35,65,55,70,310,0.4482758620689655,105,105,75,65,100,50,500,0.37593984962406013,0.5
20,10,230,10,230,5,505,0.0,64,51,23,51,23,28,240,0.11363636363636363,1.0
70,20,50,20,50,40,250,0.1557377049180328,75,95,122,58,75,69,494,0.5725806451612904,0.5
50,35,55,25,25,15,205,0.05263157894736842,76,25,45,67,55,24,292,0.0390625,2.0
110,65,105,55,95,80,510,0.6258503401360545,55,63,90,50,80,42,380,0.21138211382113822,4.0
75,38,38,56,56,67,330,0.5263157894736842,60,60,60,85,85,85,435,0.631578947368421,1.0
38,30,85,55,65,30,303,0.21428571428571427,50,120,53,35,110,87,455,0.640625,1.0
60,60,60,85,85,85,435,0.631578947368421,90,85,100,95,125,85,580,0.6834532374100719,1.0
80,160,60,170,130,80,680,0.6180555555555556,45,30,50,65,50,45,285,0.13821138211382114,1.0
40,65,40,80,40,65,330,0.5038167938931297,55,95,115,45,45,35,390,0.2116788321167883,1.0
30,45,135,45,90,30,375,0.09285714285714286,68,65,65,125,115,80,518,0.6461538461538462,1.0
74,48,76,83,81,104,466,0.7322834645669292,95,125,79,60,100,81,540,0.6165413533834586,1.0
75,75,75,125,95,40,485,0.15671641791044777,110,85,95,80,95,50,515,0.2713178294573643,1.0
101,72,72,99,89,29,462,0.1937984496124031,50,50,62,40,62,65,329,0.4188034188034188,0.5
75,80,95,90,100,50,490,0.2158273381294964,50,25,28,45,55,15,218,0.0625,1.0
100,150,110,95,110,70,635,0.5923076923076923,67,57,55,77,55,114,425,0.8879310344827587,0.0
90,100,60,90,60,80,480,0.6422764227642277,75,125,75,30,75,85,465,0.625,0.5
50,95,90,95,90,180,600,0.9172413793103448,60,85,60,85,60,55,405,0.3673469387755102,1.0
63,60,55,50,50,71,349,0.5289256198347108,75,95,60,65,60,115,470,0.8778625954198473,1.0
45,60,30,80,50,65,330,0.4603174603174603,55,69,85,32,35,28,304,0.09302325581395349,2.0
55,20,35,20,45,75,250,0.37681159420289856,44,75,35,63,33,45,295,0.2647058823529412,0.0
126,131,95,131,98,99,680,0.8294573643410853,55,50,40,40,40,75,300,0.5945945945945946,1.0
80,120,130,55,65,45,495,0.37037037037037035,43,70,48,50,60,38,309,0.2391304347826087,0.5
105,140,95,55,65,45,505,0.3,56,61,65,48,45,38,313,0.17567567567567569,1.0
58,89,77,45,45,48,362,0.3177570093457944,40,40,35,50,100,70,335,0.5031847133757962,1.0
70,135,105,60,105,20,495,0.5806451612903226,38,30,85,55,65,30,303,0.21428571428571427,0.5
50,70,50,50,50,70,340,0.5645161290322581,20,15,20,10,55,80,200,0.2682926829268293,1.0
50,50,40,50,40,64,294,0.45588235294117646,50,85,85,55,55,50,380,0.3902439024390244,1.0
70,55,95,95,110,65,490,0.48872180451127817,30,80,90,55,45,55,355,0.4295774647887324,1.0
50,105,125,55,95,50,480,0.375886524822695,60,52,168,47,138,30,495,0.19834710743801653,0.5
60,55,90,145,90,80,520,0.6071428571428571,91,129,90,72,90,108,580,0.8536585365853658,0.5
50,53,62,58,63,44,330,0.13709677419354838,80,100,70,50,60,45,405,0.25806451612903225,1.0
60,90,140,50,50,40,430,0.2535211267605634,83,80,75,70,70,101,479,0.8615384615384616,2.0
100,150,120,120,100,90,680,0.6493506493506493,90,70,80,70,95,70,475,0.5190839694656488,2.0
20,15,20,10,55,80,200,0.2682926829268293,80,110,120,130,90,70,600,0.6198347107438017,1.0
65,50,70,95,80,65,425,0.4262295081967213,74,94,131,54,116,20,489,0.4485294117647059,0.5
103,93,67,71,61,84,479,0.7142857142857143,50,50,50,50,50,50,300,0.30708661417322836,1.0
45,63,37,65,55,95,360,0.8055555555555556,80,100,70,60,70,95,475,0.7416666666666667,0.5
65,75,105,35,65,85,430,0.6940298507462687,60,100,89,55,69,112,485,0.9298245614035088,2.0
80,110,120,130,90,70,600,0.6198347107438017,40,45,65,100,120,90,460,0.5588235294117647,1.0
50,92,108,92,108,35,485,0.2457627118644068,90,130,80,65,85,55,505,0.4396551724137931,0.5
43,70,48,50,60,38,309,0.2391304347826087,75,98,63,98,63,101,498,0.889763779527559,0.5
52,65,50,45,50,38,300,0.27419354838709675,91,90,129,90,72,108,580,0.9140625,0.25
70,135,105,60,105,20,495,0.5806451612903226,60,90,70,60,120,40,440,0.27419354838709675,1.0
70,65,65,55,55,70,380,0.5,45,30,40,105,50,20,290,0.031007751937984496,1.0
100,150,90,180,160,90,770,0.7348484848484849,110,123,65,100,65,65,528,0.5217391304347826,2.0
70,140,70,110,65,105,560,0.95,89,145,90,105,80,91,600,0.8549618320610687,2.0
75,55,70,55,95,110,460,0.8444444444444444,55,40,40,65,45,35,280,0.16428571428571428,0.5
80,95,82,60,82,75,474,0.6,58,64,58,80,65,80,405,0.609271523178808,1.0
45,50,45,115,55,95,405,0.6936936936936937,75,70,90,70,105,80,490,0.656,1.0
45,100,45,45,45,10,290,0.2949640287769784,55,75,60,75,60,103,428,0.7982456140350878,0.0
76,65,45,92,42,91,411,0.7449664429530202,65,65,60,110,95,130,525,0.9253731343283582,0.5
65,40,50,125,60,30,370,0.07258064516129033,70,85,70,60,70,50,405,0.28378378378378377,2.0
115,45,20,45,25,20,270,0.11538461538461539,51,65,65,80,75,59,395,0.4365079365079365,1.0
35,64,85,74,55,32,345,0.19827586206896552,40,35,30,120,70,105,400,0.6692307692307692,1.0
72,85,70,65,70,58,420,0.41304347826086957,60,50,40,85,75,95,405,0.7540983606557377,1.0
123,77,72,99,92,58,521,0.4621212121212121,65,83,57,95,85,105,490,0.8914728682170543,1.0
64,66,68,81,76,50,405,0.25190839694656486,40,45,40,62,60,60,307,0.33884297520661155,2.0
67,82,62,46,48,43,348,0.22033898305084745,70,77,60,97,60,108,472,0.8394160583941606,0.5
45,30,40,105,50,20,290,0.031007751937984496,65,60,110,130,95,65,525,0.47761194029850745,1.0
100,134,110,95,100,61,600,0.4057971014492754,65,125,100,55,70,85,500,0.6532258064516129,2.0
75,98,63,98,63,101,498,0.8091603053435115,65,125,100,60,70,70,490,0.6099290780141844,0.5
85,80,90,105,95,60,515,0.49074074074074076,50,75,75,65,65,50,380,0.4049586776859504,0.0
45,30,35,20,20,45,195,0.14782608695652175,60,65,80,170,95,130,600,0.8625954198473282,0.25
60,60,40,65,45,35,305,0.15833333333333333,65,125,100,55,70,85,500,0.6532258064516129,1.0
60,30,30,36,56,50,262,0.32432432432432434,55,65,95,95,45,85,440,0.6610169491525424,1.0
80,100,70,50,60,45,405,0.25806451612903225,68,90,65,50,55,82,410,0.6165413533834586,1.0
35,80,50,50,70,120,405,0.84375,75,80,60,65,90,102,472,0.8625954198473282,1.0
80,145,150,105,110,110,700,0.8692307692307693,60,60,60,60,60,60,360,0.38095238095238093,1.0
80,70,40,100,60,145,495,0.921875,100,100,100,100,100,100,600,0.831858407079646,2.0
50,70,50,50,50,40,310,0.16296296296296298,65,110,130,60,65,95,525,0.8278145695364238,0.5
62,44,50,44,50,55,305,0.3629032258064516,90,65,65,40,40,15,315,0.19672131147540983,0.5
45,45,35,20,30,20,195,0.07246376811594203,53,51,53,61,56,40,314,0.14285714285714285,1.0
45,65,34,40,34,45,263,0.2589928057553957,58,89,77,45,45,48,362,0.3177570093457944,0.5
100,100,100,100,100,100,600,0.8602941176470589,76,65,45,92,42,91,411,0.7449664429530202,0.5
100,180,160,150,90,90,770,0.7520661157024794,40,30,32,50,52,65,269,0.3671875,0.5
70,115,60,115,60,55,475,0.4647887323943662,70,90,70,60,60,70,420,0.6390977443609023,0.5
40,30,30,55,30,85,270,0.4666666666666667,45,53,70,40,60,42,310,0.25735294117647056,2.0
50,60,60,60,60,30,320,0.11290322580645161,60,69,95,69,95,36,424,0.2608695652173913,0.0
65,40,70,80,140,70,465,0.5954198473282443,50,75,35,70,30,40,300,0.21296296296296297,1.0
74,108,133,83,65,32,495,0.32142857142857145,45,75,60,40,30,50,300,0.304,0.5
85,97,66,105,66,65,484,0.47107438016528924,110,80,90,95,90,65,530,0.5033557046979866,1.0
75,90,50,110,80,95,500,0.7985611510791367,70,62,67,55,55,56,365,0.38513513513513514,1.0
79,115,70,125,80,111,580,0.8468468468468469,61,90,45,50,50,160,456,0.9230769230769231,2.0
35,55,40,45,40,60,275,0.35714285714285715,85,105,85,40,50,40,405,0.211864406779661,1.0
78,130,111,130,85,100,634,0.8561151079136691,30,56,35,25,35,72,253,0.48148148148148145,1.0
70,120,65,45,85,125,510,0.9747899159663865,45,30,35,20,20,45,195,0.14782608695652175,1.0
60,85,60,85,60,55,405,0.3673469387755102,115,115,85,90,75,100,580,0.8134328358208955,0.5
35,70,55,45,55,25,285,0.09420289855072464,85,70,80,97,80,123,535,0.9304347826086956,0.125
40,55,30,30,30,60,245,0.43548387096774194,60,130,80,60,60,70,460,0.5153846153846153,4.0
38,35,40,27,25,35,200,0.08208955223880597,59,74,50,35,50,35,303,0.3125,0.5
70,60,62,80,82,60,414,0.4375,150,160,100,95,65,100,670,0.8866666666666667,1.0
85,80,70,135,75,90,535,0.7006802721088435,40,30,50,55,55,100,330,0.584070796460177,1.0
58,70,45,40,45,42,300,0.25925925925925924,90,60,60,40,40,40,330,0.29545454545454547,1.0
55,45,45,25,25,15,210,0.048,115,140,130,55,55,40,535,0.4519230769230769,8.0
86,81,97,81,107,43,495,0.203125,70,100,115,30,65,30,410,0.24390243902439024,2.0
80,100,80,80,80,100,520,0.9051724137931034,60,82,45,45,45,74,351,0.5752212389380531,1.0
60,60,60,85,85,85,435,0.631578947368421,60,85,69,65,79,80,438,0.576,1.0
60,65,80,170,95,130,600,0.8625954198473282,95,65,65,110,130,60,525,0.4016393442622951,2.0
45,80,100,35,37,28,325,0.3125,40,40,35,50,100,70,335,0.5031847133757962,0.5
40,45,40,65,40,65,295,0.5661764705882353,100,123,75,57,75,80,510,0.6923076923076923,2.0
86,76,86,116,56,95,515,0.7982456140350878,65,65,65,50,50,90,385,0.72,1.0
40,55,80,35,60,30,300,0.15037593984962405,57,80,91,80,87,75,470,0.5737704918032787,0.125
59,63,80,65,80,58,405,0.41843971631205673,40,35,30,120,70,105,400,0.6692307692307692,1.0
95,23,48,23,48,23,260,0.046153846153846156,30,56,35,25,35,72,253,0.48148148148148145,1.0
160,110,65,65,110,30,540,0.35714285714285715,80,75,150,75,150,50,580,0.30973451327433627,0.5
64,66,68,81,76,50,405,0.25190839694656486,49,55,42,42,37,85,310,0.6068376068376068,1.0
75,75,75,125,95,40,485,0.15671641791044777,55,35,50,55,110,85,390,0.6277372262773723,1.0
60,60,50,40,50,75,335,0.5882352941176471,40,65,40,80,40,65,330,0.5038167938931297,1.0
85,97,66,105,66,65,484,0.47107438016528924,65,73,55,47,75,85,400,0.6846846846846847,2.0
64,165,75,93,83,75,555,0.6587301587301587,65,45,55,45,70,45,325,0.24369747899159663,1.0
60,45,50,90,80,70,395,0.625,50,35,55,25,25,15,205,0.021739130434782608,2.0
60,90,70,60,120,40,440,0.27419354838709675,45,30,15,85,65,65,305,0.36220472440944884,1.0
95,110,95,40,95,55,490,0.40336134453781514,40,55,80,35,60,30,300,0.15037593984962405,0.5
150,80,44,90,54,80,498,0.625,50,48,43,46,41,60,288,0.47297297297297297,1.0
45,60,30,80,50,65,330,0.4603174603174603,75,85,200,55,65,30,510,0.16778523489932887,2.0
20,25,45,70,90,60,310,0.30833333333333335,85,110,76,65,82,56,474,0.3933333333333333,1.0
95,70,73,95,90,60,483,0.3983739837398374,85,135,130,60,80,25,515,0.40540540540540543,1.0
100,150,90,180,160,90,770,0.7348484848484849,125,170,100,120,90,95,700,0.77,0.5
50,50,62,40,62,65,329,0.4188034188034188,65,75,90,97,123,44,494,0.1987179487179487,0.5
90,93,55,70,55,55,418,0.3819444444444444,50,105,79,35,110,76,455,0.6214285714285714,1.0
65,50,35,115,95,95,455,0.7333333333333333,41,56,40,62,44,71,314,0.568,0.5
45,60,32,50,32,76,295,0.5925925925925926,45,95,50,40,50,75,355,0.54,1.0
65,90,115,45,115,58,488,0.5041322314049587,100,150,120,120,100,90,680,0.6493506493506493,1.0
40,30,32,50,52,65,269,0.3671875,75,70,90,70,105,80,490,0.656,0.25
65,90,50,85,45,55,390,0.371900826446281,60,70,105,70,120,75,500,0.5983606557377049,1.0
50,64,50,45,50,41,300,0.22727272727272727,95,109,105,75,85,56,525,0.34513274336283184,0.25
55,75,50,40,40,80,340,0.6302521008403361,90,30,15,40,20,15,210,0.043478260869565216,1.0
50,85,40,85,40,35,335,0.1746031746031746,65,90,65,61,61,100,442,0.8373983739837398,0.5
70,100,115,30,65,30,410,0.24390243902439024,70,55,95,95,110,65,490,0.48872180451127817,1.0
60,110,70,60,60,100,460,0.8461538461538461,60,59,85,79,105,36,424,0.16666666666666666,4.0
50,65,64,44,48,43,314,0.2196969696969697,45,22,60,27,30,29,213,0.07518796992481203,1.0
105,130,120,45,45,40,485,0.4444444444444444,100,164,150,95,120,71,700,0.5645161290322581,2.0
72,60,30,20,30,25,237,0.11570247933884298,70,83,50,37,50,60,350,0.3360655737704918,1.0
85,105,85,40,50,40,405,0.211864406779661,40,65,40,80,40,65,330,0.5038167938931297,2.0
74,48,76,83,81,104,466,0.7913043478260869,90,132,105,132,105,30,594,0.4246575342465753,1.0
111,83,68,92,82,39,475,0.1774193548387097,40,30,35,45,40,55,245,0.31496062992125984,0.0
90,92,87,75,85,76,505,0.5409836065573771,77,85,51,55,51,65,384,0.5163934426229508,0.5
65,90,120,85,70,60,490,0.43410852713178294,55,95,55,35,75,115,430,0.9380530973451328,1.0
40,30,50,55,55,100,330,0.584070796460177,50,65,90,35,35,15,290,0.14678899082568808,1.0
65,50,35,115,95,95,455,0.7333333333333333,25,35,70,95,55,45,325,0.16783216783216784,0.25
50,70,100,40,40,30,330,0.2222222222222222,78,81,71,74,69,126,499,0.9090909090909091,2.0
73,95,62,85,65,85,465,0.6666666666666666,62,48,54,63,60,68,355,0.5178571428571429,1.0
89,145,90,105,80,91,600,0.8549618320610687,55,112,45,74,45,70,401,0.559322033898305,0.0
10,55,25,35,45,95,265,0.5396825396825397,40,45,35,65,55,70,310,0.4482758620689655,0.5
45,60,40,70,50,45,310,0.2846715328467153,115,140,130,55,55,40,535,0.4519230769230769,0.5
90,85,100,95,125,85,580,0.6834532374100719,100,100,90,150,140,90,670,0.71875,0.5
68,75,53,83,113,60,452,0.45384615384615384,63,60,55,50,50,71,349,0.5289256198347108,1.0
55,20,35,20,45,75,250,0.37681159420289856,65,95,100,60,50,50,420,0.34959349593495936,1.0
55,95,115,45,45,35,390,0.2116788321167883,150,80,44,90,54,80,498,0.625,0.0
105,95,75,85,75,74,509,0.5714285714285714,75,80,70,65,75,90,455,0.7578125,0.0
70,75,60,105,60,105,475,0.88,255,10,10,75,135,55,540,0.3125,1.0
40,30,32,50,52,65,269,0.3671875,60,65,70,85,75,40,395,0.21705426356589147,0.5
50,20,40,20,40,20,190,0.0962962962962963,35,40,100,90,55,35,355,0.1796875,0.5
25,35,70,95,55,45,325,0.16783216783216784,45,75,37,70,55,83,365,0.6183206106870229,0.5
35,70,55,45,55,25,285,0.09420289855072464,40,55,30,30,30,85,270,0.688,0.25
80,120,130,55,65,45,495,0.37037037037037035,101,72,72,99,89,29,462,0.1937984496124031,1.0
55,65,95,95,45,85,440,0.6610169491525424,85,115,80,105,80,50,515,0.3063063063063063,1.0
50,40,85,40,65,25,305,0.08870967741935484,62,44,50,44,50,55,305,0.3629032258064516,0.5
90,93,55,70,55,55,418,0.3819444444444444,65,100,70,80,80,105,500,0.8666666666666667,0.5
100,50,80,60,80,50,420,0.34375,60,60,75,60,75,80,410,0.7321428571428571,2.0
60,70,50,100,50,65,395,0.5217391304347826,70,65,60,90,75,90,450,0.6571428571428571,1.0
25,20,15,105,55,90,310,0.32407407407407407,69,69,76,69,86,91,460,0.6554621848739496,1.0
45,67,60,35,50,63,320,0.5128205128205128,30,35,30,100,35,80,310,0.4765625,1.0
60,40,60,40,60,35,295,0.18055555555555555,45,75,60,40,30,50,300,0.304,0.5
80,105,65,60,75,130,515,0.9645390070921985,70,80,65,90,65,85,455,0.578125,1.0
60,50,100,85,70,65,430,0.47580645161290325,64,115,65,83,63,65,455,0.5323741007194245,1.0
150,120,100,120,100,90,680,0.664179104477612,73,95,62,85,65,85,465,0.6666666666666666,0.0
30,35,30,100,35,80,310,0.4765625,62,73,55,56,52,84,382,0.7244094488188977,1.0
100,150,120,120,100,90,680,0.6493506493506493,75,98,63,98,63,101,498,0.8091603053435115,0.5
70,150,140,65,100,75,600,0.55,75,69,72,114,100,104,534,0.8253968253968254,0.5
50,50,95,40,50,35,320,0.20279720279720279,65,83,57,95,85,105,490,0.8914728682170543,2.0
71,120,95,120,95,99,600,0.8203125,106,130,90,110,154,90,680,0.719626168224299,0.125
59,74,50,35,50,35,303,0.3125,25,20,15,105,55,90,310,0.32407407407407407,2.0
55,75,60,75,60,103,428,0.7982456140350878,70,110,70,115,70,90,525,0.75,1.0
60,30,30,36,56,50,262,0.32432432432432434,80,120,70,110,70,80,530,0.6422764227642277,2.0
58,50,145,95,105,30,483,0.2459016393442623,45,60,45,25,45,55,275,0.29,0.0
20,40,90,30,90,25,295,0.11363636363636363,40,55,30,30,30,85,270,0.688,0.0
75,75,130,75,130,95,580,0.7479674796747967,50,105,79,35,110,76,455,0.6214285714285714,1.0
70,85,140,85,70,20,470,0.272,70,60,62,80,82,60,414,0.4375,2.0
80,52,50,90,50,89,411,0.6666666666666666,60,115,105,65,70,80,495,0.7181818181818181,0.5
89,145,90,105,80,91,600,0.8549618320610687,109,66,84,81,99,32,471,0.2013888888888889,1.0
40,30,50,55,55,100,330,0.584070796460177,45,30,15,85,65,65,305,0.36220472440944884,1.0
95,60,79,100,125,81,540,0.6201550387596899,65,50,35,115,95,95,455,0.7333333333333333,1.0
45,67,60,35,50,63,320,0.5128205128205128,80,115,80,65,55,93,488,0.7846153846153846,1.0
50,180,20,180,20,150,600,0.9029850746268657,73,76,75,81,100,100,505,0.8110236220472441,1.0
106,110,90,154,90,130,680,0.926829268292683,69,69,76,69,86,91,460,0.6554621848739496,1.0
80,105,105,105,105,80,580,0.5939849624060151,90,85,100,95,125,85,580,0.6834532374100719,1.0
49,49,56,49,61,66,330,0.5190839694656488,65,110,130,60,65,95,525,0.8278145695364238,0.5
45,90,20,65,20,65,305,0.5116279069767442,80,110,120,130,90,70,600,0.6198347107438017,1.0
80,120,130,55,65,45,495,0.37037037037037035,52,65,55,58,62,60,352,0.4482758620689655,0.0
40,45,35,65,55,70,310,0.4482758620689655,70,55,75,45,65,60,370,0.45901639344262296,0.5
80,50,100,100,200,50,580,0.2357142857142857,70,90,90,135,90,125,600,0.9401709401709402,1.0
67,89,116,79,116,33,500,0.2624113475177305,55,55,55,85,55,30,335,0.1320754716981132,0.5
70,150,140,65,100,75,600,0.55,70,77,60,97,60,108,472,0.8394160583941606,0.5
65,80,140,40,70,70,465,0.5223880597014925,65,95,75,55,55,85,430,0.6933333333333334,0.5
76,104,71,104,71,108,534,0.912751677852349,30,45,59,30,39,57,260,0.2803030303030303,0.5
55,70,55,40,55,85,360,0.7073170731707317,80,105,105,105,105,80,580,0.5939849624060151,1.0
80,100,70,50,60,45,405,0.25806451612903225,90,130,80,65,85,55,505,0.4396551724137931,1.0
70,84,70,65,70,51,410,0.2949640287769784,70,75,60,105,60,105,475,0.88,2.0
50,65,107,105,107,86,520,0.7313432835820896,60,100,115,70,85,90,520,0.7557251908396947,0.5
91,90,106,130,106,77,600,0.648854961832061,100,50,50,76,96,70,442,0.5,1.0
79,115,70,125,80,111,580,0.8468468468468469,52,65,50,45,50,38,300,0.27419354838709675,1.0
70,77,60,97,60,108,472,0.8394160583941606,55,20,35,20,45,75,250,0.37681159420289856,1.0
95,135,80,110,80,100,600,0.8248175182481752,59,110,150,45,49,35,448,0.3333333333333333,0.25
30,42,118,42,88,30,350,0.112,70,62,67,55,55,56,365,0.38513513513513514,1.0
126,131,95,131,98,99,680,0.8102189781021898,100,100,100,100,100,100,600,0.8778625954198473,2.0
80,100,200,50,100,50,580,0.3472222222222222,80,80,50,40,50,25,325,0.176056338028169,1.0
70,105,105,50,40,20,390,0.33587786259541985,31,45,90,30,30,40,266,0.21929824561403508,1.0
120,70,120,75,130,85,600,0.6694915254237288,62,73,55,56,52,84,382,0.7244094488188977,1.0
100,70,70,65,65,45,415,0.1897810218978102,150,80,44,90,54,80,498,0.625,0.0
75,75,75,125,95,40,485,0.15671641791044777,62,48,66,59,57,49,341,0.33884297520661155,1.0
60,69,95,69,95,36,424,0.2608695652173913,126,131,95,131,98,99,680,0.8294573643410853,0.25
50,75,35,70,30,40,300,0.21296296296296297,78,92,75,74,63,118,500,0.8842975206611571,0.5
60,60,75,60,75,80,410,0.7321428571428571,60,90,70,60,120,40,440,0.27419354838709675,2.0
55,40,50,65,85,40,335,0.3181818181818182,38,41,40,50,65,65,299,0.4108527131782946,2.0
80,82,83,100,100,80,525,0.6742424242424242,85,110,90,45,90,80,500,0.6206896551724138,1.0
45,30,50,55,65,45,290,0.208,52,65,50,45,50,38,300,0.27419354838709675,0.0
60,79,105,59,85,36,424,0.17054263565891473,60,90,55,90,80,110,485,0.8677685950413223,2.0
60,75,85,100,85,115,520,0.8992248062015504,86,92,88,68,75,73,482,0.6835443037974683,0.0
52,65,55,58,62,60,352,0.4482758620689655,50,50,77,95,77,91,440,0.5916666666666667,0.0
68,65,65,125,115,80,518,0.6461538461538462,45,49,49,65,65,45,318,0.2781954887218045,1.0
110,78,73,76,71,60,468,0.3333333333333333,79,115,70,125,80,111,580,0.864,0.0
85,135,130,60,80,25,515,0.40540540540540543,50,60,60,60,60,30,320,0.11290322580645161,1.0
80,120,70,110,70,80,530,0.6422764227642277,100,77,77,128,128,90,600,0.6901408450704225,1.0
85,105,85,40,50,40,405,0.211864406779661,108,130,95,80,85,102,600,0.7637795275590551,1.0
60,70,105,70,120,75,500,0.5983606557377049,75,80,55,25,35,35,305,0.18666666666666668,1.0
60,90,55,90,80,110,485,0.8677685950413223,85,56,77,50,77,78,423,0.53125,0.0
90,30,15,40,20,15,210,0.043478260869565216,80,52,50,90,50,89,411,0.6666666666666666,1.0
62,44,50,44,50,55,305,0.3629032258064516,45,60,40,70,50,45,310,0.2846715328467153,2.0
65,125,100,55,70,85,500,0.6532258064516129,38,35,40,27,25,35,200,0.08208955223880597,1.0
54,63,52,83,56,97,405,0.7697841726618705,50,72,35,35,35,65,292,0.5373134328358209,2.0
72,58,80,103,80,97,490,0.7171052631578947,39,52,43,60,50,65,309,0.5041322314049587,1.0
76,48,48,57,62,34,325,0.11688311688311688,105,180,100,180,100,115,780,0.9477611940298507,0.5
100,5,5,15,65,30,220,0.07692307692307693,50,75,45,40,45,60,315,0.4380165289256198,1.0
61,72,57,55,55,65,365,0.3984375,115,140,130,55,55,40,535,0.4519230769230769,0.25
85,105,100,79,83,78,530,0.5869565217391305,67,89,116,79,116,33,500,0.2624113475177305,1.0
75,90,50,110,80,95,500,0.7985611510791367,80,95,82,60,82,75,474,0.6,1.0
101,72,72,99,89,29,462,0.1937984496124031,80,125,75,40,95,85,500,0.6911764705882353,2.0
68,165,95,65,115,110,618,0.8615384615384616,50,75,45,40,45,60,315,0.4380165289256198,0.5
150,160,100,95,65,100,670,0.8866666666666667,90,60,60,40,40,40,330,0.29545454545454547,1.0
55,75,50,40,40,80,340,0.6302521008403361,90,120,100,150,120,100,680,0.7718120805369127,1.0
40,45,35,40,40,90,290,0.65,75,100,95,40,70,110,490,0.8717948717948718,1.0
50,105,79,35,110,76,455,0.6214285714285714,50,75,35,70,30,40,300,0.21296296296296297,0.5
60,95,80,60,80,30,405,0.19480519480519481,58,50,145,95,105,30,483,0.2459016393442623,0.5
126,131,95,131,98,99,680,0.8102189781021898,150,80,44,90,54,80,498,0.625,2.0
85,80,70,135,75,90,535,0.7006802721088435,100,150,140,100,90,90,670,0.7969924812030075,1.0
75,95,125,45,75,95,510,0.8257575757575758,74,100,72,90,72,46,454,0.24561403508771928,1.0
92,105,90,125,90,98,600,0.8217054263565892,59,59,58,90,70,73,409,0.5826086956521739,1.0
30,56,35,25,35,72,253,0.48148148148148145,60,60,60,85,85,85,435,0.631578947368421,0.0
44,38,33,61,43,70,289,0.5267857142857143,126,131,95,131,98,99,680,0.8294573643410853,1.0
60,85,49,60,49,60,363,0.4444444444444444,40,27,60,37,50,66,280,0.36220472440944884,0.5
38,30,41,30,41,60,240,0.2897196261682243,66,117,70,40,50,67,410,0.4573643410852713,1.0
30,80,90,55,45,55,355,0.4295774647887324,41,50,37,50,37,66,281,0.5175438596491229,1.0
35,85,45,35,35,75,310,0.6492537313432836,70,115,60,115,60,55,475,0.4647887323943662,2.0
110,130,80,70,60,80,530,0.5862068965517241,103,60,86,60,86,50,445,0.3458646616541353,1.0
60,75,85,100,85,115,520,0.8992248062015504,65,73,55,47,75,85,400,0.6846846846846847,1.0
120,100,85,30,85,45,465,0.22448979591836735,64,115,65,83,63,65,455,0.5323741007194245,0.0
70,65,65,55,55,70,380,0.5,36,50,50,65,60,44,305,0.16363636363636364,1.0
55,45,50,45,65,80,340,0.5546218487394958,68,165,95,65,115,110,618,0.8615384615384616,2.0
80,80,50,40,50,25,325,0.176056338028169,85,97,66,105,66,65,484,0.47107438016528924,1.0
65,65,60,110,95,130,525,0.9253731343283582,40,55,70,45,60,30,300,0.10619469026548672,1.0
50,55,50,36,30,43,264,0.2922077922077922,65,75,70,95,70,95,470,0.7272727272727273,1.0
103,93,67,71,61,84,479,0.7142857142857143,85,105,100,79,83,78,530,0.5869565217391305,1.0
170,90,45,90,45,60,500,0.427536231884058,60,48,45,43,90,42,328,0.21897810218978103,1.0
70,70,70,70,70,70,420,0.5289256198347108,111,83,68,92,82,39,475,0.1774193548387097,1.0
70,80,65,90,65,85,455,0.578125,68,65,65,125,115,80,518,0.6461538461538462,0.5
95,60,79,100,125,81,540,0.6201550387596899,65,80,65,35,65,60,370,0.38405797101449274,1.0
45,60,40,70,50,45,310,0.2846715328467153,70,85,140,85,70,20,470,0.272,0.5
55,50,45,135,95,120,500,0.7714285714285715,57,80,91,80,87,75,470,0.5737704918032787,0.5
46,57,40,40,40,50,273,0.25,57,24,86,24,86,23,300,0.12727272727272726,0.0
125,120,90,170,100,95,700,0.78125,66,65,48,62,57,52,350,0.36220472440944884,2.0
30,35,30,100,35,80,310,0.4765625,105,95,80,40,80,90,490,0.753968253968254,0.0
35,40,100,90,55,35,355,0.1796875,109,66,84,81,99,32,471,0.2013888888888889,1.0
80,85,95,30,30,25,345,0.2857142857142857,70,60,75,110,75,90,480,0.7165354330708661,0.5
60,50,70,80,80,140,480,0.8449612403100775,80,160,80,130,80,100,630,0.8455284552845529,1.0
55,55,45,63,45,45,308,0.25,65,50,35,115,95,95,455,0.7333333333333333,1.0
90,50,34,60,44,70,348,0.6283185840707964,100,150,140,100,90,90,670,0.7969924812030075,1.0
110,160,110,80,110,100,670,0.8591549295774648,30,45,55,70,55,85,340,0.5633802816901409,1.0
50,65,45,85,65,95,405,0.7238095238095238,54,78,103,53,45,22,355,0.23255813953488372,4.0
100,50,80,60,80,50,420,0.34375,85,105,85,40,50,40,405,0.211864406779661,2.0
80,80,80,55,55,90,440,0.6417910447761194,45,100,45,45,45,10,290,0.2949640287769784,1.0
50,30,55,65,55,20,275,0.13675213675213677,55,50,65,175,95,150,590,0.7818181818181819,2.0
54,78,103,53,45,22,355,0.23255813953488372,70,110,80,55,80,105,500,0.8794326241134752,4.0
40,40,50,30,30,30,220,0.0873015873015873,50,65,107,105,107,86,520,0.7313432835820896,0.5
55,50,45,135,95,120,500,0.7714285714285715,75,95,60,65,60,115,470,0.8778625954198473,1.0
50,53,48,53,48,64,316,0.46153846153846156,65,75,70,95,70,95,470,0.7272727272727273,1.0
50,65,90,35,35,15,290,0.14678899082568808,56,61,65,48,45,38,313,0.17567567567567569,2.0
75,95,67,125,95,83,540,0.7117117117117117,65,80,65,35,65,60,370,0.38405797101449274,1.0
110,80,90,95,90,65,530,0.5033557046979866,60,40,50,75,85,95,405,0.6044776119402985,1.0
75,110,110,110,105,80,590,0.656934306569343,70,55,55,80,60,45,365,0.2222222222222222,1.0
38,41,40,50,65,65,299,0.4108527131782946,100,100,100,100,100,100,600,0.8758169934640523,2.0
80,105,105,105,105,80,580,0.5939849624060151,30,65,100,45,25,40,305,0.1891891891891892,1.0
60,100,89,55,69,112,485,0.9298245614035088,58,64,58,80,65,80,405,0.5423728813559322,0.5
50,65,85,35,35,55,325,0.32575757575757575,64,165,75,93,83,75,555,0.6587301587301587,0.5
40,40,35,50,100,70,335,0.5031847133757962,66,117,70,40,50,67,410,0.4573643410852713,0.5
53,54,53,37,46,45,288,0.3090909090909091,39,52,43,60,50,65,309,0.49107142857142855,1.0
100,150,140,100,90,90,670,0.7969924812030075,50,40,85,40,65,25,305,0.08870967741935484,0.5
50,92,108,92,108,35,485,0.2457627118644068,50,75,45,40,45,60,315,0.4380165289256198,1.0
70,55,75,45,65,60,370,0.45901639344262296,51,65,65,80,75,59,395,0.4365079365079365,1.0
75,95,125,45,75,95,510,0.8257575757575758,110,135,60,50,65,88,508,0.7744360902255639,1.0
60,85,49,60,49,60,363,0.4444444444444444,76,65,45,92,42,91,411,0.7449664429530202,2.0
59,59,58,90,70,73,409,0.5826086956521739,74,48,76,83,81,104,466,0.7913043478260869,1.0
44,38,33,61,43,70,289,0.5267857142857143,90,110,80,100,80,95,555,0.7982456140350878,1.0
70,150,140,65,100,75,600,0.55,40,45,35,30,40,55,245,0.3793103448275862,0.25
44,48,65,50,64,43,314,0.1623931623931624,45,85,50,55,50,65,350,0.5076923076923077,1.0
80,100,200,50,100,50,580,0.3472222222222222,79,85,60,55,60,71,410,0.60431654676259,1.0
126,131,95,131,98,99,680,0.8102189781021898,70,65,60,90,75,90,450,0.6571428571428571,2.0
50,65,45,85,65,95,405,0.7238095238095238,59,66,70,44,55,41,335,0.25190839694656486,0.5
50,53,62,58,63,44,330,0.13709677419354838,110,123,65,100,65,65,528,0.5217391304347826,2.0
45,49,49,65,65,45,318,0.2781954887218045,50,85,55,65,65,90,410,0.7478260869565218,0.5
85,115,80,105,80,50,515,0.3063063063063063,35,64,85,74,55,32,345,0.19827586206896552,2.0
75,80,70,65,75,90,455,0.7578125,80,135,130,95,90,70,600,0.5181818181818182,0.0
74,100,72,90,72,46,454,0.24561403508771928,45,49,65,49,65,45,318,0.275,0.5
95,124,78,69,71,58,495,0.37398373983739835,70,95,85,55,65,70,440,0.5,2.0
62,73,55,56,52,84,382,0.7244094488188977,83,80,75,70,70,101,479,0.8615384615384616,1.0
100,75,115,90,115,85,580,0.6446280991735537,40,45,35,65,55,70,310,0.4482758620689655,0.5
50,50,40,50,40,64,294,0.45588235294117646,25,35,70,95,55,45,325,0.16783216783216784,1.0
43,80,65,50,35,35,308,0.14193548387096774,90,120,120,60,60,50,500,0.35294117647058826,2.0
50,70,50,50,50,70,340,0.5645161290322581,79,85,60,55,60,71,410,0.60431654676259,1.0
68,125,65,65,115,80,518,0.6277372262773723,110,80,90,95,90,65,530,0.5033557046979866,2.0
61,72,57,55,55,65,365,0.3984375,60,65,80,170,95,130,600,0.8625954198473282,0.25
75,103,80,70,80,92,500,0.7933884297520661,35,20,65,40,65,20,245,0.02459016393442623,0.5
100,70,70,65,65,45,415,0.1897810218978102,62,50,58,73,54,72,369,0.4435483870967742,1.0
59,66,70,44,55,41,335,0.25190839694656486,90,50,34,60,44,70,348,0.6283185840707964,1.0
50,50,50,50,50,50,300,0.30708661417322836,70,70,115,130,90,60,535,0.5338983050847458,0.5
71,95,85,110,95,79,535,0.664,65,85,70,75,70,40,405,0.203125,1.0
45,60,30,80,50,65,330,0.4603174603174603,125,130,90,130,90,95,660,0.7734375,1.0
75,100,95,40,70,110,490,0.8717948717948718,50,60,45,100,80,65,400,0.45689655172413796,1.0
64,165,75,93,83,75,555,0.6587301587301587,65,90,40,45,80,75,395,0.625,1.0
50,75,70,35,70,48,348,0.29357798165137616,50,50,150,50,150,50,500,0.2571428571428571,0.5
80,70,65,80,120,100,515,0.8034188034188035,60,45,70,45,90,95,405,0.7304964539007093,1.0
40,70,130,60,130,25,455,0.17355371900826447,95,145,130,120,90,120,700,0.9398496240601504,1.0
45,49,49,65,65,45,318,0.2781954887218045,50,120,53,35,110,87,455,0.640625,1.0
95,75,110,100,80,30,490,0.15267175572519084,60,85,40,30,45,68,328,0.6422018348623854,4.0
106,130,90,110,154,90,680,0.719626168224299,190,33,58,33,58,33,405,0.13432835820895522,1.0
75,75,55,105,85,30,425,0.1619718309859155,50,52,48,65,50,55,320,0.33098591549295775,2.0
75,95,60,65,60,115,470,0.8778625954198473,65,65,60,130,95,110,525,0.823943661971831,1.0
50,95,90,95,90,180,600,0.9172413793103448,110,78,73,76,71,60,468,0.3333333333333333,2.0
67,89,116,79,116,33,500,0.2624113475177305,35,35,35,35,35,35,210,0.13385826771653545,1.0
100,73,83,73,83,55,467,0.371900826446281,20,40,90,30,90,25,295,0.11363636363636363,0.5
60,60,60,85,85,85,435,0.631578947368421,80,80,80,80,80,80,480,0.5606060606060606,1.0
81,102,77,85,75,85,505,0.5642857142857143,100,150,120,120,100,90,680,0.6493506493506493,2.0
80,135,130,95,90,70,600,0.5181818181818182,110,65,105,55,95,80,510,0.6258503401360545,0.0
86,81,97,81,107,43,495,0.203125,73,95,62,85,65,85,465,0.6666666666666666,1.0
35,40,100,90,55,35,355,0.1796875,60,59,85,79,105,36,424,0.16666666666666666,1.0
75,123,67,95,85,95,540,0.7642276422764228,100,90,130,45,65,55,485,0.4253731343283582,2.0
80,80,90,110,130,110,600,0.8721804511278195,20,40,90,30,90,25,295,0.11363636363636363,1.0
50,92,108,92,108,35,485,0.2457627118644068,20,15,20,10,55,80,200,0.2682926829268293,1.0
110,160,110,80,110,100,670,0.8591549295774648,75,100,63,80,63,116,497,0.9345794392523364,1.0
35,20,65,40,65,20,245,0.02459016393442623,80,100,80,80,80,100,520,0.9051724137931034,2.0
110,78,73,76,71,60,468,0.3333333333333333,90,93,55,70,55,55,418,0.3819444444444444,4.0
73,95,62,85,65,85,465,0.6666666666666666,38,30,41,30,41,60,240,0.2897196261682243,1.0
100,100,100,100,100,100,600,0.8805970149253731,86,76,86,116,56,95,515,0.7982456140350878,1.0
80,45,65,90,110,80,470,0.5462962962962963,70,90,110,60,75,95,500,0.7333333333333333,0.0
41,64,45,50,50,50,300,0.36752136752136755,95,117,80,65,70,92,519,0.8409090909090909,1.0
65,150,40,15,80,145,495,0.9663865546218487,60,80,110,50,80,45,425,0.2833333333333333,0.5
70,60,125,115,70,55,495,0.35507246376811596,70,80,50,35,35,35,305,0.14,0.5
75,98,63,98,63,101,498,0.849624060150376,90,65,65,40,40,15,315,0.19672131147540983,0.5
120,100,85,30,85,45,465,0.22448979591836735,75,80,95,90,100,50,490,0.2158273381294964,1.0
35,35,35,35,35,35,210,0.13385826771653545,60,45,70,75,85,55,390,0.3008130081300813,0.5
64,88,50,88,50,106,446,0.9111111111111111,45,35,50,70,50,30,280,0.15753424657534246,1.0
75,80,95,90,100,50,490,0.2158273381294964,45,25,50,25,25,35,205,0.13076923076923078,0.25
125,170,100,120,90,95,700,0.77,77,85,51,55,51,65,384,0.5163934426229508,1.0
90,132,105,132,105,30,594,0.4246575342465753,40,45,35,65,55,70,310,0.4482758620689655,1.0
100,100,100,100,100,100,600,0.831858407079646,60,60,60,105,105,105,495,0.848,1.0
77,120,90,60,90,48,485,0.2785714285714286,70,43,53,43,53,40,302,0.19090909090909092,1.0
60,55,145,75,150,40,525,0.2,75,80,95,90,100,50,490,0.2158273381294964,1.0
50,70,160,70,160,90,600,0.7417218543046358,100,90,130,45,65,55,485,0.4253731343283582,1.0
64,165,75,93,83,75,555,0.6587301587301587,70,100,115,30,65,30,410,0.24390243902439024,1.0
100,100,100,100,100,100,600,0.8778625954198473,61,72,57,55,55,65,365,0.3984375,2.0
55,69,85,32,35,28,304,0.09302325581395349,70,84,70,65,70,51,410,0.2949640287769784,2.0
55,95,115,45,45,35,390,0.2116788321167883,80,45,65,90,110,80,470,0.5462962962962963,1.0
80,70,40,100,60,145,495,0.921875,60,100,85,80,85,100,510,0.7007874015748031,1.0
60,62,80,63,80,60,405,0.4336283185840708,55,55,45,63,45,45,308,0.25,2.0
100,100,100,100,100,100,600,0.831858407079646,70,145,88,140,70,112,625,0.8888888888888888,0.5
86,76,86,116,56,95,515,0.7982456140350878,80,120,80,120,80,100,580,0.8478260869565217,1.0
45,60,30,80,50,65,330,0.4603174603174603,65,150,60,115,60,115,565,0.935251798561151,0.5
70,140,230,60,80,50,630,0.32432432432432434,60,52,168,47,138,30,495,0.19834710743801653,1.0
150,80,44,90,54,80,498,0.625,77,59,50,67,63,46,362,0.23140495867768596,0.5
50,70,50,50,50,70,340,0.5645161290322581,35,80,50,50,70,120,405,0.84375,1.0
60,40,50,75,85,95,405,0.6044776119402985,91,129,90,72,90,108,580,0.8536585365853658,1.0
82,80,86,85,75,72,480,0.6183206106870229,100,77,77,128,128,90,600,0.6901408450704225,1.0
165,75,80,40,45,65,470,0.5151515151515151,90,93,55,70,55,55,418,0.3819444444444444,2.0
49,55,42,42,37,85,310,0.6068376068376068,60,55,90,145,90,80,520,0.6071428571428571,0.0
75,140,65,112,65,110,567,0.9140625,63,120,85,90,55,55,468,0.2809917355371901,1.0
50,70,100,40,40,30,330,0.2222222222222222,50,20,40,20,40,20,190,0.0962962962962963,0.5
95,75,110,100,80,30,490,0.15267175572519084,74,48,76,83,81,104,466,0.7322834645669292,0.5
75,75,55,105,85,30,425,0.1619718309859155,50,65,85,35,35,55,325,0.32575757575757575,1.0
85,70,80,97,80,123,535,0.9304347826086956,45,55,39,35,39,42,255,0.18518518518518517,1.0
45,50,43,40,38,62,278,0.40441176470588236,60,75,100,55,80,50,420,0.3088235294117647,0.25
86,92,88,68,75,73,482,0.6835443037974683,43,30,55,40,65,97,330,0.6030534351145038,1.0
65,63,45,45,45,45,308,0.2595419847328244,115,45,20,45,25,20,270,0.11538461538461539,1.0
68,72,78,38,42,32,330,0.23809523809523808,55,55,85,65,85,35,380,0.2014388489208633,2.0
78,84,78,109,85,100,534,0.8646616541353384,45,53,70,40,60,42,310,0.25735294117647056,16.0
60,50,70,80,80,140,480,0.8449612403100775,90,95,95,70,90,70,510,0.5230769230769231,2.0
85,73,70,73,115,67,483,0.5126050420168067,85,100,122,58,75,54,494,0.3939393939393939,1.0
70,40,50,55,50,25,290,0.061068702290076333,60,40,60,40,60,35,295,0.18055555555555555,1.0
45,49,65,49,65,45,318,0.275,50,60,60,60,60,30,320,0.11290322580645161,1.0
58,109,112,48,48,109,484,0.8805970149253731,50,65,85,35,35,55,325,0.32575757575757575,2.0
40,40,55,40,70,55,300,0.40939597315436244,75,125,70,125,70,115,580,0.9037037037037037,0.5
75,69,72,114,100,104,534,0.8253968253968254,55,50,40,40,40,75,300,0.5945945945945946,1.0
70,85,70,60,70,50,405,0.28378378378378377,75,75,55,105,85,30,425,0.1619718309859155,0.25
45,80,100,35,37,28,325,0.3125,65,95,75,55,55,85,430,0.6933333333333334,0.5
105,140,55,30,55,95,480,0.8195488721804511,50,25,28,45,55,15,218,0.0625,1.0
60,105,60,120,60,105,510,0.8849557522123894,70,75,60,105,60,105,475,0.88,1.0
80,100,200,50,100,50,580,0.3472222222222222,43,30,55,40,65,97,330,0.6030534351145038,1.0
78,130,111,130,85,100,634,0.8561151079136691,20,10,55,15,20,80,200,0.17985611510791366,0.5
100,150,90,180,160,90,770,0.7348484848484849,55,69,85,32,35,28,304,0.09302325581395349,1.0
80,92,65,65,80,68,450,0.4824561403508772,95,124,78,69,71,58,495,0.37398373983739835,1.0
78,84,78,109,85,100,534,0.8620689655172413,58,64,58,80,65,80,405,0.609271523178808,0.5
90,100,60,90,60,80,480,0.6422764227642277,60,50,40,85,75,95,405,0.7540983606557377,1.0
35,85,45,35,35,75,310,0.6492537313432836,60,130,80,60,60,70,460,0.5153846153846153,4.0
50,75,35,70,30,40,300,0.21296296296296297,50,72,35,35,35,65,292,0.5373134328358209,1.0
65,76,84,54,96,105,480,0.9008264462809917,90,120,75,60,60,45,450,0.29411764705882354,1.0
67,57,55,77,55,114,425,0.8879310344827587,35,35,40,35,55,50,250,0.40336134453781514,2.0
86,81,97,81,107,43,495,0.203125,55,65,95,95,45,85,440,0.6610169491525424,2.0
62,55,52,109,94,109,481,0.7833333333333333,35,55,40,45,40,60,275,0.35714285714285715,0.5
40,60,40,40,40,30,250,0.0948905109489051,68,90,65,50,55,82,410,0.6165413533834586,0.5
105,95,80,40,80,90,490,0.753968253968254,55,65,95,95,45,85,440,0.6610169491525424,1.0
35,35,40,35,55,50,250,0.40336134453781514,30,105,90,25,25,50,325,0.2773722627737226,2.0
40,65,40,80,40,65,330,0.5038167938931297,90,93,55,70,55,55,418,0.3819444444444444,0.5
80,82,78,95,80,85,500,0.6869565217391305,85,135,130,60,80,25,515,0.40540540540540543,2.0
40,60,30,31,31,70,262,0.4492753623188406,50,45,45,35,35,50,260,0.23529411764705882,1.0
45,65,34,40,34,45,263,0.2589928057553957,58,109,112,48,48,109,484,0.8805970149253731,1.0
35,55,40,50,50,90,320,0.6838235294117647,50,50,50,50,50,50,300,0.30708661417322836,1.0
30,35,30,100,35,80,310,0.4765625,39,52,43,60,50,65,309,0.5041322314049587,1.0
50,50,62,40,62,65,329,0.4188034188034188,40,35,30,120,70,105,400,0.6692307692307692,1.0
30,45,59,30,39,57,260,0.2803030303030303,55,95,115,45,45,35,390,0.2116788321167883,0.25
50,65,107,105,107,86,520,0.7758620689655172,65,150,60,115,60,115,565,0.935251798561151,1.0
50,60,45,100,80,65,400,0.45689655172413796,68,75,53,83,113,60,452,0.45384615384615384,0.5
55,70,55,40,55,85,360,0.7073170731707317,103,93,67,71,61,84,479,0.7142857142857143,1.0
65,50,35,115,95,95,455,0.7333333333333333,100,100,125,110,50,50,535,0.384,2.0
20,10,230,10,230,5,505,0.0,70,150,140,65,100,75,600,0.55,0.5
80,82,78,95,80,85,500,0.6869565217391305,59,66,70,44,55,41,335,0.25190839694656486,0.5
55,66,44,44,56,85,350,0.6888888888888889,70,120,65,45,85,125,510,0.9747899159663865,1.0
45,90,20,65,20,65,305,0.5116279069767442,60,75,100,55,80,50,420,0.3088235294117647,2.0
65,125,100,60,70,70,490,0.6099290780141844,45,45,35,20,30,20,195,0.07246376811594203,1.0
38,30,85,55,65,30,303,0.21428571428571427,116,55,85,107,95,29,487,0.06818181818181818,2.0
110,85,95,80,95,50,515,0.2713178294573643,60,40,50,75,85,95,405,0.6044776119402985,1.0
70,80,50,35,35,35,305,0.14,60,45,70,45,90,95,405,0.7304964539007093,1.0
52,65,55,58,62,60,352,0.4482758620689655,73,115,60,60,60,90,458,0.6694915254237288,1.0
100,180,160,150,90,90,770,0.7520661157024794,90,90,85,125,90,100,580,0.768595041322314,0.0
46,87,60,30,40,57,320,0.37777777777777777,45,67,60,35,50,63,320,0.5128205128205128,1.0
105,150,90,150,90,95,680,0.8285714285714286,45,49,49,65,65,45,318,0.2781954887218045,2.0
68,75,53,83,113,60,452,0.45384615384615384,75,89,85,55,65,36,405,0.29545454545454547,1.0
60,50,70,50,90,65,385,0.39568345323741005,45,50,35,55,75,40,300,0.21367521367521367,1.0
65,60,70,85,75,40,395,0.1796875,95,110,95,40,95,55,490,0.40336134453781514,1.0
50,65,107,105,107,86,520,0.703125,100,100,125,110,50,50,535,0.384,1.0
55,40,40,65,45,35,280,0.16428571428571428,60,85,49,60,49,60,363,0.4444444444444444,0.5
80,80,80,80,80,80,480,0.6015037593984962,90,130,80,65,85,55,505,0.4396551724137931,1.0
39,52,43,60,50,65,309,0.5041322314049587,45,20,50,60,120,50,345,0.24074074074074073,0.5
80,45,65,90,110,80,470,0.5462962962962963,54,63,52,83,56,97,405,0.7697841726618705,1.0
60,45,70,45,90,95,405,0.7304964539007093,40,20,30,40,80,55,265,0.22764227642276422,2.0
150,80,44,90,54,80,498,0.625,80,105,105,105,105,80,580,0.5939849624060151,2.0
55,112,45,74,45,70,401,0.559322033898305,50,50,95,40,50,35,320,0.20279720279720279,0.5
80,125,75,40,95,85,500,0.6911764705882353,58,70,45,40,45,42,300,0.25925925925925924,1.0
35,65,35,65,35,65,300,0.46621621621621623,74,100,72,90,72,46,454,0.24561403508771928,0.5
65,105,60,60,70,95,455,63.0,78,81,71,74,69,126,499,0.9090909090909091,0.5
60,55,90,145,90,80,520,0.6071428571428571,106,110,90,154,90,130,680,0.926829268292683,2.0
45,60,30,80,50,65,330,0.4603174603174603,75,100,66,60,66,115,482,0.918918918918919,1.0
100,70,70,65,65,45,415,0.1897810218978102,50,65,107,105,107,86,520,0.7272727272727273,1.0
70,120,40,95,40,95,460,0.8106060606060606,49,55,42,42,37,85,310,0.6068376068376068,1.0
90,120,75,60,60,45,450,0.29411764705882354,37,25,41,25,41,25,194,0.08870967741935484,1.0
60,130,80,60,60,70,460,0.5153846153846153,40,40,50,30,30,30,220,0.0873015873015873,0.5
105,125,100,60,100,100,590,0.8359375,75,125,75,30,75,85,465,0.625,1.0
75,90,50,110,80,95,500,0.7985611510791367,90,130,80,65,85,55,505,0.4396551724137931,0.5
60,48,45,43,90,42,328,0.21897810218978103,70,90,90,135,90,125,600,0.9401709401709402,0.0
60,65,80,170,95,130,600,0.8625954198473282,90,95,105,165,110,45,610,0.2890625,1.0
83,106,65,86,65,85,490,0.6640625,70,90,110,60,75,95,500,0.7333333333333333,0.5
43,30,55,40,65,97,330,0.6030534351145038,100,75,115,90,115,85,580,0.6446280991735537,0.5
59,45,40,35,40,31,250,0.14285714285714285,41,64,45,50,50,50,300,0.36752136752136755,1.0
75,80,55,25,35,35,305,0.18666666666666668,65,130,60,95,110,65,525,0.5303030303030303,1.0
65,125,100,55,70,85,500,0.6532258064516129,115,115,85,90,75,100,580,0.8134328358208955,0.5
60,48,45,43,90,42,328,0.21897810218978103,55,55,55,85,55,30,335,0.1320754716981132,0.5
65,95,57,100,85,93,495,0.7441860465116279,80,130,100,160,120,110,700,0.8981481481481481,0.5
100,110,90,85,90,60,535,0.47794117647058826,70,110,180,60,60,50,530,0.4117647058823529,8.0
60,70,105,70,120,75,500,0.5983606557377049,130,65,60,110,95,65,525,0.5227272727272727,1.0
103,60,126,80,126,50,545,0.36363636363636365,48,72,48,72,48,48,336,0.25984251968503935,1.0
75,89,85,55,65,36,405,0.29545454545454547,90,60,60,40,40,40,330,0.29545454545454547,2.0
50,65,64,44,48,43,314,0.2196969696969697,85,73,70,73,115,67,483,0.5126050420168067,1.0
90,93,55,70,55,55,418,0.3819444444444444,80,52,50,90,50,89,411,0.6666666666666666,0.5
30,45,59,30,39,57,260,0.2803030303030303,80,185,115,40,105,75,600,0.6230769230769231,0.5
105,140,95,55,65,45,505,0.3,67,82,62,46,48,43,348,0.22033898305084745,1.0
45,40,60,40,75,50,310,0.2926829268292683,80,82,78,95,80,85,500,0.6869565217391305,1.0
45,50,35,55,75,40,300,0.21367521367521367,76,48,48,57,62,34,325,0.11688311688311688,1.0
70,95,125,65,75,45,475,0.33613445378151263,100,180,160,150,90,90,770,0.7520661157024794,0.5
50,53,62,58,63,44,330,0.13709677419354838,85,115,80,105,80,50,515,0.3063063063063063,1.0
75,123,67,95,85,95,540,0.7642276422764228,50,160,110,160,110,110,700,0.8854961832061069,1.0
60,45,50,90,80,70,395,0.625,55,65,95,95,45,85,440,0.6610169491525424,1.0
108,112,118,68,72,47,525,0.2916666666666667,115,45,20,45,25,20,270,0.11538461538461539,1.0
80,80,50,40,50,25,325,0.176056338028169,65,65,60,110,95,130,525,0.9253731343283582,1.0
25,35,70,95,55,45,325,0.16783216783216784,45,60,30,80,50,65,330,0.4603174603174603,0.5
61,90,45,50,50,160,456,0.9230769230769231,150,80,44,90,54,80,498,0.625,0.25
100,100,100,100,100,100,600,0.8602941176470589,55,75,85,25,25,15,280,0.1875,2.0
100,150,90,180,160,90,770,0.7348484848484849,100,150,140,100,90,90,670,0.7969924812030075,2.0
31,45,90,30,30,40,266,0.21929824561403508,95,110,80,70,80,50,485,0.37209302325581395,1.0
50,50,40,50,40,64,294,0.45588235294117646,90,75,75,90,100,70,500,0.5462184873949579,0.5
30,56,35,25,35,72,253,0.48148148148148145,63,120,85,90,55,55,468,0.2809917355371901,1.0
40,45,35,40,40,90,290,0.65,45,20,50,60,120,50,345,0.24074074074074073,1.0
80,120,70,110,70,80,530,0.6422764227642277,55,81,60,50,70,97,413,0.7214285714285714,2.0
25,20,15,105,55,90,310,0.32407407407407407,42,52,67,39,56,50,306,0.2868217054263566,1.0
51,65,65,80,75,59,395,0.4365079365079365,75,125,70,125,70,115,580,0.9037037037037037,1.0
89,124,80,55,80,55,483,0.5714285714285714,85,120,70,50,60,100,485,0.8308823529411765,0.0
50,20,55,25,25,30,205,0.09774436090225563,85,80,90,105,95,60,515,0.49074074074074076,1.0
50,85,125,85,115,20,480,0.4306569343065693,38,35,35,65,55,50,278,0.2647058823529412,2.0
105,95,80,40,80,90,490,0.753968253968254,70,55,95,95,110,65,490,0.48872180451127817,1.0
75,75,60,83,60,60,413,0.39344262295081966,85,50,95,120,115,80,545,0.5793650793650794,1.0
80,50,100,100,200,50,580,0.2357142857142857,91,134,95,100,100,80,600,0.6304347826086957,4.0
70,83,50,37,50,60,350,0.3360655737704918,75,55,70,55,95,110,460,0.8444444444444444,2.0
46,57,40,40,40,50,273,0.25,80,80,80,80,80,80,480,0.5606060606060606,1.0
60,60,60,35,35,30,280,0.11194029850746269,60,60,60,105,105,105,495,0.848,0.0
80,110,120,130,90,70,600,0.6198347107438017,55,40,50,65,85,40,335,0.3181818181818182,0.25
50,105,125,55,95,50,480,0.375886524822695,60,60,60,105,105,105,495,0.848,1.0
39,52,43,60,50,65,309,0.5041322314049587,30,45,59,30,39,57,260,0.2803030303030303,2.0
75,65,55,65,55,69,384,0.43548387096774194,100,100,90,150,140,90,670,0.71875,0.5
75,75,95,75,95,113,528,0.9015151515151515,75,98,63,98,63,101,498,0.8091603053435115,0.5
78,92,75,74,63,118,500,0.8842975206611571,64,51,23,51,23,28,240,0.11363636363636363,2.0
58,109,112,48,48,109,484,0.8805970149253731,90,60,70,75,70,45,410,0.23880597014925373,1.0
40,40,55,40,70,55,300,0.40939597315436244,50,35,55,25,25,15,205,0.05263157894736842,0.5
68,90,65,50,55,82,410,0.6165413533834586,105,150,90,150,90,95,680,0.8285714285714286,0.0
60,45,70,45,90,95,405,0.7304964539007093,48,61,40,61,40,50,300,0.2543859649122807,1.0
50,70,100,40,40,30,330,0.2222222222222222,65,40,70,80,140,70,465,0.5954198473282443,1.0
80,70,40,100,60,145,495,0.921875,60,52,168,47,138,30,495,0.19834710743801653,0.5
70,70,40,60,40,60,340,0.4247787610619469,78,130,111,130,85,100,634,0.8561151079136691,0.25
86,68,72,109,66,106,507,0.8099173553719008,76,25,45,67,55,24,292,0.0390625,1.0
70,60,62,80,82,60,414,0.4375,50,150,50,150,50,150,600,0.9339622641509434,2.0
70,80,65,90,65,85,455,0.578125,50,65,64,44,48,43,314,0.2196969696969697,1.0
68,165,95,65,115,110,618,0.8615384615384616,78,81,71,74,69,126,499,0.9090909090909091,0.5
45,60,32,50,32,76,295,0.5925925925925926,65,60,110,130,95,65,525,0.47761194029850745,1.0
85,70,80,97,80,123,535,0.9304347826086956,65,90,115,45,115,58,488,0.5041322314049587,2.0
40,45,65,100,120,90,460,0.5588235294117647,70,145,88,140,70,112,625,0.8888888888888888,0.5
50,180,20,180,20,150,600,0.9029850746268657,75,69,72,114,100,104,534,0.8253968253968254,0.5
255,10,10,75,135,55,540,0.3125,95,124,78,69,71,58,495,0.37398373983739835,1.0
60,30,30,36,56,50,262,0.32432432432432434,50,25,28,45,55,15,218,0.0625,1.0
84,86,88,111,101,60,530,0.4634146341463415,50,53,62,58,63,44,330,0.13709677419354838,0.25
62,77,62,50,42,65,358,0.4838709677419355,77,59,50,67,63,46,362,0.23140495867768596,0.25
70,65,65,55,55,70,380,0.5,55,85,122,58,75,99,494,0.8099173553719008,0.0
20,40,90,30,90,25,295,0.11363636363636363,38,30,41,30,41,60,240,0.2897196261682243,0.0
40,40,50,30,30,30,220,0.0873015873015873,70,70,40,60,40,60,340,0.4247787610619469,0.5
70,70,40,60,40,60,340,0.4247787610619469,75,89,85,55,65,36,405,0.29545454545454547,0.5
45,22,60,27,30,29,213,0.07518796992481203,40,40,40,70,40,20,250,0.032520325203252036,0.5
89,125,90,115,80,101,600,0.8725490196078431,95,75,80,100,110,30,490,0.24242424242424243,1.0
65,100,70,80,80,105,500,0.8666666666666667,80,90,80,130,110,110,600,0.856,0.5
25,35,70,95,55,45,325,0.16783216783216784,70,60,75,110,75,90,480,0.7165354330708661,0.5
45,25,50,25,25,35,205,0.13076923076923078,68,65,65,125,115,80,518,0.6461538461538462,2.0
65,40,70,80,140,70,465,0.5954198473282443,64,51,23,51,23,28,240,0.11363636363636363,1.0
50,65,107,105,107,86,520,0.7313432835820896,50,53,62,58,63,44,330,0.13709677419354838,4.0
45,55,45,65,45,75,330,0.5692307692307692,126,131,95,131,98,99,680,0.8294573643410853,1.0
105,130,120,45,45,40,485,0.4444444444444444,55,70,40,60,40,40,305,0.26956521739130435,2.0
75,95,95,95,95,85,540,0.6470588235294118,70,110,75,145,85,145,630,0.9444444444444444,0.5
95,85,85,65,65,35,430,0.2571428571428571,50,50,50,50,50,50,300,0.30708661417322836,1.0
45,30,40,105,50,20,290,0.031007751937984496,68,75,53,83,113,60,452,0.45384615384615384,1.0
40,45,40,62,60,60,307,0.33884297520661155,68,75,53,83,113,60,452,0.45384615384615384,0.5
70,110,180,60,60,50,530,0.4117647058823529,85,105,100,79,83,78,530,0.5869565217391305,0.5
38,35,35,65,55,50,278,0.2647058823529412,70,55,95,95,110,65,490,0.48872180451127817,0.5
45,75,37,70,55,83,365,0.6183206106870229,95,65,110,60,130,65,525,0.5275590551181102,1.0
55,40,50,65,85,40,335,0.3181818181818182,80,70,40,100,60,145,495,0.921875,1.0
110,123,65,100,65,65,528,0.5217391304347826,78,84,78,109,85,100,534,0.8646616541353384,0.25
55,104,105,94,75,52,485,0.36363636363636365,85,60,65,135,105,100,550,0.7518248175182481,2.0
80,92,65,65,80,68,450,0.4824561403508772,104,91,63,91,73,68,490,0.5118110236220472,1.0
80,70,65,80,120,100,515,0.8034188034188035,40,65,95,60,45,35,340,0.13986013986013987,0.5
95,23,48,23,48,23,260,0.046153846153846156,55,130,115,50,50,75,475,0.5982142857142857,1.0
70,85,65,105,85,120,530,0.9262295081967213,45,22,60,27,30,29,213,0.07518796992481203,0.5
83,80,75,70,70,101,479,0.8615384615384616,65,150,40,15,80,145,495,0.9663865546218487,2.0
59,74,50,35,50,35,303,0.3125,75,95,95,95,95,85,540,0.6470588235294118,1.0
95,75,110,100,80,30,490,0.15267175572519084,75,140,65,112,65,110,567,0.9140625,2.0
67,82,62,46,48,43,348,0.22033898305084745,82,121,119,69,59,71,521,0.5394736842105263,2.0
75,90,50,110,80,95,500,0.7985611510791367,45,65,34,40,34,45,263,0.2589928057553957,1.0
60,80,50,40,40,30,300,0.15328467153284672,30,40,70,70,25,60,295,0.41353383458646614,1.0
20,10,230,10,230,5,505,0.0,50,65,107,105,107,86,520,0.703125,2.0
50,75,35,70,30,40,300,0.21296296296296297,91,90,129,90,72,108,580,0.9140625,0.0
43,80,65,50,35,35,308,0.14193548387096774,86,68,72,109,66,106,507,0.8099173553719008,2.0
106,110,90,154,90,130,680,0.926829268292683,90,130,80,65,85,55,505,0.4396551724137931,1.0
95,124,78,69,71,58,495,0.37398373983739835,65,155,120,65,90,105,600,0.8677685950413223,0.25
106,110,90,154,90,130,680,0.926829268292683,76,48,48,57,62,34,325,0.11688311688311688,1.0
80,120,130,55,65,45,495,0.37037037037037035,100,100,100,100,100,100,600,0.8602941176470589,0.5
105,150,90,150,90,95,680,0.8285714285714286,100,75,115,90,115,85,580,0.6446280991735537,1.0
50,95,180,85,45,70,525,0.5298507462686567,70,140,230,60,80,50,630,0.32432432432432434,0.5
60,115,105,65,70,80,495,0.7181818181818181,64,115,65,83,63,65,455,0.5323741007194245,1.0
40,70,130,60,130,25,455,0.17355371900826447,65,130,60,75,60,75,465,0.689922480620155,0.5
103,60,126,80,126,50,545,0.36363636363636365,95,124,78,69,71,58,495,0.37398373983739835,4.0
70,45,48,60,65,35,323,0.15748031496062992,80,80,80,80,80,80,480,0.5606060606060606,1.0
60,45,70,45,90,95,405,0.7304964539007093,55,85,55,50,55,60,360,0.4233576642335766,1.0
105,140,55,30,55,95,480,0.8195488721804511,61,90,45,50,50,160,456,0.9230769230769231,2.0
60,80,50,40,40,30,300,0.15328467153284672,45,20,50,60,120,50,345,0.24074074074074073,1.0
50,53,48,53,48,64,316,0.4076923076923077,60,60,60,60,60,60,360,0.38095238095238093,1.0
55,70,45,70,50,60,350,0.45,95,75,110,100,80,30,490,0.15267175572519084,0.5
59,59,58,90,70,73,409,0.5826086956521739,100,128,90,77,77,128,600,0.959349593495935,1.0
71,95,85,110,95,79,535,0.664,80,125,75,40,95,85,500,0.6911764705882353,1.0
39,52,43,60,50,65,309,0.49107142857142855,95,145,130,120,90,120,700,0.9398496240601504,0.5
53,51,53,61,56,40,314,0.14285714285714285,50,50,77,95,77,91,440,0.5916666666666667,1.0
95,145,130,120,90,120,700,0.9398496240601504,91,129,90,72,90,108,580,0.8536585365853658,1.0
105,125,100,60,100,100,590,0.8359375,65,95,57,100,85,93,495,0.7441860465116279,1.0
75,70,90,70,105,80,490,0.656,68,165,95,65,115,110,618,0.8615384615384616,2.0
35,60,44,40,54,55,288,0.366412213740458,80,100,200,50,100,50,580,0.3472222222222222,0.5
78,84,78,109,85,100,534,0.8646616541353384,60,60,60,60,60,60,360,0.38095238095238093,1.0
55,35,50,55,110,85,390,0.6277372262773723,71,95,85,110,95,79,535,0.664,1.0
60,55,90,145,90,80,520,0.6071428571428571,40,35,30,120,70,105,400,0.6692307692307692,2.0
40,27,60,37,50,66,280,0.36220472440944884,55,70,45,70,50,60,350,0.45,0.25
111,83,68,92,82,39,475,0.1774193548387097,75,125,75,30,75,85,465,0.625,1.0
70,50,30,95,135,105,485,0.8040540540540541,70,75,80,135,80,135,575,0.917910447761194,1.0
45,80,100,35,37,28,325,0.3125,45,53,70,40,60,42,310,0.25735294117647056,1.0
90,120,75,60,60,45,450,0.29411764705882354,95,117,80,65,70,92,519,0.8409090909090909,2.0
109,66,84,81,99,32,471,0.2013888888888889,80,52,50,90,50,89,411,0.6666666666666666,0.0
101,72,72,99,89,29,462,0.1937984496124031,100,50,50,76,96,70,442,0.5,1.0
64,78,52,78,52,81,405,0.6422764227642277,53,51,53,61,56,40,314,0.14285714285714285,0.5
80,100,70,50,60,45,405,0.25806451612903225,100,120,100,150,120,90,680,0.728,1.0
70,95,125,65,75,45,475,0.33613445378151263,60,85,40,30,45,68,328,0.6422018348623854,0.5
64,78,52,78,52,81,405,0.6422764227642277,150,160,100,95,65,100,670,0.8866666666666667,2.0
70,60,62,80,82,60,414,0.4375,100,150,110,95,110,70,635,0.5923076923076923,1.0
55,85,55,50,55,60,360,0.4233576642335766,75,80,95,90,100,50,490,0.2158273381294964,4.0
60,25,35,70,80,60,330,0.3076923076923077,80,50,100,100,200,50,580,0.2357142857142857,1.0
65,150,40,15,80,145,495,0.9663865546218487,70,85,140,85,70,20,470,0.272,0.5
100,100,80,60,60,50,450,0.3050847457627119,50,50,40,30,30,50,250,0.2781954887218045,1.0
72,95,67,103,71,122,530,0.9606299212598425,55,50,40,40,40,75,300,0.5945945945945946,1.0
83,106,65,86,65,85,490,0.6640625,106,90,130,90,154,110,680,0.8699186991869918,0.25
80,52,50,90,50,89,411,0.6666666666666666,55,75,60,75,60,103,428,0.7982456140350878,0.25
100,100,100,100,100,100,600,0.831858407079646,50,95,90,95,90,180,600,0.9172413793103448,0.5
74,108,133,83,65,32,495,0.32142857142857145,60,65,60,130,75,110,500,0.7719298245614035,1.0
75,85,200,55,65,30,510,0.16778523489932887,50,45,45,35,35,50,260,0.23529411764705882,1.0
90,30,15,40,20,15,210,0.043478260869565216,70,55,65,95,85,70,440,0.5307692307692308,0.5
75,100,110,45,55,65,450,0.5333333333333333,70,110,180,60,60,50,530,0.4117647058823529,4.0
49,55,42,42,37,85,310,0.6068376068376068,50,64,50,45,50,41,300,0.22727272727272727,0.5
35,70,55,45,55,25,285,0.09420289855072464,41,56,40,62,44,71,314,0.568,2.0
62,55,52,109,94,109,481,0.7833333333333333,65,63,45,45,45,45,308,0.2595419847328244,1.0
60,59,85,79,105,36,424,0.16666666666666666,60,65,80,170,95,130,600,0.8625954198473282,0.125
60,62,80,63,80,60,405,0.4336283185840708,20,10,230,10,230,5,505,0.0,1.0
100,180,160,150,90,90,770,0.7520661157024794,45,50,45,115,55,95,405,0.6936936936936937,2.0
75,89,85,55,65,36,405,0.29545454545454547,70,83,50,37,50,60,350,0.3360655737704918,0.5
50,47,50,57,50,65,319,0.463768115942029,60,110,70,60,60,100,460,0.8461538461538461,1.0
50,75,45,40,45,60,315,0.4380165289256198,110,135,60,50,65,88,508,0.7744360902255639,0.5
40,55,99,40,79,47,360,0.26262626262626265,65,83,57,95,85,105,490,0.8914728682170543,1.0
60,67,85,77,75,116,480,0.8888888888888888,70,70,40,60,40,60,340,0.4247787610619469,1.0
55,45,45,25,25,15,210,0.048,70,55,95,95,110,65,490,0.48872180451127817,1.0
60,110,70,60,60,100,460,0.8461538461538461,50,85,40,85,40,35,335,0.1746031746031746,2.0
45,22,60,27,30,29,213,0.07518796992481203,40,30,50,55,55,100,330,0.584070796460177,1.0
74,48,76,83,81,104,466,0.7322834645669292,50,40,85,40,65,25,305,0.08870967741935484,1.0
60,65,80,170,95,130,600,0.8625954198473282,10,55,25,35,45,95,265,0.5396825396825397,0.5
44,50,91,24,86,10,305,0.1981981981981982,70,60,75,110,75,90,480,0.7165354330708661,0.5
41,64,45,50,50,50,300,0.36752136752136755,60,48,45,43,90,42,328,0.21897810218978103,1.0
50,95,95,35,110,70,455,0.5179856115107914,30,40,55,40,55,60,280,0.3237410071942446,0.5
40,35,30,20,20,50,195,0.23423423423423423,100,73,83,73,83,55,467,0.371900826446281,0.25
38,36,38,32,36,57,237,0.3893805309734513,35,60,44,40,54,55,288,0.366412213740458,1.0
160,110,65,65,110,30,540,0.35714285714285715,50,53,48,53,48,64,316,0.358974358974359,1.0
50,52,48,65,50,55,320,0.33098591549295775,67,58,57,81,67,101,431,0.8790322580645161,1.0
50,20,55,25,25,30,205,0.09774436090225563,70,45,48,60,65,35,323,0.15748031496062992,0.5
60,79,105,59,85,36,424,0.17054263565891473,70,100,70,105,75,40,460,0.23214285714285715,1.0
75,95,60,65,60,115,470,0.8778625954198473,58,109,112,48,48,109,484,0.8805970149253731,0.5
67,82,62,46,48,43,348,0.22033898305084745,35,60,44,40,54,55,288,0.366412213740458,0.5
65,65,45,75,45,95,390,0.72,65,136,94,54,96,135,580,0.9612403100775194,1.0
90,75,75,90,100,70,500,0.5462184873949579,75,98,63,98,63,101,498,0.889763779527559,2.0
110,85,95,80,95,50,515,0.2713178294573643,95,75,110,100,80,30,490,0.15267175572519084,1.0
57,80,91,80,87,75,470,0.5737704918032787,65,75,90,97,123,44,494,0.1987179487179487,1.0
77,120,90,60,90,48,485,0.2785714285714286,100,90,130,45,65,55,485,0.4253731343283582,1.0
45,75,37,70,55,83,365,0.6183206106870229,45,49,65,49,65,45,318,0.275,2.0
90,90,85,125,90,100,580,0.768595041322314,45,30,15,85,65,65,305,0.36220472440944884,1.0
20,25,45,70,90,60,310,0.30833333333333335,80,110,120,130,90,70,600,0.6198347107438017,0.5
75,80,85,110,90,50,490,0.3548387096774194,60,40,50,75,85,95,405,0.6044776119402985,1.0
60,80,50,40,40,30,300,0.15328467153284672,111,83,68,92,82,39,475,0.1774193548387097,1.0
43,70,48,50,60,38,309,0.2391304347826087,90,50,34,60,44,70,348,0.6283185840707964,1.0
190,33,58,33,58,33,405,0.13432835820895522,60,85,60,50,50,125,430,0.9090909090909091,1.0
95,117,184,44,46,28,514,0.2975206611570248,70,95,125,65,75,45,475,0.33613445378151263,1.0
65,75,70,95,70,95,470,0.7272727272727273,100,100,90,150,140,90,670,0.71875,1.0
55,85,122,58,75,99,494,0.8099173553719008,45,20,50,60,120,50,345,0.24074074074074073,1.0
100,77,77,128,128,90,600,0.6901408450704225,55,40,40,65,45,35,280,0.16428571428571428,1.0
65,136,94,54,96,135,580,0.9612403100775194,70,85,70,60,70,50,405,0.28378378378378377,1.0
30,56,35,25,35,72,253,0.48148148148148145,90,92,75,92,85,60,494,0.49586776859504134,1.0
50,120,53,35,110,87,455,0.640625,109,66,84,81,99,32,471,0.2013888888888889,1.0
65,65,65,50,50,90,385,0.72,64,78,52,78,52,81,405,0.6422764227642277,2.0
60,62,80,63,80,60,405,0.4336283185840708,64,115,65,83,63,65,455,0.5323741007194245,1.0
55,68,64,45,55,31,318,0.11666666666666667,135,85,40,40,85,5,390,0.6864406779661016,1.0
37,25,41,25,41,25,194,0.08870967741935484,65,150,40,15,80,145,495,0.9663865546218487,0.5
74,48,76,83,81,104,466,0.7913043478260869,20,40,90,30,90,25,295,0.11363636363636363,1.0
86,92,88,68,75,73,482,0.6835443037974683,70,85,70,60,70,50,405,0.28378378378378377,2.0
108,130,95,80,85,102,600,0.7637795275590551,38,35,40,27,25,35,200,0.08208955223880597,0.5
75,75,60,83,60,60,413,0.39344262295081966,95,65,110,60,130,65,525,0.5275590551181102,1.0
70,43,53,43,53,40,302,0.19090909090909092,60,85,49,60,49,60,363,0.4444444444444444,1.0
40,40,55,40,70,55,300,0.40939597315436244,88,107,122,74,75,64,530,0.4596774193548387,0.5
45,75,37,70,55,83,365,0.6183206106870229,65,90,122,58,75,84,494,0.71875,2.0
89,124,80,55,80,55,483,0.5714285714285714,60,50,50,60,70,50,340,0.28346456692913385,0.5
75,140,65,112,65,110,567,0.9140625,80,160,80,130,80,100,630,0.8455284552845529,2.0
50,50,62,40,62,65,329,0.4188034188034188,75,85,200,55,65,30,510,0.16778523489932887,0.0
100,100,100,100,100,100,600,0.8345864661654135,115,115,85,90,75,100,580,0.8134328358208955,0.5
38,41,40,50,65,65,299,0.4108527131782946,95,65,65,110,130,60,525,0.4016393442622951,1.0
55,55,50,45,65,55,325,0.37373737373737376,45,90,20,65,20,65,305,0.5116279069767442,1.0
75,98,63,98,63,101,498,0.849624060150376,73,76,75,81,100,100,505,0.8110236220472441,2.0
35,80,50,50,70,120,405,0.84375,40,27,60,37,50,66,280,0.36220472440944884,0.5
55,66,44,44,56,85,350,0.6888888888888889,71,82,64,64,59,112,452,0.9327731092436975,1.0
70,140,70,110,65,105,560,0.95,80,100,123,122,120,80,625,0.56,0.5
70,83,50,37,50,60,350,0.3360655737704918,74,48,76,83,81,104,466,0.7913043478260869,1.0
108,100,121,81,95,95,600,0.7476635514018691,65,65,45,75,45,95,390,0.72,0.0
20,40,90,30,90,25,295,0.11363636363636363,60,90,70,60,120,40,440,0.27419354838709675,0.0
50,150,50,150,50,150,600,0.9339622641509434,50,65,107,105,107,86,520,0.7313432835820896,1.0
80,82,83,100,100,80,525,0.6742424242424242,60,100,89,55,69,112,485,0.9298245614035088,0.125
50,60,60,60,60,30,320,0.11290322580645161,30,30,42,30,42,70,244,0.4230769230769231,1.0
45,30,50,55,65,45,290,0.208,90,70,80,70,95,70,475,0.5190839694656488,1.0
70,110,80,55,80,105,500,0.8794326241134752,97,165,60,65,50,58,495,0.3902439024390244,0.5
50,50,120,80,80,30,410,0.07258064516129033,40,45,35,40,40,90,290,0.65,1.0
90,70,80,70,95,70,475,0.5190839694656488,126,131,95,131,98,99,680,0.8294573643410853,1.0
85,120,70,50,60,100,485,0.8308823529411765,76,25,45,67,55,24,292,0.0390625,1.0
66,41,77,61,87,23,355,0.12096774193548387,50,50,50,50,50,50,300,0.30708661417322836,2.0
135,85,40,40,85,5,390,0.6864406779661016,95,60,79,100,125,81,540,0.6201550387596899,1.0
100,150,120,120,100,90,680,0.6493506493506493,120,120,120,120,120,120,720,0.9344262295081968,1.0
89,124,80,55,80,55,483,0.5714285714285714,100,100,125,110,50,50,535,0.384,0.5
30,80,90,55,45,55,355,0.4295774647887324,50,53,48,53,48,64,316,0.358974358974359,0.5
70,20,50,20,50,40,250,0.1557377049180328,108,170,115,120,95,92,700,0.7083333333333334,2.0
50,65,107,105,107,86,520,0.7313432835820896,109,66,84,81,99,32,471,0.2013888888888889,0.0
95,135,80,110,80,100,600,0.8248175182481752,49,66,70,44,55,51,335,0.4260869565217391,2.0
60,55,50,40,55,45,305,0.22377622377622378,40,45,65,100,120,90,460,0.5588235294117647,2.0
70,65,60,90,75,90,450,0.6571428571428571,40,45,40,35,35,56,251,0.373015873015873,0.5
45,50,35,55,75,40,300,0.21367521367521367,90,92,87,75,85,76,505,0.5409836065573771,1.0
50,47,50,57,50,65,319,0.463768115942029,110,130,80,70,60,80,530,0.5862068965517241,0.0
50,92,108,92,108,35,485,0.2457627118644068,65,65,65,50,50,90,385,0.72,1.0
42,52,67,39,56,50,306,0.2868217054263566,80,145,150,105,110,110,700,0.8692307692307693,0.5
80,100,70,50,60,45,405,0.25806451612903225,75,75,75,125,95,40,485,0.15671641791044777,0.5
66,65,48,62,57,52,350,0.36220472440944884,85,80,90,105,95,60,515,0.49074074074074076,1.0
45,25,50,25,25,35,205,0.13076923076923078,60,60,75,60,75,80,410,0.7321428571428571,1.0
38,30,41,30,41,60,240,0.2897196261682243,59,74,50,35,50,35,303,0.3125,0.0
40,30,35,50,70,55,280,0.28205128205128205,38,30,41,30,41,60,240,0.2897196261682243,1.0
76,104,71,104,71,108,534,0.912751677852349,75,100,66,60,66,115,482,0.918918918918919,2.0
55,50,45,135,95,120,500,0.7714285714285715,70,90,110,60,75,95,500,0.7333333333333333,0.0
68,90,65,50,55,82,410,0.6165413533834586,50,48,43,46,41,60,288,0.47297297297297297,1.0
80,70,65,80,120,100,515,0.8034188034188035,86,81,97,81,107,43,495,0.203125,1.0
60,85,69,60,69,77,420,0.518796992481203,45,50,35,55,75,40,300,0.21367521367521367,1.0
86,81,97,81,107,43,495,0.203125,65,65,60,130,95,110,525,0.823943661971831,1.0
69,69,76,69,86,91,460,0.6554621848739496,106,190,100,154,100,130,780,0.9259259259259259,1.0
95,65,110,60,130,65,525,0.5275590551181102,91,129,90,72,90,108,580,0.8536585365853658,0.5
79,100,80,110,90,121,580,0.968,60,70,65,125,105,90,515,0.6911764705882353,2.0
70,84,70,65,70,51,410,0.2949640287769784,80,82,78,95,80,85,500,0.6869565217391305,1.0
38,30,85,55,65,30,303,0.21428571428571427,70,45,48,60,65,35,323,0.15748031496062992,1.0
68,90,65,50,55,82,410,0.6165413533834586,50,160,110,160,110,110,700,0.8854961832061069,0.0
135,85,40,40,85,5,390,0.6864406779661016,65,80,65,35,65,60,370,0.38405797101449274,1.0
70,40,50,55,50,25,290,0.061068702290076333,170,90,45,90,45,60,500,0.427536231884058,0.25
90,92,75,92,85,60,494,0.49586776859504134,50,64,50,45,50,41,300,0.22727272727272727,8.0
50,35,55,25,25,15,205,0.05263157894736842,70,95,125,65,75,45,475,0.33613445378151263,1.0
100,90,130,45,65,55,485,0.4253731343283582,40,45,40,65,40,65,295,0.5661764705882353,1.0
30,42,118,42,88,30,350,0.112,35,40,100,90,55,35,355,0.1796875,1.0
63,63,47,41,41,74,329,0.56,55,75,85,25,25,15,280,0.1875,0.5
55,70,40,60,40,40,305,0.26956521739130435,50,92,108,92,108,35,485,0.2457627118644068,1.0
55,50,65,175,95,150,590,0.7818181818181819,56,61,65,48,45,38,313,0.17567567567567569,1.0
100,150,140,100,90,90,670,0.7969924812030075,35,20,65,40,65,20,245,0.02459016393442623,1.0
39,52,43,60,50,65,309,0.49107142857142855,100,100,100,100,100,100,600,0.8758169934640523,2.0
68,85,65,165,135,100,618,0.8083333333333333,50,65,45,85,65,95,405,0.7238095238095238,1.0
80,80,80,55,55,90,440,0.6417910447761194,65,155,120,65,90,105,600,0.8677685950413223,1.0
68,125,65,65,115,80,518,0.6277372262773723,90,75,85,115,90,55,510,0.3445378151260504,1.0
65,75,105,35,65,85,430,0.6940298507462687,75,90,50,110,80,95,500,0.7985611510791367,2.0
50,20,55,25,25,30,205,0.09774436090225563,75,90,50,110,80,95,500,0.7985611510791367,1.0
77,59,50,67,63,46,362,0.23140495867768596,40,20,30,40,80,55,265,0.22764227642276422,8.0
50,40,85,40,65,25,305,0.08870967741935484,75,98,63,98,63,101,498,0.8091603053435115,2.0
60,50,40,85,75,95,405,0.7540983606557377,83,80,75,70,70,101,479,0.8615384615384616,2.0
95,135,80,110,80,100,600,0.8248175182481752,95,75,110,100,80,30,490,0.15267175572519084,1.0
73,100,60,100,60,65,458,0.42657342657342656,50,65,107,105,107,86,520,0.7313432835820896,2.0
38,30,41,30,41,60,240,0.2897196261682243,40,30,35,45,40,55,245,0.31496062992125984,1.0
50,20,40,20,40,20,190,0.0962962962962963,70,110,70,115,70,90,525,0.75,0.5
100,150,90,180,160,90,770,0.7348484848484849,50,65,107,105,107,86,520,0.7758620689655172,0.5
45,40,60,40,75,50,310,0.2926829268292683,85,80,70,135,75,90,535,0.7006802721088435,1.0
60,60,60,85,85,85,435,0.631578947368421,53,51,53,61,56,40,314,0.14285714285714285,1.0
65,150,60,115,60,115,565,0.935251798561151,70,110,180,60,60,50,530,0.4117647058823529,1.0
75,80,60,65,90,102,472,0.8625954198473282,100,110,90,85,90,60,535,0.47794117647058826,1.0
50,50,150,50,150,50,500,0.2571428571428571,70,120,40,95,40,95,460,0.8106060606060606,2.0
65,63,45,45,45,45,308,0.2595419847328244,40,40,50,30,30,30,220,0.0873015873015873,2.0
100,120,100,150,120,90,680,0.728,35,46,34,35,45,20,215,0.072,1.0
80,120,79,95,79,70,523,0.5833333333333334,75,100,66,60,66,115,482,0.918918918918919,1.0
65,70,60,65,65,115,440,0.8583333333333333,95,155,109,70,130,81,640,0.6788321167883211,1.0
45,45,55,45,55,63,308,0.4594594594594595,50,85,125,85,115,20,480,0.4306569343065693,1.0
60,69,95,69,95,36,424,0.2608695652173913,79,85,60,55,60,71,410,0.60431654676259,0.5
71,73,88,120,89,59,500,0.43537414965986393,40,35,30,20,20,50,195,0.23423423423423423,1.0
40,35,30,20,20,50,195,0.23423423423423423,75,140,65,112,65,110,567,0.9140625,0.25
20,10,55,15,20,80,200,0.17985611510791366,60,80,95,70,85,50,440,0.2231404958677686,1.0
65,90,50,85,45,55,390,0.371900826446281,78,84,78,109,85,100,534,0.8646616541353384,0.25
120,120,120,120,120,120,720,0.9344262295081968,74,100,72,90,72,46,454,0.24561403508771928,1.0
77,120,90,60,90,48,485,0.2785714285714286,85,105,100,79,83,78,530,0.5869565217391305,1.0
90,132,105,132,105,30,594,0.4246575342465753,125,120,90,170,100,95,700,0.78125,0.5
60,40,80,60,45,40,325,0.23529411764705882,50,100,150,100,150,50,600,0.37142857142857144,2.0
45,40,60,40,75,50,310,0.2926829268292683,70,62,67,55,55,56,365,0.38513513513513514,1.0
100,150,140,100,90,90,670,0.7969924812030075,65,75,105,35,65,85,430,0.6940298507462687,0.0
55,40,85,80,105,40,405,0.23622047244094488,65,65,45,75,45,95,390,0.72,2.0
95,75,80,100,110,30,490,0.24242424242424243,60,85,49,60,49,60,363,0.4444444444444444,1.0
95,60,79,100,125,81,540,0.6201550387596899,60,60,60,60,60,60,360,0.38095238095238093,1.0
110,85,95,80,95,50,515,0.2713178294573643,85,135,130,60,80,25,515,0.40540540540540543,0.5
110,85,95,80,95,50,515,0.2713178294573643,103,93,67,71,61,84,479,0.7142857142857143,1.0
50,40,85,40,65,25,305,0.08870967741935484,68,165,95,65,115,110,618,0.8615384615384616,1.0
60,90,55,90,80,110,485,0.8677685950413223,50,20,55,25,25,30,205,0.09774436090225563,1.0
64,115,65,83,63,65,455,0.5323741007194245,45,67,60,35,50,63,320,0.5128205128205128,1.0
60,25,35,70,80,60,330,0.3076923076923077,90,30,15,40,20,15,210,0.043478260869565216,1.0
36,50,50,65,60,44,305,0.16363636363636364,65,110,130,60,65,95,525,0.8278145695364238,2.0
41,50,37,50,37,66,281,0.5175438596491229,66,65,48,62,57,52,350,0.36220472440944884,1.0
70,120,65,45,85,125,510,0.9747899159663865,110,135,60,50,65,88,508,0.7744360902255639,1.0
64,51,23,51,23,28,240,0.11363636363636363,70,150,140,65,100,75,600,0.55,0.5
74,94,131,54,116,20,489,0.4485294117647059,60,80,50,50,50,40,330,0.23853211009174313,1.0
70,90,70,60,60,70,420,0.6390977443609023,72,60,30,20,30,25,237,0.11570247933884298,0.5
62,44,50,44,50,55,305,0.3629032258064516,44,38,39,61,79,42,303,0.2251655629139073,1.0
100,150,120,120,100,90,680,0.6493506493506493,95,109,105,75,85,56,525,0.34513274336283184,0.0
50,65,107,105,107,86,520,0.703125,89,124,80,55,80,55,483,0.5714285714285714,0.0
62,48,66,59,57,49,341,0.33884297520661155,25,20,15,105,55,90,310,0.32407407407407407,1.0
40,65,95,60,45,35,340,0.13986013986013987,110,78,73,76,71,60,468,0.3333333333333333,0.5
50,65,107,105,107,86,520,0.7313432835820896,40,35,30,20,20,50,195,0.23423423423423423,0.25
74,94,131,54,116,20,489,0.4485294117647059,50,95,180,85,45,70,525,0.5298507462686567,2.0
30,45,59,30,39,57,260,0.2803030303030303,165,75,80,40,45,65,470,0.5151515151515151,1.0
70,100,70,105,75,40,460,0.23214285714285715,38,30,85,55,65,30,303,0.21428571428571427,1.0
108,112,118,68,72,47,525,0.2916666666666667,100,77,77,128,128,90,600,0.6901408450704225,1.0
75,80,85,110,90,50,490,0.3548387096774194,66,65,48,62,57,52,350,0.36220472440944884,1.0
115,115,85,90,75,100,580,0.8134328358208955,40,30,35,45,40,55,245,0.31496062992125984,0.5
45,22,60,27,30,29,213,0.07518796992481203,95,110,80,70,80,50,485,0.37209302325581395,1.0
84,86,88,111,101,60,530,0.4634146341463415,100,100,100,100,100,100,600,0.8758169934640523,0.5
50,20,55,25,25,30,205,0.09774436090225563,40,65,95,60,45,35,340,0.13986013986013987,0.5
50,105,125,55,95,50,480,0.375886524822695,79,100,80,110,90,121,580,0.968,1.0
38,35,40,27,25,35,200,0.08208955223880597,91,129,90,72,90,108,580,0.8536585365853658,0.5
90,110,80,100,80,95,555,0.7982456140350878,55,20,35,20,45,75,250,0.37681159420289856,1.0
50,105,125,55,95,50,480,0.375886524822695,105,150,90,150,90,95,680,0.8285714285714286,2.0
75,80,60,65,90,102,472,0.8625954198473282,40,70,40,35,40,60,285,0.392,1.0
106,110,90,154,90,130,680,0.926829268292683,100,103,75,120,75,127,600,0.940677966101695,1.0
62,50,58,73,54,72,369,0.4435483870967742,70,90,70,60,60,70,420,0.6390977443609023,1.0
40,70,130,60,130,25,455,0.17355371900826447,35,70,55,45,55,25,285,0.09420289855072464,1.0
76,25,45,67,55,24,292,0.0390625,60,50,100,85,70,65,430,0.47580645161290325,1.0
60,60,60,35,35,30,280,0.11194029850746269,62,50,58,73,54,72,369,0.4435483870967742,1.0
106,110,90,154,90,130,680,0.926829268292683,60,82,45,45,45,74,351,0.5752212389380531,0.0
70,80,65,90,65,85,455,0.578125,70,150,140,65,100,75,600,0.55,0.25
70,83,50,37,50,60,350,0.3360655737704918,50,160,110,160,110,110,700,0.8854961832061069,0.25
90,50,34,60,44,70,348,0.6283185840707964,40,30,30,40,50,30,220,0.07936507936507936,2.0
70,130,100,55,80,65,500,0.608,50,75,35,70,30,40,300,0.21296296296296297,1.0
30,80,90,55,45,55,355,0.4295774647887324,50,65,64,44,48,43,314,0.2196969696969697,0.5
60,45,70,75,85,55,390,0.3008130081300813,80,110,60,150,130,70,600,0.5042016806722689,0.5
55,95,55,35,75,115,430,0.9380530973451328,75,125,75,30,75,85,465,0.625,0.5
85,60,65,135,105,100,550,0.7518248175182481,190,33,58,33,58,33,405,0.13432835820895522,2.0
65,40,70,80,140,70,465,0.5954198473282443,54,45,47,75,98,52,371,0.39669421487603307,1.0
75,65,55,65,55,69,384,0.43548387096774194,115,45,20,45,25,20,270,0.11538461538461539,1.0
40,30,30,55,30,85,270,0.4666666666666667,75,95,60,65,60,115,470,0.8778625954198473,1.0
20,10,55,15,20,80,200,0.17985611510791366,100,100,100,100,100,100,600,0.8758169934640523,1.0
20,10,55,15,20,80,200,0.17985611510791366,90,120,120,60,60,50,500,0.35294117647058826,2.0
62,48,66,59,57,49,341,0.33884297520661155,75,98,63,98,63,101,498,0.889763779527559,0.5
105,140,55,30,55,95,480,0.8195488721804511,75,80,95,90,100,50,490,0.2158273381294964,2.0
90,100,60,90,60,80,480,0.6422764227642277,63,60,55,50,50,71,349,0.5289256198347108,0.5
50,70,160,70,160,90,600,0.7417218543046358,60,50,70,80,80,140,480,0.8449612403100775,1.0
95,155,109,70,130,81,640,0.6788321167883211,80,100,80,80,80,100,520,0.9051724137931034,1.0
100,100,100,100,100,100,600,0.8345864661654135,70,62,67,55,55,56,365,0.38513513513513514,1.0
70,115,60,115,60,55,475,0.4647887323943662,70,60,125,115,70,55,495,0.35507246376811596,4.0
35,46,34,35,45,20,215,0.072,50,105,125,55,95,50,480,0.375886524822695,0.5
72,60,30,20,30,25,237,0.11570247933884298,60,40,50,75,85,95,405,0.6044776119402985,1.0
80,52,50,90,50,89,411,0.6666666666666666,65,75,105,35,65,85,430,0.6940298507462687,0.5
50,92,108,92,108,35,485,0.2457627118644068,90,75,85,115,90,55,510,0.3445378151260504,1.0
75,75,95,75,95,113,528,0.9015151515151515,66,41,77,61,87,23,355,0.12096774193548387,1.0
100,150,120,120,100,90,680,0.6493506493506493,45,95,50,40,50,75,355,0.54,1.0
65,105,60,60,70,95,455,63.0,55,95,115,45,45,35,390,0.2116788321167883,2.0
80,70,65,80,120,100,515,0.8034188034188035,46,57,40,40,40,50,273,0.25,0.5
75,95,95,95,95,85,540,0.6470588235294118,91,129,90,72,90,108,580,0.8536585365853658,2.0
70,40,50,55,50,25,290,0.061068702290076333,45,35,45,62,53,35,275,0.11851851851851852,1.0
59,74,50,35,50,35,303,0.3125,30,30,42,30,42,70,244,0.4230769230769231,0.0
91,90,72,90,129,108,580,0.896,70,92,65,80,55,98,460,0.8090909090909091,2.0
70,130,100,55,80,65,500,0.608,50,40,85,40,65,25,305,0.08870967741935484,1.0
80,100,80,80,80,100,520,0.9051724137931034,74,48,76,83,81,104,466,0.7913043478260869,1.0
80,120,130,55,65,45,495,0.37037037037037035,30,45,59,30,39,57,260,0.2803030303030303,2.0
60,85,49,60,49,60,363,0.4444444444444444,45,30,40,105,50,20,290,0.031007751937984496,1.0
20,40,90,30,90,25,295,0.11363636363636363,170,90,45,90,45,60,500,0.427536231884058,1.0
68,90,65,50,55,82,410,0.6165413533834586,45,30,15,85,65,65,305,0.36220472440944884,1.0
38,30,41,30,41,60,240,0.2897196261682243,62,73,55,56,52,84,382,0.7244094488188977,1.0
70,90,70,60,60,70,420,0.6390977443609023,80,100,123,122,120,80,625,0.56,1.0
80,120,79,95,79,70,523,0.5833333333333334,70,60,62,80,82,60,414,0.4375,2.0
80,75,150,75,150,50,580,0.30973451327433627,65,50,70,95,80,65,425,0.4262295081967213,1.0
45,49,65,49,65,45,318,0.275,60,110,70,60,60,100,460,0.8461538461538461,0.5
45,90,20,65,20,65,305,0.5116279069767442,116,55,85,107,95,29,487,0.06818181818181818,2.0
46,57,40,40,40,50,273,0.25,61,72,57,55,55,65,365,0.3984375,0.5
75,95,67,125,95,83,540,0.7117117117117117,50,70,160,70,160,90,600,0.7417218543046358,1.0
40,45,35,30,40,55,245,0.3793103448275862,40,45,35,40,40,90,290,0.65,1.0
101,72,72,99,89,29,462,0.1937984496124031,63,63,47,41,41,74,329,0.56,1.0
75,125,100,70,80,45,495,0.33035714285714285,190,33,58,33,58,33,405,0.13432835820895522,2.0
92,105,90,125,90,98,600,0.8217054263565892,65,60,110,130,95,65,525,0.47761194029850745,1.0
55,95,115,45,45,35,390,0.2116788321167883,91,90,106,130,106,77,600,0.648854961832061,4.0
58,64,58,80,65,80,405,0.609271523178808,55,65,95,95,45,85,440,0.6610169491525424,0.5
60,52,168,47,138,30,495,0.19834710743801653,80,110,120,130,90,70,600,0.6198347107438017,0.5
95,117,184,44,46,28,514,0.2975206611570248,60,40,60,95,60,55,370,0.4222222222222222,0.5
78,130,111,130,85,100,634,0.8561151079136691,65,65,60,110,95,130,525,0.9253731343283582,1.0
49,49,56,49,61,66,330,0.5190839694656488,190,33,58,33,58,33,405,0.13432835820895522,1.0
70,92,65,80,55,98,460,0.8090909090909091,85,105,55,85,50,115,495,0.9032258064516129,0.5
50,65,107,105,107,86,520,0.6991150442477876,73,115,60,60,60,90,458,0.6694915254237288,1.0
65,47,55,73,75,85,400,0.65,45,20,50,60,120,50,345,0.24074074074074073,0.5
40,40,50,30,30,30,220,0.0873015873015873,78,130,111,130,85,100,634,0.8561151079136691,0.25
60,55,50,40,55,45,305,0.22377622377622378,70,77,60,97,60,108,472,0.8394160583941606,1.0
65,155,120,65,90,105,600,0.8677685950413223,86,76,86,116,56,95,515,0.7982456140350878,1.0
75,80,55,25,35,35,305,0.18666666666666668,57,24,86,24,86,23,300,0.12727272727272726,1.0
80,75,150,75,150,50,580,0.30973451327433627,80,100,200,50,100,50,580,0.3472222222222222,2.0
45,85,50,55,50,65,350,0.5076923076923077,80,70,70,90,100,70,480,0.5609756097560976,1.0
70,45,48,60,65,35,323,0.15748031496062992,60,70,50,100,50,65,395,0.5217391304347826,1.0
73,76,75,81,100,100,505,0.8110236220472441,108,112,118,68,72,47,525,0.2916666666666667,1.0
40,80,100,30,30,20,300,0.11851851851851852,80,80,90,110,130,110,600,0.8721804511278195,1.0
83,80,75,70,70,101,479,0.8615384615384616,65,75,90,97,123,44,494,0.1987179487179487,1.0
65,125,100,60,70,70,490,0.6099290780141844,45,20,50,60,120,50,345,0.24074074074074073,0.5
105,180,100,180,100,115,780,0.9477611940298507,106,150,70,194,120,140,780,0.952,1.0
50,50,50,50,50,50,300,0.30708661417322836,75,100,66,60,66,115,482,0.918918918918919,1.0
64,88,50,88,50,106,446,0.9111111111111111,72,105,115,54,86,68,500,0.5149253731343284,1.0
50,75,70,35,70,48,348,0.29357798165137616,60,60,50,40,50,75,335,0.5882352941176471,2.0
115,45,20,45,25,20,270,0.11538461538461539,62,48,54,63,60,68,355,0.5178571428571429,1.0
125,58,58,76,76,67,460,0.515625,110,160,110,80,110,100,670,0.8591549295774648,1.0
70,100,115,30,65,30,410,0.24390243902439024,58,109,112,48,48,109,484,0.8805970149253731,1.0
95,100,85,108,70,70,528,0.5652173913043478,63,120,85,90,55,55,468,0.2809917355371901,0.5
75,69,72,114,100,104,534,0.8253968253968254,60,60,60,35,35,30,280,0.11194029850746269,1.0
40,30,35,45,40,55,245,0.31496062992125984,64,115,65,83,63,65,455,0.5323741007194245,1.0
1,90,45,30,30,40,236,0.33064516129032256,59,110,150,45,49,35,448,0.3333333333333333,0.5
65,85,70,75,70,40,405,0.203125,55,50,45,135,95,120,500,0.7714285714285715,1.0
108,130,95,80,85,102,600,0.7637795275590551,95,135,80,110,80,100,600,0.8248175182481752,0.0
70,100,115,30,65,30,410,0.24390243902439024,54,78,103,53,45,22,355,0.23255813953488372,1.0
50,47,50,57,50,65,319,0.463768115942029,75,80,55,25,35,35,305,0.18666666666666668,0.5
30,80,90,55,45,55,355,0.4295774647887324,95,110,80,70,80,50,485,0.37209302325581395,2.0
99,68,83,72,87,51,460,0.417910447761194,70,115,60,115,60,55,475,0.4647887323943662,1.0
165,75,80,40,45,65,470,0.5151515151515151,50,52,48,65,50,55,320,0.33098591549295775,0.5
50,50,95,40,50,35,320,0.20279720279720279,65,65,65,50,50,90,385,0.72,1.0
97,165,60,65,50,58,495,0.3902439024390244,55,40,50,65,85,40,335,0.3181818181818182,1.0
77,59,50,67,63,46,362,0.23140495867768596,59,63,80,65,80,58,405,0.41843971631205673,0.5
55,40,40,65,45,35,280,0.16428571428571428,150,120,100,120,100,90,680,0.664179104477612,0.5
82,80,86,85,75,72,480,0.6183206106870229,49,55,42,42,37,85,310,0.6068376068376068,1.0
45,95,50,40,50,75,355,0.54,48,72,48,72,48,48,336,0.25984251968503935,2.0
90,55,75,60,75,30,385,0.13970588235294118,65,65,65,50,50,90,385,0.72,1.0
50,50,95,40,50,35,320,0.20279720279720279,65,80,80,59,63,58,405,0.4411764705882353,1.0
58,64,58,80,65,80,405,0.609271523178808,45,30,15,85,65,65,305,0.36220472440944884,2.0
55,65,95,95,45,85,440,0.6610169491525424,75,95,60,65,60,115,470,0.8778625954198473,1.0
70,135,105,60,105,20,495,0.5806451612903226,46,57,40,40,40,50,273,0.25,0.5
86,81,97,81,107,43,495,0.203125,67,82,62,46,48,43,348,0.22033898305084745,0.5
75,80,70,65,75,90,455,0.7578125,95,109,105,75,85,56,525,0.34513274336283184,2.0
106,190,100,154,100,130,780,0.9259259259259259,85,70,80,97,80,123,535,0.9304347826086956,0.5
80,160,60,170,130,80,680,0.6180555555555556,65,73,55,47,75,85,400,0.6846846846846847,1.0
65,125,100,60,70,70,490,0.6099290780141844,70,84,70,65,70,51,410,0.2949640287769784,2.0
67,57,55,77,55,114,425,0.8879310344827587,106,130,90,110,154,90,680,0.719626168224299,1.0
105,150,90,150,90,95,680,0.8285714285714286,150,120,100,120,100,90,680,0.664179104477612,2.0
75,87,63,87,63,98,473,0.865546218487395,76,147,90,60,70,97,540,0.8267716535433071,0.5
60,105,60,120,60,105,510,0.8849557522123894,65,40,70,80,140,70,465,0.5954198473282443,1.0
100,75,115,90,115,85,580,0.6446280991735537,30,45,135,45,90,30,375,0.09285714285714286,2.0
40,45,65,100,120,90,460,0.5588235294117647,70,80,102,80,102,40,474,0.2677165354330709,1.0
45,75,37,70,55,83,365,0.6183206106870229,62,48,66,59,57,49,341,0.33884297520661155,1.0
40,55,80,35,60,30,300,0.15037593984962405,75,95,60,65,60,115,470,0.8778625954198473,1.0
60,60,60,35,35,30,280,0.11194029850746269,55,45,50,45,65,80,340,0.5546218487394958,1.0
75,69,72,114,100,104,534,0.8253968253968254,100,100,100,100,100,100,600,0.8778625954198473,0.25
44,75,35,63,33,45,295,0.2647058823529412,43,70,48,50,60,38,309,0.2391304347826087,2.0
55,70,55,40,55,85,360,0.7073170731707317,90,92,87,75,85,76,505,0.5409836065573771,1.0
70,130,100,55,80,65,500,0.608,70,110,80,55,80,105,500,0.8794326241134752,0.5
55,45,50,45,65,80,340,0.5546218487394958,40,45,40,65,40,65,295,0.5661764705882353,0.5
100,110,90,85,90,60,535,0.47794117647058826,50,105,79,35,110,76,455,0.6214285714285714,1.0
30,45,59,30,39,57,260,0.2803030303030303,82,121,119,69,59,71,521,0.5394736842105263,0.5
81,102,77,85,75,85,505,0.5642857142857143,60,110,70,60,60,100,460,0.8461538461538461,0.0
35,64,85,74,55,32,345,0.19827586206896552,60,105,60,120,60,105,510,0.8849557522123894,1.0
76,65,45,92,42,91,411,0.7449664429530202,65,105,60,60,70,95,455,63.0,2.0
85,110,76,65,82,56,474,0.3933333333333333,85,56,77,50,77,78,423,0.53125,0.0
74,94,131,54,116,20,489,0.4485294117647059,70,55,55,80,60,45,365,0.2222222222222222,0.5
40,45,35,40,40,90,290,0.65,55,55,45,63,45,45,308,0.25,1.0
76,147,90,60,70,97,540,0.8267716535433071,60,50,100,85,70,65,430,0.47580645161290325,1.0
50,50,50,50,50,50,300,0.30708661417322836,90,75,75,90,100,70,500,0.5462184873949579,0.5
60,50,50,60,70,50,340,0.28346456692913385,60,52,168,47,138,30,495,0.19834710743801653,2.0
65,40,50,125,60,30,370,0.07258064516129033,70,43,53,43,53,40,302,0.19090909090909092,2.0
126,131,95,131,98,99,680,0.8102189781021898,30,42,118,42,88,30,350,0.112,0.25
45,30,40,105,50,20,290,0.031007751937984496,39,52,43,60,50,65,309,0.5041322314049587,1.0
71,73,88,120,89,59,500,0.43537414965986393,72,60,30,20,30,25,237,0.11570247933884298,1.0
70,80,70,80,70,110,480,0.6594202898550725,54,63,52,83,56,97,405,0.7697841726618705,0.5
45,63,37,65,55,95,360,0.8055555555555556,70,70,70,70,70,70,420,0.5289256198347108,1.0
64,51,23,51,23,28,240,0.11363636363636363,35,46,34,35,45,20,215,0.072,1.0
40,40,40,70,40,20,250,0.032520325203252036,80,80,80,80,80,80,480,0.5606060606060606,0.5
50,70,160,70,160,90,600,0.7417218543046358,85,97,66,105,66,65,484,0.47107438016528924,1.0
40,55,70,45,60,30,300,0.10619469026548672,65,90,115,45,115,58,488,0.5041322314049587,1.0
100,150,120,120,100,90,680,0.6493506493506493,45,60,45,25,45,55,275,0.29,1.0
65,65,45,75,45,95,390,0.72,45,30,35,20,20,45,195,0.14782608695652175,2.0
50,65,107,105,107,86,520,0.7758620689655172,100,100,100,100,100,100,600,0.8778625954198473,2.0
78,84,78,109,85,100,534,0.8646616541353384,95,155,109,70,130,81,640,0.6788321167883211,0.5
68,85,65,165,135,100,618,0.8083333333333333,78,130,111,130,85,100,634,0.8561151079136691,1.0
55,65,35,60,30,85,330,0.6126126126126126,50,120,53,35,110,87,455,0.640625,1.0
70,90,45,15,45,50,315,0.3629032258064516,60,69,95,69,95,36,424,0.2608695652173913,4.0
40,55,80,35,60,30,300,0.15037593984962405,55,40,50,65,85,40,335,0.3181818181818182,0.5
50,30,55,65,55,20,275,0.13675213675213677,50,53,62,58,63,44,330,0.13709677419354838,0.5
60,100,89,55,69,112,485,0.9298245614035088,60,40,80,60,45,40,325,0.23529411764705882,8.0
70,115,60,115,60,55,475,0.4647887323943662,59,110,150,45,49,35,448,0.3333333333333333,1.0
30,30,30,30,30,30,180,0.12612612612612611,100,70,70,65,65,45,415,0.1897810218978102,1.0
65,55,115,100,40,60,435,0.3798449612403101,60,60,60,35,35,30,280,0.11194029850746269,1.0
90,60,60,40,40,40,330,0.29545454545454547,30,56,35,25,35,72,253,0.48148148148148145,1.0
60,85,69,60,69,77,420,0.518796992481203,80,82,100,83,100,80,525,0.6821705426356589,1.0
70,80,70,80,70,110,480,0.6594202898550725,50,105,79,35,110,76,455,0.6214285714285714,1.0
255,10,10,75,135,55,540,0.3125,50,55,50,36,30,43,264,0.2922077922077922,1.0
62,73,55,56,52,84,382,0.7244094488188977,60,55,90,145,90,80,520,0.6071428571428571,0.5
44,38,39,61,79,42,303,0.2251655629139073,111,83,68,92,82,39,475,0.1774193548387097,1.0
40,80,35,35,45,70,305,0.4661016949152542,60,52,168,47,138,30,495,0.19834710743801653,4.0
55,20,35,20,45,75,250,0.37681159420289856,43,80,65,50,35,35,308,0.14193548387096774,1.0
60,85,49,60,49,60,363,0.4444444444444444,70,120,100,145,105,20,560,0.2824427480916031,0.0
85,105,55,85,50,115,495,0.9032258064516129,95,125,79,60,100,81,540,0.6165413533834586,0.5
60,100,89,55,69,112,485,0.9298245614035088,35,60,44,40,54,55,288,0.366412213740458,0.25
88,107,122,74,75,64,530,0.4596774193548387,65,65,60,130,95,110,525,0.823943661971831,0.5
73,100,60,100,60,65,458,0.42657342657342656,60,130,80,60,60,70,460,0.5153846153846153,2.0
60,100,85,80,85,100,510,0.7007874015748031,55,50,65,175,95,150,590,0.7818181818181819,0.25
55,104,105,94,75,52,485,0.36363636363636365,80,160,60,170,130,80,680,0.6180555555555556,1.0
90,120,120,60,60,50,500,0.35294117647058826,90,55,75,60,75,30,385,0.13970588235294118,1.0
58,89,77,45,45,48,362,0.3177570093457944,90,132,105,132,105,30,594,0.4246575342465753,2.0
95,65,110,60,130,65,525,0.5275590551181102,55,104,105,94,75,52,485,0.36363636363636365,1.0
75,95,95,95,95,85,540,0.6470588235294118,90,75,75,90,100,70,500,0.5462184873949579,0.5
50,65,107,105,107,86,520,0.7758620689655172,100,134,110,95,100,61,600,0.4057971014492754,2.0
30,30,42,30,42,70,244,0.4230769230769231,79,100,80,110,90,121,580,0.968,0.5
70,85,140,85,70,20,470,0.272,73,76,75,81,100,100,505,0.8110236220472441,0.5
90,95,95,70,90,70,510,0.5230769230769231,50,75,70,35,70,48,348,0.29357798165137616,2.0
123,100,62,97,81,68,531,0.4806201550387597,91,134,95,100,100,80,600,0.6304347826086957,0.25
45,30,35,20,20,45,195,0.14782608695652175,91,134,95,100,100,80,600,0.6304347826086957,0.5
45,30,50,55,65,45,290,0.208,65,40,50,125,60,30,370,0.07258064516129033,0.5
50,60,45,100,80,65,400,0.45689655172413796,150,120,100,120,100,90,680,0.664179104477612,0.25
80,95,82,60,82,75,474,0.6,100,50,80,60,80,50,420,0.34375,2.0
50,105,125,55,95,50,480,0.375886524822695,60,60,40,65,45,35,305,0.15833333333333333,0.25
64,88,50,88,50,106,446,0.9111111111111111,45,90,20,65,20,65,305,0.5116279069767442,0.5
110,160,110,80,110,100,670,0.8591549295774648,100,75,115,90,115,85,580,0.6446280991735537,1.0
75,70,90,70,105,80,490,0.656,55,75,60,75,60,103,428,0.7982456140350878,0.5
108,100,121,81,95,95,600,0.7476635514018691,85,76,64,45,55,90,415,0.6739130434782609,1.0
64,165,75,93,83,75,555,0.6587301587301587,70,140,230,60,80,50,630,0.32432432432432434,1.0
60,79,105,59,85,36,424,0.17054263565891473,65,155,120,65,90,105,600,0.8677685950413223,0.0
60,70,65,125,105,90,515,0.6911764705882353,73,100,60,100,60,65,458,0.42657342657342656,0.25
50,65,85,35,35,55,325,0.32575757575757575,50,35,55,25,25,15,205,0.021739130434782608,2.0
50,100,150,100,150,50,600,0.37142857142857144,45,100,45,45,45,10,290,0.2949640287769784,0.5
95,125,79,60,100,81,540,0.6165413533834586,75,75,55,105,85,30,425,0.1619718309859155,1.0
53,51,53,61,56,40,314,0.14285714285714285,45,50,45,115,55,95,405,0.6936936936936937,1.0
57,24,86,24,86,23,300,0.12727272727272726,50,65,107,105,107,86,520,0.703125,1.0
70,135,105,60,105,20,495,0.5806451612903226,65,60,110,130,95,65,525,0.47761194029850745,2.0
106,190,100,154,100,130,780,0.9259259259259259,105,180,100,180,100,115,780,0.9477611940298507,0.5
105,130,120,45,45,40,485,0.4444444444444444,60,80,50,40,40,30,300,0.15328467153284672,1.0
95,23,48,23,48,23,260,0.046153846153846156,53,51,53,61,56,40,314,0.14285714285714285,1.0
35,46,34,35,45,20,215,0.072,80,100,80,80,80,100,520,0.9051724137931034,1.0
60,48,45,43,90,42,328,0.21897810218978103,67,89,116,79,116,33,500,0.2624113475177305,0.25
100,100,100,100,100,100,600,0.8602941176470589,105,180,100,180,100,115,780,0.9477611940298507,0.25
85,90,80,70,80,130,535,0.9262295081967213,85,105,85,40,50,40,405,0.211864406779661,2.0
62,77,62,50,42,65,358,0.4838709677419355,45,55,45,65,45,75,330,0.5692307692307692,1.0
110,123,65,100,65,65,528,0.5217391304347826,60,90,55,90,80,110,485,0.8677685950413223,1.0
100,100,100,100,100,100,600,0.8778625954198473,50,70,50,50,50,40,310,0.16296296296296298,0.5
50,53,48,53,48,64,316,0.4076923076923077,50,95,180,85,45,70,525,0.5298507462686567,2.0
38,30,41,30,41,60,240,0.2897196261682243,71,95,85,110,95,79,535,0.664,1.0
59,59,58,90,70,73,409,0.5826086956521739,45,100,135,65,135,45,525,0.29411764705882354,1.0
75,80,85,110,90,50,490,0.3548387096774194,95,110,95,40,95,55,490,0.40336134453781514,1.0
75,75,95,75,95,113,528,0.9015151515151515,55,55,50,45,65,55,325,0.37373737373737376,1.0
60,55,50,40,55,45,305,0.22377622377622378,50,95,95,35,110,70,455,0.5179856115107914,0.5
66,117,70,40,50,67,410,0.4573643410852713,85,105,85,40,50,40,405,0.211864406779661,1.0
60,25,35,70,80,60,330,0.3076923076923077,100,128,90,77,77,128,600,0.959349593495935,1.0
45,65,34,40,34,45,263,0.2589928057553957,91,72,90,129,90,108,580,0.8620689655172413,2.0
72,85,70,65,70,58,420,0.41304347826086957,50,53,48,53,48,64,316,0.4076923076923077,1.0
80,130,100,160,120,110,700,0.8981481481481481,20,10,230,10,230,5,505,0.0,1.0
99,68,83,72,87,51,460,0.417910447761194,105,130,120,45,45,40,485,0.4444444444444444,2.0
50,53,48,53,48,64,316,0.4076923076923077,90,120,75,60,60,45,450,0.29411764705882354,1.0
45,30,40,105,50,20,290,0.031007751937984496,115,45,20,45,25,20,270,0.11538461538461539,1.0
50,53,48,53,48,64,316,0.46153846153846156,100,100,100,100,100,100,600,0.8805970149253731,0.5
45,30,50,65,50,45,285,0.13821138211382114,89,145,90,105,80,91,600,0.8549618320610687,2.0
106,150,70,194,120,140,780,0.952,76,65,45,92,42,91,411,0.7449664429530202,1.0
80,110,60,150,130,70,600,0.5042016806722689,75,90,50,110,80,95,500,0.7985611510791367,0.0
125,130,90,130,90,95,660,0.7734375,83,80,75,70,70,101,479,0.8615384615384616,2.0
114,85,70,85,80,30,464,0.2066115702479339,60,69,95,69,95,36,424,0.2608695652173913,0.0
65,130,60,95,110,65,525,0.5303030303030303,100,150,90,180,160,90,770,0.7348484848484849,0.5
75,87,63,87,63,98,473,0.865546218487395,60,60,60,60,60,60,360,0.38095238095238093,1.0
60,85,42,85,42,91,405,0.8227848101265823,62,48,54,63,60,68,355,0.5178571428571429,2.0
85,120,70,50,60,100,485,0.8308823529411765,103,93,67,71,61,84,479,0.7142857142857143,1.0
85,73,70,73,115,67,483,0.5126050420168067,100,150,90,180,160,90,770,0.7348484848484849,1.0
40,70,40,35,40,60,285,0.392,106,190,100,154,100,130,780,0.9259259259259259,0.5
70,105,105,50,40,20,390,0.33587786259541985,90,85,100,95,125,85,580,0.6834532374100719,4.0
80,135,85,70,95,150,615,0.9844961240310077,20,40,90,30,90,25,295,0.11363636363636363,1.0
65,75,90,97,123,44,494,0.1987179487179487,105,150,90,150,90,95,680,0.8285714285714286,2.0
50,53,48,53,48,64,316,0.358974358974359,44,50,91,24,86,10,305,0.1981981981981982,0.5
40,29,45,29,45,36,224,0.14634146341463414,70,90,45,15,45,50,315,0.3629032258064516,0.5
40,30,30,55,30,85,270,0.4666666666666667,71,120,95,120,95,99,600,0.8203125,1.0
90,65,65,40,40,15,315,0.19672131147540983,60,85,49,60,49,60,363,0.4444444444444444,1.0
55,50,45,135,95,120,500,0.7714285714285715,79,115,70,125,80,111,580,0.864,1.0
70,75,80,135,80,135,575,0.917910447761194,50,65,85,35,35,55,325,0.32575757575757575,1.0
100,100,100,100,100,100,600,0.8602941176470589,80,95,82,60,82,75,474,0.6,0.5
62,55,52,109,94,109,481,0.7833333333333333,86,68,72,109,66,106,507,0.8099173553719008,1.0
70,120,100,145,105,20,560,0.2824427480916031,60,80,50,40,40,30,300,0.15328467153284672,1.0
64,165,75,93,83,75,555,0.6587301587301587,75,98,63,98,63,101,498,0.849624060150376,1.0
95,117,80,65,70,92,519,0.8409090909090909,65,130,60,95,110,65,525,0.5303030303030303,2.0
165,75,80,40,45,65,470,0.5151515151515151,85,56,77,50,77,78,423,0.53125,2.0
70,75,80,135,80,135,575,0.917910447761194,100,134,110,95,100,61,600,0.4057971014492754,1.0
50,70,50,50,50,70,340,0.5645161290322581,135,85,40,40,85,5,390,0.6864406779661016,1.0
65,80,140,40,70,70,465,0.5223880597014925,100,77,77,128,128,90,600,0.6901408450704225,1.0
48,61,40,61,40,50,300,0.2543859649122807,75,140,65,112,65,110,567,0.9140625,0.5
115,115,85,90,75,100,580,0.8134328358208955,55,104,105,94,75,52,485,0.36363636363636365,0.5
30,105,90,25,25,50,325,0.2773722627737226,50,95,180,85,45,70,525,0.5298507462686567,0.5
60,100,85,80,85,100,510,0.7007874015748031,76,147,90,60,70,97,540,0.8267716535433071,1.0
46,87,60,30,40,57,320,0.37777777777777777,70,60,125,115,70,55,495,0.35507246376811596,1.0
67,57,55,77,55,114,425,0.8879310344827587,105,130,120,45,45,40,485,0.4444444444444444,1.0
50,72,35,35,35,65,292,0.5373134328358209,70,60,62,80,82,60,414,0.4375,0.0
85,76,64,45,55,90,415,0.6739130434782609,80,135,85,70,95,150,615,0.9844961240310077,0.5
78,81,71,74,69,126,499,0.9090909090909091,50,70,50,50,50,70,340,0.5645161290322581,0.5
65,65,65,50,50,90,385,0.72,65,75,90,97,123,44,494,0.1987179487179487,0.5
95,85,85,65,65,35,430,0.2571428571428571,55,55,50,45,65,55,325,0.37373737373737376,1.0
73,100,60,100,60,65,458,0.42657342657342656,79,103,120,135,115,78,630,0.5763888888888888,1.0
51,65,65,80,75,59,395,0.4365079365079365,62,44,50,44,50,55,305,0.3629032258064516,1.0
60,85,42,85,42,91,405,0.8227848101265823,80,80,80,80,80,80,480,0.5606060606060606,1.0
40,30,32,50,52,65,269,0.3671875,65,95,100,60,50,50,420,0.34959349593495936,0.5
75,98,63,98,63,101,498,0.8091603053435115,126,131,95,131,98,99,680,0.8102189781021898,0.5
40,45,35,40,40,90,290,0.65,77,120,90,60,90,48,485,0.2785714285714286,1.0
50,65,107,105,107,86,520,0.7758620689655172,55,84,105,114,75,52,485,0.2890625,1.0
80,135,130,95,90,70,600,0.5181818181818182,41,56,40,62,44,71,314,0.568,0.5
30,80,90,55,45,55,355,0.4295774647887324,80,90,80,130,110,110,600,0.856,0.5
63,60,55,50,50,71,349,0.5289256198347108,48,61,40,61,40,50,300,0.2543859649122807,2.0
59,59,58,90,70,73,409,0.5826086956521739,95,155,109,70,130,81,640,0.6788321167883211,0.5
100,110,90,85,90,60,535,0.47794117647058826,70,62,67,55,55,56,365,0.38513513513513514,2.0
40,30,35,45,40,55,245,0.31496062992125984,50,60,60,60,60,30,320,0.11290322580645161,1.0
28,25,25,45,35,40,198,0.16083916083916083,65,110,130,60,65,95,525,0.8278145695364238,1.0
45,30,35,20,20,45,195,0.14782608695652175,50,72,35,35,35,65,292,0.5373134328358209,2.0
58,109,112,48,48,109,484,0.8805970149253731,45,50,35,55,75,40,300,0.21367521367521367,1.0
65,40,70,80,140,70,465,0.5954198473282443,77,85,51,55,51,65,384,0.5163934426229508,2.0
75,80,60,65,90,102,472,0.8625954198473282,90,60,60,40,40,40,330,0.29545454545454547,1.0
95,23,48,23,48,23,260,0.046153846153846156,110,80,90,95,90,65,530,0.5033557046979866,1.0
109,66,84,81,99,32,471,0.2013888888888889,78,70,61,50,61,100,420,0.8145161290322581,1.0
50,65,107,105,107,86,520,0.7313432835820896,45,50,55,75,65,30,320,0.06293706293706294,0.125
55,85,122,58,75,99,494,0.8099173553719008,55,45,50,45,65,80,340,0.5546218487394958,0.25
45,80,100,35,37,28,325,0.3125,44,38,33,61,43,70,289,0.5267857142857143,0.0
45,63,37,65,55,95,360,0.8055555555555556,40,65,95,60,45,35,340,0.13986013986013987,1.0
90,95,105,165,110,45,610,0.2890625,55,40,50,65,85,40,335,0.3181818181818182,2.0
60,40,80,60,45,40,325,0.23529411764705882,54,78,103,53,45,22,355,0.23255813953488372,4.0
38,35,35,65,55,50,278,0.2647058823529412,80,120,79,95,79,70,523,0.5833333333333334,1.0
100,77,77,128,128,90,600,0.6901408450704225,100,100,100,100,100,100,600,0.8758169934640523,0.125
85,73,70,73,115,67,483,0.5126050420168067,80,120,130,55,65,45,495,0.37037037037037035,2.0
80,130,100,160,120,110,700,0.8981481481481481,100,70,70,65,65,45,415,0.1897810218978102,1.0
80,70,70,90,100,70,480,0.5609756097560976,68,72,78,38,42,32,330,0.23809523809523808,4.0
65,63,45,45,45,45,308,0.2595419847328244,60,60,40,65,45,35,305,0.15833333333333333,0.5
30,105,90,25,25,50,325,0.2773722627737226,85,105,55,85,50,115,495,0.9032258064516129,0.5
125,58,58,76,76,67,460,0.515625,66,41,77,61,87,23,355,0.12096774193548387,0.5
42,52,67,39,56,50,306,0.2868217054263566,60,50,100,85,70,65,430,0.47580645161290325,1.0
100,100,90,150,140,90,670,0.71875,35,55,35,30,30,35,220,0.23684210526315788,1.0
100,100,100,100,100,100,600,0.8345864661654135,45,60,40,70,50,45,310,0.2846715328467153,0.5
75,87,63,87,63,98,473,0.865546218487395,85,135,130,60,80,25,515,0.40540540540540543,1.0
30,30,42,30,42,70,244,0.4230769230769231,54,45,47,75,98,52,371,0.39669421487603307,0.5
65,47,55,73,75,85,400,0.65,55,20,35,20,45,75,250,0.37681159420289856,1.0
60,67,85,77,75,116,480,0.8888888888888888,100,100,100,100,100,100,600,0.8602941176470589,0.5
45,85,50,55,50,65,350,0.5076923076923077,65,80,65,35,65,60,370,0.38405797101449274,2.0
80,90,80,130,110,110,600,0.856,75,100,63,80,63,116,497,0.9345794392523364,1.0
66,117,70,40,50,67,410,0.4573643410852713,35,55,40,50,50,90,320,0.6838235294117647,1.0
30,40,70,70,25,60,295,0.41353383458646614,80,145,150,105,110,110,700,0.8692307692307693,1.0
70,77,60,97,60,108,472,0.8394160583941606,60,60,60,35,35,30,280,0.11194029850746269,1.0
40,20,30,40,80,55,265,0.22764227642276422,55,66,44,44,56,85,350,0.6888888888888889,1.0
108,112,118,68,72,47,525,0.2916666666666667,49,66,70,44,55,51,335,0.4260869565217391,0.5
45,100,135,65,135,45,525,0.29411764705882354,66,117,70,40,50,67,410,0.4573643410852713,1.0
91,72,90,129,90,108,580,0.8925619834710744,83,80,80,135,80,121,579,0.9444444444444444,1.0
64,78,52,78,52,81,405,0.6422764227642277,68,65,65,125,115,80,518,0.6461538461538462,0.25
160,110,65,65,110,30,540,0.35714285714285715,45,85,50,55,50,65,350,0.5076923076923077,1.0
35,40,100,90,55,35,355,0.1796875,67,58,57,81,67,101,431,0.8790322580645161,1.0
75,75,55,105,85,30,425,0.1619718309859155,60,80,50,50,50,40,330,0.23853211009174313,1.0
58,109,112,48,48,109,484,0.8805970149253731,35,65,35,65,35,65,300,0.46621621621621623,0.5
45,25,50,25,25,35,205,0.13076923076923078,120,100,85,30,85,45,465,0.22448979591836735,0.5
65,150,40,15,80,145,495,0.9663865546218487,53,54,53,37,46,45,288,0.3090909090909091,4.0
50,52,48,65,50,55,320,0.33098591549295775,59,63,80,65,80,58,405,0.41843971631205673,0.5
50,80,95,10,45,10,290,0.232,103,60,126,80,126,50,545,0.36363636363636365,1.0
95,65,65,110,130,60,525,0.4016393442622951,75,65,55,65,55,69,384,0.43548387096774194,1.0
110,123,65,100,65,65,528,0.5217391304347826,70,77,60,97,60,108,472,0.8394160583941606,1.0
68,75,53,83,113,60,452,0.45384615384615384,79,85,60,55,60,71,410,0.60431654676259,1.0
60,45,50,90,80,70,395,0.625,110,65,105,55,95,80,510,0.6258503401360545,1.0
105,140,95,55,65,45,505,0.3,66,117,70,40,50,67,410,0.4573643410852713,1.0
80,120,130,55,65,45,495,0.37037037037037035,30,56,35,25,35,72,253,0.48148148148148145,1.0
55,70,40,60,40,40,305,0.26956521739130435,190,33,58,33,58,33,405,0.13432835820895522,1.0
60,50,150,50,150,60,520,0.5206611570247934,45,45,35,20,30,20,195,0.07246376811594203,1.0
37,25,41,25,41,25,194,0.08870967741935484,60,62,80,63,80,60,405,0.4336283185840708,2.0
50,35,55,25,25,15,205,0.021739130434782608,40,80,100,30,30,20,300,0.11851851851851852,1.0
110,78,73,76,71,60,468,0.3333333333333333,80,100,70,60,70,95,475,0.7416666666666667,0.25
70,84,70,65,70,51,410,0.2949640287769784,100,100,100,100,100,100,600,0.8758169934640523,1.0
65,110,130,60,65,95,525,0.8278145695364238,50,50,40,30,30,50,250,0.2781954887218045,2.0
100,50,80,60,80,50,420,0.34375,80,80,80,55,55,90,440,0.6417910447761194,1.0
71,73,88,120,89,59,500,0.43537414965986393,45,85,70,40,40,60,340,0.5229357798165137,1.0
80,160,80,130,80,100,630,0.8455284552845529,70,55,95,95,110,65,490,0.48872180451127817,0.5
77,59,50,67,63,46,362,0.23140495867768596,110,80,90,95,90,65,530,0.5033557046979866,0.5
65,65,65,50,50,90,385,0.72,65,55,115,100,40,60,435,0.3798449612403101,0.5
60,65,60,130,75,110,500,0.7719298245614035,40,55,30,30,30,85,270,0.688,0.0
78,84,78,109,85,100,534,0.8646616541353384,28,25,25,45,35,40,198,0.16083916083916083,1.0
115,115,85,90,75,100,580,0.8134328358208955,50,65,107,105,107,86,520,0.7313432835820896,2.0
75,140,65,112,65,110,567,0.9140625,105,125,100,60,100,100,590,0.8359375,1.0
35,85,45,35,35,75,310,0.6492537313432836,40,30,35,45,40,55,245,0.31496062992125984,1.0
50,60,60,60,60,30,320,0.11290322580645161,48,72,48,72,48,48,336,0.25984251968503935,1.0
100,70,70,65,65,45,415,0.1897810218978102,50,65,64,44,48,43,314,0.2196969696969697,1.0
44,75,35,63,33,45,295,0.2647058823529412,80,125,75,40,95,85,500,0.6911764705882353,1.0
60,60,40,65,45,35,305,0.15833333333333333,45,55,39,35,39,42,255,0.18518518518518517,1.0
75,98,63,98,63,101,498,0.889763779527559,50,25,28,45,55,15,218,0.0625,1.0
100,100,100,100,100,100,600,0.8805970149253731,75,125,75,30,75,85,465,0.625,1.0
85,115,80,105,80,50,515,0.3063063063063063,62,50,58,73,54,72,369,0.4435483870967742,1.0
74,94,131,54,116,20,489,0.4485294117647059,85,76,64,45,55,90,415,0.6739130434782609,1.0
75,98,63,98,63,101,498,0.849624060150376,60,95,80,60,80,30,405,0.19480519480519481,0.5
70,120,65,45,85,125,510,0.9747899159663865,125,130,90,130,90,95,660,0.7734375,1.0
70,110,70,115,70,90,525,0.75,103,60,86,60,86,50,445,0.3458646616541353,2.0
80,105,65,60,75,130,515,0.9645390070921985,60,95,80,60,80,30,405,0.19480519480519481,8.0
40,45,35,40,40,90,290,0.65,60,85,60,50,50,125,430,0.9090909090909091,1.0
40,55,80,35,60,30,300,0.15037593984962405,80,135,130,95,90,70,600,0.5181818181818182,0.125
95,135,80,110,80,100,600,0.8248175182481752,75,100,95,40,70,110,490,0.8717948717948718,1.0
100,100,100,100,100,100,600,0.8778625954198473,80,80,80,80,80,80,480,0.5606060606060606,0.5
80,130,100,160,120,110,700,0.8981481481481481,80,135,130,95,90,70,600,0.5181818181818182,0.125
45,30,35,20,20,45,195,0.14782608695652175,78,81,71,74,69,126,499,0.9090909090909091,0.25
75,125,70,125,70,115,580,0.9037037037037037,75,65,55,65,55,69,384,0.43548387096774194,2.0
65,136,94,54,96,135,580,0.9612403100775194,86,92,88,68,75,73,482,0.6835443037974683,1.0
190,33,58,33,58,33,405,0.13432835820895522,60,79,105,59,85,36,424,0.17054263565891473,2.0
79,103,120,135,115,78,630,0.5763888888888888,85,56,77,50,77,78,423,0.53125,2.0
58,64,58,80,65,80,405,0.5423728813559322,64,51,23,51,23,28,240,0.11363636363636363,1.0
65,90,65,61,61,100,442,0.8373983739837398,170,90,45,90,45,60,500,0.427536231884058,1.0
43,30,55,40,65,97,330,0.6030534351145038,55,95,55,35,75,115,430,0.9380530973451328,1.0
70,120,100,145,105,20,560,0.2824427480916031,40,30,50,55,55,100,330,0.584070796460177,2.0
90,92,75,92,85,60,494,0.49586776859504134,40,80,100,30,30,20,300,0.11851851851851852,8.0
50,92,108,92,108,35,485,0.2457627118644068,65,90,40,45,80,75,395,0.625,1.0
86,68,72,109,66,106,507,0.8099173553719008,35,70,55,45,55,25,285,0.09420289855072464,4.0
70,43,53,43,53,40,302,0.19090909090909092,70,115,60,115,60,55,475,0.4647887323943662,2.0
70,20,50,20,50,40,250,0.1557377049180328,74,100,72,90,72,46,454,0.24561403508771928,0.5
50,50,40,30,30,50,250,0.2781954887218045,105,180,100,180,100,115,780,0.9477611940298507,0.0
30,80,90,55,45,55,355,0.4295774647887324,60,25,35,70,80,60,330,0.3076923076923077,1.0
67,82,62,46,48,43,348,0.22033898305084745,85,105,85,40,50,40,405,0.211864406779661,1.0
60,67,85,77,75,116,480,0.8888888888888888,95,75,110,100,80,30,490,0.15267175572519084,2.0
65,60,70,85,75,40,395,0.1796875,70,110,80,55,80,105,500,0.8794326241134752,1.0
54,78,103,53,45,22,355,0.23255813953488372,65,90,40,45,80,75,395,0.625,2.0
60,67,85,77,75,116,480,0.8888888888888888,100,150,120,120,100,90,680,0.6493506493506493,1.0
60,40,50,75,85,95,405,0.6044776119402985,68,85,65,165,135,100,618,0.8083333333333333,1.0
105,130,120,45,45,40,485,0.4444444444444444,111,83,68,92,82,39,475,0.1774193548387097,0.5
40,45,35,30,40,55,245,0.3793103448275862,75,95,95,95,95,85,540,0.6470588235294118,1.0
40,45,40,65,40,65,295,0.5661764705882353,65,136,94,54,96,135,580,0.9612403100775194,1.0
68,75,53,83,113,60,452,0.45384615384615384,90,100,60,90,60,80,480,0.6422764227642277,1.0
130,70,35,70,35,60,400,0.4017857142857143,58,64,58,80,65,80,405,0.5423728813559322,2.0
50,35,55,25,25,15,205,0.05263157894736842,110,135,60,50,65,88,508,0.7744360902255639,0.5
60,85,69,60,69,77,420,0.518796992481203,76,104,71,104,71,108,534,0.912751677852349,1.0
60,70,50,100,50,65,395,0.5217391304347826,80,160,60,170,130,80,680,0.6180555555555556,4.0
41,56,40,62,44,71,314,0.568,45,45,35,20,30,20,195,0.07246376811594203,1.0
56,61,65,48,45,38,313,0.17567567567567569,43,80,65,50,35,35,308,0.14193548387096774,2.0
75,80,55,25,35,35,305,0.18666666666666668,45,40,60,40,75,50,310,0.2926829268292683,1.0
70,140,70,110,65,105,560,0.95,95,75,80,100,110,30,490,0.24242424242424243,1.0
90,110,80,100,80,95,555,0.7982456140350878,70,80,102,80,102,40,474,0.2677165354330709,2.0
50,25,28,45,55,15,218,0.0625,80,82,78,95,80,85,500,0.6869565217391305,1.0
75,69,72,114,100,104,534,0.8253968253968254,50,80,95,10,45,10,290,0.232,0.5
62,50,58,73,54,72,369,0.4435483870967742,57,80,91,80,87,75,470,0.5737704918032787,1.0
45,100,135,65,135,45,525,0.29411764705882354,35,40,100,90,55,35,355,0.1796875,1.0
85,60,65,135,105,100,550,0.7518248175182481,80,95,82,60,82,75,474,0.6,0.5
90,130,80,65,85,55,505,0.4396551724137931,60,60,60,85,85,85,435,0.631578947368421,0.0
80,92,65,65,80,68,450,0.4824561403508772,60,52,168,47,138,30,495,0.19834710743801653,2.0
65,150,60,115,60,115,565,0.935251798561151,72,58,80,103,80,97,490,0.7171052631578947,2.0
50,35,55,25,25,15,205,0.021739130434782608,95,65,65,110,130,60,525,0.4016393442622951,0.5
70,55,65,95,85,70,440,0.5307692307692308,60,95,80,60,80,30,405,0.19480519480519481,2.0
50,65,107,105,107,86,520,0.6991150442477876,65,125,60,95,60,105,510,0.9236641221374046,1.0
78,81,71,74,69,126,499,0.9090909090909091,52,65,50,45,50,38,300,0.27419354838709675,0.5
75,38,38,56,56,67,330,0.5263157894736842,55,70,40,60,40,40,305,0.26956521739130435,1.0
50,75,35,70,30,40,300,0.21296296296296297,75,125,70,125,70,115,580,0.9037037037037037,1.0
75,75,130,75,130,95,580,0.7479674796747967,80,120,130,55,65,45,495,0.37037037037037035,2.0
70,55,95,95,110,65,490,0.48872180451127817,90,60,70,75,70,45,410,0.23880597014925373,1.0
78,70,61,50,61,100,420,0.8145161290322581,70,70,115,130,90,60,535,0.5338983050847458,0.5
97,165,60,65,50,58,495,0.3902439024390244,60,85,69,65,79,80,438,0.576,1.0
60,60,75,60,75,80,410,0.7321428571428571,35,55,40,45,40,60,275,0.35714285714285715,1.0
60,79,105,59,85,36,424,0.17054263565891473,85,110,90,45,90,80,500,0.6206896551724138,1.0
74,48,76,83,81,104,466,0.7322834645669292,50,20,40,20,40,20,190,0.0962962962962963,1.0
60,50,40,85,75,95,405,0.7540983606557377,106,190,100,154,100,130,780,0.9259259259259259,1.0
73,100,60,100,60,65,458,0.42657342657342656,90,100,60,90,60,80,480,0.6422764227642277,2.0
40,30,32,50,52,65,269,0.3671875,40,29,45,29,45,36,224,0.14634146341463414,1.0
75,89,85,55,65,36,405,0.29545454545454547,50,150,50,150,50,150,600,0.9339622641509434,1.0
65,65,60,110,95,130,525,0.9253731343283582,71,120,95,120,95,99,600,0.8203125,1.0
45,100,45,45,45,10,290,0.2949640287769784,90,55,75,60,75,30,385,0.13970588235294118,1.0
75,98,63,98,63,101,498,0.849624060150376,111,83,68,92,82,39,475,0.1774193548387097,1.0
100,150,120,120,100,90,680,0.6493506493506493,40,30,32,50,52,65,269,0.3671875,2.0
65,50,70,95,80,65,425,0.4262295081967213,60,69,95,69,95,36,424,0.2608695652173913,0.5
30,45,55,70,55,85,340,0.5633802816901409,65,65,45,75,45,95,390,0.72,1.0
41,50,37,50,37,66,281,0.5175438596491229,91,90,129,90,72,108,580,0.9140625,0.5
70,115,60,115,60,55,475,0.4647887323943662,59,59,58,90,70,73,409,0.5826086956521739,0.5
100,77,77,128,128,90,600,0.6901408450704225,90,132,105,132,105,30,594,0.4246575342465753,1.0
81,102,77,85,75,85,505,0.5642857142857143,90,120,120,60,60,50,500,0.35294117647058826,0.5
20,10,230,10,230,5,505,0.0,61,72,57,55,55,65,365,0.3984375,0.5
80,100,70,50,60,45,405,0.25806451612903225,106,150,70,194,120,140,780,0.952,0.5
60,55,145,75,150,40,525,0.2,64,165,75,93,83,75,555,0.6587301587301587,1.0
65,75,70,95,70,95,470,0.7272727272727273,95,80,105,40,70,100,490,0.8046875,1.0
60,55,145,75,150,40,525,0.2,72,95,67,103,71,122,530,0.9606299212598425,0.5
62,55,52,109,94,109,481,0.7833333333333333,80,105,105,105,105,80,580,0.5939849624060151,1.0
100,50,50,76,96,70,442,0.5,80,105,65,60,75,130,515,0.9645390070921985,0.25
85,105,85,40,50,40,405,0.211864406779661,50,52,48,65,50,55,320,0.33098591549295775,1.0
40,40,35,50,100,70,335,0.5031847133757962,70,83,50,37,50,60,350,0.3360655737704918,1.0
50,50,120,80,80,30,410,0.07258064516129033,105,130,120,45,45,40,485,0.4444444444444444,0.25
100,120,100,150,120,90,680,0.728,65,150,40,15,80,145,495,0.9663865546218487,2.0
80,125,75,40,95,85,500,0.6911764705882353,71,73,88,120,89,59,500,0.43537414965986393,1.0
65,90,115,45,115,58,488,0.5041322314049587,62,48,66,59,57,49,341,0.33884297520661155,0.25
50,70,100,40,40,30,330,0.2222222222222222,50,50,40,30,30,50,250,0.2781954887218045,2.0
50,80,95,10,45,10,290,0.232,68,125,65,65,115,80,518,0.6277372262773723,0.5
80,92,65,65,80,68,450,0.4824561403508772,89,145,90,105,80,91,600,0.8549618320610687,2.0
50,85,125,85,115,20,480,0.4306569343065693,60,65,80,170,95,130,600,0.8625954198473282,4.0
45,100,135,65,135,45,525,0.29411764705882354,67,58,57,81,67,101,431,0.8790322580645161,1.0
115,140,130,55,55,40,535,0.4519230769230769,80,80,90,110,130,110,600,0.8721804511278195,1.0
60,60,50,40,50,75,335,0.5882352941176471,60,40,50,75,85,95,405,0.6044776119402985,1.0
46,57,40,40,40,50,273,0.25,20,40,15,35,35,60,205,0.34285714285714286,1.0
45,67,60,35,50,63,320,0.5128205128205128,108,100,121,81,95,95,600,0.7476635514018691,1.0
45,35,45,62,53,35,275,0.11851851851851852,100,100,100,100,100,100,600,0.8602941176470589,0.5
62,44,50,44,50,55,305,0.3629032258064516,30,45,135,45,90,30,375,0.09285714285714286,1.0
70,110,75,145,85,145,630,0.9444444444444444,60,60,60,60,60,60,360,0.38095238095238093,1.0
60,55,90,145,90,80,520,0.6071428571428571,80,105,105,105,105,80,580,0.5939849624060151,2.0
60,69,95,69,95,36,424,0.2608695652173913,95,110,80,70,80,50,485,0.37209302325581395,2.0
38,35,35,65,55,50,278,0.2647058823529412,68,65,65,125,115,80,518,0.6461538461538462,0.5
45,35,50,70,50,30,280,0.15753424657534246,58,89,77,45,45,48,362,0.3177570093457944,1.0
62,44,50,44,50,55,305,0.3629032258064516,95,60,79,100,125,81,540,0.6201550387596899,0.5
50,65,107,105,107,86,520,0.7758620689655172,60,50,40,85,75,95,405,0.7540983606557377,0.5
40,20,30,40,80,55,265,0.22764227642276422,60,85,42,85,42,91,405,0.8227848101265823,1.0
65,65,60,130,95,110,525,0.823943661971831,80,100,70,50,60,45,405,0.25806451612903225,1.0
85,50,95,120,115,80,545,0.5793650793650794,50,65,107,105,107,86,520,0.703125,0.5
70,90,90,135,90,125,600,0.9401709401709402,80,100,200,50,100,50,580,0.3472222222222222,1.0
40,35,30,20,20,50,195,0.23423423423423423,54,45,47,75,98,52,371,0.39669421487603307,1.0
30,105,90,25,25,50,325,0.2773722627737226,45,30,15,85,65,65,305,0.36220472440944884,1.0
75,75,75,125,95,40,485,0.15671641791044777,60,70,65,125,105,90,515,0.6911764705882353,2.0
106,90,130,90,154,110,680,0.8699186991869918,41,50,37,50,37,66,281,0.5175438596491229,0.0
100,110,90,85,90,60,535,0.47794117647058826,65,105,60,60,70,95,455,63.0,1.0
79,105,70,145,80,101,580,0.8608695652173913,55,95,55,35,75,115,430,0.9380530973451328,1.0
100,110,90,85,90,60,535,0.47794117647058826,105,95,75,85,75,74,509,0.5714285714285714,1.0
75,100,66,60,66,115,482,0.918918918918919,63,63,47,41,41,74,329,0.56,1.0
95,117,184,44,46,28,514,0.2975206611570248,70,43,53,43,53,40,302,0.19090909090909092,1.0
150,80,44,90,54,80,498,0.625,95,110,95,40,95,55,490,0.40336134453781514,0.0
90,70,80,70,95,70,475,0.5190839694656488,50,75,75,65,65,50,380,0.4049586776859504,1.0
30,40,55,40,55,60,280,0.3237410071942446,55,75,85,25,25,15,280,0.1875,2.0
60,80,50,40,40,30,300,0.15328467153284672,60,62,50,62,60,40,334,0.18181818181818182,1.0
59,66,70,44,55,41,335,0.25190839694656486,60,62,63,80,80,60,405,0.38016528925619836,0.25
80,82,83,100,100,80,525,0.6742424242424242,40,70,40,35,40,60,285,0.392,1.0
70,90,90,135,90,125,600,0.9401709401709402,38,35,40,27,25,35,200,0.08208955223880597,1.0
50,60,45,100,80,65,400,0.45689655172413796,100,123,75,57,75,80,510,0.6923076923076923,0.5
90,85,100,95,125,85,580,0.6834532374100719,50,50,150,50,150,50,500,0.2571428571428571,0.5
106,150,70,194,120,140,780,0.952,50,45,45,35,35,50,260,0.23529411764705882,1.0
95,155,109,70,130,81,640,0.6788321167883211,95,23,48,23,48,23,260,0.046153846153846156,2.0
105,140,95,55,65,45,505,0.3,64,88,50,88,50,106,446,0.9111111111111111,2.0
70,115,60,115,60,55,475,0.4647887323943662,45,50,43,40,38,62,278,0.40441176470588236,0.5
60,70,105,70,120,75,500,0.5983606557377049,75,110,110,110,105,80,590,0.656934306569343,1.0
61,72,57,55,55,65,365,0.3984375,60,100,89,55,69,112,485,0.9298245614035088,0.5
60,55,145,75,150,40,525,0.2,92,105,90,125,90,98,600,0.8217054263565892,1.0
76,25,45,67,55,24,292,0.0390625,60,85,69,60,69,77,420,0.518796992481203,1.0
60,50,70,80,80,140,480,0.8449612403100775,44,38,39,61,79,42,303,0.2251655629139073,1.0
95,110,80,70,80,50,485,0.37209302325581395,45,65,34,40,34,45,263,0.2589928057553957,1.0
35,70,55,45,55,25,285,0.09420289855072464,70,85,70,60,70,50,405,0.28378378378378377,4.0
20,10,230,10,230,5,505,0.0,60,82,45,45,45,74,351,0.5752212389380531,1.0
82,121,119,69,59,71,521,0.5394736842105263,65,95,57,100,85,93,495,0.7441860465116279,2.0
95,125,79,60,100,81,540,0.6165413533834586,80,85,95,30,30,25,345,0.2857142857142857,2.0
95,75,80,100,110,30,490,0.24242424242424243,75,80,95,90,100,50,490,0.2158273381294964,0.5
45,22,60,27,30,29,213,0.07518796992481203,95,124,78,69,71,58,495,0.37398373983739835,1.0
36,50,50,65,60,44,305,0.16363636363636364,60,115,105,65,70,80,495,0.7181818181818181,0.5
60,95,80,60,80,30,405,0.19480519480519481,116,55,85,107,95,29,487,0.06818181818181818,2.0
60,85,69,65,79,80,438,0.576,75,103,80,70,80,92,500,0.7933884297520661,2.0
75,95,95,95,95,85,540,0.6470588235294118,45,22,60,27,30,29,213,0.07518796992481203,1.0
41,56,40,62,44,71,314,0.568,46,57,40,40,40,50,273,0.25,1.0
60,90,70,60,120,40,440,0.27419354838709675,70,65,60,90,75,90,450,0.6571428571428571,1.0
60,100,89,55,69,112,485,0.9298245614035088,75,90,90,140,90,115,600,0.9481481481481482,1.0
65,150,60,115,60,115,565,0.935251798561151,85,73,70,73,115,67,483,0.5126050420168067,2.0
100,50,50,76,96,70,442,0.5,50,150,50,150,50,150,600,0.9339622641509434,1.0
75,98,63,98,63,101,498,0.889763779527559,103,60,86,60,86,50,445,0.3458646616541353,1.0
100,75,115,90,115,85,580,0.6446280991735537,60,50,150,50,150,60,520,0.5206611570247934,1.0
105,125,100,60,100,100,590,0.8359375,50,95,95,35,110,70,455,0.5179856115107914,1.0
70,55,65,95,85,70,440,0.5307692307692308,65,110,130,60,65,95,525,0.8278145695364238,1.0
75,80,70,65,75,90,455,0.7578125,95,109,105,75,85,56,525,0.34513274336283184,2.0
60,80,50,40,40,30,300,0.15328467153284672,40,50,90,30,55,65,330,0.44680851063829785,0.5
45,95,50,40,50,75,355,0.54,106,90,130,90,154,110,680,0.8699186991869918,2.0
61,90,45,50,50,160,456,0.9230769230769231,60,70,105,70,120,75,500,0.5983606557377049,2.0
72,58,80,103,80,97,490,0.7171052631578947,40,70,130,60,130,25,455,0.17355371900826447,1.0
90,95,95,70,90,70,510,0.5230769230769231,50,180,20,180,20,150,600,0.9029850746268657,0.5
39,52,43,60,50,65,309,0.5041322314049587,35,45,160,30,45,70,385,0.48148148148148145,0.5
60,85,49,60,49,60,363,0.4444444444444444,58,109,112,48,48,109,484,0.8805970149253731,1.0
60,25,35,70,80,60,330,0.3076923076923077,100,50,50,76,96,70,442,0.5,1.0
110,78,73,76,71,60,468,0.3333333333333333,60,50,150,50,150,60,520,0.5206611570247934,2.0
80,120,80,120,80,100,580,0.8478260869565217,105,95,75,85,75,74,509,0.5714285714285714,1.0
91,90,106,130,106,77,600,0.648854961832061,80,95,82,60,82,75,474,0.6,1.0
70,60,62,80,82,60,414,0.4375,44,38,33,61,43,70,289,0.5267857142857143,0.5
65,73,55,47,75,85,400,0.6846846846846847,95,80,105,40,70,100,490,0.8046875,1.0
75,125,75,30,75,85,465,0.625,60,80,95,70,85,50,440,0.2231404958677686,2.0
35,64,85,74,55,32,345,0.19827586206896552,45,100,45,45,45,10,290,0.2949640287769784,2.0
106,150,70,194,120,140,780,0.952,80,100,123,122,120,80,625,0.56,2.0
100,103,75,120,75,127,600,0.940677966101695,75,89,85,55,65,36,405,0.29545454545454547,1.0
85,60,65,135,105,100,550,0.7518248175182481,80,110,120,130,90,70,600,0.6198347107438017,0.125
45,63,37,65,55,95,360,0.8055555555555556,40,35,30,20,20,50,195,0.23423423423423423,1.0
70,80,50,35,35,35,305,0.14,120,120,120,120,120,120,720,0.9344262295081968,2.0
90,60,60,40,40,40,330,0.29545454545454547,68,65,65,125,115,80,518,0.6461538461538462,1.0
45,49,65,49,65,45,318,0.275,50,65,45,85,65,95,405,0.7238095238095238,0.5
60,75,100,55,80,50,420,0.3088235294117647,35,35,40,35,55,50,250,0.40336134453781514,1.0
85,90,80,70,80,130,535,0.9262295081967213,64,66,68,81,76,50,405,0.25190839694656486,1.0
50,105,125,55,95,50,480,0.375886524822695,45,80,100,35,37,28,325,0.3125,0.25
52,65,55,58,62,60,352,0.4482758620689655,65,90,65,61,61,100,442,0.8373983739837398,1.0
55,50,40,40,40,75,300,0.5945945945945946,85,105,55,85,50,115,495,0.9032258064516129,1.0
52,65,50,45,50,38,300,0.27419354838709675,108,100,121,81,95,95,600,0.7476635514018691,2.0
60,67,85,77,75,116,480,0.8888888888888888,55,104,105,94,75,52,485,0.36363636363636365,2.0
76,104,71,104,71,108,534,0.912751677852349,35,65,35,65,35,65,300,0.46621621621621623,0.5
65,40,50,125,60,30,370,0.07258064516129033,30,40,55,40,55,60,280,0.3237410071942446,0.5
70,55,55,80,60,45,365,0.2222222222222222,90,120,100,150,120,100,680,0.7718120805369127,1.0
35,55,40,50,50,90,320,0.6838235294117647,58,64,58,80,65,80,405,0.5423728813559322,1.0
35,40,100,90,55,35,355,0.1796875,10,55,25,35,45,95,265,0.5396825396825397,1.0
105,95,75,85,75,74,509,0.5714285714285714,20,40,90,30,90,25,295,0.11363636363636363,1.0
25,35,70,95,55,45,325,0.16783216783216784,66,65,48,62,57,52,350,0.36220472440944884,0.5
75,140,65,112,65,110,567,0.9140625,50,35,55,25,25,15,205,0.021739130434782608,4.0
60,25,35,70,80,60,330,0.3076923076923077,100,100,90,150,140,90,670,0.71875,1.0
65,136,94,54,96,135,580,0.9612403100775194,45,50,45,115,55,95,405,0.6936936936936937,0.0
50,70,160,70,160,90,600,0.7417218543046358,65,90,122,58,75,84,494,0.71875,1.0
65,150,60,115,60,115,565,0.935251798561151,80,45,65,90,110,80,470,0.5462962962962963,2.0
50,85,55,65,65,90,410,0.7478260869565218,50,80,95,10,45,10,290,0.232,0.5
45,75,60,40,30,50,300,0.304,90,132,105,132,105,30,594,0.4246575342465753,1.0
65,65,65,50,50,90,385,0.72,95,85,85,65,65,35,430,0.2571428571428571,1.0
95,145,130,120,90,120,700,0.9398496240601504,55,85,55,50,55,60,360,0.4233576642335766,2.0
135,85,40,40,85,5,390,0.6864406779661016,95,155,109,70,130,81,640,0.6788321167883211,1.0
55,50,40,40,40,75,300,0.5945945945945946,62,55,52,109,94,109,481,0.7833333333333333,1.0
60,59,85,79,105,36,424,0.16666666666666666,50,85,55,65,65,90,410,0.7478260869565218,0.25
80,90,80,130,110,110,600,0.856,75,100,95,40,70,110,490,0.8717948717948718,1.0
30,45,55,70,55,85,340,0.5633802816901409,60,67,85,77,75,116,480,0.8888888888888888,0.5
35,55,35,30,30,35,220,0.23684210526315788,50,95,90,95,90,180,600,0.9172413793103448,2.0
75,125,100,70,80,45,495,0.33035714285714285,45,53,70,40,60,42,310,0.25735294117647056,4.0
65,130,60,75,60,75,465,0.689922480620155,70,55,55,80,60,45,365,0.2222222222222222,1.0
72,60,30,20,30,25,237,0.11570247933884298,106,110,90,154,90,130,680,0.926829268292683,0.5
60,65,80,170,95,130,600,0.8625954198473282,85,105,100,79,83,78,530,0.5869565217391305,1.0
100,103,75,120,75,127,600,0.940677966101695,20,15,20,10,55,80,200,0.2682926829268293,2.0
59,63,80,65,80,58,405,0.41843971631205673,100,90,130,45,65,55,485,0.4253731343283582,1.0
50,80,95,10,45,10,290,0.232,38,35,40,27,25,35,200,0.08208955223880597,2.0
61,90,45,50,50,160,456,0.9230769230769231,110,65,105,55,95,80,510,0.6258503401360545,1.0
64,88,50,88,50,106,446,0.9111111111111111,66,117,70,40,50,67,410,0.4573643410852713,1.0
80,80,50,40,50,25,325,0.176056338028169,20,40,15,35,35,60,205,0.34285714285714286,1.0
58,89,77,45,45,48,362,0.3177570093457944,50,92,108,92,108,35,485,0.2457627118644068,1.0
75,85,200,55,65,30,510,0.16778523489932887,50,105,79,35,110,76,455,0.6214285714285714,1.0
120,120,120,120,120,120,720,0.9344262295081968,79,115,70,125,80,111,580,0.8468468468468469,1.0
54,66,70,44,55,46,335,0.4214876033057851,72,95,67,103,71,122,530,0.9606299212598425,1.0
50,70,160,70,160,90,600,0.7417218543046358,35,80,50,50,70,120,405,0.84375,2.0
60,60,60,105,105,105,495,0.848,60,67,85,77,75,116,480,0.8888888888888888,1.0
255,10,10,75,135,55,540,0.3125,75,80,55,25,35,35,305,0.18666666666666668,1.0
60,55,50,40,55,45,305,0.22377622377622378,45,67,60,35,50,63,320,0.5128205128205128,1.0
79,85,60,55,60,71,410,0.60431654676259,100,100,100,100,100,100,600,0.831858407079646,1.0
125,58,58,76,76,67,460,0.515625,45,35,45,62,53,35,275,0.11851851851851852,0.25
50,65,107,105,107,86,520,0.703125,75,125,70,125,70,115,580,0.9037037037037037,1.0
30,56,35,25,35,72,253,0.48148148148148145,55,20,35,20,45,75,250,0.37681159420289856,1.0
85,120,70,50,60,100,485,0.8308823529411765,65,130,60,75,60,75,465,0.689922480620155,1.0
63,60,55,50,50,71,349,0.5289256198347108,104,91,63,91,73,68,490,0.5118110236220472,1.0
58,50,145,95,105,30,483,0.2459016393442623,110,123,65,100,65,65,528,0.5217391304347826,1.0
75,75,55,105,85,30,425,0.1619718309859155,95,110,95,40,95,55,490,0.40336134453781514,1.0
60,55,50,40,55,45,305,0.22377622377622378,100,100,125,110,50,50,535,0.384,4.0
55,85,122,58,75,99,494,0.8099173553719008,108,100,121,81,95,95,600,0.7476635514018691,1.0
75,70,90,70,105,80,490,0.656,70,90,70,60,60,70,420,0.6390977443609023,1.0
100,77,77,128,128,90,600,0.6901408450704225,105,30,105,140,105,55,540,0.3524590163934426,0.5
85,135,130,60,80,25,515,0.40540540540540543,100,77,77,128,128,90,600,0.6901408450704225,1.0
45,30,50,65,50,45,285,0.13821138211382114,70,110,180,60,60,50,530,0.4117647058823529,0.5
45,60,30,80,50,65,330,0.4603174603174603,54,63,52,83,56,97,405,0.7697841726618705,0.5
75,90,50,110,80,95,500,0.7985611510791367,77,120,90,60,90,48,485,0.2785714285714286,0.5
65,75,70,95,70,95,470,0.7272727272727273,70,92,65,80,55,98,460,0.8090909090909091,1.0
90,95,95,70,90,70,510,0.5230769230769231,60,45,70,75,85,55,390,0.3008130081300813,0.5
60,85,60,85,60,55,405,0.3673469387755102,44,38,33,61,43,70,289,0.5267857142857143,2.0
75,80,70,65,75,90,455,0.7578125,75,80,95,90,100,50,490,0.2158273381294964,4.0
50,65,107,105,107,86,520,0.703125,165,75,80,40,45,65,470,0.5151515151515151,1.0
65,83,57,95,85,105,490,0.8914728682170543,85,115,80,105,80,50,515,0.3063063063063063,0.5
40,45,65,100,120,90,460,0.5588235294117647,70,80,102,80,102,40,474,0.2677165354330709,1.0
70,60,62,80,82,60,414,0.4375,45,30,50,55,65,45,290,0.208,2.0
40,80,35,35,45,70,305,0.4661016949152542,55,95,115,45,45,35,390,0.2116788321167883,2.0
81,102,77,85,75,85,505,0.5642857142857143,79,115,70,125,80,111,580,0.8468468468468469,0.0
65,90,50,85,45,55,390,0.371900826446281,50,35,55,25,25,15,205,0.021739130434782608,0.5
30,45,55,70,55,85,340,0.5633802816901409,58,64,58,80,65,80,405,0.609271523178808,2.0
38,35,35,65,55,50,278,0.2647058823529412,60,85,60,85,60,55,405,0.3673469387755102,1.0
95,145,130,120,90,120,700,0.9398496240601504,65,47,55,73,75,85,400,0.65,2.0
95,110,95,40,95,55,490,0.40336134453781514,76,104,71,104,71,108,534,0.912751677852349,1.0
50,70,100,40,40,30,330,0.2222222222222222,70,140,70,110,65,105,560,0.95,0.5
95,85,85,65,65,35,430,0.2571428571428571,40,70,40,35,40,60,285,0.392,1.0
110,78,73,76,71,60,468,0.3333333333333333,41,64,45,50,50,50,300,0.36752136752136755,0.5
45,45,55,45,55,63,308,0.4594594594594595,35,80,50,50,70,120,405,0.84375,2.0
60,80,50,40,40,30,300,0.15328467153284672,55,55,50,45,65,55,325,0.37373737373737376,1.0
100,150,120,120,100,90,680,0.6493506493506493,76,25,45,67,55,24,292,0.0390625,1.0
59,74,50,35,50,35,303,0.3125,44,38,33,61,43,70,289,0.5267857142857143,0.0
95,23,48,23,48,23,260,0.046153846153846156,40,80,35,35,45,70,305,0.4661016949152542,1.0
85,50,95,120,115,80,545,0.5793650793650794,55,65,35,60,30,85,330,0.6126126126126126,1.0
62,77,62,50,42,65,358,0.4838709677419355,50,60,45,100,80,65,400,0.45689655172413796,2.0
38,30,85,55,65,30,303,0.21428571428571427,79,103,120,135,115,78,630,0.5763888888888888,1.0
77,59,50,67,63,46,362,0.23140495867768596,95,135,80,110,80,100,600,0.8248175182481752,8.0
90,120,100,150,120,100,680,0.7718120805369127,125,58,58,76,76,67,460,0.515625,0.5
255,10,10,75,135,55,540,0.3125,45,65,34,40,34,45,263,0.2589928057553957,1.0
100,100,80,60,60,50,450,0.3050847457627119,60,59,85,79,105,36,424,0.16666666666666666,0.5
35,60,44,40,54,55,288,0.366412213740458,111,83,68,92,82,39,475,0.1774193548387097,0.5
110,85,95,80,95,50,515,0.2713178294573643,90,85,100,95,125,85,580,0.6834532374100719,1.0
30,40,70,70,25,60,295,0.41353383458646614,65,80,140,40,70,70,465,0.5223880597014925,1.0
90,60,60,40,40,40,330,0.29545454545454547,44,58,44,58,44,61,309,0.41964285714285715,2.0
37,25,41,25,41,25,194,0.08870967741935484,70,40,50,55,50,25,290,0.061068702290076333,1.0
66,41,77,61,87,23,355,0.12096774193548387,50,50,62,40,62,65,329,0.4188034188034188,0.5
10,55,25,35,45,95,265,0.5396825396825397,70,100,115,30,65,30,410,0.24390243902439024,2.0
90,70,80,70,95,70,475,0.5190839694656488,28,25,25,45,35,40,198,0.16083916083916083,1.0
70,70,70,70,70,70,420,0.5289256198347108,70,120,65,45,85,125,510,0.9747899159663865,1.0
110,80,90,95,90,65,530,0.5033557046979866,100,50,50,76,96,70,442,0.5,2.0
70,55,75,45,65,60,370,0.45901639344262296,43,80,65,50,35,35,308,0.14193548387096774,1.0
82,80,86,85,75,72,480,0.6183206106870229,50,55,50,36,30,43,264,0.2922077922077922,1.0
50,85,85,55,55,50,380,0.3902439024390244,60,80,50,50,50,40,330,0.23853211009174313,1.0
70,94,50,94,50,66,424,0.48148148148148145,60,40,80,60,45,40,325,0.23529411764705882,8.0
55,70,45,70,50,60,350,0.45,84,71,43,71,43,48,360,0.25874125874125875,1.0
95,145,130,120,90,120,700,0.9398496240601504,65,65,45,75,45,95,390,0.72,2.0
70,50,30,95,135,105,485,0.8040540540540541,58,64,58,80,65,80,405,0.609271523178808,0.5
60,100,89,55,69,112,485,0.9298245614035088,74,48,76,83,81,104,466,0.7322834645669292,2.0
74,48,76,83,81,104,466,0.7322834645669292,76,104,71,104,71,108,534,0.912751677852349,1.0
70,120,65,45,85,125,510,0.9747899159663865,60,60,60,35,35,30,280,0.11194029850746269,1.0
90,70,80,70,95,70,475,0.5190839694656488,62,73,55,56,52,84,382,0.7244094488188977,2.0
80,110,60,150,130,70,600,0.5042016806722689,80,70,70,90,100,70,480,0.5609756097560976,1.0
65,95,57,100,85,93,495,0.7441860465116279,40,40,40,70,40,20,250,0.032520325203252036,0.5
60,115,105,65,70,80,495,0.7181818181818181,80,100,70,50,60,45,405,0.25806451612903225,0.5
80,50,100,100,200,50,580,0.2357142857142857,84,71,43,71,43,48,360,0.25874125874125875,1.0
75,123,67,95,85,95,540,0.7642276422764228,66,65,48,62,57,52,350,0.36220472440944884,0.5
70,50,30,95,135,105,485,0.8040540540540541,62,44,50,44,50,55,305,0.3629032258064516,1.0
77,120,90,60,90,48,485,0.2785714285714286,75,110,110,110,105,80,590,0.656934306569343,0.0
95,70,73,95,90,60,483,0.3983739837398374,50,50,50,50,50,50,300,0.30708661417322836,1.0
80,95,82,60,82,75,474,0.6,60,62,80,63,80,60,405,0.4336283185840708,2.0
75,85,200,55,65,30,510,0.16778523489932887,55,50,40,40,40,75,300,0.5945945945945946,1.0
90,30,15,40,20,15,210,0.043478260869565216,83,106,65,86,65,85,490,0.6640625,1.0
40,80,35,35,45,70,305,0.4661016949152542,35,40,100,90,55,35,355,0.1796875,2.0
100,100,100,100,100,100,600,0.8602941176470589,75,95,95,95,95,85,540,0.6470588235294118,1.0
83,80,75,70,70,101,479,0.8615384615384616,40,55,30,30,30,60,245,0.43548387096774194,1.0
80,135,130,95,90,70,600,0.5181818181818182,40,30,30,40,50,30,220,0.07936507936507936,0.5
60,55,90,145,90,80,520,0.6071428571428571,84,71,43,71,43,48,360,0.25874125874125875,0.0
73,100,60,100,60,65,458,0.42657342657342656,125,130,90,130,90,95,660,0.7734375,1.0
75,87,63,87,63,98,473,0.865546218487395,75,125,230,55,95,30,610,0.3448275862068966,1.0
65,125,100,60,70,70,490,0.6099290780141844,75,75,75,125,95,40,485,0.15671641791044777,2.0
40,50,90,30,55,65,330,0.44680851063829785,85,80,70,135,75,90,535,0.7006802721088435,1.0
110,80,90,95,90,65,530,0.5033557046979866,60,45,50,90,80,70,395,0.625,2.0
45,49,49,65,65,45,318,0.2781954887218045,55,75,60,75,60,103,428,0.7982456140350878,0.5
41,56,40,62,44,71,314,0.568,105,95,80,40,80,90,490,0.753968253968254,1.0
50,95,180,85,45,70,525,0.5298507462686567,105,105,75,65,100,50,500,0.37593984962406013,1.0
60,59,85,79,105,36,424,0.16666666666666666,90,120,75,60,60,45,450,0.29411764705882354,0.5
73,100,60,100,60,65,458,0.42657342657342656,70,55,55,80,60,45,365,0.2222222222222222,1.0
60,55,145,75,150,40,525,0.2,30,42,118,42,88,30,350,0.112,0.5
105,30,105,140,105,55,540,0.3524590163934426,108,112,118,68,72,47,525,0.2916666666666667,2.0
65,60,70,85,75,40,395,0.1796875,40,60,30,31,31,70,262,0.4492753623188406,1.0
85,120,70,50,60,100,485,0.8308823529411765,70,80,50,35,35,35,305,0.14,2.0
45,75,37,70,55,83,365,0.6183206106870229,110,135,60,50,65,88,508,0.7744360902255639,2.0
1,90,45,30,30,40,236,0.33064516129032256,105,95,75,85,75,74,509,0.5714285714285714,1.0
125,120,90,170,100,95,700,0.78125,60,82,45,45,45,74,351,0.5752212389380531,2.0
50,25,28,45,55,15,218,0.0625,85,56,77,50,77,78,423,0.53125,1.0
38,35,35,65,55,50,278,0.2647058823529412,65,136,94,54,96,135,580,0.9612403100775194,2.0
65,40,70,80,140,70,465,0.5954198473282443,125,58,58,76,76,67,460,0.515625,0.25
50,65,90,35,35,15,290,0.14678899082568808,75,123,67,95,85,95,540,0.7642276422764228,1.0
40,65,95,60,45,35,340,0.13986013986013987,95,80,105,40,70,100,490,0.8046875,1.0
50,65,107,105,107,86,520,0.7272727272727273,70,40,50,55,50,25,290,0.061068702290076333,2.0
106,110,90,154,90,130,680,0.926829268292683,50,45,45,35,35,50,260,0.23529411764705882,1.0
45,63,37,65,55,95,360,0.8055555555555556,100,5,5,15,65,30,220,0.07692307692307693,1.0
50,92,108,92,108,35,485,0.2457627118644068,50,20,55,25,25,30,205,0.09774436090225563,1.0
50,50,62,40,62,65,329,0.4188034188034188,50,95,95,35,110,70,455,0.5179856115107914,1.0
108,100,121,81,95,95,600,0.7476635514018691,75,75,55,105,85,30,425,0.1619718309859155,0.5
60,40,50,75,85,95,405,0.6044776119402985,65,110,130,60,65,95,525,0.8278145695364238,0.5
25,35,70,95,55,45,325,0.16783216783216784,58,64,58,80,65,80,405,0.5423728813559322,0.5
40,40,55,40,70,55,300,0.40939597315436244,85,80,70,135,75,90,535,0.7006802721088435,1.0
55,45,43,55,43,72,313,0.5853658536585366,85,110,76,65,82,56,474,0.3933333333333333,2.0
60,60,60,105,105,105,495,0.848,80,160,60,170,130,80,680,0.6180555555555556,1.0
28,25,25,45,35,40,198,0.16083916083916083,70,70,115,130,90,60,535,0.5338983050847458,0.25
74,94,131,54,116,20,489,0.4485294117647059,45,50,45,115,55,95,405,0.6936936936936937,0.5
62,50,58,73,54,72,369,0.4435483870967742,55,55,55,85,55,30,335,0.1320754716981132,1.0
53,54,53,37,46,45,288,0.3090909090909091,40,60,30,31,31,70,262,0.4492753623188406,1.0
73,100,60,100,60,65,458,0.42657342657342656,75,87,63,87,63,98,473,0.865546218487395,1.0
105,105,75,65,100,50,500,0.37593984962406013,95,110,95,40,95,55,490,0.40336134453781514,1.0
90,132,105,132,105,30,594,0.4246575342465753,50,65,90,35,35,15,290,0.14678899082568808,0.5
59,59,58,90,70,73,409,0.5826086956521739,95,109,105,75,85,56,525,0.34513274336283184,2.0
160,110,65,65,110,30,540,0.35714285714285715,110,135,60,50,65,88,508,0.7744360902255639,0.5
70,55,55,80,60,45,365,0.2222222222222222,40,45,35,30,40,55,245,0.3793103448275862,2.0
70,45,48,60,65,35,323,0.15748031496062992,55,112,45,74,45,70,401,0.559322033898305,1.0
75,80,95,90,100,50,490,0.2158273381294964,65,150,40,15,80,145,495,0.9663865546218487,0.25
55,45,43,55,43,72,313,0.5853658536585366,80,45,65,90,110,80,470,0.5462962962962963,0.5
105,30,105,140,105,55,540,0.3524590163934426,70,110,180,60,60,50,530,0.4117647058823529,0.5
30,45,59,30,39,57,260,0.2803030303030303,60,70,105,70,120,75,500,0.5983606557377049,1.0
50,70,160,70,160,90,600,0.7417218543046358,80,82,78,95,80,85,500,0.6869565217391305,1.0
60,80,50,50,50,40,330,0.23853211009174313,84,71,43,71,43,48,360,0.25874125874125875,1.0
55,50,45,135,95,120,500,0.7714285714285715,65,45,55,45,70,45,325,0.24369747899159663,1.0
55,95,115,45,45,35,390,0.2116788321167883,70,85,65,105,85,120,530,0.9262295081967213,0.5
40,45,35,30,40,55,245,0.3793103448275862,40,80,100,30,30,20,300,0.11851851851851852,0.125
45,40,60,40,75,50,310,0.2926829268292683,60,79,105,59,85,36,424,0.17054263565891473,2.0
95,65,65,110,130,60,525,0.4016393442622951,50,65,107,105,107,86,520,0.6991150442477876,0.5
35,35,40,35,55,50,250,0.40336134453781514,80,110,120,130,90,70,600,0.6198347107438017,1.0
55,95,115,45,45,35,390,0.2116788321167883,111,83,68,92,82,39,475,0.1774193548387097,0.5
25,35,70,95,55,45,325,0.16783216783216784,60,70,105,70,120,75,500,0.5983606557377049,0.0
56,61,65,48,45,38,313,0.17567567567567569,100,50,80,60,80,50,420,0.34375,2.0
40,30,50,55,55,100,330,0.584070796460177,80,135,85,70,95,150,615,0.9844961240310077,2.0
65,155,120,65,90,105,600,0.8677685950413223,77,85,51,55,51,65,384,0.5163934426229508,2.0
103,60,126,80,126,50,545,0.36363636363636365,75,95,125,45,75,95,510,0.8257575757575758,1.0
75,110,110,110,105,80,590,0.656934306569343,65,73,55,47,75,85,400,0.6846846846846847,1.0
50,60,60,60,60,30,320,0.11290322580645161,95,60,79,100,125,81,540,0.6201550387596899,0.5
55,20,35,20,45,75,250,0.37681159420289856,60,59,85,79,105,36,424,0.16666666666666666,1.0
90,120,75,60,60,45,450,0.29411764705882354,35,85,45,35,35,75,310,0.6492537313432836,1.0
86,81,97,81,107,43,495,0.203125,95,145,130,120,90,120,700,0.9398496240601504,0.5
62,73,55,56,52,84,382,0.7244094488188977,70,140,230,60,80,50,630,0.32432432432432434,1.0
64,66,68,81,76,50,405,0.25190839694656486,85,105,85,40,50,40,405,0.211864406779661,1.0
78,92,75,74,63,118,500,0.8842975206611571,40,50,90,30,55,65,330,0.44680851063829785,0.5
85,110,76,65,82,56,474,0.3933333333333333,40,40,35,50,100,70,335,0.5031847133757962,1.0
40,30,30,55,30,85,270,0.4666666666666667,50,95,90,95,90,180,600,0.9172413793103448,1.0
40,45,35,30,40,55,245,0.3793103448275862,65,80,140,40,70,70,465,0.5223880597014925,0.0
105,105,75,65,100,50,500,0.37593984962406013,80,70,65,80,120,100,515,0.8034188034188035,0.5
90,92,87,75,85,76,505,0.5409836065573771,45,30,50,55,65,45,290,0.208,1.0
60,90,70,60,120,40,440,0.27419354838709675,30,80,90,55,45,55,355,0.4295774647887324,0.5
74,48,76,83,81,104,466,0.7913043478260869,75,103,80,70,80,92,500,0.7933884297520661,1.0
60,69,95,69,95,36,424,0.2608695652173913,95,155,109,70,130,81,640,0.6788321167883211,1.0
38,30,85,55,65,30,303,0.21428571428571427,68,72,78,38,42,32,330,0.23809523809523808,1.0
45,50,43,40,38,62,278,0.40441176470588236,40,45,40,65,40,65,295,0.5661764705882353,0.5
44,38,39,61,79,42,303,0.2251655629139073,35,70,55,45,55,25,285,0.09420289855072464,1.0
72,58,80,103,80,97,490,0.7171052631578947,90,85,100,95,125,85,580,0.6834532374100719,1.0
52,65,50,45,50,38,300,0.27419354838709675,85,135,130,60,80,25,515,0.40540540540540543,1.0
62,55,52,109,94,109,481,0.7833333333333333,55,112,45,74,45,70,401,0.559322033898305,1.0
66,41,77,61,87,23,355,0.12096774193548387,70,85,70,60,70,50,405,0.28378378378378377,2.0
37,25,41,25,41,25,194,0.08870967741935484,55,50,40,40,40,75,300,0.5945945945945946,1.0
89,145,90,105,80,91,600,0.8549618320610687,75,95,95,95,95,85,540,0.6470588235294118,1.0
38,41,40,50,65,65,299,0.4108527131782946,90,130,80,65,85,55,505,0.4396551724137931,1.0
75,95,122,58,75,69,494,0.5725806451612904,55,50,65,175,95,150,590,0.7818181818181819,2.0
85,50,95,120,115,80,545,0.5793650793650794,55,85,122,58,75,99,494,0.8099173553719008,2.0
50,65,107,105,107,86,520,0.7272727272727273,75,89,85,55,65,36,405,0.29545454545454547,1.0
45,30,35,20,20,45,195,0.14782608695652175,95,110,95,40,95,55,490,0.40336134453781514,1.0
65,136,94,54,96,135,580,0.9612403100775194,95,117,184,44,46,28,514,0.2975206611570248,2.0
45,22,60,27,30,29,213,0.07518796992481203,70,40,50,55,50,25,290,0.061068702290076333,1.0
50,65,64,44,48,43,314,0.2196969696969697,80,145,150,105,110,110,700,0.8692307692307693,1.0
72,85,70,65,70,58,420,0.41304347826086957,35,55,40,50,50,90,320,0.6838235294117647,1.0
59,45,40,35,40,31,250,0.14285714285714285,160,110,65,65,110,30,540,0.35714285714285715,1.0
97,165,60,65,50,58,495,0.3902439024390244,50,70,160,70,160,90,600,0.7417218543046358,1.0
78,65,68,112,154,75,552,0.628099173553719,74,94,131,54,116,20,489,0.4485294117647059,0.5
58,109,112,48,48,109,484,0.8805970149253731,50,75,75,65,65,50,380,0.4049586776859504,1.0
110,65,105,55,95,80,510,0.6258503401360545,105,140,95,55,65,45,505,0.3,1.0
60,50,100,85,70,65,430,0.47580645161290325,80,75,150,75,150,50,580,0.30973451327433627,0.5
60,75,85,100,85,115,520,0.8992248062015504,78,130,111,130,85,100,634,0.8561151079136691,1.0
64,78,52,78,52,81,405,0.6422764227642277,45,50,55,75,65,30,320,0.06293706293706294,1.0
90,92,87,75,85,76,505,0.5409836065573771,55,69,85,32,35,28,304,0.09302325581395349,1.0
43,80,65,50,35,35,308,0.14193548387096774,50,65,85,35,35,55,325,0.32575757575757575,2.0
40,50,45,70,45,70,320,0.5517241379310345,75,125,75,30,75,85,465,0.625,2.0
76,104,71,104,71,108,534,0.912751677852349,70,90,45,15,45,50,315,0.3629032258064516,0.5
55,81,60,50,70,97,413,0.7214285714285714,40,45,35,65,55,70,310,0.4482758620689655,1.0
45,50,35,55,75,40,300,0.21367521367521367,78,52,60,63,65,23,341,0.06015037593984962,0.0
110,65,105,55,95,80,510,0.6258503401360545,60,85,49,60,49,60,363,0.4444444444444444,0.5
75,75,60,83,60,60,413,0.39344262295081966,78,84,78,109,85,100,534,0.8646616541353384,2.0
60,85,49,60,49,60,363,0.4444444444444444,88,107,122,74,75,64,530,0.4596774193548387,0.5
91,129,90,72,90,108,580,0.8536585365853658,85,105,55,85,50,115,495,0.9032258064516129,1.0
65,65,65,50,50,90,385,0.72,50,70,50,50,50,40,310,0.16296296296296298,0.5
80,70,65,80,120,100,515,0.8034188034188035,50,85,40,85,40,35,335,0.1746031746031746,1.0
40,30,32,50,52,65,269,0.3671875,35,85,45,35,35,75,310,0.6492537313432836,0.5
126,131,95,131,98,99,680,0.8102189781021898,35,60,44,40,54,55,288,0.366412213740458,1.0
30,105,90,25,25,50,325,0.2773722627737226,60,90,55,90,80,110,485,0.8677685950413223,1.0
65,110,130,60,65,95,525,0.8278145695364238,45,20,50,60,120,50,345,0.24074074074074073,1.0
105,95,75,85,75,74,509,0.5714285714285714,90,95,105,165,110,45,610,0.2890625,1.0
80,120,80,120,80,100,580,0.8478260869565217,95,117,184,44,46,28,514,0.2975206611570248,0.5
69,55,45,55,55,15,294,0.11666666666666667,50,50,77,95,77,91,440,0.5916666666666667,0.5
25,35,70,95,55,45,325,0.16783216783216784,75,55,70,55,95,110,460,0.8444444444444444,1.0
65,125,60,95,60,105,510,0.9236641221374046,125,58,58,76,76,67,460,0.515625,1.0
100,100,80,60,60,50,450,0.3050847457627119,40,30,30,55,30,85,270,0.4666666666666667,0.0
90,95,95,70,90,70,510,0.5230769230769231,60,75,85,100,85,115,520,0.8992248062015504,0.25
90,65,65,40,40,15,315,0.19672131147540983,71,73,88,120,89,59,500,0.43537414965986393,0.5
35,46,34,35,45,20,215,0.072,79,85,60,55,60,71,410,0.60431654676259,1.0
45,53,70,40,60,42,310,0.25735294117647056,125,120,90,170,100,95,700,0.78125,0.5
68,72,78,38,42,32,330,0.23809523809523808,55,35,50,55,110,85,390,0.6277372262773723,0.0
95,100,85,108,70,70,528,0.5652173913043478,55,55,50,45,65,55,325,0.37373737373737376,1.0
108,130,95,80,85,102,600,0.7637795275590551,65,136,94,54,96,135,580,0.9612403100775194,1.0
20,15,20,10,55,80,200,0.2682926829268293,45,30,50,55,65,45,290,0.208,1.0
46,57,40,40,40,50,273,0.25,40,80,35,35,45,70,305,0.4661016949152542,1.0
126,131,95,131,98,99,680,0.8294573643410853,69,55,45,55,55,15,294,0.11666666666666667,0.5
58,89,77,45,45,48,362,0.3177570093457944,70,80,50,35,35,35,305,0.14,0.5
57,80,91,80,87,75,470,0.5737704918032787,60,50,150,50,150,60,520,0.5206611570247934,0.25
73,95,62,85,65,85,465,0.6666666666666666,84,71,43,71,43,48,360,0.25874125874125875,1.0
55,20,35,20,45,75,250,0.37681159420289856,68,125,65,65,115,80,518,0.6277372262773723,1.0
90,100,90,125,85,90,580,0.7352941176470589,30,40,55,40,55,60,280,0.3237410071942446,2.0
30,40,70,70,25,60,295,0.41353383458646614,65,83,57,95,85,105,490,0.8914728682170543,1.0
83,80,80,135,80,121,579,0.9444444444444444,125,58,58,76,76,67,460,0.515625,0.5
95,75,180,130,80,30,590,0.13793103448275862,60,80,50,50,50,40,330,0.23853211009174313,1.0
165,75,80,40,45,65,470,0.5151515151515151,101,72,72,99,89,29,462,0.1937984496124031,1.0
45,25,50,25,25,35,205,0.13076923076923078,70,85,65,105,85,120,530,0.9262295081967213,4.0
35,55,40,50,50,90,320,0.6838235294117647,45,80,100,35,37,28,325,0.3125,1.0
62,73,55,56,52,84,382,0.7244094488188977,60,40,60,95,60,55,370,0.4222222222222222,0.5
60,67,85,77,75,116,480,0.8888888888888888,40,30,50,55,55,100,330,0.584070796460177,1.0
60,110,70,60,60,100,460,0.8461538461538461,65,136,94,54,96,135,580,0.9612403100775194,2.0
50,70,50,50,50,40,310,0.16296296296296298,20,25,45,70,90,60,310,0.30833333333333335,1.0
75,85,200,55,65,30,510,0.16778523489932887,81,102,77,85,75,85,505,0.5642857142857143,2.0
79,115,70,125,80,111,580,0.864,82,121,119,69,59,71,521,0.5394736842105263,0.25
60,95,80,60,80,30,405,0.19480519480519481,89,124,80,55,80,55,483,0.5714285714285714,1.0
82,121,119,69,59,71,521,0.5394736842105263,75,80,55,25,35,35,305,0.18666666666666668,0.5
35,35,40,35,55,50,250,0.40336134453781514,45,65,34,40,34,45,263,0.2589928057553957,0.5
75,89,85,55,65,36,405,0.29545454545454547,50,80,95,10,45,10,290,0.232,2.0
40,55,80,35,60,30,300,0.15037593984962405,70,80,65,90,65,85,455,0.578125,0.5
65,65,60,130,95,110,525,0.823943661971831,45,67,60,35,50,63,320,0.5128205128205128,1.0
95,75,110,100,80,30,490,0.15267175572519084,45,75,60,40,30,50,300,0.304,0.5
40,60,30,31,31,70,262,0.4492753623188406,60,59,85,79,105,36,424,0.16666666666666666,4.0
67,57,55,77,55,114,425,0.8879310344827587,70,110,180,60,60,50,530,0.4117647058823529,0.125
67,82,62,46,48,43,348,0.22033898305084745,78,70,61,50,61,100,420,0.8145161290322581,2.0
64,165,75,93,83,75,555,0.6587301587301587,85,105,85,40,50,40,405,0.211864406779661,1.0
40,80,35,35,45,70,305,0.4661016949152542,40,55,30,30,30,60,245,0.43548387096774194,1.0
71,73,88,120,89,59,500,0.43537414965986393,80,52,50,90,50,89,411,0.6666666666666666,1.0
110,123,65,100,65,65,528,0.5217391304347826,45,30,40,105,50,20,290,0.031007751937984496,0.5
20,15,20,10,55,80,200,0.2682926829268293,41,56,40,62,44,71,314,0.568,0.5
165,75,80,40,45,65,470,0.5151515151515151,81,102,77,85,75,85,505,0.5642857142857143,2.0
70,140,70,110,65,105,560,0.95,68,72,78,38,42,32,330,0.23809523809523808,2.0
75,98,63,98,63,101,498,0.889763779527559,45,60,30,80,50,65,330,0.4603174603174603,0.5
54,78,103,53,45,22,355,0.23255813953488372,62,44,50,44,50,55,305,0.3629032258064516,1.0
60,85,69,60,69,77,420,0.518796992481203,95,155,109,70,130,81,640,0.6788321167883211,1.0
54,63,52,83,56,97,405,0.7697841726618705,100,5,5,15,65,30,220,0.07692307692307693,1.0
65,100,70,80,80,105,500,0.8666666666666667,65,70,60,65,65,115,440,0.8583333333333333,1.0
50,65,107,105,107,86,520,0.7758620689655172,50,80,95,10,45,10,290,0.232,2.0
80,82,83,100,100,80,525,0.6742424242424242,65,55,115,100,40,60,435,0.3798449612403101,1.0
70,94,50,94,50,66,424,0.48148148148148145,59,59,58,90,70,73,409,0.5826086956521739,0.5
45,85,70,40,40,60,340,0.5229357798165137,60,100,115,70,85,90,520,0.7557251908396947,0.5
65,73,55,47,75,85,400,0.6846846846846847,70,75,80,135,80,135,575,0.917910447761194,1.0
45,50,35,55,75,40,300,0.21367521367521367,95,110,80,70,80,50,485,0.37209302325581395,1.0
75,38,38,56,56,67,330,0.5263157894736842,70,100,115,30,65,30,410,0.24390243902439024,2.0
60,60,60,85,85,85,435,0.631578947368421,59,63,80,65,80,58,405,0.41843971631205673,1.0
60,80,110,50,80,45,425,0.2833333333333333,125,58,58,76,76,67,460,0.515625,2.0
35,64,85,74,55,32,345,0.19827586206896552,54,45,47,75,98,52,371,0.39669421487603307,1.0
60,52,168,47,138,30,495,0.19834710743801653,40,60,30,31,31,70,262,0.4492753623188406,2.0
126,131,95,131,98,99,680,0.8102189781021898,100,120,100,150,120,90,680,0.728,1.0
60,70,105,70,120,75,500,0.5983606557377049,50,50,77,95,77,91,440,0.5916666666666667,2.0
60,79,105,59,85,36,424,0.17054263565891473,80,80,50,40,50,25,325,0.176056338028169,1.0
35,45,160,30,45,70,385,0.48148148148148145,90,55,75,60,75,30,385,0.13970588235294118,1.0
83,106,65,86,65,85,490,0.6640625,50,120,53,35,110,87,455,0.640625,1.0
40,30,30,40,50,30,220,0.07936507936507936,38,35,35,65,55,50,278,0.2647058823529412,1.0
89,125,90,115,80,101,600,0.8725490196078431,70,120,100,145,105,20,560,0.2824427480916031,2.0
50,60,45,100,80,65,400,0.45689655172413796,40,50,45,70,45,70,320,0.5517241379310345,0.5
40,40,35,50,100,70,335,0.5031847133757962,45,55,45,65,45,75,330,0.5692307692307692,1.0
95,80,105,40,70,100,490,0.8046875,78,81,71,74,69,126,499,0.9090909090909091,1.0
70,90,110,60,75,95,500,0.7333333333333333,70,62,67,55,55,56,365,0.38513513513513514,0.5
55,45,50,45,65,80,340,0.5546218487394958,50,70,50,50,50,70,340,0.5645161290322581,1.0
55,66,44,44,56,85,350,0.6888888888888889,91,134,95,100,100,80,600,0.6304347826086957,1.0
60,60,60,35,35,30,280,0.11194029850746269,48,61,40,61,40,50,300,0.2543859649122807,1.0
71,82,64,64,59,112,452,0.9327731092436975,50,53,48,53,48,64,316,0.46153846153846156,1.0
75,100,110,45,55,65,450,0.5333333333333333,80,80,90,110,130,110,600,0.8721804511278195,1.0
39,52,43,60,50,65,309,0.49107142857142855,60,150,50,150,50,60,520,0.5,2.0
40,70,40,35,40,60,285,0.392,73,95,62,85,65,85,465,0.6666666666666666,2.0
20,10,55,15,20,80,200,0.17985611510791366,65,80,140,40,70,70,465,0.5223880597014925,1.0
95,85,85,65,65,35,430,0.2571428571428571,75,80,60,65,90,102,472,0.8625954198473282,1.0
35,35,40,35,55,50,250,0.40336134453781514,70,70,40,60,40,60,340,0.4247787610619469,1.0
100,164,150,95,120,71,700,0.5645161290322581,80,160,60,170,130,80,680,0.6180555555555556,1.0
60,65,60,130,75,110,500,0.7719298245614035,45,45,55,45,55,63,308,0.4594594594594595,2.0
45,30,15,85,65,65,305,0.36220472440944884,45,53,70,40,60,42,310,0.25735294117647056,2.0
60,110,70,60,60,100,460,0.8461538461538461,70,110,75,145,85,145,630,0.9444444444444444,2.0
58,50,145,95,105,30,483,0.2459016393442623,60,69,95,69,95,36,424,0.2608695652173913,1.0
91,90,72,90,129,108,580,0.896,55,70,40,60,40,40,305,0.26956521739130435,2.0
57,80,91,80,87,75,470,0.5737704918032787,65,83,57,95,85,105,490,0.8914728682170543,0.5
95,125,79,60,100,81,540,0.6165413533834586,75,75,130,75,130,95,580,0.7479674796747967,1.0
70,84,70,65,70,51,410,0.2949640287769784,75,125,75,30,75,85,465,0.625,0.5
35,55,35,30,30,35,220,0.23684210526315788,72,105,115,54,86,68,500,0.5149253731343284,1.0
40,30,32,50,52,65,269,0.3671875,79,100,80,110,90,121,580,0.968,0.5
100,5,5,15,65,30,220,0.07692307692307693,65,45,55,45,70,45,325,0.24369747899159663,1.0
70,55,95,95,110,65,490,0.48872180451127817,60,100,115,70,85,90,520,0.7557251908396947,0.5
78,84,78,109,85,100,534,0.8620689655172413,60,45,70,45,90,95,405,0.7304964539007093,1.0
60,50,70,80,80,140,480,0.8449612403100775,64,165,75,93,83,75,555,0.6587301587301587,1.0
60,55,145,75,150,40,525,0.2,40,55,99,40,79,47,360,0.26262626262626265,2.0
90,100,70,110,150,80,600,0.6037735849056604,83,106,65,86,65,85,490,0.6640625,1.0
75,125,230,55,95,30,610,0.3448275862068966,75,125,70,125,70,115,580,0.9037037037037037,1.0
95,75,180,130,80,30,590,0.13793103448275862,90,60,60,40,40,40,330,0.29545454545454547,4.0
55,95,55,35,75,115,430,0.9380530973451328,55,55,55,85,55,30,335,0.1320754716981132,2.0
95,117,80,65,70,92,519,0.8409090909090909,40,55,70,45,60,30,300,0.10619469026548672,2.0
45,30,50,65,50,45,285,0.13821138211382114,40,27,60,37,50,66,280,0.36220472440944884,1.0
101,72,72,99,89,29,462,0.1937984496124031,150,100,120,100,120,90,680,0.6666666666666666,2.0
60,70,65,125,105,90,515,0.6911764705882353,70,75,60,105,60,105,475,0.88,1.0
40,45,40,62,60,60,307,0.33884297520661155,110,130,80,70,60,80,530,0.5862068965517241,2.0
40,45,35,30,40,55,245,0.3793103448275862,80,50,100,100,200,50,580,0.2357142857142857,1.0
75,95,60,65,60,115,470,0.8778625954198473,55,55,45,63,45,45,308,0.25,1.0
70,135,105,60,105,20,495,0.5806451612903226,70,77,60,97,60,108,472,0.8394160583941606,0.5
25,35,70,95,55,45,325,0.16783216783216784,125,120,90,170,100,95,700,0.78125,1.0
50,60,45,100,80,65,400,0.45689655172413796,75,98,63,98,63,101,498,0.8091603053435115,1.0
80,130,100,160,120,110,700,0.8981481481481481,70,110,80,55,80,105,500,0.8794326241134752,1.0
85,60,65,135,105,100,550,0.7518248175182481,37,25,41,25,41,25,194,0.08870967741935484,2.0
79,115,70,125,80,111,580,0.864,75,95,125,45,75,95,510,0.8257575757575758,0.0
59,110,150,45,49,35,448,0.3333333333333333,40,35,30,20,20,50,195,0.23423423423423423,1.0
79,103,120,135,115,78,630,0.5763888888888888,65,60,110,130,95,65,525,0.47761194029850745,1.0
60,69,95,69,95,36,424,0.2608695652173913,84,71,43,71,43,48,360,0.25874125874125875,1.0
10,55,25,35,45,95,265,0.5396825396825397,90,110,80,100,80,95,555,0.7982456140350878,2.0
50,47,50,57,50,65,319,0.463768115942029,50,92,108,92,108,35,485,0.2457627118644068,1.0
70,110,80,55,80,105,500,0.8794326241134752,90,93,55,70,55,55,418,0.3819444444444444,0.5
95,125,79,60,100,81,540,0.6165413533834586,105,140,55,30,55,95,480,0.8195488721804511,2.0
44,75,35,63,33,45,295,0.2647058823529412,53,54,53,37,46,45,288,0.3090909090909091,1.0
60,85,60,85,60,55,405,0.3673469387755102,75,95,122,58,75,69,494,0.5725806451612904,0.0
60,62,63,80,80,60,405,0.38016528925619836,50,50,150,50,150,50,500,0.2571428571428571,2.0
40,30,30,55,30,85,270,0.4666666666666667,82,121,119,69,59,71,521,0.5394736842105263,0.5
38,36,38,32,36,57,237,0.3893805309734513,108,112,118,68,72,47,525,0.2916666666666667,1.0
70,95,85,55,65,70,440,0.5,76,65,45,92,42,91,411,0.7449664429530202,2.0
60,60,60,35,35,30,280,0.11194029850746269,90,100,90,125,85,90,580,0.7352941176470589,1.0
100,70,70,65,65,45,415,0.1897810218978102,75,75,130,75,130,95,580,0.7479674796747967,1.0
75,100,110,45,55,65,450,0.5333333333333333,75,65,55,65,55,69,384,0.43548387096774194,1.0
48,61,40,61,40,50,300,0.2543859649122807,78,65,68,112,154,75,552,0.628099173553719,1.0
85,105,100,79,83,78,530,0.5869565217391305,76,147,90,60,70,97,540,0.8267716535433071,0.5
37,25,41,25,41,25,194,0.08870967741935484,70,75,60,105,60,105,475,0.88,1.0
60,65,80,170,95,130,600,0.8625954198473282,50,55,50,36,30,43,264,0.2922077922077922,0.0
76,25,45,67,55,24,292,0.0390625,45,75,60,40,30,50,300,0.304,1.0
55,95,115,45,45,35,390,0.2116788321167883,91,90,72,90,129,108,580,0.896,0.25
75,75,60,83,60,60,413,0.39344262295081966,75,95,122,58,75,69,494,0.5725806451612904,0.5
91,90,72,90,129,108,580,0.896,65,63,45,45,45,45,308,0.2595419847328244,0.5
90,132,105,132,105,30,594,0.4246575342465753,55,68,64,45,55,31,318,0.11666666666666667,1.0
59,59,58,90,70,73,409,0.5826086956521739,54,45,47,75,98,52,371,0.39669421487603307,1.0
73,100,60,100,60,65,458,0.42657342657342656,50,64,50,45,50,41,300,0.22727272727272727,0.25
50,105,79,35,110,76,455,0.6214285714285714,86,81,97,81,107,43,495,0.203125,2.0
63,63,47,41,41,74,329,0.56,43,80,65,50,35,35,308,0.14193548387096774,1.0
45,55,39,35,39,42,255,0.18518518518518517,60,85,42,85,42,91,405,0.8227848101265823,1.0
160,110,65,65,110,30,540,0.35714285714285715,41,56,40,62,44,71,314,0.568,1.0
65,80,80,59,63,58,405,0.4411764705882353,150,120,100,120,100,90,680,0.664179104477612,0.5
105,105,75,65,100,50,500,0.37593984962406013,66,117,70,40,50,67,410,0.4573643410852713,1.0
50,70,50,50,50,40,310,0.16296296296296298,55,70,45,70,50,60,350,0.45,2.0
30,80,90,55,45,55,355,0.4295774647887324,90,85,75,115,100,115,580,0.9381443298969072,1.0
55,45,43,55,43,72,313,0.5853658536585366,95,85,85,65,65,35,430,0.2571428571428571,2.0
80,50,100,100,200,50,580,0.2357142857142857,60,70,50,100,50,65,395,0.5217391304347826,2.0
40,27,60,37,50,66,280,0.36220472440944884,50,60,60,60,60,30,320,0.11290322580645161,0.5
50,105,125,55,95,50,480,0.375886524822695,90,75,85,115,90,55,510,0.3445378151260504,0.5
95,135,80,110,80,100,600,0.8248175182481752,35,70,55,45,55,25,285,0.09420289855072464,4.0
50,65,107,105,107,86,520,0.7272727272727273,60,85,49,60,49,60,363,0.4444444444444444,0.25
111,83,68,92,82,39,475,0.1774193548387097,90,132,105,132,105,30,594,0.4246575342465753,0.25
90,50,34,60,44,70,348,0.6283185840707964,100,120,100,150,120,90,680,0.728,1.0
75,95,67,125,95,83,540,0.7117117117117117,57,80,91,80,87,75,470,0.5737704918032787,2.0
53,51,53,61,56,40,314,0.14285714285714285,135,85,40,40,85,5,390,0.6864406779661016,1.0
45,49,65,49,65,45,318,0.275,60,100,89,55,69,112,485,0.9298245614035088,0.25
70,43,53,43,53,40,302,0.19090909090909092,60,50,40,85,75,95,405,0.7540983606557377,1.0
50,95,95,35,110,70,455,0.5179856115107914,80,80,50,40,50,25,325,0.176056338028169,0.5
40,80,35,35,45,70,305,0.4661016949152542,62,48,66,59,57,49,341,0.33884297520661155,0.5
60,50,100,85,70,65,430,0.47580645161290325,79,103,120,135,115,78,630,0.5763888888888888,0.5
50,55,50,36,30,43,264,0.2922077922077922,55,66,44,44,56,85,350,0.6888888888888889,1.0
73,76,75,81,100,100,505,0.8110236220472441,70,115,60,115,60,55,475,0.4647887323943662,2.0
75,38,38,56,56,67,330,0.5263157894736842,60,69,95,69,95,36,424,0.2608695652173913,1.0
74,94,131,54,116,20,489,0.4485294117647059,60,85,40,30,45,68,328,0.6422018348623854,2.0
65,65,45,75,45,95,390,0.72,59,45,40,35,40,31,250,0.14285714285714285,1.0
80,45,65,90,110,80,470,0.5462962962962963,55,70,55,40,55,85,360,0.7073170731707317,1.0
40,45,35,30,40,55,245,0.3793103448275862,50,50,120,80,80,30,410,0.07258064516129033,0.25
85,105,55,85,50,115,495,0.9032258064516129,70,100,70,105,75,40,460,0.23214285714285715,4.0
91,90,106,130,106,77,600,0.648854961832061,55,55,50,45,65,55,325,0.37373737373737376,1.0
95,145,130,120,90,120,700,0.9398496240601504,95,125,79,60,100,81,540,0.6165413533834586,1.0
35,40,100,90,55,35,355,0.1796875,45,50,55,75,65,30,320,0.06293706293706294,0.5
41,56,40,62,44,71,314,0.568,50,70,100,40,40,30,330,0.2222222222222222,2.0
40,80,35,35,45,70,305,0.4661016949152542,80,82,78,95,80,85,500,0.6869565217391305,1.0
100,50,80,60,80,50,420,0.34375,50,50,120,80,80,30,410,0.07258064516129033,2.0
45,49,65,49,65,45,318,0.275,70,130,100,55,80,65,500,0.608,0.25
90,120,75,60,60,45,450,0.29411764705882354,50,85,125,85,115,20,480,0.4306569343065693,2.0
75,105,75,105,75,45,480,0.3274336283185841,65,75,90,97,123,44,494,0.1987179487179487,0.5
80,85,95,30,30,25,345,0.2857142857142857,60,60,40,65,45,35,305,0.15833333333333333,2.0
65,110,130,60,65,95,525,0.8278145695364238,65,75,70,95,70,95,470,0.7272727272727273,0.5
76,104,71,104,71,108,534,0.912751677852349,101,72,72,99,89,29,462,0.1937984496124031,0.5
110,123,65,100,65,65,528,0.5217391304347826,76,65,45,92,42,91,411,0.7449664429530202,1.0
58,70,45,40,45,42,300,0.25925925925925924,50,160,110,160,110,110,700,0.8854961832061069,0.0
70,140,230,60,80,50,630,0.32432432432432434,80,125,75,40,95,85,500,0.6911764705882353,1.0
69,69,76,69,86,91,460,0.6554621848739496,65,130,60,95,110,65,525,0.5303030303030303,2.0
45,30,50,65,50,45,285,0.13821138211382114,35,55,40,45,40,60,275,0.35714285714285715,1.0
70,85,65,105,85,120,530,0.9262295081967213,78,84,78,109,85,100,534,0.8646616541353384,0.25
35,60,44,40,54,55,288,0.366412213740458,60,75,85,100,85,115,520,0.8992248062015504,1.0
100,100,100,100,100,100,600,0.8345864661654135,57,80,91,80,87,75,470,0.5737704918032787,0.25
40,55,99,40,79,47,360,0.26262626262626265,80,105,105,105,105,80,580,0.5939849624060151,2.0
35,65,35,65,35,65,300,0.46621621621621623,67,57,55,77,55,114,425,0.8879310344827587,1.0
60,60,75,60,75,80,410,0.7321428571428571,60,65,70,85,75,40,395,0.21705426356589147,1.0
55,104,105,94,75,52,485,0.36363636363636365,170,90,45,90,45,60,500,0.427536231884058,0.5
60,62,50,62,60,40,334,0.18181818181818182,50,105,125,55,95,50,480,0.375886524822695,0.25
50,30,55,65,55,20,275,0.13675213675213677,40,30,30,55,30,85,270,0.4666666666666667,0.5
60,45,70,45,90,95,405,0.7304964539007093,60,60,50,40,50,75,335,0.5882352941176471,0.5
80,185,115,40,105,75,600,0.6230769230769231,72,85,70,65,70,58,420,0.41304347826086957,4.0
130,70,35,70,35,60,400,0.4017857142857143,80,80,90,110,130,110,600,0.8721804511278195,0.5
120,70,120,75,130,85,600,0.6694915254237288,50,47,50,57,50,65,319,0.463768115942029,1.0
110,65,105,55,95,80,510,0.6258503401360545,70,145,88,140,70,112,625,0.8888888888888888,0.5
85,80,90,105,95,60,515,0.49074074074074076,60,90,140,50,50,40,430,0.2535211267605634,0.25
35,35,40,35,55,50,250,0.40336134453781514,90,132,105,132,105,30,594,0.4246575342465753,1.0
75,140,65,112,65,110,567,0.9140625,68,75,53,83,113,60,452,0.45384615384615384,1.0
50,65,64,44,48,43,314,0.2196969696969697,91,134,95,100,100,80,600,0.6304347826086957,0.5
80,100,123,122,120,80,625,0.56,58,109,112,48,48,109,484,0.8805970149253731,0.0
79,100,80,110,90,121,580,0.968,65,110,130,60,65,95,525,0.8278145695364238,2.0
85,80,90,105,95,60,515,0.49074074074074076,65,73,55,47,75,85,400,0.6846846846846847,1.0
80,82,83,100,100,80,525,0.6742424242424242,86,68,72,109,66,106,507,0.8099173553719008,0.5
55,66,44,44,56,85,350,0.6888888888888889,41,50,37,50,37,66,281,0.5175438596491229,1.0
65,75,105,35,65,85,430,0.6940298507462687,60,60,50,40,50,75,335,0.5882352941176471,1.0
75,80,70,65,75,90,455,0.7578125,80,145,150,105,110,110,700,0.8692307692307693,0.0
75,55,70,55,95,110,460,0.8444444444444444,80,50,100,100,200,50,580,0.2357142857142857,1.0
59,59,58,90,70,73,409,0.5826086956521739,70,120,100,145,105,20,560,0.2824427480916031,0.5
90,95,95,70,90,70,510,0.5230769230769231,60,60,60,85,85,85,435,0.631578947368421,0.0
65,100,70,80,80,105,500,0.8666666666666667,50,25,28,45,55,15,218,0.0625,1.0
37,25,41,25,41,25,194,0.08870967741935484,60,85,69,60,69,77,420,0.518796992481203,1.0
52,65,50,45,50,38,300,0.27419354838709675,80,80,90,110,130,110,600,0.8721804511278195,4.0
75,80,95,90,100,50,490,0.2158273381294964,90,95,95,70,90,70,510,0.5230769230769231,2.0
50,35,55,25,25,15,205,0.021739130434782608,40,50,45,70,45,70,320,0.5517241379310345,1.0
100,123,75,57,75,80,510,0.6923076923076923,60,40,60,40,60,35,295,0.18055555555555555,2.0
60,65,60,130,75,110,500,0.7719298245614035,75,123,67,95,85,95,540,0.7642276422764228,1.0
115,115,85,90,75,100,580,0.8134328358208955,120,120,120,120,120,120,720,0.9344262295081968,1.0
45,75,60,40,30,50,300,0.304,1,90,45,30,30,40,236,0.33064516129032256,1.0
45,85,70,40,40,60,340,0.5229357798165137,80,130,100,160,120,110,700,0.8981481481481481,2.0
90,93,55,70,55,55,418,0.3819444444444444,64,78,52,78,52,81,405,0.6422764227642277,0.5
75,87,63,87,63,98,473,0.865546218487395,55,40,50,65,85,40,335,0.3181818181818182,0.5
70,85,65,105,85,120,530,0.9262295081967213,35,35,35,35,35,35,210,0.13385826771653545,1.0
50,95,95,35,110,70,455,0.5179856115107914,75,80,85,110,90,50,490,0.3548387096774194,0.5
50,20,40,20,40,20,190,0.0962962962962963,45,40,60,40,75,50,310,0.2926829268292683,1.0
55,40,40,65,45,35,280,0.16428571428571428,50,53,62,58,63,44,330,0.13709677419354838,2.0
75,80,85,110,90,50,490,0.3548387096774194,30,30,42,30,42,70,244,0.4230769230769231,0.25
38,36,38,32,36,57,237,0.3893805309734513,55,47,52,40,40,41,275,0.16806722689075632,1.0
74,108,133,83,65,32,495,0.32142857142857145,123,77,72,99,92,58,521,0.4621212121212121,4.0
74,108,133,83,65,32,495,0.32142857142857145,90,50,34,60,44,70,348,0.6283185840707964,2.0
90,65,65,40,40,15,315,0.19672131147540983,60,90,55,90,80,110,485,0.8677685950413223,1.0
90,70,80,70,95,70,475,0.5190839694656488,50,50,150,50,150,50,500,0.2571428571428571,2.0
105,140,95,55,65,45,505,0.3,50,50,40,50,40,64,294,0.45588235294117646,1.0
75,110,110,110,105,80,590,0.656934306569343,65,60,110,130,95,65,525,0.47761194029850745,1.0
58,50,145,95,105,30,483,0.2459016393442623,79,85,60,55,60,71,410,0.60431654676259,0.0
85,100,122,58,75,54,494,0.3939393939393939,65,136,94,54,96,135,580,0.9612403100775194,0.0
62,50,58,73,54,72,369,0.4435483870967742,70,70,40,60,40,60,340,0.4247787610619469,2.0
45,35,50,70,50,30,280,0.15753424657534246,40,40,50,30,30,30,220,0.0873015873015873,0.5
170,90,45,90,45,60,500,0.427536231884058,40,30,35,45,40,55,245,0.31496062992125984,0.5
45,50,35,55,75,40,300,0.21367521367521367,90,60,70,75,70,45,410,0.23880597014925373,1.0
100,100,100,100,100,100,600,0.8345864661654135,50,50,40,30,30,50,250,0.2781954887218045,4.0
70,65,60,90,75,90,450,0.6571428571428571,60,65,80,170,95,130,600,0.8625954198473282,0.0625
90,75,85,115,90,55,510,0.3445378151260504,50,53,48,53,48,64,316,0.358974358974359,2.0
44,48,65,50,64,43,314,0.1623931623931624,92,105,90,125,90,98,600,0.8217054263565892,0.5
73,115,60,60,60,90,458,0.6694915254237288,45,30,50,65,50,45,285,0.13821138211382114,1.0
35,85,45,35,35,75,310,0.6492537313432836,65,150,60,115,60,115,565,0.935251798561151,1.0
60,95,80,60,80,30,405,0.19480519480519481,60,69,95,69,95,36,424,0.2608695652173913,0.125
45,35,45,62,53,35,275,0.11851851851851852,70,80,50,35,35,35,305,0.14,1.0
65,65,60,110,95,130,525,0.9253731343283582,65,60,70,85,75,40,395,0.1796875,1.0
60,65,80,170,95,130,600,0.8625954198473282,50,53,62,58,63,44,330,0.13709677419354838,1.0
80,80,50,40,50,25,325,0.176056338028169,85,135,130,60,80,25,515,0.40540540540540543,0.5
105,30,105,140,105,55,540,0.3524590163934426,55,95,55,35,75,115,430,0.9380530973451328,0.0
50,65,107,105,107,86,520,0.7272727272727273,59,45,40,35,40,31,250,0.14285714285714285,1.0
100,50,80,60,80,50,420,0.34375,55,45,45,25,25,15,210,0.048,1.0
90,65,65,40,40,15,315,0.19672131147540983,65,95,75,55,55,85,430,0.6933333333333334,1.0
55,55,55,85,55,30,335,0.1320754716981132,65,65,60,130,95,110,525,0.823943661971831,0.5
85,76,64,45,55,90,415,0.6739130434782609,75,100,95,40,70,110,490,0.8717948717948718,1.0
90,60,60,40,40,40,330,0.29545454545454547,70,80,70,80,70,110,480,0.6594202898550725,1.0
65,65,60,110,95,130,525,0.9253731343283582,50,50,62,40,62,65,329,0.4188034188034188,1.0
54,78,103,53,45,22,355,0.23255813953488372,40,45,40,62,60,60,307,0.33884297520661155,4.0
95,95,85,125,65,55,520,0.3894736842105263,50,75,45,40,45,60,315,0.4380165289256198,0.5
80,100,200,50,100,50,580,0.3472222222222222,77,59,50,67,63,46,362,0.23140495867768596,2.0
91,90,106,130,106,77,600,0.648854961832061,70,120,65,45,85,125,510,0.9747899159663865,4.0
70,45,48,60,65,35,323,0.15748031496062992,80,120,130,55,65,45,495,0.37037037037037035,1.0
60,40,60,95,60,55,370,0.4222222222222222,45,90,20,65,20,65,305,0.5116279069767442,0.25
40,35,30,120,70,105,400,0.6692307692307692,130,70,35,70,35,60,400,0.4017857142857143,1.0
50,65,45,85,65,95,405,0.7238095238095238,45,95,50,40,50,75,355,0.54,1.0
50,20,55,25,25,30,205,0.09774436090225563,125,130,90,130,90,95,660,0.7734375,1.0
74,48,76,83,81,104,466,0.7322834645669292,55,75,50,40,40,80,340,0.6302521008403361,1.0
70,55,55,80,60,45,365,0.2222222222222222,50,20,55,25,25,30,205,0.09774436090225563,1.0
60,85,69,65,79,80,438,0.576,58,89,77,45,45,48,362,0.3177570093457944,0.5
45,49,65,49,65,45,318,0.275,40,35,30,120,70,105,400,0.6692307692307692,1.0
76,147,90,60,70,97,540,0.8267716535433071,50,95,95,35,110,70,455,0.5179856115107914,1.0
79,105,70,145,80,101,580,0.8608695652173913,55,40,85,80,105,40,405,0.23622047244094488,2.0
90,85,75,115,100,115,580,0.9381443298969072,39,52,43,60,50,65,309,0.49107142857142855,1.0
100,134,110,95,100,61,600,0.4057971014492754,108,112,118,68,72,47,525,0.2916666666666667,0.5
75,80,55,25,35,35,305,0.18666666666666668,80,92,65,65,80,68,450,0.4824561403508772,1.0
150,120,100,120,100,90,680,0.664179104477612,70,80,70,80,70,110,480,0.6594202898550725,2.0
60,82,45,45,45,74,351,0.5752212389380531,60,85,60,50,50,125,430,0.9090909090909091,0.0
68,85,65,165,135,100,618,0.8083333333333333,43,30,55,40,65,97,330,0.6030534351145038,1.0
130,65,60,110,95,65,525,0.5227272727272727,82,80,86,85,75,72,480,0.6183206106870229,1.0
60,62,80,63,80,60,405,0.4336283185840708,55,84,105,114,75,52,485,0.2890625,2.0
70,105,105,50,40,20,390,0.33587786259541985,54,45,47,75,98,52,371,0.39669421487603307,1.0
95,75,80,100,110,30,490,0.24242424242424243,110,135,60,50,65,88,508,0.7744360902255639,2.0
85,115,80,105,80,50,515,0.3063063063063063,50,55,50,36,30,43,264,0.2922077922077922,2.0
60,55,90,145,90,80,520,0.6071428571428571,70,130,100,55,80,65,500,0.608,4.0
55,45,50,45,65,80,340,0.5546218487394958,60,60,75,60,75,80,410,0.7321428571428571,2.0
70,62,67,55,55,56,365,0.38513513513513514,50,105,79,35,110,76,455,0.6214285714285714,1.0
66,41,77,61,87,23,355,0.12096774193548387,30,80,90,55,45,55,355,0.4295774647887324,4.0
65,85,70,75,70,40,405,0.203125,10,55,25,35,45,95,265,0.5396825396825397,0.0
80,120,70,110,70,80,530,0.6422764227642277,45,90,20,65,20,65,305,0.5116279069767442,1.0
125,170,100,120,90,95,700,0.77,85,56,77,50,77,78,423,0.53125,2.0
80,120,79,95,79,70,523,0.5833333333333334,75,69,72,114,100,104,534,0.8253968253968254,1.0
70,140,230,60,80,50,630,0.32432432432432434,30,40,55,40,55,60,280,0.3237410071942446,1.0
60,90,140,50,50,40,430,0.2535211267605634,70,95,85,55,65,70,440,0.5,2.0
40,50,45,70,45,70,320,0.5517241379310345,60,60,60,35,35,30,280,0.11194029850746269,1.0
75,89,85,55,65,36,405,0.29545454545454547,55,112,45,74,45,70,401,0.559322033898305,1.0
35,64,85,74,55,32,345,0.19827586206896552,116,55,85,107,95,29,487,0.06818181818181818,1.0
100,150,140,100,90,90,670,0.7969924812030075,74,94,131,54,116,20,489,0.4485294117647059,1.0
106,190,100,154,100,130,780,0.9259259259259259,60,50,150,50,150,60,520,0.5206611570247934,0.0
50,85,40,85,40,35,335,0.1746031746031746,60,80,50,40,40,30,300,0.15328467153284672,1.0
43,80,65,50,35,35,308,0.14193548387096774,60,55,145,75,150,40,525,0.2,2.0
70,40,50,55,50,25,290,0.061068702290076333,30,30,42,30,42,70,244,0.4230769230769231,2.0
70,92,65,80,55,98,460,0.8090909090909091,45,35,50,70,50,30,280,0.15753424657534246,0.5
60,60,60,60,60,60,360,0.38095238095238093,55,68,64,45,55,31,318,0.11666666666666667,1.0
75,69,72,114,100,104,534,0.8253968253968254,55,130,115,50,50,75,475,0.5982142857142857,0.5
40,30,35,50,70,55,280,0.28205128205128205,91,72,90,129,90,108,580,0.8620689655172413,2.0
69,55,45,55,55,15,294,0.11666666666666667,30,30,30,30,30,30,180,0.12612612612612611,1.0
60,65,60,130,75,110,500,0.7719298245614035,50,95,95,35,110,70,455,0.5179856115107914,1.0
65,60,70,85,75,40,395,0.1796875,55,55,45,63,45,45,308,0.25,1.0
59,59,58,90,70,73,409,0.5826086956521739,50,120,53,35,110,87,455,0.640625,1.0
40,80,100,30,30,20,300,0.11851851851851852,65,55,115,100,40,60,435,0.3798449612403101,0.5
50,75,45,40,45,60,315,0.4380165289256198,75,98,63,98,63,101,498,0.849624060150376,1.0
91,134,95,100,100,80,600,0.6304347826086957,95,70,73,95,90,60,483,0.3983739837398374,0.0
103,93,67,71,61,84,479,0.7142857142857143,85,105,85,40,50,40,405,0.211864406779661,0.5
110,123,65,100,65,65,528,0.5217391304347826,35,55,35,30,30,35,220,0.23684210526315788,2.0
65,90,120,85,70,60,490,0.43410852713178294,75,90,140,60,60,40,465,0.3008130081300813,0.0
30,65,100,45,25,40,305,0.1891891891891892,50,20,40,20,40,20,190,0.0962962962962963,1.0
58,64,58,80,65,80,405,0.5423728813559322,91,90,106,130,106,77,600,0.648854961832061,1.0
45,50,45,115,55,95,405,0.6936936936936937,48,72,48,72,48,48,336,0.25984251968503935,2.0
50,65,85,35,35,55,325,0.32575757575757575,55,112,45,74,45,70,401,0.559322033898305,1.0
70,55,75,45,65,60,370,0.45901639344262296,50,48,43,46,41,60,288,0.47297297297297297,1.0
60,82,45,45,45,74,351,0.5752212389380531,65,130,60,75,60,75,465,0.689922480620155,0.5
71,120,95,120,95,99,600,0.8203125,62,50,58,73,54,72,369,0.4435483870967742,0.25
60,85,49,60,49,60,363,0.4444444444444444,77,59,50,67,63,46,362,0.23140495867768596,1.0
78,104,78,159,115,100,634,0.8444444444444444,90,120,120,60,60,50,500,0.35294117647058826,1.0
103,60,86,60,86,50,445,0.3458646616541353,55,104,105,94,75,52,485,0.36363636363636365,1.0
65,50,70,95,80,65,425,0.4262295081967213,60,65,70,85,75,40,395,0.21705426356589147,2.0
70,145,88,140,70,112,625,0.8888888888888888,45,85,50,55,50,65,350,0.5076923076923077,1.0
70,60,125,115,70,55,495,0.35507246376811596,110,65,75,125,85,30,490,0.15,1.0
60,75,100,55,80,50,420,0.3088235294117647,45,30,35,20,20,45,195,0.14782608695652175,1.0
114,85,70,85,80,30,464,0.2066115702479339,40,45,40,62,60,60,307,0.33884297520661155,0.5
100,100,100,100,100,100,600,0.8758169934640523,70,145,88,140,70,112,625,0.8888888888888888,0.25
75,98,63,98,63,101,498,0.849624060150376,45,100,135,65,135,45,525,0.29411764705882354,1.0
75,100,110,45,55,65,450,0.5333333333333333,80,160,60,170,130,80,680,0.6180555555555556,1.0
75,75,60,83,60,60,413,0.39344262295081966,105,140,55,30,55,95,480,0.8195488721804511,2.0
70,110,75,145,85,145,630,0.9444444444444444,60,70,105,70,120,75,500,0.5983606557377049,2.0
60,80,110,50,80,45,425,0.2833333333333333,55,68,64,45,55,31,318,0.11666666666666667,0.5
55,55,45,63,45,45,308,0.25,78,84,78,109,85,100,534,0.8620689655172413,2.0
70,95,85,55,65,70,440,0.5,38,30,41,30,41,60,240,0.2897196261682243,1.0
50,50,40,30,30,50,250,0.2781954887218045,43,80,65,50,35,35,308,0.14193548387096774,0.5
90,100,70,110,150,80,600,0.6037735849056604,72,58,80,103,80,97,490,0.7171052631578947,1.0
45,95,50,40,50,75,355,0.54,70,40,50,55,50,25,290,0.061068702290076333,2.0
44,48,65,50,64,43,314,0.1623931623931624,60,75,85,100,85,115,520,0.8992248062015504,0.5
80,110,60,150,130,70,600,0.5042016806722689,68,65,65,125,115,80,518,0.6461538461538462,1.0
35,46,34,35,45,20,215,0.072,100,100,100,100,100,100,600,0.8778625954198473,1.0
65,75,90,97,123,44,494,0.1987179487179487,45,49,49,65,65,45,318,0.2781954887218045,1.0
75,98,63,98,63,101,498,0.8091603053435115,28,25,25,45,35,40,198,0.16083916083916083,1.0
95,80,105,40,70,100,490,0.8046875,65,65,45,75,45,95,390,0.72,1.0
60,25,35,70,80,60,330,0.3076923076923077,125,120,90,170,100,95,700,0.78125,1.0
60,25,35,70,80,60,330,0.3076923076923077,80,70,40,100,60,145,495,0.921875,1.0
60,60,40,65,45,35,305,0.15833333333333333,65,90,120,85,70,60,490,0.43410852713178294,2.0
65,45,55,45,70,45,325,0.24369747899159663,116,55,85,107,95,29,487,0.06818181818181818,1.0
45,63,37,65,55,95,360,0.8055555555555556,45,60,40,70,50,45,310,0.2846715328467153,1.0
150,120,100,120,100,90,680,0.664179104477612,108,100,121,81,95,95,600,0.7476635514018691,2.0
44,38,33,61,43,70,289,0.5267857142857143,44,75,35,63,33,45,295,0.2647058823529412,0.0
40,30,30,55,30,85,270,0.4666666666666667,100,150,90,180,160,90,770,0.7348484848484849,0.5
50,80,95,10,45,10,290,0.232,100,150,120,120,100,90,680,0.6493506493506493,1.0
75,85,200,55,65,30,510,0.16778523489932887,60,45,70,45,90,95,405,0.7304964539007093,1.0
55,45,45,25,25,15,210,0.048,100,77,77,128,128,90,600,0.6901408450704225,1.0
50,53,48,53,48,64,316,0.46153846153846156,50,95,180,85,45,70,525,0.5298507462686567,1.0
70,95,125,65,75,45,475,0.33613445378151263,45,50,55,75,65,30,320,0.06293706293706294,1.0
95,110,80,70,80,50,485,0.37209302325581395,95,117,80,65,70,92,519,0.8409090909090909,2.0
55,45,45,25,25,15,210,0.048,100,5,5,15,65,30,220,0.07692307692307693,1.0
50,70,50,50,50,40,310,0.16296296296296298,70,70,70,70,70,70,420,0.5289256198347108,1.0
78,92,75,74,63,118,500,0.8842975206611571,50,65,107,105,107,86,520,0.703125,1.0
65,40,70,80,140,70,465,0.5954198473282443,75,65,55,65,55,69,384,0.43548387096774194,1.0
68,125,65,65,115,80,518,0.6277372262773723,65,136,94,54,96,135,580,0.9612403100775194,2.0
35,64,85,74,55,32,345,0.19827586206896552,106,150,70,194,120,140,780,0.952,1.0
160,110,65,65,110,30,540,0.35714285714285715,75,38,38,56,56,67,330,0.5263157894736842,1.0
90,100,60,90,60,80,480,0.6422764227642277,50,75,35,70,30,40,300,0.21296296296296297,0.25
78,52,60,63,65,23,341,0.06015037593984962,56,61,65,48,45,38,313,0.17567567567567569,1.0
85,115,80,105,80,50,515,0.3063063063063063,70,150,140,65,100,75,600,0.55,1.0
45,22,60,27,30,29,213,0.07518796992481203,80,100,200,50,100,50,580,0.3472222222222222,1.0
50,53,62,58,63,44,330,0.13709677419354838,83,80,80,135,80,121,579,0.9444444444444444,1.0
71,120,95,120,95,99,600,0.8203125,70,110,75,145,85,145,630,0.9444444444444444,2.0
50,50,77,95,77,91,440,0.5916666666666667,50,75,35,70,30,40,300,0.21296296296296297,0.5
170,90,45,90,45,60,500,0.427536231884058,60,69,95,69,95,36,424,0.2608695652173913,1.0
85,105,100,79,83,78,530,0.5869565217391305,65,110,130,60,65,95,525,0.8278145695364238,0.5
100,100,100,100,100,100,600,0.8758169934640523,110,65,105,55,95,80,510,0.6258503401360545,0.0
38,30,41,30,41,60,240,0.2897196261682243,65,95,57,100,85,93,495,0.7441860465116279,1.0
95,60,79,100,125,81,540,0.6201550387596899,95,145,130,120,90,120,700,0.9398496240601504,0.5
100,77,77,128,128,90,600,0.6901408450704225,80,120,130,55,65,45,495,0.37037037037037035,1.0
70,120,65,45,85,125,510,0.9747899159663865,64,66,68,81,76,50,405,0.25190839694656486,0.5
49,49,56,49,61,66,330,0.5190839694656488,59,45,40,35,40,31,250,0.14285714285714285,1.0
65,90,122,58,75,84,494,0.71875,50,65,107,105,107,86,520,0.7758620689655172,2.0
63,63,47,41,41,74,329,0.56,76,48,48,57,62,34,325,0.11688311688311688,1.0
50,80,95,10,45,10,290,0.232,58,50,145,95,105,30,483,0.2459016393442623,1.0
75,103,80,70,80,92,500,0.7933884297520661,60,65,70,85,75,40,395,0.21705426356589147,0.25
45,63,37,65,55,95,360,0.8055555555555556,85,97,66,105,66,65,484,0.47107438016528924,1.0
65,95,57,100,85,93,495,0.7441860465116279,64,51,23,51,23,28,240,0.11363636363636363,1.0
85,73,70,73,115,67,483,0.5126050420168067,60,50,70,80,80,140,480,0.8449612403100775,1.0
62,73,55,56,52,84,382,0.7244094488188977,64,66,68,81,76,50,405,0.25190839694656486,0.5
108,130,95,80,85,102,600,0.7637795275590551,40,50,45,70,45,70,320,0.5517241379310345,0.0
85,97,66,105,66,65,484,0.47107438016528924,105,95,80,40,80,90,490,0.753968253968254,1.0
91,90,106,130,106,77,600,0.648854961832061,110,130,80,70,60,80,530,0.5862068965517241,4.0
70,84,70,65,70,51,410,0.2949640287769784,50,95,95,35,110,70,455,0.5179856115107914,0.5
60,130,80,60,60,70,460,0.5153846153846153,75,95,122,58,75,69,494,0.5725806451612904,0.0
40,60,40,40,40,30,250,0.0948905109489051,43,80,65,50,35,35,308,0.14193548387096774,1.0
45,90,20,65,20,65,305,0.5116279069767442,80,110,120,130,90,70,600,0.6198347107438017,1.0
130,70,35,70,35,60,400,0.4017857142857143,65,95,57,100,85,93,495,0.7441860465116279,2.0
105,180,100,180,100,115,780,0.9477611940298507,40,45,65,100,120,90,460,0.5588235294117647,0.0
72,105,115,54,86,68,500,0.5149253731343284,126,131,95,131,98,99,680,0.8294573643410853,1.0
70,105,105,50,40,20,390,0.33587786259541985,53,51,53,61,56,40,314,0.14285714285714285,1.0
100,75,115,90,115,85,580,0.6446280991735537,105,140,55,30,55,95,480,0.8195488721804511,2.0
75,105,75,105,75,45,480,0.3274336283185841,41,56,40,62,44,71,314,0.568,0.5
95,60,79,100,125,81,540,0.6201550387596899,70,70,40,60,40,60,340,0.4247787610619469,0.5
91,129,90,72,90,108,580,0.8536585365853658,48,61,40,61,40,50,300,0.2543859649122807,0.25
60,50,50,60,70,50,340,0.28346456692913385,70,85,70,60,70,50,405,0.28378378378378377,4.0
60,130,80,60,60,70,460,0.5153846153846153,60,60,60,60,60,60,360,0.38095238095238093,2.0
50,50,150,50,150,50,500,0.2571428571428571,55,55,55,85,55,30,335,0.1320754716981132,1.0
91,72,90,129,90,108,580,0.8620689655172413,41,56,40,62,44,71,314,0.568,0.5
50,85,85,55,55,50,380,0.3902439024390244,90,110,80,100,80,95,555,0.7982456140350878,0.25
75,75,75,125,95,40,485,0.15671641791044777,255,10,10,75,135,55,540,0.3125,1.0
40,30,35,45,40,55,245,0.31496062992125984,35,60,44,40,54,55,288,0.366412213740458,1.0
80,70,65,80,120,100,515,0.8034188034188035,110,78,73,76,71,60,468,0.3333333333333333,0.5
70,110,80,55,80,105,500,0.8794326241134752,65,80,65,35,65,60,370,0.38405797101449274,1.0
56,61,65,48,45,38,313,0.17567567567567569,76,104,71,104,71,108,534,0.912751677852349,0.5
50,50,40,50,40,64,294,0.45588235294117646,65,83,57,95,85,105,490,0.8914728682170543,1.0
90,92,87,75,85,76,505,0.5409836065573771,50,60,45,100,80,65,400,0.45689655172413796,1.0
60,60,60,35,35,30,280,0.11194029850746269,60,50,150,50,150,60,520,0.5206611570247934,0.0
63,120,85,90,55,55,468,0.2809917355371901,50,180,20,180,20,150,600,0.9029850746268657,2.0
95,100,85,108,70,70,528,0.5652173913043478,90,75,75,90,100,70,500,0.5462184873949579,0.5
58,64,58,80,65,80,405,0.609271523178808,90,93,55,70,55,55,418,0.3819444444444444,0.5
70,90,90,135,90,125,600,0.9401709401709402,100,77,77,128,128,90,600,0.6901408450704225,2.0
100,150,110,95,110,70,635,0.5923076923076923,100,75,115,90,115,85,580,0.6446280991735537,0.5
80,100,80,80,80,100,520,0.9051724137931034,79,103,120,135,115,78,630,0.5763888888888888,1.0
45,53,70,40,60,42,310,0.25735294117647056,58,64,58,80,65,80,405,0.609271523178808,0.25
60,65,60,130,75,110,500,0.7719298245614035,60,40,60,40,60,35,295,0.18055555555555555,2.0
65,85,70,75,70,40,405,0.203125,55,20,35,20,45,75,250,0.37681159420289856,1.0
60,65,70,85,75,40,395,0.21705426356589147,70,60,62,80,82,60,414,0.4375,0.25
65,136,94,54,96,135,580,0.9612403100775194,123,100,62,97,81,68,531,0.4806201550387597,1.0
60,85,60,85,60,55,405,0.3673469387755102,65,45,55,45,70,45,325,0.24369747899159663,0.5
70,70,40,60,40,60,340,0.4247787610619469,79,115,70,125,80,111,580,0.8468468468468469,0.5
75,125,70,125,70,115,580,0.9037037037037037,50,52,48,65,50,55,320,0.33098591549295775,1.0
111,83,68,92,82,39,475,0.1774193548387097,100,164,150,95,120,71,700,0.5645161290322581,4.0
100,100,100,100,100,100,600,0.8758169934640523,190,33,58,33,58,33,405,0.13432835820895522,0.5
45,60,40,70,50,45,310,0.2846715328467153,35,70,55,45,55,25,285,0.09420289855072464,4.0
53,54,53,37,46,45,288,0.3090909090909091,51,65,65,80,75,59,395,0.4365079365079365,1.0
70,45,48,60,65,35,323,0.15748031496062992,40,40,55,40,70,55,300,0.40939597315436244,1.0
43,70,48,50,60,38,309,0.2391304347826087,40,50,90,30,55,65,330,0.44680851063829785,0.25
65,125,100,60,70,70,490,0.6099290780141844,43,30,55,40,65,97,330,0.6030534351145038,0.5
100,100,125,110,50,50,535,0.384,65,40,70,80,140,70,465,0.5954198473282443,1.0
70,120,100,145,105,20,560,0.2824427480916031,88,107,122,74,75,64,530,0.4596774193548387,1.0
53,51,53,61,56,40,314,0.14285714285714285,78,84,78,109,85,100,534,0.8646616541353384,2.0
60,100,85,80,85,100,510,0.7007874015748031,40,30,32,50,52,65,269,0.3671875,0.5
80,100,70,60,70,95,475,0.7416666666666667,40,55,30,30,30,60,245,0.43548387096774194,0.5
50,35,55,25,25,15,205,0.021739130434782608,50,75,75,65,65,50,380,0.4049586776859504,1.0
255,10,10,75,135,55,540,0.3125,80,70,65,80,120,100,515,0.8034188034188035,1.0
55,35,50,55,110,85,390,0.6277372262773723,105,180,100,180,100,115,780,0.9477611940298507,0.5
50,60,45,100,80,65,400,0.45689655172413796,50,65,107,105,107,86,520,0.6991150442477876,0.5
70,85,140,85,70,20,470,0.272,80,45,65,90,110,80,470,0.5462962962962963,1.0
50,70,50,50,50,40,310,0.16296296296296298,40,45,40,35,35,56,251,0.373015873015873,1.0
82,80,86,85,75,72,480,0.6183206106870229,45,30,40,105,50,20,290,0.031007751937984496,1.0
100,100,100,100,100,100,600,0.831858407079646,40,45,40,62,60,60,307,0.33884297520661155,1.0
80,110,120,130,90,70,600,0.6198347107438017,30,105,90,25,25,50,325,0.2773722627737226,0.25
65,95,57,100,85,93,495,0.7441860465116279,101,72,72,99,89,29,462,0.1937984496124031,1.0
100,70,70,65,65,45,415,0.1897810218978102,86,92,88,68,75,73,482,0.6835443037974683,1.0
70,110,75,145,85,145,630,0.9444444444444444,40,40,35,50,100,70,335,0.5031847133757962,1.0
100,100,100,100,100,100,600,0.8345864661654135,50,50,150,50,150,50,500,0.2571428571428571,2.0
50,65,90,35,35,15,290,0.14678899082568808,45,25,50,25,25,35,205,0.13076923076923078,0.5
62,77,62,50,42,65,358,0.4838709677419355,90,85,100,95,125,85,580,0.6834532374100719,1.0
90,132,105,132,105,30,594,0.4246575342465753,72,95,67,103,71,122,530,0.9606299212598425,1.0
60,80,95,70,85,50,440,0.2231404958677686,80,100,70,60,70,95,475,0.7416666666666667,1.0
70,80,50,35,35,35,305,0.14,50,50,95,40,50,35,320,0.20279720279720279,1.0
95,80,105,40,70,100,490,0.8046875,80,90,80,130,110,110,600,0.856,1.0
65,80,80,59,63,58,405,0.4411764705882353,80,130,100,160,120,110,700,0.8981481481481481,0.5
60,90,70,60,120,40,440,0.27419354838709675,70,55,75,45,65,60,370,0.45901639344262296,1.0
55,45,43,55,43,72,313,0.5853658536585366,66,41,77,61,87,23,355,0.12096774193548387,1.0
50,65,45,85,65,95,405,0.7238095238095238,57,80,91,80,87,75,470,0.5737704918032787,0.5
50,40,85,40,65,25,305,0.08870967741935484,70,110,80,55,80,105,500,0.8794326241134752,0.5
60,62,80,63,80,60,405,0.4336283185840708,50,48,43,46,41,60,288,0.47297297297297297,4.0
50,80,95,10,45,10,290,0.232,80,80,50,40,50,25,325,0.176056338028169,1.0
55,75,60,75,60,103,428,0.7982456140350878,45,60,32,50,32,76,295,0.5925925925925926,0.25
65,85,70,75,70,40,405,0.203125,60,115,105,65,70,80,495,0.7181818181818181,2.0
110,80,90,95,90,65,530,0.5033557046979866,80,110,120,130,90,70,600,0.6198347107438017,0.25
90,120,75,60,60,45,450,0.29411764705882354,165,75,80,40,45,65,470,0.5151515151515151,1.0
40,65,40,80,40,65,330,0.5038167938931297,45,30,35,20,20,45,195,0.14782608695652175,1.0
105,140,95,55,65,45,505,0.3,123,100,62,97,81,68,531,0.4806201550387597,1.0
85,105,85,40,50,40,405,0.211864406779661,71,73,88,120,89,59,500,0.43537414965986393,1.0
73,115,60,60,60,90,458,0.6694915254237288,30,56,35,25,35,72,253,0.48148148148148145,1.0
75,80,55,25,35,35,305,0.18666666666666668,65,125,60,95,60,105,510,0.9236641221374046,1.0
50,85,40,85,40,35,335,0.1746031746031746,65,155,120,65,90,105,600,0.8677685950413223,0.25
90,85,75,115,100,115,580,0.9381443298969072,75,80,55,25,35,35,305,0.18666666666666668,1.0
58,109,112,48,48,109,484,0.8805970149253731,95,117,184,44,46,28,514,0.2975206611570248,2.0
60,85,42,85,42,91,405,0.8227848101265823,45,95,50,40,50,75,355,0.54,1.0
70,120,40,95,40,95,460,0.8106060606060606,95,117,184,44,46,28,514,0.2975206611570248,1.0
45,50,43,40,38,62,278,0.40441176470588236,40,45,35,30,40,55,245,0.3793103448275862,1.0
75,75,95,75,95,113,528,0.9015151515151515,75,90,50,110,80,95,500,0.7985611510791367,0.5
105,180,100,180,100,115,780,0.9477611940298507,55,65,95,95,45,85,440,0.6610169491525424,1.0
100,50,80,60,80,50,420,0.34375,64,66,68,81,76,50,405,0.25190839694656486,0.5
82,80,86,85,75,72,480,0.6183206106870229,75,75,60,83,60,60,413,0.39344262295081966,1.0
90,93,55,70,55,55,418,0.3819444444444444,75,125,70,125,70,115,580,0.9037037037037037,0.5
56,61,65,48,45,38,313,0.17567567567567569,52,65,50,45,50,38,300,0.27419354838709675,0.5
20,15,20,10,55,80,200,0.2682926829268293,100,100,80,60,60,50,450,0.3050847457627119,2.0
50,60,60,60,60,30,320,0.11290322580645161,83,80,80,135,80,121,579,0.9444444444444444,1.0
85,105,100,79,83,78,530,0.5869565217391305,90,60,60,40,40,40,330,0.29545454545454547,2.0
55,45,45,25,25,15,210,0.048,60,45,50,90,80,70,395,0.625,0.0
75,98,63,98,63,101,498,0.889763779527559,35,60,44,40,54,55,288,0.366412213740458,1.0
71,82,64,64,59,112,452,0.9327731092436975,75,95,67,125,95,83,540,0.7117117117117117,1.0
80,100,80,80,80,100,520,0.9051724137931034,50,53,48,53,48,64,316,0.4076923076923077,0.5
55,130,115,50,50,75,475,0.5982142857142857,60,60,75,60,75,80,410,0.7321428571428571,1.0
74,48,76,83,81,104,466,0.7322834645669292,125,170,100,120,90,95,700,0.77,1.0
101,72,72,99,89,29,462,0.1937984496124031,35,70,55,45,55,25,285,0.09420289855072464,1.0
50,65,64,44,48,43,314,0.2196969696969697,89,125,90,115,80,101,600,0.8725490196078431,2.0
86,81,97,81,107,43,495,0.203125,89,124,80,55,80,55,483,0.5714285714285714,1.0
50,70,160,70,160,90,600,0.7417218543046358,85,100,122,58,75,54,494,0.3939393939393939,1.0
70,70,115,130,90,60,535,0.5338983050847458,35,35,35,35,35,35,210,0.13385826771653545,1.0
70,95,125,65,75,45,475,0.33613445378151263,60,60,50,40,50,75,335,0.5882352941176471,2.0
50,53,48,53,48,64,316,0.4076923076923077,70,80,50,35,35,35,305,0.14,1.0
75,110,110,110,105,80,590,0.656934306569343,250,5,5,35,105,50,450,0.15306122448979592,1.0
91,90,129,90,72,108,580,0.9140625,90,85,100,95,125,85,580,0.6834532374100719,2.0
255,10,10,75,135,55,540,0.3125,76,104,71,104,71,108,534,0.912751677852349,1.0
48,72,48,72,48,48,336,0.25984251968503935,70,50,30,95,135,105,485,0.8040540540540541,1.0
70,92,65,80,55,98,460,0.8090909090909091,130,85,80,85,95,60,535,0.43884892086330934,0.5
125,120,90,170,100,95,700,0.78125,88,107,122,74,75,64,530,0.4596774193548387,2.0
56,61,65,48,45,38,313,0.17567567567567569,70,80,50,35,35,35,305,0.14,1.0
90,75,85,115,90,55,510,0.3445378151260504,120,120,120,120,120,120,720,0.9344262295081968,1.0
90,100,60,90,60,80,480,0.6422764227642277,75,103,80,70,80,92,500,0.7933884297520661,0.25
65,50,70,95,80,65,425,0.4262295081967213,95,80,105,40,70,100,490,0.8046875,1.0
60,90,140,50,50,40,430,0.2535211267605634,95,75,180,130,80,30,590,0.13793103448275862,0.5
90,120,100,150,120,100,680,0.7718120805369127,72,95,67,103,71,122,530,0.9606299212598425,0.5
75,90,90,140,90,115,600,0.9481481481481482,160,110,65,65,110,30,540,0.35714285714285715,1.0
65,50,70,95,80,65,425,0.4262295081967213,55,75,50,40,40,80,340,0.6302521008403361,1.0
95,70,73,95,90,60,483,0.3983739837398374,100,120,120,150,100,90,680,0.7880794701986755,1.0
80,120,79,95,79,70,523,0.5833333333333334,65,65,60,130,95,110,525,0.823943661971831,1.0
65,125,100,60,70,70,490,0.6099290780141844,90,60,60,40,40,40,330,0.29545454545454547,1.0
100,128,90,77,77,128,600,0.959349593495935,40,20,30,40,80,55,265,0.22764227642276422,0.25
70,150,140,65,100,75,600,0.55,105,95,75,85,75,74,509,0.5714285714285714,0.5
50,150,50,150,50,150,600,0.9339622641509434,50,60,45,100,80,65,400,0.45689655172413796,2.0
55,55,85,65,85,35,380,0.2014388489208633,30,30,42,30,42,70,244,0.4230769230769231,4.0
106,90,130,90,154,110,680,0.8699186991869918,38,35,35,65,55,50,278,0.2647058823529412,0.5
71,95,85,110,95,79,535,0.664,90,100,60,90,60,80,480,0.6422764227642277,2.0
50,72,35,35,35,65,292,0.5373134328358209,70,120,100,145,105,20,560,0.2824427480916031,2.0
70,120,40,95,40,95,460,0.8106060606060606,70,62,67,55,55,56,365,0.38513513513513514,1.0
60,100,89,55,69,112,485,0.9298245614035088,90,130,80,65,85,55,505,0.4396551724137931,0.5
40,30,35,50,70,55,280,0.28205128205128205,43,80,65,50,35,35,308,0.14193548387096774,2.0
60,65,80,170,95,130,600,0.8625954198473282,65,47,55,73,75,85,400,0.65,1.0
78,84,78,109,85,100,534,0.8620689655172413,55,45,50,45,65,80,340,0.5546218487394958,2.0
75,125,230,55,95,30,610,0.3448275862068966,108,130,95,80,85,102,600,0.7637795275590551,1.0
80,100,123,122,120,80,625,0.56,70,90,90,135,90,125,600,0.9401709401709402,1.0
100,100,100,100,100,100,600,0.8602941176470589,45,53,70,40,60,42,310,0.25735294117647056,0.25
45,85,50,55,50,65,350,0.5076923076923077,80,80,80,80,80,80,480,0.6015037593984962,2.0
106,190,100,154,100,130,780,0.9259259259259259,49,49,56,49,61,66,330,0.5190839694656488,1.0
65,90,65,61,61,100,442,0.8373983739837398,90,92,87,75,85,76,505,0.5409836065573771,1.0
91,90,129,90,72,108,580,0.9140625,41,64,45,50,50,50,300,0.36752136752136755,1.0
110,78,73,76,71,60,468,0.3333333333333333,58,109,112,48,48,109,484,0.8805970149253731,1.0
91,134,95,100,100,80,600,0.6304347826086957,70,84,70,65,70,51,410,0.2949640287769784,0.5
75,75,95,75,95,113,528,0.9015151515151515,45,90,20,65,20,65,305,0.5116279069767442,2.0
95,110,80,70,80,50,485,0.37209302325581395,78,81,71,74,69,126,499,0.9090909090909091,1.0
53,51,53,61,56,40,314,0.14285714285714285,76,65,45,92,42,91,411,0.7449664429530202,1.0
90,93,55,70,55,55,418,0.3819444444444444,100,50,50,76,96,70,442,0.5,1.0
70,80,70,80,70,110,480,0.6594202898550725,60,95,80,60,80,30,405,0.19480519480519481,2.0
84,86,88,111,101,60,530,0.4634146341463415,60,100,85,80,85,100,510,0.7007874015748031,1.0
35,55,40,50,50,90,320,0.6838235294117647,45,25,50,25,25,35,205,0.13076923076923078,1.0
60,60,60,35,35,30,280,0.11194029850746269,95,70,73,95,90,60,483,0.3983739837398374,1.0
55,68,64,45,55,31,318,0.11666666666666667,75,80,60,65,90,102,472,0.8625954198473282,1.0
91,90,72,90,129,108,580,0.896,60,45,70,45,90,95,405,0.7304964539007093,1.0
150,100,120,100,120,90,680,0.6666666666666666,64,115,65,83,63,65,455,0.5323741007194245,2.0
50,105,125,55,95,50,480,0.375886524822695,50,75,75,65,65,50,380,0.4049586776859504,2.0
35,55,35,30,30,35,220,0.23684210526315788,110,65,105,55,95,80,510,0.6258503401360545,0.5
65,155,120,65,90,105,600,0.8677685950413223,67,58,57,81,67,101,431,0.8790322580645161,0.25
85,105,85,40,50,40,405,0.211864406779661,60,70,105,70,120,75,500,0.5983606557377049,0.5
46,87,60,30,40,57,320,0.37777777777777777,111,83,68,92,82,39,475,0.1774193548387097,1.0
78,52,60,63,65,23,341,0.06015037593984962,65,50,35,115,95,95,455,0.7333333333333333,1.0
80,80,90,110,130,110,600,0.8721804511278195,40,55,99,40,79,47,360,0.26262626262626265,2.0
75,38,38,56,56,67,330,0.5263157894736842,60,90,140,50,50,40,430,0.2535211267605634,2.0
70,85,70,60,70,50,405,0.28378378378378377,100,100,100,100,100,100,600,0.8778625954198473,4.0
75,110,110,110,105,80,590,0.656934306569343,50,75,45,40,45,60,315,0.4380165289256198,1.0
45,60,40,70,50,45,310,0.2846715328467153,60,105,60,120,60,105,510,0.8849557522123894,1.0
100,120,100,150,120,90,680,0.728,125,170,100,120,90,95,700,0.77,2.0
35,85,45,35,35,75,310,0.6492537313432836,49,49,56,49,61,66,330,0.5190839694656488,1.0
45,35,50,70,50,30,280,0.15753424657534246,60,55,90,145,90,80,520,0.6071428571428571,0.5
110,65,105,55,95,80,510,0.6258503401360545,50,95,95,35,110,70,455,0.5179856115107914,1.0
55,68,64,45,55,31,318,0.11666666666666667,58,70,45,40,45,42,300,0.25925925925925924,1.0
54,66,70,44,55,46,335,0.4214876033057851,60,40,60,40,60,35,295,0.18055555555555555,0.5
75,70,90,70,105,80,490,0.656,55,70,40,60,40,40,305,0.26956521739130435,1.0
55,40,85,80,105,40,405,0.23622047244094488,50,75,45,40,45,60,315,0.4380165289256198,2.0
65,85,70,75,70,40,405,0.203125,55,75,85,25,25,15,280,0.1875,1.0
50,47,50,57,50,65,319,0.463768115942029,75,103,80,70,80,92,500,0.7933884297520661,1.0
55,130,115,50,50,75,475,0.5982142857142857,60,85,49,60,49,60,363,0.4444444444444444,1.0
61,84,65,70,70,70,420,0.5,80,120,80,120,80,100,580,0.8478260869565217,1.0
55,81,60,50,70,97,413,0.7214285714285714,60,45,70,45,90,95,405,0.7304964539007093,1.0
45,95,50,40,50,75,355,0.54,79,105,70,145,80,101,580,0.8608695652173913,1.0
50,53,62,58,63,44,330,0.13709677419354838,65,40,50,125,60,30,370,0.07258064516129033,1.0
75,55,70,55,95,110,460,0.8444444444444444,71,82,64,64,59,112,452,0.9327731092436975,1.0
30,30,30,30,30,30,180,0.12612612612612611,70,75,60,105,60,105,475,0.88,1.0
105,95,75,85,75,74,509,0.5714285714285714,60,70,105,70,120,75,500,0.5983606557377049,2.0
80,70,65,80,120,100,515,0.8034188034188035,45,50,55,75,65,30,320,0.06293706293706294,0.5
55,66,44,44,56,85,350,0.6888888888888889,60,40,50,75,85,95,405,0.6044776119402985,1.0
70,140,70,110,65,105,560,0.95,80,80,80,80,80,80,480,0.6015037593984962,1.0
110,130,80,70,60,80,530,0.5862068965517241,75,95,125,45,75,95,510,0.8257575757575758,0.0
70,110,70,115,70,90,525,0.75,30,65,100,45,25,40,305,0.1891891891891892,0.5
40,50,45,70,45,70,320,0.5517241379310345,103,93,67,71,61,84,479,0.7142857142857143,0.0
50,160,110,160,110,110,700,0.8854961832061069,70,60,75,110,75,90,480,0.7165354330708661,1.0
86,92,88,68,75,73,482,0.6835443037974683,90,75,75,90,100,70,500,0.5462184873949579,1.0
50,50,95,40,50,35,320,0.20279720279720279,60,70,50,100,50,65,395,0.5217391304347826,0.0
76,25,45,67,55,24,292,0.0390625,50,60,45,100,80,65,400,0.45689655172413796,2.0
60,60,60,105,105,105,495,0.848,65,95,75,55,55,85,430,0.6933333333333334,1.0
126,131,95,131,98,99,680,0.8294573643410853,106,190,100,154,100,130,780,0.9259259259259259,2.0
80,80,80,80,80,80,480,0.6015037593984962,108,112,118,68,72,47,525,0.2916666666666667,2.0
61,78,95,56,58,57,405,0.40336134453781514,90,85,75,115,100,115,580,0.9381443298969072,1.0
50,65,107,105,107,86,520,0.6991150442477876,65,80,140,40,70,70,465,0.5223880597014925,4.0
65,65,45,75,45,95,390,0.72,43,70,48,50,60,38,309,0.2391304347826087,2.0
75,80,55,25,35,35,305,0.18666666666666668,60,52,168,47,138,30,495,0.19834710743801653,4.0
100,100,100,100,100,100,600,0.8758169934640523,45,75,37,70,55,83,365,0.6183206106870229,0.5
106,110,90,154,90,130,680,0.926829268292683,60,85,60,50,50,125,430,0.9090909090909091,1.0
66,65,48,62,57,52,350,0.36220472440944884,50,70,100,40,40,30,330,0.2222222222222222,1.0
100,150,120,120,100,90,680,0.6493506493506493,60,67,85,77,75,116,480,0.8888888888888888,0.0
45,45,35,20,30,20,195,0.07246376811594203,105,140,55,30,55,95,480,0.8195488721804511,0.5
65,80,65,35,65,60,370,0.38405797101449274,85,80,70,135,75,90,535,0.7006802721088435,1.0
45,50,55,75,65,30,320,0.06293706293706294,38,35,35,65,55,50,278,0.2647058823529412,2.0
50,30,55,65,55,20,275,0.13675213675213677,60,60,60,60,60,60,360,0.38095238095238093,0.0
49,55,42,42,37,85,310,0.6068376068376068,74,108,133,83,65,32,495,0.32142857142857145,0.5
110,85,95,80,95,50,515,0.2713178294573643,50,53,48,53,48,64,316,0.46153846153846156,1.0
60,60,75,60,75,80,410,0.7321428571428571,60,100,115,70,85,90,520,0.7557251908396947,1.0
100,100,80,60,60,50,450,0.3050847457627119,50,50,77,95,77,91,440,0.5916666666666667,2.0
80,125,75,40,95,85,500,0.6911764705882353,50,50,62,40,62,65,329,0.4188034188034188,0.25
60,62,63,80,80,60,405,0.38016528925619836,45,35,50,70,50,30,280,0.15753424657534246,1.0
89,125,90,115,80,101,600,0.8725490196078431,20,25,45,70,90,60,310,0.30833333333333335,1.0
72,85,70,65,70,58,420,0.41304347826086957,60,60,50,40,50,75,335,0.5882352941176471,1.0
65,55,115,100,40,60,435,0.3798449612403101,60,50,150,50,150,60,520,0.5206611570247934,0.5
120,120,120,120,120,120,720,0.9344262295081968,45,55,45,65,45,75,330,0.5692307692307692,1.0
80,110,120,130,90,70,600,0.6198347107438017,66,117,70,40,50,67,410,0.4573643410852713,0.25
50,120,53,35,110,87,455,0.640625,110,123,65,100,65,65,528,0.5217391304347826,1.0
80,115,80,65,55,93,488,0.7846153846153846,35,60,44,40,54,55,288,0.366412213740458,1.0
50,92,108,92,108,35,485,0.2457627118644068,70,55,65,95,85,70,440,0.5307692307692308,4.0
67,58,57,81,67,101,431,0.8790322580645161,54,63,52,83,56,97,405,0.7697841726618705,2.0
100,100,100,100,100,100,600,0.8805970149253731,40,70,130,60,130,25,455,0.17355371900826447,1.0
55,55,55,85,55,30,335,0.1320754716981132,126,131,95,131,98,99,680,0.8102189781021898,0.0
90,100,70,110,150,80,600,0.6037735849056604,50,180,20,180,20,150,600,0.9029850746268657,1.0
70,130,100,55,80,65,500,0.608,60,65,80,170,95,130,600,0.8625954198473282,0.25
45,20,50,60,120,50,345,0.24074074074074073,38,30,41,30,41,60,240,0.2897196261682243,1.0
65,125,100,55,70,85,500,0.6532258064516129,70,92,65,80,55,98,460,0.8090909090909091,1.0
60,65,70,85,75,40,395,0.21705426356589147,105,150,90,150,90,95,680,0.8285714285714286,0.25
60,85,69,60,69,77,420,0.518796992481203,43,30,55,40,65,97,330,0.6030534351145038,1.0
30,45,135,45,90,30,375,0.09285714285714286,35,55,40,50,50,90,320,0.6838235294117647,1.0
110,135,60,50,65,88,508,0.7744360902255639,95,125,79,60,100,81,540,0.6165413533834586,0.0
65,100,70,80,80,105,500,0.8666666666666667,50,180,20,180,20,150,600,0.9029850746268657,1.0
70,75,60,105,60,105,475,0.88,60,80,95,70,85,50,440,0.2231404958677686,1.0
60,85,60,50,50,125,430,0.9090909090909091,45,40,60,40,75,50,310,0.2926829268292683,1.0
75,110,110,110,105,80,590,0.656934306569343,70,80,102,80,102,40,474,0.2677165354330709,1.0
103,93,67,71,61,84,479,0.7142857142857143,80,80,90,110,130,110,600,0.8721804511278195,2.0
95,117,80,65,70,92,519,0.8409090909090909,97,165,60,65,50,58,495,0.3902439024390244,2.0
70,55,75,45,65,60,370,0.45901639344262296,40,55,30,30,30,60,245,0.43548387096774194,1.0
65,90,122,58,75,84,494,0.71875,75,125,100,70,80,45,495,0.33035714285714285,1.0
80,100,80,80,80,100,520,0.9051724137931034,126,131,95,131,98,99,680,0.8102189781021898,0.0
105,150,90,150,90,95,680,0.8285714285714286,100,180,160,150,90,90,770,0.7520661157024794,1.0
50,85,85,55,55,50,380,0.3902439024390244,95,100,85,108,70,70,528,0.5652173913043478,0.5
60,100,89,55,69,112,485,0.9298245614035088,40,40,55,40,70,55,300,0.40939597315436244,1.0
30,45,55,70,55,85,340,0.5633802816901409,78,104,78,159,115,100,634,0.8444444444444444,2.0
75,89,85,55,65,36,405,0.29545454545454547,55,40,85,80,105,40,405,0.23622047244094488,0.5
80,115,80,65,55,93,488,0.7846153846153846,90,55,75,60,75,30,385,0.13970588235294118,1.0
60,85,60,85,60,55,405,0.3673469387755102,126,131,95,131,98,99,680,0.8294573643410853,0.5
70,43,53,43,53,40,302,0.19090909090909092,111,83,68,92,82,39,475,0.1774193548387097,0.5
68,75,53,83,113,60,452,0.45384615384615384,60,70,65,125,105,90,515,0.6911764705882353,1.0
60,60,60,85,85,85,435,0.631578947368421,89,125,90,115,80,101,600,0.8725490196078431,1.0
65,95,100,60,50,50,420,0.34959349593495936,60,100,85,80,85,100,510,0.7007874015748031,1.0
73,115,60,60,60,90,458,0.6694915254237288,65,47,55,73,75,85,400,0.65,1.0
70,85,140,85,70,20,470,0.272,45,30,15,85,65,65,305,0.36220472440944884,2.0
50,65,107,105,107,86,520,0.7758620689655172,59,66,70,44,55,41,335,0.25190839694656486,0.25
91,134,95,100,100,80,600,0.6304347826086957,110,65,75,125,85,30,490,0.15,1.0
58,64,58,80,65,80,405,0.5423728813559322,78,70,61,50,61,100,420,0.8145161290322581,1.0
50,95,90,95,90,180,600,0.9172413793103448,75,125,230,55,95,30,610,0.3448275862068966,1.0
60,85,69,65,79,80,438,0.576,78,70,61,50,61,100,420,0.8145161290322581,1.0
76,147,90,60,70,97,540,0.8267716535433071,70,55,55,80,60,45,365,0.2222222222222222,1.0
75,90,140,60,60,40,465,0.3008130081300813,85,105,55,85,50,115,495,0.9032258064516129,0.5
45,60,32,50,32,76,295,0.5925925925925926,30,30,42,30,42,70,244,0.4230769230769231,2.0
50,50,77,95,77,91,440,0.5916666666666667,75,55,70,55,95,110,460,0.8444444444444444,1.0
65,40,70,80,140,70,465,0.5954198473282443,80,70,70,90,100,70,480,0.5609756097560976,0.5
50,120,53,35,110,87,455,0.640625,50,40,85,40,65,25,305,0.08870967741935484,0.5
30,105,90,25,25,50,325,0.2773722627737226,86,68,72,109,66,106,507,0.8099173553719008,2.0
100,150,120,120,100,90,680,0.6493506493506493,100,100,100,100,100,100,600,0.8778625954198473,1.0
60,60,60,35,35,30,280,0.11194029850746269,73,100,60,100,60,65,458,0.42657342657342656,1.0
95,85,85,65,65,35,430,0.2571428571428571,60,110,70,60,60,100,460,0.8461538461538461,0.0
44,75,35,63,33,45,295,0.2647058823529412,30,35,30,100,35,80,310,0.4765625,2.0
64,88,50,88,50,106,446,0.9111111111111111,60,40,60,95,60,55,370,0.4222222222222222,2.0
60,40,60,95,60,55,370,0.4222222222222222,110,160,110,80,110,100,670,0.8591549295774648,0.0
120,100,85,30,85,45,465,0.22448979591836735,50,65,85,35,35,55,325,0.32575757575757575,1.0
50,65,45,85,65,95,405,0.7238095238095238,85,120,70,50,60,100,485,0.8308823529411765,0.5
110,78,73,76,71,60,468,0.3333333333333333,101,72,72,99,89,29,462,0.1937984496124031,1.0
80,160,60,170,130,80,680,0.6180555555555556,50,60,60,60,60,30,320,0.11290322580645161,2.0
43,30,55,40,65,97,330,0.6030534351145038,60,65,60,130,75,110,500,0.7719298245614035,1.0
60,75,85,100,85,115,520,0.8992248062015504,40,45,40,65,40,65,295,0.5661764705882353,1.0
106,190,100,154,100,130,780,0.9259259259259259,60,100,85,80,85,100,510,0.7007874015748031,0.25
30,30,30,30,30,30,180,0.12612612612612611,59,45,40,35,40,31,250,0.14285714285714285,1.0
73,100,60,100,60,65,458,0.42657342657342656,100,120,120,150,100,90,680,0.7880794701986755,0.0
58,70,45,40,45,42,300,0.25925925925925924,106,150,70,194,120,140,780,0.952,1.0
60,80,110,50,80,45,425,0.2833333333333333,80,120,79,95,79,70,523,0.5833333333333334,2.0
71,73,88,120,89,59,500,0.43537414965986393,86,76,86,116,56,95,515,0.7982456140350878,1.0
35,45,160,30,45,70,385,0.48148148148148145,95,70,73,95,90,60,483,0.3983739837398374,1.0
55,70,55,40,55,85,360,0.7073170731707317,59,74,50,35,50,35,303,0.3125,0.0
90,92,87,75,85,76,505,0.5409836065573771,99,68,83,72,87,51,460,0.417910447761194,0.0
90,95,95,70,90,70,510,0.5230769230769231,80,120,79,95,79,70,523,0.5833333333333334,1.0
86,68,72,109,66,106,507,0.8099173553719008,91,90,129,90,72,108,580,0.9140625,1.0
45,60,30,80,50,65,330,0.4603174603174603,95,60,79,100,125,81,540,0.6201550387596899,0.5
65,150,40,15,80,145,495,0.9663865546218487,80,45,65,90,110,80,470,0.5462962962962963,2.0
75,80,60,65,90,102,472,0.8625954198473282,70,70,70,70,70,70,420,0.5289256198347108,1.0
95,110,80,70,80,50,485,0.37209302325581395,50,95,95,35,110,70,455,0.5179856115107914,1.0
91,129,90,72,90,108,580,0.8536585365853658,114,85,70,85,80,30,464,0.2066115702479339,0.5
60,130,80,60,60,70,460,0.5153846153846153,85,115,80,105,80,50,515,0.3063063063063063,1.0
75,70,90,70,105,80,490,0.656,110,160,110,80,110,100,670,0.8591549295774648,1.0
85,80,70,135,75,90,535,0.7006802721088435,38,30,85,55,65,30,303,0.21428571428571427,0.0
55,81,60,50,70,97,413,0.7214285714285714,35,70,55,45,55,25,285,0.09420289855072464,1.0
71,82,64,64,59,112,452,0.9327731092436975,45,60,40,70,50,45,310,0.2846715328467153,1.0
50,50,95,40,50,35,320,0.20279720279720279,50,70,50,50,50,40,310,0.16296296296296298,1.0
63,63,47,41,41,74,329,0.56,40,40,35,50,100,70,335,0.5031847133757962,0.5
77,59,50,67,63,46,362,0.23140495867768596,70,80,70,80,70,110,480,0.6594202898550725,1.0
80,92,65,65,80,68,450,0.4824561403508772,65,85,70,75,70,40,405,0.203125,1.0
39,52,43,60,50,65,309,0.5041322314049587,70,85,70,60,70,50,405,0.28378378378378377,0.5
50,48,43,46,41,60,288,0.47297297297297297,38,36,38,32,36,57,237,0.3893805309734513,1.0
95,23,48,23,48,23,260,0.046153846153846156,75,90,50,110,80,95,500,0.7985611510791367,0.0
35,46,34,35,45,20,215,0.072,100,100,100,100,100,100,600,0.831858407079646,1.0
40,60,40,40,40,30,250,0.0948905109489051,55,70,40,60,40,40,305,0.26956521739130435,1.0
40,40,55,40,70,55,300,0.40939597315436244,63,63,47,41,41,74,329,0.56,0.0
70,20,50,20,50,40,250,0.1557377049180328,90,95,95,70,90,70,510,0.5230769230769231,1.0
40,30,35,45,40,55,245,0.31496062992125984,126,131,95,131,98,99,680,0.8294573643410853,0.0
55,85,122,58,75,99,494,0.8099173553719008,76,65,45,92,42,91,411,0.7449664429530202,0.0
20,25,45,70,90,60,310,0.30833333333333335,91,72,90,129,90,108,580,0.8620689655172413,2.0
64,115,65,83,63,65,455,0.5323741007194245,65,80,65,35,65,60,370,0.38405797101449274,0.0
70,80,50,35,35,35,305,0.14,50,50,150,50,150,50,500,0.2571428571428571,1.0
45,45,55,45,55,63,308,0.4594594594594595,95,110,95,40,95,55,490,0.40336134453781514,1.0
90,95,105,165,110,45,610,0.2890625,40,30,30,40,50,30,220,0.07936507936507936,1.0
60,95,80,60,80,30,405,0.19480519480519481,68,65,65,125,115,80,518,0.6461538461538462,1.0
70,120,40,95,40,95,460,0.8106060606060606,71,120,95,120,95,99,600,0.8203125,1.0
40,40,35,50,100,70,335,0.5031847133757962,65,65,60,130,95,110,525,0.823943661971831,1.0
55,45,43,55,43,72,313,0.5853658536585366,50,45,45,35,35,50,260,0.23529411764705882,1.0
50,65,64,44,48,43,314,0.2196969696969697,83,80,75,70,70,101,479,0.8615384615384616,1.0
60,40,60,95,60,55,370,0.4222222222222222,126,131,95,131,98,99,680,0.8102189781021898,0.5
115,140,130,55,55,40,535,0.4519230769230769,84,86,88,111,101,60,530,0.4634146341463415,1.0
70,84,70,65,70,51,410,0.2949640287769784,20,40,90,30,90,25,295,0.11363636363636363,1.0
50,60,60,60,60,30,320,0.11290322580645161,65,60,110,130,95,65,525,0.47761194029850745,1.0
45,30,15,85,65,65,305,0.36220472440944884,60,70,65,125,105,90,515,0.6911764705882353,4.0
55,130,115,50,50,75,475,0.5982142857142857,50,75,35,70,30,40,300,0.21296296296296297,0.5
95,75,80,100,110,30,490,0.24242424242424243,75,80,55,25,35,35,305,0.18666666666666668,1.0
250,5,5,35,105,50,450,0.15306122448979592,40,70,130,60,130,25,455,0.17355371900826447,0.0
61,78,95,56,58,57,405,0.40336134453781514,100,50,80,60,80,50,420,0.34375,2.0
59,66,70,44,55,41,335,0.25190839694656486,103,93,67,71,61,84,479,0.7142857142857143,0.25
95,85,85,65,65,35,430,0.2571428571428571,64,66,68,81,76,50,405,0.25190839694656486,0.5
95,23,48,23,48,23,260,0.046153846153846156,65,60,110,130,95,65,525,0.47761194029850745,1.0
52,65,55,58,62,60,352,0.4482758620689655,45,49,65,49,65,45,318,0.275,2.0
61,90,45,50,50,160,456,0.9230769230769231,52,65,55,58,62,60,352,0.4482758620689655,0.5
86,76,86,116,56,95,515,0.7982456140350878,43,80,65,50,35,35,308,0.14193548387096774,1.0
95,75,110,100,80,30,490,0.15267175572519084,70,65,60,90,75,90,450,0.6571428571428571,2.0
70,85,65,105,85,120,530,0.9262295081967213,60,69,95,69,95,36,424,0.2608695652173913,0.25
84,71,43,71,43,48,360,0.25874125874125875,40,30,32,50,52,65,269,0.3671875,1.0
63,120,85,90,55,55,468,0.2809917355371901,38,41,40,50,65,65,299,0.4108527131782946,2.0
60,80,110,50,80,45,425,0.2833333333333333,35,55,40,50,50,90,320,0.6838235294117647,2.0
45,30,15,85,65,65,305,0.36220472440944884,73,115,60,60,60,90,458,0.6694915254237288,1.0
85,90,80,70,80,130,535,0.9262295081967213,77,59,50,67,63,46,362,0.23140495867768596,0.25
41,56,40,62,44,71,314,0.568,59,110,150,45,49,35,448,0.3333333333333333,1.0
55,35,50,55,110,85,390,0.6277372262773723,65,63,45,45,45,45,308,0.2595419847328244,0.5
65,50,70,95,80,65,425,0.4262295081967213,45,45,35,20,30,20,195,0.07246376811594203,1.0
41,64,45,50,50,50,300,0.36752136752136755,55,50,40,40,40,75,300,0.5945945945945946,1.0
50,92,108,92,108,35,485,0.2457627118644068,75,90,50,110,80,95,500,0.7985611510791367,0.25
65,90,50,85,45,55,390,0.371900826446281,80,115,80,65,55,93,488,0.7846153846153846,0.5
80,100,70,50,60,45,405,0.25806451612903225,114,85,70,85,80,30,464,0.2066115702479339,0.5
60,50,70,50,90,65,385,0.39568345323741005,50,65,45,85,65,95,405,0.7238095238095238,4.0
50,45,45,35,35,50,260,0.23529411764705882,35,55,40,45,40,60,275,0.35714285714285715,1.0
40,30,50,55,55,100,330,0.584070796460177,77,120,90,60,90,48,485,0.2785714285714286,0.5
38,35,35,65,55,50,278,0.2647058823529412,105,150,90,150,90,95,680,0.8285714285714286,2.0
55,40,50,65,85,40,335,0.3181818181818182,70,115,60,115,60,55,475,0.4647887323943662,0.25
79,105,70,145,80,101,580,0.8608695652173913,70,70,70,70,70,70,420,0.5289256198347108,1.0
50,50,120,80,80,30,410,0.07258064516129033,100,103,75,120,75,127,600,0.940677966101695,4.0
45,50,45,115,55,95,405,0.6936936936936937,106,110,90,154,90,130,680,0.926829268292683,2.0
45,53,70,40,60,42,310,0.25735294117647056,75,98,63,98,63,101,498,0.849624060150376,2.0
40,29,45,29,45,36,224,0.14634146341463414,50,52,48,65,50,55,320,0.33098591549295775,1.0
65,60,70,85,75,40,395,0.1796875,85,70,80,97,80,123,535,0.9304347826086956,1.0
85,80,90,105,95,60,515,0.49074074074074076,75,125,230,55,95,30,610,0.3448275862068966,0.5
110,65,105,55,95,80,510,0.6258503401360545,70,70,70,70,70,70,420,0.5289256198347108,1.0
120,70,120,75,130,85,600,0.6694915254237288,85,110,90,45,90,80,500,0.6206896551724138,1.0
70,60,62,80,82,60,414,0.4375,75,90,90,140,90,115,600,0.9481481481481482,1.0
80,110,120,130,90,70,600,0.6198347107438017,75,95,95,95,95,85,540,0.6470588235294118,0.0625
76,25,45,67,55,24,292,0.0390625,68,72,78,38,42,32,330,0.23809523809523808,2.0
45,75,60,40,30,50,300,0.304,61,72,57,55,55,65,365,0.3984375,1.0
70,65,60,90,75,90,450,0.6571428571428571,100,150,110,95,110,70,635,0.5923076923076923,0.5
78,130,111,130,85,100,634,0.8561151079136691,100,150,140,100,90,90,670,0.7969924812030075,1.0
50,72,35,35,35,65,292,0.5373134328358209,60,85,60,50,50,125,430,0.9090909090909091,0.0
30,56,35,25,35,72,253,0.48148148148148145,105,140,55,30,55,95,480,0.8195488721804511,1.0
65,125,100,60,70,70,490,0.6099290780141844,83,80,80,135,80,121,579,0.9444444444444444,1.0
65,60,110,130,95,65,525,0.47761194029850745,55,45,45,25,25,15,210,0.048,1.0
80,82,83,100,100,80,525,0.6742424242424242,80,100,123,122,120,80,625,0.56,0.25
80,45,65,90,110,80,470,0.5462962962962963,60,48,45,43,90,42,328,0.21897810218978103,0.5
86,92,88,68,75,73,482,0.6835443037974683,50,50,50,50,50,50,300,0.30708661417322836,1.0
45,30,15,85,65,65,305,0.36220472440944884,60,150,50,150,50,60,520,0.5,0.25
95,125,79,60,100,81,540,0.6165413533834586,70,100,70,105,75,40,460,0.23214285714285715,4.0
60,62,63,80,80,60,405,0.38016528925619836,50,65,85,35,35,55,325,0.32575757575757575,0.5
105,140,95,55,65,45,505,0.3,65,65,45,75,45,95,390,0.72,0.25
60,85,60,85,60,55,405,0.3673469387755102,50,50,40,30,30,50,250,0.2781954887218045,4.0
75,80,85,110,90,50,490,0.3548387096774194,90,85,100,95,125,85,580,0.6834532374100719,0.5
25,35,70,95,55,45,325,0.16783216783216784,40,45,40,65,40,65,295,0.5661764705882353,0.25
30,65,100,45,25,40,305,0.1891891891891892,80,100,70,60,70,95,475,0.7416666666666667,0.5
250,5,5,35,105,50,450,0.15306122448979592,65,125,100,60,70,70,490,0.6099290780141844,0.5
90,60,70,75,70,45,410,0.23880597014925373,60,150,50,150,50,60,520,0.5,0.5
80,80,80,80,80,80,480,0.5606060606060606,90,85,100,95,125,85,580,0.6834532374100719,1.0
100,150,120,120,100,90,680,0.6493506493506493,50,25,28,45,55,15,218,0.0625,0.0
50,50,77,95,77,91,440,0.5916666666666667,45,55,39,35,39,42,255,0.18518518518518517,0.0
70,85,65,105,85,120,530,0.9262295081967213,165,75,80,40,45,65,470,0.5151515151515151,2.0
28,25,25,45,35,40,198,0.16083916083916083,44,75,35,63,33,45,295,0.2647058823529412,1.0
45,60,45,25,45,55,275,0.29,45,75,60,40,30,50,300,0.304,1.0
60,52,168,47,138,30,495,0.19834710743801653,100,100,100,100,100,100,600,0.8778625954198473,1.0
60,60,60,60,60,60,360,0.38095238095238093,75,95,95,95,95,85,540,0.6470588235294118,1.0
65,50,35,115,95,95,455,0.7333333333333333,83,106,65,86,65,85,490,0.6640625,2.0
79,115,70,125,80,111,580,0.8468468468468469,90,30,15,40,20,15,210,0.043478260869565216,1.0
76,147,90,60,70,97,540,0.8267716535433071,70,45,48,60,65,35,323,0.15748031496062992,0.0
91,129,90,72,90,108,580,0.8536585365853658,60,52,168,47,138,30,495,0.19834710743801653,2.0
85,105,100,79,83,78,530,0.5869565217391305,150,160,100,95,65,100,670,0.8866666666666667,1.0
20,40,15,35,35,60,205,0.34285714285714286,100,90,130,45,65,55,485,0.4253731343283582,2.0
30,65,100,45,25,40,305,0.1891891891891892,60,90,70,60,120,40,440,0.27419354838709675,1.0
88,107,122,74,75,64,530,0.4596774193548387,106,190,100,154,100,130,780,0.9259259259259259,0.5
67,89,116,79,116,33,500,0.2624113475177305,95,75,80,100,110,30,490,0.24242424242424243,0.25
70,40,50,55,50,25,290,0.061068702290076333,50,70,50,50,50,70,340,0.5645161290322581,4.0
45,95,50,40,50,75,355,0.54,44,50,91,24,86,10,305,0.1981981981981982,0.5
85,105,85,40,50,40,405,0.211864406779661,45,75,60,40,30,50,300,0.304,1.0
50,65,90,35,35,15,290,0.14678899082568808,45,55,39,35,39,42,255,0.18518518518518517,1.0
95,124,78,69,71,58,495,0.37398373983739835,75,90,50,110,80,95,500,0.7985611510791367,1.0
50,50,62,40,62,65,329,0.4188034188034188,85,97,66,105,66,65,484,0.47107438016528924,1.0
80,120,70,110,70,80,530,0.6422764227642277,75,80,60,65,90,102,472,0.8625954198473282,2.0
91,90,129,90,72,108,580,0.9140625,45,55,45,65,45,75,330,0.5692307692307692,2.0
45,50,35,55,75,40,300,0.21367521367521367,80,75,150,75,150,50,580,0.30973451327433627,0.5
89,125,90,115,80,101,600,0.8725490196078431,64,51,23,51,23,28,240,0.11363636363636363,1.0
85,60,65,135,105,100,550,0.7518248175182481,106,190,100,154,100,130,780,0.9259259259259259,1.0
60,45,50,90,80,70,395,0.625,91,90,106,130,106,77,600,0.648854961832061,0.125
55,85,122,58,75,99,494,0.8099173553719008,1,90,45,30,30,40,236,0.33064516129032256,1.0
55,50,65,175,95,150,590,0.7818181818181819,250,5,5,35,105,50,450,0.15306122448979592,1.0
70,60,62,80,82,60,414,0.4375,55,55,55,85,55,30,335,0.1320754716981132,2.0
120,70,120,75,130,85,600,0.6694915254237288,123,100,62,97,81,68,531,0.4806201550387597,1.0
50,20,55,25,25,30,205,0.09774436090225563,170,90,45,90,45,60,500,0.427536231884058,1.0
30,65,100,45,25,40,305,0.1891891891891892,101,72,72,99,89,29,462,0.1937984496124031,1.0
63,60,55,50,50,71,349,0.5289256198347108,48,72,48,72,48,48,336,0.25984251968503935,1.0
65,150,60,115,60,115,565,0.935251798561151,30,80,90,55,45,55,355,0.4295774647887324,1.0
82,121,119,69,59,71,521,0.5394736842105263,75,70,90,70,105,80,490,0.656,4.0
70,130,100,55,80,65,500,0.608,70,20,50,20,50,40,250,0.1557377049180328,0.125
65,60,70,85,75,40,395,0.1796875,60,40,50,75,85,95,405,0.6044776119402985,1.0
65,65,60,110,95,130,525,0.9253731343283582,75,100,110,45,55,65,450,0.5333333333333333,0.0
54,63,52,83,56,97,405,0.7697841726618705,55,20,35,20,45,75,250,0.37681159420289856,1.0
40,29,45,29,45,36,224,0.14634146341463414,50,50,40,50,40,64,294,0.45588235294117646,1.0
89,124,80,55,80,55,483,0.5714285714285714,30,40,70,70,25,60,295,0.41353383458646614,1.0
60,69,95,69,95,36,424,0.2608695652173913,61,78,95,56,58,57,405,0.40336134453781514,2.0
70,92,65,80,55,98,460,0.8090909090909091,45,35,50,70,50,30,280,0.15753424657534246,0.5
40,20,30,40,80,55,265,0.22764227642276422,60,100,89,55,69,112,485,0.9298245614035088,1.0
100,100,100,100,100,100,600,0.8778625954198473,40,55,70,45,60,30,300,0.10619469026548672,1.0
115,45,20,45,25,20,270,0.11538461538461539,85,120,70,50,60,100,485,0.8308823529411765,1.0
75,90,50,110,80,95,500,0.7985611510791367,70,55,95,95,110,65,490,0.48872180451127817,2.0
68,75,53,83,113,60,452,0.45384615384615384,70,140,230,60,80,50,630,0.32432432432432434,0.5
150,80,44,90,54,80,498,0.625,123,100,62,97,81,68,531,0.4806201550387597,2.0
55,40,40,65,45,35,280,0.16428571428571428,100,120,100,150,120,90,680,0.728,0.5
170,90,45,90,45,60,500,0.427536231884058,50,70,50,50,50,70,340,0.5645161290322581,1.0
85,100,122,58,75,54,494,0.3939393939393939,60,55,90,145,90,80,520,0.6071428571428571,1.0
70,60,62,80,82,60,414,0.4375,60,90,55,90,80,110,485,0.8677685950413223,0.5
39,52,43,60,50,65,309,0.5041322314049587,50,85,125,85,115,20,480,0.4306569343065693,1.0
58,50,145,95,105,30,483,0.2459016393442623,25,35,70,95,55,45,325,0.16783216783216784,1.0
45,95,50,40,50,75,355,0.54,60,40,80,60,45,40,325,0.23529411764705882,4.0
74,48,76,83,81,104,466,0.7913043478260869,50,50,40,30,30,50,250,0.2781954887218045,2.0
60,25,35,70,80,60,330,0.3076923076923077,80,70,70,90,100,70,480,0.5609756097560976,1.0
89,145,90,105,80,91,600,0.8549618320610687,50,50,62,40,62,65,329,0.4188034188034188,2.0
95,110,95,40,95,55,490,0.40336134453781514,75,80,55,25,35,35,305,0.18666666666666668,1.0
160,110,65,65,110,30,540,0.35714285714285715,100,100,100,100,100,100,600,0.8805970149253731,1.0
55,35,50,55,110,85,390,0.6277372262773723,44,48,65,50,64,43,314,0.1623931623931624,1.0
76,65,45,92,42,91,411,0.7449664429530202,35,55,40,45,40,60,275,0.35714285714285715,0.5
70,90,45,15,45,50,315,0.3629032258064516,70,94,50,94,50,66,424,0.48148148148148145,2.0
31,45,90,30,30,40,266,0.21929824561403508,35,65,35,65,35,65,300,0.46621621621621623,1.0
72,60,30,20,30,25,237,0.11570247933884298,65,65,65,50,50,90,385,0.72,1.0
60,80,50,50,50,40,330,0.23853211009174313,35,65,35,65,35,65,300,0.46621621621621623,1.0
70,43,53,43,53,40,302,0.19090909090909092,50,47,50,57,50,65,319,0.463768115942029,1.0
78,52,60,63,65,23,341,0.06015037593984962,42,52,67,39,56,50,306,0.2868217054263566,1.0
40,35,30,20,20,50,195,0.23423423423423423,125,58,58,76,76,67,460,0.515625,1.0
70,95,85,55,65,70,440,0.5,54,63,52,83,56,97,405,0.7697841726618705,1.0
79,115,70,125,80,111,580,0.8468468468468469,50,65,85,35,35,55,325,0.32575757575757575,1.0
40,40,50,30,30,30,220,0.0873015873015873,58,70,45,40,45,42,300,0.25925925925925924,1.0
40,55,30,30,30,85,270,0.688,70,120,100,145,105,20,560,0.2824427480916031,1.0
65,80,80,59,63,58,405,0.4411764705882353,78,130,111,130,85,100,634,0.8561151079136691,1.0
100,180,160,150,90,90,770,0.7520661157024794,60,90,140,50,50,40,430,0.2535211267605634,4.0
77,120,90,60,90,48,485,0.2785714285714286,45,55,45,65,45,75,330,0.5692307692307692,1.0
90,120,75,60,60,45,450,0.29411764705882354,55,81,60,50,70,97,413,0.7214285714285714,1.0
76,104,71,104,71,108,534,0.912751677852349,60,100,115,70,85,90,520,0.7557251908396947,4.0
60,90,140,50,50,40,430,0.2535211267605634,75,95,125,45,75,95,510,0.8257575757575758,1.0
85,73,70,73,115,67,483,0.5126050420168067,100,134,110,95,100,61,600,0.4057971014492754,0.0
40,60,40,40,40,30,250,0.0948905109489051,40,40,35,50,100,70,335,0.5031847133757962,0.25
63,60,55,50,50,71,349,0.5289256198347108,80,82,83,100,100,80,525,0.6742424242424242,2.0
50,85,85,55,55,50,380,0.3902439024390244,84,71,43,71,43,48,360,0.25874125874125875,1.0
60,55,145,75,150,40,525,0.2,60,60,50,40,50,75,335,0.5882352941176471,1.0
50,70,50,50,50,40,310,0.16296296296296298,95,125,79,60,100,81,540,0.6165413533834586,0.5
65,155,120,65,90,105,600,0.8677685950413223,59,110,150,45,49,35,448,0.3333333333333333,0.125
86,76,86,116,56,95,515,0.7982456140350878,75,123,67,95,85,95,540,0.7642276422764228,0.5
60,100,115,70,85,90,520,0.7557251908396947,50,70,160,70,160,90,600,0.7417218543046358,1.0
50,50,77,95,77,91,440,0.5916666666666667,70,90,90,135,90,125,600,0.9401709401709402,0.5
80,120,130,55,65,45,495,0.37037037037037035,54,78,103,53,45,22,355,0.23255813953488372,2.0
78,84,78,109,85,100,534,0.8620689655172413,85,56,77,50,77,78,423,0.53125,1.0
35,55,40,45,40,60,275,0.35714285714285715,95,145,130,120,90,120,700,0.9398496240601504,1.0
45,75,60,40,30,50,300,0.304,48,61,40,61,40,50,300,0.2543859649122807,1.0
55,95,55,35,75,115,430,0.9380530973451328,100,100,100,100,100,100,600,0.8778625954198473,1.0
25,20,15,105,55,90,310,0.32407407407407407,61,90,45,50,50,160,456,0.9230769230769231,1.0
59,63,80,65,80,58,405,0.41843971631205673,160,110,65,65,110,30,540,0.35714285714285715,1.0
60,100,115,70,85,90,520,0.7557251908396947,65,73,55,47,75,85,400,0.6846846846846847,1.0
126,131,95,131,98,99,680,0.8102189781021898,79,115,70,125,80,111,580,0.8468468468468469,1.0
35,40,100,90,55,35,355,0.1796875,70,55,75,45,65,60,370,0.45901639344262296,2.0
70,100,115,30,65,30,410,0.24390243902439024,45,85,50,55,50,65,350,0.5076923076923077,0.5
60,30,30,36,56,50,262,0.32432432432432434,80,120,79,95,79,70,523,0.5833333333333334,0.5
60,90,70,60,120,40,440,0.27419354838709675,40,70,40,35,40,60,285,0.392,1.0
70,65,60,90,75,90,450,0.6571428571428571,45,100,135,65,135,45,525,0.29411764705882354,0.25
50,48,43,46,41,60,288,0.47297297297297297,74,48,76,83,81,104,466,0.7913043478260869,1.0
60,60,50,40,50,75,335,0.5882352941176471,40,55,80,35,60,30,300,0.15037593984962405,0.25
95,155,109,70,130,81,640,0.6788321167883211,65,47,55,73,75,85,400,0.65,1.0
65,50,35,115,95,95,455,0.7333333333333333,125,130,90,130,90,95,660,0.7734375,1.0
90,60,60,40,40,40,330,0.29545454545454547,45,50,55,75,65,30,320,0.06293706293706294,1.0
62,48,66,59,57,49,341,0.33884297520661155,60,115,105,65,70,80,495,0.7181818181818181,1.0
95,70,73,95,90,60,483,0.3983739837398374,50,65,85,35,35,55,325,0.32575757575757575,1.0
70,60,125,115,70,55,495,0.35507246376811596,69,55,45,55,55,15,294,0.11666666666666667,0.5
35,20,65,40,65,20,245,0.02459016393442623,70,140,70,110,65,105,560,0.95,2.0
79,100,80,110,90,121,580,0.968,50,50,95,40,50,35,320,0.20279720279720279,1.0
71,95,85,110,95,79,535,0.664,60,70,105,70,120,75,500,0.5983606557377049,2.0
91,72,90,129,90,108,580,0.8925619834710744,130,65,60,110,95,65,525,0.5227272727272727,0.5
42,52,67,39,56,50,306,0.2868217054263566,75,95,95,95,95,85,540,0.6470588235294118,0.25
65,60,110,130,95,65,525,0.47761194029850745,91,72,90,129,90,108,580,0.8620689655172413,0.5
50,180,20,180,20,150,600,0.9029850746268657,78,104,78,159,115,100,634,0.8444444444444444,1.0
40,30,32,50,52,65,269,0.3671875,38,35,35,65,55,50,278,0.2647058823529412,1.0
160,110,65,65,110,30,540,0.35714285714285715,73,115,60,60,60,90,458,0.6694915254237288,1.0
95,117,184,44,46,28,514,0.2975206611570248,35,55,40,50,50,90,320,0.6838235294117647,1.0
25,35,70,95,55,45,325,0.16783216783216784,100,100,100,100,100,100,600,0.8345864661654135,0.5
120,70,120,75,130,85,600,0.6694915254237288,55,40,40,65,45,35,280,0.16428571428571428,1.0
50,65,85,35,35,55,325,0.32575757575757575,114,85,70,85,80,30,464,0.2066115702479339,1.0
70,20,50,20,50,40,250,0.1557377049180328,150,80,44,90,54,80,498,0.625,1.0
64,115,65,83,63,65,455,0.5323741007194245,65,40,70,80,140,70,465,0.5954198473282443,1.0
108,112,118,68,72,47,525,0.2916666666666667,60,110,70,60,60,100,460,0.8461538461538461,0.0
50,55,50,36,30,43,264,0.2922077922077922,70,84,70,65,70,51,410,0.2949640287769784,0.25
65,70,60,65,65,115,440,0.8583333333333333,65,150,60,115,60,115,565,0.935251798561151,1.0
86,81,97,81,107,43,495,0.203125,85,73,70,73,115,67,483,0.5126050420168067,1.0
250,5,5,35,105,50,450,0.15306122448979592,90,93,55,70,55,55,418,0.3819444444444444,1.0
40,70,40,35,40,60,285,0.392,49,49,56,49,61,66,330,0.5190839694656488,1.0
65,155,120,65,90,105,600,0.8677685950413223,80,185,115,40,105,75,600,0.6230769230769231,2.0
70,150,140,65,100,75,600,0.55,70,55,95,95,110,65,490,0.48872180451127817,2.0
90,120,100,150,120,100,680,0.7718120805369127,78,84,78,109,85,100,534,0.8620689655172413,2.0
65,125,100,60,70,70,490,0.6099290780141844,62,73,55,56,52,84,382,0.7244094488188977,0.5
41,56,40,62,44,71,314,0.568,83,80,80,135,80,121,579,0.9444444444444444,1.0
90,60,70,75,70,45,410,0.23880597014925373,100,90,130,45,65,55,485,0.4253731343283582,0.5
70,43,53,43,53,40,302,0.19090909090909092,50,120,53,35,110,87,455,0.640625,1.0
36,50,50,65,60,44,305,0.16363636363636364,50,80,95,10,45,10,290,0.232,1.0
45,30,50,55,65,45,290,0.208,55,85,122,58,75,99,494,0.8099173553719008,1.0
58,64,58,80,65,80,405,0.609271523178808,50,85,125,85,115,20,480,0.4306569343065693,1.0
65,100,70,80,80,105,500,0.8666666666666667,70,55,55,80,60,45,365,0.2222222222222222,1.0
35,80,50,50,70,120,405,0.84375,60,85,60,50,50,125,430,0.9090909090909091,0.0
40,65,40,80,40,65,330,0.5038167938931297,67,58,57,81,67,101,431,0.8790322580645161,0.5
75,98,63,98,63,101,498,0.8091603053435115,60,60,40,65,45,35,305,0.15833333333333333,1.0
110,65,75,125,85,30,490,0.15,70,110,70,115,70,90,525,0.75,0.5
95,145,130,120,90,120,700,0.9398496240601504,40,27,60,37,50,66,280,0.36220472440944884,0.0
80,92,65,65,80,68,450,0.4824561403508772,70,70,40,60,40,60,340,0.4247787610619469,0.5
20,25,45,70,90,60,310,0.30833333333333335,90,120,100,150,120,100,680,0.7718120805369127,2.0
50,50,95,40,50,35,320,0.20279720279720279,79,105,70,145,80,101,580,0.8608695652173913,0.0
125,58,58,76,76,67,460,0.515625,55,65,35,60,30,85,330,0.6126126126126126,1.0
60,100,85,80,85,100,510,0.7007874015748031,20,25,45,70,90,60,310,0.30833333333333335,0.125
65,50,35,115,95,95,455,0.7333333333333333,85,105,85,40,50,40,405,0.211864406779661,1.0
65,40,70,80,140,70,465,0.5954198473282443,44,48,65,50,64,43,314,0.1623931623931624,0.5
65,65,60,110,95,130,525,0.9253731343283582,106,130,90,110,154,90,680,0.719626168224299,2.0
60,90,70,60,120,40,440,0.27419354838709675,39,52,43,60,50,65,309,0.49107142857142855,1.0
70,70,70,70,70,70,420,0.5289256198347108,100,123,75,57,75,80,510,0.6923076923076923,1.0
95,65,65,110,130,60,525,0.4016393442622951,77,85,51,55,51,65,384,0.5163934426229508,1.0
68,85,65,165,135,100,618,0.8083333333333333,70,55,55,80,60,45,365,0.2222222222222222,1.0
100,75,115,90,115,85,580,0.6446280991735537,50,35,55,25,25,15,205,0.05263157894736842,1.0
50,160,110,160,110,110,700,0.8854961832061069,72,105,115,54,86,68,500,0.5149253731343284,1.0
65,65,60,130,95,110,525,0.823943661971831,79,115,70,125,80,111,580,0.864,1.0
60,45,70,45,90,95,405,0.7304964539007093,73,95,62,85,65,85,465,0.6666666666666666,1.0
40,45,65,100,120,90,460,0.5588235294117647,65,125,100,55,70,85,500,0.6532258064516129,1.0
68,75,53,83,113,60,452,0.45384615384615384,50,70,50,50,50,40,310,0.16296296296296298,1.0
75,80,55,25,35,35,305,0.18666666666666668,45,50,55,75,65,30,320,0.06293706293706294,0.5
62,50,58,73,54,72,369,0.4435483870967742,50,95,90,95,90,180,600,0.9172413793103448,1.0
105,150,90,150,90,95,680,0.8285714285714286,110,123,65,100,65,65,528,0.5217391304347826,2.0
126,131,95,131,98,99,680,0.8294573643410853,67,58,57,81,67,101,431,0.8790322580645161,1.0
80,80,90,110,130,110,600,0.8721804511278195,41,50,37,50,37,66,281,0.5175438596491229,0.0
80,85,95,30,30,25,345,0.2857142857142857,85,50,95,120,115,80,545,0.5793650793650794,0.0
45,100,135,65,135,45,525,0.29411764705882354,110,80,90,95,90,65,530,0.5033557046979866,1.0
74,108,133,83,65,32,495,0.32142857142857145,55,65,95,95,45,85,440,0.6610169491525424,0.5
170,90,45,90,45,60,500,0.427536231884058,50,45,45,35,35,50,260,0.23529411764705882,1.0
45,90,20,65,20,65,305,0.5116279069767442,65,75,105,35,65,85,430,0.6940298507462687,2.0
50,70,100,40,40,30,330,0.2222222222222222,50,105,125,55,95,50,480,0.375886524822695,0.125
40,80,35,35,45,70,305,0.4661016949152542,115,45,20,45,25,20,270,0.11538461538461539,1.0
80,105,105,105,105,80,580,0.5939849624060151,75,80,55,25,35,35,305,0.18666666666666668,1.0
60,60,60,105,105,105,495,0.848,70,85,140,85,70,20,470,0.272,1.0
60,67,85,77,75,116,480,0.8888888888888888,55,81,60,50,70,97,413,0.7214285714285714,1.0
45,40,60,40,75,50,310,0.2926829268292683,50,40,85,40,65,25,305,0.08870967741935484,2.0
60,65,80,170,95,130,600,0.8625954198473282,95,155,109,70,130,81,640,0.6788321167883211,0.5
35,20,65,40,65,20,245,0.02459016393442623,90,60,70,75,70,45,410,0.23880597014925373,1.0
65,95,75,55,55,85,430,0.6933333333333334,40,50,90,30,55,65,330,0.44680851063829785,0.5
123,77,72,99,92,58,521,0.4621212121212121,78,52,60,63,65,23,341,0.06015037593984962,1.0
105,130,120,45,45,40,485,0.4444444444444444,75,80,85,110,90,50,490,0.3548387096774194,1.0
95,100,85,108,70,70,528,0.5652173913043478,90,120,120,60,60,50,500,0.35294117647058826,2.0
43,80,65,50,35,35,308,0.14193548387096774,67,82,62,46,48,43,348,0.22033898305084745,1.0
60,115,105,65,70,80,495,0.7181818181818181,76,147,90,60,70,97,540,0.8267716535433071,0.5
65,55,115,100,40,60,435,0.3798449612403101,65,65,60,110,95,130,525,0.9253731343283582,1.0
60,25,35,70,80,60,330,0.3076923076923077,45,100,135,65,135,45,525,0.29411764705882354,1.0
70,65,65,55,55,70,380,0.5,67,57,55,77,55,114,425,0.8879310344827587,1.0
70,75,60,105,60,105,475,0.88,85,120,70,50,60,100,485,0.8308823529411765,2.0
41,50,37,50,37,66,281,0.5175438596491229,50,35,55,25,25,15,205,0.021739130434782608,1.0
54,78,103,53,45,22,355,0.23255813953488372,65,125,100,55,70,85,500,0.6532258064516129,2.0
55,35,50,55,110,85,390,0.6277372262773723,50,95,95,35,110,70,455,0.5179856115107914,1.0
75,125,70,125,70,115,580,0.9037037037037037,40,45,65,100,120,90,460,0.5588235294117647,0.5
44,58,44,58,44,61,309,0.41964285714285715,58,70,45,40,45,42,300,0.25925925925925924,0.5
45,50,55,75,65,30,320,0.06293706293706294,60,45,70,75,85,55,390,0.3008130081300813,1.0
40,50,90,30,55,65,330,0.44680851063829785,59,45,40,35,40,31,250,0.14285714285714285,1.0
75,105,75,105,75,45,480,0.3274336283185841,35,55,40,50,50,90,320,0.6838235294117647,1.0
120,100,85,30,85,45,465,0.22448979591836735,85,70,80,97,80,123,535,0.9304347826086956,0.5
60,40,80,60,45,40,325,0.23529411764705882,77,120,90,60,90,48,485,0.2785714285714286,0.5
25,35,70,95,55,45,325,0.16783216783216784,116,55,85,107,95,29,487,0.06818181818181818,1.0
78,65,68,112,154,75,552,0.628099173553719,80,100,70,60,70,95,475,0.7416666666666667,1.0
70,150,140,65,100,75,600,0.55,70,75,80,135,80,135,575,0.917910447761194,0.5
50,65,64,44,48,43,314,0.2196969696969697,79,115,70,125,80,111,580,0.8468468468468469,1.0
74,48,76,83,81,104,466,0.7913043478260869,59,110,150,45,49,35,448,0.3333333333333333,0.5
62,77,62,50,42,65,358,0.4838709677419355,150,160,100,95,65,100,670,0.8866666666666667,1.0
65,75,105,35,65,85,430,0.6940298507462687,20,15,20,10,55,80,200,0.2682926829268293,1.0
160,110,65,65,110,30,540,0.35714285714285715,100,150,120,120,100,90,680,0.6493506493506493,1.0
60,59,85,79,105,36,424,0.16666666666666666,85,73,70,73,115,67,483,0.5126050420168067,2.0
45,50,43,40,38,62,278,0.40441176470588236,77,85,51,55,51,65,384,0.5163934426229508,2.0
85,120,70,50,60,100,485,0.8308823529411765,70,90,70,60,60,70,420,0.6390977443609023,1.0
75,70,90,70,105,80,490,0.656,70,55,65,95,85,70,440,0.5307692307692308,0.5
70,45,48,60,65,35,323,0.15748031496062992,90,130,80,65,85,55,505,0.4396551724137931,2.0
75,125,75,30,75,85,465,0.625,75,65,55,65,55,69,384,0.43548387096774194,1.0
110,160,110,80,110,100,670,0.8591549295774648,120,120,120,120,120,120,720,0.9344262295081968,1.0
110,123,65,100,65,65,528,0.5217391304347826,76,25,45,67,55,24,292,0.0390625,0.5
55,63,90,50,80,42,380,0.21138211382113822,45,55,39,35,39,42,255,0.18518518518518517,1.0
50,180,20,180,20,150,600,0.9029850746268657,60,105,60,120,60,105,510,0.8849557522123894,0.0
45,49,49,65,65,45,318,0.2781954887218045,48,72,48,72,48,48,336,0.25984251968503935,1.0
85,80,70,135,75,90,535,0.7006802721088435,70,94,50,94,50,66,424,0.48148148148148145,1.0
50,53,62,58,63,44,330,0.13709677419354838,78,84,78,109,85,100,534,0.8620689655172413,2.0
80,100,80,80,80,100,520,0.9051724137931034,61,90,45,50,50,160,456,0.9230769230769231,0.0
74,48,76,83,81,104,466,0.7322834645669292,100,100,100,100,100,100,600,0.8345864661654135,0.5
125,170,100,120,90,95,700,0.77,82,80,86,85,75,72,480,0.6183206106870229,0.0
50,35,55,25,25,15,205,0.021739130434782608,40,60,40,40,40,30,250,0.0948905109489051,0.5
59,110,150,45,49,35,448,0.3333333333333333,45,40,60,40,75,50,310,0.2926829268292683,0.0
110,80,90,95,90,65,530,0.5033557046979866,70,77,60,97,60,108,472,0.8394160583941606,1.0
90,50,34,60,44,70,348,0.6283185840707964,37,25,41,25,41,25,194,0.08870967741935484,2.0
75,125,230,55,95,30,610,0.3448275862068966,20,40,15,35,35,60,205,0.34285714285714286,1.0
75,140,65,112,65,110,567,0.9140625,67,57,55,77,55,114,425,0.8879310344827587,2.0
80,95,82,60,82,75,474,0.6,50,35,55,25,25,15,205,0.05263157894736842,1.0
60,105,60,120,60,105,510,0.8849557522123894,84,71,43,71,43,48,360,0.25874125874125875,1.0
60,62,63,80,80,60,405,0.38016528925619836,55,40,85,80,105,40,405,0.23622047244094488,1.0
65,150,40,15,80,145,495,0.9663865546218487,38,41,40,50,65,65,299,0.4108527131782946,0.5
70,115,60,115,60,55,475,0.4647887323943662,90,75,75,90,100,70,500,0.5462184873949579,2.0
52,65,50,45,50,38,300,0.27419354838709675,55,95,55,35,75,115,430,0.9380530973451328,0.5
85,100,122,58,75,54,494,0.3939393939393939,110,65,75,125,85,30,490,0.15,2.0
150,160,100,95,65,100,670,0.8866666666666667,66,117,70,40,50,67,410,0.4573643410852713,1.0
70,115,60,115,60,55,475,0.4647887323943662,90,95,95,70,90,70,510,0.5230769230769231,1.0
41,64,45,50,50,50,300,0.36752136752136755,67,57,55,77,55,114,425,0.8879310344827587,1.0
50,35,55,25,25,15,205,0.021739130434782608,97,165,60,65,50,58,495,0.3902439024390244,1.0
85,110,90,45,90,80,500,0.6206896551724138,54,63,52,83,56,97,405,0.7697841726618705,1.0
70,110,80,55,80,105,500,0.8794326241134752,50,50,120,80,80,30,410,0.07258064516129033,0.25
75,80,95,90,100,50,490,0.2158273381294964,105,130,120,45,45,40,485,0.4444444444444444,4.0
70,80,65,90,65,85,455,0.578125,60,45,50,90,80,70,395,0.625,1.0
95,80,105,40,70,100,490,0.8046875,170,90,45,90,45,60,500,0.427536231884058,1.0
85,50,95,120,115,80,545,0.5793650793650794,40,29,45,29,45,36,224,0.14634146341463414,2.0
75,85,200,55,65,30,510,0.16778523489932887,70,140,70,110,65,105,560,0.95,0.5
65,150,60,115,60,115,565,0.935251798561151,70,60,70,87,78,85,450,0.6228070175438597,1.0
90,93,55,70,55,55,418,0.3819444444444444,75,125,70,125,70,115,580,0.9037037037037037,0.5
50,105,79,35,110,76,455,0.6214285714285714,45,60,30,80,50,65,330,0.4603174603174603,2.0
35,64,85,74,55,32,345,0.19827586206896552,50,20,55,25,25,30,205,0.09774436090225563,1.0
45,50,35,55,75,40,300,0.21367521367521367,50,50,50,50,50,50,300,0.30708661417322836,1.0
75,140,65,112,65,110,567,0.9140625,35,65,35,65,35,65,300,0.46621621621621623,1.0
46,87,60,30,40,57,320,0.37777777777777777,40,20,30,40,80,55,265,0.22764227642276422,1.0
91,72,90,129,90,108,580,0.8925619834710744,50,65,107,105,107,86,520,0.7272727272727273,0.5
100,100,100,100,100,100,600,0.8778625954198473,86,81,97,81,107,43,495,0.203125,1.0
130,85,80,85,95,60,535,0.43884892086330934,60,90,70,60,120,40,440,0.27419354838709675,1.0
69,69,76,69,86,91,460,0.6554621848739496,70,84,70,65,70,51,410,0.2949640287769784,4.0
80,115,80,65,55,93,488,0.7846153846153846,40,45,35,40,40,90,290,0.65,1.0
60,85,60,85,60,55,405,0.3673469387755102,90,93,55,70,55,55,418,0.3819444444444444,0.5
55,70,40,60,40,40,305,0.26956521739130435,80,185,115,40,105,75,600,0.6230769230769231,1.0
40,30,32,50,52,65,269,0.3671875,106,110,90,154,90,130,680,0.926829268292683,2.0
100,70,70,65,65,45,415,0.1897810218978102,60,59,85,79,105,36,424,0.16666666666666666,1.0
40,80,35,35,45,70,305,0.4661016949152542,68,75,53,83,113,60,452,0.45384615384615384,1.0
95,117,184,44,46,28,514,0.2975206611570248,60,40,60,95,60,55,370,0.4222222222222222,0.5
63,60,55,50,50,71,349,0.5289256198347108,50,80,95,10,45,10,290,0.232,0.25
59,66,70,44,55,41,335,0.25190839694656486,86,92,88,68,75,73,482,0.6835443037974683,1.0
95,117,80,65,70,92,519,0.8409090909090909,70,140,230,60,80,50,630,0.32432432432432434,2.0
85,110,90,45,90,80,500,0.6206896551724138,55,85,55,50,55,60,360,0.4233576642335766,1.0
86,68,72,109,66,106,507,0.8099173553719008,95,109,105,75,85,56,525,0.34513274336283184,2.0
70,70,70,70,70,70,420,0.5289256198347108,68,85,65,165,135,100,618,0.8083333333333333,1.0
55,68,64,45,55,31,318,0.11666666666666667,65,47,55,73,75,85,400,0.65,0.5
50,35,55,25,25,15,205,0.021739130434782608,65,80,140,40,70,70,465,0.5223880597014925,0.25
55,45,45,25,25,15,210,0.048,75,140,65,112,65,110,567,0.9140625,0.0
90,85,100,95,125,85,580,0.6834532374100719,105,150,90,150,90,95,680,0.8285714285714286,4.0
55,75,85,25,25,15,280,0.1875,55,40,40,65,45,35,280,0.16428571428571428,1.0
60,60,60,85,85,85,435,0.631578947368421,45,75,60,40,30,50,300,0.304,1.0
101,72,72,99,89,29,462,0.1937984496124031,49,66,70,44,55,51,335,0.4260869565217391,1.0
72,95,67,103,71,122,530,0.9606299212598425,38,30,85,55,65,30,303,0.21428571428571427,2.0
95,124,78,69,71,58,495,0.37398373983739835,67,58,57,81,67,101,431,0.8790322580645161,0.25
75,85,200,55,65,30,510,0.16778523489932887,50,50,77,95,77,91,440,0.5916666666666667,1.0
85,60,65,135,105,100,550,0.7518248175182481,39,52,43,60,50,65,309,0.5041322314049587,0.25
60,105,60,120,60,105,510,0.8849557522123894,105,95,75,85,75,74,509,0.5714285714285714,1.0
60,25,35,70,80,60,330,0.3076923076923077,60,50,150,50,150,60,520,0.5206611570247934,0.5
63,63,47,41,41,74,329,0.56,50,53,48,53,48,64,316,0.4076923076923077,2.0
65,80,140,40,70,70,465,0.5223880597014925,40,65,40,80,40,65,330,0.5038167938931297,1.0
45,85,70,40,40,60,340,0.5229357798165137,105,130,120,45,45,40,485,0.4444444444444444,2.0
65,50,70,95,80,65,425,0.4262295081967213,45,49,65,49,65,45,318,0.275,1.0
78,70,61,50,61,100,420,0.8145161290322581,44,48,65,50,64,43,314,0.1623931623931624,1.0
70,55,75,45,65,60,370,0.45901639344262296,120,70,120,75,130,85,600,0.6694915254237288,2.0
60,70,50,100,50,65,395,0.5217391304347826,75,103,80,70,80,92,500,0.7933884297520661,8.0
55,65,35,60,30,85,330,0.6126126126126126,65,95,100,60,50,50,420,0.34959349593495936,0.5
75,80,70,65,75,90,455,0.7578125,44,58,44,58,44,61,309,0.41964285714285715,1.0
60,60,60,60,60,60,360,0.38095238095238093,72,85,70,65,70,58,420,0.41304347826086957,1.0
90,50,34,60,44,70,348,0.6283185840707964,60,50,40,85,75,95,405,0.7540983606557377,0.5
70,135,105,60,105,20,495,0.5806451612903226,40,55,80,35,60,30,300,0.15037593984962405,0.5
40,65,40,80,40,65,330,0.5038167938931297,50,55,50,36,30,43,264,0.2922077922077922,1.0
78,52,60,63,65,23,341,0.06015037593984962,55,55,85,65,85,35,380,0.2014388489208633,1.0
49,66,70,44,55,51,335,0.4260869565217391,65,85,70,75,70,40,405,0.203125,1.0
72,58,80,103,80,97,490,0.7171052631578947,60,79,105,59,85,36,424,0.17054263565891473,4.0
80,115,80,65,55,93,488,0.7846153846153846,83,106,65,86,65,85,490,0.6640625,2.0
74,48,76,83,81,104,466,0.7913043478260869,45,67,60,35,50,63,320,0.5128205128205128,1.0
40,55,30,30,30,85,270,0.688,65,95,57,100,85,93,495,0.7441860465116279,1.0
115,45,20,45,25,20,270,0.11538461538461539,75,95,125,45,75,95,510,0.8257575757575758,1.0
76,65,45,92,42,91,411,0.7449664429530202,70,100,115,30,65,30,410,0.24390243902439024,0.25
61,90,45,50,50,160,456,0.9230769230769231,50,75,35,70,30,40,300,0.21296296296296297,2.0
60,90,55,90,80,110,485,0.8677685950413223,65,125,100,60,70,70,490,0.6099290780141844,1.0
58,64,58,80,65,80,405,0.5423728813559322,35,40,100,90,55,35,355,0.1796875,0.25
60,65,60,130,75,110,500,0.7719298245614035,40,40,50,30,30,30,220,0.0873015873015873,2.0
70,110,75,145,85,145,630,0.9444444444444444,38,35,40,27,25,35,200,0.08208955223880597,0.5
80,70,40,100,60,145,495,0.921875,60,69,95,69,95,36,424,0.2608695652173913,0.5
68,125,65,65,115,80,518,0.6277372262773723,80,80,80,55,55,90,440,0.6417910447761194,2.0
100,120,100,150,120,90,680,0.728,60,50,50,60,70,50,340,0.28346456692913385,1.0
60,105,60,120,60,105,510,0.8849557522123894,43,30,55,40,65,97,330,0.6030534351145038,1.0
60,85,69,60,69,77,420,0.518796992481203,60,50,70,50,90,65,385,0.39568345323741005,1.0
52,65,55,58,62,60,352,0.4482758620689655,65,80,140,40,70,70,465,0.5223880597014925,0.25
76,147,90,60,70,97,540,0.8267716535433071,50,55,50,36,30,43,264,0.2922077922077922,1.0
55,63,90,50,80,42,380,0.21138211382113822,90,90,85,125,90,100,580,0.768595041322314,0.25
125,120,90,170,100,95,700,0.78125,59,110,150,45,49,35,448,0.3333333333333333,0.25
55,75,85,25,25,15,280,0.1875,90,120,100,150,120,100,680,0.7718120805369127,1.0
65,90,40,45,80,75,395,0.625,65,65,60,110,95,130,525,0.9253731343283582,1.0
80,160,80,130,80,100,630,0.8455284552845529,70,50,30,95,135,105,485,0.8040540540540541,4.0
45,45,35,20,30,20,195,0.07246376811594203,40,30,35,50,70,55,280,0.28205128205128205,1.0
75,125,230,55,95,30,610,0.3448275862068966,52,65,50,45,50,38,300,0.27419354838709675,1.0
65,47,55,73,75,85,400,0.65,91,129,90,72,90,108,580,0.8536585365853658,0.5
110,65,105,55,95,80,510,0.6258503401360545,38,35,40,27,25,35,200,0.08208955223880597,2.0
90,110,80,100,80,95,555,0.7982456140350878,114,85,70,85,80,30,464,0.2066115702479339,2.0
35,55,40,50,50,90,320,0.6838235294117647,70,140,70,110,65,105,560,0.95,2.0
50,65,107,105,107,86,520,0.6991150442477876,95,85,85,65,65,35,430,0.2571428571428571,0.0
50,105,79,35,110,76,455,0.6214285714285714,190,33,58,33,58,33,405,0.13432835820895522,0.5
84,71,43,71,43,48,360,0.25874125874125875,80,100,80,80,80,100,520,0.9051724137931034,1.0
40,65,40,80,40,65,330,0.5038167938931297,104,91,63,91,73,68,490,0.5118110236220472,1.0
65,125,100,55,70,85,500,0.6532258064516129,79,103,120,135,115,78,630,0.5763888888888888,1.0
10,55,25,35,45,95,265,0.5396825396825397,165,75,80,40,45,65,470,0.5151515151515151,1.0
65,90,122,58,75,84,494,0.71875,40,40,40,70,40,20,250,0.032520325203252036,0.5
45,60,32,50,32,76,295,0.5925925925925926,60,50,70,50,90,65,385,0.39568345323741005,1.0
38,35,35,65,55,50,278,0.2647058823529412,77,85,51,55,51,65,384,0.5163934426229508,1.0
80,120,79,95,79,70,523,0.5833333333333334,80,100,80,80,80,100,520,0.9051724137931034,0.0
68,165,95,65,115,110,618,0.8615384615384616,60,62,80,63,80,60,405,0.4336283185840708,1.0
38,41,40,50,65,65,299,0.4108527131782946,100,100,100,100,100,100,600,0.8602941176470589,2.0
70,70,115,130,90,60,535,0.5338983050847458,50,72,35,35,35,65,292,0.5373134328358209,0.0
50,50,40,30,30,50,250,0.2781954887218045,110,160,110,80,110,100,670,0.8591549295774648,1.0
45,85,50,55,50,65,350,0.5076923076923077,100,103,75,120,75,127,600,0.940677966101695,0.5
45,55,39,35,39,42,255,0.18518518518518517,70,105,105,50,40,20,390,0.33587786259541985,0.5
80,90,80,130,110,110,600,0.856,95,80,105,40,70,100,490,0.8046875,1.0
65,95,100,60,50,50,420,0.34959349593495936,111,83,68,92,82,39,475,0.1774193548387097,1.0
55,70,45,70,50,60,350,0.45,78,130,111,130,85,100,634,0.8561151079136691,0.25
50,25,28,45,55,15,218,0.0625,90,85,100,95,125,85,580,0.6834532374100719,1.0
55,112,45,74,45,70,401,0.559322033898305,86,68,72,109,66,106,507,0.8099173553719008,2.0
52,65,55,58,62,60,352,0.4482758620689655,70,62,67,55,55,56,365,0.38513513513513514,1.0
70,140,70,110,65,105,560,0.95,123,77,72,99,92,58,521,0.4621212121212121,2.0
39,52,43,60,50,65,309,0.5041322314049587,255,10,10,75,135,55,540,0.3125,1.0
30,45,135,45,90,30,375,0.09285714285714286,75,80,55,25,35,35,305,0.18666666666666668,0.5
50,53,48,53,48,64,316,0.4076923076923077,85,56,77,50,77,78,423,0.53125,2.0
75,80,70,65,75,90,455,0.7578125,45,60,45,25,45,55,275,0.29,1.0
75,75,55,105,85,30,425,0.1619718309859155,90,132,105,132,105,30,594,0.4246575342465753,0.5
80,70,65,80,120,100,515,0.8034188034188035,90,60,60,40,40,40,330,0.29545454545454547,1.0
45,85,70,40,40,60,340,0.5229357798165137,48,72,48,72,48,48,336,0.25984251968503935,2.0
80,115,80,65,55,93,488,0.7846153846153846,95,23,48,23,48,23,260,0.046153846153846156,1.0
80,85,95,30,30,25,345,0.2857142857142857,70,90,45,15,45,50,315,0.3629032258064516,4.0
45,95,50,40,50,75,355,0.54,55,45,45,25,25,15,210,0.048,0.5
78,70,61,50,61,100,420,0.8145161290322581,50,105,125,55,95,50,480,0.375886524822695,0.5
105,130,120,45,45,40,485,0.4444444444444444,65,83,57,95,85,105,490,0.8914728682170543,2.0
62,50,58,73,54,72,369,0.4435483870967742,38,35,35,65,55,50,278,0.2647058823529412,1.0
50,50,40,50,40,64,294,0.45588235294117646,110,65,105,55,95,80,510,0.6258503401360545,1.0
85,135,130,60,80,25,515,0.40540540540540543,110,65,75,125,85,30,490,0.15,1.0
45,50,45,115,55,95,405,0.6936936936936937,45,95,50,40,50,75,355,0.54,0.5
90,132,105,132,105,30,594,0.4246575342465753,81,102,77,85,75,85,505,0.5642857142857143,2.0
90,55,75,60,75,30,385,0.13970588235294118,70,70,115,130,90,60,535,0.5338983050847458,0.5
54,63,52,83,56,97,405,0.7697841726618705,20,40,90,30,90,25,295,0.11363636363636363,1.0
75,95,95,95,95,85,540,0.6470588235294118,95,135,80,110,80,100,600,0.8248175182481752,1.0
20,10,230,10,230,5,505,0.0,50,65,45,85,65,95,405,0.7238095238095238,2.0
165,75,80,40,45,65,470,0.5151515151515151,67,89,116,79,116,33,500,0.2624113475177305,1.0
125,58,58,76,76,67,460,0.515625,73,76,75,81,100,100,505,0.8110236220472441,2.0
71,82,64,64,59,112,452,0.9327731092436975,72,60,30,20,30,25,237,0.11570247933884298,1.0
62,55,52,109,94,109,481,0.7833333333333333,80,100,123,122,120,80,625,0.56,0.5
45,55,39,35,39,42,255,0.18518518518518517,95,124,78,69,71,58,495,0.37398373983739835,1.0
75,80,70,65,75,90,455,0.7578125,73,115,60,60,60,90,458,0.6694915254237288,1.0
106,190,100,154,100,130,780,0.9259259259259259,55,55,45,63,45,45,308,0.25,1.0
60,62,50,62,60,40,334,0.18181818181818182,95,135,80,110,80,100,600,0.8248175182481752,1.0
90,60,70,75,70,45,410,0.23880597014925373,90,70,80,70,95,70,475,0.5190839694656488,0.125
75,85,200,55,65,30,510,0.16778523489932887,40,55,99,40,79,47,360,0.26262626262626265,1.0
80,120,130,55,65,45,495,0.37037037037037035,41,50,37,50,37,66,281,0.5175438596491229,1.0
70,140,230,60,80,50,630,0.32432432432432434,65,105,60,60,70,95,455,63.0,1.0
45,50,35,55,75,40,300,0.21367521367521367,80,160,60,170,130,80,680,0.6180555555555556,1.0
150,80,44,90,54,80,498,0.625,85,110,90,45,90,80,500,0.6206896551724138,0.0
100,50,80,60,80,50,420,0.34375,83,80,75,70,70,101,479,0.8615384615384616,1.0
50,25,28,45,55,15,218,0.0625,80,100,123,122,120,80,625,0.56,0.5
45,60,45,25,45,55,275,0.29,61,78,95,56,58,57,405,0.40336134453781514,1.0
80,80,80,80,80,80,480,0.6015037593984962,70,120,100,145,105,20,560,0.2824427480916031,1.0
45,85,70,40,40,60,340,0.5229357798165137,50,50,50,50,50,50,300,0.30708661417322836,2.0
105,125,100,60,100,100,590,0.8359375,70,80,70,80,70,110,480,0.6594202898550725,0.0
55,75,60,75,60,103,428,0.7982456140350878,110,65,75,125,85,30,490,0.15,1.0
65,90,65,61,61,100,442,0.8373983739837398,50,75,75,65,65,50,380,0.4049586776859504,0.0
50,85,125,85,115,20,480,0.4306569343065693,50,75,45,40,45,60,315,0.4380165289256198,1.0
80,45,65,90,110,80,470,0.5462962962962963,43,80,65,50,35,35,308,0.14193548387096774,1.0
50,70,100,40,40,30,330,0.2222222222222222,70,60,70,87,78,85,450,0.6228070175438597,1.0
65,130,60,95,110,65,525,0.5303030303030303,70,90,45,15,45,50,315,0.3629032258064516,0.5
65,95,75,55,55,85,430,0.6933333333333334,65,130,60,75,60,75,465,0.689922480620155,1.0
80,100,70,60,70,95,475,0.7416666666666667,85,73,70,73,115,67,483,0.5126050420168067,1.0
90,93,55,70,55,55,418,0.3819444444444444,64,66,68,81,76,50,405,0.25190839694656486,0.5
70,100,70,105,75,40,460,0.23214285714285715,80,100,70,60,70,95,475,0.7416666666666667,1.0
77,59,50,67,63,46,362,0.23140495867768596,58,64,58,80,65,80,405,0.5423728813559322,1.0
58,89,77,45,45,48,362,0.3177570093457944,60,75,85,100,85,115,520,0.8992248062015504,1.0
110,85,95,80,95,50,515,0.2713178294573643,40,80,100,30,30,20,300,0.11851851851851852,0.5
30,35,30,100,35,80,310,0.4765625,45,45,35,20,30,20,195,0.07246376811594203,1.0
75,75,55,105,85,30,425,0.1619718309859155,50,180,20,180,20,150,600,0.9029850746268657,1.0
70,92,65,80,55,98,460,0.8090909090909091,65,50,70,95,80,65,425,0.4262295081967213,1.0
1,90,45,30,30,40,236,0.33064516129032256,75,110,110,110,105,80,590,0.656934306569343,0.5
45,90,20,65,20,65,305,0.5116279069767442,50,50,62,40,62,65,329,0.4188034188034188,1.0
60,50,100,85,70,65,430,0.47580645161290325,50,47,50,57,50,65,319,0.463768115942029,1.0
125,170,100,120,90,95,700,0.77,75,100,95,40,70,110,490,0.8717948717948718,1.0
75,90,50,110,80,95,500,0.7985611510791367,70,75,60,105,60,105,475,0.88,1.0
105,95,80,40,80,90,490,0.753968253968254,50,35,55,25,25,15,205,0.021739130434782608,1.0
75,98,63,98,63,101,498,0.849624060150376,44,50,91,24,86,10,305,0.1981981981981982,0.5
55,66,44,44,56,85,350,0.6888888888888889,65,75,105,35,65,85,430,0.6940298507462687,1.0
69,69,76,69,86,91,460,0.6554621848739496,86,81,97,81,107,43,495,0.203125,1.0
50,20,40,20,40,20,190,0.0962962962962963,105,30,105,140,105,55,540,0.3524590163934426,0.5
75,95,67,125,95,83,540,0.7117117117117117,90,70,80,70,95,70,475,0.5190839694656488,1.0
120,100,85,30,85,45,465,0.22448979591836735,85,80,90,105,95,60,515,0.49074074074074076,2.0
50,160,110,160,110,110,700,0.8854961832061069,30,42,118,42,88,30,350,0.112,0.25
80,160,60,170,130,80,680,0.6180555555555556,90,93,55,70,55,55,418,0.3819444444444444,0.5
36,50,50,65,60,44,305,0.16363636363636364,45,53,70,40,60,42,310,0.25735294117647056,2.0
60,75,100,55,80,50,420,0.3088235294117647,75,75,75,125,95,40,485,0.15671641791044777,0.5
58,89,77,45,45,48,362,0.3177570093457944,60,30,30,36,56,50,262,0.32432432432432434,2.0
91,72,90,129,90,108,580,0.8925619834710744,65,125,100,60,70,70,490,0.6099290780141844,4.0
60,110,70,60,60,100,460,0.8461538461538461,70,45,48,60,65,35,323,0.15748031496062992,1.0
45,90,20,65,20,65,305,0.5116279069767442,55,63,90,50,80,42,380,0.21138211382113822,0.5
95,155,109,70,130,81,640,0.6788321167883211,40,55,30,30,30,85,270,0.688,1.0
85,90,80,70,80,130,535,0.9262295081967213,35,80,50,50,70,120,405,0.84375,0.5
30,65,100,45,25,40,305,0.1891891891891892,50,50,50,50,50,50,300,0.30708661417322836,1.0
44,38,39,61,79,42,303,0.2251655629139073,55,40,50,65,85,40,335,0.3181818181818182,1.0
82,80,86,85,75,72,480,0.6183206106870229,60,70,105,70,120,75,500,0.5983606557377049,1.0
45,30,15,85,65,65,305,0.36220472440944884,45,55,39,35,39,42,255,0.18518518518518517,1.0
55,40,50,65,85,40,335,0.3181818181818182,70,115,60,115,60,55,475,0.4647887323943662,0.25
82,121,119,69,59,71,521,0.5394736842105263,75,80,55,25,35,35,305,0.18666666666666668,0.5
63,60,55,50,50,71,349,0.5289256198347108,40,30,30,40,50,30,220,0.07936507936507936,2.0
60,130,80,60,60,70,460,0.5153846153846153,70,85,140,85,70,20,470,0.272,0.5
40,55,70,45,60,30,300,0.10619469026548672,100,110,90,85,90,60,535,0.47794117647058826,0.5
40,50,90,30,55,65,330,0.44680851063829785,65,55,115,100,40,60,435,0.3798449612403101,4.0
95,75,180,130,80,30,590,0.13793103448275862,75,70,90,70,105,80,490,0.656,0.5
106,130,90,110,154,90,680,0.719626168224299,40,45,40,35,35,56,251,0.373015873015873,1.0
75,80,60,65,90,102,472,0.8625954198473282,150,120,100,120,100,90,680,0.664179104477612,0.0
55,95,115,45,45,35,390,0.2116788321167883,80,80,50,40,50,25,325,0.176056338028169,2.0
55,40,40,65,45,35,280,0.16428571428571428,59,74,50,35,50,35,303,0.3125,0.0
60,52,168,47,138,30,495,0.19834710743801653,62,44,50,44,50,55,305,0.3629032258064516,1.0
100,100,100,100,100,100,600,0.8345864661654135,44,38,33,61,43,70,289,0.5267857142857143,1.0
85,135,130,60,80,25,515,0.40540540540540543,130,65,60,110,95,65,525,0.5227272727272727,1.0
106,150,70,194,120,140,780,0.952,64,66,68,81,76,50,405,0.25190839694656486,1.0
35,40,100,90,55,35,355,0.1796875,65,90,65,61,61,100,442,0.8373983739837398,2.0
75,75,95,75,95,113,528,0.9015151515151515,63,63,47,41,41,74,329,0.56,0.5
64,78,52,78,52,81,405,0.6422764227642277,70,50,30,95,135,105,485,0.8040540540540541,4.0
50,60,45,100,80,65,400,0.45689655172413796,50,105,79,35,110,76,455,0.6214285714285714,1.0
105,95,75,85,75,74,509,0.5714285714285714,67,125,40,30,30,58,350,0.3431372549019608,4.0
71,120,95,120,95,99,600,0.8203125,55,70,40,60,40,40,305,0.26956521739130435,2.0
70,95,85,55,65,70,440,0.5,40,30,35,50,70,55,280,0.28205128205128205,2.0
115,140,130,55,55,40,535,0.4519230769230769,74,94,131,54,116,20,489,0.4485294117647059,0.5
100,120,100,150,120,90,680,0.728,30,80,90,55,45,55,355,0.4295774647887324,0.25
50,70,100,40,40,30,330,0.2222222222222222,55,70,55,40,55,85,360,0.7073170731707317,1.0
70,80,65,90,65,85,455,0.578125,80,70,40,100,60,145,495,0.921875,1.0
50,105,79,35,110,76,455,0.6214285714285714,39,52,43,60,50,65,309,0.5041322314049587,1.0
55,65,35,60,30,85,330,0.6126126126126126,50,95,95,35,110,70,455,0.5179856115107914,1.0
50,55,50,36,30,43,264,0.2922077922077922,45,67,60,35,50,63,320,0.5128205128205128,1.0
45,90,20,65,20,65,305,0.5116279069767442,79,115,70,125,80,111,580,0.864,1.0
78,65,68,112,154,75,552,0.628099173553719,100,73,83,73,83,55,467,0.371900826446281,0.5
70,85,70,60,70,50,405,0.28378378378378377,40,55,99,40,79,47,360,0.26262626262626265,1.0
78,104,78,159,115,100,634,0.8444444444444444,65,83,57,95,85,105,490,0.8914728682170543,0.5
80,135,130,95,90,70,600,0.5181818181818182,35,60,44,40,54,55,288,0.366412213740458,2.0
75,80,55,25,35,35,305,0.18666666666666668,67,82,62,46,48,43,348,0.22033898305084745,1.0
55,50,45,135,95,120,500,0.7714285714285715,45,80,100,35,37,28,325,0.3125,0.5
95,110,95,40,95,55,490,0.40336134453781514,60,90,55,90,80,110,485,0.8677685950413223,1.0
35,55,40,45,40,60,275,0.35714285714285715,110,80,90,95,90,65,530,0.5033557046979866,2.0
75,95,60,65,60,115,470,0.8778625954198473,75,125,100,70,80,45,495,0.33035714285714285,0.5
95,80,105,40,70,100,490,0.8046875,50,50,50,50,50,50,300,0.30708661417322836,1.0
40,70,130,60,130,25,455,0.17355371900826447,100,100,100,100,100,100,600,0.8758169934640523,2.0
60,90,70,60,120,40,440,0.27419354838709675,40,65,95,60,45,35,340,0.13986013986013987,1.0
55,40,40,65,45,35,280,0.16428571428571428,65,90,65,61,61,100,442,0.8373983739837398,2.0
35,20,65,40,65,20,245,0.02459016393442623,130,85,80,85,95,60,535,0.43884892086330934,1.0
40,55,80,35,60,30,300,0.15037593984962405,54,78,103,53,45,22,355,0.23255813953488372,1.0
40,30,35,50,70,55,280,0.28205128205128205,55,35,50,55,110,85,390,0.6277372262773723,0.25
61,84,65,70,70,70,420,0.5,55,95,55,35,75,115,430,0.9380530973451328,1.0
70,120,100,145,105,20,560,0.2824427480916031,50,70,50,50,50,70,340,0.5645161290322581,0.5
55,95,55,35,75,115,430,0.9380530973451328,60,67,85,77,75,116,480,0.8888888888888888,1.0
50,52,48,65,50,55,320,0.33098591549295775,79,85,60,55,60,71,410,0.60431654676259,0.5
71,120,95,120,95,99,600,0.8203125,72,105,115,54,86,68,500,0.5149253731343284,1.0
30,56,35,25,35,72,253,0.48148148148148145,67,125,40,30,30,58,350,0.3431372549019608,0.5
100,100,100,100,100,100,600,0.8345864661654135,20,15,20,10,55,80,200,0.2682926829268293,2.0
30,40,70,70,25,60,295,0.41353383458646614,85,120,70,50,60,100,485,0.8308823529411765,1.0
72,58,80,103,80,97,490,0.7171052631578947,75,100,66,60,66,115,482,0.918918918918919,1.0
50,85,40,85,40,35,335,0.1746031746031746,60,65,70,85,75,40,395,0.21705426356589147,0.25
50,50,40,30,30,50,250,0.2781954887218045,45,60,40,70,50,45,310,0.2846715328467153,1.0
41,64,45,50,50,50,300,0.36752136752136755,62,48,54,63,60,68,355,0.5178571428571429,1.0
10,55,25,35,45,95,265,0.5396825396825397,79,105,70,145,80,101,580,0.8608695652173913,0.0
65,136,94,54,96,135,580,0.9612403100775194,45,75,60,40,30,50,300,0.304,1.0
50,105,79,35,110,76,455,0.6214285714285714,50,75,45,40,45,60,315,0.4380165289256198,0.5
110,123,65,100,65,65,528,0.5217391304347826,115,45,20,45,25,20,270,0.11538461538461539,1.0
60,62,50,62,60,40,334,0.18181818181818182,95,65,65,110,130,60,525,0.4016393442622951,1.0
60,130,80,60,60,70,460,0.5153846153846153,55,65,95,95,45,85,440,0.6610169491525424,2.0
65,85,70,75,70,40,405,0.203125,80,115,80,65,55,93,488,0.7846153846153846,2.0
84,86,88,111,101,60,530,0.4634146341463415,70,105,105,50,40,20,390,0.33587786259541985,4.0
72,58,80,103,80,97,490,0.7171052631578947,60,60,50,40,50,75,335,0.5882352941176471,2.0
60,65,60,130,75,110,500,0.7719298245614035,28,25,25,45,35,40,198,0.16083916083916083,4.0
91,90,129,90,72,108,580,0.9140625,85,105,85,40,50,40,405,0.211864406779661,1.0
70,80,102,80,102,40,474,0.2677165354330709,50,70,160,70,160,90,600,0.7417218543046358,2.0
66,117,70,40,50,67,410,0.4573643410852713,75,100,95,40,70,110,490,0.8717948717948718,1.0
75,140,65,112,65,110,567,0.9140625,90,95,95,70,90,70,510,0.5230769230769231,1.0
55,50,65,175,95,150,590,0.7818181818181819,60,150,50,150,50,60,520,0.5,0.5
90,90,85,125,90,100,580,0.768595041322314,70,120,65,45,85,125,510,0.9747899159663865,1.0
75,125,70,125,70,115,580,0.9037037037037037,45,20,50,60,120,50,345,0.24074074074074073,1.0
45,75,60,40,30,50,300,0.304,31,45,90,30,30,40,266,0.21929824561403508,1.0
65,65,60,110,95,130,525,0.9253731343283582,90,30,15,40,20,15,210,0.043478260869565216,1.0
70,120,40,95,40,95,460,0.8106060606060606,50,100,150,100,150,50,600,0.37142857142857144,1.0
60,80,50,50,50,40,330,0.23853211009174313,85,105,100,79,83,78,530,0.5869565217391305,1.0
35,55,40,45,40,60,275,0.35714285714285715,80,105,65,60,75,130,515,0.9645390070921985,2.0
68,65,65,125,115,80,518,0.6461538461538462,120,120,120,120,120,120,720,0.9344262295081968,1.0
50,65,107,105,107,86,520,0.6991150442477876,78,65,68,112,154,75,552,0.628099173553719,1.0
80,160,60,170,130,80,680,0.6180555555555556,55,20,35,20,45,75,250,0.37681159420289856,1.0
50,100,150,100,150,50,600,0.37142857142857144,86,81,97,81,107,43,495,0.203125,1.0
65,155,120,65,90,105,600,0.8677685950413223,55,45,43,55,43,72,313,0.5853658536585366,1.0
110,80,90,95,90,65,530,0.5033557046979866,55,35,50,55,110,85,390,0.6277372262773723,2.0
80,135,130,95,90,70,600,0.5181818181818182,95,75,110,100,80,30,490,0.15267175572519084,0.25
80,105,105,105,105,80,580,0.5939849624060151,65,125,100,60,70,70,490,0.6099290780141844,0.0
100,100,125,110,50,50,535,0.384,30,80,90,55,45,55,355,0.4295774647887324,4.0
45,90,20,65,20,65,305,0.5116279069767442,65,83,57,95,85,105,490,0.8914728682170543,1.0
250,5,5,35,105,50,450,0.15306122448979592,60,62,80,63,80,60,405,0.4336283185840708,1.0
71,73,88,120,89,59,500,0.43537414965986393,80,70,70,90,100,70,480,0.5609756097560976,0.25
45,60,45,25,45,55,275,0.29,75,75,55,105,85,30,425,0.1619718309859155,1.0
95,135,80,110,80,100,600,0.8248175182481752,50,75,45,40,45,60,315,0.4380165289256198,2.0
64,66,68,81,76,50,405,0.25190839694656486,160,110,65,65,110,30,540,0.35714285714285715,1.0
71,73,88,120,89,59,500,0.43537414965986393,77,59,50,67,63,46,362,0.23140495867768596,2.0
58,109,112,48,48,109,484,0.8805970149253731,105,180,100,180,100,115,780,0.9477611940298507,0.5
77,120,90,60,90,48,485,0.2785714285714286,105,30,105,140,105,55,540,0.3524590163934426,1.0
65,75,105,35,65,85,430,0.6940298507462687,84,71,43,71,43,48,360,0.25874125874125875,1.0
100,120,100,150,120,90,680,0.728,41,50,37,50,37,66,281,0.5175438596491229,1.0
79,100,80,110,90,121,580,0.968,50,180,20,180,20,150,600,0.9029850746268657,1.0
30,45,135,45,90,30,375,0.09285714285714286,85,50,95,120,115,80,545,0.5793650793650794,2.0
105,130,120,45,45,40,485,0.4444444444444444,55,47,52,40,40,41,275,0.16806722689075632,2.0
90,95,105,165,110,45,610,0.2890625,35,85,45,35,35,75,310,0.6492537313432836,2.0
65,90,50,85,45,55,390,0.371900826446281,95,110,95,40,95,55,490,0.40336134453781514,1.0
80,100,200,50,100,50,580,0.3472222222222222,80,80,80,55,55,90,440,0.6417910447761194,1.0
50,65,107,105,107,86,520,0.7272727272727273,80,82,78,95,80,85,500,0.6869565217391305,2.0
45,30,50,55,65,45,290,0.208,100,100,125,110,50,50,535,0.384,1.0
55,40,50,65,85,40,335,0.3181818181818182,50,95,180,85,45,70,525,0.5298507462686567,0.5
60,59,85,79,105,36,424,0.16666666666666666,65,73,55,47,75,85,400,0.6846846846846847,0.5
80,85,95,30,30,25,345,0.2857142857142857,65,65,65,50,50,90,385,0.72,1.0
80,70,40,100,60,145,495,0.921875,65,45,55,45,70,45,325,0.24369747899159663,1.0
81,102,77,85,75,85,505,0.5642857142857143,105,130,120,45,45,40,485,0.4444444444444444,0.5
86,92,88,68,75,73,482,0.6835443037974683,40,27,60,37,50,66,280,0.36220472440944884,0.5
75,85,200,55,65,30,510,0.16778523489932887,44,38,39,61,79,42,303,0.2251655629139073,0.5
52,65,50,45,50,38,300,0.27419354838709675,50,60,45,100,80,65,400,0.45689655172413796,1.0
45,50,45,115,55,95,405,0.6936936936936937,90,85,100,95,125,85,580,0.6834532374100719,1.0
70,43,53,43,53,40,302,0.19090909090909092,40,50,45,70,45,70,320,0.5517241379310345,1.0
73,76,75,81,100,100,505,0.8110236220472441,100,73,83,73,83,55,467,0.371900826446281,1.0
120,70,120,75,130,85,600,0.6694915254237288,62,44,50,44,50,55,305,0.3629032258064516,1.0
75,98,63,98,63,101,498,0.8091603053435115,50,45,45,35,35,50,260,0.23529411764705882,1.0
95,75,110,100,80,30,490,0.15267175572519084,40,40,55,40,70,55,300,0.40939597315436244,2.0
50,95,95,35,110,70,455,0.5179856115107914,55,20,35,20,45,75,250,0.37681159420289856,2.0
55,75,50,40,40,80,340,0.6302521008403361,80,52,50,90,50,89,411,0.6666666666666666,2.0
51,65,65,80,75,59,395,0.4365079365079365,91,72,90,129,90,108,580,0.8925619834710744,0.5
55,45,45,25,25,15,210,0.048,80,50,100,100,200,50,580,0.2357142857142857,1.0
95,65,110,60,130,65,525,0.5275590551181102,39,52,43,60,50,65,309,0.49107142857142855,1.0
65,80,65,35,65,60,370,0.38405797101449274,70,140,230,60,80,50,630,0.32432432432432434,0.5
60,55,50,40,55,45,305,0.22377622377622378,65,90,120,85,70,60,490,0.43410852713178294,0.25
59,110,150,45,49,35,448,0.3333333333333333,67,58,57,81,67,101,431,0.8790322580645161,0.25
100,100,90,150,140,90,670,0.71875,91,90,106,130,106,77,600,0.648854961832061,2.0
75,105,75,105,75,45,480,0.3274336283185841,74,48,76,83,81,104,466,0.7913043478260869,1.0
100,128,90,77,77,128,600,0.959349593495935,35,60,44,40,54,55,288,0.366412213740458,0.5
105,95,75,85,75,74,509,0.5714285714285714,50,20,55,25,25,30,205,0.09774436090225563,0.5
125,120,90,170,100,95,700,0.78125,60,80,110,50,80,45,425,0.2833333333333333,2.0
35,55,40,50,50,90,320,0.6838235294117647,65,90,40,45,80,75,395,0.625,1.0
50,80,95,10,45,10,290,0.232,60,65,80,170,95,130,600,0.8625954198473282,1.0
80,82,100,83,100,80,525,0.6821705426356589,75,55,70,55,95,110,460,0.8444444444444444,0.25
90,60,70,75,70,45,410,0.23880597014925373,60,67,85,77,75,116,480,0.8888888888888888,1.0
65,90,50,85,45,55,390,0.371900826446281,70,85,140,85,70,20,470,0.272,0.5
100,110,90,85,90,60,535,0.47794117647058826,40,50,90,30,55,65,330,0.44680851063829785,1.0
123,100,62,97,81,68,531,0.4806201550387597,49,55,42,42,37,85,310,0.6068376068376068,1.0
100,120,100,150,120,90,680,0.728,65,63,45,45,45,45,308,0.2595419847328244,0.5
45,55,45,65,45,75,330,0.5692307692307692,58,50,145,95,105,30,483,0.2459016393442623,1.0
90,90,85,125,90,100,580,0.768595041322314,86,92,88,68,75,73,482,0.6835443037974683,1.0
95,65,110,60,130,65,525,0.5275590551181102,45,55,45,65,45,75,330,0.5692307692307692,1.0
74,48,76,83,81,104,466,0.7322834645669292,65,100,70,80,80,105,500,0.8666666666666667,1.0
30,45,135,45,90,30,375,0.09285714285714286,90,120,75,60,60,45,450,0.29411764705882354,1.0
70,85,65,105,85,120,530,0.9262295081967213,90,75,75,90,100,70,500,0.5462184873949579,2.0
65,90,120,85,70,60,490,0.43410852713178294,70,45,48,60,65,35,323,0.15748031496062992,2.0
50,75,75,65,65,50,380,0.4049586776859504,43,30,55,40,65,97,330,0.6030534351145038,1.0
35,80,50,50,70,120,405,0.84375,45,50,43,40,38,62,278,0.40441176470588236,0.0
90,50,34,60,44,70,348,0.6283185840707964,54,78,103,53,45,22,355,0.23255813953488372,0.5
40,50,45,70,45,70,320,0.5517241379310345,50,75,70,35,70,48,348,0.29357798165137616,0.0
250,5,5,35,105,50,450,0.15306122448979592,55,70,40,60,40,40,305,0.26956521739130435,1.0
105,30,105,140,105,55,540,0.3524590163934426,90,130,80,65,85,55,505,0.4396551724137931,1.0
41,56,40,62,44,71,314,0.568,50,85,40,85,40,35,335,0.1746031746031746,0.5
70,120,40,95,40,95,460,0.8106060606060606,70,85,70,60,70,50,405,0.28378378378378377,1.0
50,75,35,70,30,40,300,0.21296296296296297,40,40,55,40,70,55,300,0.40939597315436244,1.0
75,100,95,40,70,110,490,0.8717948717948718,45,60,45,25,45,55,275,0.29,1.0
106,110,90,154,90,130,680,0.926829268292683,90,70,80,70,95,70,475,0.5190839694656488,1.0
64,88,50,88,50,106,446,0.9111111111111111,41,64,45,50,50,50,300,0.36752136752136755,1.0
80,145,150,105,110,110,700,0.8692307692307693,65,130,60,75,60,75,465,0.689922480620155,0.0
55,85,55,50,55,60,360,0.4233576642335766,50,53,48,53,48,64,316,0.4076923076923077,4.0
105,30,105,140,105,55,540,0.3524590163934426,65,83,57,95,85,105,490,0.8914728682170543,1.0
54,63,52,83,56,97,405,0.7697841726618705,110,135,60,50,65,88,508,0.7744360902255639,2.0
1,90,45,30,30,40,236,0.33064516129032256,70,45,48,60,65,35,323,0.15748031496062992,0.5
50,85,85,55,55,50,380,0.3902439024390244,40,45,65,100,120,90,460,0.5588235294117647,0.5
20,40,15,35,35,60,205,0.34285714285714286,108,112,118,68,72,47,525,0.2916666666666667,0.0
40,55,80,35,60,30,300,0.15037593984962405,95,117,80,65,70,92,519,0.8409090909090909,0.0
79,85,60,55,60,71,410,0.60431654676259,60,60,60,105,105,105,495,0.848,0.0
90,90,85,125,90,100,580,0.768595041322314,85,110,76,65,82,56,474,0.3933333333333333,1.0
95,110,95,40,95,55,490,0.40336134453781514,55,104,105,94,75,52,485,0.36363636363636365,1.0
62,55,52,109,94,109,481,0.7833333333333333,59,45,40,35,40,31,250,0.14285714285714285,1.0
70,140,230,60,80,50,630,0.32432432432432434,40,30,30,40,50,30,220,0.07936507936507936,0.5
100,100,100,100,100,100,600,0.831858407079646,30,45,55,70,55,85,340,0.5633802816901409,1.0
60,85,42,85,42,91,405,0.8227848101265823,55,66,44,44,56,85,350,0.6888888888888889,1.0
70,120,100,145,105,20,560,0.2824427480916031,105,30,105,140,105,55,540,0.3524590163934426,1.0
70,50,30,95,135,105,485,0.8040540540540541,75,125,70,125,70,115,580,0.9037037037037037,1.0
60,69,95,69,95,36,424,0.2608695652173913,41,56,40,62,44,71,314,0.568,0.5
55,55,55,85,55,30,335,0.1320754716981132,50,60,45,100,80,65,400,0.45689655172413796,2.0
65,65,60,130,95,110,525,0.823943661971831,75,55,70,55,95,110,460,0.8444444444444444,1.0
59,59,58,90,70,73,409,0.5826086956521739,55,55,55,85,55,30,335,0.1320754716981132,1.0
50,53,48,53,48,64,316,0.4076923076923077,35,46,34,35,45,20,215,0.072,1.0
50,65,107,105,107,86,520,0.7758620689655172,60,85,69,60,69,77,420,0.518796992481203,1.0
97,165,60,65,50,58,495,0.3902439024390244,65,90,115,45,115,58,488,0.5041322314049587,0.5
68,72,78,38,42,32,330,0.23809523809523808,88,107,122,74,75,64,530,0.4596774193548387,0.5
44,48,65,50,64,43,314,0.1623931623931624,55,50,40,40,40,75,300,0.5945945945945946,1.0
70,110,75,145,85,145,630,0.9444444444444444,60,69,95,69,95,36,424,0.2608695652173913,0.125
56,61,65,48,45,38,313,0.17567567567567569,95,110,80,70,80,50,485,0.37209302325581395,1.0
60,45,50,90,80,70,395,0.625,70,110,180,60,60,50,530,0.4117647058823529,0.125
40,30,30,40,50,30,220,0.07936507936507936,84,71,43,71,43,48,360,0.25874125874125875,1.0
125,58,58,76,76,67,460,0.515625,50,55,50,36,30,43,264,0.2922077922077922,2.0
90,120,120,60,60,50,500,0.35294117647058826,50,85,125,85,115,20,480,0.4306569343065693,1.0
1,90,45,30,30,40,236,0.33064516129032256,60,50,70,80,80,140,480,0.8449612403100775,1.0
55,55,50,45,65,55,325,0.37373737373737376,105,180,100,180,100,115,780,0.9477611940298507,1.0
41,50,37,50,37,66,281,0.5175438596491229,40,45,35,65,55,70,310,0.4482758620689655,1.0
106,130,90,110,154,90,680,0.719626168224299,70,90,45,15,45,50,315,0.3629032258064516,0.5
70,80,102,80,102,40,474,0.2677165354330709,105,140,55,30,55,95,480,0.8195488721804511,0.5
95,60,79,100,125,81,540,0.6201550387596899,75,80,70,65,75,90,455,0.7578125,1.0
108,170,115,120,95,92,700,0.7083333333333334,91,134,95,100,100,80,600,0.6304347826086957,0.0
70,80,65,90,65,85,455,0.578125,65,90,65,61,61,100,442,0.8373983739837398,1.0
95,65,110,60,130,65,525,0.5275590551181102,71,73,88,120,89,59,500,0.43537414965986393,1.0
62,55,52,109,94,109,481,0.7833333333333333,40,80,35,35,45,70,305,0.4661016949152542,1.0
30,35,30,100,35,80,310,0.4765625,75,125,230,55,95,30,610,0.3448275862068966,0.0
50,55,50,36,30,43,264,0.2922077922077922,70,110,75,145,85,145,630,0.9444444444444444,2.0
60,85,49,60,49,60,363,0.4444444444444444,49,55,42,42,37,85,310,0.6068376068376068,1.0
25,20,15,105,55,90,310,0.32407407407407407,85,80,70,135,75,90,535,0.7006802721088435,1.0
60,110,70,60,60,100,460,0.8461538461538461,109,66,84,81,99,32,471,0.2013888888888889,0.5
40,70,130,60,130,25,455,0.17355371900826447,45,30,40,105,50,20,290,0.031007751937984496,2.0
40,70,130,60,130,25,455,0.17355371900826447,35,64,85,74,55,32,345,0.19827586206896552,1.0
62,50,58,73,54,72,369,0.4435483870967742,80,135,85,70,95,150,615,0.9844961240310077,0.25
90,130,80,65,85,55,505,0.4396551724137931,50,70,160,70,160,90,600,0.7417218543046358,0.5
39,52,43,60,50,65,309,0.5041322314049587,50,50,150,50,150,50,500,0.2571428571428571,0.5
40,30,50,55,55,100,330,0.584070796460177,35,70,55,45,55,25,285,0.09420289855072464,0.5
80,120,70,110,70,80,530,0.6422764227642277,60,60,40,65,45,35,305,0.15833333333333333,0.5
85,76,64,45,55,90,415,0.6739130434782609,55,45,45,25,25,15,210,0.048,1.0
90,130,80,65,85,55,505,0.4396551724137931,110,123,65,100,65,65,528,0.5217391304347826,1.0
70,70,70,70,70,70,420,0.5289256198347108,68,72,78,38,42,32,330,0.23809523809523808,1.0
69,55,45,55,55,15,294,0.11666666666666667,80,160,80,130,80,100,630,0.8455284552845529,0.5
83,80,80,135,80,121,579,0.9444444444444444,50,180,20,180,20,150,600,0.9029850746268657,1.0
55,63,90,50,80,42,380,0.21138211382113822,91,90,106,130,106,77,600,0.648854961832061,0.0625
80,100,70,60,70,95,475,0.7416666666666667,60,70,50,100,50,65,395,0.5217391304347826,0.25
130,85,80,85,95,60,535,0.43884892086330934,85,56,77,50,77,78,423,0.53125,4.0
76,65,45,92,42,91,411,0.7449664429530202,90,60,70,75,70,45,410,0.23880597014925373,1.0
79,85,60,55,60,71,410,0.60431654676259,100,100,100,100,100,100,600,0.831858407079646,1.0
69,55,45,55,55,15,294,0.11666666666666667,50,180,20,180,20,150,600,0.9029850746268657,1.0
60,105,60,120,60,105,510,0.8849557522123894,95,110,80,70,80,50,485,0.37209302325581395,1.0
65,90,40,45,80,75,395,0.625,40,30,30,55,30,85,270,0.4666666666666667,0.5
75,95,67,125,95,83,540,0.7117117117117117,59,63,80,65,80,58,405,0.41843971631205673,0.5
250,5,5,35,105,50,450,0.15306122448979592,115,115,85,90,75,100,580,0.8134328358208955,1.0
103,60,86,60,86,50,445,0.3458646616541353,65,155,120,65,90,105,600,0.8677685950413223,1.0
60,85,60,50,50,125,430,0.9090909090909091,108,112,118,68,72,47,525,0.2916666666666667,1.0
75,100,110,45,55,65,450,0.5333333333333333,60,85,42,85,42,91,405,0.8227848101265823,0.0
106,130,90,110,154,90,680,0.719626168224299,70,62,67,55,55,56,365,0.38513513513513514,1.0
70,110,80,55,80,105,500,0.8794326241134752,111,83,68,92,82,39,475,0.1774193548387097,1.0
50,95,95,35,110,70,455,0.5179856115107914,60,62,80,63,80,60,405,0.4336283185840708,1.0
85,120,70,50,60,100,485,0.8308823529411765,70,135,105,60,105,20,495,0.5806451612903226,0.5
50,47,50,57,50,65,319,0.463768115942029,100,50,80,60,80,50,420,0.34375,1.0
75,80,55,25,35,35,305,0.18666666666666668,75,90,140,60,60,40,465,0.3008130081300813,1.0
100,77,77,128,128,90,600,0.6901408450704225,60,48,45,43,90,42,328,0.21897810218978103,0.5
25,35,70,95,55,45,325,0.16783216783216784,50,100,150,100,150,50,600,0.37142857142857144,1.0
70,80,102,80,102,40,474,0.2677165354330709,50,65,107,105,107,86,520,0.6991150442477876,0.25
95,155,109,70,130,81,640,0.6788321167883211,60,60,60,35,35,30,280,0.11194029850746269,1.0
60,40,50,75,85,95,405,0.6044776119402985,75,70,90,70,105,80,490,0.656,1.0
50,95,180,85,45,70,525,0.5298507462686567,55,66,44,44,56,85,350,0.6888888888888889,1.0
60,85,69,60,69,77,420,0.518796992481203,55,45,43,55,43,72,313,0.5853658536585366,1.0
75,98,63,98,63,101,498,0.8091603053435115,60,110,70,60,60,100,460,0.8461538461538461,0.5
35,45,160,30,45,70,385,0.48148148148148145,108,112,118,68,72,47,525,0.2916666666666667,0.5
60,110,70,60,60,100,460,0.8461538461538461,35,55,35,30,30,35,220,0.23684210526315788,1.0
50,95,180,85,45,70,525,0.5298507462686567,55,112,45,74,45,70,401,0.559322033898305,4.0
103,93,67,71,61,84,479,0.7142857142857143,100,150,90,180,160,90,770,0.7348484848484849,1.0
90,120,100,150,120,100,680,0.7718120805369127,75,90,50,110,80,95,500,0.7985611510791367,2.0
80,70,40,100,60,145,495,0.921875,35,35,35,35,35,35,210,0.13385826771653545,0.5
60,70,105,70,120,75,500,0.5983606557377049,80,85,95,30,30,25,345,0.2857142857142857,4.0
103,93,67,71,61,84,479,0.7142857142857143,39,52,43,60,50,65,309,0.5041322314049587,1.0
45,25,50,25,25,35,205,0.13076923076923078,65,63,45,45,45,45,308,0.2595419847328244,0.5
89,145,90,105,80,91,600,0.8549618320610687,50,65,107,105,107,86,520,0.6991150442477876,2.0
45,50,35,55,75,40,300,0.21367521367521367,55,65,95,95,45,85,440,0.6610169491525424,1.0
70,92,65,80,55,98,460,0.8090909090909091,30,105,90,25,25,50,325,0.2773722627737226,0.5
82,121,119,69,59,71,521,0.5394736842105263,70,95,85,55,65,70,440,0.5,1.0
90,120,120,60,60,50,500,0.35294117647058826,66,65,48,62,57,52,350,0.36220472440944884,0.5
50,50,150,50,150,50,500,0.2571428571428571,80,110,60,150,130,70,600,0.5042016806722689,1.0
55,45,50,45,65,80,340,0.5546218487394958,49,55,42,42,37,85,310,0.6068376068376068,1.0
40,50,45,70,45,70,320,0.5517241379310345,45,35,45,62,53,35,275,0.11851851851851852,2.0
70,75,60,105,60,105,475,0.88,41,56,40,62,44,71,314,0.568,2.0
65,73,55,47,75,85,400,0.6846846846846847,63,60,55,50,50,71,349,0.5289256198347108,0.5
65,125,60,95,60,105,510,0.9236641221374046,60,60,40,65,45,35,305,0.15833333333333333,1.0
110,80,90,95,90,65,530,0.5033557046979866,70,94,50,94,50,66,424,0.48148148148148145,2.0
60,110,70,60,60,100,460,0.8461538461538461,95,65,65,110,130,60,525,0.4016393442622951,1.0
70,77,60,97,60,108,472,0.8394160583941606,110,65,105,55,95,80,510,0.6258503401360545,2.0
40,45,35,40,40,90,290,0.65,40,27,60,37,50,66,280,0.36220472440944884,1.0
60,60,60,85,85,85,435,0.631578947368421,90,85,75,115,100,115,580,0.9381443298969072,1.0
75,80,55,25,35,35,305,0.18666666666666668,65,65,65,50,50,90,385,0.72,1.0
70,95,125,65,75,45,475,0.33613445378151263,70,95,85,55,65,70,440,0.5,2.0
50,40,85,40,65,25,305,0.08870967741935484,45,100,135,65,135,45,525,0.29411764705882354,0.5
71,95,85,110,95,79,535,0.664,74,108,133,83,65,32,495,0.32142857142857145,0.5
65,125,100,60,70,70,490,0.6099290780141844,75,123,67,95,85,95,540,0.7642276422764228,0.5
30,56,35,25,35,72,253,0.48148148148148145,40,40,35,50,100,70,335,0.5031847133757962,1.0
60,85,49,60,49,60,363,0.4444444444444444,65,90,120,85,70,60,490,0.43410852713178294,1.0
70,75,80,135,80,135,575,0.917910447761194,80,100,80,80,80,100,520,0.9051724137931034,0.0
85,56,77,50,77,78,423,0.53125,38,41,40,50,65,65,299,0.4108527131782946,2.0
75,125,75,30,75,85,465,0.625,68,165,95,65,115,110,618,0.8615384615384616,0.5
100,103,75,120,75,127,600,0.940677966101695,70,84,70,65,70,51,410,0.2949640287769784,2.0
35,70,55,45,55,25,285,0.09420289855072464,55,47,52,40,40,41,275,0.16806722689075632,0.25
64,165,75,93,83,75,555,0.6587301587301587,60,55,145,75,150,40,525,0.2,1.0
55,63,90,50,80,42,380,0.21138211382113822,50,55,50,36,30,43,264,0.2922077922077922,0.25
95,135,80,110,80,100,600,0.8248175182481752,50,55,50,36,30,43,264,0.2922077922077922,1.0
70,140,70,110,65,105,560,0.95,44,38,33,61,43,70,289,0.5267857142857143,1.0
80,85,95,30,30,25,345,0.2857142857142857,45,50,35,55,75,40,300,0.21367521367521367,1.0
60,95,80,60,80,30,405,0.19480519480519481,50,70,50,50,50,40,310,0.16296296296296298,2.0
71,95,85,110,95,79,535,0.664,50,65,85,35,35,55,325,0.32575757575757575,1.0
72,58,80,103,80,97,490,0.7171052631578947,125,58,58,76,76,67,460,0.515625,0.5
75,140,65,112,65,110,567,0.9140625,60,150,50,150,50,60,520,0.5,0.25
75,80,60,65,90,102,472,0.8625954198473282,75,55,70,55,95,110,460,0.8444444444444444,1.0
55,40,40,65,45,35,280,0.16428571428571428,50,55,50,36,30,43,264,0.2922077922077922,2.0
70,94,50,94,50,66,424,0.48148148148148145,75,55,70,55,95,110,460,0.8444444444444444,2.0
45,50,55,75,65,30,320,0.06293706293706294,55,45,50,45,65,80,340,0.5546218487394958,0.5
95,95,85,125,65,55,520,0.3894736842105263,75,38,38,56,56,67,330,0.5263157894736842,2.0
75,140,65,112,65,110,567,0.9140625,85,105,55,85,50,115,495,0.9032258064516129,1.0
70,110,80,55,80,105,500,0.8794326241134752,90,110,80,100,80,95,555,0.7982456140350878,0.5
100,134,110,95,100,61,600,0.4057971014492754,86,68,72,109,66,106,507,0.8099173553719008,2.0
90,92,87,75,85,76,505,0.5409836065573771,99,68,83,72,87,51,460,0.417910447761194,0.0
60,40,60,95,60,55,370,0.4222222222222222,43,80,65,50,35,35,308,0.14193548387096774,0.5
70,120,65,45,85,125,510,0.9747899159663865,55,50,40,40,40,75,300,0.5945945945945946,1.0
50,180,20,180,20,150,600,0.9029850746268657,70,120,65,45,85,125,510,0.9747899159663865,0.0
38,36,38,32,36,57,237,0.3893805309734513,40,30,32,50,52,65,269,0.3671875,1.0
35,45,160,30,45,70,385,0.48148148148148145,67,89,116,79,116,33,500,0.2624113475177305,1.0
75,100,110,45,55,65,450,0.5333333333333333,79,85,60,55,60,71,410,0.60431654676259,1.0
165,75,80,40,45,65,470,0.5151515151515151,90,30,15,40,20,15,210,0.043478260869565216,1.0
100,120,120,150,100,90,680,0.7880794701986755,85,60,65,135,105,100,550,0.7518248175182481,0.5
70,70,40,60,40,60,340,0.4247787610619469,95,135,80,110,80,100,600,0.8248175182481752,0.25
90,92,75,92,85,60,494,0.49586776859504134,101,72,72,99,89,29,462,0.1937984496124031,1.0
50,30,55,65,55,20,275,0.13675213675213677,43,30,55,40,65,97,330,0.6030534351145038,0.5
70,145,88,140,70,112,625,0.8888888888888888,60,40,60,95,60,55,370,0.4222222222222222,0.0
90,85,100,95,125,85,580,0.6834532374100719,70,140,70,110,65,105,560,0.95,0.5
64,115,65,83,63,65,455,0.5323741007194245,55,130,115,50,50,75,475,0.5982142857142857,1.0
100,100,100,100,100,100,600,0.8778625954198473,38,35,35,65,55,50,278,0.2647058823529412,0.5
45,95,50,40,50,75,355,0.54,90,100,60,90,60,80,480,0.6422764227642277,4.0
60,50,70,50,90,65,385,0.39568345323741005,50,53,48,53,48,64,316,0.358974358974359,1.0
45,85,70,40,40,60,340,0.5229357798165137,92,105,90,125,90,98,600,0.8217054263565892,0.5
75,38,38,56,56,67,330,0.5263157894736842,95,85,85,65,65,35,430,0.2571428571428571,0.0
150,120,100,120,100,90,680,0.664179104477612,50,50,40,50,40,64,294,0.45588235294117646,1.0
75,110,110,110,105,80,590,0.656934306569343,100,100,100,100,100,100,600,0.8805970149253731,1.0
130,85,80,85,95,60,535,0.43884892086330934,55,68,64,45,55,31,318,0.11666666666666667,1.0
70,135,105,60,105,20,495,0.5806451612903226,60,85,60,50,50,125,430,0.9090909090909091,0.5
20,25,45,70,90,60,310,0.30833333333333335,38,30,85,55,65,30,303,0.21428571428571427,1.0
65,105,60,60,70,95,455,63.0,54,45,47,75,98,52,371,0.39669421487603307,0.5
65,55,115,100,40,60,435,0.3798449612403101,55,40,85,80,105,40,405,0.23622047244094488,0.5
65,60,110,130,95,65,525,0.47761194029850745,50,50,150,50,150,50,500,0.2571428571428571,1.0
123,77,72,99,92,58,521,0.4621212121212121,50,50,50,50,50,50,300,0.30708661417322836,1.0
103,93,67,71,61,84,479,0.7142857142857143,60,55,90,145,90,80,520,0.6071428571428571,1.0
60,100,85,80,85,100,510,0.7007874015748031,55,85,122,58,75,99,494,0.8099173553719008,0.0
65,90,40,45,80,75,395,0.625,75,80,70,65,75,90,455,0.7578125,0.125
25,20,15,105,55,90,310,0.32407407407407407,50,50,95,40,50,35,320,0.20279720279720279,2.0
60,45,70,75,85,55,390,0.3008130081300813,57,80,91,80,87,75,470,0.5737704918032787,0.5
68,72,78,38,42,32,330,0.23809523809523808,50,53,62,58,63,44,330,0.13709677419354838,1.0
97,165,60,65,50,58,495,0.3902439024390244,95,65,110,60,130,65,525,0.5275590551181102,1.0
70,60,62,80,82,60,414,0.4375,79,85,60,55,60,71,410,0.60431654676259,1.0
65,40,50,125,60,30,370,0.07258064516129033,79,103,120,135,115,78,630,0.5763888888888888,1.0
120,100,85,30,85,45,465,0.22448979591836735,49,55,42,42,37,85,310,0.6068376068376068,2.0
150,80,44,90,54,80,498,0.625,80,110,60,150,130,70,600,0.5042016806722689,4.0
75,85,200,55,65,30,510,0.16778523489932887,85,105,55,85,50,115,495,0.9032258064516129,0.5
80,80,80,55,55,90,440,0.6417910447761194,40,60,30,31,31,70,262,0.4492753623188406,1.0
50,50,95,40,50,35,320,0.20279720279720279,95,75,80,100,110,30,490,0.24242424242424243,1.0
60,85,42,85,42,91,405,0.8227848101265823,40,40,35,50,100,70,335,0.5031847133757962,1.0
80,50,100,100,200,50,580,0.2357142857142857,25,35,70,95,55,45,325,0.16783216783216784,0.5
75,80,70,65,75,90,455,0.7578125,63,63,47,41,41,74,329,0.56,0.5
60,40,60,40,60,35,295,0.18055555555555555,80,145,150,105,110,110,700,0.8692307692307693,0.5
58,50,145,95,105,30,483,0.2459016393442623,50,20,55,25,25,30,205,0.09774436090225563,1.0
40,45,35,65,55,70,310,0.4482758620689655,38,30,85,55,65,30,303,0.21428571428571427,1.0
100,150,90,180,160,90,770,0.7348484848484849,105,140,55,30,55,95,480,0.8195488721804511,2.0
30,56,35,25,35,72,253,0.48148148148148145,65,63,45,45,45,45,308,0.2595419847328244,1.0
90,100,90,125,85,90,580,0.7352941176470589,75,125,100,70,80,45,495,0.33035714285714285,1.0
90,30,15,40,20,15,210,0.043478260869565216,120,100,85,30,85,45,465,0.22448979591836735,2.0
60,50,70,50,90,65,385,0.39568345323741005,40,60,30,31,31,70,262,0.4492753623188406,0.5
40,45,35,30,40,55,245,0.3793103448275862,85,50,95,120,115,80,545,0.5793650793650794,2.0
55,130,115,50,50,75,475,0.5982142857142857,49,66,70,44,55,51,335,0.4260869565217391,0.5
70,90,90,135,90,125,600,0.9401709401709402,91,90,106,130,106,77,600,0.648854961832061,1.0
40,40,55,40,70,55,300,0.40939597315436244,70,62,67,55,55,56,365,0.38513513513513514,4.0
45,60,32,50,32,76,295,0.5925925925925926,88,107,122,74,75,64,530,0.4596774193548387,0.5
75,100,110,45,55,65,450,0.5333333333333333,62,73,55,56,52,84,382,0.7244094488188977,0.0
75,125,100,70,80,45,495,0.33035714285714285,54,66,70,44,55,46,335,0.4214876033057851,1.0
53,51,53,61,56,40,314,0.14285714285714285,60,30,30,36,56,50,262,0.32432432432432434,1.0
55,40,40,65,45,35,280,0.16428571428571428,30,45,55,70,55,85,340,0.5633802816901409,2.0
70,150,140,65,100,75,600,0.55,76,147,90,60,70,97,540,0.8267716535433071,1.0
85,50,95,120,115,80,545,0.5793650793650794,60,40,80,60,45,40,325,0.23529411764705882,2.0
97,165,60,65,50,58,495,0.3902439024390244,55,50,45,135,95,120,500,0.7714285714285715,1.0
62,73,55,56,52,84,382,0.7244094488188977,35,46,34,35,45,20,215,0.072,1.0
55,95,115,45,45,35,390,0.2116788321167883,80,110,60,150,130,70,600,0.5042016806722689,1.0
75,125,230,55,95,30,610,0.3448275862068966,65,85,70,75,70,40,405,0.203125,1.0
80,70,70,90,100,70,480,0.5609756097560976,66,41,77,61,87,23,355,0.12096774193548387,1.0
100,90,130,45,65,55,485,0.4253731343283582,82,80,86,85,75,72,480,0.6183206106870229,1.0
40,65,95,60,45,35,340,0.13986013986013987,54,45,47,75,98,52,371,0.39669421487603307,2.0
50,65,90,35,35,15,290,0.14678899082568808,95,75,80,100,110,30,490,0.24242424242424243,2.0
114,85,70,85,80,30,464,0.2066115702479339,85,100,122,58,75,54,494,0.3939393939393939,0.5
80,85,95,30,30,25,345,0.2857142857142857,70,120,40,95,40,95,460,0.8106060606060606,1.0
75,140,65,112,65,110,567,0.9140625,40,60,30,31,31,70,262,0.4492753623188406,2.0
60,62,50,62,60,40,334,0.18181818181818182,80,70,70,90,100,70,480,0.5609756097560976,1.0
45,60,30,80,50,65,330,0.4603174603174603,50,25,28,45,55,15,218,0.0625,0.5
72,85,70,65,70,58,420,0.41304347826086957,79,85,60,55,60,71,410,0.60431654676259,1.0
90,110,80,100,80,95,555,0.7982456140350878,70,70,40,60,40,60,340,0.4247787610619469,2.0
75,90,50,110,80,95,500,0.7985611510791367,45,100,135,65,135,45,525,0.29411764705882354,2.0
70,60,125,115,70,55,495,0.35507246376811596,70,75,60,105,60,105,475,0.88,1.0
100,70,70,65,65,45,415,0.1897810218978102,65,83,57,95,85,105,490,0.8914728682170543,1.0
84,86,88,111,101,60,530,0.4634146341463415,250,5,5,35,105,50,450,0.15306122448979592,1.0
75,95,60,65,60,115,470,0.8778625954198473,59,74,50,35,50,35,303,0.3125,0.0
85,70,80,97,80,123,535,0.9304347826086956,91,134,95,100,100,80,600,0.6304347826086957,2.0
89,124,80,55,80,55,483,0.5714285714285714,83,80,80,135,80,121,579,0.9444444444444444,0.0
60,50,100,85,70,65,430,0.47580645161290325,40,70,40,35,40,60,285,0.392,2.0
70,62,67,55,55,56,365,0.38513513513513514,55,40,85,80,105,40,405,0.23622047244094488,2.0
105,105,75,65,100,50,500,0.37593984962406013,75,80,70,65,75,90,455,0.7578125,0.5
45,30,40,105,50,20,290,0.031007751937984496,126,131,95,131,98,99,680,0.8294573643410853,1.0
45,60,30,80,50,65,330,0.4603174603174603,35,60,44,40,54,55,288,0.366412213740458,1.0
50,75,70,35,70,48,348,0.29357798165137616,50,100,150,100,150,50,600,0.37142857142857144,0.5
50,53,48,53,48,64,316,0.358974358974359,89,124,80,55,80,55,483,0.5714285714285714,2.0
100,150,120,120,100,90,680,0.6493506493506493,80,50,100,100,200,50,580,0.2357142857142857,1.0
60,80,50,50,50,40,330,0.23853211009174313,75,98,63,98,63,101,498,0.849624060150376,1.0
45,49,65,49,65,45,318,0.275,78,81,71,74,69,126,499,0.9090909090909091,0.25
80,100,200,50,100,50,580,0.3472222222222222,38,30,41,30,41,60,240,0.2897196261682243,1.0
45,40,60,40,75,50,310,0.2926829268292683,109,66,84,81,99,32,471,0.2013888888888889,0.5
39,52,43,60,50,65,309,0.49107142857142855,65,90,120,85,70,60,490,0.43410852713178294,1.0
80,95,82,60,82,75,474,0.6,100,150,120,120,100,90,680,0.6493506493506493,1.0
59,63,80,65,80,58,405,0.41843971631205673,50,150,50,150,50,150,600,0.9339622641509434,1.0
40,35,30,20,20,50,195,0.23423423423423423,45,50,35,55,75,40,300,0.21367521367521367,1.0
120,70,120,75,130,85,600,0.6694915254237288,75,105,75,105,75,45,480,0.3274336283185841,1.0
80,70,65,80,120,100,515,0.8034188034188035,95,110,95,40,95,55,490,0.40336134453781514,1.0
80,80,50,40,50,25,325,0.176056338028169,65,90,122,58,75,84,494,0.71875,1.0
30,45,55,70,55,85,340,0.5633802816901409,35,60,44,40,54,55,288,0.366412213740458,1.0
44,58,44,58,44,61,309,0.41964285714285715,81,102,77,85,75,85,505,0.5642857142857143,1.0
60,85,69,60,69,77,420,0.518796992481203,55,70,45,70,50,60,350,0.45,1.0
110,85,95,80,95,50,515,0.2713178294573643,30,40,55,40,55,60,280,0.3237410071942446,1.0
72,105,115,54,86,68,500,0.5149253731343284,91,90,129,90,72,108,580,0.9140625,0.25
75,55,70,55,95,110,460,0.8444444444444444,75,89,85,55,65,36,405,0.29545454545454547,1.0
67,89,116,79,116,33,500,0.2624113475177305,65,75,90,97,123,44,494,0.1987179487179487,2.0
75,90,90,140,90,115,600,0.9481481481481482,60,52,168,47,138,30,495,0.19834710743801653,1.0
60,85,69,65,79,80,438,0.576,60,82,45,45,45,74,351,0.5752212389380531,0.5
55,50,45,135,95,120,500,0.7714285714285715,120,100,85,30,85,45,465,0.22448979591836735,1.0
110,135,60,50,65,88,508,0.7744360902255639,50,95,95,35,110,70,455,0.5179856115107914,1.0
50,105,125,55,95,50,480,0.375886524822695,75,100,66,60,66,115,482,0.918918918918919,1.0
45,75,60,40,30,50,300,0.304,45,95,50,40,50,75,355,0.54,1.0
70,90,45,15,45,50,315,0.3629032258064516,80,120,130,55,65,45,495,0.37037037037037035,0.5
50,95,180,85,45,70,525,0.5298507462686567,35,46,34,35,45,20,215,0.072,1.0
70,77,60,97,60,108,472,0.8394160583941606,20,10,55,15,20,80,200,0.17985611510791366,2.0
40,30,35,45,40,55,245,0.31496062992125984,35,55,40,50,50,90,320,0.6838235294117647,0.5
90,120,75,60,60,45,450,0.29411764705882354,60,62,80,63,80,60,405,0.4336283185840708,1.0
76,48,48,57,62,34,325,0.11688311688311688,90,85,100,95,125,85,580,0.6834532374100719,1.0
81,102,77,85,75,85,505,0.5642857142857143,108,100,121,81,95,95,600,0.7476635514018691,0.5
38,30,41,30,41,60,240,0.2897196261682243,44,75,35,63,33,45,295,0.2647058823529412,0.0
80,82,100,83,100,80,525,0.6821705426356589,45,35,45,62,53,35,275,0.11851851851851852,0.5
60,25,35,70,80,60,330,0.3076923076923077,51,65,65,80,75,59,395,0.4365079365079365,1.0
50,80,95,10,45,10,290,0.232,65,110,130,60,65,95,525,0.8278145695364238,1.0
45,100,45,45,45,10,290,0.2949640287769784,60,100,85,80,85,100,510,0.7007874015748031,1.0
62,55,52,109,94,109,481,0.7833333333333333,160,110,65,65,110,30,540,0.35714285714285715,1.0
20,25,45,70,90,60,310,0.30833333333333335,70,20,50,20,50,40,250,0.1557377049180328,1.0
80,185,115,40,105,75,600,0.6230769230769231,60,85,69,65,79,80,438,0.576,0.25
71,73,88,120,89,59,500,0.43537414965986393,45,60,40,70,50,45,310,0.2846715328467153,2.0
45,35,45,62,53,35,275,0.11851851851851852,95,60,79,100,125,81,540,0.6201550387596899,2.0
62,73,55,56,52,84,382,0.7244094488188977,59,59,58,90,70,73,409,0.5826086956521739,0.5
78,65,68,112,154,75,552,0.628099173553719,79,103,120,135,115,78,630,0.5763888888888888,1.0
44,50,91,24,86,10,305,0.1981981981981982,64,51,23,51,23,28,240,0.11363636363636363,1.0
50,65,107,105,107,86,520,0.7313432835820896,50,65,107,105,107,86,520,0.7758620689655172,2.0
100,150,110,95,110,70,635,0.5923076923076923,70,120,65,45,85,125,510,0.9747899159663865,1.0
72,85,70,65,70,58,420,0.41304347826086957,48,72,48,72,48,48,336,0.25984251968503935,2.0
64,51,23,51,23,28,240,0.11363636363636363,95,95,85,125,65,55,520,0.3894736842105263,1.0
60,40,80,60,45,40,325,0.23529411764705882,104,91,63,91,73,68,490,0.5118110236220472,1.0
65,75,70,95,70,95,470,0.7272727272727273,55,45,45,25,25,15,210,0.048,2.0
60,90,55,90,80,110,485,0.8677685950413223,70,77,60,97,60,108,472,0.8394160583941606,0.5
85,135,130,60,80,25,515,0.40540540540540543,50,65,107,105,107,86,520,0.7272727272727273,2.0
50,53,48,53,48,64,316,0.46153846153846156,45,20,50,60,120,50,345,0.24074074074074073,0.5
105,105,75,65,100,50,500,0.37593984962406013,100,100,100,100,100,100,600,0.8345864661654135,2.0
60,70,50,100,50,65,395,0.5217391304347826,35,35,40,35,55,50,250,0.40336134453781514,2.0
65,40,50,125,60,30,370,0.07258064516129033,78,92,75,74,63,118,500,0.8842975206611571,1.0
38,35,35,65,55,50,278,0.2647058823529412,40,30,35,50,70,55,280,0.28205128205128205,1.0
37,25,41,25,41,25,194,0.08870967741935484,45,30,35,20,20,45,195,0.14782608695652175,1.0
40,55,30,30,30,60,245,0.43548387096774194,57,80,91,80,87,75,470,0.5737704918032787,0.25
55,75,50,40,40,80,340,0.6302521008403361,55,84,105,114,75,52,485,0.2890625,1.0
85,105,100,79,83,78,530,0.5869565217391305,78,70,61,50,61,100,420,0.8145161290322581,1.0
100,150,120,120,100,90,680,0.6493506493506493,101,72,72,99,89,29,462,0.1937984496124031,0.0
67,125,40,30,30,58,350,0.3431372549019608,77,120,90,60,90,48,485,0.2785714285714286,1.0
50,92,108,92,108,35,485,0.2457627118644068,89,145,90,105,80,91,600,0.8549618320610687,1.0
70,43,53,43,53,40,302,0.19090909090909092,60,48,45,43,90,42,328,0.21897810218978103,1.0
86,81,97,81,107,43,495,0.203125,80,120,80,120,80,100,580,0.8478260869565217,2.0
62,50,58,73,54,72,369,0.4435483870967742,60,60,60,105,105,105,495,0.848,0.0
63,120,85,90,55,55,468,0.2809917355371901,65,95,57,100,85,93,495,0.7441860465116279,2.0
50,180,20,180,20,150,600,0.9029850746268657,30,80,90,55,45,55,355,0.4295774647887324,1.0
70,90,70,60,60,70,420,0.6390977443609023,40,45,40,62,60,60,307,0.33884297520661155,1.0
50,47,50,57,50,65,319,0.463768115942029,82,121,119,69,59,71,521,0.5394736842105263,0.5
60,90,140,50,50,40,430,0.2535211267605634,78,84,78,109,85,100,534,0.8620689655172413,1.0
40,45,35,40,40,90,290,0.65,62,77,62,50,42,65,358,0.4838709677419355,1.0
101,72,72,99,89,29,462,0.1937984496124031,59,59,58,90,70,73,409,0.5826086956521739,0.5
45,60,30,80,50,65,330,0.4603174603174603,54,63,52,83,56,97,405,0.7697841726618705,0.5
80,125,75,40,95,85,500,0.6911764705882353,105,105,75,65,100,50,500,0.37593984962406013,0.25
49,66,70,44,55,51,335,0.4260869565217391,50,53,62,58,63,44,330,0.13709677419354838,2.0
70,83,50,37,50,60,350,0.3360655737704918,81,102,77,85,75,85,505,0.5642857142857143,1.0
110,130,80,70,60,80,530,0.5862068965517241,85,70,80,97,80,123,535,0.9304347826086956,0.0
70,105,105,50,40,20,390,0.33587786259541985,41,64,45,50,50,50,300,0.36752136752136755,1.0
100,100,100,100,100,100,600,0.8345864661654135,40,35,30,120,70,105,400,0.6692307692307692,0.5
65,125,60,95,60,105,510,0.9236641221374046,78,130,111,130,85,100,634,0.8561151079136691,1.0
60,60,60,60,60,60,360,0.38095238095238093,60,40,50,75,85,95,405,0.6044776119402985,1.0
65,150,40,15,80,145,495,0.9663865546218487,70,55,95,95,110,65,490,0.48872180451127817,2.0
65,65,45,75,45,95,390,0.72,55,40,85,80,105,40,405,0.23622047244094488,0.25
50,150,50,150,50,150,600,0.9339622641509434,71,73,88,120,89,59,500,0.43537414965986393,1.0
70,140,230,60,80,50,630,0.32432432432432434,100,164,150,95,120,71,700,0.5645161290322581,2.0
80,70,65,80,120,100,515,0.8034188034188035,60,60,60,105,105,105,495,0.848,0.5
78,92,75,74,63,118,500,0.8842975206611571,81,102,77,85,75,85,505,0.5642857142857143,0.5
70,85,70,60,70,50,405,0.28378378378378377,60,55,90,145,90,80,520,0.6071428571428571,4.0
65,90,122,58,75,84,494,0.71875,84,71,43,71,43,48,360,0.25874125874125875,0.0
89,125,90,115,80,101,600,0.8725490196078431,75,100,63,80,63,116,497,0.9345794392523364,1.0
67,89,116,79,116,33,500,0.2624113475177305,30,45,55,70,55,85,340,0.5633802816901409,0.5
95,80,105,40,70,100,490,0.8046875,40,45,35,65,55,70,310,0.4482758620689655,1.0
100,164,150,95,120,71,700,0.5645161290322581,65,130,60,75,60,75,465,0.689922480620155,0.5
44,38,39,61,79,42,303,0.2251655629139073,55,104,105,94,75,52,485,0.36363636363636365,1.0
60,80,110,50,80,45,425,0.2833333333333333,40,30,30,55,30,85,270,0.4666666666666667,0.0
45,100,45,45,45,10,290,0.2949640287769784,60,40,80,60,45,40,325,0.23529411764705882,0.5
50,85,40,85,40,35,335,0.1746031746031746,60,50,70,50,90,65,385,0.39568345323741005,0.25
72,85,70,65,70,58,420,0.41304347826086957,28,25,25,45,35,40,198,0.16083916083916083,0.0
95,23,48,23,48,23,260,0.046153846153846156,75,75,55,105,85,30,425,0.1619718309859155,1.0
46,57,40,40,40,50,273,0.25,65,73,55,47,75,85,400,0.6846846846846847,1.0
80,120,70,110,70,80,530,0.6422764227642277,45,49,49,65,65,45,318,0.2781954887218045,1.0
50,70,50,50,50,40,310,0.16296296296296298,65,130,60,95,110,65,525,0.5303030303030303,2.0
75,80,60,65,90,102,472,0.8625954198473282,95,75,180,130,80,30,590,0.13793103448275862,1.0
45,85,50,55,50,65,350,0.5076923076923077,55,95,115,45,45,35,390,0.2116788321167883,2.0
48,61,40,61,40,50,300,0.2543859649122807,80,130,100,160,120,110,700,0.8981481481481481,0.5
45,50,43,40,38,62,278,0.40441176470588236,40,30,35,45,40,55,245,0.31496062992125984,1.0
50,70,100,40,40,30,330,0.2222222222222222,100,120,120,150,100,90,680,0.7880794701986755,0.25
55,130,115,50,50,75,475,0.5982142857142857,55,35,50,55,110,85,390,0.6277372262773723,1.0
165,75,80,40,45,65,470,0.5151515151515151,65,55,115,100,40,60,435,0.3798449612403101,0.5
50,85,55,65,65,90,410,0.7478260869565218,60,67,85,77,75,116,480,0.8888888888888888,2.0
150,100,120,100,120,90,680,0.6666666666666666,70,80,102,80,102,40,474,0.2677165354330709,1.0
40,20,30,40,80,55,265,0.22764227642276422,69,55,45,55,55,15,294,0.11666666666666667,2.0
38,35,35,65,55,50,278,0.2647058823529412,60,75,100,55,80,50,420,0.3088235294117647,0.125
35,64,85,74,55,32,345,0.19827586206896552,65,80,80,59,63,58,405,0.4411764705882353,0.5
48,72,48,72,48,48,336,0.25984251968503935,45,100,135,65,135,45,525,0.29411764705882354,1.0
60,65,70,85,75,40,395,0.21705426356589147,80,70,40,100,60,145,495,0.921875,0.5
55,95,115,45,45,35,390,0.2116788321167883,55,47,52,40,40,41,275,0.16806722689075632,2.0
90,100,60,90,60,80,480,0.6422764227642277,86,68,72,109,66,106,507,0.8099173553719008,0.5
60,69,95,69,95,36,424,0.2608695652173913,80,90,80,130,110,110,600,0.856,2.0
60,40,50,75,85,95,405,0.6044776119402985,55,75,85,25,25,15,280,0.1875,1.0
45,35,50,70,50,30,280,0.15753424657534246,65,155,120,65,90,105,600,0.8677685950413223,0.25
54,63,52,83,56,97,405,0.7697841726618705,100,164,150,95,120,71,700,0.5645161290322581,2.0
75,65,55,65,55,69,384,0.43548387096774194,65,136,94,54,96,135,580,0.9612403100775194,1.0
95,60,79,100,125,81,540,0.6201550387596899,35,20,65,40,65,20,245,0.02459016393442623,1.0
45,45,35,20,30,20,195,0.07246376811594203,62,48,66,59,57,49,341,0.33884297520661155,0.5
60,115,105,65,70,80,495,0.7181818181818181,80,120,79,95,79,70,523,0.5833333333333334,1.0
55,95,115,45,45,35,390,0.2116788321167883,80,45,65,90,110,80,470,0.5462962962962963,1.0
71,73,88,120,89,59,500,0.43537414965986393,40,70,40,35,40,60,285,0.392,1.0
70,150,140,65,100,75,600,0.55,50,50,150,50,150,50,500,0.2571428571428571,0.5
65,136,94,54,96,135,580,0.9612403100775194,55,20,35,20,45,75,250,0.37681159420289856,2.0
45,53,70,40,60,42,310,0.25735294117647056,70,55,95,95,110,65,490,0.48872180451127817,2.0
70,65,60,90,75,90,450,0.6571428571428571,20,25,45,70,90,60,310,0.30833333333333335,2.0
51,65,65,80,75,59,395,0.4365079365079365,60,60,60,35,35,30,280,0.11194029850746269,1.0
58,64,58,80,65,80,405,0.609271523178808,78,70,61,50,61,100,420,0.8145161290322581,1.0
100,150,120,120,100,90,680,0.6493506493506493,45,63,37,65,55,95,360,0.8055555555555556,0.5
75,75,95,75,95,113,528,0.9015151515151515,115,115,85,90,75,100,580,0.8134328358208955,0.5
60,45,70,45,90,95,405,0.7304964539007093,74,100,72,90,72,46,454,0.24561403508771928,0.5
45,35,45,62,53,35,275,0.11851851851851852,50,50,62,40,62,65,329,0.4188034188034188,0.5
90,85,75,115,100,115,580,0.9381443298969072,65,90,50,85,45,55,390,0.371900826446281,0.5
50,25,28,45,55,15,218,0.0625,39,52,43,60,50,65,309,0.5041322314049587,0.5
70,84,70,65,70,51,410,0.2949640287769784,65,47,55,73,75,85,400,0.65,1.0
75,75,75,125,95,40,485,0.15671641791044777,126,131,95,131,98,99,680,0.8102189781021898,0.0
126,131,95,131,98,99,680,0.8294573643410853,105,95,80,40,80,90,490,0.753968253968254,1.0
90,132,105,132,105,30,594,0.4246575342465753,80,100,70,50,60,45,405,0.25806451612903225,1.0
40,45,65,100,120,90,460,0.5588235294117647,91,134,95,100,100,80,600,0.6304347826086957,2.0
63,63,47,41,41,74,329,0.56,100,70,70,65,65,45,415,0.1897810218978102,1.0
80,70,40,100,60,145,495,0.921875,38,35,40,27,25,35,200,0.08208955223880597,1.0
80,160,80,130,80,100,630,0.8455284552845529,75,95,67,125,95,83,540,0.7117117117117117,0.5
85,110,76,65,82,56,474,0.3933333333333333,40,55,30,30,30,60,245,0.43548387096774194,0.0
60,60,40,65,45,35,305,0.15833333333333333,100,103,75,120,75,127,600,0.940677966101695,0.0
55,20,35,20,45,75,250,0.37681159420289856,55,85,122,58,75,99,494,0.8099173553719008,0.0
65,40,50,125,60,30,370,0.07258064516129033,40,20,30,40,80,55,265,0.22764227642276422,1.0
77,120,90,60,90,48,485,0.2785714285714286,60,50,70,50,90,65,385,0.39568345323741005,1.0
50,180,20,180,20,150,600,0.9029850746268657,60,85,60,50,50,125,430,0.9090909090909091,1.0
73,100,60,100,60,65,458,0.42657342657342656,80,115,80,65,55,93,488,0.7846153846153846,1.0
126,131,95,131,98,99,680,0.8102189781021898,75,75,95,75,95,113,528,0.9015151515151515,2.0
54,78,103,53,45,22,355,0.23255813953488372,28,25,25,45,35,40,198,0.16083916083916083,1.0
75,125,75,30,75,85,465,0.625,104,91,63,91,73,68,490,0.5118110236220472,2.0
63,60,55,50,50,71,349,0.5289256198347108,95,23,48,23,48,23,260,0.046153846153846156,1.0
40,70,40,35,40,60,285,0.392,55,75,50,40,40,80,340,0.6302521008403361,1.0
85,73,70,73,115,67,483,0.5126050420168067,85,105,55,85,50,115,495,0.9032258064516129,1.0
70,70,115,130,90,60,535,0.5338983050847458,95,23,48,23,48,23,260,0.046153846153846156,1.0
110,160,110,80,110,100,670,0.8591549295774648,60,40,80,60,45,40,325,0.23529411764705882,1.0
55,50,40,40,40,75,300,0.5945945945945946,70,90,110,60,75,95,500,0.7333333333333333,1.0
60,50,40,85,75,95,405,0.7540983606557377,45,55,39,35,39,42,255,0.18518518518518517,1.0
75,75,75,125,95,40,485,0.15671641791044777,80,110,120,130,90,70,600,0.6198347107438017,1.0
50,48,43,46,41,60,288,0.47297297297297297,50,92,108,92,108,35,485,0.2457627118644068,1.0
31,45,90,30,30,40,266,0.21929824561403508,45,67,60,35,50,63,320,0.5128205128205128,1.0
92,105,90,125,90,98,600,0.8217054263565892,100,123,75,57,75,80,510,0.6923076923076923,1.0
38,35,35,65,55,50,278,0.2647058823529412,60,100,85,80,85,100,510,0.7007874015748031,1.0
40,50,90,30,55,65,330,0.44680851063829785,50,160,110,160,110,110,700,0.8854961832061069,0.5
190,33,58,33,58,33,405,0.13432835820895522,50,50,120,80,80,30,410,0.07258064516129033,1.0
190,33,58,33,58,33,405,0.13432835820895522,65,83,57,95,85,105,490,0.8914728682170543,1.0
90,90,85,125,90,100,580,0.768595041322314,75,95,60,65,60,115,470,0.8778625954198473,1.0
95,110,80,70,80,50,485,0.37209302325581395,130,70,35,70,35,60,400,0.4017857142857143,0.5
80,135,130,95,90,70,600,0.5181818181818182,95,95,85,125,65,55,520,0.3894736842105263,0.5
38,35,40,27,25,35,200,0.08208955223880597,90,95,105,165,110,45,610,0.2890625,1.0
64,51,23,51,23,28,240,0.11363636363636363,60,45,70,45,90,95,405,0.7304964539007093,1.0
85,90,80,70,80,130,535,0.9262295081967213,75,110,110,110,105,80,590,0.656934306569343,2.0
126,131,95,131,98,99,680,0.8294573643410853,30,30,30,30,30,30,180,0.12612612612612611,1.0
120,120,120,120,120,120,720,0.9344262295081968,70,43,53,43,53,40,302,0.19090909090909092,1.0
62,48,54,63,60,68,355,0.5178571428571429,105,125,100,60,100,100,590,0.8359375,1.0
85,73,70,73,115,67,483,0.5126050420168067,44,75,35,63,33,45,295,0.2647058823529412,1.0
100,73,83,73,83,55,467,0.371900826446281,45,75,37,70,55,83,365,0.6183206106870229,1.0
45,80,100,35,37,28,325,0.3125,106,90,130,90,154,110,680,0.8699186991869918,2.0
45,85,50,55,50,65,350,0.5076923076923077,85,105,100,79,83,78,530,0.5869565217391305,1.0
42,52,67,39,56,50,306,0.2868217054263566,58,89,77,45,45,48,362,0.3177570093457944,1.0
67,82,62,46,48,43,348,0.22033898305084745,50,25,28,45,55,15,218,0.0625,0.5
62,44,50,44,50,55,305,0.3629032258064516,76,147,90,60,70,97,540,0.8267716535433071,0.5
35,55,40,50,50,90,320,0.6838235294117647,50,65,85,35,35,55,325,0.32575757575757575,1.0
79,100,80,110,90,121,580,0.968,55,104,105,94,75,52,485,0.36363636363636365,1.0
50,95,90,95,90,180,600,0.9172413793103448,75,98,63,98,63,101,498,0.8091603053435115,1.0
70,60,70,87,78,85,450,0.6228070175438597,70,90,110,60,75,95,500,0.7333333333333333,0.5
65,90,50,85,45,55,390,0.371900826446281,50,60,45,100,80,65,400,0.45689655172413796,0.25
55,81,60,50,70,97,413,0.7214285714285714,50,20,55,25,25,30,205,0.09774436090225563,1.0
103,60,126,80,126,50,545,0.36363636363636365,65,47,55,73,75,85,400,0.65,1.0
80,135,130,95,90,70,600,0.5181818181818182,135,85,40,40,85,5,390,0.6864406779661016,1.0
110,80,90,95,90,65,530,0.5033557046979866,50,55,50,36,30,43,264,0.2922077922077922,2.0
60,60,50,40,50,75,335,0.5882352941176471,45,85,70,40,40,60,340,0.5229357798165137,0.25
55,55,45,63,45,45,308,0.25,97,165,60,65,50,58,495,0.3902439024390244,2.0
53,51,53,61,56,40,314,0.14285714285714285,95,135,80,110,80,100,600,0.8248175182481752,0.5
110,80,90,95,90,65,530,0.5033557046979866,50,105,125,55,95,50,480,0.375886524822695,0.5
65,90,122,58,75,84,494,0.71875,108,112,118,68,72,47,525,0.2916666666666667,2.0
65,60,110,130,95,65,525,0.47761194029850745,90,60,60,40,40,40,330,0.29545454545454547,2.0
95,65,110,60,130,65,525,0.5275590551181102,86,92,88,68,75,73,482,0.6835443037974683,1.0
85,76,64,45,55,90,415,0.6739130434782609,44,38,39,61,79,42,303,0.2251655629139073,1.0
50,65,107,105,107,86,520,0.703125,50,35,55,25,25,15,205,0.021739130434782608,1.0
82,80,86,85,75,72,480,0.6183206106870229,28,25,25,45,35,40,198,0.16083916083916083,1.0
49,49,56,49,61,66,330,0.5190839694656488,50,50,120,80,80,30,410,0.07258064516129033,4.0
70,90,90,135,90,125,600,0.9401709401709402,60,60,60,85,85,85,435,0.631578947368421,2.0
55,75,60,75,60,103,428,0.7982456140350878,40,30,35,50,70,55,280,0.28205128205128205,1.0
40,30,50,55,55,100,330,0.584070796460177,85,70,80,97,80,123,535,0.9304347826086956,1.0
68,72,78,38,42,32,330,0.23809523809523808,75,98,63,98,63,101,498,0.889763779527559,2.0
80,52,50,90,50,89,411,0.6666666666666666,45,55,45,65,45,75,330,0.5692307692307692,0.5
50,75,35,70,30,40,300,0.21296296296296297,65,80,65,35,65,60,370,0.38405797101449274,1.0
55,85,55,50,55,60,360,0.4233576642335766,72,85,70,65,70,58,420,0.41304347826086957,1.0
60,85,60,50,50,125,430,0.9090909090909091,80,185,115,40,105,75,600,0.6230769230769231,4.0
70,80,65,90,65,85,455,0.578125,60,70,105,70,120,75,500,0.5983606557377049,1.0
65,95,57,100,85,93,495,0.7441860465116279,80,125,75,40,95,85,500,0.6911764705882353,2.0
70,110,70,115,70,90,525,0.75,40,80,35,35,45,70,305,0.4661016949152542,1.0
55,55,45,63,45,45,308,0.25,44,50,91,24,86,10,305,0.1981981981981982,0.5
65,60,70,85,75,40,395,0.1796875,65,125,100,55,70,85,500,0.6532258064516129,1.0
70,110,180,60,60,50,530,0.4117647058823529,65,75,70,95,70,95,470,0.7272727272727273,2.0
45,53,70,40,60,42,310,0.25735294117647056,46,87,60,30,40,57,320,0.37777777777777777,0.5
45,60,32,50,32,76,295,0.5925925925925926,125,58,58,76,76,67,460,0.515625,1.0
55,69,85,32,35,28,304,0.09302325581395349,70,130,100,55,80,65,500,0.608,0.5
95,70,73,95,90,60,483,0.3983739837398374,84,71,43,71,43,48,360,0.25874125874125875,1.0
65,80,140,40,70,70,465,0.5223880597014925,45,40,60,40,75,50,310,0.2926829268292683,1.0
55,70,55,40,55,85,360,0.7073170731707317,65,95,100,60,50,50,420,0.34959349593495936,1.0
55,85,55,50,55,60,360,0.4233576642335766,61,72,57,55,55,65,365,0.3984375,0.5
80,80,90,110,130,110,600,0.8721804511278195,65,85,70,75,70,40,405,0.203125,1.0
55,75,85,25,25,15,280,0.1875,108,130,95,80,85,102,600,0.7637795275590551,0.5
80,120,130,55,65,45,495,0.37037037037037035,74,94,131,54,116,20,489,0.4485294117647059,0.5
70,60,70,87,78,85,450,0.6228070175438597,50,30,55,65,55,20,275,0.13675213675213677,0.5
75,125,100,70,80,45,495,0.33035714285714285,65,65,60,110,95,130,525,0.9253731343283582,1.0
80,120,80,120,80,100,580,0.8478260869565217,72,58,80,103,80,97,490,0.7171052631578947,2.0
85,105,55,85,50,115,495,0.9032258064516129,100,100,100,100,100,100,600,0.8602941176470589,0.5
85,50,95,120,115,80,545,0.5793650793650794,80,110,60,150,130,70,600,0.5042016806722689,1.0
80,115,80,65,55,93,488,0.7846153846153846,65,130,60,75,60,75,465,0.689922480620155,1.0
35,35,35,35,35,35,210,0.13385826771653545,60,50,50,60,70,50,340,0.28346456692913385,1.0
60,40,60,40,60,35,295,0.18055555555555555,40,35,30,120,70,105,400,0.6692307692307692,1.0
70,60,125,115,70,55,495,0.35507246376811596,60,50,70,80,80,140,480,0.8449612403100775,1.0
20,10,230,10,230,5,505,0.0,95,75,180,130,80,30,590,0.13793103448275862,2.0
70,55,55,80,60,45,365,0.2222222222222222,190,33,58,33,58,33,405,0.13432835820895522,1.0
75,125,70,125,70,115,580,0.9037037037037037,43,30,55,40,65,97,330,0.6030534351145038,1.0
60,100,89,55,69,112,485,0.9298245614035088,109,66,84,81,99,32,471,0.2013888888888889,0.5
40,70,130,60,130,25,455,0.17355371900826447,106,90,130,90,154,110,680,0.8699186991869918,2.0
45,45,35,20,30,20,195,0.07246376811594203,79,115,70,125,80,111,580,0.864,0.5
40,45,35,30,40,55,245,0.3793103448275862,77,120,90,60,90,48,485,0.2785714285714286,1.0
70,75,80,135,80,135,575,0.917910447761194,50,50,40,30,30,50,250,0.2781954887218045,0.0
60,80,95,70,85,50,440,0.2231404958677686,84,71,43,71,43,48,360,0.25874125874125875,1.0
45,20,50,60,120,50,345,0.24074074074074073,80,100,70,60,70,95,475,0.7416666666666667,1.0
72,95,67,103,71,122,530,0.9606299212598425,40,55,80,35,60,30,300,0.15037593984962405,2.0
78,84,78,109,85,100,534,0.8620689655172413,70,84,70,65,70,51,410,0.2949640287769784,0.5
65,75,70,95,70,95,470,0.7272727272727273,70,100,70,105,75,40,460,0.23214285714285715,2.0
91,72,90,129,90,108,580,0.8925619834710744,48,61,40,61,40,50,300,0.2543859649122807,0.5
50,60,45,100,80,65,400,0.45689655172413796,104,91,63,91,73,68,490,0.5118110236220472,1.0
35,40,100,90,55,35,355,0.1796875,75,75,60,83,60,60,413,0.39344262295081966,0.5
82,121,119,69,59,71,521,0.5394736842105263,60,62,80,63,80,60,405,0.4336283185840708,1.0
74,48,76,83,81,104,466,0.7322834645669292,55,75,50,40,40,80,340,0.6302521008403361,1.0
55,45,50,45,65,80,340,0.5546218487394958,50,20,40,20,40,20,190,0.0962962962962963,1.0
85,135,130,60,80,25,515,0.40540540540540543,60,65,60,130,75,110,500,0.7719298245614035,1.0
70,55,75,45,65,60,370,0.45901639344262296,68,90,65,50,55,82,410,0.6165413533834586,1.0
45,60,45,25,45,55,275,0.29,65,65,65,50,50,90,385,0.72,1.0
50,50,120,80,80,30,410,0.07258064516129033,100,77,77,128,128,90,600,0.6901408450704225,1.0
70,100,115,30,65,30,410,0.24390243902439024,114,85,70,85,80,30,464,0.2066115702479339,1.0
55,65,95,95,45,85,440,0.6610169491525424,80,52,50,90,50,89,411,0.6666666666666666,1.0
45,63,37,65,55,95,360,0.8055555555555556,40,45,40,35,35,56,251,0.373015873015873,2.0
79,103,120,135,115,78,630,0.5763888888888888,90,120,75,60,60,45,450,0.29411764705882354,1.0
55,66,44,44,56,85,350,0.6888888888888889,53,54,53,37,46,45,288,0.3090909090909091,1.0
123,100,62,97,81,68,531,0.4806201550387597,62,48,66,59,57,49,341,0.33884297520661155,1.0
45,50,45,115,55,95,405,0.6936936936936937,90,60,70,75,70,45,410,0.23880597014925373,1.0
80,80,80,55,55,90,440,0.6417910447761194,80,115,80,65,55,93,488,0.7846153846153846,1.0
90,92,75,92,85,60,494,0.49586776859504134,63,120,85,90,55,55,468,0.2809917355371901,1.0
75,100,66,60,66,115,482,0.918918918918919,64,165,75,93,83,75,555,0.6587301587301587,0.0
70,55,65,95,85,70,440,0.5307692307692308,85,135,130,60,80,25,515,0.40540540540540543,1.0
40,70,130,60,130,25,455,0.17355371900826447,43,30,55,40,65,97,330,0.6030534351145038,1.0
80,80,80,80,80,80,480,0.6015037593984962,50,75,75,65,65,50,380,0.4049586776859504,1.0
65,80,80,59,63,58,405,0.4411764705882353,58,70,45,40,45,42,300,0.25925925925925924,1.0
73,115,60,60,60,90,458,0.6694915254237288,50,100,150,100,150,50,600,0.37142857142857144,0.5
50,72,35,35,35,65,292,0.5373134328358209,100,100,125,110,50,50,535,0.384,0.5
125,120,90,170,100,95,700,0.78125,63,63,47,41,41,74,329,0.56,1.0
30,80,90,55,45,55,355,0.4295774647887324,78,81,71,74,69,126,499,0.9090909090909091,8.0
55,85,55,50,55,60,360,0.4233576642335766,45,65,34,40,34,45,263,0.2589928057553957,1.0
52,65,50,45,50,38,300,0.27419354838709675,70,110,70,115,70,90,525,0.75,0.25
45,95,50,40,50,75,355,0.54,64,78,52,78,52,81,405,0.6422764227642277,0.25
68,90,65,50,55,82,410,0.6165413533834586,90,75,85,115,90,55,510,0.3445378151260504,2.0
41,64,45,50,50,50,300,0.36752136752136755,70,100,70,105,75,40,460,0.23214285714285715,1.0
100,110,90,85,90,60,535,0.47794117647058826,50,64,50,45,50,41,300,0.22727272727272727,8.0
70,120,40,95,40,95,460,0.8106060606060606,37,25,41,25,41,25,194,0.08870967741935484,1.0
82,80,86,85,75,72,480,0.6183206106870229,66,117,70,40,50,67,410,0.4573643410852713,2.0
60,79,105,59,85,36,424,0.17054263565891473,75,80,60,65,90,102,472,0.8625954198473282,1.0
70,75,60,105,60,105,475,0.88,65,40,70,80,140,70,465,0.5954198473282443,4.0
70,75,80,135,80,135,575,0.917910447761194,60,55,90,145,90,80,520,0.6071428571428571,1.0
95,145,130,120,90,120,700,0.9398496240601504,90,120,100,150,120,100,680,0.7718120805369127,2.0
60,40,60,40,60,35,295,0.18055555555555555,45,50,45,115,55,95,405,0.6936936936936937,0.5
50,60,60,60,60,30,320,0.11290322580645161,55,47,52,40,40,41,275,0.16806722689075632,0.5
95,125,79,60,100,81,540,0.6165413533834586,106,130,90,110,154,90,680,0.719626168224299,2.0
91,90,129,90,72,108,580,0.9140625,190,33,58,33,58,33,405,0.13432835820895522,0.5
115,115,85,90,75,100,580,0.8134328358208955,95,124,78,69,71,58,495,0.37398373983739835,1.0
95,124,78,69,71,58,495,0.37398373983739835,20,25,45,70,90,60,310,0.30833333333333335,0.25
40,55,30,30,30,60,245,0.43548387096774194,57,24,86,24,86,23,300,0.12727272727272726,0.25
40,55,30,30,30,60,245,0.43548387096774194,70,80,65,90,65,85,455,0.578125,1.0
40,50,90,30,55,65,330,0.44680851063829785,65,125,60,95,60,105,510,0.9236641221374046,0.5
75,125,70,125,70,115,580,0.9037037037037037,80,100,123,122,120,80,625,0.56,2.0
70,92,65,80,55,98,460,0.8090909090909091,40,30,35,50,70,55,280,0.28205128205128205,0.5
43,80,65,50,35,35,308,0.14193548387096774,150,100,120,100,120,90,680,0.6666666666666666,0.5
35,35,40,35,55,50,250,0.40336134453781514,91,134,95,100,100,80,600,0.6304347826086957,0.25
108,100,121,81,95,95,600,0.7476635514018691,62,48,54,63,60,68,355,0.5178571428571429,1.0
125,130,90,130,90,95,660,0.7734375,100,100,90,150,140,90,670,0.71875,0.5
70,65,60,90,75,90,450,0.6571428571428571,60,60,40,65,45,35,305,0.15833333333333333,0.25
100,128,90,77,77,128,600,0.959349593495935,60,100,85,80,85,100,510,0.7007874015748031,0.5
50,50,150,50,150,50,500,0.2571428571428571,38,36,38,32,36,57,237,0.3893805309734513,1.0
70,83,50,37,50,60,350,0.3360655737704918,75,123,67,95,85,95,540,0.7642276422764228,0.5
66,65,48,62,57,52,350,0.36220472440944884,45,60,30,80,50,65,330,0.4603174603174603,0.5
123,100,62,97,81,68,531,0.4806201550387597,60,80,50,40,40,30,300,0.15328467153284672,1.0
90,75,85,115,90,55,510,0.3445378151260504,54,63,52,83,56,97,405,0.7697841726618705,2.0
95,65,110,60,130,65,525,0.5275590551181102,80,125,75,40,95,85,500,0.6911764705882353,0.5
55,35,50,55,110,85,390,0.6277372262773723,79,100,80,110,90,121,580,0.968,0.5
30,40,70,70,25,60,295,0.41353383458646614,38,30,85,55,65,30,303,0.21428571428571427,1.0
65,90,120,85,70,60,490,0.43410852713178294,50,85,85,55,55,50,380,0.3902439024390244,0.0
55,40,40,65,45,35,280,0.16428571428571428,68,165,95,65,115,110,618,0.8615384615384616,1.0
67,89,116,79,116,33,500,0.2624113475177305,45,50,55,75,65,30,320,0.06293706293706294,2.0
75,95,95,95,95,85,540,0.6470588235294118,90,100,60,90,60,80,480,0.6422764227642277,0.5
50,35,55,25,25,15,205,0.021739130434782608,80,80,80,55,55,90,440,0.6417910447761194,1.0
45,60,45,25,45,55,275,0.29,75,98,63,98,63,101,498,0.889763779527559,1.0
110,65,105,55,95,80,510,0.6258503401360545,65,55,115,100,40,60,435,0.3798449612403101,2.0
105,105,75,65,100,50,500,0.37593984962406013,30,45,135,45,90,30,375,0.09285714285714286,0.5
40,55,80,35,60,30,300,0.15037593984962405,80,92,65,65,80,68,450,0.4824561403508772,0.5
115,45,20,45,25,20,270,0.11538461538461539,75,98,63,98,63,101,498,0.849624060150376,1.0
91,90,72,90,129,108,580,0.896,62,55,52,109,94,109,481,0.7833333333333333,2.0
85,90,80,70,80,130,535,0.9262295081967213,90,95,105,165,110,45,610,0.2890625,0.5
103,93,67,71,61,84,479,0.7142857142857143,60,59,85,79,105,36,424,0.16666666666666666,2.0
60,85,40,30,45,68,328,0.6422018348623854,62,55,52,109,94,109,481,0.7833333333333333,2.0
110,130,80,70,60,80,530,0.5862068965517241,65,85,70,75,70,40,405,0.203125,2.0
20,15,20,10,55,80,200,0.2682926829268293,45,50,35,55,75,40,300,0.21367521367521367,0.5
80,80,80,80,80,80,480,0.6015037593984962,70,90,90,135,90,125,600,0.9401709401709402,1.0
91,72,90,129,90,108,580,0.8620689655172413,50,85,85,55,55,50,380,0.3902439024390244,1.0
45,55,39,35,39,42,255,0.18518518518518517,61,84,65,70,70,70,420,0.5,1.0
60,115,105,65,70,80,495,0.7181818181818181,28,25,25,45,35,40,198,0.16083916083916083,1.0
60,62,63,80,80,60,405,0.38016528925619836,45,45,35,20,30,20,195,0.07246376811594203,0.5
80,80,90,110,130,110,600,0.8721804511278195,67,89,116,79,116,33,500,0.2624113475177305,0.125
45,80,100,35,37,28,325,0.3125,90,70,80,70,95,70,475,0.5190839694656488,1.0
60,75,100,55,80,50,420,0.3088235294117647,40,45,35,30,40,55,245,0.3793103448275862,2.0
60,60,50,40,50,75,335,0.5882352941176471,55,65,35,60,30,85,330,0.6126126126126126,2.0
110,123,65,100,65,65,528,0.5217391304347826,65,65,60,110,95,130,525,0.9253731343283582,1.0
59,110,150,45,49,35,448,0.3333333333333333,65,85,70,75,70,40,405,0.203125,0.5
100,90,130,45,65,55,485,0.4253731343283582,70,150,140,65,100,75,600,0.55,1.0
45,53,70,40,60,42,310,0.25735294117647056,100,180,160,150,90,90,770,0.7520661157024794,0.5
110,78,73,76,71,60,468,0.3333333333333333,60,50,40,85,75,95,405,0.7540983606557377,2.0
60,40,50,75,85,95,405,0.6044776119402985,45,100,45,45,45,10,290,0.2949640287769784,0.0
95,155,109,70,130,81,640,0.6788321167883211,70,65,65,55,55,70,380,0.5,1.0
65,90,65,61,61,100,442,0.8373983739837398,108,112,118,68,72,47,525,0.2916666666666667,1.0
35,45,160,30,45,70,385,0.48148148148148145,75,95,125,45,75,95,510,0.8257575757575758,0.0
85,90,80,70,80,130,535,0.9262295081967213,60,50,40,85,75,95,405,0.7540983606557377,0.5
50,80,95,10,45,10,290,0.232,78,92,75,74,63,118,500,0.8842975206611571,1.0
65,55,115,100,40,60,435,0.3798449612403101,50,65,90,35,35,15,290,0.14678899082568808,0.5
101,72,72,99,89,29,462,0.1937984496124031,70,60,75,110,75,90,480,0.7165354330708661,1.0
63,60,55,50,50,71,349,0.5289256198347108,70,120,100,145,105,20,560,0.2824427480916031,1.0
65,155,120,65,90,105,600,0.8677685950413223,60,60,75,60,75,80,410,0.7321428571428571,2.0
85,73,70,73,115,67,483,0.5126050420168067,55,45,43,55,43,72,313,0.5853658536585366,0.5
74,48,76,83,81,104,466,0.7913043478260869,65,90,40,45,80,75,395,0.625,2.0
66,65,48,62,57,52,350,0.36220472440944884,60,85,42,85,42,91,405,0.8227848101265823,0.5
65,130,60,95,110,65,525,0.5303030303030303,100,5,5,15,65,30,220,0.07692307692307693,1.0
84,71,43,71,43,48,360,0.25874125874125875,70,105,105,50,40,20,390,0.33587786259541985,0.5
55,45,50,45,65,80,340,0.5546218487394958,65,105,60,60,70,95,455,63.0,2.0
52,65,55,58,62,60,352,0.4482758620689655,105,95,80,40,80,90,490,0.753968253968254,1.0
85,73,70,73,115,67,483,0.5126050420168067,80,80,90,110,130,110,600,0.8721804511278195,0.5
89,145,90,105,80,91,600,0.8549618320610687,108,170,115,120,95,92,700,0.7083333333333334,1.0
45,30,50,55,65,45,290,0.208,65,75,105,35,65,85,430,0.6940298507462687,2.0
45,49,49,65,65,45,318,0.2781954887218045,70,94,50,94,50,66,424,0.48148148148148145,0.25
80,105,105,105,105,80,580,0.5939849624060151,74,100,72,90,72,46,454,0.24561403508771928,1.0
108,130,95,80,85,102,600,0.7637795275590551,110,65,105,55,95,80,510,0.6258503401360545,0.0
90,60,70,75,70,45,410,0.23880597014925373,86,76,86,116,56,95,515,0.7982456140350878,2.0
108,112,118,68,72,47,525,0.2916666666666667,75,75,95,75,95,113,528,0.9015151515151515,0.5
75,90,50,110,80,95,500,0.7985611510791367,65,125,100,60,70,70,490,0.6099290780141844,1.0
50,47,50,57,50,65,319,0.463768115942029,70,120,100,145,105,20,560,0.2824427480916031,0.0
65,40,70,80,140,70,465,0.5954198473282443,80,52,50,90,50,89,411,0.6666666666666666,2.0
60,79,105,59,85,36,424,0.17054263565891473,55,85,55,50,55,60,360,0.4233576642335766,0.5
80,90,80,130,110,110,600,0.856,73,95,62,85,65,85,465,0.6666666666666666,1.0
59,63,80,65,80,58,405,0.41843971631205673,50,35,55,25,25,15,205,0.05263157894736842,1.0
50,55,50,36,30,43,264,0.2922077922077922,116,55,85,107,95,29,487,0.06818181818181818,1.0
53,51,53,61,56,40,314,0.14285714285714285,45,80,100,35,37,28,325,0.3125,1.0
55,65,95,95,45,85,440,0.6610169491525424,80,105,65,60,75,130,515,0.9645390070921985,2.0
55,70,45,70,50,60,350,0.45,55,104,105,94,75,52,485,0.36363636363636365,0.5
39,52,43,60,50,65,309,0.5041322314049587,75,85,200,55,65,30,510,0.16778523489932887,2.0
70,77,60,97,60,108,472,0.8394160583941606,99,68,83,72,87,51,460,0.417910447761194,1.0
67,82,62,46,48,43,348,0.22033898305084745,58,50,145,95,105,30,483,0.2459016393442623,0.0
50,20,55,25,25,30,205,0.09774436090225563,100,100,100,100,100,100,600,0.8778625954198473,1.0
50,50,150,50,150,50,500,0.2571428571428571,60,48,45,43,90,42,328,0.21897810218978103,1.0
64,115,65,83,63,65,455,0.5323741007194245,89,145,90,105,80,91,600,0.8549618320610687,1.0
50,65,90,35,35,15,290,0.14678899082568808,1,90,45,30,30,40,236,0.33064516129032256,0.5
60,60,60,35,35,30,280,0.11194029850746269,65,73,55,47,75,85,400,0.6846846846846847,1.0
115,115,85,90,75,100,580,0.8134328358208955,75,85,200,55,65,30,510,0.16778523489932887,2.0
50,72,35,35,35,65,292,0.5373134328358209,55,55,50,45,65,55,325,0.37373737373737376,1.0
250,5,5,35,105,50,450,0.15306122448979592,60,80,95,70,85,50,440,0.2231404958677686,0.5
50,20,40,20,40,20,190,0.0962962962962963,60,65,60,130,75,110,500,0.7719298245614035,0.0
80,100,80,80,80,100,520,0.9051724137931034,56,61,65,48,45,38,313,0.17567567567567569,0.5
86,92,88,68,75,73,482,0.6835443037974683,62,55,52,109,94,109,481,0.7833333333333333,1.0
77,85,51,55,51,65,384,0.5163934426229508,70,77,60,97,60,108,472,0.8394160583941606,1.0
70,77,60,97,60,108,472,0.8394160583941606,80,80,80,55,55,90,440,0.6417910447761194,1.0
70,55,55,80,60,45,365,0.2222222222222222,60,69,95,69,95,36,424,0.2608695652173913,1.0
60,65,60,130,75,110,500,0.7719298245614035,75,98,63,98,63,101,498,0.8091603053435115,2.0
45,55,39,35,39,42,255,0.18518518518518517,100,100,80,60,60,50,450,0.3050847457627119,1.0
40,45,65,100,120,90,460,0.5588235294117647,75,38,38,56,56,67,330,0.5263157894736842,1.0
75,90,90,140,90,115,600,0.9481481481481482,50,92,108,92,108,35,485,0.2457627118644068,1.0
74,48,76,83,81,104,466,0.7322834645669292,65,45,55,45,70,45,325,0.24369747899159663,1.0
40,60,30,31,31,70,262,0.4492753623188406,85,60,65,135,105,100,550,0.7518248175182481,2.0
50,75,70,35,70,48,348,0.29357798165137616,55,40,40,65,45,35,280,0.16428571428571428,1.0
50,80,95,10,45,10,290,0.232,90,55,75,60,75,30,385,0.13970588235294118,1.0
60,85,40,30,45,68,328,0.6422018348623854,41,50,37,50,37,66,281,0.5175438596491229,1.0
35,55,35,30,30,35,220,0.23684210526315788,73,76,75,81,100,100,505,0.8110236220472441,1.0
44,75,35,63,33,45,295,0.2647058823529412,48,61,40,61,40,50,300,0.2543859649122807,1.0
59,66,70,44,55,41,335,0.25190839694656486,61,72,57,55,55,65,365,0.3984375,0.5
60,62,80,63,80,60,405,0.4336283185840708,73,100,60,100,60,65,458,0.42657342657342656,0.5
45,35,45,62,53,35,275,0.11851851851851852,50,40,85,40,65,25,305,0.08870967741935484,0.5
90,60,70,75,70,45,410,0.23880597014925373,60,95,80,60,80,30,405,0.19480519480519481,1.0
100,128,90,77,77,128,600,0.959349593495935,100,134,110,95,100,61,600,0.4057971014492754,2.0
50,20,55,25,25,30,205,0.09774436090225563,50,50,50,50,50,50,300,0.30708661417322836,1.0
75,75,60,83,60,60,413,0.39344262295081966,60,85,40,30,45,68,328,0.6422018348623854,2.0
60,90,140,50,50,40,430,0.2535211267605634,80,90,80,130,110,110,600,0.856,1.0
80,135,85,70,95,150,615,0.9844961240310077,123,100,62,97,81,68,531,0.4806201550387597,2.0
85,100,122,58,75,54,494,0.3939393939393939,60,90,55,90,80,110,485,0.8677685950413223,1.0
45,85,50,55,50,65,350,0.5076923076923077,75,105,75,105,75,45,480,0.3274336283185841,1.0
80,125,75,40,95,85,500,0.6911764705882353,20,15,20,10,55,80,200,0.2682926829268293,1.0
85,120,70,50,60,100,485,0.8308823529411765,65,80,80,59,63,58,405,0.4411764705882353,1.0
57,24,86,24,86,23,300,0.12727272727272726,90,50,34,60,44,70,348,0.6283185840707964,1.0
40,65,40,80,40,65,330,0.5038167938931297,80,105,105,105,105,80,580,0.5939849624060151,2.0
65,63,45,45,45,45,308,0.2595419847328244,67,89,116,79,116,33,500,0.2624113475177305,2.0
50,65,107,105,107,86,520,0.6991150442477876,79,103,120,135,115,78,630,0.5763888888888888,1.0
95,110,80,70,80,50,485,0.37209302325581395,95,155,109,70,130,81,640,0.6788321167883211,0.5
80,125,75,40,95,85,500,0.6911764705882353,64,51,23,51,23,28,240,0.11363636363636363,2.0
64,66,68,81,76,50,405,0.25190839694656486,49,49,56,49,61,66,330,0.5190839694656488,0.5
80,100,70,50,60,45,405,0.25806451612903225,30,56,35,25,35,72,253,0.48148148148148145,2.0
82,80,86,85,75,72,480,0.6183206106870229,50,50,150,50,150,50,500,0.2571428571428571,1.0
80,50,100,100,200,50,580,0.2357142857142857,55,81,60,50,70,97,413,0.7214285714285714,1.0
44,38,39,61,79,42,303,0.2251655629139073,60,50,100,85,70,65,430,0.47580645161290325,1.0
55,45,50,45,65,80,340,0.5546218487394958,54,45,47,75,98,52,371,0.39669421487603307,1.0
30,105,90,25,25,50,325,0.2773722627737226,77,85,51,55,51,65,384,0.5163934426229508,1.0
70,70,70,70,70,70,420,0.5289256198347108,52,65,55,58,62,60,352,0.4482758620689655,1.0
60,80,50,50,50,40,330,0.23853211009174313,55,40,50,65,85,40,335,0.3181818181818182,0.0
100,103,75,120,75,127,600,0.940677966101695,50,160,110,160,110,110,700,0.8854961832061069,1.0
25,35,70,95,55,45,325,0.16783216783216784,58,109,112,48,48,109,484,0.8805970149253731,0.5
60,50,100,85,70,65,430,0.47580645161290325,75,125,70,125,70,115,580,0.9037037037037037,1.0
20,15,20,10,55,80,200,0.2682926829268293,100,100,80,60,60,50,450,0.3050847457627119,2.0
65,85,70,75,70,40,405,0.203125,60,55,50,40,55,45,305,0.22377622377622378,1.0
45,49,49,65,65,45,318,0.2781954887218045,70,43,53,43,53,40,302,0.19090909090909092,0.25
45,60,32,50,32,76,295,0.5925925925925926,79,85,60,55,60,71,410,0.60431654676259,2.0
78,84,78,109,85,100,534,0.8646616541353384,44,48,65,50,64,43,314,0.1623931623931624,0.5
75,55,70,55,95,110,460,0.8444444444444444,60,85,69,65,79,80,438,0.576,0.5
44,50,91,24,86,10,305,0.1981981981981982,75,80,55,25,35,35,305,0.18666666666666668,1.0
60,40,50,75,85,95,405,0.6044776119402985,55,45,45,25,25,15,210,0.048,0.0
52,65,50,45,50,38,300,0.27419354838709675,65,45,55,45,70,45,325,0.24369747899159663,1.0
62,73,55,56,52,84,382,0.7244094488188977,50,25,28,45,55,15,218,0.0625,1.0
75,95,95,95,95,85,540,0.6470588235294118,71,120,95,120,95,99,600,0.8203125,0.5
60,40,60,95,60,55,370,0.4222222222222222,25,35,70,95,55,45,325,0.16783216783216784,2.0
55,40,40,65,45,35,280,0.16428571428571428,65,90,65,61,61,100,442,0.8373983739837398,2.0
52,65,50,45,50,38,300,0.27419354838709675,90,92,75,92,85,60,494,0.49586776859504134,1.0
123,100,62,97,81,68,531,0.4806201550387597,90,55,75,60,75,30,385,0.13970588235294118,1.0
105,140,55,30,55,95,480,0.8195488721804511,38,41,40,50,65,65,299,0.4108527131782946,0.5
75,95,122,58,75,69,494,0.5725806451612904,50,85,85,55,55,50,380,0.3902439024390244,0.5
60,40,60,95,60,55,370,0.4222222222222222,60,69,95,69,95,36,424,0.2608695652173913,4.0
70,92,65,80,55,98,460,0.8090909090909091,95,75,180,130,80,30,590,0.13793103448275862,0.5
50,64,50,45,50,41,300,0.22727272727272727,45,50,55,75,65,30,320,0.06293706293706294,1.0
100,128,90,77,77,128,600,0.959349593495935,50,65,107,105,107,86,520,0.703125,2.0
55,40,40,65,45,35,280,0.16428571428571428,75,98,63,98,63,101,498,0.889763779527559,1.0
44,38,33,61,43,70,289,0.5267857142857143,55,50,65,175,95,150,590,0.7818181818181819,1.0
45,55,45,65,45,75,330,0.5692307692307692,65,125,100,60,70,70,490,0.6099290780141844,0.25
60,85,69,65,79,80,438,0.576,109,66,84,81,99,32,471,0.2013888888888889,0.5
75,85,200,55,65,30,510,0.16778523489932887,65,95,75,55,55,85,430,0.6933333333333334,1.0
100,120,100,150,120,90,680,0.728,67,58,57,81,67,101,431,0.8790322580645161,0.0
79,103,120,135,115,78,630,0.5763888888888888,108,112,118,68,72,47,525,0.2916666666666667,2.0
55,55,45,63,45,45,308,0.25,40,80,35,35,45,70,305,0.4661016949152542,1.0
65,90,50,85,45,55,390,0.371900826446281,90,100,90,125,85,90,580,0.7352941176470589,0.25
65,65,45,75,45,95,390,0.72,75,90,140,60,60,40,465,0.3008130081300813,0.5
65,65,60,130,95,110,525,0.823943661971831,65,90,50,85,45,55,390,0.371900826446281,2.0
70,85,65,105,85,120,530,0.9262295081967213,50,75,35,70,30,40,300,0.21296296296296297,0.25
40,45,40,62,60,60,307,0.33884297520661155,64,66,68,81,76,50,405,0.25190839694656486,0.5
82,121,119,69,59,71,521,0.5394736842105263,60,48,45,43,90,42,328,0.21897810218978103,1.0
40,30,35,50,70,55,280,0.28205128205128205,78,104,78,159,115,100,634,0.8444444444444444,0.25
50,120,53,35,110,87,455,0.640625,85,73,70,73,115,67,483,0.5126050420168067,0.5
90,120,100,150,120,100,680,0.7718120805369127,75,75,55,105,85,30,425,0.1619718309859155,0.5
67,58,57,81,67,101,431,0.8790322580645161,70,70,115,130,90,60,535,0.5338983050847458,0.25
91,90,129,90,72,108,580,0.9140625,60,90,140,50,50,40,430,0.2535211267605634,4.0
40,50,90,30,55,65,330,0.44680851063829785,60,75,85,100,85,115,520,0.8992248062015504,2.0
65,85,70,75,70,40,405,0.203125,105,180,100,180,100,115,780,0.9477611940298507,1.0
41,56,40,62,44,71,314,0.568,60,30,30,36,56,50,262,0.32432432432432434,1.0
72,105,115,54,86,68,500,0.5149253731343284,50,50,50,50,50,50,300,0.30708661417322836,2.0
50,100,150,100,150,50,600,0.37142857142857144,70,80,70,80,70,110,480,0.6594202898550725,2.0
71,120,95,120,95,99,600,0.8203125,55,85,122,58,75,99,494,0.8099173553719008,1.0
50,92,108,92,108,35,485,0.2457627118644068,105,95,80,40,80,90,490,0.753968253968254,0.0
43,30,55,40,65,97,330,0.6030534351145038,75,125,75,30,75,85,465,0.625,1.0
70,70,40,60,40,60,340,0.4247787610619469,61,90,45,50,50,160,456,0.9230769230769231,0.25
106,150,70,194,120,140,780,0.952,190,33,58,33,58,33,405,0.13432835820895522,0.5
63,120,85,90,55,55,468,0.2809917355371901,55,20,35,20,45,75,250,0.37681159420289856,1.0
50,65,64,44,48,43,314,0.2196969696969697,84,71,43,71,43,48,360,0.25874125874125875,1.0
70,150,140,65,100,75,600,0.55,35,55,40,45,40,60,275,0.35714285714285715,0.5
25,35,70,95,55,45,325,0.16783216783216784,60,40,50,75,85,95,405,0.6044776119402985,0.25
43,70,48,50,60,38,309,0.2391304347826087,80,80,90,110,130,110,600,0.8721804511278195,1.0
74,100,72,90,72,46,454,0.24561403508771928,40,30,35,45,40,55,245,0.31496062992125984,0.25
62,48,54,63,60,68,355,0.5178571428571429,80,80,80,55,55,90,440,0.6417910447761194,1.0
39,52,43,60,50,65,309,0.49107142857142855,74,100,72,90,72,46,454,0.24561403508771928,2.0
90,30,15,40,20,15,210,0.043478260869565216,69,69,76,69,86,91,460,0.6554621848739496,1.0
79,85,60,55,60,71,410,0.60431654676259,86,81,97,81,107,43,495,0.203125,0.5
45,53,70,40,60,42,310,0.25735294117647056,75,98,63,98,63,101,498,0.889763779527559,0.25
78,81,71,74,69,126,499,0.9090909090909091,95,85,85,65,65,35,430,0.2571428571428571,0.5
90,75,75,90,100,70,500,0.5462184873949579,68,75,53,83,113,60,452,0.45384615384615384,0.5
60,110,70,60,60,100,460,0.8461538461538461,60,90,70,60,120,40,440,0.27419354838709675,1.0
80,82,100,83,100,80,525,0.6821705426356589,65,90,122,58,75,84,494,0.71875,0.5
45,65,34,40,34,45,263,0.2589928057553957,62,73,55,56,52,84,382,0.7244094488188977,2.0
65,65,60,130,95,110,525,0.823943661971831,100,180,160,150,90,90,770,0.7520661157024794,2.0
45,20,50,60,120,50,345,0.24074074074074073,125,130,90,130,90,95,660,0.7734375,0.5
90,130,80,65,85,55,505,0.4396551724137931,55,63,90,50,80,42,380,0.21138211382113822,0.5
85,70,80,97,80,123,535,0.9304347826086956,50,120,53,35,110,87,455,0.640625,2.0
50,95,95,35,110,70,455,0.5179856115107914,40,70,130,60,130,25,455,0.17355371900826447,0.0
50,40,85,40,65,25,305,0.08870967741935484,60,30,30,36,56,50,262,0.32432432432432434,0.5
100,100,100,100,100,100,600,0.8805970149253731,35,35,35,35,35,35,210,0.13385826771653545,1.0
45,85,50,55,50,65,350,0.5076923076923077,70,60,62,80,82,60,414,0.4375,0.25
70,105,105,50,40,20,390,0.33587786259541985,126,131,95,131,98,99,680,0.8294573643410853,1.0
110,80,90,95,90,65,530,0.5033557046979866,55,55,45,63,45,45,308,0.25,0.25
85,110,76,65,82,56,474,0.3933333333333333,60,62,80,63,80,60,405,0.4336283185840708,0.5
90,85,100,95,125,85,580,0.6834532374100719,165,75,80,40,45,65,470,0.5151515151515151,0.5
55,84,105,114,75,52,485,0.2890625,59,110,150,45,49,35,448,0.3333333333333333,1.0
105,125,100,60,100,100,590,0.8359375,35,40,100,90,55,35,355,0.1796875,0.5
80,100,70,60,70,95,475,0.7416666666666667,45,49,65,49,65,45,318,0.275,0.5
105,150,90,150,90,95,680,0.8285714285714286,80,70,40,100,60,145,495,0.921875,2.0
90,75,85,115,90,55,510,0.3445378151260504,40,45,65,100,120,90,460,0.5588235294117647,1.0
50,75,70,35,70,48,348,0.29357798165137616,70,115,60,115,60,55,475,0.4647887323943662,1.0
45,75,37,70,55,83,365,0.6183206106870229,85,56,77,50,77,78,423,0.53125,1.0
65,90,50,85,45,55,390,0.371900826446281,85,115,80,105,80,50,515,0.3063063063063063,1.0
55,45,43,55,43,72,313,0.5853658536585366,80,135,130,95,90,70,600,0.5181818181818182,0.125
72,95,67,103,71,122,530,0.9606299212598425,65,65,60,130,95,110,525,0.823943661971831,2.0
100,128,90,77,77,128,600,0.959349593495935,88,107,122,74,75,64,530,0.4596774193548387,1.0
130,85,80,85,95,60,535,0.43884892086330934,30,45,135,45,90,30,375,0.09285714285714286,2.0
58,64,58,80,65,80,405,0.609271523178808,70,94,50,94,50,66,424,0.48148148148148145,2.0
44,75,35,63,33,45,295,0.2647058823529412,40,65,40,80,40,65,330,0.5038167938931297,0.5
60,95,80,60,80,30,405,0.19480519480519481,190,33,58,33,58,33,405,0.13432835820895522,2.0
30,30,42,30,42,70,244,0.4230769230769231,75,98,63,98,63,101,498,0.889763779527559,0.5
37,25,41,25,41,25,194,0.08870967741935484,55,130,115,50,50,75,475,0.5982142857142857,1.0
40,80,100,30,30,20,300,0.11851851851851852,72,58,80,103,80,97,490,0.7171052631578947,0.0
50,30,55,65,55,20,275,0.13675213675213677,60,95,80,60,80,30,405,0.19480519480519481,4.0
30,65,100,45,25,40,305,0.1891891891891892,60,60,60,60,60,60,360,0.38095238095238093,1.0
54,66,70,44,55,46,335,0.4214876033057851,38,36,38,32,36,57,237,0.3893805309734513,0.0
65,75,105,35,65,85,430,0.6940298507462687,165,75,80,40,45,65,470,0.5151515151515151,1.0
86,76,86,116,56,95,515,0.7982456140350878,115,140,130,55,55,40,535,0.4519230769230769,0.5
90,60,70,75,70,45,410,0.23880597014925373,35,46,34,35,45,20,215,0.072,1.0
65,90,65,61,61,100,442,0.8373983739837398,59,74,50,35,50,35,303,0.3125,0.0
70,110,180,60,60,50,530,0.4117647058823529,90,55,75,60,75,30,385,0.13970588235294118,1.0
70,43,53,43,53,40,302,0.19090909090909092,85,105,55,85,50,115,495,0.9032258064516129,1.0
110,65,75,125,85,30,490,0.15,35,70,55,45,55,25,285,0.09420289855072464,1.0
40,45,40,35,35,56,251,0.373015873015873,73,100,60,100,60,65,458,0.42657342657342656,1.0
64,88,50,88,50,106,446,0.9111111111111111,50,100,150,100,150,50,600,0.37142857142857144,0.5
54,63,52,83,56,97,405,0.7697841726618705,35,55,40,45,40,60,275,0.35714285714285715,1.0
35,65,35,65,35,65,300,0.46621621621621623,90,120,100,150,120,100,680,0.7718120805369127,0.25
60,60,50,40,50,75,335,0.5882352941176471,50,75,70,35,70,48,348,0.29357798165137616,1.0
40,80,100,30,30,20,300,0.11851851851851852,85,90,80,70,80,130,535,0.9262295081967213,0.0
60,40,50,75,85,95,405,0.6044776119402985,95,124,78,69,71,58,495,0.37398373983739835,1.0
52,65,50,45,50,38,300,0.27419354838709675,78,52,60,63,65,23,341,0.06015037593984962,0.0
77,120,90,60,90,48,485,0.2785714285714286,95,110,95,40,95,55,490,0.40336134453781514,1.0
70,90,110,60,75,95,500,0.7333333333333333,70,135,105,60,105,20,495,0.5806451612903226,0.0
70,50,30,95,135,105,485,0.8040540540540541,60,150,50,150,50,60,520,0.5,0.5
50,50,50,50,50,50,300,0.30708661417322836,65,40,70,80,140,70,465,0.5954198473282443,1.0
60,80,50,50,50,40,330,0.23853211009174313,77,59,50,67,63,46,362,0.23140495867768596,0.5
65,47,55,73,75,85,400,0.65,92,105,90,125,90,98,600,0.8217054263565892,2.0
38,41,40,50,65,65,299,0.4108527131782946,79,115,70,125,80,111,580,0.864,1.0
105,140,55,30,55,95,480,0.8195488721804511,50,95,180,85,45,70,525,0.5298507462686567,1.0
35,60,44,40,54,55,288,0.366412213740458,50,70,160,70,160,90,600,0.7417218543046358,1.0
125,170,100,120,90,95,700,0.77,45,50,55,75,65,30,320,0.06293706293706294,2.0
92,105,90,125,90,98,600,0.8217054263565892,45,50,43,40,38,62,278,0.40441176470588236,1.0
75,95,67,125,95,83,540,0.7117117117117117,70,110,80,55,80,105,500,0.8794326241134752,2.0
45,60,30,80,50,65,330,0.4603174603174603,65,63,45,45,45,45,308,0.2595419847328244,0.5
80,75,150,75,150,50,580,0.30973451327433627,70,20,50,20,50,40,250,0.1557377049180328,0.25
40,65,95,60,45,35,340,0.13986013986013987,60,115,105,65,70,80,495,0.7181818181818181,0.5
70,140,230,60,80,50,630,0.32432432432432434,57,80,91,80,87,75,470,0.5737704918032787,0.25
105,95,80,40,80,90,490,0.753968253968254,75,90,140,60,60,40,465,0.3008130081300813,0.5
50,105,125,55,95,50,480,0.375886524822695,55,70,45,70,50,60,350,0.45,0.25
57,24,86,24,86,23,300,0.12727272727272726,60,60,60,35,35,30,280,0.11194029850746269,1.0
60,60,60,35,35,30,280,0.11194029850746269,95,75,80,100,110,30,490,0.24242424242424243,1.0
130,65,60,110,95,65,525,0.5227272727272727,50,70,160,70,160,90,600,0.7417218543046358,1.0
50,65,107,105,107,86,520,0.7313432835820896,40,55,99,40,79,47,360,0.26262626262626265,0.25
95,60,79,100,125,81,540,0.6201550387596899,45,20,50,60,120,50,345,0.24074074074074073,0.5
74,48,76,83,81,104,466,0.7322834645669292,70,120,100,145,105,20,560,0.2824427480916031,2.0
75,75,130,75,130,95,580,0.7479674796747967,49,49,56,49,61,66,330,0.5190839694656488,1.0
65,95,57,100,85,93,495,0.7441860465116279,85,115,80,105,80,50,515,0.3063063063063063,1.0
65,60,110,130,95,65,525,0.47761194029850745,70,90,45,15,45,50,315,0.3629032258064516,0.5
100,75,115,90,115,85,580,0.6446280991735537,123,100,62,97,81,68,531,0.4806201550387597,0.5
68,165,95,65,115,110,618,0.8615384615384616,123,100,62,97,81,68,531,0.4806201550387597,1.0
55,63,90,50,80,42,380,0.21138211382113822,54,45,47,75,98,52,371,0.39669421487603307,0.5
45,50,55,75,65,30,320,0.06293706293706294,60,55,90,145,90,80,520,0.6071428571428571,0.25
95,155,109,70,130,81,640,0.6788321167883211,55,40,50,65,85,40,335,0.3181818181818182,1.0
105,105,75,65,100,50,500,0.37593984962406013,91,129,90,72,90,108,580,0.8536585365853658,0.5
90,92,75,92,85,60,494,0.49586776859504134,68,125,65,65,115,80,518,0.6277372262773723,1.0
90,60,70,75,70,45,410,0.23880597014925373,255,10,10,75,135,55,540,0.3125,1.0
50,70,50,50,50,40,310,0.16296296296296298,95,145,130,120,90,120,700,0.9398496240601504,0.5
90,60,60,40,40,40,330,0.29545454545454547,40,50,45,70,45,70,320,0.5517241379310345,0.0
80,100,70,60,70,95,475,0.7416666666666667,45,80,100,35,37,28,325,0.3125,0.0
72,105,115,54,86,68,500,0.5149253731343284,70,110,80,55,80,105,500,0.8794326241134752,4.0
116,55,85,107,95,29,487,0.06818181818181818,60,110,70,60,60,100,460,0.8461538461538461,1.0
65,76,84,54,96,105,480,0.9008264462809917,50,53,48,53,48,64,316,0.46153846153846156,1.0
70,60,125,115,70,55,495,0.35507246376811596,65,90,115,45,115,58,488,0.5041322314049587,0.5
40,40,55,40,70,55,300,0.40939597315436244,100,128,90,77,77,128,600,0.959349593495935,1.0
40,50,90,30,55,65,330,0.44680851063829785,45,35,45,62,53,35,275,0.11851851851851852,4.0
70,145,88,140,70,112,625,0.8888888888888888,90,92,87,75,85,76,505,0.5409836065573771,0.5
45,85,50,55,50,65,350,0.5076923076923077,103,93,67,71,61,84,479,0.7142857142857143,1.0
75,90,90,140,90,115,600,0.9481481481481482,79,103,120,135,115,78,630,0.5763888888888888,0.5
75,95,125,45,75,95,510,0.8257575757575758,40,60,30,31,31,70,262,0.4492753623188406,0.0
90,120,120,60,60,50,500,0.35294117647058826,51,65,65,80,75,59,395,0.4365079365079365,1.0
80,105,105,105,105,80,580,0.5939849624060151,250,5,5,35,105,50,450,0.15306122448979592,1.0
65,55,115,100,40,60,435,0.3798449612403101,75,100,66,60,66,115,482,0.918918918918919,1.0
60,67,85,77,75,116,480,0.8888888888888888,40,30,32,50,52,65,269,0.3671875,1.0
95,75,110,100,80,30,490,0.15267175572519084,85,60,65,135,105,100,550,0.7518248175182481,2.0
89,145,90,105,80,91,600,0.8549618320610687,54,45,47,75,98,52,371,0.39669421487603307,1.0
55,68,64,45,55,31,318,0.11666666666666667,60,90,55,90,80,110,485,0.8677685950413223,1.0
115,45,20,45,25,20,270,0.11538461538461539,63,63,47,41,41,74,329,0.56,1.0
62,77,62,50,42,65,358,0.4838709677419355,63,120,85,90,55,55,468,0.2809917355371901,1.0
100,73,83,73,83,55,467,0.371900826446281,60,85,40,30,45,68,328,0.6422018348623854,0.5
65,125,100,55,70,85,500,0.6532258064516129,90,75,85,115,90,55,510,0.3445378151260504,1.0
45,50,55,75,65,30,320,0.06293706293706294,95,75,80,100,110,30,490,0.24242424242424243,2.0
75,125,230,55,95,30,610,0.3448275862068966,65,90,122,58,75,84,494,0.71875,0.5
60,40,80,60,45,40,325,0.23529411764705882,75,105,75,105,75,45,480,0.3274336283185841,2.0
45,85,70,40,40,60,340,0.5229357798165137,80,45,65,90,110,80,470,0.5462962962962963,2.0
55,35,50,55,110,85,390,0.6277372262773723,70,140,70,110,65,105,560,0.95,2.0
40,55,99,40,79,47,360,0.26262626262626265,85,110,90,45,90,80,500,0.6206896551724138,1.0
70,85,70,60,70,50,405,0.28378378378378377,50,60,45,100,80,65,400,0.45689655172413796,0.5
75,95,122,58,75,69,494,0.5725806451612904,50,52,48,65,50,55,320,0.33098591549295775,2.0
95,80,105,40,70,100,490,0.8046875,20,10,230,10,230,5,505,0.0,0.5
85,80,70,135,75,90,535,0.7006802721088435,90,100,90,125,85,90,580,0.7352941176470589,1.0
80,120,79,95,79,70,523,0.5833333333333334,101,72,72,99,89,29,462,0.1937984496124031,1.0
100,100,100,100,100,100,600,0.8805970149253731,48,61,40,61,40,50,300,0.2543859649122807,1.0
75,95,67,125,95,83,540,0.7117117117117117,38,30,41,30,41,60,240,0.2897196261682243,1.0
70,95,125,65,75,45,475,0.33613445378151263,60,130,80,60,60,70,460,0.5153846153846153,0.5
30,56,35,25,35,72,253,0.48148148148148145,110,160,110,80,110,100,670,0.8591549295774648,1.0
45,65,34,40,34,45,263,0.2589928057553957,68,90,65,50,55,82,410,0.6165413533834586,0.0
60,85,49,60,49,60,363,0.4444444444444444,80,80,50,40,50,25,325,0.176056338028169,1.0
60,70,65,125,105,90,515,0.6911764705882353,60,130,80,60,60,70,460,0.5153846153846153,1.0
82,121,119,69,59,71,521,0.5394736842105263,61,78,95,56,58,57,405,0.40336134453781514,1.0
58,109,112,48,48,109,484,0.8805970149253731,40,70,40,35,40,60,285,0.392,0.5
38,30,85,55,65,30,303,0.21428571428571427,72,95,67,103,71,122,530,0.9606299212598425,0.5
105,30,105,140,105,55,540,0.3524590163934426,80,105,65,60,75,130,515,0.9645390070921985,0.5
126,131,95,131,98,99,680,0.8294573643410853,50,85,85,55,55,50,380,0.3902439024390244,0.5
62,48,54,63,60,68,355,0.5178571428571429,85,50,95,120,115,80,545,0.5793650793650794,1.0
61,78,95,56,58,57,405,0.40336134453781514,55,40,85,80,105,40,405,0.23622047244094488,0.5
65,150,40,15,80,145,495,0.9663865546218487,60,79,105,59,85,36,424,0.17054263565891473,0.5
92,105,90,125,90,98,600,0.8217054263565892,60,40,80,60,45,40,325,0.23529411764705882,2.0
77,59,50,67,63,46,362,0.23140495867768596,65,90,65,61,61,100,442,0.8373983739837398,4.0
80,80,80,80,80,80,480,0.5606060606060606,69,55,45,55,55,15,294,0.11666666666666667,0.5
50,53,48,53,48,64,316,0.4076923076923077,125,58,58,76,76,67,460,0.515625,2.0
100,128,90,77,77,128,600,0.959349593495935,95,155,109,70,130,81,640,0.6788321167883211,2.0
50,95,180,85,45,70,525,0.5298507462686567,50,85,40,85,40,35,335,0.1746031746031746,1.0
95,145,130,120,90,120,700,0.9398496240601504,79,105,70,145,80,101,580,0.8608695652173913,0.5
80,80,90,110,130,110,600,0.8721804511278195,28,25,25,45,35,40,198,0.16083916083916083,0.0
64,78,52,78,52,81,405,0.6422764227642277,64,165,75,93,83,75,555,0.6587301587301587,0.0
40,30,30,55,30,85,270,0.4666666666666667,40,40,50,30,30,30,220,0.0873015873015873,1.0
70,55,75,45,65,60,370,0.45901639344262296,150,100,120,100,120,90,680,0.6666666666666666,2.0
56,61,65,48,45,38,313,0.17567567567567569,75,75,130,75,130,95,580,0.7479674796747967,1.0
90,92,75,92,85,60,494,0.49586776859504134,89,145,90,105,80,91,600,0.8549618320610687,4.0
38,35,35,65,55,50,278,0.2647058823529412,75,90,140,60,60,40,465,0.3008130081300813,0.25
108,112,118,68,72,47,525,0.2916666666666667,60,75,100,55,80,50,420,0.3088235294117647,2.0
65,90,65,61,61,100,442,0.8373983739837398,105,180,100,180,100,115,780,0.9477611940298507,1.0
84,71,43,71,43,48,360,0.25874125874125875,100,100,100,100,100,100,600,0.8758169934640523,0.5
120,100,85,30,85,45,465,0.22448979591836735,100,50,50,76,96,70,442,0.5,1.0
40,40,50,30,30,30,220,0.0873015873015873,52,65,55,58,62,60,352,0.4482758620689655,0.5
91,90,106,130,106,77,600,0.648854961832061,65,75,90,97,123,44,494,0.1987179487179487,0.5
90,60,60,40,40,40,330,0.29545454545454547,55,20,35,20,45,75,250,0.37681159420289856,1.0
60,62,80,63,80,60,405,0.4336283185840708,79,85,60,55,60,71,410,0.60431654676259,2.0
45,53,70,40,60,42,310,0.25735294117647056,70,150,140,65,100,75,600,0.55,0.125
45,95,50,40,50,75,355,0.54,45,35,45,62,53,35,275,0.11851851851851852,2.0
80,100,200,50,100,50,580,0.3472222222222222,46,87,60,30,40,57,320,0.37777777777777777,1.0
45,60,32,50,32,76,295,0.5925925925925926,75,75,60,83,60,60,413,0.39344262295081966,2.0
75,70,90,70,105,80,490,0.656,60,67,85,77,75,116,480,0.8888888888888888,0.0
52,65,55,58,62,60,352,0.4482758620689655,45,95,50,40,50,75,355,0.54,0.5
60,62,50,62,60,40,334,0.18181818181818182,126,131,95,131,98,99,680,0.8102189781021898,1.0
40,30,35,45,40,55,245,0.31496062992125984,39,52,43,60,50,65,309,0.5041322314049587,1.0
150,100,120,100,120,90,680,0.6666666666666666,75,100,95,40,70,110,490,0.8717948717948718,0.0
89,125,90,115,80,101,600,0.8725490196078431,75,125,70,125,70,115,580,0.9037037037037037,1.0
70,85,70,60,70,50,405,0.28378378378378377,75,95,125,45,75,95,510,0.8257575757575758,0.0
75,103,80,70,80,92,500,0.7933884297520661,55,50,40,40,40,75,300,0.5945945945945946,1.0
35,65,35,65,35,65,300,0.46621621621621623,68,72,78,38,42,32,330,0.23809523809523808,2.0
74,48,76,83,81,104,466,0.7322834645669292,65,40,50,125,60,30,370,0.07258064516129033,0.5
60,70,50,100,50,65,395,0.5217391304347826,53,51,53,61,56,40,314,0.14285714285714285,1.0
91,72,90,129,90,108,580,0.8925619834710744,105,130,120,45,45,40,485,0.4444444444444444,8.0
100,120,120,150,100,90,680,0.7880794701986755,50,92,108,92,108,35,485,0.2457627118644068,1.0
55,45,45,25,25,15,210,0.048,70,80,65,90,65,85,455,0.578125,1.0
50,72,35,35,35,65,292,0.5373134328358209,78,70,61,50,61,100,420,0.8145161290322581,1.0
65,65,45,75,45,95,390,0.72,62,50,58,73,54,72,369,0.4435483870967742,0.5
70,62,67,55,55,56,365,0.38513513513513514,95,124,78,69,71,58,495,0.37398373983739835,1.0
45,53,70,40,60,42,310,0.25735294117647056,50,48,43,46,41,60,288,0.47297297297297297,4.0
85,80,90,105,95,60,515,0.49074074074074076,100,123,75,57,75,80,510,0.6923076923076923,1.0
70,140,70,110,65,105,560,0.95,65,136,94,54,96,135,580,0.9612403100775194,0.5
55,63,90,50,80,42,380,0.21138211382113822,90,100,60,90,60,80,480,0.6422764227642277,2.0
80,82,100,83,100,80,525,0.6821705426356589,54,45,47,75,98,52,371,0.39669421487603307,1.0
76,65,45,92,42,91,411,0.7449664429530202,60,60,40,65,45,35,305,0.15833333333333333,1.0
90,120,75,60,60,45,450,0.29411764705882354,65,95,100,60,50,50,420,0.34959349593495936,2.0
80,100,70,60,70,95,475,0.7416666666666667,55,85,55,50,55,60,360,0.4233576642335766,0.25
40,45,65,100,120,90,460,0.5588235294117647,65,83,57,95,85,105,490,0.8914728682170543,1.0
90,65,65,40,40,15,315,0.19672131147540983,40,65,95,60,45,35,340,0.13986013986013987,2.0
40,55,30,30,30,85,270,0.688,60,60,50,40,50,75,335,0.5882352941176471,2.0
80,82,100,83,100,80,525,0.6821705426356589,20,40,15,35,35,60,205,0.34285714285714286,1.0
58,109,112,48,48,109,484,0.8805970149253731,74,48,76,83,81,104,466,0.7913043478260869,2.0
50,53,48,53,48,64,316,0.46153846153846156,70,60,62,80,82,60,414,0.4375,2.0
90,55,75,60,75,30,385,0.13970588235294118,95,70,73,95,90,60,483,0.3983739837398374,1.0
55,50,40,40,40,75,300,0.5945945945945946,79,103,120,135,115,78,630,0.5763888888888888,1.0
60,60,50,40,50,75,335,0.5882352941176471,70,150,140,65,100,75,600,0.55,0.125
100,70,70,65,65,45,415,0.1897810218978102,105,130,120,45,45,40,485,0.4444444444444444,0.5
65,90,50,85,45,55,390,0.371900826446281,91,134,95,100,100,80,600,0.6304347826086957,0.25
80,110,120,130,90,70,600,0.6198347107438017,75,90,50,110,80,95,500,0.7985611510791367,1.0
78,84,78,109,85,100,534,0.8620689655172413,90,100,70,110,150,80,600,0.6037735849056604,0.5
50,50,95,40,50,35,320,0.20279720279720279,53,51,53,61,56,40,314,0.14285714285714285,1.0
45,25,50,25,25,35,205,0.13076923076923078,65,90,122,58,75,84,494,0.71875,1.0
75,90,90,140,90,115,600,0.9481481481481482,50,52,48,65,50,55,320,0.33098591549295775,0.5
60,65,60,130,75,110,500,0.7719298245614035,97,165,60,65,50,58,495,0.3902439024390244,0.5
78,65,68,112,154,75,552,0.628099173553719,40,30,35,50,70,55,280,0.28205128205128205,0.5
110,65,105,55,95,80,510,0.6258503401360545,59,74,50,35,50,35,303,0.3125,2.0
50,50,95,40,50,35,320,0.20279720279720279,60,60,60,105,105,105,495,0.848,1.0
50,50,40,50,40,64,294,0.45588235294117646,85,60,65,135,105,100,550,0.7518248175182481,2.0
75,100,110,45,55,65,450,0.5333333333333333,43,30,55,40,65,97,330,0.6030534351145038,1.0
130,70,35,70,35,60,400,0.4017857142857143,40,55,30,30,30,85,270,0.688,1.0
50,65,85,35,35,55,325,0.32575757575757575,70,80,65,90,65,85,455,0.578125,2.0
65,90,40,45,80,75,395,0.625,75,125,230,55,95,30,610,0.3448275862068966,0.0
60,80,95,70,85,50,440,0.2231404958677686,80,90,80,130,110,110,600,0.856,1.0
105,180,100,180,100,115,780,0.9477611940298507,100,164,150,95,120,71,700,0.5645161290322581,0.5
57,24,86,24,86,23,300,0.12727272727272726,80,80,80,55,55,90,440,0.6417910447761194,1.0
55,47,52,40,40,41,275,0.16806722689075632,75,95,122,58,75,69,494,0.5725806451612904,1.0
55,69,85,32,35,28,304,0.09302325581395349,70,150,140,65,100,75,600,0.55,0.5
50,105,125,55,95,50,480,0.375886524822695,70,75,60,105,60,105,475,0.88,0.5
65,90,50,85,45,55,390,0.371900826446281,60,80,110,50,80,45,425,0.2833333333333333,1.0
50,25,28,45,55,15,218,0.0625,45,100,135,65,135,45,525,0.29411764705882354,1.0
73,95,62,85,65,85,465,0.6666666666666666,89,124,80,55,80,55,483,0.5714285714285714,0.0
65,130,60,75,60,75,465,0.689922480620155,50,47,50,57,50,65,319,0.463768115942029,1.0
100,100,90,150,140,90,670,0.71875,40,30,50,55,55,100,330,0.584070796460177,1.0
86,68,72,109,66,106,507,0.8099173553719008,80,80,80,55,55,90,440,0.6417910447761194,1.0
150,160,100,95,65,100,670,0.8866666666666667,60,50,70,50,90,65,385,0.39568345323741005,1.0
70,130,100,55,80,65,500,0.608,90,70,80,70,95,70,475,0.5190839694656488,1.0
85,56,77,50,77,78,423,0.53125,40,40,40,70,40,20,250,0.032520325203252036,2.0
40,50,90,30,55,65,330,0.44680851063829785,45,67,60,35,50,63,320,0.5128205128205128,1.0
100,50,50,76,96,70,442,0.5,80,100,80,80,80,100,520,0.9051724137931034,1.0
70,80,65,90,65,85,455,0.578125,30,56,35,25,35,72,253,0.48148148148148145,1.0
55,45,45,25,25,15,210,0.048,95,75,110,100,80,30,490,0.15267175572519084,0.5
45,25,50,25,25,35,205,0.13076923076923078,90,70,80,70,95,70,475,0.5190839694656488,1.0
64,51,23,51,23,28,240,0.11363636363636363,105,140,55,30,55,95,480,0.8195488721804511,1.0
125,130,90,130,90,95,660,0.7734375,60,60,50,40,50,75,335,0.5882352941176471,2.0
70,120,100,145,105,20,560,0.2824427480916031,70,60,70,87,78,85,450,0.6228070175438597,1.0
150,100,120,100,120,90,680,0.6666666666666666,65,55,115,100,40,60,435,0.3798449612403101,1.0
63,60,55,50,50,71,349,0.5289256198347108,40,27,60,37,50,66,280,0.36220472440944884,2.0
95,110,95,40,95,55,490,0.40336134453781514,60,150,50,150,50,60,520,0.5,0.0
70,77,60,97,60,108,472,0.8394160583941606,72,95,67,103,71,122,530,0.9606299212598425,4.0
78,81,71,74,69,126,499,0.9090909090909091,70,90,90,135,90,125,600,0.9401709401709402,1.0
90,95,95,70,90,70,510,0.5230769230769231,40,30,35,45,40,55,245,0.31496062992125984,0.25
38,35,40,27,25,35,200,0.08208955223880597,67,82,62,46,48,43,348,0.22033898305084745,0.5
78,104,78,159,115,100,634,0.8444444444444444,70,80,65,90,65,85,455,0.578125,1.0
100,100,100,100,100,100,600,0.8805970149253731,70,62,67,55,55,56,365,0.38513513513513514,1.0
95,100,85,108,70,70,528,0.5652173913043478,60,52,168,47,138,30,495,0.19834710743801653,2.0
75,80,55,25,35,35,305,0.18666666666666668,58,64,58,80,65,80,405,0.609271523178808,1.0
60,45,70,45,90,95,405,0.7304964539007093,65,65,45,75,45,95,390,0.72,2.0
45,80,100,35,37,28,325,0.3125,70,85,70,60,70,50,405,0.28378378378378377,0.5
45,45,35,20,30,20,195,0.07246376811594203,50,25,28,45,55,15,218,0.0625,0.5
72,85,70,65,70,58,420,0.41304347826086957,75,80,85,110,90,50,490,0.3548387096774194,1.0
85,110,76,65,82,56,474,0.3933333333333333,50,53,48,53,48,64,316,0.4076923076923077,0.5
80,100,70,50,60,45,405,0.25806451612903225,85,97,66,105,66,65,484,0.47107438016528924,1.0
50,50,77,95,77,91,440,0.5916666666666667,55,75,85,25,25,15,280,0.1875,1.0
55,55,45,63,45,45,308,0.25,45,22,60,27,30,29,213,0.07518796992481203,1.0
60,85,40,30,45,68,328,0.6422018348623854,55,45,45,25,25,15,210,0.048,1.0
55,66,44,44,56,85,350,0.6888888888888889,50,48,43,46,41,60,288,0.47297297297297297,1.0
74,108,133,83,65,32,495,0.32142857142857145,50,52,48,65,50,55,320,0.33098591549295775,0.5
45,60,40,70,50,45,310,0.2846715328467153,60,60,60,105,105,105,495,0.848,1.0
55,55,45,63,45,45,308,0.25,50,75,35,70,30,40,300,0.21296296296296297,0.5
75,140,65,112,65,110,567,0.9140625,60,50,150,50,150,60,520,0.5206611570247934,0.25
60,55,50,40,55,45,305,0.22377622377622378,70,120,40,95,40,95,460,0.8106060606060606,2.0
20,10,230,10,230,5,505,0.0,45,67,60,35,50,63,320,0.5128205128205128,1.0
55,104,105,94,75,52,485,0.36363636363636365,65,70,60,65,65,115,440,0.8583333333333333,1.0
57,80,91,80,87,75,470,0.5737704918032787,75,38,38,56,56,67,330,0.5263157894736842,0.25
70,95,125,65,75,45,475,0.33613445378151263,50,50,40,30,30,50,250,0.2781954887218045,1.0
60,69,95,69,95,36,424,0.2608695652173913,80,100,123,122,120,80,625,0.56,1.0
65,130,60,75,60,75,465,0.689922480620155,85,73,70,73,115,67,483,0.5126050420168067,2.0
45,35,45,62,53,35,275,0.11851851851851852,99,68,83,72,87,51,460,0.417910447761194,0.25
60,45,50,90,80,70,395,0.625,85,73,70,73,115,67,483,0.5126050420168067,2.0
70,75,80,135,80,135,575,0.917910447761194,25,35,70,95,55,45,325,0.16783216783216784,0.5
70,94,50,94,50,66,424,0.48148148148148145,58,109,112,48,48,109,484,0.8805970149253731,0.5
60,105,60,120,60,105,510,0.8849557522123894,62,48,66,59,57,49,341,0.33884297520661155,0.5
71,95,85,110,95,79,535,0.664,61,84,65,70,70,70,420,0.5,2.0
79,115,70,125,80,111,580,0.8468468468468469,72,105,115,54,86,68,500,0.5149253731343284,0.5
80,82,83,100,100,80,525,0.6742424242424242,45,30,50,55,65,45,290,0.208,1.0
48,72,48,72,48,48,336,0.25984251968503935,65,150,60,115,60,115,565,0.935251798561151,0.0
45,50,35,55,75,40,300,0.21367521367521367,70,60,70,87,78,85,450,0.6228070175438597,1.0
60,45,70,75,85,55,390,0.3008130081300813,60,40,80,60,45,40,325,0.23529411764705882,0.5
61,72,57,55,55,65,365,0.3984375,35,80,50,50,70,120,405,0.84375,0.5
60,90,140,50,50,40,430,0.2535211267605634,50,72,35,35,35,65,292,0.5373134328358209,0.5
50,20,55,25,25,30,205,0.09774436090225563,65,45,55,45,70,45,325,0.24369747899159663,1.0
65,90,122,58,75,84,494,0.71875,45,95,50,40,50,75,355,0.54,1.0
80,82,83,100,100,80,525,0.6742424242424242,40,45,35,30,40,55,245,0.3793103448275862,0.125
60,59,85,79,105,36,424,0.16666666666666666,79,100,80,110,90,121,580,0.968,0.25
40,70,40,35,40,60,285,0.392,100,77,77,128,128,90,600,0.6901408450704225,1.0
120,120,120,120,120,120,720,0.9344262295081968,100,5,5,15,65,30,220,0.07692307692307693,1.0
50,85,125,85,115,20,480,0.4306569343065693,20,25,45,70,90,60,310,0.30833333333333335,2.0
75,80,60,65,90,102,472,0.8625954198473282,40,55,99,40,79,47,360,0.26262626262626265,1.0
75,38,38,56,56,67,330,0.5263157894736842,85,135,130,60,80,25,515,0.40540540540540543,2.0
45,60,30,80,50,65,330,0.4603174603174603,60,40,50,75,85,95,405,0.6044776119402985,1.0
46,57,40,40,40,50,273,0.25,65,95,100,60,50,50,420,0.34959349593495936,1.0
105,125,100,60,100,100,590,0.8359375,65,63,45,45,45,45,308,0.2595419847328244,1.0
76,104,71,104,71,108,534,0.912751677852349,100,180,160,150,90,90,770,0.7520661157024794,0.5
45,60,30,80,50,65,330,0.4603174603174603,90,100,90,125,85,90,580,0.7352941176470589,0.5
75,55,70,55,95,110,460,0.8444444444444444,75,98,63,98,63,101,498,0.849624060150376,2.0
54,63,52,83,56,97,405,0.7697841726618705,65,63,45,45,45,45,308,0.2595419847328244,2.0
69,69,76,69,86,91,460,0.6554621848739496,50,85,125,85,115,20,480,0.4306569343065693,1.0
76,104,71,104,71,108,534,0.912751677852349,50,50,62,40,62,65,329,0.4188034188034188,0.5
91,90,129,90,72,108,580,0.9140625,105,30,105,140,105,55,540,0.3524590163934426,0.25
108,170,115,120,95,92,700,0.7083333333333334,44,50,91,24,86,10,305,0.1981981981981982,0.5
70,95,125,65,75,45,475,0.33613445378151263,100,100,100,100,100,100,600,0.8758169934640523,0.5
40,40,35,50,100,70,335,0.5031847133757962,35,55,40,50,50,90,320,0.6838235294117647,1.0
39,52,43,60,50,65,309,0.49107142857142855,25,20,15,105,55,90,310,0.32407407407407407,1.0
55,70,40,60,40,40,305,0.26956521739130435,80,82,78,95,80,85,500,0.6869565217391305,0.5
60,100,85,80,85,100,510,0.7007874015748031,150,160,100,95,65,100,670,0.8866666666666667,2.0
45,60,32,50,32,76,295,0.5925925925925926,80,80,90,110,130,110,600,0.8721804511278195,0.5
84,71,43,71,43,48,360,0.25874125874125875,30,30,42,30,42,70,244,0.4230769230769231,1.0
75,103,80,70,80,92,500,0.7933884297520661,59,66,70,44,55,41,335,0.25190839694656486,0.5
71,73,88,120,89,59,500,0.43537414965986393,70,60,70,87,78,85,450,0.6228070175438597,0.5
75,80,60,65,90,102,472,0.8625954198473282,90,60,60,40,40,40,330,0.29545454545454547,1.0
45,30,50,55,65,45,290,0.208,45,45,35,20,30,20,195,0.07246376811594203,1.0
55,47,52,40,40,41,275,0.16806722689075632,77,85,51,55,51,65,384,0.5163934426229508,1.0
52,65,55,58,62,60,352,0.4482758620689655,75,75,95,75,95,113,528,0.9015151515151515,2.0
55,50,40,40,40,75,300,0.5945945945945946,85,90,80,70,80,130,535,0.9262295081967213,1.0
50,30,55,65,55,20,275,0.13675213675213677,64,51,23,51,23,28,240,0.11363636363636363,0.0
58,64,58,80,65,80,405,0.609271523178808,35,35,40,35,55,50,250,0.40336134453781514,2.0
70,90,90,135,90,125,600,0.9401709401709402,45,20,50,60,120,50,345,0.24074074074074073,1.0
55,70,55,40,55,85,360,0.7073170731707317,40,55,30,30,30,85,270,0.688,1.0
130,85,80,85,95,60,535,0.43884892086330934,68,125,65,65,115,80,518,0.6277372262773723,1.0
38,35,40,27,25,35,200,0.08208955223880597,91,90,106,130,106,77,600,0.648854961832061,0.25
40,30,30,40,50,30,220,0.07936507936507936,80,80,90,110,130,110,600,0.8721804511278195,0.25
85,110,76,65,82,56,474,0.3933333333333333,100,110,90,85,90,60,535,0.47794117647058826,4.0
70,60,75,110,75,90,480,0.7165354330708661,60,80,110,50,80,45,425,0.2833333333333333,2.0
106,110,90,154,90,130,680,0.926829268292683,70,75,60,105,60,105,475,0.88,1.0
64,51,23,51,23,28,240,0.11363636363636363,70,77,60,97,60,108,472,0.8394160583941606,1.0
100,100,100,100,100,100,600,0.831858407079646,40,60,30,31,31,70,262,0.4492753623188406,1.0
45,50,43,40,38,62,278,0.40441176470588236,30,105,90,25,25,50,325,0.2773722627737226,1.0
65,125,100,60,70,70,490,0.6099290780141844,74,94,131,54,116,20,489,0.4485294117647059,0.5
30,45,135,45,90,30,375,0.09285714285714286,75,100,110,45,55,65,450,0.5333333333333333,0.5
49,66,70,44,55,51,335,0.4260869565217391,35,55,40,45,40,60,275,0.35714285714285715,1.0
30,40,70,70,25,60,295,0.41353383458646614,77,85,51,55,51,65,384,0.5163934426229508,1.0
58,109,112,48,48,109,484,0.8805970149253731,65,95,57,100,85,93,495,0.7441860465116279,0.25
65,40,50,125,60,30,370,0.07258064516129033,65,47,55,73,75,85,400,0.65,1.0
60,62,80,63,80,60,405,0.4336283185840708,85,80,90,105,95,60,515,0.49074074074074076,1.0
75,98,63,98,63,101,498,0.849624060150376,50,65,45,85,65,95,405,0.7238095238095238,0.5
60,50,70,80,80,140,480,0.8449612403100775,40,30,50,55,55,100,330,0.584070796460177,0.5
50,65,45,85,65,95,405,0.7238095238095238,76,25,45,67,55,24,292,0.0390625,1.0
45,85,50,55,50,65,350,0.5076923076923077,75,70,90,70,105,80,490,0.656,0.5
75,100,66,60,66,115,482,0.918918918918919,58,70,45,40,45,42,300,0.25925925925925924,1.0
65,90,40,45,80,75,395,0.625,50,50,40,30,30,50,250,0.2781954887218045,0.5
130,65,60,110,95,65,525,0.5227272727272727,70,60,75,110,75,90,480,0.7165354330708661,0.5
60,59,85,79,105,36,424,0.16666666666666666,190,33,58,33,58,33,405,0.13432835820895522,2.0
50,75,35,70,30,40,300,0.21296296296296297,84,86,88,111,101,60,530,0.4634146341463415,0.0
50,50,50,50,50,50,300,0.30708661417322836,80,185,115,40,105,75,600,0.6230769230769231,1.0
100,100,100,100,100,100,600,0.8805970149253731,106,110,90,154,90,130,680,0.926829268292683,1.0
60,100,115,70,85,90,520,0.7557251908396947,75,38,38,56,56,67,330,0.5263157894736842,0.25
70,90,90,135,90,125,600,0.9401709401709402,50,65,90,35,35,15,290,0.14678899082568808,1.0
79,115,70,125,80,111,580,0.864,62,48,54,63,60,68,355,0.5178571428571429,1.0
85,105,55,85,50,115,495,0.9032258064516129,55,50,40,40,40,75,300,0.5945945945945946,1.0
100,100,100,100,100,100,600,0.8758169934640523,38,35,35,65,55,50,278,0.2647058823529412,0.25
70,60,62,80,82,60,414,0.4375,70,80,50,35,35,35,305,0.14,1.0
50,64,50,45,50,41,300,0.22727272727272727,89,124,80,55,80,55,483,0.5714285714285714,0.5
40,80,35,35,45,70,305,0.4661016949152542,75,105,75,105,75,45,480,0.3274336283185841,1.0
111,83,68,92,82,39,475,0.1774193548387097,103,60,126,80,126,50,545,0.36363636363636365,1.0
65,130,60,75,60,75,465,0.689922480620155,35,80,50,50,70,120,405,0.84375,1.0
60,62,50,62,60,40,334,0.18181818181818182,72,95,67,103,71,122,530,0.9606299212598425,1.0
125,130,90,130,90,95,660,0.7734375,50,70,160,70,160,90,600,0.7417218543046358,1.0
68,72,78,38,42,32,330,0.23809523809523808,105,150,90,150,90,95,680,0.8285714285714286,0.0
65,90,115,45,115,58,488,0.5041322314049587,60,90,55,90,80,110,485,0.8677685950413223,1.0
70,115,60,115,60,55,475,0.4647887323943662,100,100,100,100,100,100,600,0.8758169934640523,1.0
120,70,120,75,130,85,600,0.6694915254237288,105,95,75,85,75,74,509,0.5714285714285714,2.0
108,170,115,120,95,92,700,0.7083333333333334,50,72,35,35,35,65,292,0.5373134328358209,1.0
70,75,80,135,80,135,575,0.917910447761194,40,45,35,40,40,90,290,0.65,1.0
77,120,90,60,90,48,485,0.2785714285714286,106,150,70,194,120,140,780,0.952,1.0
40,45,40,65,40,65,295,0.5661764705882353,64,51,23,51,23,28,240,0.11363636363636363,1.0
105,140,55,30,55,95,480,0.8195488721804511,59,74,50,35,50,35,303,0.3125,1.0
60,100,85,80,85,100,510,0.7007874015748031,80,80,80,55,55,90,440,0.6417910447761194,2.0
75,98,63,98,63,101,498,0.849624060150376,100,150,90,180,160,90,770,0.7348484848484849,0.5
95,95,85,125,65,55,520,0.3894736842105263,50,70,100,40,40,30,330,0.2222222222222222,0.5
50,50,62,40,62,65,329,0.4188034188034188,65,73,55,47,75,85,400,0.6846846846846847,1.0
75,125,70,125,70,115,580,0.9037037037037037,80,185,115,40,105,75,600,0.6230769230769231,1.0
90,92,87,75,85,76,505,0.5409836065573771,79,103,120,135,115,78,630,0.5763888888888888,1.0
103,60,86,60,86,50,445,0.3458646616541353,35,55,40,50,50,90,320,0.6838235294117647,1.0
45,45,35,20,30,20,195,0.07246376811594203,90,132,105,132,105,30,594,0.4246575342465753,2.0
55,65,95,95,45,85,440,0.6610169491525424,60,80,110,50,80,45,425,0.2833333333333333,2.0
70,92,65,80,55,98,460,0.8090909090909091,57,80,91,80,87,75,470,0.5737704918032787,1.0
105,95,75,85,75,74,509,0.5714285714285714,58,64,58,80,65,80,405,0.609271523178808,4.0
68,85,65,165,135,100,618,0.8083333333333333,60,50,100,85,70,65,430,0.47580645161290325,1.0
70,55,95,95,110,65,490,0.48872180451127817,35,55,40,45,40,60,275,0.35714285714285715,1.0
50,160,110,160,110,110,700,0.8854961832061069,123,100,62,97,81,68,531,0.4806201550387597,1.0
65,75,90,97,123,44,494,0.1987179487179487,65,70,60,65,65,115,440,0.8583333333333333,1.0
70,70,40,60,40,60,340,0.4247787610619469,123,100,62,97,81,68,531,0.4806201550387597,0.5
80,100,80,80,80,100,520,0.9051724137931034,60,130,80,60,60,70,460,0.5153846153846153,0.5
100,134,110,95,100,61,600,0.4057971014492754,80,125,75,40,95,85,500,0.6911764705882353,0.5
62,48,54,63,60,68,355,0.5178571428571429,68,125,65,65,115,80,518,0.6277372262773723,0.5
45,60,32,50,32,76,295,0.5925925925925926,50,85,55,65,65,90,410,0.7478260869565218,1.0
70,140,70,110,65,105,560,0.95,70,45,48,60,65,35,323,0.15748031496062992,0.5
99,68,83,72,87,51,460,0.417910447761194,80,80,80,80,80,80,480,0.6015037593984962,1.0
74,48,76,83,81,104,466,0.7913043478260869,78,81,71,74,69,126,499,0.9090909090909091,1.0
50,65,107,105,107,86,520,0.7272727272727273,40,60,30,31,31,70,262,0.4492753623188406,2.0
70,90,90,135,90,125,600,0.9401709401709402,70,95,85,55,65,70,440,0.5,2.0
50,50,95,40,50,35,320,0.20279720279720279,80,120,80,120,80,100,580,0.8478260869565217,1.0
78,70,61,50,61,100,420,0.8145161290322581,50,150,50,150,50,150,600,0.9339622641509434,1.0
40,70,130,60,130,25,455,0.17355371900826447,60,85,60,50,50,125,430,0.9090909090909091,0.0
110,85,95,80,95,50,515,0.2713178294573643,50,65,107,105,107,86,520,0.703125,1.0
70,70,40,60,40,60,340,0.4247787610619469,75,70,90,70,105,80,490,0.656,0.25
38,30,85,55,65,30,303,0.21428571428571427,59,74,50,35,50,35,303,0.3125,2.0
50,50,40,50,40,64,294,0.45588235294117646,65,80,80,59,63,58,405,0.4411764705882353,0.5
65,150,40,15,80,145,495,0.9663865546218487,82,121,119,69,59,71,521,0.5394736842105263,0.5
75,90,90,140,90,115,600,0.9481481481481482,68,165,95,65,115,110,618,0.8615384615384616,1.0
100,100,125,110,50,50,535,0.384,54,45,47,75,98,52,371,0.39669421487603307,1.0
35,20,65,40,65,20,245,0.02459016393442623,50,75,45,40,45,60,315,0.4380165289256198,1.0
105,95,80,40,80,90,490,0.753968253968254,86,92,88,68,75,73,482,0.6835443037974683,1.0
45,63,37,65,55,95,360,0.8055555555555556,60,50,50,60,70,50,340,0.28346456692913385,1.0
61,72,57,55,55,65,365,0.3984375,40,50,90,30,55,65,330,0.44680851063829785,0.5
50,95,90,95,90,180,600,0.9172413793103448,40,35,30,120,70,105,400,0.6692307692307692,0.5
85,115,80,105,80,50,515,0.3063063063063063,60,40,60,40,60,35,295,0.18055555555555555,0.5
45,50,43,40,38,62,278,0.40441176470588236,50,53,48,53,48,64,316,0.4076923076923077,2.0
59,110,150,45,49,35,448,0.3333333333333333,90,120,100,150,120,100,680,0.7718120805369127,0.5
68,72,78,38,42,32,330,0.23809523809523808,75,95,60,65,60,115,470,0.8778625954198473,1.0
40,45,40,65,40,65,295,0.5661764705882353,100,73,83,73,83,55,467,0.371900826446281,1.0
108,130,95,80,85,102,600,0.7637795275590551,40,55,30,30,30,60,245,0.43548387096774194,0.0
100,5,5,15,65,30,220,0.07692307692307693,72,85,70,65,70,58,420,0.41304347826086957,1.0
60,85,69,65,79,80,438,0.576,60,65,80,170,95,130,600,0.8625954198473282,0.25
45,85,50,55,50,65,350,0.5076923076923077,55,45,50,45,65,80,340,0.5546218487394958,0.5
70,85,140,85,70,20,470,0.272,65,100,70,80,80,105,500,0.8666666666666667,0.5
85,115,80,105,80,50,515,0.3063063063063063,60,85,69,60,69,77,420,0.518796992481203,1.0
59,110,150,45,49,35,448,0.3333333333333333,91,129,90,72,90,108,580,0.8536585365853658,2.0
40,30,50,55,55,100,330,0.584070796460177,70,84,70,65,70,51,410,0.2949640287769784,0.0
75,100,63,80,63,116,497,0.9345794392523364,60,59,85,79,105,36,424,0.16666666666666666,0.5
79,103,120,135,115,78,630,0.5763888888888888,70,60,75,110,75,90,480,0.7165354330708661,0.5
60,55,145,75,150,40,525,0.2,70,120,100,145,105,20,560,0.2824427480916031,0.5
100,90,130,45,65,55,485,0.4253731343283582,65,85,70,75,70,40,405,0.203125,1.0
95,100,85,108,70,70,528,0.5652173913043478,100,50,50,76,96,70,442,0.5,1.0
75,125,100,70,80,45,495,0.33035714285714285,90,85,75,115,100,115,580,0.9381443298969072,1.0
60,55,90,145,90,80,520,0.6071428571428571,64,78,52,78,52,81,405,0.6422764227642277,0.5
72,105,115,54,86,68,500,0.5149253731343284,45,50,35,55,75,40,300,0.21367521367521367,0.5
95,60,79,100,125,81,540,0.6201550387596899,65,100,70,80,80,105,500,0.8666666666666667,2.0
65,47,55,73,75,85,400,0.65,250,5,5,35,105,50,450,0.15306122448979592,1.0
80,130,100,160,120,110,700,0.8981481481481481,67,82,62,46,48,43,348,0.22033898305084745,1.0
45,55,39,35,39,42,255,0.18518518518518517,70,75,60,105,60,105,475,0.88,1.0
40,80,35,35,45,70,305,0.4661016949152542,50,55,50,36,30,43,264,0.2922077922077922,1.0
50,65,85,35,35,55,325,0.32575757575757575,105,105,75,65,100,50,500,0.37593984962406013,0.5
30,105,90,25,25,50,325,0.2773722627737226,38,36,38,32,36,57,237,0.3893805309734513,1.0
65,125,100,60,70,70,490,0.6099290780141844,55,65,95,95,45,85,440,0.6610169491525424,0.5
60,85,69,65,79,80,438,0.576,40,55,70,45,60,30,300,0.10619469026548672,0.0
20,10,55,15,20,80,200,0.17985611510791366,40,65,95,60,45,35,340,0.13986013986013987,1.0
40,65,95,60,45,35,340,0.13986013986013987,65,50,70,95,80,65,425,0.4262295081967213,1.0
40,45,35,40,40,90,290,0.65,50,85,85,55,55,50,380,0.3902439024390244,0.5
59,66,70,44,55,41,335,0.25190839694656486,40,55,30,30,30,60,245,0.43548387096774194,0.0
78,52,60,63,65,23,341,0.06015037593984962,70,70,70,70,70,70,420,0.5289256198347108,1.0
60,62,63,80,80,60,405,0.38016528925619836,110,123,65,100,65,65,528,0.5217391304347826,0.5
100,100,100,100,100,100,600,0.8805970149253731,45,25,50,25,25,35,205,0.13076923076923078,1.0
65,155,120,65,90,105,600,0.8677685950413223,85,56,77,50,77,78,423,0.53125,1.0
90,90,85,125,90,100,580,0.768595041322314,58,64,58,80,65,80,405,0.609271523178808,1.0
63,60,55,50,50,71,349,0.5289256198347108,110,130,80,70,60,80,530,0.5862068965517241,1.0
37,25,41,25,41,25,194,0.08870967741935484,20,10,55,15,20,80,200,0.17985611510791366,1.0
70,50,30,95,135,105,485,0.8040540540540541,50,105,125,55,95,50,480,0.375886524822695,0.5
40,45,35,65,55,70,310,0.4482758620689655,67,89,116,79,116,33,500,0.2624113475177305,0.5
40,30,35,45,40,55,245,0.31496062992125984,60,62,63,80,80,60,405,0.38016528925619836,2.0
75,125,230,55,95,30,610,0.3448275862068966,50,40,85,40,65,25,305,0.08870967741935484,0.5
45,80,100,35,37,28,325,0.3125,80,105,65,60,75,130,515,0.9645390070921985,2.0
110,85,95,80,95,50,515,0.2713178294573643,80,90,80,130,110,110,600,0.856,1.0
60,60,60,85,85,85,435,0.631578947368421,45,50,45,115,55,95,405,0.6936936936936937,2.0
65,110,130,60,65,95,525,0.8278145695364238,60,40,80,60,45,40,325,0.23529411764705882,0.5
70,60,75,110,75,90,480,0.7165354330708661,80,70,70,90,100,70,480,0.5609756097560976,1.0
50,105,125,55,95,50,480,0.375886524822695,103,60,126,80,126,50,545,0.36363636363636365,0.5
70,60,70,87,78,85,450,0.6228070175438597,95,117,184,44,46,28,514,0.2975206611570248,1.0
106,190,100,154,100,130,780,0.9259259259259259,55,40,40,65,45,35,280,0.16428571428571428,1.0
61,84,65,70,70,70,420,0.5,60,85,40,30,45,68,328,0.6422018348623854,1.0
45,40,60,40,75,50,310,0.2926829268292683,55,70,40,60,40,40,305,0.26956521739130435,1.0
80,50,100,100,200,50,580,0.2357142857142857,50,50,95,40,50,35,320,0.20279720279720279,2.0
60,85,42,85,42,91,405,0.8227848101265823,20,10,230,10,230,5,505,0.0,1.0
40,45,65,100,120,90,460,0.5588235294117647,80,125,75,40,95,85,500,0.6911764705882353,2.0
50,65,107,105,107,86,520,0.7758620689655172,40,30,50,55,55,100,330,0.584070796460177,0.5
250,5,5,35,105,50,450,0.15306122448979592,65,130,60,75,60,75,465,0.689922480620155,1.0
75,90,90,140,90,115,600,0.9481481481481482,69,69,76,69,86,91,460,0.6554621848739496,0.5
70,80,70,80,70,110,480,0.6594202898550725,50,53,48,53,48,64,316,0.46153846153846156,0.5
79,115,70,125,80,111,580,0.8468468468468469,104,91,63,91,73,68,490,0.5118110236220472,1.0
1,90,45,30,30,40,236,0.33064516129032256,35,55,40,45,40,60,275,0.35714285714285715,1.0
68,65,65,125,115,80,518,0.6461538461538462,90,75,75,90,100,70,500,0.5462184873949579,1.0
95,117,184,44,46,28,514,0.2975206611570248,40,80,35,35,45,70,305,0.4661016949152542,1.0
44,38,39,61,79,42,303,0.2251655629139073,83,80,80,135,80,121,579,0.9444444444444444,1.0
70,115,60,115,60,55,475,0.4647887323943662,55,63,90,50,80,42,380,0.21138211382113822,0.25
95,110,80,70,80,50,485,0.37209302325581395,91,72,90,129,90,108,580,0.8925619834710744,0.5
75,89,85,55,65,36,405,0.29545454545454547,115,140,130,55,55,40,535,0.4519230769230769,4.0
105,140,55,30,55,95,480,0.8195488721804511,30,105,90,25,25,50,325,0.2773722627737226,0.5
90,120,75,60,60,45,450,0.29411764705882354,115,45,20,45,25,20,270,0.11538461538461539,1.0
108,112,118,68,72,47,525,0.2916666666666667,75,70,90,70,105,80,490,0.656,0.0
100,90,130,45,65,55,485,0.4253731343283582,70,55,55,80,60,45,365,0.2222222222222222,1.0
65,83,57,95,85,105,490,0.8914728682170543,60,130,80,60,60,70,460,0.5153846153846153,0.5
50,85,55,65,65,90,410,0.7478260869565218,45,60,40,70,50,45,310,0.2846715328467153,0.5
45,53,70,40,60,42,310,0.25735294117647056,65,73,55,47,75,85,400,0.6846846846846847,0.5
35,80,50,50,70,120,405,0.84375,115,45,20,45,25,20,270,0.11538461538461539,1.0
75,80,95,90,100,50,490,0.2158273381294964,60,80,95,70,85,50,440,0.2231404958677686,0.5
80,160,80,130,80,100,630,0.8455284552845529,55,35,50,55,110,85,390,0.6277372262773723,0.5
66,41,77,61,87,23,355,0.12096774193548387,70,110,180,60,60,50,530,0.4117647058823529,0.5
55,75,85,25,25,15,280,0.1875,20,25,45,70,90,60,310,0.30833333333333335,1.0
89,125,90,115,80,101,600,0.8725490196078431,40,60,40,40,40,30,250,0.0948905109489051,2.0
100,134,110,95,100,61,600,0.4057971014492754,63,63,47,41,41,74,329,0.56,0.5
40,65,40,80,40,65,330,0.5038167938931297,50,52,48,65,50,55,320,0.33098591549295775,1.0
82,121,119,69,59,71,521,0.5394736842105263,25,20,15,105,55,90,310,0.32407407407407407,1.0
60,90,70,60,120,40,440,0.27419354838709675,70,110,70,115,70,90,525,0.75,0.5
75,98,63,98,63,101,498,0.849624060150376,67,58,57,81,67,101,431,0.8790322580645161,1.0
60,45,70,75,85,55,390,0.3008130081300813,130,85,80,85,95,60,535,0.43884892086330934,1.0
104,91,63,91,73,68,490,0.5118110236220472,50,50,150,50,150,50,500,0.2571428571428571,0.5
60,90,70,60,120,40,440,0.27419354838709675,55,68,64,45,55,31,318,0.11666666666666667,1.0
70,90,110,60,75,95,500,0.7333333333333333,50,70,50,50,50,70,340,0.5645161290322581,0.5
190,33,58,33,58,33,405,0.13432835820895522,65,55,115,100,40,60,435,0.3798449612403101,1.0
70,75,60,105,60,105,475,0.88,50,65,90,35,35,15,290,0.14678899082568808,1.0
50,70,160,70,160,90,600,0.7417218543046358,50,65,107,105,107,86,520,0.7313432835820896,1.0
50,70,50,50,50,40,310,0.16296296296296298,40,30,50,55,55,100,330,0.584070796460177,1.0
58,64,58,80,65,80,405,0.609271523178808,150,120,100,120,100,90,680,0.664179104477612,0.5
65,40,70,80,140,70,465,0.5954198473282443,75,80,60,65,90,102,472,0.8625954198473282,1.0
45,75,60,40,30,50,300,0.304,62,55,52,109,94,109,481,0.7833333333333333,1.0
62,50,58,73,54,72,369,0.4435483870967742,45,55,45,65,45,75,330,0.5692307692307692,2.0
50,65,107,105,107,86,520,0.7758620689655172,80,80,80,55,55,90,440,0.6417910447761194,1.0
78,92,75,74,63,118,500,0.8842975206611571,38,30,85,55,65,30,303,0.21428571428571427,0.0
55,55,55,85,55,30,335,0.1320754716981132,70,90,70,60,60,70,420,0.6390977443609023,0.0
59,63,80,65,80,58,405,0.41843971631205673,90,120,100,150,120,100,680,0.7718120805369127,0.25
90,93,55,70,55,55,418,0.3819444444444444,45,95,50,40,50,75,355,0.54,1.0
45,40,60,40,75,50,310,0.2926829268292683,45,35,50,70,50,30,280,0.15753424657534246,2.0
64,165,75,93,83,75,555,0.6587301587301587,70,20,50,20,50,40,250,0.1557377049180328,1.0
70,43,53,43,53,40,302,0.19090909090909092,55,95,115,45,45,35,390,0.2116788321167883,0.25
55,75,60,75,60,103,428,0.7982456140350878,60,60,60,85,85,85,435,0.631578947368421,1.0
55,70,45,70,50,60,350,0.45,70,90,70,60,60,70,420,0.6390977443609023,1.0
50,50,50,50,50,50,300,0.30708661417322836,65,50,70,95,80,65,425,0.4262295081967213,1.0
125,58,58,76,76,67,460,0.515625,99,68,83,72,87,51,460,0.417910447761194,0.5
104,91,63,91,73,68,490,0.5118110236220472,75,75,130,75,130,95,580,0.7479674796747967,1.0
70,110,180,60,60,50,530,0.4117647058823529,30,45,55,70,55,85,340,0.5633802816901409,0.5
90,120,100,150,120,100,680,0.7718120805369127,106,90,130,90,154,110,680,0.8699186991869918,1.0
55,68,64,45,55,31,318,0.11666666666666667,72,95,67,103,71,122,530,0.9606299212598425,2.0
108,170,115,120,95,92,700,0.7083333333333334,120,120,120,120,120,120,720,0.9344262295081968,1.0
80,100,200,50,100,50,580,0.3472222222222222,90,132,105,132,105,30,594,0.4246575342465753,2.0
70,90,45,15,45,50,315,0.3629032258064516,30,42,118,42,88,30,350,0.112,1.0
55,40,50,65,85,40,335,0.3181818181818182,90,30,15,40,20,15,210,0.043478260869565216,0.0
20,10,55,15,20,80,200,0.17985611510791366,60,130,80,60,60,70,460,0.5153846153846153,0.5
40,45,40,62,60,60,307,0.33884297520661155,120,100,85,30,85,45,465,0.22448979591836735,1.0
71,120,95,120,95,99,600,0.8203125,75,90,140,60,60,40,465,0.3008130081300813,0.25
70,94,50,94,50,66,424,0.48148148148148145,80,82,100,83,100,80,525,0.6821705426356589,4.0
65,125,100,55,70,85,500,0.6532258064516129,100,164,150,95,120,71,700,0.5645161290322581,2.0
59,45,40,35,40,31,250,0.14285714285714285,45,45,35,20,30,20,195,0.07246376811594203,1.0
65,130,60,95,110,65,525,0.5303030303030303,55,70,40,60,40,40,305,0.26956521739130435,2.0
30,80,90,55,45,55,355,0.4295774647887324,30,65,100,45,25,40,305,0.1891891891891892,0.5
79,103,120,135,115,78,630,0.5763888888888888,100,100,100,100,100,100,600,0.831858407079646,1.0
105,140,95,55,65,45,505,0.3,75,70,90,70,105,80,490,0.656,0.5
84,71,43,71,43,48,360,0.25874125874125875,40,45,40,62,60,60,307,0.33884297520661155,1.0
30,80,90,55,45,55,355,0.4295774647887324,83,80,80,135,80,121,579,0.9444444444444444,2.0
64,51,23,51,23,28,240,0.11363636363636363,70,60,62,80,82,60,414,0.4375,1.0
50,70,160,70,160,90,600,0.7417218543046358,40,80,35,35,45,70,305,0.4661016949152542,1.0
105,95,75,85,75,74,509,0.5714285714285714,50,80,95,10,45,10,290,0.232,4.0
80,45,65,90,110,80,470,0.5462962962962963,90,92,75,92,85,60,494,0.49586776859504134,1.0
64,115,65,83,63,65,455,0.5323741007194245,65,110,130,60,65,95,525,0.8278145695364238,1.0
78,84,78,109,85,100,534,0.8646616541353384,50,65,107,105,107,86,520,0.7758620689655172,0.25
80,70,70,90,100,70,480,0.5609756097560976,79,115,70,125,80,111,580,0.8468468468468469,0.5
95,95,85,125,65,55,520,0.3894736842105263,100,110,90,85,90,60,535,0.47794117647058826,8.0
65,110,130,60,65,95,525,0.8278145695364238,50,65,107,105,107,86,520,0.7313432835820896,0.5
65,80,80,59,63,58,405,0.4411764705882353,115,115,85,90,75,100,580,0.8134328358208955,2.0
50,55,50,36,30,43,264,0.2922077922077922,75,85,200,55,65,30,510,0.16778523489932887,0.25
65,40,70,80,140,70,465,0.5954198473282443,61,84,65,70,70,70,420,0.5,0.5
70,120,100,145,105,20,560,0.2824427480916031,70,90,90,135,90,125,600,0.9401709401709402,1.0
75,75,75,125,95,40,485,0.15671641791044777,75,75,130,75,130,95,580,0.7479674796747967,0.5
95,75,80,100,110,30,490,0.24242424242424243,110,65,105,55,95,80,510,0.6258503401360545,0.0
90,130,80,65,85,55,505,0.4396551724137931,190,33,58,33,58,33,405,0.13432835820895522,0.5
50,52,48,65,50,55,320,0.33098591549295775,50,75,45,40,45,60,315,0.4380165289256198,1.0
60,62,50,62,60,40,334,0.18181818181818182,55,104,105,94,75,52,485,0.36363636363636365,1.0
62,77,62,50,42,65,358,0.4838709677419355,108,100,121,81,95,95,600,0.7476635514018691,1.0
50,30,55,65,55,20,275,0.13675213675213677,81,102,77,85,75,85,505,0.5642857142857143,1.0
77,59,50,67,63,46,362,0.23140495867768596,70,110,180,60,60,50,530,0.4117647058823529,0.25
70,70,115,130,90,60,535,0.5338983050847458,90,93,55,70,55,55,418,0.3819444444444444,0.5
45,85,50,55,50,65,350,0.5076923076923077,80,80,80,80,80,80,480,0.6015037593984962,2.0
72,105,115,54,86,68,500,0.5149253731343284,80,115,80,65,55,93,488,0.7846153846153846,2.0
110,85,95,80,95,50,515,0.2713178294573643,60,100,89,55,69,112,485,0.9298245614035088,1.0
67,57,55,77,55,114,425,0.8879310344827587,40,65,95,60,45,35,340,0.13986013986013987,2.0
80,160,80,130,80,100,630,0.8455284552845529,70,85,70,60,70,50,405,0.28378378378378377,0.5
64,66,68,81,76,50,405,0.25190839694656486,75,98,63,98,63,101,498,0.889763779527559,2.0
40,30,30,40,50,30,220,0.07936507936507936,90,100,70,110,150,80,600,0.6037735849056604,0.25
60,95,80,60,80,30,405,0.19480519480519481,46,57,40,40,40,50,273,0.25,0.25
90,120,120,60,60,50,500,0.35294117647058826,79,85,60,55,60,71,410,0.60431654676259,1.0
120,100,85,30,85,45,465,0.22448979591836735,53,54,53,37,46,45,288,0.3090909090909091,1.0
68,75,53,83,113,60,452,0.45384615384615384,90,120,100,150,120,100,680,0.7718120805369127,2.0
45,85,50,55,50,65,350,0.5076923076923077,90,100,90,125,85,90,580,0.7352941176470589,0.5
37,25,41,25,41,25,194,0.08870967741935484,55,47,52,40,40,41,275,0.16806722689075632,0.5
45,67,60,35,50,63,320,0.5128205128205128,65,76,84,54,96,105,480,0.9008264462809917,1.0
100,100,100,100,100,100,600,0.8602941176470589,80,105,105,105,105,80,580,0.5939849624060151,1.0
60,70,105,70,120,75,500,0.5983606557377049,78,92,75,74,63,118,500,0.8842975206611571,0.0
46,57,40,40,40,50,273,0.25,95,110,80,70,80,50,485,0.37209302325581395,1.0
85,135,130,60,80,25,515,0.40540540540540543,50,60,60,60,60,30,320,0.11290322580645161,1.0
90,130,80,65,85,55,505,0.4396551724137931,60,90,70,60,120,40,440,0.27419354838709675,2.0
80,115,80,65,55,93,488,0.7846153846153846,115,45,20,45,25,20,270,0.11538461538461539,1.0
55,85,55,50,55,60,360,0.4233576642335766,35,46,34,35,45,20,215,0.072,1.0
65,80,140,40,70,70,465,0.5223880597014925,62,50,58,73,54,72,369,0.4435483870967742,0.5
75,89,85,55,65,36,405,0.29545454545454547,80,95,82,60,82,75,474,0.6,0.5
40,45,35,40,40,90,290,0.65,55,65,95,95,45,85,440,0.6610169491525424,1.0
35,55,40,50,50,90,320,0.6838235294117647,120,70,120,75,130,85,600,0.6694915254237288,1.0
45,50,43,40,38,62,278,0.40441176470588236,75,75,75,125,95,40,485,0.15671641791044777,1.0
60,60,40,65,45,35,305,0.15833333333333333,80,80,80,80,80,80,480,0.6015037593984962,2.0
77,85,51,55,51,65,384,0.5163934426229508,126,131,95,131,98,99,680,0.8294573643410853,0.5
80,80,50,40,50,25,325,0.176056338028169,80,70,70,90,100,70,480,0.5609756097560976,2.0
78,104,78,159,115,100,634,0.8444444444444444,40,50,45,70,45,70,320,0.5517241379310345,1.0
59,110,150,45,49,35,448,0.3333333333333333,100,100,100,100,100,100,600,0.8602941176470589,1.0
62,48,54,63,60,68,355,0.5178571428571429,40,45,35,65,55,70,310,0.4482758620689655,1.0
70,90,110,60,75,95,500,0.7333333333333333,45,45,55,45,55,63,308,0.4594594594594595,2.0
50,150,50,150,50,150,600,0.9339622641509434,64,66,68,81,76,50,405,0.25190839694656486,1.0
105,140,95,55,65,45,505,0.3,60,55,145,75,150,40,525,0.2,4.0
50,50,50,50,50,50,300,0.30708661417322836,85,135,130,60,80,25,515,0.40540540540540543,1.0
50,65,45,85,65,95,405,0.7238095238095238,44,58,44,58,44,61,309,0.41964285714285715,0.5
91,72,90,129,90,108,580,0.8925619834710744,86,81,97,81,107,43,495,0.203125,2.0
40,55,30,30,30,85,270,0.688,25,20,15,105,55,90,310,0.32407407407407407,1.0
65,125,60,95,60,105,510,0.9236641221374046,60,110,70,60,60,100,460,0.8461538461538461,1.0
60,48,45,43,90,42,328,0.21897810218978103,100,70,70,65,65,45,415,0.1897810218978102,1.0
70,110,180,60,60,50,530,0.4117647058823529,41,50,37,50,37,66,281,0.5175438596491229,1.0
70,83,50,37,50,60,350,0.3360655737704918,109,66,84,81,99,32,471,0.2013888888888889,0.5
40,45,35,30,40,55,245,0.3793103448275862,65,125,100,55,70,85,500,0.6532258064516129,2.0
65,125,60,95,60,105,510,0.9236641221374046,105,150,90,150,90,95,680,0.8285714285714286,0.5
75,125,70,125,70,115,580,0.9037037037037037,100,100,100,100,100,100,600,0.8758169934640523,0.25
55,55,55,85,55,30,335,0.1320754716981132,70,70,115,130,90,60,535,0.5338983050847458,0.5
65,65,65,50,50,90,385,0.72,80,80,80,80,80,80,480,0.5606060606060606,0.5
63,63,47,41,41,74,329,0.56,70,50,30,95,135,105,485,0.8040540540540541,1.0
20,10,230,10,230,5,505,0.0,120,70,120,75,130,85,600,0.6694915254237288,2.0
50,70,100,40,40,30,330,0.2222222222222222,45,60,32,50,32,76,295,0.5925925925925926,0.5
125,170,100,120,90,95,700,0.77,50,85,125,85,115,20,480,0.4306569343065693,1.0
30,30,42,30,42,70,244,0.4230769230769231,70,80,65,90,65,85,455,0.578125,2.0
85,76,64,45,55,90,415,0.6739130434782609,64,66,68,81,76,50,405,0.25190839694656486,1.0
48,61,40,61,40,50,300,0.2543859649122807,100,50,50,76,96,70,442,0.5,1.0
50,50,50,50,50,50,300,0.30708661417322836,126,131,95,131,98,99,680,0.8102189781021898,2.0
60,80,95,70,85,50,440,0.2231404958677686,65,60,110,130,95,65,525,0.47761194029850745,2.0
95,110,80,70,80,50,485,0.37209302325581395,40,35,30,120,70,105,400,0.6692307692307692,1.0
50,20,55,25,25,30,205,0.09774436090225563,100,110,90,85,90,60,535,0.47794117647058826,1.0
45,35,50,70,50,30,280,0.15753424657534246,70,55,95,95,110,65,490,0.48872180451127817,1.0
45,50,35,55,75,40,300,0.21367521367521367,89,145,90,105,80,91,600,0.8549618320610687,1.0
70,90,45,15,45,50,315,0.3629032258064516,84,86,88,111,101,60,530,0.4634146341463415,1.0
40,65,95,60,45,35,340,0.13986013986013987,30,42,118,42,88,30,350,0.112,0.0
46,57,40,40,40,50,273,0.25,81,102,77,85,75,85,505,0.5642857142857143,0.25
40,45,40,35,35,56,251,0.373015873015873,95,110,95,40,95,55,490,0.40336134453781514,1.0
86,81,97,81,107,43,495,0.203125,65,65,45,75,45,95,390,0.72,1.0
50,50,62,40,62,65,329,0.4188034188034188,60,60,60,105,105,105,495,0.848,0.5
50,80,95,10,45,10,290,0.232,62,48,66,59,57,49,341,0.33884297520661155,1.0
50,48,43,46,41,60,288,0.47297297297297297,80,52,50,90,50,89,411,0.6666666666666666,0.0
126,131,95,131,98,99,680,0.8294573643410853,150,160,100,95,65,100,670,0.8866666666666667,1.0
109,66,84,81,99,32,471,0.2013888888888889,70,92,65,80,55,98,460,0.8090909090909091,2.0
80,75,150,75,150,50,580,0.30973451327433627,126,131,95,131,98,99,680,0.8294573643410853,0.5
70,100,70,105,75,40,460,0.23214285714285715,71,82,64,64,59,112,452,0.9327731092436975,1.0
60,95,80,60,80,30,405,0.19480519480519481,75,75,95,75,95,113,528,0.9015151515151515,1.0
84,86,88,111,101,60,530,0.4634146341463415,78,92,75,74,63,118,500,0.8842975206611571,1.0
85,105,100,79,83,78,530,0.5869565217391305,45,63,37,65,55,95,360,0.8055555555555556,1.0
60,85,69,65,79,80,438,0.576,30,42,118,42,88,30,350,0.112,0.0
70,115,60,115,60,55,475,0.4647887323943662,65,80,140,40,70,70,465,0.5223880597014925,0.25
90,75,85,115,90,55,510,0.3445378151260504,70,94,50,94,50,66,424,0.48148148148148145,2.0
80,82,83,100,100,80,525,0.6742424242424242,55,95,55,35,75,115,430,0.9380530973451328,1.0
42,52,67,39,56,50,306,0.2868217054263566,80,135,85,70,95,150,615,0.9844961240310077,4.0
70,55,95,95,110,65,490,0.48872180451127817,50,70,50,50,50,40,310,0.16296296296296298,1.0
126,131,95,131,98,99,680,0.8294573643410853,90,95,105,165,110,45,610,0.2890625,2.0
58,64,58,80,65,80,405,0.609271523178808,54,78,103,53,45,22,355,0.23255813953488372,0.25
40,30,35,50,70,55,280,0.28205128205128205,60,85,42,85,42,91,405,0.8227848101265823,0.5
111,83,68,92,82,39,475,0.1774193548387097,65,90,40,45,80,75,395,0.625,1.0
60,62,50,62,60,40,334,0.18181818181818182,59,66,70,44,55,41,335,0.25190839694656486,1.0
99,68,83,72,87,51,460,0.417910447761194,65,40,50,125,60,30,370,0.07258064516129033,1.0
70,115,60,115,60,55,475,0.4647887323943662,45,55,39,35,39,42,255,0.18518518518518517,1.0
90,130,80,65,85,55,505,0.4396551724137931,91,129,90,72,90,108,580,0.8536585365853658,2.0
59,63,80,65,80,58,405,0.41843971631205673,60,45,70,45,90,95,405,0.7304964539007093,1.0
100,100,90,150,140,90,670,0.71875,80,135,130,95,90,70,600,0.5181818181818182,1.0
103,60,86,60,86,50,445,0.3458646616541353,35,64,85,74,55,32,345,0.19827586206896552,1.0
75,95,95,95,95,85,540,0.6470588235294118,78,81,71,74,69,126,499,0.9090909090909091,2.0
50,25,28,45,55,15,218,0.0625,100,120,120,150,100,90,680,0.7880794701986755,1.0
55,85,55,50,55,60,360,0.4233576642335766,35,65,35,65,35,65,300,0.46621621621621623,0.5
76,104,71,104,71,108,534,0.912751677852349,80,45,65,90,110,80,470,0.5462962962962963,0.5
65,110,130,60,65,95,525,0.8278145695364238,45,49,49,65,65,45,318,0.2781954887218045,0.25
53,54,53,37,46,45,288,0.3090909090909091,100,150,110,95,110,70,635,0.5923076923076923,2.0
100,100,100,100,100,100,600,0.8345864661654135,50,53,62,58,63,44,330,0.13709677419354838,2.0
67,89,116,79,116,33,500,0.2624113475177305,54,63,52,83,56,97,405,0.7697841726618705,0.5
90,130,80,65,85,55,505,0.4396551724137931,100,5,5,15,65,30,220,0.07692307692307693,2.0
70,84,70,65,70,51,410,0.2949640287769784,95,110,95,40,95,55,490,0.40336134453781514,1.0
75,89,85,55,65,36,405,0.29545454545454547,45,22,60,27,30,29,213,0.07518796992481203,0.5
60,60,60,60,60,60,360,0.38095238095238093,91,72,90,129,90,108,580,0.8620689655172413,1.0
40,80,100,30,30,20,300,0.11851851851851852,65,100,70,80,80,105,500,0.8666666666666667,4.0
68,85,65,165,135,100,618,0.8083333333333333,70,95,85,55,65,70,440,0.5,0.5
75,69,72,114,100,104,534,0.8253968253968254,80,70,70,90,100,70,480,0.5609756097560976,1.0
75,98,63,98,63,101,498,0.849624060150376,45,85,50,55,50,65,350,0.5076923076923077,1.0
85,110,76,65,82,56,474,0.3933333333333333,75,140,65,112,65,110,567,0.9140625,1.0
76,25,45,67,55,24,292,0.0390625,72,58,80,103,80,97,490,0.7171052631578947,0.5
70,90,45,15,45,50,315,0.3629032258064516,80,105,105,105,105,80,580,0.5939849624060151,1.0
75,125,75,30,75,85,465,0.625,60,85,42,85,42,91,405,0.8227848101265823,1.0
42,52,67,39,56,50,306,0.2868217054263566,56,61,65,48,45,38,313,0.17567567567567569,0.5
80,185,115,40,105,75,600,0.6230769230769231,50,53,48,53,48,64,316,0.4076923076923077,2.0
79,103,120,135,115,78,630,0.5763888888888888,85,80,90,105,95,60,515,0.49074074074074076,1.0
70,90,70,60,60,70,420,0.6390977443609023,62,48,54,63,60,68,355,0.5178571428571429,2.0
70,60,62,80,82,60,414,0.4375,35,55,40,45,40,60,275,0.35714285714285715,0.5
40,40,35,50,100,70,335,0.5031847133757962,40,45,40,35,35,56,251,0.373015873015873,1.0
85,80,90,105,95,60,515,0.49074074074074076,105,150,90,150,90,95,680,0.8285714285714286,1.0
83,80,75,70,70,101,479,0.8615384615384616,50,65,107,105,107,86,520,0.7272727272727273,0.5
95,65,65,110,130,60,525,0.4016393442622951,40,30,30,40,50,30,220,0.07936507936507936,1.0
30,40,55,40,55,60,280,0.3237410071942446,40,50,90,30,55,65,330,0.44680851063829785,0.5
50,65,107,105,107,86,520,0.7272727272727273,80,135,85,70,95,150,615,0.9844961240310077,1.0
65,150,40,15,80,145,495,0.9663865546218487,70,65,60,90,75,90,450,0.6571428571428571,0.25
55,95,115,45,45,35,390,0.2116788321167883,30,45,135,45,90,30,375,0.09285714285714286,2.0
78,52,60,63,65,23,341,0.06015037593984962,25,35,70,95,55,45,325,0.16783216783216784,0.5
110,65,75,125,85,30,490,0.15,60,50,40,85,75,95,405,0.7540983606557377,1.0
60,30,30,36,56,50,262,0.32432432432432434,50,25,28,45,55,15,218,0.0625,1.0
80,75,150,75,150,50,580,0.30973451327433627,100,150,140,100,90,90,670,0.7969924812030075,1.0
45,53,70,40,60,42,310,0.25735294117647056,50,50,95,40,50,35,320,0.20279720279720279,2.0
65,150,60,115,60,115,565,0.935251798561151,40,50,90,30,55,65,330,0.44680851063829785,1.0
106,150,70,194,120,140,780,0.952,50,50,77,95,77,91,440,0.5916666666666667,1.0
64,88,50,88,50,106,446,0.9111111111111111,73,95,62,85,65,85,465,0.6666666666666666,1.0
70,100,115,30,65,30,410,0.24390243902439024,60,62,63,80,80,60,405,0.38016528925619836,1.0
75,87,63,87,63,98,473,0.865546218487395,50,45,45,35,35,50,260,0.23529411764705882,1.0
50,52,48,65,50,55,320,0.33098591549295775,90,75,85,115,90,55,510,0.3445378151260504,1.0
55,55,50,45,65,55,325,0.37373737373737376,90,30,15,40,20,15,210,0.043478260869565216,1.0
70,90,45,15,45,50,315,0.3629032258064516,115,140,130,55,55,40,535,0.4519230769230769,0.5
65,60,110,130,95,65,525,0.47761194029850745,60,70,50,100,50,65,395,0.5217391304347826,2.0
50,70,50,50,50,70,340,0.5645161290322581,60,60,40,65,45,35,305,0.15833333333333333,2.0
75,100,63,80,63,116,497,0.9345794392523364,90,93,55,70,55,55,418,0.3819444444444444,1.0
95,117,80,65,70,92,519,0.8409090909090909,85,110,90,45,90,80,500,0.6206896551724138,1.0
100,50,50,76,96,70,442,0.5,55,75,85,25,25,15,280,0.1875,0.25
85,100,122,58,75,54,494,0.3939393939393939,62,77,62,50,42,65,358,0.4838709677419355,0.0
55,68,64,45,55,31,318,0.11666666666666667,80,100,80,80,80,100,520,0.9051724137931034,1.0
55,69,85,32,35,28,304,0.09302325581395349,75,75,55,105,85,30,425,0.1619718309859155,2.0
65,136,94,54,96,135,580,0.9612403100775194,60,62,50,62,60,40,334,0.18181818181818182,2.0
40,60,40,40,40,30,250,0.0948905109489051,35,20,65,40,65,20,245,0.02459016393442623,1.0
74,94,131,54,116,20,489,0.4485294117647059,65,60,110,130,95,65,525,0.47761194029850745,2.0
45,55,45,65,45,75,330,0.5692307692307692,130,65,60,110,95,65,525,0.5227272727272727,0.5
80,50,100,100,200,50,580,0.2357142857142857,20,25,45,70,90,60,310,0.30833333333333335,1.0
40,30,30,55,30,85,270,0.4666666666666667,65,60,70,85,75,40,395,0.1796875,1.0
60,80,50,40,40,30,300,0.15328467153284672,60,105,60,120,60,105,510,0.8849557522123894,2.0
50,80,95,10,45,10,290,0.232,40,45,40,65,40,65,295,0.5661764705882353,1.0
55,81,60,50,70,97,413,0.7214285714285714,44,38,39,61,79,42,303,0.2251655629139073,1.0
95,109,105,75,85,56,525,0.34513274336283184,85,110,76,65,82,56,474,0.3933333333333333,0.25
70,84,70,65,70,51,410,0.2949640287769784,80,92,65,65,80,68,450,0.4824561403508772,1.0
80,160,80,130,80,100,630,0.8455284552845529,91,72,90,129,90,108,580,0.8620689655172413,0.5
85,80,90,105,95,60,515,0.49074074074074076,35,20,65,40,65,20,245,0.02459016393442623,1.0
70,60,70,87,78,85,450,0.6228070175438597,95,70,73,95,90,60,483,0.3983739837398374,1.0
40,55,80,35,60,30,300,0.15037593984962405,45,60,40,70,50,45,310,0.2846715328467153,0.5
50,65,107,105,107,86,520,0.703125,62,55,52,109,94,109,481,0.7833333333333333,0.5
65,70,60,65,65,115,440,0.8583333333333333,105,140,55,30,55,95,480,0.8195488721804511,1.0
55,75,50,40,40,80,340,0.6302521008403361,35,85,45,35,35,75,310,0.6492537313432836,1.0
28,25,25,45,35,40,198,0.16083916083916083,108,100,121,81,95,95,600,0.7476635514018691,4.0
41,64,45,50,50,50,300,0.36752136752136755,71,95,85,110,95,79,535,0.664,1.0
85,120,70,50,60,100,485,0.8308823529411765,75,125,100,70,80,45,495,0.33035714285714285,0.5
50,50,40,50,40,64,294,0.45588235294117646,85,97,66,105,66,65,484,0.47107438016528924,2.0
59,66,70,44,55,41,335,0.25190839694656486,42,52,67,39,56,50,306,0.2868217054263566,4.0
40,45,35,30,40,55,245,0.3793103448275862,60,60,75,60,75,80,410,0.7321428571428571,2.0
70,55,75,45,65,60,370,0.45901639344262296,80,82,78,95,80,85,500,0.6869565217391305,1.0
40,40,40,70,40,20,250,0.032520325203252036,51,65,65,80,75,59,395,0.4365079365079365,2.0
73,100,60,100,60,65,458,0.42657342657342656,55,40,50,65,85,40,335,0.3181818181818182,0.5
70,60,125,115,70,55,495,0.35507246376811596,41,56,40,62,44,71,314,0.568,0.5
50,70,50,50,50,40,310,0.16296296296296298,100,77,77,128,128,90,600,0.6901408450704225,1.0
110,85,95,80,95,50,515,0.2713178294573643,85,120,70,50,60,100,485,0.8308823529411765,1.0
110,80,90,95,90,65,530,0.5033557046979866,50,85,85,55,55,50,380,0.3902439024390244,0.5
40,30,35,45,40,55,245,0.31496062992125984,79,115,70,125,80,111,580,0.8468468468468469,1.0
101,72,72,99,89,29,462,0.1937984496124031,110,85,95,80,95,50,515,0.2713178294573643,1.0
95,117,184,44,46,28,514,0.2975206611570248,40,29,45,29,45,36,224,0.14634146341463414,1.0
120,100,85,30,85,45,465,0.22448979591836735,65,75,105,35,65,85,430,0.6940298507462687,0.5
62,50,58,73,54,72,369,0.4435483870967742,80,110,60,150,130,70,600,0.5042016806722689,0.0
55,50,40,40,40,75,300,0.5945945945945946,60,65,60,130,75,110,500,0.7719298245614035,0.0
80,105,105,105,105,80,580,0.5939849624060151,45,40,60,40,75,50,310,0.2926829268292683,1.0
80,100,70,50,60,45,405,0.25806451612903225,79,115,70,125,80,111,580,0.864,0.5
82,80,86,85,75,72,480,0.6183206106870229,50,180,20,180,20,150,600,0.9029850746268657,1.0
28,25,25,45,35,40,198,0.16083916083916083,45,63,37,65,55,95,360,0.8055555555555556,1.0
1,90,45,30,30,40,236,0.33064516129032256,60,85,60,50,50,125,430,0.9090909090909091,0.0
95,100,85,108,70,70,528,0.5652173913043478,114,85,70,85,80,30,464,0.2066115702479339,0.5
20,15,20,10,55,80,200,0.2682926829268293,80,120,130,55,65,45,495,0.37037037037037035,4.0
30,45,59,30,39,57,260,0.2803030303030303,65,80,65,35,65,60,370,0.38405797101449274,1.0
50,75,35,70,30,40,300,0.21296296296296297,95,124,78,69,71,58,495,0.37398373983739835,1.0
45,30,40,105,50,20,290,0.031007751937984496,100,100,80,60,60,50,450,0.3050847457627119,2.0
85,76,64,45,55,90,415,0.6739130434782609,120,120,120,120,120,120,720,0.9344262295081968,1.0
60,62,50,62,60,40,334,0.18181818181818182,90,120,120,60,60,50,500,0.35294117647058826,4.0
90,92,87,75,85,76,505,0.5409836065573771,70,85,70,60,70,50,405,0.28378378378378377,0.5
65,150,40,15,80,145,495,0.9663865546218487,106,90,130,90,154,110,680,0.8699186991869918,1.0
80,135,85,70,95,150,615,0.9844961240310077,90,92,75,92,85,60,494,0.49586776859504134,4.0
67,89,116,79,116,33,500,0.2624113475177305,64,115,65,83,63,65,455,0.5323741007194245,1.0
100,100,80,60,60,50,450,0.3050847457627119,70,120,100,145,105,20,560,0.2824427480916031,2.0
100,150,110,95,110,70,635,0.5923076923076923,79,100,80,110,90,121,580,0.968,0.0
45,49,65,49,65,45,318,0.275,60,100,115,70,85,90,520,0.7557251908396947,0.5
30,45,59,30,39,57,260,0.2803030303030303,45,50,43,40,38,62,278,0.40441176470588236,0.5
105,150,90,150,90,95,680,0.8285714285714286,65,95,57,100,85,93,495,0.7441860465116279,1.0
45,85,50,55,50,65,350,0.5076923076923077,80,100,70,50,60,45,405,0.25806451612903225,1.0
70,110,70,115,70,90,525,0.75,78,92,75,74,63,118,500,0.8842975206611571,0.5
50,60,60,60,60,30,320,0.11290322580645161,65,75,90,97,123,44,494,0.1987179487179487,0.25
61,78,95,56,58,57,405,0.40336134453781514,75,105,75,105,75,45,480,0.3274336283185841,2.0
65,75,70,95,70,95,470,0.7272727272727273,56,61,65,48,45,38,313,0.17567567567567569,2.0
75,95,122,58,75,69,494,0.5725806451612904,35,65,35,65,35,65,300,0.46621621621621623,2.0
89,125,90,115,80,101,600,0.8725490196078431,116,55,85,107,95,29,487,0.06818181818181818,1.0
35,55,40,45,40,60,275,0.35714285714285715,45,45,55,45,55,63,308,0.4594594594594595,0.5
69,69,76,69,86,91,460,0.6554621848739496,55,55,45,63,45,45,308,0.25,0.5
60,85,60,50,50,125,430,0.9090909090909091,60,45,70,75,85,55,390,0.3008130081300813,1.0
59,63,80,65,80,58,405,0.41843971631205673,60,65,70,85,75,40,395,0.21705426356589147,0.5
70,120,100,145,105,20,560,0.2824427480916031,58,50,145,95,105,30,483,0.2459016393442623,1.0
70,95,125,65,75,45,475,0.33613445378151263,42,52,67,39,56,50,306,0.2868217054263566,1.0
100,134,110,95,100,61,600,0.4057971014492754,64,66,68,81,76,50,405,0.25190839694656486,1.0
75,38,38,56,56,67,330,0.5263157894736842,70,60,70,87,78,85,450,0.6228070175438597,0.25
80,95,82,60,82,75,474,0.6,100,150,110,95,110,70,635,0.5923076923076923,0.5
35,35,40,35,55,50,250,0.40336134453781514,77,59,50,67,63,46,362,0.23140495867768596,1.0
80,100,200,50,100,50,580,0.3472222222222222,75,100,66,60,66,115,482,0.918918918918919,1.0
75,85,200,55,65,30,510,0.16778523489932887,60,100,115,70,85,90,520,0.7557251908396947,1.0
65,90,65,61,61,100,442,0.8373983739837398,150,100,120,100,120,90,680,0.6666666666666666,0.0
78,84,78,109,85,100,534,0.8646616541353384,70,65,60,90,75,90,450,0.6571428571428571,4.0
37,25,41,25,41,25,194,0.08870967741935484,69,55,45,55,55,15,294,0.11666666666666667,1.0
75,100,63,80,63,116,497,0.9345794392523364,100,100,125,110,50,50,535,0.384,0.5
54,78,103,53,45,22,355,0.23255813953488372,100,100,100,100,100,100,600,0.8602941176470589,0.5
75,98,63,98,63,101,498,0.889763779527559,40,40,50,30,30,30,220,0.0873015873015873,2.0
45,60,30,80,50,65,330,0.4603174603174603,75,125,230,55,95,30,610,0.3448275862068966,2.0
65,95,57,100,85,93,495,0.7441860465116279,50,20,55,25,25,30,205,0.09774436090225563,2.0
50,70,50,50,50,70,340,0.5645161290322581,75,95,95,95,95,85,540,0.6470588235294118,2.0
59,74,50,35,50,35,303,0.3125,123,77,72,99,92,58,521,0.4621212121212121,2.0
103,60,126,80,126,50,545,0.36363636363636365,85,70,80,97,80,123,535,0.9304347826086956,2.0
76,147,90,60,70,97,540,0.8267716535433071,80,115,80,65,55,93,488,0.7846153846153846,1.0
45,20,50,60,120,50,345,0.24074074074074073,90,95,95,70,90,70,510,0.5230769230769231,1.0
45,49,49,65,65,45,318,0.2781954887218045,80,70,40,100,60,145,495,0.921875,0.5
60,60,60,35,35,30,280,0.11194029850746269,65,40,70,80,140,70,465,0.5954198473282443,1.0
45,45,55,45,55,63,308,0.4594594594594595,70,55,75,45,65,60,370,0.45901639344262296,0.5
80,70,40,100,60,145,495,0.921875,100,100,100,100,100,100,600,0.8805970149253731,1.0
70,110,80,55,80,105,500,0.8794326241134752,46,57,40,40,40,50,273,0.25,0.5
70,62,67,55,55,56,365,0.38513513513513514,40,45,35,40,40,90,290,0.65,1.0
49,66,70,44,55,51,335,0.4260869565217391,60,70,50,100,50,65,395,0.5217391304347826,0.25
95,110,80,70,80,50,485,0.37209302325581395,50,160,110,160,110,110,700,0.8854961832061069,1.0
60,85,69,65,79,80,438,0.576,76,147,90,60,70,97,540,0.8267716535433071,1.0
80,105,105,105,105,80,580,0.5939849624060151,50,47,50,57,50,65,319,0.463768115942029,1.0
60,130,80,60,60,70,460,0.5153846153846153,45,22,60,27,30,29,213,0.07518796992481203,0.25
44,38,39,61,79,42,303,0.2251655629139073,75,98,63,98,63,101,498,0.849624060150376,1.0
95,109,105,75,85,56,525,0.34513274336283184,45,85,50,55,50,65,350,0.5076923076923077,1.0
100,103,75,120,75,127,600,0.940677966101695,165,75,80,40,45,65,470,0.5151515151515151,2.0
165,75,80,40,45,65,470,0.5151515151515151,50,65,90,35,35,15,290,0.14678899082568808,1.0
75,125,230,55,95,30,610,0.3448275862068966,76,48,48,57,62,34,325,0.11688311688311688,0.5
49,66,70,44,55,51,335,0.4260869565217391,80,85,95,30,30,25,345,0.2857142857142857,4.0
75,75,130,75,130,95,580,0.7479674796747967,70,92,65,80,55,98,460,0.8090909090909091,1.0
50,75,45,40,45,60,315,0.4380165289256198,69,55,45,55,55,15,294,0.11666666666666667,1.0
111,83,68,92,82,39,475,0.1774193548387097,60,75,100,55,80,50,420,0.3088235294117647,2.0
55,55,55,85,55,30,335,0.1320754716981132,80,105,65,60,75,130,515,0.9645390070921985,1.0
100,70,70,65,65,45,415,0.1897810218978102,109,66,84,81,99,32,471,0.2013888888888889,1.0
90,132,105,132,105,30,594,0.4246575342465753,55,130,115,50,50,75,475,0.5982142857142857,1.0
50,47,50,57,50,65,319,0.463768115942029,60,90,140,50,50,40,430,0.2535211267605634,0.5
65,63,45,45,45,45,308,0.2595419847328244,60,62,50,62,60,40,334,0.18181818181818182,4.0
73,95,62,85,65,85,465,0.6666666666666666,95,23,48,23,48,23,260,0.046153846153846156,1.0
100,100,100,100,100,100,600,0.831858407079646,80,100,123,122,120,80,625,0.56,2.0
75,80,85,110,90,50,490,0.3548387096774194,77,59,50,67,63,46,362,0.23140495867768596,1.0
70,70,40,60,40,60,340,0.4247787610619469,110,65,105,55,95,80,510,0.6258503401360545,0.25
80,100,70,50,60,45,405,0.25806451612903225,80,75,150,75,150,50,580,0.30973451327433627,2.0
50,52,48,65,50,55,320,0.33098591549295775,30,40,55,40,55,60,280,0.3237410071942446,1.0
95,135,80,110,80,100,600,0.8248175182481752,67,57,55,77,55,114,425,0.8879310344827587,1.0
67,89,116,79,116,33,500,0.2624113475177305,80,95,82,60,82,75,474,0.6,2.0
79,103,120,135,115,78,630,0.5763888888888888,45,53,70,40,60,42,310,0.25735294117647056,0.5
83,106,65,86,65,85,490,0.6640625,35,55,35,30,30,35,220,0.23684210526315788,2.0
25,20,15,105,55,90,310,0.32407407407407407,100,100,100,100,100,100,600,0.8778625954198473,0.5
40,45,40,35,35,56,251,0.373015873015873,91,72,90,129,90,108,580,0.8925619834710744,2.0
116,55,85,107,95,29,487,0.06818181818181818,50,65,107,105,107,86,520,0.7758620689655172,1.0
50,64,50,45,50,41,300,0.22727272727272727,106,150,70,194,120,140,780,0.952,1.0
75,90,90,140,90,115,600,0.9481481481481482,60,40,80,60,45,40,325,0.23529411764705882,4.0
50,70,50,50,50,70,340,0.5645161290322581,60,95,80,60,80,30,405,0.19480519480519481,0.25
80,82,78,95,80,85,500,0.6869565217391305,65,95,57,100,85,93,495,0.7441860465116279,2.0
55,112,45,74,45,70,401,0.559322033898305,60,60,40,65,45,35,305,0.15833333333333333,1.0
60,80,50,50,50,40,330,0.23853211009174313,55,95,115,45,45,35,390,0.2116788321167883,0.5
25,35,70,95,55,45,325,0.16783216783216784,40,60,30,31,31,70,262,0.4492753623188406,2.0
69,55,45,55,55,15,294,0.11666666666666667,35,55,40,50,50,90,320,0.6838235294117647,1.0
60,85,60,50,50,125,430,0.9090909090909091,10,55,25,35,45,95,265,0.5396825396825397,1.0
45,35,45,62,53,35,275,0.11851851851851852,60,130,80,60,60,70,460,0.5153846153846153,0.5
65,130,60,95,110,65,525,0.5303030303030303,55,55,45,63,45,45,308,0.25,0.5
60,95,80,60,80,30,405,0.19480519480519481,84,86,88,111,101,60,530,0.4634146341463415,0.5
95,125,79,60,100,81,540,0.6165413533834586,70,70,70,70,70,70,420,0.5289256198347108,1.0
120,100,85,30,85,45,465,0.22448979591836735,105,125,100,60,100,100,590,0.8359375,2.0
35,20,65,40,65,20,245,0.02459016393442623,70,95,85,55,65,70,440,0.5,1.0
60,50,40,85,75,95,405,0.7540983606557377,55,95,115,45,45,35,390,0.2116788321167883,0.0
60,150,50,150,50,60,520,0.5,80,80,90,110,130,110,600,0.8721804511278195,2.0
50,50,40,50,40,64,294,0.45588235294117646,123,77,72,99,92,58,521,0.4621212121212121,2.0
45,30,50,65,50,45,285,0.13821138211382114,55,66,44,44,56,85,350,0.6888888888888889,1.0
60,48,45,43,90,42,328,0.21897810218978103,55,45,43,55,43,72,313,0.5853658536585366,0.5
65,76,84,54,96,105,480,0.9008264462809917,80,120,80,120,80,100,580,0.8478260869565217,1.0
59,59,58,90,70,73,409,0.5826086956521739,40,65,40,80,40,65,330,0.5038167938931297,1.0
106,90,130,90,154,110,680,0.8699186991869918,50,50,150,50,150,50,500,0.2571428571428571,0.5
70,110,80,55,80,105,500,0.8794326241134752,77,120,90,60,90,48,485,0.2785714285714286,1.0
40,30,30,55,30,85,270,0.4666666666666667,80,80,90,110,130,110,600,0.8721804511278195,0.5
80,135,85,70,95,150,615,0.9844961240310077,30,30,42,30,42,70,244,0.4230769230769231,8.0
111,83,68,92,82,39,475,0.1774193548387097,20,40,90,30,90,25,295,0.11363636363636363,1.0
45,35,50,70,50,30,280,0.15753424657534246,60,90,70,60,120,40,440,0.27419354838709675,1.0
70,85,70,60,70,50,405,0.28378378378378377,80,92,65,65,80,68,450,0.4824561403508772,0.5
60,50,150,50,150,60,520,0.5206611570247934,105,140,95,55,65,45,505,0.3,1.0
80,82,83,100,100,80,525,0.6742424242424242,123,77,72,99,92,58,521,0.4621212121212121,1.0
65,80,80,59,63,58,405,0.4411764705882353,80,70,65,80,120,100,515,0.8034188034188035,0.5
45,49,49,65,65,45,318,0.2781954887218045,90,130,80,65,85,55,505,0.4396551724137931,1.0
91,72,90,129,90,108,580,0.8620689655172413,106,110,90,154,90,130,680,0.926829268292683,0.5
89,145,90,105,80,91,600,0.8549618320610687,105,95,75,85,75,74,509,0.5714285714285714,1.0
49,66,70,44,55,51,335,0.4260869565217391,65,65,60,110,95,130,525,0.9253731343283582,1.0
105,30,105,140,105,55,540,0.3524590163934426,54,63,52,83,56,97,405,0.7697841726618705,0.5
80,135,130,95,90,70,600,0.5181818181818182,74,48,76,83,81,104,466,0.7322834645669292,0.5
50,180,20,180,20,150,600,0.9029850746268657,130,70,35,70,35,60,400,0.4017857142857143,1.0
70,80,102,80,102,40,474,0.2677165354330709,60,105,60,120,60,105,510,0.8849557522123894,2.0
84,71,43,71,43,48,360,0.25874125874125875,65,90,65,61,61,100,442,0.8373983739837398,1.0
65,47,55,73,75,85,400,0.65,40,50,90,30,55,65,330,0.44680851063829785,0.5
95,85,85,65,65,35,430,0.2571428571428571,86,76,86,116,56,95,515,0.7982456140350878,0.0
50,70,50,50,50,70,340,0.5645161290322581,100,100,100,100,100,100,600,0.8758169934640523,1.0
85,135,130,60,80,25,515,0.40540540540540543,59,63,80,65,80,58,405,0.41843971631205673,1.0
55,55,45,63,45,45,308,0.25,75,95,125,45,75,95,510,0.8257575757575758,2.0
85,70,80,97,80,123,535,0.9304347826086956,80,105,105,105,105,80,580,0.5939849624060151,1.0
40,55,99,40,79,47,360,0.26262626262626265,45,85,70,40,40,60,340,0.5229357798165137,0.0
35,35,35,35,35,35,210,0.13385826771653545,49,66,70,44,55,51,335,0.4260869565217391,0.0
41,56,40,62,44,71,314,0.568,75,90,50,110,80,95,500,0.7985611510791367,2.0
68,72,78,38,42,32,330,0.23809523809523808,65,100,70,80,80,105,500,0.8666666666666667,2.0
55,75,60,75,60,103,428,0.7982456140350878,100,5,5,15,65,30,220,0.07692307692307693,1.0
90,95,95,70,90,70,510,0.5230769230769231,82,121,119,69,59,71,521,0.5394736842105263,2.0
45,75,37,70,55,83,365,0.6183206106870229,40,35,30,120,70,105,400,0.6692307692307692,1.0
70,55,65,95,85,70,440,0.5307692307692308,80,100,200,50,100,50,580,0.3472222222222222,1.0
65,125,60,95,60,105,510,0.9236641221374046,105,30,105,140,105,55,540,0.3524590163934426,0.5
45,30,15,85,65,65,305,0.36220472440944884,65,60,70,85,75,40,395,0.1796875,1.0
65,130,60,95,110,65,525,0.5303030303030303,40,65,40,80,40,65,330,0.5038167938931297,1.0
123,77,72,99,92,58,521,0.4621212121212121,80,45,65,90,110,80,470,0.5462962962962963,1.0
40,80,35,35,45,70,305,0.4661016949152542,38,30,85,55,65,30,303,0.21428571428571427,0.0
68,125,65,65,115,80,518,0.6277372262773723,50,75,75,65,65,50,380,0.4049586776859504,0.0
60,65,80,170,95,130,600,0.8625954198473282,105,140,95,55,65,45,505,0.3,1.0
77,59,50,67,63,46,362,0.23140495867768596,60,48,45,43,90,42,328,0.21897810218978103,1.0
40,45,35,65,55,70,310,0.4482758620689655,70,94,50,94,50,66,424,0.48148148148148145,0.25
45,45,55,45,55,63,308,0.4594594594594595,91,90,106,130,106,77,600,0.648854961832061,0.25
60,45,50,90,80,70,395,0.625,40,55,80,35,60,30,300,0.15037593984962405,0.5
40,45,35,65,55,70,310,0.4482758620689655,43,80,65,50,35,35,308,0.14193548387096774,2.0
59,63,80,65,80,58,405,0.41843971631205673,45,22,60,27,30,29,213,0.07518796992481203,1.0
100,103,75,120,75,127,600,0.940677966101695,82,121,119,69,59,71,521,0.5394736842105263,0.5
68,72,78,38,42,32,330,0.23809523809523808,91,90,106,130,106,77,600,0.648854961832061,4.0
80,100,70,50,60,45,405,0.25806451612903225,60,50,50,60,70,50,340,0.28346456692913385,1.0
75,55,70,55,95,110,460,0.8444444444444444,90,120,120,60,60,50,500,0.35294117647058826,2.0
43,80,65,50,35,35,308,0.14193548387096774,95,80,105,40,70,100,490,0.8046875,1.0
78,92,75,74,63,118,500,0.8842975206611571,60,62,50,62,60,40,334,0.18181818181818182,4.0
20,10,230,10,230,5,505,0.0,60,40,60,40,60,35,295,0.18055555555555555,2.0
40,45,40,65,40,65,295,0.5661764705882353,50,50,150,50,150,50,500,0.2571428571428571,1.0
88,107,122,74,75,64,530,0.4596774193548387,64,78,52,78,52,81,405,0.6422764227642277,0.5
100,50,80,60,80,50,420,0.34375,91,134,95,100,100,80,600,0.6304347826086957,1.0
106,110,90,154,90,130,680,0.926829268292683,95,117,184,44,46,28,514,0.2975206611570248,1.0
80,50,100,100,200,50,580,0.2357142857142857,80,85,95,30,30,25,345,0.2857142857142857,2.0
75,105,75,105,75,45,480,0.3274336283185841,50,70,50,50,50,70,340,0.5645161290322581,1.0
75,125,75,30,75,85,465,0.625,70,65,65,55,55,70,380,0.5,2.0
100,100,90,150,140,90,670,0.71875,35,70,55,45,55,25,285,0.09420289855072464,0.5
70,55,95,95,110,65,490,0.48872180451127817,60,60,60,85,85,85,435,0.631578947368421,1.0
80,85,95,30,30,25,345,0.2857142857142857,100,100,100,100,100,100,600,0.8345864661654135,0.5
85,100,122,58,75,54,494,0.3939393939393939,43,30,55,40,65,97,330,0.6030534351145038,2.0
55,95,55,35,75,115,430,0.9380530973451328,80,82,100,83,100,80,525,0.6821705426356589,2.0
89,145,90,105,80,91,600,0.8549618320610687,65,80,65,35,65,60,370,0.38405797101449274,1.0
54,66,70,44,55,46,335,0.4214876033057851,85,115,80,105,80,50,515,0.3063063063063063,1.0
44,58,44,58,44,61,309,0.41964285714285715,70,83,50,37,50,60,350,0.3360655737704918,1.0
90,95,95,70,90,70,510,0.5230769230769231,60,80,110,50,80,45,425,0.2833333333333333,2.0
30,40,55,40,55,60,280,0.3237410071942446,60,85,40,30,45,68,328,0.6422018348623854,2.0
67,57,55,77,55,114,425,0.8879310344827587,65,50,70,95,80,65,425,0.4262295081967213,0.5
69,69,76,69,86,91,460,0.6554621848739496,95,95,85,125,65,55,520,0.3894736842105263,0.5
80,120,130,55,65,45,495,0.37037037037037035,55,63,90,50,80,42,380,0.21138211382113822,0.5
65,155,120,65,90,105,600,0.8677685950413223,68,75,53,83,113,60,452,0.45384615384615384,1.0
38,30,41,30,41,60,240,0.2897196261682243,55,81,60,50,70,97,413,0.7214285714285714,1.0
65,95,57,100,85,93,495,0.7441860465116279,83,80,75,70,70,101,479,0.8615384615384616,1.0
70,20,50,20,50,40,250,0.1557377049180328,45,49,49,65,65,45,318,0.2781954887218045,0.25
103,60,126,80,126,50,545,0.36363636363636365,45,40,60,40,75,50,310,0.2926829268292683,1.0
108,112,118,68,72,47,525,0.2916666666666667,80,45,65,90,110,80,470,0.5462962962962963,1.0
30,45,135,45,90,30,375,0.09285714285714286,75,80,85,110,90,50,490,0.3548387096774194,1.0
38,35,35,65,55,50,278,0.2647058823529412,65,130,60,95,110,65,525,0.5303030303030303,0.5
80,130,100,160,120,110,700,0.8981481481481481,45,60,45,25,45,55,275,0.29,1.0
95,65,110,60,130,65,525,0.5275590551181102,30,56,35,25,35,72,253,0.48148148148148145,1.0
65,150,60,115,60,115,565,0.935251798561151,50,65,90,35,35,15,290,0.14678899082568808,1.0
85,90,80,70,80,130,535,0.9262295081967213,50,20,55,25,25,30,205,0.09774436090225563,2.0
78,52,60,63,65,23,341,0.06015037593984962,90,75,85,115,90,55,510,0.3445378151260504,1.0
75,123,67,95,85,95,540,0.7642276422764228,40,65,95,60,45,35,340,0.13986013986013987,1.0
30,45,135,45,90,30,375,0.09285714285714286,80,50,100,100,200,50,580,0.2357142857142857,2.0
67,57,55,77,55,114,425,0.8879310344827587,70,40,50,55,50,25,290,0.061068702290076333,1.0
85,105,85,40,50,40,405,0.211864406779661,45,80,100,35,37,28,325,0.3125,0.0
49,55,42,42,37,85,310,0.6068376068376068,65,45,55,45,70,45,325,0.24369747899159663,1.0
100,100,100,100,100,100,600,0.8805970149253731,80,160,60,170,130,80,680,0.6180555555555556,1.0
91,72,90,129,90,108,580,0.8925619834710744,70,83,50,37,50,60,350,0.3360655737704918,1.0
50,150,50,150,50,150,600,0.9339622641509434,50,160,110,160,110,110,700,0.8854961832061069,1.0
70,65,65,55,55,70,380,0.5,79,85,60,55,60,71,410,0.60431654676259,1.0
59,63,80,65,80,58,405,0.41843971631205673,95,117,184,44,46,28,514,0.2975206611570248,1.0
35,80,50,50,70,120,405,0.84375,62,50,58,73,54,72,369,0.4435483870967742,2.0
67,58,57,81,67,101,431,0.8790322580645161,75,95,95,95,95,85,540,0.6470588235294118,2.0
30,30,30,30,30,30,180,0.12612612612612611,65,75,90,97,123,44,494,0.1987179487179487,0.25
45,22,60,27,30,29,213,0.07518796992481203,99,68,83,72,87,51,460,0.417910447761194,1.0
67,58,57,81,67,101,431,0.8790322580645161,39,52,43,60,50,65,309,0.49107142857142855,0.5
61,78,95,56,58,57,405,0.40336134453781514,95,80,105,40,70,100,490,0.8046875,1.0
70,120,40,95,40,95,460,0.8106060606060606,80,45,65,90,110,80,470,0.5462962962962963,2.0
45,100,135,65,135,45,525,0.29411764705882354,60,45,70,45,90,95,405,0.7304964539007093,1.0
75,125,75,30,75,85,465,0.625,60,50,150,50,150,60,520,0.5206611570247934,0.0
65,100,70,80,80,105,500,0.8666666666666667,40,27,60,37,50,66,280,0.36220472440944884,2.0
91,72,90,129,90,108,580,0.8925619834710744,35,55,35,30,30,35,220,0.23684210526315788,2.0
100,90,130,45,65,55,485,0.4253731343283582,50,70,50,50,50,40,310,0.16296296296296298,0.5
44,48,65,50,64,43,314,0.1623931623931624,75,75,60,83,60,60,413,0.39344262295081966,0.5
65,75,70,95,70,95,470,0.7272727272727273,55,55,50,45,65,55,325,0.37373737373737376,1.0
60,70,105,70,120,75,500,0.5983606557377049,74,48,76,83,81,104,466,0.7913043478260869,0.5
90,60,60,40,40,40,330,0.29545454545454547,30,45,55,70,55,85,340,0.5633802816901409,1.0
95,125,79,60,100,81,540,0.6165413533834586,75,80,55,25,35,35,305,0.18666666666666668,2.0
50,85,40,85,40,35,335,0.1746031746031746,55,55,50,45,65,55,325,0.37373737373737376,1.0
150,80,44,90,54,80,498,0.625,90,90,85,125,90,100,580,0.768595041322314,0.5
38,41,40,50,65,65,299,0.4108527131782946,82,80,86,85,75,72,480,0.6183206106870229,1.0
100,150,90,180,160,90,770,0.7348484848484849,40,70,40,35,40,60,285,0.392,1.0
40,60,40,40,40,30,250,0.0948905109489051,35,70,55,45,55,25,285,0.09420289855072464,4.0
70,140,70,110,65,105,560,0.95,60,59,85,79,105,36,424,0.16666666666666666,0.5
65,80,65,35,65,60,370,0.38405797101449274,55,40,40,65,45,35,280,0.16428571428571428,1.0
65,75,105,35,65,85,430,0.6940298507462687,40,60,30,31,31,70,262,0.4492753623188406,0.0
38,30,85,55,65,30,303,0.21428571428571427,70,62,67,55,55,56,365,0.38513513513513514,1.0
70,75,60,105,60,105,475,0.88,105,130,120,45,45,40,485,0.4444444444444444,0.0
20,10,230,10,230,5,505,0.0,95,85,85,65,65,35,430,0.2571428571428571,0.5
90,70,80,70,95,70,475,0.5190839694656488,70,77,60,97,60,108,472,0.8394160583941606,1.0
50,64,50,45,50,41,300,0.22727272727272727,69,55,45,55,55,15,294,0.11666666666666667,1.0
78,52,60,63,65,23,341,0.06015037593984962,50,50,95,40,50,35,320,0.20279720279720279,1.0
86,76,86,116,56,95,515,0.7982456140350878,100,50,50,76,96,70,442,0.5,0.5
90,75,75,90,100,70,500,0.5462184873949579,78,52,60,63,65,23,341,0.06015037593984962,1.0
100,164,150,95,120,71,700,0.5645161290322581,50,50,40,50,40,64,294,0.45588235294117646,1.0
74,94,131,54,116,20,489,0.4485294117647059,100,100,100,100,100,100,600,0.8805970149253731,1.0
54,63,52,83,56,97,405,0.7697841726618705,125,58,58,76,76,67,460,0.515625,0.5
50,60,45,100,80,65,400,0.45689655172413796,86,92,88,68,75,73,482,0.6835443037974683,1.0
60,70,105,70,120,75,500,0.5983606557377049,50,70,50,50,50,70,340,0.5645161290322581,2.0
40,50,90,30,55,65,330,0.44680851063829785,45,45,55,45,55,63,308,0.4594594594594595,4.0
65,55,115,100,40,60,435,0.3798449612403101,85,60,65,135,105,100,550,0.7518248175182481,0.25
45,53,70,40,60,42,310,0.25735294117647056,60,90,55,90,80,110,485,0.8677685950413223,1.0
60,79,105,59,85,36,424,0.17054263565891473,62,77,62,50,42,65,358,0.4838709677419355,0.0
70,45,48,60,65,35,323,0.15748031496062992,75,98,63,98,63,101,498,0.8091603053435115,1.0
35,65,35,65,35,65,300,0.46621621621621623,85,73,70,73,115,67,483,0.5126050420168067,1.0
84,86,88,111,101,60,530,0.4634146341463415,60,60,60,60,60,60,360,0.38095238095238093,1.0
40,45,40,62,60,60,307,0.33884297520661155,125,58,58,76,76,67,460,0.515625,0.5
40,55,30,30,30,85,270,0.688,54,66,70,44,55,46,335,0.4214876033057851,0.0
65,40,70,80,140,70,465,0.5954198473282443,103,60,86,60,86,50,445,0.3458646616541353,1.0
92,105,90,125,90,98,600,0.8217054263565892,45,63,37,65,55,95,360,0.8055555555555556,1.0
40,65,95,60,45,35,340,0.13986013986013987,50,50,50,50,50,50,300,0.30708661417322836,1.0
77,85,51,55,51,65,384,0.5163934426229508,68,85,65,165,135,100,618,0.8083333333333333,1.0
65,65,60,130,95,110,525,0.823943661971831,44,58,44,58,44,61,309,0.41964285714285715,1.0
55,40,40,65,45,35,280,0.16428571428571428,80,100,70,60,70,95,475,0.7416666666666667,0.5
90,75,85,115,90,55,510,0.3445378151260504,55,75,60,75,60,103,428,0.7982456140350878,1.0
70,85,70,60,70,50,405,0.28378378378378377,40,60,40,40,40,30,250,0.0948905109489051,1.0
75,75,75,125,95,40,485,0.15671641791044777,64,115,65,83,63,65,455,0.5323741007194245,1.0
50,64,50,45,50,41,300,0.22727272727272727,65,85,70,75,70,40,405,0.203125,2.0
65,90,120,85,70,60,490,0.43410852713178294,53,51,53,61,56,40,314,0.14285714285714285,1.0
110,123,65,100,65,65,528,0.5217391304347826,75,80,60,65,90,102,472,0.8625954198473282,2.0
62,55,52,109,94,109,481,0.7833333333333333,76,147,90,60,70,97,540,0.8267716535433071,0.5
72,85,70,65,70,58,420,0.41304347826086957,65,150,40,15,80,145,495,0.9663865546218487,1.0
73,100,60,100,60,65,458,0.42657342657342656,65,50,35,115,95,95,455,0.7333333333333333,1.0
255,10,10,75,135,55,540,0.3125,52,65,55,58,62,60,352,0.4482758620689655,1.0
90,60,70,75,70,45,410,0.23880597014925373,65,50,35,115,95,95,455,0.7333333333333333,0.5
44,38,33,61,43,70,289,0.5267857142857143,67,82,62,46,48,43,348,0.22033898305084745,1.0
64,115,65,83,63,65,455,0.5323741007194245,70,77,60,97,60,108,472,0.8394160583941606,1.0
72,60,30,20,30,25,237,0.11570247933884298,40,27,60,37,50,66,280,0.36220472440944884,0.5
70,60,75,110,75,90,480,0.7165354330708661,70,80,65,90,65,85,455,0.578125,1.0
60,105,60,120,60,105,510,0.8849557522123894,60,80,95,70,85,50,440,0.2231404958677686,1.0
44,75,35,63,33,45,295,0.2647058823529412,73,100,60,100,60,65,458,0.42657342657342656,1.0
50,53,48,53,48,64,316,0.46153846153846156,80,80,80,55,55,90,440,0.6417910447761194,1.0
28,25,25,45,35,40,198,0.16083916083916083,55,65,95,95,45,85,440,0.6610169491525424,1.0
90,92,75,92,85,60,494,0.49586776859504134,120,70,120,75,130,85,600,0.6694915254237288,1.0
80,110,60,150,130,70,600,0.5042016806722689,95,145,130,120,90,120,700,0.9398496240601504,1.0
90,110,80,100,80,95,555,0.7982456140350878,36,50,50,65,60,44,305,0.16363636363636364,2.0
57,24,86,24,86,23,300,0.12727272727272726,80,75,150,75,150,50,580,0.30973451327433627,0.25
62,73,55,56,52,84,382,0.7244094488188977,45,100,135,65,135,45,525,0.29411764705882354,1.0
75,90,90,140,90,115,600,0.9481481481481482,81,102,77,85,75,85,505,0.5642857142857143,1.0
80,110,120,130,90,70,600,0.6198347107438017,35,46,34,35,45,20,215,0.072,1.0
45,63,37,65,55,95,360,0.8055555555555556,50,95,90,95,90,180,600,0.9172413793103448,1.0
95,75,80,100,110,30,490,0.24242424242424243,64,51,23,51,23,28,240,0.11363636363636363,1.0
62,73,55,56,52,84,382,0.7244094488188977,95,109,105,75,85,56,525,0.34513274336283184,4.0
85,100,122,58,75,54,494,0.3939393939393939,50,50,150,50,150,50,500,0.2571428571428571,2.0
85,80,70,135,75,90,535,0.7006802721088435,60,60,60,85,85,85,435,0.631578947368421,0.0
66,65,48,62,57,52,350,0.36220472440944884,90,120,120,60,60,50,500,0.35294117647058826,2.0
80,100,70,60,70,95,475,0.7416666666666667,95,110,95,40,95,55,490,0.40336134453781514,1.0
85,90,80,70,80,130,535,0.9262295081967213,45,55,39,35,39,42,255,0.18518518518518517,1.0
90,93,55,70,55,55,418,0.3819444444444444,75,95,125,45,75,95,510,0.8257575757575758,0.5
91,90,129,90,72,108,580,0.9140625,86,81,97,81,107,43,495,0.203125,4.0
106,110,90,154,90,130,680,0.926829268292683,60,25,35,70,80,60,330,0.3076923076923077,0.5
105,105,75,65,100,50,500,0.37593984962406013,50,48,43,46,41,60,288,0.47297297297297297,0.5
50,85,40,85,40,35,335,0.1746031746031746,48,72,48,72,48,48,336,0.25984251968503935,1.0
58,89,77,45,45,48,362,0.3177570093457944,62,50,58,73,54,72,369,0.4435483870967742,2.0
50,65,107,105,107,86,520,0.7272727272727273,70,105,105,50,40,20,390,0.33587786259541985,0.5
40,45,35,40,40,90,290,0.65,50,65,107,105,107,86,520,0.7272727272727273,1.0
80,90,80,130,110,110,600,0.856,55,66,44,44,56,85,350,0.6888888888888889,1.0
85,73,70,73,115,67,483,0.5126050420168067,70,90,110,60,75,95,500,0.7333333333333333,0.0
70,140,230,60,80,50,630,0.32432432432432434,60,60,60,105,105,105,495,0.848,1.0
55,55,50,45,65,55,325,0.37373737373737376,108,100,121,81,95,95,600,0.7476635514018691,1.0
65,45,55,45,70,45,325,0.24369747899159663,90,85,75,115,100,115,580,0.9381443298969072,1.0
70,115,60,115,60,55,475,0.4647887323943662,60,52,168,47,138,30,495,0.19834710743801653,1.0
68,165,95,65,115,110,618,0.8615384615384616,70,60,75,110,75,90,480,0.7165354330708661,1.0
75,75,55,105,85,30,425,0.1619718309859155,40,45,40,35,35,56,251,0.373015873015873,0.5
90,65,65,40,40,15,315,0.19672131147540983,70,120,100,145,105,20,560,0.2824427480916031,8.0
95,100,85,108,70,70,528,0.5652173913043478,100,77,77,128,128,90,600,0.6901408450704225,1.0
70,80,70,80,70,110,480,0.6594202898550725,65,75,90,97,123,44,494,0.1987179487179487,2.0
95,110,95,40,95,55,490,0.40336134453781514,65,95,100,60,50,50,420,0.34959349593495936,1.0
110,130,80,70,60,80,530,0.5862068965517241,75,95,95,95,95,85,540,0.6470588235294118,1.0
90,130,80,65,85,55,505,0.4396551724137931,60,30,30,36,56,50,262,0.32432432432432434,1.0
95,110,95,40,95,55,490,0.40336134453781514,65,80,80,59,63,58,405,0.4411764705882353,1.0
65,85,70,75,70,40,405,0.203125,60,70,50,100,50,65,395,0.5217391304347826,2.0
63,120,85,90,55,55,468,0.2809917355371901,45,25,50,25,25,35,205,0.13076923076923078,1.0
70,115,60,115,60,55,475,0.4647887323943662,50,70,50,50,50,40,310,0.16296296296296298,2.0
60,48,45,43,90,42,328,0.21897810218978103,58,64,58,80,65,80,405,0.5423728813559322,1.0
65,110,130,60,65,95,525,0.8278145695364238,101,72,72,99,89,29,462,0.1937984496124031,1.0
108,112,118,68,72,47,525,0.2916666666666667,42,52,67,39,56,50,306,0.2868217054263566,2.0
50,60,60,60,60,30,320,0.11290322580645161,77,85,51,55,51,65,384,0.5163934426229508,1.0
250,5,5,35,105,50,450,0.15306122448979592,35,55,35,30,30,35,220,0.23684210526315788,1.0
73,100,60,100,60,65,458,0.42657342657342656,65,60,110,130,95,65,525,0.47761194029850745,1.0
91,129,90,72,90,108,580,0.8536585365853658,40,30,35,50,70,55,280,0.28205128205128205,0.5
38,30,41,30,41,60,240,0.2897196261682243,60,50,40,85,75,95,405,0.7540983606557377,1.0
100,150,90,180,160,90,770,0.7348484848484849,40,70,130,60,130,25,455,0.17355371900826447,1.0
43,80,65,50,35,35,308,0.14193548387096774,126,131,95,131,98,99,680,0.8102189781021898,1.0
75,100,110,45,55,65,450,0.5333333333333333,50,85,40,85,40,35,335,0.1746031746031746,0.5
115,45,20,45,25,20,270,0.11538461538461539,115,115,85,90,75,100,580,0.8134328358208955,0.5
65,125,60,95,60,105,510,0.9236641221374046,30,40,55,40,55,60,280,0.3237410071942446,0.5
75,125,75,30,75,85,465,0.625,126,131,95,131,98,99,680,0.8294573643410853,0.5
80,120,80,120,80,100,580,0.8478260869565217,50,35,55,25,25,15,205,0.021739130434782608,1.0
45,25,50,25,25,35,205,0.13076923076923078,85,70,80,97,80,123,535,0.9304347826086956,0.5
80,70,40,100,60,145,495,0.921875,40,80,100,30,30,20,300,0.11851851851851852,1.0
60,100,85,80,85,100,510,0.7007874015748031,75,80,55,25,35,35,305,0.18666666666666668,1.0
65,70,60,65,65,115,440,0.8583333333333333,63,60,55,50,50,71,349,0.5289256198347108,1.0
65,130,60,75,60,75,465,0.689922480620155,83,80,80,135,80,121,579,0.9444444444444444,1.0
50,50,95,40,50,35,320,0.20279720279720279,45,22,60,27,30,29,213,0.07518796992481203,0.5
45,65,34,40,34,45,263,0.2589928057553957,68,75,53,83,113,60,452,0.45384615384615384,0.5
54,78,103,53,45,22,355,0.23255813953488372,60,40,80,60,45,40,325,0.23529411764705882,0.5
85,110,90,45,90,80,500,0.6206896551724138,59,110,150,45,49,35,448,0.3333333333333333,0.0
54,45,47,75,98,52,371,0.39669421487603307,40,55,80,35,60,30,300,0.15037593984962405,0.5
55,85,122,58,75,99,494,0.8099173553719008,60,150,50,150,50,60,520,0.5,1.0
45,30,50,65,50,45,285,0.13821138211382114,110,160,110,80,110,100,670,0.8591549295774648,1.0
80,185,115,40,105,75,600,0.6230769230769231,62,48,66,59,57,49,341,0.33884297520661155,0.25
60,50,150,50,150,60,520,0.5206611570247934,80,185,115,40,105,75,600,0.6230769230769231,1.0
106,110,90,154,90,130,680,0.926829268292683,65,55,115,100,40,60,435,0.3798449612403101,1.0
110,78,73,76,71,60,468,0.3333333333333333,85,110,76,65,82,56,474,0.3933333333333333,0.25
55,40,85,80,105,40,405,0.23622047244094488,85,50,95,120,115,80,545,0.5793650793650794,1.0
50,20,40,20,40,20,190,0.0962962962962963,60,40,60,40,60,35,295,0.18055555555555555,1.0
70,70,70,70,70,70,420,0.5289256198347108,60,50,50,60,70,50,340,0.28346456692913385,1.0
75,87,63,87,63,98,473,0.865546218487395,190,33,58,33,58,33,405,0.13432835820895522,1.0
60,80,50,40,40,30,300,0.15328467153284672,70,60,62,80,82,60,414,0.4375,1.0
75,98,63,98,63,101,498,0.889763779527559,60,79,105,59,85,36,424,0.17054263565891473,2.0
70,77,60,97,60,108,472,0.8394160583941606,62,44,50,44,50,55,305,0.3629032258064516,2.0
75,80,85,110,90,50,490,0.3548387096774194,73,76,75,81,100,100,505,0.8110236220472441,0.5
60,55,50,40,55,45,305,0.22377622377622378,106,110,90,154,90,130,680,0.926829268292683,2.0
78,52,60,63,65,23,341,0.06015037593984962,66,41,77,61,87,23,355,0.12096774193548387,1.0
126,131,95,131,98,99,680,0.8102189781021898,60,60,60,60,60,60,360,0.38095238095238093,1.0
59,45,40,35,40,31,250,0.14285714285714285,41,50,37,50,37,66,281,0.5175438596491229,1.0
95,60,79,100,125,81,540,0.6201550387596899,40,40,40,70,40,20,250,0.032520325203252036,2.0
115,140,130,55,55,40,535,0.4519230769230769,70,20,50,20,50,40,250,0.1557377049180328,1.0
45,50,35,55,75,40,300,0.21367521367521367,65,125,100,60,70,70,490,0.6099290780141844,0.5
65,75,90,97,123,44,494,0.1987179487179487,70,65,65,55,55,70,380,0.5,1.0
60,60,75,60,75,80,410,0.7321428571428571,40,55,70,45,60,30,300,0.10619469026548672,1.0
100,110,90,85,90,60,535,0.47794117647058826,75,38,38,56,56,67,330,0.5263157894736842,1.0
110,160,110,80,110,100,670,0.8591549295774648,45,20,50,60,120,50,345,0.24074074074074073,1.0
76,65,45,92,42,91,411,0.7449664429530202,40,30,32,50,52,65,269,0.3671875,2.0
100,103,75,120,75,127,600,0.940677966101695,80,52,50,90,50,89,411,0.6666666666666666,0.5
90,50,34,60,44,70,348,0.6283185840707964,70,45,48,60,65,35,323,0.15748031496062992,1.0
103,60,126,80,126,50,545,0.36363636363636365,125,58,58,76,76,67,460,0.515625,1.0
65,65,45,75,45,95,390,0.72,65,90,122,58,75,84,494,0.71875,2.0
60,85,60,50,50,125,430,0.9090909090909091,45,100,135,65,135,45,525,0.29411764705882354,0.0
60,60,60,105,105,105,495,0.848,70,43,53,43,53,40,302,0.19090909090909092,1.0
85,110,76,65,82,56,474,0.3933333333333333,45,49,65,49,65,45,318,0.275,0.5
75,75,55,105,85,30,425,0.1619718309859155,57,80,91,80,87,75,470,0.5737704918032787,0.5
40,50,45,70,45,70,320,0.5517241379310345,45,75,37,70,55,83,365,0.6183206106870229,1.0
99,68,83,72,87,51,460,0.417910447761194,50,120,53,35,110,87,455,0.640625,2.0
45,49,49,65,65,45,318,0.2781954887218045,62,55,52,109,94,109,481,0.7833333333333333,1.0
65,95,100,60,50,50,420,0.34959349593495936,105,180,100,180,100,115,780,0.9477611940298507,2.0
50,50,40,30,30,50,250,0.2781954887218045,40,45,40,65,40,65,295,0.5661764705882353,2.0
123,77,72,99,92,58,521,0.4621212121212121,100,110,90,85,90,60,535,0.47794117647058826,0.5
60,65,70,85,75,40,395,0.21705426356589147,43,30,55,40,65,97,330,0.6030534351145038,2.0
63,60,55,50,50,71,349,0.5289256198347108,60,59,85,79,105,36,424,0.16666666666666666,4.0
95,135,80,110,80,100,600,0.8248175182481752,85,115,80,105,80,50,515,0.3063063063063063,0.5
35,64,85,74,55,32,345,0.19827586206896552,35,65,35,65,35,65,300,0.46621621621621623,0.5
70,60,125,115,70,55,495,0.35507246376811596,75,75,130,75,130,95,580,0.7479674796747967,1.0
110,135,60,50,65,88,508,0.7744360902255639,126,131,95,131,98,99,680,0.8102189781021898,0.0
100,150,120,120,100,90,680,0.6493506493506493,100,100,90,150,140,90,670,0.71875,2.0
60,85,49,60,49,60,363,0.4444444444444444,81,102,77,85,75,85,505,0.5642857142857143,0.0
100,70,70,65,65,45,415,0.1897810218978102,106,90,130,90,154,110,680,0.8699186991869918,1.0
110,78,73,76,71,60,468,0.3333333333333333,70,80,102,80,102,40,474,0.2677165354330709,0.0
82,121,119,69,59,71,521,0.5394736842105263,70,85,70,60,70,50,405,0.28378378378378377,0.5
100,100,125,110,50,50,535,0.384,80,82,100,83,100,80,525,0.6821705426356589,0.5
40,80,100,30,30,20,300,0.11851851851851852,58,64,58,80,65,80,405,0.5423728813559322,4.0
40,45,40,35,35,56,251,0.373015873015873,45,100,135,65,135,45,525,0.29411764705882354,0.0
59,45,40,35,40,31,250,0.14285714285714285,95,65,110,60,130,65,525,0.5275590551181102,1.0
69,69,76,69,86,91,460,0.6554621848739496,45,49,65,49,65,45,318,0.275,0.5
80,120,79,95,79,70,523,0.5833333333333334,105,140,95,55,65,45,505,0.3,1.0
100,100,100,100,100,100,600,0.8805970149253731,95,75,180,130,80,30,590,0.13793103448275862,0.5
66,41,77,61,87,23,355,0.12096774193548387,35,55,40,45,40,60,275,0.35714285714285715,1.0
110,160,110,80,110,100,670,0.8591549295774648,126,131,95,131,98,99,680,0.8294573643410853,1.0
100,150,90,180,160,90,770,0.7348484848484849,70,105,105,50,40,20,390,0.33587786259541985,2.0
65,65,60,130,95,110,525,0.823943661971831,50,65,90,35,35,15,290,0.14678899082568808,1.0
65,50,70,95,80,65,425,0.4262295081967213,50,160,110,160,110,110,700,0.8854961832061069,1.0
50,105,125,55,95,50,480,0.375886524822695,95,155,109,70,130,81,640,0.6788321167883211,1.0
85,80,90,105,95,60,515,0.49074074074074076,55,55,45,63,45,45,308,0.25,1.0
72,58,80,103,80,97,490,0.7171052631578947,95,70,73,95,90,60,483,0.3983739837398374,1.0
106,110,90,154,90,130,680,0.926829268292683,61,78,95,56,58,57,405,0.40336134453781514,1.0
50,53,48,53,48,64,316,0.358974358974359,50,95,90,95,90,180,600,0.9172413793103448,1.0
45,67,60,35,50,63,320,0.5128205128205128,75,100,110,45,55,65,450,0.5333333333333333,2.0
50,50,62,40,62,65,329,0.4188034188034188,50,53,48,53,48,64,316,0.46153846153846156,1.0
38,41,40,50,65,65,299,0.4108527131782946,108,112,118,68,72,47,525,0.2916666666666667,1.0
70,60,125,115,70,55,495,0.35507246376811596,50,50,120,80,80,30,410,0.07258064516129033,8.0
45,49,65,49,65,45,318,0.275,50,85,85,55,55,50,380,0.3902439024390244,0.5
44,75,35,63,33,45,295,0.2647058823529412,60,85,49,60,49,60,363,0.4444444444444444,1.0
100,90,130,45,65,55,485,0.4253731343283582,78,65,68,112,154,75,552,0.628099173553719,1.0
65,125,100,60,70,70,490,0.6099290780141844,35,55,40,50,50,90,320,0.6838235294117647,0.5
91,90,106,130,106,77,600,0.648854961832061,100,50,50,76,96,70,442,0.5,1.0
55,112,45,74,45,70,401,0.559322033898305,91,72,90,129,90,108,580,0.8925619834710744,1.0
44,48,65,50,64,43,314,0.1623931623931624,80,70,70,90,100,70,480,0.5609756097560976,0.25
100,50,80,60,80,50,420,0.34375,81,102,77,85,75,85,505,0.5642857142857143,1.0
75,98,63,98,63,101,498,0.889763779527559,60,60,60,85,85,85,435,0.631578947368421,1.0
75,87,63,87,63,98,473,0.865546218487395,60,85,60,50,50,125,430,0.9090909090909091,1.0
40,30,35,50,70,55,280,0.28205128205128205,70,50,30,95,135,105,485,0.8040540540540541,1.0
75,95,67,125,95,83,540,0.7117117117117117,50,53,48,53,48,64,316,0.4076923076923077,2.0
110,80,90,95,90,65,530,0.5033557046979866,66,65,48,62,57,52,350,0.36220472440944884,1.0
50,85,40,85,40,35,335,0.1746031746031746,110,135,60,50,65,88,508,0.7744360902255639,1.0
76,65,45,92,42,91,411,0.7449664429530202,60,60,50,40,50,75,335,0.5882352941176471,2.0
65,70,60,65,65,115,440,0.8583333333333333,110,78,73,76,71,60,468,0.3333333333333333,1.0
43,30,55,40,65,97,330,0.6030534351145038,40,30,30,40,50,30,220,0.07936507936507936,0.25
70,65,60,90,75,90,450,0.6571428571428571,45,30,50,55,65,45,290,0.208,2.0
65,150,60,115,60,115,565,0.935251798561151,46,57,40,40,40,50,273,0.25,1.0
68,90,65,50,55,82,410,0.6165413533834586,85,60,65,135,105,100,550,0.7518248175182481,1.0
80,70,40,100,60,145,495,0.921875,85,70,80,97,80,123,535,0.9304347826086956,0.5
60,80,50,50,50,40,330,0.23853211009174313,75,90,50,110,80,95,500,0.7985611510791367,1.0
76,48,48,57,62,34,325,0.11688311688311688,60,85,49,60,49,60,363,0.4444444444444444,1.0
80,80,80,80,80,80,480,0.5606060606060606,30,45,135,45,90,30,375,0.09285714285714286,2.0
40,45,65,100,120,90,460,0.5588235294117647,90,50,34,60,44,70,348,0.6283185840707964,1.0
55,112,45,74,45,70,401,0.559322033898305,86,92,88,68,75,73,482,0.6835443037974683,1.0
90,120,100,150,120,100,680,0.7718120805369127,65,76,84,54,96,105,480,0.9008264462809917,1.0
85,100,122,58,75,54,494,0.3939393939393939,35,46,34,35,45,20,215,0.072,0.0
64,66,68,81,76,50,405,0.25190839694656486,115,140,130,55,55,40,535,0.4519230769230769,4.0
72,95,67,103,71,122,530,0.9606299212598425,45,30,50,65,50,45,285,0.13821138211382114,2.0
86,81,97,81,107,43,495,0.203125,76,48,48,57,62,34,325,0.11688311688311688,2.0
44,58,44,58,44,61,309,0.41964285714285715,101,72,72,99,89,29,462,0.1937984496124031,1.0
65,65,65,50,50,90,385,0.72,55,40,85,80,105,40,405,0.23622047244094488,1.0
79,115,70,125,80,111,580,0.864,95,60,79,100,125,81,540,0.6201550387596899,2.0
50,30,55,65,55,20,275,0.13675213675213677,75,89,85,55,65,36,405,0.29545454545454547,2.0
106,110,90,154,90,130,680,0.926829268292683,45,60,30,80,50,65,330,0.4603174603174603,0.0
65,90,40,45,80,75,395,0.625,20,25,45,70,90,60,310,0.30833333333333335,2.0
51,65,65,80,75,59,395,0.4365079365079365,80,100,70,60,70,95,475,0.7416666666666667,2.0
35,55,35,30,30,35,220,0.23684210526315788,75,75,55,105,85,30,425,0.1619718309859155,1.0
80,100,70,50,60,45,405,0.25806451612903225,55,69,85,32,35,28,304,0.09302325581395349,2.0
116,55,85,107,95,29,487,0.06818181818181818,90,75,75,90,100,70,500,0.5462184873949579,1.0
40,45,40,35,35,56,251,0.373015873015873,60,69,95,69,95,36,424,0.2608695652173913,0.5
95,65,110,60,130,65,525,0.5275590551181102,100,77,77,128,128,90,600,0.6901408450704225,2.0
80,80,50,40,50,25,325,0.176056338028169,116,55,85,107,95,29,487,0.06818181818181818,1.0
66,41,77,61,87,23,355,0.12096774193548387,109,66,84,81,99,32,471,0.2013888888888889,1.0
58,89,77,45,45,48,362,0.3177570093457944,45,75,60,40,30,50,300,0.304,2.0
100,50,50,76,96,70,442,0.5,49,66,70,44,55,51,335,0.4260869565217391,0.0
70,120,100,145,105,20,560,0.2824427480916031,67,57,55,77,55,114,425,0.8879310344827587,0.0
95,95,85,125,65,55,520,0.3894736842105263,75,100,63,80,63,116,497,0.9345794392523364,1.0
68,75,53,83,113,60,452,0.45384615384615384,35,35,40,35,55,50,250,0.40336134453781514,1.0
65,40,50,125,60,30,370,0.07258064516129033,30,45,135,45,90,30,375,0.09285714285714286,1.0
60,85,49,60,49,60,363,0.4444444444444444,91,90,129,90,72,108,580,0.9140625,1.0
65,80,65,35,65,60,370,0.38405797101449274,30,30,42,30,42,70,244,0.4230769230769231,1.0
40,70,130,60,130,25,455,0.17355371900826447,55,66,44,44,56,85,350,0.6888888888888889,0.0
50,85,55,65,65,90,410,0.7478260869565218,100,134,110,95,100,61,600,0.4057971014492754,0.5
60,50,70,50,90,65,385,0.39568345323741005,150,100,120,100,120,90,680,0.6666666666666666,0.25
75,98,63,98,63,101,498,0.849624060150376,80,120,79,95,79,70,523,0.5833333333333334,1.0
46,57,40,40,40,50,273,0.25,105,180,100,180,100,115,780,0.9477611940298507,1.0
85,50,95,120,115,80,545,0.5793650793650794,76,65,45,92,42,91,411,0.7449664429530202,1.0
80,160,60,170,130,80,680,0.6180555555555556,36,50,50,65,60,44,305,0.16363636363636364,1.0
60,65,70,85,75,40,395,0.21705426356589147,90,65,65,40,40,15,315,0.19672131147540983,2.0
62,48,54,63,60,68,355,0.5178571428571429,90,95,105,165,110,45,610,0.2890625,1.0
103,60,126,80,126,50,545,0.36363636363636365,50,64,50,45,50,41,300,0.22727272727272727,0.5
40,50,45,70,45,70,320,0.5517241379310345,80,70,70,90,100,70,480,0.5609756097560976,2.0
125,170,100,120,90,95,700,0.77,70,60,62,80,82,60,414,0.4375,2.0
60,105,60,120,60,105,510,0.8849557522123894,100,100,100,100,100,100,600,0.8345864661654135,2.0
100,120,120,150,100,90,680,0.7880794701986755,75,85,200,55,65,30,510,0.16778523489932887,0.25
50,70,50,50,50,70,340,0.5645161290322581,45,50,43,40,38,62,278,0.40441176470588236,0.0
79,103,120,135,115,78,630,0.5763888888888888,40,45,40,35,35,56,251,0.373015873015873,1.0
65,136,94,54,96,135,580,0.9612403100775194,35,55,40,50,50,90,320,0.6838235294117647,1.0
60,65,70,85,75,40,395,0.21705426356589147,75,100,95,40,70,110,490,0.8717948717948718,1.0
100,100,80,60,60,50,450,0.3050847457627119,50,75,35,70,30,40,300,0.21296296296296297,2.0
72,58,80,103,80,97,490,0.7171052631578947,65,55,115,100,40,60,435,0.3798449612403101,2.0
40,45,35,30,40,55,245,0.3793103448275862,65,90,65,61,61,100,442,0.8373983739837398,1.0
60,40,60,95,60,55,370,0.4222222222222222,67,82,62,46,48,43,348,0.22033898305084745,1.0
75,80,70,65,75,90,455,0.7578125,45,50,43,40,38,62,278,0.40441176470588236,1.0
40,40,40,70,40,20,250,0.032520325203252036,80,120,79,95,79,70,523,0.5833333333333334,1.0
75,55,70,55,95,110,460,0.8444444444444444,55,104,105,94,75,52,485,0.36363636363636365,2.0
125,130,90,130,90,95,660,0.7734375,70,145,88,140,70,112,625,0.8888888888888888,0.25
65,90,120,85,70,60,490,0.43410852713178294,50,72,35,35,35,65,292,0.5373134328358209,0.5
60,60,60,35,35,30,280,0.11194029850746269,62,73,55,56,52,84,382,0.7244094488188977,1.0
109,66,84,81,99,32,471,0.2013888888888889,190,33,58,33,58,33,405,0.13432835820895522,1.0
90,75,75,90,100,70,500,0.5462184873949579,45,75,37,70,55,83,365,0.6183206106870229,2.0
70,60,125,115,70,55,495,0.35507246376811596,60,80,95,70,85,50,440,0.2231404958677686,0.5
60,85,49,60,49,60,363,0.4444444444444444,50,70,100,40,40,30,330,0.2222222222222222,1.0
10,55,25,35,45,95,265,0.5396825396825397,50,65,64,44,48,43,314,0.2196969696969697,1.0
61,90,45,50,50,160,456,0.9230769230769231,65,150,60,115,60,115,565,0.935251798561151,2.0
165,75,80,40,45,65,470,0.5151515151515151,80,120,70,110,70,80,530,0.6422764227642277,2.0
90,60,60,40,40,40,330,0.29545454545454547,30,45,59,30,39,57,260,0.2803030303030303,1.0
73,115,60,60,60,90,458,0.6694915254237288,80,45,65,90,110,80,470,0.5462962962962963,1.0
70,70,115,130,90,60,535,0.5338983050847458,60,60,40,65,45,35,305,0.15833333333333333,0.0
45,100,45,45,45,10,290,0.2949640287769784,43,80,65,50,35,35,308,0.14193548387096774,1.0
75,65,55,65,55,69,384,0.43548387096774194,65,65,60,130,95,110,525,0.823943661971831,1.0
39,52,43,60,50,65,309,0.49107142857142855,95,60,79,100,125,81,540,0.6201550387596899,0.5
60,85,40,30,45,68,328,0.6422018348623854,57,24,86,24,86,23,300,0.12727272727272726,2.0
55,50,45,135,95,120,500,0.7714285714285715,100,90,130,45,65,55,485,0.4253731343283582,1.0
110,65,75,125,85,30,490,0.15,48,72,48,72,48,48,336,0.25984251968503935,0.5
67,82,62,46,48,43,348,0.22033898305084745,40,30,35,50,70,55,280,0.28205128205128205,0.5
43,80,65,50,35,35,308,0.14193548387096774,80,125,75,40,95,85,500,0.6911764705882353,1.0
35,46,34,35,45,20,215,0.072,50,120,53,35,110,87,455,0.640625,1.0
65,125,60,95,60,105,510,0.9236641221374046,100,100,90,150,140,90,670,0.71875,1.0
43,80,65,50,35,35,308,0.14193548387096774,60,85,40,30,45,68,328,0.6422018348623854,2.0
85,70,80,97,80,123,535,0.9304347826086956,110,123,65,100,65,65,528,0.5217391304347826,2.0
100,100,90,150,140,90,670,0.71875,85,110,90,45,90,80,500,0.6206896551724138,1.0
150,120,100,120,100,90,680,0.664179104477612,50,60,60,60,60,30,320,0.11290322580645161,1.0
40,45,40,35,35,56,251,0.373015873015873,75,125,100,70,80,45,495,0.33035714285714285,0.5
65,50,35,115,95,95,455,0.7333333333333333,65,155,120,65,90,105,600,0.8677685950413223,2.0
70,110,80,55,80,105,500,0.8794326241134752,65,130,60,95,110,65,525,0.5303030303030303,0.5
38,30,41,30,41,60,240,0.2897196261682243,75,100,95,40,70,110,490,0.8717948717948718,1.0
80,135,130,95,90,70,600,0.5181818181818182,73,95,62,85,65,85,465,0.6666666666666666,1.0
65,65,60,130,95,110,525,0.823943661971831,65,50,70,95,80,65,425,0.4262295081967213,0.5
78,84,78,109,85,100,534,0.8646616541353384,41,56,40,62,44,71,314,0.568,0.5
50,65,64,44,48,43,314,0.2196969696969697,84,86,88,111,101,60,530,0.4634146341463415,0.5
72,85,70,65,70,58,420,0.41304347826086957,60,150,50,150,50,60,520,0.5,1.0
68,75,53,83,113,60,452,0.45384615384615384,50,50,95,40,50,35,320,0.20279720279720279,1.0
70,100,115,30,65,30,410,0.24390243902439024,55,65,95,95,45,85,440,0.6610169491525424,1.0
85,50,95,120,115,80,545,0.5793650793650794,50,180,20,180,20,150,600,0.9029850746268657,1.0
55,85,55,50,55,60,360,0.4233576642335766,55,75,50,40,40,80,340,0.6302521008403361,0.5
72,105,115,54,86,68,500,0.5149253731343284,78,84,78,109,85,100,534,0.8620689655172413,4.0
50,50,40,50,40,64,294,0.45588235294117646,100,180,160,150,90,90,770,0.7520661157024794,4.0
85,100,122,58,75,54,494,0.3939393939393939,80,90,80,130,110,110,600,0.856,1.0
59,59,58,90,70,73,409,0.5826086956521739,83,80,80,135,80,121,579,0.9444444444444444,1.0
101,72,72,99,89,29,462,0.1937984496124031,70,55,65,95,85,70,440,0.5307692307692308,1.0
60,90,70,60,120,40,440,0.27419354838709675,75,123,67,95,85,95,540,0.7642276422764228,1.0
90,100,70,110,150,80,600,0.6037735849056604,105,30,105,140,105,55,540,0.3524590163934426,1.0
80,70,40,100,60,145,495,0.921875,62,48,66,59,57,49,341,0.33884297520661155,0.5
40,55,99,40,79,47,360,0.26262626262626265,75,98,63,98,63,101,498,0.889763779527559,0.5
60,69,95,69,95,36,424,0.2608695652173913,58,70,45,40,45,42,300,0.25925925925925924,1.0
43,80,65,50,35,35,308,0.14193548387096774,95,100,85,108,70,70,528,0.5652173913043478,0.5
30,105,90,25,25,50,325,0.2773722627737226,100,70,70,65,65,45,415,0.1897810218978102,1.0
91,134,95,100,100,80,600,0.6304347826086957,67,82,62,46,48,43,348,0.22033898305084745,2.0
90,95,95,70,90,70,510,0.5230769230769231,100,100,100,100,100,100,600,0.8345864661654135,0.25
61,72,57,55,55,65,365,0.3984375,54,78,103,53,45,22,355,0.23255813953488372,0.5
75,110,110,110,105,80,590,0.656934306569343,70,85,140,85,70,20,470,0.272,0.5
65,75,70,95,70,95,470,0.7272727272727273,45,100,135,65,135,45,525,0.29411764705882354,1.0
50,50,95,40,50,35,320,0.20279720279720279,48,61,40,61,40,50,300,0.2543859649122807,2.0
50,48,43,46,41,60,288,0.47297297297297297,80,120,130,55,65,45,495,0.37037037037037035,8.0
80,92,65,65,80,68,450,0.4824561403508772,76,25,45,67,55,24,292,0.0390625,1.0
90,95,95,70,90,70,510,0.5230769230769231,40,45,35,30,40,55,245,0.3793103448275862,0.25
75,80,55,25,35,35,305,0.18666666666666668,106,130,90,110,154,90,680,0.719626168224299,0.5
75,80,55,25,35,35,305,0.18666666666666668,55,50,40,40,40,75,300,0.5945945945945946,2.0
40,30,35,45,40,55,245,0.31496062992125984,54,45,47,75,98,52,371,0.39669421487603307,0.0
68,85,65,165,135,100,618,0.8083333333333333,45,50,43,40,38,62,278,0.40441176470588236,1.0
80,110,120,130,90,70,600,0.6198347107438017,80,160,80,130,80,100,630,0.8455284552845529,1.0
67,125,40,30,30,58,350,0.3431372549019608,106,90,130,90,154,110,680,0.8699186991869918,2.0
45,60,45,25,45,55,275,0.29,100,100,90,150,140,90,670,0.71875,1.0
45,50,43,40,38,62,278,0.40441176470588236,72,60,30,20,30,25,237,0.11570247933884298,2.0
65,105,60,60,70,95,455,63.0,35,40,100,90,55,35,355,0.1796875,2.0
75,75,75,125,95,40,485,0.15671641791044777,40,50,90,30,55,65,330,0.44680851063829785,2.0
35,46,34,35,45,20,215,0.072,63,63,47,41,41,74,329,0.56,1.0
20,25,45,70,90,60,310,0.30833333333333335,45,22,60,27,30,29,213,0.07518796992481203,1.0
75,100,110,45,55,65,450,0.5333333333333333,30,40,70,70,25,60,295,0.41353383458646614,1.0
39,52,43,60,50,65,309,0.5041322314049587,49,49,56,49,61,66,330,0.5190839694656488,0.5
100,120,100,150,120,90,680,0.728,78,81,71,74,69,126,499,0.9090909090909091,0.5
75,125,70,125,70,115,580,0.9037037037037037,40,55,80,35,60,30,300,0.15037593984962405,0.25
115,45,20,45,25,20,270,0.11538461538461539,80,130,100,160,120,110,700,0.8981481481481481,2.0
80,130,100,160,120,110,700,0.8981481481481481,90,100,70,110,150,80,600,0.6037735849056604,2.0
80,100,70,50,60,45,405,0.25806451612903225,80,75,150,75,150,50,580,0.30973451327433627,2.0
66,65,48,62,57,52,350,0.36220472440944884,75,80,95,90,100,50,490,0.2158273381294964,0.5
55,65,95,95,45,85,440,0.6610169491525424,40,80,100,30,30,20,300,0.11851851851851852,4.0
78,84,78,109,85,100,534,0.8620689655172413,109,66,84,81,99,32,471,0.2013888888888889,1.0
76,48,48,57,62,34,325,0.11688311688311688,120,70,120,75,130,85,600,0.6694915254237288,1.0
30,45,59,30,39,57,260,0.2803030303030303,165,75,80,40,45,65,470,0.5151515151515151,1.0
97,165,60,65,50,58,495,0.3902439024390244,75,125,70,125,70,115,580,0.9037037037037037,1.0
86,92,88,68,75,73,482,0.6835443037974683,101,72,72,99,89,29,462,0.1937984496124031,0.5
45,75,37,70,55,83,365,0.6183206106870229,50,65,107,105,107,86,520,0.7758620689655172,0.5
68,165,95,65,115,110,618,0.8615384615384616,70,77,60,97,60,108,472,0.8394160583941606,0.5
71,73,88,120,89,59,500,0.43537414965986393,60,80,95,70,85,50,440,0.2231404958677686,1.0
55,95,115,45,45,35,390,0.2116788321167883,70,90,45,15,45,50,315,0.3629032258064516,4.0
95,125,79,60,100,81,540,0.6165413533834586,75,80,85,110,90,50,490,0.3548387096774194,1.0
50,85,125,85,115,20,480,0.4306569343065693,37,25,41,25,41,25,194,0.08870967741935484,1.0
72,105,115,54,86,68,500,0.5149253731343284,40,45,35,65,55,70,310,0.4482758620689655,0.5
40,30,30,40,50,30,220,0.07936507936507936,40,70,40,35,40,60,285,0.392,1.0
65,40,50,125,60,30,370,0.07258064516129033,61,72,57,55,55,65,365,0.3984375,2.0
80,80,90,110,130,110,600,0.8721804511278195,28,25,25,45,35,40,198,0.16083916083916083,0.0
40,35,30,120,70,105,400,0.6692307692307692,45,55,45,65,45,75,330,0.5692307692307692,1.0
90,90,85,125,90,100,580,0.768595041322314,41,64,45,50,50,50,300,0.36752136752136755,0.5
80,125,75,40,95,85,500,0.6911764705882353,45,55,45,65,45,75,330,0.5692307692307692,0.5
60,100,89,55,69,112,485,0.9298245614035088,50,60,60,60,60,30,320,0.11290322580645161,0.25
43,80,65,50,35,35,308,0.14193548387096774,40,65,95,60,45,35,340,0.13986013986013987,1.0
30,40,70,70,25,60,295,0.41353383458646614,40,30,35,50,70,55,280,0.28205128205128205,0.5
65,70,60,65,65,115,440,0.8583333333333333,91,129,90,72,90,108,580,0.8536585365853658,0.5
45,67,60,35,50,63,320,0.5128205128205128,99,68,83,72,87,51,460,0.417910447761194,0.5
45,30,40,105,50,20,290,0.031007751937984496,45,80,100,35,37,28,325,0.3125,0.5
60,60,50,40,50,75,335,0.5882352941176471,103,60,126,80,126,50,545,0.36363636363636365,1.0
46,87,60,30,40,57,320,0.37777777777777777,80,82,100,83,100,80,525,0.6821705426356589,1.0
75,75,55,105,85,30,425,0.1619718309859155,55,130,115,50,50,75,475,0.5982142857142857,2.0
65,130,60,95,110,65,525,0.5303030303030303,78,92,75,74,63,118,500,0.8842975206611571,1.0
75,65,55,65,55,69,384,0.43548387096774194,70,94,50,94,50,66,424,0.48148148148148145,0.0
80,80,90,110,130,110,600,0.8721804511278195,75,80,95,90,100,50,490,0.2158273381294964,1.0
60,50,70,50,90,65,385,0.39568345323741005,95,145,130,120,90,120,700,0.9398496240601504,0.5
70,62,67,55,55,56,365,0.38513513513513514,80,82,83,100,100,80,525,0.6742424242424242,1.0
91,90,72,90,129,108,580,0.896,20,40,90,30,90,25,295,0.11363636363636363,0.0
90,120,120,60,60,50,500,0.35294117647058826,55,130,115,50,50,75,475,0.5982142857142857,1.0
85,80,70,135,75,90,535,0.7006802721088435,91,129,90,72,90,108,580,0.8536585365853658,0.5
60,70,105,70,120,75,500,0.5983606557377049,75,105,75,105,75,45,480,0.3274336283185841,1.0
55,50,45,135,95,120,500,0.7714285714285715,80,80,80,80,80,80,480,0.5606060606060606,1.0
55,45,43,55,43,72,313,0.5853658536585366,64,115,65,83,63,65,455,0.5323741007194245,1.0
40,45,35,65,55,70,310,0.4482758620689655,95,85,85,65,65,35,430,0.2571428571428571,4.0
77,59,50,67,63,46,362,0.23140495867768596,95,117,184,44,46,28,514,0.2975206611570248,1.0
60,60,60,85,85,85,435,0.631578947368421,99,68,83,72,87,51,460,0.417910447761194,1.0
95,70,73,95,90,60,483,0.3983739837398374,100,120,100,150,120,90,680,0.728,1.0
40,70,130,60,130,25,455,0.17355371900826447,45,95,50,40,50,75,355,0.54,1.0
50,65,107,105,107,86,520,0.7272727272727273,60,100,89,55,69,112,485,0.9298245614035088,2.0
108,100,121,81,95,95,600,0.7476635514018691,74,108,133,83,65,32,495,0.32142857142857145,2.0
126,131,95,131,98,99,680,0.8294573643410853,110,65,75,125,85,30,490,0.15,1.0
85,105,55,85,50,115,495,0.9032258064516129,135,85,40,40,85,5,390,0.6864406779661016,1.0
58,64,58,80,65,80,405,0.609271523178808,80,70,40,100,60,145,495,0.921875,2.0
70,62,67,55,55,56,365,0.38513513513513514,1,90,45,30,30,40,236,0.33064516129032256,0.5
90,120,75,60,60,45,450,0.29411764705882354,95,65,110,60,130,65,525,0.5275590551181102,2.0
48,72,48,72,48,48,336,0.25984251968503935,60,60,75,60,75,80,410,0.7321428571428571,0.5
50,180,20,180,20,150,600,0.9029850746268657,30,35,30,100,35,80,310,0.4765625,2.0
80,105,65,60,75,130,515,0.9645390070921985,55,55,45,63,45,45,308,0.25,1.0
1,90,45,30,30,40,236,0.33064516129032256,50,65,64,44,48,43,314,0.2196969696969697,1.0
80,105,65,60,75,130,515,0.9645390070921985,85,120,70,50,60,100,485,0.8308823529411765,2.0
65,110,130,60,65,95,525,0.8278145695364238,95,110,95,40,95,55,490,0.40336134453781514,1.0
60,50,50,60,70,50,340,0.28346456692913385,105,95,75,85,75,74,509,0.5714285714285714,4.0
45,60,32,50,32,76,295,0.5925925925925926,45,100,135,65,135,45,525,0.29411764705882354,1.0
50,105,125,55,95,50,480,0.375886524822695,39,52,43,60,50,65,309,0.49107142857142855,0.25
65,150,40,15,80,145,495,0.9663865546218487,55,55,50,45,65,55,325,0.37373737373737376,1.0
80,160,80,130,80,100,630,0.8455284552845529,110,65,75,125,85,30,490,0.15,0.5
75,98,63,98,63,101,498,0.8091603053435115,95,124,78,69,71,58,495,0.37398373983739835,1.0
68,65,65,125,115,80,518,0.6461538461538462,65,125,100,60,70,70,490,0.6099290780141844,0.0
60,62,63,80,80,60,405,0.38016528925619836,60,115,105,65,70,80,495,0.7181818181818181,2.0
40,80,100,30,30,20,300,0.11851851851851852,91,90,106,130,106,77,600,0.648854961832061,4.0
40,80,100,30,30,20,300,0.11851851851851852,100,123,75,57,75,80,510,0.6923076923076923,0.0
50,53,48,53,48,64,316,0.4076923076923077,89,145,90,105,80,91,600,0.8549618320610687,1.0
60,85,60,50,50,125,430,0.9090909090909091,89,124,80,55,80,55,483,0.5714285714285714,0.0
50,50,40,30,30,50,250,0.2781954887218045,55,70,55,40,55,85,360,0.7073170731707317,1.0
40,80,100,30,30,20,300,0.11851851851851852,116,55,85,107,95,29,487,0.06818181818181818,1.0
70,135,105,60,105,20,495,0.5806451612903226,67,57,55,77,55,114,425,0.8879310344827587,1.0
60,115,105,65,70,80,495,0.7181818181818181,62,50,58,73,54,72,369,0.4435483870967742,4.0
40,50,45,70,45,70,320,0.5517241379310345,65,85,70,75,70,40,405,0.203125,0.5
82,80,86,85,75,72,480,0.6183206106870229,20,25,45,70,90,60,310,0.30833333333333335,1.0
45,22,60,27,30,29,213,0.07518796992481203,40,40,40,70,40,20,250,0.032520325203252036,0.5
40,29,45,29,45,36,224,0.14634146341463414,55,130,115,50,50,75,475,0.5982142857142857,1.0
59,66,70,44,55,41,335,0.25190839694656486,70,43,53,43,53,40,302,0.19090909090909092,0.5
49,66,70,44,55,51,335,0.4260869565217391,67,82,62,46,48,43,348,0.22033898305084745,1.0
50,70,50,50,50,70,340,0.5645161290322581,84,71,43,71,43,48,360,0.25874125874125875,1.0
20,40,90,30,90,25,295,0.11363636363636363,76,48,48,57,62,34,325,0.11688311688311688,1.0
90,85,75,115,100,115,580,0.9381443298969072,90,65,65,40,40,15,315,0.19672131147540983,2.0
60,25,35,70,80,60,330,0.3076923076923077,35,45,160,30,45,70,385,0.48148148148148145,2.0
85,80,90,105,95,60,515,0.49074074074074076,45,65,34,40,34,45,263,0.2589928057553957,1.0
40,45,35,40,40,90,290,0.65,50,65,107,105,107,86,520,0.703125,1.0
99,68,83,72,87,51,460,0.417910447761194,68,75,53,83,113,60,452,0.45384615384615384,0.5
85,60,65,135,105,100,550,0.7518248175182481,80,100,70,60,70,95,475,0.7416666666666667,4.0
40,55,30,30,30,60,245,0.43548387096774194,106,110,90,154,90,130,680,0.926829268292683,1.0
165,75,80,40,45,65,470,0.5151515151515151,80,80,50,40,50,25,325,0.176056338028169,1.0
78,70,61,50,61,100,420,0.8145161290322581,80,135,130,95,90,70,600,0.5181818181818182,0.5
60,90,70,60,120,40,440,0.27419354838709675,100,50,80,60,80,50,420,0.34375,1.0
49,55,42,42,37,85,310,0.6068376068376068,110,65,105,55,95,80,510,0.6258503401360545,1.0
38,30,85,55,65,30,303,0.21428571428571427,70,90,110,60,75,95,500,0.7333333333333333,0.5
40,55,30,30,30,85,270,0.688,55,112,45,74,45,70,401,0.559322033898305,0.25
95,70,73,95,90,60,483,0.3983739837398374,78,81,71,74,69,126,499,0.9090909090909091,0.5
60,150,50,150,50,60,520,0.5,44,38,39,61,79,42,303,0.2251655629139073,0.5
100,100,90,150,140,90,670,0.71875,70,90,70,60,60,70,420,0.6390977443609023,1.0
35,65,35,65,35,65,300,0.46621621621621623,90,70,80,70,95,70,475,0.5190839694656488,0.5
100,128,90,77,77,128,600,0.959349593495935,95,60,79,100,125,81,540,0.6201550387596899,1.0
60,50,100,85,70,65,430,0.47580645161290325,70,75,60,105,60,105,475,0.88,0.5
75,98,63,98,63,101,498,0.889763779527559,78,70,61,50,61,100,420,0.8145161290322581,1.0
100,180,160,150,90,90,770,0.7520661157024794,104,91,63,91,73,68,490,0.5118110236220472,1.0
60,100,85,80,85,100,510,0.7007874015748031,40,55,99,40,79,47,360,0.26262626262626265,0.5
65,47,55,73,75,85,400,0.65,60,60,60,85,85,85,435,0.631578947368421,0.5
80,80,80,80,80,80,480,0.6015037593984962,50,65,107,105,107,86,520,0.703125,0.5
80,100,123,122,120,80,625,0.56,103,60,126,80,126,50,545,0.36363636363636365,2.0
150,80,44,90,54,80,498,0.625,50,70,160,70,160,90,600,0.7417218543046358,2.0
60,85,40,30,45,68,328,0.6422018348623854,55,65,95,95,45,85,440,0.6610169491525424,1.0
52,65,55,58,62,60,352,0.4482758620689655,78,84,78,109,85,100,534,0.8646616541353384,1.0
60,115,105,65,70,80,495,0.7181818181818181,100,100,100,100,100,100,600,0.8758169934640523,0.5
85,56,77,50,77,78,423,0.53125,130,65,60,110,95,65,525,0.5227272727272727,1.0
80,135,85,70,95,150,615,0.9844961240310077,60,45,70,75,85,55,390,0.3008130081300813,1.0
55,55,50,45,65,55,325,0.37373737373737376,89,145,90,105,80,91,600,0.8549618320610687,1.0
80,185,115,40,105,75,600,0.6230769230769231,65,55,115,100,40,60,435,0.3798449612403101,2.0
80,82,83,100,100,80,525,0.6742424242424242,58,50,145,95,105,30,483,0.2459016393442623,0.5
30,30,30,30,30,30,180,0.12612612612612611,75,85,200,55,65,30,510,0.16778523489932887,1.0
75,80,95,90,100,50,490,0.2158273381294964,60,50,70,80,80,140,480,0.8449612403100775,1.0
123,100,62,97,81,68,531,0.4806201550387597,45,30,50,65,50,45,285,0.13821138211382114,1.0
30,42,118,42,88,30,350,0.112,66,117,70,40,50,67,410,0.4573643410852713,1.0
91,134,95,100,100,80,600,0.6304347826086957,100,110,90,85,90,60,535,0.47794117647058826,1.0
78,81,71,74,69,126,499,0.9090909090909091,80,45,65,90,110,80,470,0.5462962962962963,1.0
50,50,50,50,50,50,300,0.30708661417322836,70,75,80,135,80,135,575,0.917910447761194,1.0
40,45,65,100,120,90,460,0.5588235294117647,73,115,60,60,60,90,458,0.6694915254237288,1.0
72,95,67,103,71,122,530,0.9606299212598425,44,50,91,24,86,10,305,0.1981981981981982,0.5
95,145,130,120,90,120,700,0.9398496240601504,35,35,40,35,55,50,250,0.40336134453781514,2.0
40,65,40,80,40,65,330,0.5038167938931297,45,67,60,35,50,63,320,0.5128205128205128,1.0
70,100,70,105,75,40,460,0.23214285714285715,54,45,47,75,98,52,371,0.39669421487603307,1.0
69,55,45,55,55,15,294,0.11666666666666667,70,90,110,60,75,95,500,0.7333333333333333,0.25
45,55,39,35,39,42,255,0.18518518518518517,75,98,63,98,63,101,498,0.8091603053435115,1.0
123,77,72,99,92,58,521,0.4621212121212121,120,100,85,30,85,45,465,0.22448979591836735,0.5
40,20,30,40,80,55,265,0.22764227642276422,43,30,55,40,65,97,330,0.6030534351145038,1.0
40,55,30,30,30,60,245,0.43548387096774194,95,155,109,70,130,81,640,0.6788321167883211,1.0
50,52,48,65,50,55,320,0.33098591549295775,60,70,65,125,105,90,515,0.6911764705882353,0.5
75,89,85,55,65,36,405,0.29545454545454547,50,95,180,85,45,70,525,0.5298507462686567,2.0
35,80,50,50,70,120,405,0.84375,90,90,85,125,90,100,580,0.768595041322314,0.0
51,65,65,80,75,59,395,0.4365079365079365,45,50,45,115,55,95,405,0.6936936936936937,1.0
105,95,75,85,75,74,509,0.5714285714285714,65,80,80,59,63,58,405,0.4411764705882353,0.5
42,52,67,39,56,50,306,0.2868217054263566,105,140,95,55,65,45,505,0.3,0.5
50,52,48,65,50,55,320,0.33098591549295775,75,95,95,95,95,85,540,0.6470588235294118,0.25
70,140,70,110,65,105,560,0.95,40,20,30,40,80,55,265,0.22764227642276422,1.0
108,112,118,68,72,47,525,0.2916666666666667,80,100,200,50,100,50,580,0.3472222222222222,2.0
54,66,70,44,55,46,335,0.4214876033057851,100,103,75,120,75,127,600,0.940677966101695,0.25
40,80,100,30,30,20,300,0.11851851851851852,106,150,70,194,120,140,780,0.952,1.0
50,60,60,60,60,30,320,0.11290322580645161,65,100,70,80,80,105,500,0.8666666666666667,2.0
68,165,95,65,115,110,618,0.8615384615384616,85,105,100,79,83,78,530,0.5869565217391305,1.0
40,35,30,120,70,105,400,0.6692307692307692,80,50,100,100,200,50,580,0.2357142857142857,1.0
58,64,58,80,65,80,405,0.609271523178808,80,80,80,55,55,90,440,0.6417910447761194,1.0
35,35,40,35,55,50,250,0.40336134453781514,76,48,48,57,62,34,325,0.11688311688311688,2.0
40,65,40,80,40,65,330,0.5038167938931297,55,70,45,70,50,60,350,0.45,1.0
90,100,90,125,85,90,580,0.7352941176470589,71,120,95,120,95,99,600,0.8203125,4.0
50,75,75,65,65,50,380,0.4049586776859504,60,100,89,55,69,112,485,0.9298245614035088,1.0
58,109,112,48,48,109,484,0.8805970149253731,75,75,75,125,95,40,485,0.15671641791044777,2.0
65,95,75,55,55,85,430,0.6933333333333334,50,45,45,35,35,50,260,0.23529411764705882,1.0
38,36,38,32,36,57,237,0.3893805309734513,91,90,106,130,106,77,600,0.648854961832061,0.5
53,51,53,61,56,40,314,0.14285714285714285,40,80,35,35,45,70,305,0.4661016949152542,1.0
50,35,55,25,25,15,205,0.05263157894736842,105,140,55,30,55,95,480,0.8195488721804511,0.5
65,125,100,55,70,85,500,0.6532258064516129,95,65,110,60,130,65,525,0.5275590551181102,2.0
106,130,90,110,154,90,680,0.719626168224299,70,70,40,60,40,60,340,0.4247787610619469,4.0
86,92,88,68,75,73,482,0.6835443037974683,75,100,66,60,66,115,482,0.918918918918919,1.0
60,65,70,85,75,40,395,0.21705426356589147,68,125,65,65,115,80,518,0.6277372262773723,1.0
50,53,48,53,48,64,316,0.46153846153846156,100,100,80,60,60,50,450,0.3050847457627119,2.0
45,80,100,35,37,28,325,0.3125,110,130,80,70,60,80,530,0.5862068965517241,2.0
50,75,75,65,65,50,380,0.4049586776859504,100,73,83,73,83,55,467,0.371900826446281,1.0
105,30,105,140,105,55,540,0.3524590163934426,85,73,70,73,115,67,483,0.5126050420168067,0.5
100,100,100,100,100,100,600,0.8758169934640523,95,117,80,65,70,92,519,0.8409090909090909,0.0
110,65,75,125,85,30,490,0.15,100,50,50,76,96,70,442,0.5,1.0
62,48,54,63,60,68,355,0.5178571428571429,65,75,70,95,70,95,470,0.7272727272727273,0.5
91,90,72,90,129,108,580,0.896,90,130,80,65,85,55,505,0.4396551724137931,1.0
60,60,60,85,85,85,435,0.631578947368421,70,40,50,55,50,25,290,0.061068702290076333,1.0
43,80,65,50,35,35,308,0.14193548387096774,90,30,15,40,20,15,210,0.043478260869565216,1.0
105,140,55,30,55,95,480,0.8195488721804511,65,95,57,100,85,93,495,0.7441860465116279,0.5
65,90,122,58,75,84,494,0.71875,72,105,115,54,86,68,500,0.5149253731343284,4.0
55,55,45,63,45,45,308,0.25,65,100,70,80,80,105,500,0.8666666666666667,2.0
105,150,90,150,90,95,680,0.8285714285714286,90,85,100,95,125,85,580,0.6834532374100719,1.0
40,65,40,80,40,65,330,0.5038167938931297,50,75,75,65,65,50,380,0.4049586776859504,1.0
60,50,50,60,70,50,340,0.28346456692913385,38,35,40,27,25,35,200,0.08208955223880597,0.5
60,85,69,60,69,77,420,0.518796992481203,105,140,55,30,55,95,480,0.8195488721804511,1.0
72,58,80,103,80,97,490,0.7171052631578947,65,40,70,80,140,70,465,0.5954198473282443,1.0
78,130,111,130,85,100,634,0.8561151079136691,45,90,20,65,20,65,305,0.5116279069767442,0.5
73,95,62,85,65,85,465,0.6666666666666666,40,45,35,40,40,90,290,0.65,1.0
45,30,50,55,65,45,290,0.208,50,48,43,46,41,60,288,0.47297297297297297,2.0
60,50,100,85,70,65,430,0.47580645161290325,70,110,80,55,80,105,500,0.8794326241134752,2.0
44,58,44,58,44,61,309,0.41964285714285715,108,170,115,120,95,92,700,0.7083333333333334,0.5
39,52,43,60,50,65,309,0.49107142857142855,40,35,30,120,70,105,400,0.6692307692307692,1.0
90,100,60,90,60,80,480,0.6422764227642277,40,60,40,40,40,30,250,0.0948905109489051,0.25
70,83,50,37,50,60,350,0.3360655737704918,79,115,70,125,80,111,580,0.864,0.5
57,80,91,80,87,75,470,0.5737704918032787,65,95,75,55,55,85,430,0.6933333333333334,0.25
100,123,75,57,75,80,510,0.6923076923076923,55,68,64,45,55,31,318,0.11666666666666667,2.0
90,92,87,75,85,76,505,0.5409836065573771,78,84,78,109,85,100,534,0.8620689655172413,2.0
80,82,83,100,100,80,525,0.6742424242424242,65,90,40,45,80,75,395,0.625,0.125
40,45,40,65,40,65,295,0.5661764705882353,50,92,108,92,108,35,485,0.2457627118644068,1.0
110,130,80,70,60,80,530,0.5862068965517241,60,45,70,45,90,95,405,0.7304964539007093,2.0
80,100,70,60,70,95,475,0.7416666666666667,95,70,73,95,90,60,483,0.3983739837398374,1.0
45,20,50,60,120,50,345,0.24074074074074073,85,76,64,45,55,90,415,0.6739130434782609,1.0
65,110,130,60,65,95,525,0.8278145695364238,78,104,78,159,115,100,634,0.8444444444444444,0.25
40,45,40,35,35,56,251,0.373015873015873,50,120,53,35,110,87,455,0.640625,2.0
90,92,87,75,85,76,505,0.5409836065573771,105,140,55,30,55,95,480,0.8195488721804511,2.0
100,50,80,60,80,50,420,0.34375,115,140,130,55,55,40,535,0.4519230769230769,4.0
60,95,80,60,80,30,405,0.19480519480519481,65,125,100,60,70,70,490,0.6099290780141844,0.5
50,35,55,25,25,15,205,0.05263157894736842,65,136,94,54,96,135,580,0.9612403100775194,0.5
90,132,105,132,105,30,594,0.4246575342465753,80,110,120,130,90,70,600,0.6198347107438017,0.25
50,55,50,36,30,43,264,0.2922077922077922,120,100,85,30,85,45,465,0.22448979591836735,2.0
52,65,55,58,62,60,352,0.4482758620689655,37,25,41,25,41,25,194,0.08870967741935484,2.0
65,50,70,95,80,65,425,0.4262295081967213,80,100,80,80,80,100,520,0.9051724137931034,2.0
64,88,50,88,50,106,446,0.9111111111111111,58,70,45,40,45,42,300,0.25925925925925924,1.0
70,110,180,60,60,50,530,0.4117647058823529,65,83,57,95,85,105,490,0.8914728682170543,0.5
60,50,70,80,80,140,480,0.8449612403100775,60,80,50,40,40,30,300,0.15328467153284672,1.0
60,90,55,90,80,110,485,0.8677685950413223,45,55,39,35,39,42,255,0.18518518518518517,1.0
51,65,65,80,75,59,395,0.4365079365079365,30,30,30,30,30,30,180,0.12612612612612611,2.0
45,90,20,65,20,65,305,0.5116279069767442,60,85,49,60,49,60,363,0.4444444444444444,1.0
68,85,65,165,135,100,618,0.8083333333333333,50,105,125,55,95,50,480,0.375886524822695,0.25
50,70,50,50,50,70,340,0.5645161290322581,75,100,110,45,55,65,450,0.5333333333333333,1.0
50,150,50,150,50,150,600,0.9339622641509434,50,65,107,105,107,86,520,0.7272727272727273,1.0
70,55,95,95,110,65,490,0.48872180451127817,65,110,130,60,65,95,525,0.8278145695364238,1.0
72,105,115,54,86,68,500,0.5149253731343284,45,30,35,20,20,45,195,0.14782608695652175,2.0
90,132,105,132,105,30,594,0.4246575342465753,50,20,55,25,25,30,205,0.09774436090225563,0.5
103,60,126,80,126,50,545,0.36363636363636365,45,35,50,70,50,30,280,0.15753424657534246,1.0
50,50,120,80,80,30,410,0.07258064516129033,74,48,76,83,81,104,466,0.7322834645669292,1.0
54,66,70,44,55,46,335,0.4214876033057851,50,65,64,44,48,43,314,0.2196969696969697,2.0
50,150,50,150,50,150,600,0.9339622641509434,105,150,90,150,90,95,680,0.8285714285714286,1.0
105,125,100,60,100,100,590,0.8359375,35,55,40,45,40,60,275,0.35714285714285715,1.0
75,90,140,60,60,40,465,0.3008130081300813,35,64,85,74,55,32,345,0.19827586206896552,0.5
70,85,70,60,70,50,405,0.28378378378378377,75,100,63,80,63,116,497,0.9345794392523364,2.0
103,60,126,80,126,50,545,0.36363636363636365,45,55,45,65,45,75,330,0.5692307692307692,1.0
100,77,77,128,128,90,600,0.6901408450704225,60,100,89,55,69,112,485,0.9298245614035088,2.0
60,55,90,145,90,80,520,0.6071428571428571,60,85,60,85,60,55,405,0.3673469387755102,0.5
64,88,50,88,50,106,446,0.9111111111111111,60,130,80,60,60,70,460,0.5153846153846153,0.5
65,150,60,115,60,115,565,0.935251798561151,71,73,88,120,89,59,500,0.43537414965986393,1.0
65,70,60,65,65,115,440,0.8583333333333333,90,70,80,70,95,70,475,0.5190839694656488,1.0
75,95,95,95,95,85,540,0.6470588235294118,50,53,48,53,48,64,316,0.358974358974359,0.5
65,125,60,95,60,105,510,0.9236641221374046,65,80,65,35,65,60,370,0.38405797101449274,2.0
80,100,70,60,70,95,475,0.7416666666666667,78,70,61,50,61,100,420,0.8145161290322581,1.0
75,38,38,56,56,67,330,0.5263157894736842,55,70,45,70,50,60,350,0.45,2.0
91,90,129,90,72,108,580,0.9140625,70,55,65,95,85,70,440,0.5307692307692308,2.0
68,72,78,38,42,32,330,0.23809523809523808,58,109,112,48,48,109,484,0.8805970149253731,1.0
70,120,100,145,105,20,560,0.2824427480916031,60,95,80,60,80,30,405,0.19480519480519481,1.0
45,67,60,35,50,63,320,0.5128205128205128,44,58,44,58,44,61,309,0.41964285714285715,2.0
60,85,60,85,60,55,405,0.3673469387755102,90,110,80,100,80,95,555,0.7982456140350878,0.5
100,150,90,180,160,90,770,0.7348484848484849,30,42,118,42,88,30,350,0.112,2.0
54,78,103,53,45,22,355,0.23255813953488372,80,135,85,70,95,150,615,0.9844961240310077,4.0
30,40,70,70,25,60,295,0.41353383458646614,50,64,50,45,50,41,300,0.22727272727272727,4.0
70,80,65,90,65,85,455,0.578125,46,57,40,40,40,50,273,0.25,2.0
80,80,80,80,80,80,480,0.6015037593984962,61,84,65,70,70,70,420,0.5,2.0
70,90,45,15,45,50,315,0.3629032258064516,100,100,100,100,100,100,600,0.831858407079646,1.0
50,70,50,50,50,70,340,0.5645161290322581,50,65,107,105,107,86,520,0.703125,2.0
70,65,60,90,75,90,450,0.6571428571428571,108,100,121,81,95,95,600,0.7476635514018691,0.5
75,75,75,125,95,40,485,0.15671641791044777,43,30,55,40,65,97,330,0.6030534351145038,1.0
70,43,53,43,53,40,302,0.19090909090909092,126,131,95,131,98,99,680,0.8102189781021898,1.0
40,30,30,55,30,85,270,0.4666666666666667,85,70,80,97,80,123,535,0.9304347826086956,0.5
61,84,65,70,70,70,420,0.5,50,85,40,85,40,35,335,0.1746031746031746,1.0
70,150,140,65,100,75,600,0.55,100,150,120,120,100,90,680,0.6493506493506493,0.5
50,47,50,57,50,65,319,0.463768115942029,100,180,160,150,90,90,770,0.7520661157024794,0.0
95,135,80,110,80,100,600,0.8248175182481752,55,70,55,40,55,85,360,0.7073170731707317,1.0
60,52,168,47,138,30,495,0.19834710743801653,60,110,70,60,60,100,460,0.8461538461538461,2.0
65,60,70,85,75,40,395,0.1796875,35,60,44,40,54,55,288,0.366412213740458,1.0
50,75,75,65,65,50,380,0.4049586776859504,40,40,55,40,70,55,300,0.40939597315436244,4.0
50,65,107,105,107,86,520,0.7758620689655172,64,88,50,88,50,106,446,0.9111111111111111,1.0
85,120,70,50,60,100,485,0.8308823529411765,78,70,61,50,61,100,420,0.8145161290322581,1.0
55,20,35,20,45,75,250,0.37681159420289856,60,80,50,40,40,30,300,0.15328467153284672,1.0
100,100,100,100,100,100,600,0.8805970149253731,77,120,90,60,90,48,485,0.2785714285714286,0.5
70,130,100,55,80,65,500,0.608,116,55,85,107,95,29,487,0.06818181818181818,2.0
105,130,120,45,45,40,485,0.4444444444444444,50,75,70,35,70,48,348,0.29357798165137616,0.5
123,77,72,99,92,58,521,0.4621212121212121,70,94,50,94,50,66,424,0.48148148148148145,8.0
50,30,55,65,55,20,275,0.13675213675213677,70,62,67,55,55,56,365,0.38513513513513514,1.0
65,130,60,95,110,65,525,0.5303030303030303,65,83,57,95,85,105,490,0.8914728682170543,1.0
91,134,95,100,100,80,600,0.6304347826086957,50,35,55,25,25,15,205,0.021739130434782608,2.0
104,91,63,91,73,68,490,0.5118110236220472,55,95,115,45,45,35,390,0.2116788321167883,0.5
45,63,37,65,55,95,360,0.8055555555555556,64,51,23,51,23,28,240,0.11363636363636363,1.0
61,78,95,56,58,57,405,0.40336134453781514,109,66,84,81,99,32,471,0.2013888888888889,2.0
70,60,70,87,78,85,450,0.6228070175438597,110,65,105,55,95,80,510,0.6258503401360545,0.5
65,83,57,95,85,105,490,0.8914728682170543,60,60,40,65,45,35,305,0.15833333333333333,0.0
58,64,58,80,65,80,405,0.5423728813559322,111,83,68,92,82,39,475,0.1774193548387097,0.5
50,180,20,180,20,150,600,0.9029850746268657,38,36,38,32,36,57,237,0.3893805309734513,1.0
55,20,35,20,45,75,250,0.37681159420289856,40,45,40,62,60,60,307,0.33884297520661155,1.0
80,82,78,95,80,85,500,0.6869565217391305,70,60,75,110,75,90,480,0.7165354330708661,0.5
60,80,110,50,80,45,425,0.2833333333333333,58,109,112,48,48,109,484,0.8805970149253731,1.0
80,145,150,105,110,110,700,0.8692307692307693,75,123,67,95,85,95,540,0.7642276422764228,0.5
45,22,60,27,30,29,213,0.07518796992481203,106,90,130,90,154,110,680,0.8699186991869918,1.0
55,20,35,20,45,75,250,0.37681159420289856,125,170,100,120,90,95,700,0.77,1.0
67,125,40,30,30,58,350,0.3431372549019608,70,60,70,87,78,85,450,0.6228070175438597,1.0
30,40,55,40,55,60,280,0.3237410071942446,83,80,80,135,80,121,579,0.9444444444444444,1.0
95,65,65,110,130,60,525,0.4016393442622951,75,98,63,98,63,101,498,0.889763779527559,0.5
105,125,100,60,100,100,590,0.8359375,83,80,80,135,80,121,579,0.9444444444444444,1.0
40,30,30,40,50,30,220,0.07936507936507936,49,66,70,44,55,51,335,0.4260869565217391,0.25
60,110,70,60,60,100,460,0.8461538461538461,50,35,55,25,25,15,205,0.05263157894736842,2.0
60,50,70,50,90,65,385,0.39568345323741005,55,35,50,55,110,85,390,0.6277372262773723,0.5
100,120,100,150,120,90,680,0.728,60,59,85,79,105,36,424,0.16666666666666666,4.0
30,56,35,25,35,72,253,0.48148148148148145,55,35,50,55,110,85,390,0.6277372262773723,1.0
50,50,50,50,50,50,300,0.30708661417322836,40,35,30,120,70,105,400,0.6692307692307692,1.0
65,40,70,80,140,70,465,0.5954198473282443,91,90,129,90,72,108,580,0.9140625,1.0
65,95,100,60,50,50,420,0.34959349593495936,70,65,60,90,75,90,450,0.6571428571428571,1.0
81,102,77,85,75,85,505,0.5642857142857143,85,105,55,85,50,115,495,0.9032258064516129,1.0
55,55,55,85,55,30,335,0.1320754716981132,50,50,40,30,30,50,250,0.2781954887218045,2.0
75,125,70,125,70,115,580,0.9037037037037037,70,110,70,115,70,90,525,0.75,0.5
60,45,70,75,85,55,390,0.3008130081300813,95,117,80,65,70,92,519,0.8409090909090909,0.0
78,84,78,109,85,100,534,0.8620689655172413,35,46,34,35,45,20,215,0.072,1.0
65,45,55,45,70,45,325,0.24369747899159663,105,180,100,180,100,115,780,0.9477611940298507,0.5
90,120,120,60,60,50,500,0.35294117647058826,70,75,60,105,60,105,475,0.88,2.0
50,72,35,35,35,65,292,0.5373134328358209,62,73,55,56,52,84,382,0.7244094488188977,0.0
50,50,150,50,150,50,500,0.2571428571428571,100,100,100,100,100,100,600,0.8805970149253731,1.0
60,90,140,50,50,40,430,0.2535211267605634,60,95,80,60,80,30,405,0.19480519480519481,2.0
50,65,107,105,107,86,520,0.7272727272727273,77,59,50,67,63,46,362,0.23140495867768596,0.5
60,85,60,85,60,55,405,0.3673469387755102,50,70,160,70,160,90,600,0.7417218543046358,0.5
70,130,100,55,80,65,500,0.608,55,95,55,35,75,115,430,0.9380530973451328,4.0
95,135,80,110,80,100,600,0.8248175182481752,50,50,77,95,77,91,440,0.5916666666666667,0.5
90,92,75,92,85,60,494,0.49586776859504134,50,50,62,40,62,65,329,0.4188034188034188,0.5
70,92,65,80,55,98,460,0.8090909090909091,108,130,95,80,85,102,600,0.7637795275590551,1.0
75,80,55,25,35,35,305,0.18666666666666668,250,5,5,35,105,50,450,0.15306122448979592,2.0
75,87,63,87,63,98,473,0.865546218487395,1,90,45,30,30,40,236,0.33064516129032256,2.0
126,131,95,131,98,99,680,0.8294573643410853,60,40,80,60,45,40,325,0.23529411764705882,1.0
165,75,80,40,45,65,470,0.5151515151515151,40,55,80,35,60,30,300,0.15037593984962405,1.0
70,62,67,55,55,56,365,0.38513513513513514,80,50,100,100,200,50,580,0.2357142857142857,1.0
85,120,70,50,60,100,485,0.8308823529411765,85,76,64,45,55,90,415,0.6739130434782609,1.0
40,40,50,30,30,30,220,0.0873015873015873,40,45,35,40,40,90,290,0.65,1.0
80,70,40,100,60,145,495,0.921875,45,30,40,105,50,20,290,0.031007751937984496,2.0
61,72,57,55,55,65,365,0.3984375,38,41,40,50,65,65,299,0.4108527131782946,1.0
60,100,115,70,85,90,520,0.7557251908396947,62,77,62,50,42,65,358,0.4838709677419355,1.0
85,100,122,58,75,54,494,0.3939393939393939,60,55,90,145,90,80,520,0.6071428571428571,1.0
86,92,88,68,75,73,482,0.6835443037974683,60,85,60,85,60,55,405,0.3673469387755102,0.5
75,80,95,90,100,50,490,0.2158273381294964,100,100,100,100,100,100,600,0.8778625954198473,0.5
83,80,80,135,80,121,579,0.9444444444444444,55,104,105,94,75,52,485,0.36363636363636365,1.0
60,80,50,50,50,40,330,0.23853211009174313,78,104,78,159,115,100,634,0.8444444444444444,1.0
100,150,140,100,90,90,670,0.7969924812030075,101,72,72,99,89,29,462,0.1937984496124031,1.0
45,30,15,85,65,65,305,0.36220472440944884,30,65,100,45,25,40,305,0.1891891891891892,0.5
85,120,70,50,60,100,485,0.8308823529411765,45,75,37,70,55,83,365,0.6183206106870229,1.0
36,50,50,65,60,44,305,0.16363636363636364,49,55,42,42,37,85,310,0.6068376068376068,1.0
120,120,120,120,120,120,720,0.9344262295081968,81,102,77,85,75,85,505,0.5642857142857143,1.0
55,40,85,80,105,40,405,0.23622047244094488,80,120,70,110,70,80,530,0.6422764227642277,2.0
55,40,85,80,105,40,405,0.23622047244094488,80,105,105,105,105,80,580,0.5939849624060151,1.0
75,125,230,55,95,30,610,0.3448275862068966,80,120,130,55,65,45,495,0.37037037037037035,4.0
45,22,60,27,30,29,213,0.07518796992481203,35,20,65,40,65,20,245,0.02459016393442623,0.5
41,64,45,50,50,50,300,0.36752136752136755,75,55,70,55,95,110,460,0.8444444444444444,1.0
60,30,30,36,56,50,262,0.32432432432432434,50,85,40,85,40,35,335,0.1746031746031746,2.0
100,5,5,15,65,30,220,0.07692307692307693,66,41,77,61,87,23,355,0.12096774193548387,0.5
52,65,55,58,62,60,352,0.4482758620689655,40,40,35,50,100,70,335,0.5031847133757962,1.0
73,95,62,85,65,85,465,0.6666666666666666,60,115,105,65,70,80,495,0.7181818181818181,0.5
59,45,40,35,40,31,250,0.14285714285714285,55,45,45,25,25,15,210,0.048,1.0
79,115,70,125,80,111,580,0.8468468468468469,95,85,85,65,65,35,430,0.2571428571428571,1.0
70,90,45,15,45,50,315,0.3629032258064516,70,62,67,55,55,56,365,0.38513513513513514,1.0
80,145,150,105,110,110,700,0.8692307692307693,78,130,111,130,85,100,634,0.8561151079136691,0.5
43,80,65,50,35,35,308,0.14193548387096774,90,60,70,75,70,45,410,0.23880597014925373,0.5
60,69,95,69,95,36,424,0.2608695652173913,65,40,50,125,60,30,370,0.07258064516129033,2.0
75,75,60,83,60,60,413,0.39344262295081966,60,75,85,100,85,115,520,0.8992248062015504,0.5
50,48,43,46,41,60,288,0.47297297297297297,65,83,57,95,85,105,490,0.8914728682170543,2.0
75,75,60,83,60,60,413,0.39344262295081966,106,110,90,154,90,130,680,0.926829268292683,1.0
70,80,70,80,70,110,480,0.6594202898550725,85,80,90,105,95,60,515,0.49074074074074076,0.0
75,95,60,65,60,115,470,0.8778625954198473,49,66,70,44,55,51,335,0.4260869565217391,0.0
61,90,45,50,50,160,456,0.9230769230769231,55,55,85,65,85,35,380,0.2014388489208633,0.5
75,85,200,55,65,30,510,0.16778523489932887,35,85,45,35,35,75,310,0.6492537313432836,0.0
90,132,105,132,105,30,594,0.4246575342465753,50,180,20,180,20,150,600,0.9029850746268657,1.0
50,75,45,40,45,60,315,0.4380165289256198,90,50,34,60,44,70,348,0.6283185840707964,0.25
75,75,55,105,85,30,425,0.1619718309859155,50,75,35,70,30,40,300,0.21296296296296297,0.25
80,80,90,110,130,110,600,0.8721804511278195,50,20,55,25,25,30,205,0.09774436090225563,1.0
100,50,50,76,96,70,442,0.5,10,55,25,35,45,95,265,0.5396825396825397,1.0
80,95,82,60,82,75,474,0.6,35,55,35,30,30,35,220,0.23684210526315788,1.0
62,73,55,56,52,84,382,0.7244094488188977,108,130,95,80,85,102,600,0.7637795275590551,0.5
51,65,65,80,75,59,395,0.4365079365079365,115,140,130,55,55,40,535,0.4519230769230769,2.0
60,55,90,145,90,80,520,0.6071428571428571,60,90,55,90,80,110,485,0.8677685950413223,1.0
45,53,70,40,60,42,310,0.25735294117647056,80,52,50,90,50,89,411,0.6666666666666666,0.125
100,128,90,77,77,128,600,0.959349593495935,60,60,40,65,45,35,305,0.15833333333333333,1.0
60,85,60,85,60,55,405,0.3673469387755102,61,84,65,70,70,70,420,0.5,0.5
70,95,125,65,75,45,475,0.33613445378151263,61,84,65,70,70,70,420,0.5,1.0
84,71,43,71,43,48,360,0.25874125874125875,71,120,95,120,95,99,600,0.8203125,0.5
75,75,60,83,60,60,413,0.39344262295081966,80,105,105,105,105,80,580,0.5939849624060151,1.0
100,100,80,60,60,50,450,0.3050847457627119,150,80,44,90,54,80,498,0.625,0.0
80,80,80,80,80,80,480,0.6015037593984962,40,55,30,30,30,60,245,0.43548387096774194,2.0
40,70,130,60,130,25,455,0.17355371900826447,50,160,110,160,110,110,700,0.8854961832061069,1.0
70,100,70,105,75,40,460,0.23214285714285715,80,70,70,90,100,70,480,0.5609756097560976,0.5
65,136,94,54,96,135,580,0.9612403100775194,49,49,56,49,61,66,330,0.5190839694656488,1.0
55,40,50,65,85,40,335,0.3181818181818182,50,40,85,40,65,25,305,0.08870967741935484,1.0
40,45,65,100,120,90,460,0.5588235294117647,40,60,40,40,40,30,250,0.0948905109489051,1.0
42,52,67,39,56,50,306,0.2868217054263566,58,64,58,80,65,80,405,0.609271523178808,4.0
110,85,95,80,95,50,515,0.2713178294573643,105,95,75,85,75,74,509,0.5714285714285714,1.0
110,65,105,55,95,80,510,0.6258503401360545,40,27,60,37,50,66,280,0.36220472440944884,1.0
55,112,45,74,45,70,401,0.559322033898305,70,105,105,50,40,20,390,0.33587786259541985,0.5
61,72,57,55,55,65,365,0.3984375,35,85,45,35,35,75,310,0.6492537313432836,1.0
40,40,35,50,100,70,335,0.5031847133757962,80,100,70,50,60,45,405,0.25806451612903225,1.0
65,65,65,50,50,90,385,0.72,82,80,86,85,75,72,480,0.6183206106870229,1.0
75,87,63,87,63,98,473,0.865546218487395,70,43,53,43,53,40,302,0.19090909090909092,1.0
80,110,60,150,130,70,600,0.5042016806722689,68,85,65,165,135,100,618,0.8083333333333333,1.0
80,70,70,90,100,70,480,0.5609756097560976,80,80,80,80,80,80,480,0.6015037593984962,1.0
70,110,75,145,85,145,630,0.9444444444444444,82,121,119,69,59,71,521,0.5394736842105263,2.0
50,20,55,25,25,30,205,0.09774436090225563,50,50,40,50,40,64,294,0.45588235294117646,1.0
50,70,160,70,160,90,600,0.7417218543046358,60,85,60,85,60,55,405,0.3673469387755102,1.0
65,47,55,73,75,85,400,0.65,75,75,60,83,60,60,413,0.39344262295081966,1.0
45,49,49,65,65,45,318,0.2781954887218045,35,55,35,30,30,35,220,0.23684210526315788,1.0
77,120,90,60,90,48,485,0.2785714285714286,75,103,80,70,80,92,500,0.7933884297520661,1.0
75,80,55,25,35,35,305,0.18666666666666668,60,50,50,60,70,50,340,0.28346456692913385,1.0
60,60,60,60,60,60,360,0.38095238095238093,60,60,40,65,45,35,305,0.15833333333333333,1.0
100,120,100,150,120,90,680,0.728,60,45,70,75,85,55,390,0.3008130081300813,1.0
125,170,100,120,90,95,700,0.77,71,120,95,120,95,99,600,0.8203125,0.25
95,75,80,100,110,30,490,0.24242424242424243,90,100,70,110,150,80,600,0.6037735849056604,0.5
70,130,100,55,80,65,500,0.608,65,100,70,80,80,105,500,0.8666666666666667,0.25
65,83,57,95,85,105,490,0.8914728682170543,89,124,80,55,80,55,483,0.5714285714285714,0.0
91,90,129,90,72,108,580,0.9140625,95,75,80,100,110,30,490,0.24242424242424243,0.25
75,95,95,95,95,85,540,0.6470588235294118,76,65,45,92,42,91,411,0.7449664429530202,1.0
75,100,63,80,63,116,497,0.9345794392523364,250,5,5,35,105,50,450,0.15306122448979592,1.0
50,55,50,36,30,43,264,0.2922077922077922,90,85,100,95,125,85,580,0.6834532374100719,1.0
85,60,65,135,105,100,550,0.7518248175182481,55,130,115,50,50,75,475,0.5982142857142857,0.5
45,67,60,35,50,63,320,0.5128205128205128,70,80,102,80,102,40,474,0.2677165354330709,1.0
65,90,40,45,80,75,395,0.625,54,63,52,83,56,97,405,0.7697841726618705,1.0
75,95,95,95,95,85,540,0.6470588235294118,66,117,70,40,50,67,410,0.4573643410852713,1.0
75,80,95,90,100,50,490,0.2158273381294964,50,85,85,55,55,50,380,0.3902439024390244,0.5
48,61,40,61,40,50,300,0.2543859649122807,95,117,80,65,70,92,519,0.8409090909090909,1.0
130,85,80,85,95,60,535,0.43884892086330934,70,77,60,97,60,108,472,0.8394160583941606,1.0
45,95,50,40,50,75,355,0.54,60,90,140,50,50,40,430,0.2535211267605634,0.25
65,50,35,115,95,95,455,0.7333333333333333,30,45,59,30,39,57,260,0.2803030303030303,2.0
115,140,130,55,55,40,535,0.4519230769230769,60,80,110,50,80,45,425,0.2833333333333333,0.5
40,20,30,40,80,55,265,0.22764227642276422,60,100,115,70,85,90,520,0.7557251908396947,0.25
73,76,75,81,100,100,505,0.8110236220472441,70,90,110,60,75,95,500,0.7333333333333333,1.0
60,85,69,65,79,80,438,0.576,83,106,65,86,65,85,490,0.6640625,0.5
75,89,85,55,65,36,405,0.29545454545454547,40,45,40,35,35,56,251,0.373015873015873,0.5
50,50,62,40,62,65,329,0.4188034188034188,70,94,50,94,50,66,424,0.48148148148148145,1.0
50,52,48,65,50,55,320,0.33098591549295775,28,25,25,45,35,40,198,0.16083916083916083,1.0
114,85,70,85,80,30,464,0.2066115702479339,50,50,62,40,62,65,329,0.4188034188034188,0.25
65,105,60,60,70,95,455,63.0,70,70,70,70,70,70,420,0.5289256198347108,2.0
60,60,60,35,35,30,280,0.11194029850746269,80,45,65,90,110,80,470,0.5462962962962963,1.0
110,123,65,100,65,65,528,0.5217391304347826,55,65,95,95,45,85,440,0.6610169491525424,0.5
68,165,95,65,115,110,618,0.8615384615384616,126,131,95,131,98,99,680,0.8102189781021898,0.0
90,100,60,90,60,80,480,0.6422764227642277,20,25,45,70,90,60,310,0.30833333333333335,1.0
50,50,150,50,150,50,500,0.2571428571428571,100,90,130,45,65,55,485,0.4253731343283582,1.0
81,102,77,85,75,85,505,0.5642857142857143,95,117,80,65,70,92,519,0.8409090909090909,0.5
55,65,35,60,30,85,330,0.6126126126126126,65,83,57,95,85,105,490,0.8914728682170543,1.0
58,50,145,95,105,30,483,0.2459016393442623,100,100,80,60,60,50,450,0.3050847457627119,1.0
35,80,50,50,70,120,405,0.84375,70,55,65,95,85,70,440,0.5307692307692308,2.0
75,100,63,80,63,116,497,0.9345794392523364,75,65,55,65,55,69,384,0.43548387096774194,0.0
80,92,65,65,80,68,450,0.4824561403508772,80,110,120,130,90,70,600,0.6198347107438017,1.0
51,65,65,80,75,59,395,0.4365079365079365,150,80,44,90,54,80,498,0.625,2.0
65,90,122,58,75,84,494,0.71875,50,100,150,100,150,50,600,0.37142857142857144,2.0
40,35,30,20,20,50,195,0.23423423423423423,50,105,125,55,95,50,480,0.375886524822695,0.0
120,70,120,75,130,85,600,0.6694915254237288,95,155,109,70,130,81,640,0.6788321167883211,0.0
95,85,85,65,65,35,430,0.2571428571428571,86,68,72,109,66,106,507,0.8099173553719008,4.0
20,40,90,30,90,25,295,0.11363636363636363,40,29,45,29,45,36,224,0.14634146341463414,1.0
60,70,65,125,105,90,515,0.6911764705882353,80,70,70,90,100,70,480,0.5609756097560976,2.0
62,55,52,109,94,109,481,0.7833333333333333,55,84,105,114,75,52,485,0.2890625,2.0
80,145,150,105,110,110,700,0.8692307692307693,76,147,90,60,70,97,540,0.8267716535433071,1.0
130,65,60,110,95,65,525,0.5227272727272727,58,89,77,45,45,48,362,0.3177570093457944,1.0
60,100,115,70,85,90,520,0.7557251908396947,110,123,65,100,65,65,528,0.5217391304347826,0.5
60,85,40,30,45,68,328,0.6422018348623854,105,125,100,60,100,100,590,0.8359375,1.0
40,20,30,40,80,55,265,0.22764227642276422,81,102,77,85,75,85,505,0.5642857142857143,0.5
57,80,91,80,87,75,470,0.5737704918032787,70,140,70,110,65,105,560,0.95,1.0
55,63,90,50,80,42,380,0.21138211382113822,60,62,80,63,80,60,405,0.4336283185840708,1.0
106,110,90,154,90,130,680,0.926829268292683,71,73,88,120,89,59,500,0.43537414965986393,1.0
126,131,95,131,98,99,680,0.8102189781021898,60,40,60,40,60,35,295,0.18055555555555555,2.0
75,89,85,55,65,36,405,0.29545454545454547,74,94,131,54,116,20,489,0.4485294117647059,0.25
55,35,50,55,110,85,390,0.6277372262773723,120,100,85,30,85,45,465,0.22448979591836735,1.0
100,100,100,100,100,100,600,0.8345864661654135,70,90,110,60,75,95,500,0.7333333333333333,0.0
45,30,50,55,65,45,290,0.208,160,110,65,65,110,30,540,0.35714285714285715,1.0
71,73,88,120,89,59,500,0.43537414965986393,50,20,40,20,40,20,190,0.0962962962962963,1.0
70,145,88,140,70,112,625,0.8888888888888888,40,35,30,120,70,105,400,0.6692307692307692,0.5
70,92,65,80,55,98,460,0.8090909090909091,80,45,65,90,110,80,470,0.5462962962962963,1.0
30,105,90,25,25,50,325,0.2773722627737226,80,115,80,65,55,93,488,0.7846153846153846,1.0
80,185,115,40,105,75,600,0.6230769230769231,50,45,45,35,35,50,260,0.23529411764705882,2.0
90,132,105,132,105,30,594,0.4246575342465753,75,89,85,55,65,36,405,0.29545454545454547,1.0
40,55,30,30,30,85,270,0.688,90,85,75,115,100,115,580,0.9381443298969072,0.5
88,107,122,74,75,64,530,0.4596774193548387,130,70,35,70,35,60,400,0.4017857142857143,2.0
91,129,90,72,90,108,580,0.8536585365853658,70,120,65,45,85,125,510,0.9747899159663865,8.0
70,80,70,80,70,110,480,0.6594202898550725,70,145,88,140,70,112,625,0.8888888888888888,0.5
68,65,65,125,115,80,518,0.6461538461538462,45,55,45,65,45,75,330,0.5692307692307692,1.0
45,35,45,62,53,35,275,0.11851851851851852,40,55,30,30,30,60,245,0.43548387096774194,0.5
36,50,50,65,60,44,305,0.16363636363636364,108,100,121,81,95,95,600,0.7476635514018691,4.0
75,80,85,110,90,50,490,0.3548387096774194,60,55,50,40,55,45,305,0.22377622377622378,0.125
35,45,160,30,45,70,385,0.48148148148148145,50,64,50,45,50,41,300,0.22727272727272727,1.0
45,35,50,70,50,30,280,0.15753424657534246,46,57,40,40,40,50,273,0.25,0.5
108,130,95,80,85,102,600,0.7637795275590551,65,63,45,45,45,45,308,0.2595419847328244,2.0
55,84,105,114,75,52,485,0.2890625,55,65,95,95,45,85,440,0.6610169491525424,0.5
90,132,105,132,105,30,594,0.4246575342465753,110,80,90,95,90,65,530,0.5033557046979866,0.5
79,103,120,135,115,78,630,0.5763888888888888,80,80,80,80,80,80,480,0.5606060606060606,0.5
86,81,97,81,107,43,495,0.203125,55,112,45,74,45,70,401,0.559322033898305,2.0
100,90,130,45,65,55,485,0.4253731343283582,49,49,56,49,61,66,330,0.5190839694656488,0.5
75,98,63,98,63,101,498,0.8091603053435115,75,95,95,95,95,85,540,0.6470588235294118,1.0
80,135,85,70,95,150,615,0.9844961240310077,70,20,50,20,50,40,250,0.1557377049180328,1.0
73,76,75,81,100,100,505,0.8110236220472441,45,85,50,55,50,65,350,0.5076923076923077,1.0
50,64,50,45,50,41,300,0.22727272727272727,50,70,50,50,50,70,340,0.5645161290322581,0.5
40,65,95,60,45,35,340,0.13986013986013987,65,50,35,115,95,95,455,0.7333333333333333,1.0
70,120,40,95,40,95,460,0.8106060606060606,44,50,91,24,86,10,305,0.1981981981981982,0.5
80,70,70,90,100,70,480,0.5609756097560976,50,65,107,105,107,86,520,0.7272727272727273,0.5
95,60,79,100,125,81,540,0.6201550387596899,50,64,50,45,50,41,300,0.22727272727272727,4.0
55,65,95,95,45,85,440,0.6610169491525424,90,55,75,60,75,30,385,0.13970588235294118,1.0
95,70,73,95,90,60,483,0.3983739837398374,50,50,95,40,50,35,320,0.20279720279720279,1.0
45,60,30,80,50,65,330,0.4603174603174603,90,75,75,90,100,70,500,0.5462184873949579,0.5
50,160,110,160,110,110,700,0.8854961832061069,70,100,70,105,75,40,460,0.23214285714285715,0.5
108,100,121,81,95,95,600,0.7476635514018691,45,49,65,49,65,45,318,0.275,0.5
70,60,70,87,78,85,450,0.6228070175438597,65,130,60,75,60,75,465,0.689922480620155,1.0
55,104,105,94,75,52,485,0.36363636363636365,90,55,75,60,75,30,385,0.13970588235294118,1.0
110,65,105,55,95,80,510,0.6258503401360545,55,40,40,65,45,35,280,0.16428571428571428,0.5
65,80,140,40,70,70,465,0.5223880597014925,85,70,80,97,80,123,535,0.9304347826086956,1.0
75,100,66,60,66,115,482,0.918918918918919,83,106,65,86,65,85,490,0.6640625,1.0
65,47,55,73,75,85,400,0.65,110,65,105,55,95,80,510,0.6258503401360545,1.0
80,100,123,122,120,80,625,0.56,80,105,65,60,75,130,515,0.9645390070921985,0.5
60,60,75,60,75,80,410,0.7321428571428571,45,65,34,40,34,45,263,0.2589928057553957,1.0
100,90,130,45,65,55,485,0.4253731343283582,80,120,70,110,70,80,530,0.6422764227642277,2.0
250,5,5,35,105,50,450,0.15306122448979592,54,63,52,83,56,97,405,0.7697841726618705,1.0
38,30,41,30,41,60,240,0.2897196261682243,95,60,79,100,125,81,540,0.6201550387596899,1.0
90,100,60,90,60,80,480,0.6422764227642277,70,80,50,35,35,35,305,0.14,0.5
70,80,65,90,65,85,455,0.578125,50,35,55,25,25,15,205,0.021739130434782608,1.0
100,103,75,120,75,127,600,0.940677966101695,80,145,150,105,110,110,700,0.8692307692307693,0.25
100,180,160,150,90,90,770,0.7520661157024794,45,85,50,55,50,65,350,0.5076923076923077,1.0
65,90,65,61,61,100,442,0.8373983739837398,65,60,70,85,75,40,395,0.1796875,1.0
90,120,100,150,120,100,680,0.7718120805369127,55,65,95,95,45,85,440,0.6610169491525424,0.5
65,80,140,40,70,70,465,0.5223880597014925,105,150,90,150,90,95,680,0.8285714285714286,1.0
75,100,110,45,55,65,450,0.5333333333333333,83,106,65,86,65,85,490,0.6640625,2.0
70,55,75,45,65,60,370,0.45901639344262296,50,160,110,160,110,110,700,0.8854961832061069,0.25
90,85,100,95,125,85,580,0.6834532374100719,50,100,150,100,150,50,600,0.37142857142857144,0.5
100,110,90,85,90,60,535,0.47794117647058826,70,75,80,135,80,135,575,0.917910447761194,2.0
110,160,110,80,110,100,670,0.8591549295774648,78,81,71,74,69,126,499,0.9090909090909091,1.0
65,75,105,35,65,85,430,0.6940298507462687,70,60,125,115,70,55,495,0.35507246376811596,1.0
64,115,65,83,63,65,455,0.5323741007194245,77,59,50,67,63,46,362,0.23140495867768596,1.0
100,150,90,180,160,90,770,0.7348484848484849,115,140,130,55,55,40,535,0.4519230769230769,4.0
75,125,100,70,80,45,495,0.33035714285714285,60,85,49,60,49,60,363,0.4444444444444444,1.0
55,81,60,50,70,97,413,0.7214285714285714,65,90,40,45,80,75,395,0.625,1.0
75,95,60,65,60,115,470,0.8778625954198473,73,95,62,85,65,85,465,0.6666666666666666,1.0
75,85,200,55,65,30,510,0.16778523489932887,95,125,79,60,100,81,540,0.6165413533834586,0.0
76,48,48,57,62,34,325,0.11688311688311688,68,125,65,65,115,80,518,0.6277372262773723,1.0
43,80,65,50,35,35,308,0.14193548387096774,75,80,70,65,75,90,455,0.7578125,1.0
31,45,90,30,30,40,266,0.21929824561403508,90,92,75,92,85,60,494,0.49586776859504134,1.0
76,104,71,104,71,108,534,0.912751677852349,65,125,100,60,70,70,490,0.6099290780141844,8.0
125,130,90,130,90,95,660,0.7734375,28,25,25,45,35,40,198,0.16083916083916083,0.0
60,130,80,60,60,70,460,0.5153846153846153,85,73,70,73,115,67,483,0.5126050420168067,0.5
70,45,48,60,65,35,323,0.15748031496062992,40,35,30,20,20,50,195,0.23423423423423423,0.5
50,65,90,35,35,15,290,0.14678899082568808,58,70,45,40,45,42,300,0.25925925925925924,1.0
70,135,105,60,105,20,495,0.5806451612903226,65,110,130,60,65,95,525,0.8278145695364238,2.0
80,52,50,90,50,89,411,0.6666666666666666,54,63,52,83,56,97,405,0.7697841726618705,1.0
64,115,65,83,63,65,455,0.5323741007194245,71,120,95,120,95,99,600,0.8203125,1.0
30,80,90,55,45,55,355,0.4295774647887324,60,67,85,77,75,116,480,0.8888888888888888,0.5
38,41,40,50,65,65,299,0.4108527131782946,60,75,85,100,85,115,520,0.8992248062015504,0.5
70,95,85,55,65,70,440,0.5,50,150,50,150,50,150,600,0.9339622641509434,0.5
60,40,60,40,60,35,295,0.18055555555555555,80,100,200,50,100,50,580,0.3472222222222222,2.0
55,66,44,44,56,85,350,0.6888888888888889,70,75,80,135,80,135,575,0.917910447761194,1.0
60,55,90,145,90,80,520,0.6071428571428571,59,59,58,90,70,73,409,0.5826086956521739,0.5
50,55,50,36,30,43,264,0.2922077922077922,75,105,75,105,75,45,480,0.3274336283185841,1.0
40,35,30,20,20,50,195,0.23423423423423423,64,51,23,51,23,28,240,0.11363636363636363,1.0
70,110,75,145,85,145,630,0.9444444444444444,90,65,65,40,40,15,315,0.19672131147540983,2.0
89,145,90,105,80,91,600,0.8549618320610687,55,55,85,65,85,35,380,0.2014388489208633,1.0
40,45,40,35,35,56,251,0.373015873015873,75,90,140,60,60,40,465,0.3008130081300813,0.5
100,90,130,45,65,55,485,0.4253731343283582,40,20,30,40,80,55,265,0.22764227642276422,4.0
85,80,90,105,95,60,515,0.49074074074074076,50,95,95,35,110,70,455,0.5179856115107914,1.0
55,55,85,65,85,35,380,0.2014388489208633,55,65,95,95,45,85,440,0.6610169491525424,0.5
110,123,65,100,65,65,528,0.5217391304347826,45,49,65,49,65,45,318,0.275,2.0
80,52,50,90,50,89,411,0.6666666666666666,74,100,72,90,72,46,454,0.24561403508771928,4.0
50,85,40,85,40,35,335,0.1746031746031746,70,90,45,15,45,50,315,0.3629032258064516,0.5
74,100,72,90,72,46,454,0.24561403508771928,70,60,125,115,70,55,495,0.35507246376811596,4.0
95,110,95,40,95,55,490,0.40336134453781514,80,100,80,80,80,100,520,0.9051724137931034,1.0
80,145,150,105,110,110,700,0.8692307692307693,70,94,50,94,50,66,424,0.48148148148148145,1.0
95,60,79,100,125,81,540,0.6201550387596899,80,85,95,30,30,25,345,0.2857142857142857,4.0
72,58,80,103,80,97,490,0.7171052631578947,70,50,30,95,135,105,485,0.8040540540540541,1.0
70,100,115,30,65,30,410,0.24390243902439024,80,105,105,105,105,80,580,0.5939849624060151,1.0
50,65,107,105,107,86,520,0.7758620689655172,55,69,85,32,35,28,304,0.09302325581395349,1.0
80,100,123,122,120,80,625,0.56,44,38,39,61,79,42,303,0.2251655629139073,2.0
60,65,70,85,75,40,395,0.21705426356589147,105,105,75,65,100,50,500,0.37593984962406013,0.25
50,52,48,65,50,55,320,0.33098591549295775,45,20,50,60,120,50,345,0.24074074074074073,0.5
106,110,90,154,90,130,680,0.926829268292683,69,55,45,55,55,15,294,0.11666666666666667,2.0
65,70,60,65,65,115,440,0.8583333333333333,64,78,52,78,52,81,405,0.6422764227642277,1.0
80,80,80,55,55,90,440,0.6417910447761194,80,70,40,100,60,145,495,0.921875,1.0
40,50,90,30,55,65,330,0.44680851063829785,83,80,75,70,70,101,479,0.8615384615384616,0.5
85,80,70,135,75,90,535,0.7006802721088435,95,70,73,95,90,60,483,0.3983739837398374,1.0
30,45,55,70,55,85,340,0.5633802816901409,60,85,69,60,69,77,420,0.518796992481203,1.0
75,140,65,112,65,110,567,0.9140625,50,85,125,85,115,20,480,0.4306569343065693,1.0
44,38,33,61,43,70,289,0.5267857142857143,30,30,30,30,30,30,180,0.12612612612612611,0.5
71,73,88,120,89,59,500,0.43537414965986393,71,120,95,120,95,99,600,0.8203125,1.0
65,125,100,60,70,70,490,0.6099290780141844,38,35,35,65,55,50,278,0.2647058823529412,0.5
60,62,50,62,60,40,334,0.18181818181818182,20,25,45,70,90,60,310,0.30833333333333335,1.0
50,20,55,25,25,30,205,0.09774436090225563,86,81,97,81,107,43,495,0.203125,2.0
65,65,45,75,45,95,390,0.72,95,70,73,95,90,60,483,0.3983739837398374,0.5
30,30,42,30,42,70,244,0.4230769230769231,20,10,230,10,230,5,505,0.0,1.0
160,110,65,65,110,30,540,0.35714285714285715,75,98,63,98,63,101,498,0.889763779527559,1.0
55,63,90,50,80,42,380,0.21138211382113822,100,150,120,120,100,90,680,0.6493506493506493,0.5
130,85,80,85,95,60,535,0.43884892086330934,120,120,120,120,120,120,720,0.9344262295081968,1.0
100,120,120,150,100,90,680,0.7880794701986755,62,77,62,50,42,65,358,0.4838709677419355,1.0
80,95,82,60,82,75,474,0.6,75,95,125,45,75,95,510,0.8257575757575758,0.5
50,105,79,35,110,76,455,0.6214285714285714,46,87,60,30,40,57,320,0.37777777777777777,1.0
80,70,65,80,120,100,515,0.8034188034188035,50,180,20,180,20,150,600,0.9029850746268657,1.0
74,108,133,83,65,32,495,0.32142857142857145,70,90,70,60,60,70,420,0.6390977443609023,1.0
100,100,100,100,100,100,600,0.831858407079646,59,59,58,90,70,73,409,0.5826086956521739,1.0
90,130,80,65,85,55,505,0.4396551724137931,70,110,180,60,60,50,530,0.4117647058823529,4.0
35,64,85,74,55,32,345,0.19827586206896552,72,60,30,20,30,25,237,0.11570247933884298,1.0
60,30,30,36,56,50,262,0.32432432432432434,90,92,87,75,85,76,505,0.5409836065573771,1.0
60,100,115,70,85,90,520,0.7557251908396947,70,70,70,70,70,70,420,0.5289256198347108,1.0
120,100,85,30,85,45,465,0.22448979591836735,65,100,70,80,80,105,500,0.8666666666666667,1.0
55,50,65,175,95,150,590,0.7818181818181819,40,27,60,37,50,66,280,0.36220472440944884,1.0
30,45,59,30,39,57,260,0.2803030303030303,73,115,60,60,60,90,458,0.6694915254237288,1.0
40,40,50,30,30,30,220,0.0873015873015873,45,60,30,80,50,65,330,0.4603174603174603,0.5
62,50,58,73,54,72,369,0.4435483870967742,55,95,115,45,45,35,390,0.2116788321167883,0.25
60,82,45,45,45,74,351,0.5752212389380531,52,65,55,58,62,60,352,0.4482758620689655,0.0
84,86,88,111,101,60,530,0.4634146341463415,44,58,44,58,44,61,309,0.41964285714285715,1.0
35,85,45,35,35,75,310,0.6492537313432836,45,90,20,65,20,65,305,0.5116279069767442,1.0
60,80,110,50,80,45,425,0.2833333333333333,55,50,65,175,95,150,590,0.7818181818181819,1.0
20,10,55,15,20,80,200,0.17985611510791366,90,75,75,90,100,70,500,0.5462184873949579,0.5
65,76,84,54,96,105,480,0.9008264462809917,55,68,64,45,55,31,318,0.11666666666666667,1.0
123,100,62,97,81,68,531,0.4806201550387597,95,60,79,100,125,81,540,0.6201550387596899,2.0
85,105,85,40,50,40,405,0.211864406779661,100,100,100,100,100,100,600,0.8805970149253731,1.0
50,45,45,35,35,50,260,0.23529411764705882,70,120,100,145,105,20,560,0.2824427480916031,1.0
75,110,110,110,105,80,590,0.656934306569343,90,92,75,92,85,60,494,0.49586776859504134,1.0
78,84,78,109,85,100,534,0.8646616541353384,40,30,50,55,55,100,330,0.584070796460177,0.5
50,25,28,45,55,15,218,0.0625,30,35,30,100,35,80,310,0.4765625,0.5
40,35,30,120,70,105,400,0.6692307692307692,41,64,45,50,50,50,300,0.36752136752136755,1.0
40,45,35,65,55,70,310,0.4482758620689655,72,95,67,103,71,122,530,0.9606299212598425,2.0
106,90,130,90,154,110,680,0.8699186991869918,46,87,60,30,40,57,320,0.37777777777777777,1.0
40,45,65,100,120,90,460,0.5588235294117647,99,68,83,72,87,51,460,0.417910447761194,1.0
79,85,60,55,60,71,410,0.60431654676259,65,155,120,65,90,105,600,0.8677685950413223,1.0
50,40,85,40,65,25,305,0.08870967741935484,55,45,45,25,25,15,210,0.048,1.0
55,68,64,45,55,31,318,0.11666666666666667,80,145,150,105,110,110,700,0.8692307692307693,0.5
79,103,120,135,115,78,630,0.5763888888888888,126,131,95,131,98,99,680,0.8294573643410853,1.0
64,88,50,88,50,106,446,0.9111111111111111,59,45,40,35,40,31,250,0.14285714285714285,1.0
50,65,64,44,48,43,314,0.2196969696969697,91,72,90,129,90,108,580,0.8925619834710744,0.5
65,65,60,110,95,130,525,0.9253731343283582,50,48,43,46,41,60,288,0.47297297297297297,0.0
40,45,65,100,120,90,460,0.5588235294117647,70,77,60,97,60,108,472,0.8394160583941606,1.0
91,90,129,90,72,108,580,0.9140625,70,80,50,35,35,35,305,0.14,1.0
45,55,39,35,39,42,255,0.18518518518518517,50,45,45,35,35,50,260,0.23529411764705882,1.0
35,35,40,35,55,50,250,0.40336134453781514,75,87,63,87,63,98,473,0.865546218487395,1.0
45,80,100,35,37,28,325,0.3125,46,87,60,30,40,57,320,0.37777777777777777,1.0
79,85,60,55,60,71,410,0.60431654676259,110,85,95,80,95,50,515,0.2713178294573643,1.0
50,65,107,105,107,86,520,0.6991150442477876,90,100,60,90,60,80,480,0.6422764227642277,1.0
39,52,43,60,50,65,309,0.5041322314049587,50,52,48,65,50,55,320,0.33098591549295775,0.5
80,50,100,100,200,50,580,0.2357142857142857,109,66,84,81,99,32,471,0.2013888888888889,2.0
75,90,50,110,80,95,500,0.7985611510791367,75,100,110,45,55,65,450,0.5333333333333333,1.0
55,55,50,45,65,55,325,0.37373737373737376,60,40,60,40,60,35,295,0.18055555555555555,1.0
75,80,60,65,90,102,472,0.8625954198473282,90,75,85,115,90,55,510,0.3445378151260504,1.0
91,129,90,72,90,108,580,0.8536585365853658,80,80,90,110,130,110,600,0.8721804511278195,0.5
70,105,105,50,40,20,390,0.33587786259541985,55,104,105,94,75,52,485,0.36363636363636365,1.0
65,63,45,45,45,45,308,0.2595419847328244,106,110,90,154,90,130,680,0.926829268292683,1.0
100,77,77,128,128,90,600,0.6901408450704225,80,70,65,80,120,100,515,0.8034188034188035,2.0
106,190,100,154,100,130,780,0.9259259259259259,95,125,79,60,100,81,540,0.6165413533834586,0.5
99,68,83,72,87,51,460,0.417910447761194,52,65,50,45,50,38,300,0.27419354838709675,0.5
79,115,70,125,80,111,580,0.864,85,60,65,135,105,100,550,0.7518248175182481,2.0
60,60,60,35,35,30,280,0.11194029850746269,49,49,56,49,61,66,330,0.5190839694656488,1.0
35,80,50,50,70,120,405,0.84375,20,25,45,70,90,60,310,0.30833333333333335,1.0
55,65,95,95,45,85,440,0.6610169491525424,60,75,85,100,85,115,520,0.8992248062015504,0.5
105,95,75,85,75,74,509,0.5714285714285714,61,72,57,55,55,65,365,0.3984375,2.0
40,45,40,65,40,65,295,0.5661764705882353,81,102,77,85,75,85,505,0.5642857142857143,0.0
55,81,60,50,70,97,413,0.7214285714285714,75,100,63,80,63,116,497,0.9345794392523364,1.0
65,83,57,95,85,105,490,0.8914728682170543,75,75,55,105,85,30,425,0.1619718309859155,0.5
75,95,60,65,60,115,470,0.8778625954198473,78,65,68,112,154,75,552,0.628099173553719,1.0
50,40,85,40,65,25,305,0.08870967741935484,68,75,53,83,113,60,452,0.45384615384615384,1.0
70,85,65,105,85,120,530,0.9262295081967213,50,70,50,50,50,40,310,0.16296296296296298,2.0
40,30,30,55,30,85,270,0.4666666666666667,150,160,100,95,65,100,670,0.8866666666666667,1.0
77,120,90,60,90,48,485,0.2785714285714286,90,100,70,110,150,80,600,0.6037735849056604,2.0
50,60,45,100,80,65,400,0.45689655172413796,60,82,45,45,45,74,351,0.5752212389380531,1.0
30,56,35,25,35,72,253,0.48148148148148145,55,112,45,74,45,70,401,0.559322033898305,0.5
70,100,115,30,65,30,410,0.24390243902439024,61,84,65,70,70,70,420,0.5,1.0
95,85,85,65,65,35,430,0.2571428571428571,50,50,62,40,62,65,329,0.4188034188034188,2.0
106,190,100,154,100,130,780,0.9259259259259259,35,45,160,30,45,70,385,0.48148148148148145,4.0
55,35,50,55,110,85,390,0.6277372262773723,39,52,43,60,50,65,309,0.5041322314049587,0.5
160,110,65,65,110,30,540,0.35714285714285715,40,30,35,45,40,55,245,0.31496062992125984,1.0
95,85,85,65,65,35,430,0.2571428571428571,52,65,50,45,50,38,300,0.27419354838709675,0.5
50,20,40,20,40,20,190,0.0962962962962963,70,120,40,95,40,95,460,0.8106060606060606,2.0
60,70,105,70,120,75,500,0.5983606557377049,55,35,50,55,110,85,390,0.6277372262773723,0.0
72,60,30,20,30,25,237,0.11570247933884298,80,52,50,90,50,89,411,0.6666666666666666,0.25
55,70,40,60,40,40,305,0.26956521739130435,40,45,40,35,35,56,251,0.373015873015873,2.0
81,102,77,85,75,85,505,0.5642857142857143,66,65,48,62,57,52,350,0.36220472440944884,1.0
125,130,90,130,90,95,660,0.7734375,101,72,72,99,89,29,462,0.1937984496124031,0.0
40,70,130,60,130,25,455,0.17355371900826447,53,51,53,61,56,40,314,0.14285714285714285,1.0
65,45,55,45,70,45,325,0.24369747899159663,60,70,50,100,50,65,395,0.5217391304347826,1.0
64,66,68,81,76,50,405,0.25190839694656486,70,70,115,130,90,60,535,0.5338983050847458,1.0
80,160,60,170,130,80,680,0.6180555555555556,106,130,90,110,154,90,680,0.719626168224299,1.0
100,128,90,77,77,128,600,0.959349593495935,70,62,67,55,55,56,365,0.38513513513513514,0.5
104,91,63,91,73,68,490,0.5118110236220472,95,117,80,65,70,92,519,0.8409090909090909,1.0
70,45,48,60,65,35,323,0.15748031496062992,72,85,70,65,70,58,420,0.41304347826086957,4.0
70,65,60,90,75,90,450,0.6571428571428571,90,120,75,60,60,45,450,0.29411764705882354,1.0
80,100,200,50,100,50,580,0.3472222222222222,55,112,45,74,45,70,401,0.559322033898305,2.0
79,100,80,110,90,121,580,0.968,60,60,40,65,45,35,305,0.15833333333333333,1.0
48,72,48,72,48,48,336,0.25984251968503935,95,145,130,120,90,120,700,0.9398496240601504,1.0
130,85,80,85,95,60,535,0.43884892086330934,38,36,38,32,36,57,237,0.3893805309734513,1.0
30,30,30,30,30,30,180,0.12612612612612611,64,165,75,93,83,75,555,0.6587301587301587,1.0
70,65,60,90,75,90,450,0.6571428571428571,35,65,35,65,35,65,300,0.46621621621621623,1.0
70,120,65,45,85,125,510,0.9747899159663865,62,73,55,56,52,84,382,0.7244094488188977,1.0
80,50,100,100,200,50,580,0.2357142857142857,85,90,80,70,80,130,535,0.9262295081967213,2.0
40,45,35,65,55,70,310,0.4482758620689655,90,110,80,100,80,95,555,0.7982456140350878,0.5
50,50,40,50,40,64,294,0.45588235294117646,45,75,37,70,55,83,365,0.6183206106870229,2.0
55,40,40,65,45,35,280,0.16428571428571428,60,55,90,145,90,80,520,0.6071428571428571,1.0
50,64,50,45,50,41,300,0.22727272727272727,70,95,85,55,65,70,440,0.5,2.0
79,115,70,125,80,111,580,0.864,50,53,48,53,48,64,316,0.358974358974359,2.0
60,60,60,85,85,85,435,0.631578947368421,41,50,37,50,37,66,281,0.5175438596491229,0.5
86,81,97,81,107,43,495,0.203125,30,30,30,30,30,30,180,0.12612612612612611,0.5
84,71,43,71,43,48,360,0.25874125874125875,50,40,85,40,65,25,305,0.08870967741935484,1.0
45,55,39,35,39,42,255,0.18518518518518517,65,83,57,95,85,105,490,0.8914728682170543,1.0
50,50,40,50,40,64,294,0.45588235294117646,45,30,40,105,50,20,290,0.031007751937984496,1.0
125,120,90,170,100,95,700,0.78125,70,60,70,87,78,85,450,0.6228070175438597,2.0
49,49,56,49,61,66,330,0.5190839694656488,60,85,60,50,50,125,430,0.9090909090909091,1.0
55,112,45,74,45,70,401,0.559322033898305,40,55,70,45,60,30,300,0.10619469026548672,0.25
50,35,55,25,25,15,205,0.021739130434782608,100,120,100,150,120,90,680,0.728,0.5
70,20,50,20,50,40,250,0.1557377049180328,45,67,60,35,50,63,320,0.5128205128205128,0.5
65,105,60,60,70,95,455,63.0,80,85,95,30,30,25,345,0.2857142857142857,2.0
41,56,40,62,44,71,314,0.568,71,82,64,64,59,112,452,0.9327731092436975,1.0
50,45,45,35,35,50,260,0.23529411764705882,72,95,67,103,71,122,530,0.9606299212598425,1.0
80,100,200,50,100,50,580,0.3472222222222222,50,20,40,20,40,20,190,0.0962962962962963,1.0
60,115,105,65,70,80,495,0.7181818181818181,43,30,55,40,65,97,330,0.6030534351145038,0.5
70,110,180,60,60,50,530,0.4117647058823529,70,115,60,115,60,55,475,0.4647887323943662,1.0
55,45,43,55,43,72,313,0.5853658536585366,71,120,95,120,95,99,600,0.8203125,0.5
70,90,90,135,90,125,600,0.9401709401709402,65,90,122,58,75,84,494,0.71875,2.0
44,75,35,63,33,45,295,0.2647058823529412,135,85,40,40,85,5,390,0.6864406779661016,0.0
60,65,80,170,95,130,600,0.8625954198473282,60,45,50,90,80,70,395,0.625,1.0
30,45,55,70,55,85,340,0.5633802816901409,65,130,60,75,60,75,465,0.689922480620155,1.0
55,40,85,80,105,40,405,0.23622047244094488,30,80,90,55,45,55,355,0.4295774647887324,0.5
63,63,47,41,41,74,329,0.56,80,70,40,100,60,145,495,0.921875,1.0
130,65,60,110,95,65,525,0.5227272727272727,70,90,45,15,45,50,315,0.3629032258064516,2.0
80,105,105,105,105,80,580,0.5939849624060151,70,55,65,95,85,70,440,0.5307692307692308,0.5
30,105,90,25,25,50,325,0.2773722627737226,50,50,95,40,50,35,320,0.20279720279720279,2.0
80,85,95,30,30,25,345,0.2857142857142857,65,95,57,100,85,93,495,0.7441860465116279,4.0
60,60,60,105,105,105,495,0.848,50,70,50,50,50,70,340,0.5645161290322581,1.0
65,85,70,75,70,40,405,0.203125,50,50,50,50,50,50,300,0.30708661417322836,1.0
126,131,95,131,98,99,680,0.8294573643410853,85,80,70,135,75,90,535,0.7006802721088435,1.0
70,60,125,115,70,55,495,0.35507246376811596,50,85,55,65,65,90,410,0.7478260869565218,4.0
40,45,40,35,35,56,251,0.373015873015873,36,50,50,65,60,44,305,0.16363636363636364,1.0
60,85,40,30,45,68,328,0.6422018348623854,108,112,118,68,72,47,525,0.2916666666666667,1.0
50,50,62,40,62,65,329,0.4188034188034188,60,50,40,85,75,95,405,0.7540983606557377,1.0
50,65,107,105,107,86,520,0.7272727272727273,62,50,58,73,54,72,369,0.4435483870967742,1.0
80,52,50,90,50,89,411,0.6666666666666666,60,40,80,60,45,40,325,0.23529411764705882,8.0
90,132,105,132,105,30,594,0.4246575342465753,45,90,20,65,20,65,305,0.5116279069767442,1.0
70,70,40,60,40,60,340,0.4247787610619469,70,80,50,35,35,35,305,0.14,0.5
75,95,122,58,75,69,494,0.5725806451612904,60,59,85,79,105,36,424,0.16666666666666666,0.25
90,75,75,90,100,70,500,0.5462184873949579,45,30,35,20,20,45,195,0.14782608695652175,1.0
92,105,90,125,90,98,600,0.8217054263565892,85,115,80,105,80,50,515,0.3063063063063063,1.0
80,92,65,65,80,68,450,0.4824561403508772,40,45,35,65,55,70,310,0.4482758620689655,0.5
50,75,75,65,65,50,380,0.4049586776859504,65,70,60,65,65,115,440,0.8583333333333333,0.0
50,47,50,57,50,65,319,0.463768115942029,40,30,35,45,40,55,245,0.31496062992125984,0.5
65,95,75,55,55,85,430,0.6933333333333334,78,84,78,109,85,100,534,0.8646616541353384,2.0
72,105,115,54,86,68,500,0.5149253731343284,55,55,55,85,55,30,335,0.1320754716981132,1.0
80,80,90,110,130,110,600,0.8721804511278195,65,125,100,55,70,85,500,0.6532258064516129,1.0
68,72,78,38,42,32,330,0.23809523809523808,45,85,50,55,50,65,350,0.5076923076923077,1.0
55,40,85,80,105,40,405,0.23622047244094488,80,110,60,150,130,70,600,0.5042016806722689,1.0
75,75,130,75,130,95,580,0.7479674796747967,85,115,80,105,80,50,515,0.3063063063063063,1.0
95,110,95,40,95,55,490,0.40336134453781514,90,120,75,60,60,45,450,0.29411764705882354,1.0
70,85,70,60,70,50,405,0.28378378378378377,106,190,100,154,100,130,780,0.9259259259259259,1.0
70,85,140,85,70,20,470,0.272,86,76,86,116,56,95,515,0.7982456140350878,2.0
70,90,90,135,90,125,600,0.9401709401709402,75,105,75,105,75,45,480,0.3274336283185841,1.0
50,65,85,35,35,55,325,0.32575757575757575,91,90,106,130,106,77,600,0.648854961832061,0.25
50,85,85,55,55,50,380,0.3902439024390244,70,65,60,90,75,90,450,0.6571428571428571,0.5
100,100,100,100,100,100,600,0.8345864661654135,55,95,115,45,45,35,390,0.2116788321167883,8.0
75,125,70,125,70,115,580,0.9037037037037037,50,65,107,105,107,86,520,0.7272727272727273,1.0
70,45,48,60,65,35,323,0.15748031496062992,35,40,100,90,55,35,355,0.1796875,1.0
50,65,90,35,35,15,290,0.14678899082568808,68,72,78,38,42,32,330,0.23809523809523808,1.0
95,23,48,23,48,23,260,0.046153846153846156,45,45,55,45,55,63,308,0.4594594594594595,1.0
45,30,50,55,65,45,290,0.208,40,40,35,50,100,70,335,0.5031847133757962,2.0
60,85,60,85,60,55,405,0.3673469387755102,74,48,76,83,81,104,466,0.7322834645669292,0.5
105,95,75,85,75,74,509,0.5714285714285714,55,75,50,40,40,80,340,0.6302521008403361,0.0
36,50,50,65,60,44,305,0.16363636363636364,45,30,50,55,65,45,290,0.208,1.0
50,30,55,65,55,20,275,0.13675213675213677,100,100,100,100,100,100,600,0.831858407079646,2.0
80,82,83,100,100,80,525,0.6742424242424242,110,135,60,50,65,88,508,0.7744360902255639,0.0
170,90,45,90,45,60,500,0.427536231884058,55,68,64,45,55,31,318,0.11666666666666667,0.5
70,40,50,55,50,25,290,0.061068702290076333,50,65,64,44,48,43,314,0.2196969696969697,0.25
70,105,105,50,40,20,390,0.33587786259541985,68,90,65,50,55,82,410,0.6165413533834586,0.5
39,52,43,60,50,65,309,0.49107142857142855,100,134,110,95,100,61,600,0.4057971014492754,0.5
61,78,95,56,58,57,405,0.40336134453781514,95,124,78,69,71,58,495,0.37398373983739835,1.0
70,95,85,55,65,70,440,0.5,63,63,47,41,41,74,329,0.56,0.0
55,45,50,45,65,80,340,0.5546218487394958,67,58,57,81,67,101,431,0.8790322580645161,0.5
65,90,120,85,70,60,490,0.43410852713178294,106,190,100,154,100,130,780,0.9259259259259259,1.0
100,73,83,73,83,55,467,0.371900826446281,75,125,100,70,80,45,495,0.33035714285714285,0.5
90,92,75,92,85,60,494,0.49586776859504134,50,70,160,70,160,90,600,0.7417218543046358,1.0
40,35,30,120,70,105,400,0.6692307692307692,79,105,70,145,80,101,580,0.8608695652173913,1.0
63,120,85,90,55,55,468,0.2809917355371901,30,80,90,55,45,55,355,0.4295774647887324,1.0
50,95,95,35,110,70,455,0.5179856115107914,60,40,80,60,45,40,325,0.23529411764705882,0.5
100,128,90,77,77,128,600,0.959349593495935,61,84,65,70,70,70,420,0.5,1.0
65,150,60,115,60,115,565,0.935251798561151,61,72,57,55,55,65,365,0.3984375,1.0
30,45,55,70,55,85,340,0.5633802816901409,80,115,80,65,55,93,488,0.7846153846153846,1.0
105,95,75,85,75,74,509,0.5714285714285714,60,85,49,60,49,60,363,0.4444444444444444,2.0
100,100,100,100,100,100,600,0.8805970149253731,85,80,70,135,75,90,535,0.7006802721088435,1.0
72,105,115,54,86,68,500,0.5149253731343284,65,65,65,50,50,90,385,0.72,0.5
65,85,70,75,70,40,405,0.203125,95,65,65,110,130,60,525,0.4016393442622951,1.0
72,85,70,65,70,58,420,0.41304347826086957,40,50,90,30,55,65,330,0.44680851063829785,1.0
70,100,70,105,75,40,460,0.23214285714285715,55,95,115,45,45,35,390,0.2116788321167883,1.0
100,164,150,95,120,71,700,0.5645161290322581,38,35,35,65,55,50,278,0.2647058823529412,1.0
80,70,65,80,120,100,515,0.8034188034188035,60,150,50,150,50,60,520,0.5,0.0
50,75,35,70,30,40,300,0.21296296296296297,50,70,100,40,40,30,330,0.2222222222222222,0.0
60,30,30,36,56,50,262,0.32432432432432434,95,60,79,100,125,81,540,0.6201550387596899,1.0
35,85,45,35,35,75,310,0.6492537313432836,65,125,100,60,70,70,490,0.6099290780141844,0.25
70,65,60,90,75,90,450,0.6571428571428571,40,35,30,20,20,50,195,0.23423423423423423,0.25
79,105,70,145,80,101,580,0.8608695652173913,44,38,39,61,79,42,303,0.2251655629139073,1.0
85,115,80,105,80,50,515,0.3063063063063063,91,90,72,90,129,108,580,0.896,0.5
100,103,75,120,75,127,600,0.940677966101695,150,120,100,120,100,90,680,0.664179104477612,0.5
40,45,35,65,55,70,310,0.4482758620689655,50,72,35,35,35,65,292,0.5373134328358209,2.0
60,55,145,75,150,40,525,0.2,45,50,35,55,75,40,300,0.21367521367521367,1.0
105,130,120,45,45,40,485,0.4444444444444444,68,125,65,65,115,80,518,0.6277372262773723,0.5
80,120,79,95,79,70,523,0.5833333333333334,64,165,75,93,83,75,555,0.6587301587301587,1.0
90,110,80,100,80,95,555,0.7982456140350878,60,70,65,125,105,90,515,0.6911764705882353,2.0
95,117,80,65,70,92,519,0.8409090909090909,75,95,95,95,95,85,540,0.6470588235294118,1.0
10,55,25,35,45,95,265,0.5396825396825397,70,150,140,65,100,75,600,0.55,1.0
150,100,120,100,120,90,680,0.6666666666666666,83,80,75,70,70,101,479,0.8615384615384616,0.0
50,55,50,36,30,43,264,0.2922077922077922,50,72,35,35,35,65,292,0.5373134328358209,1.0
95,75,80,100,110,30,490,0.24242424242424243,80,120,80,120,80,100,580,0.8478260869565217,1.0
50,55,50,36,30,43,264,0.2922077922077922,100,150,110,95,110,70,635,0.5923076923076923,1.0
63,63,47,41,41,74,329,0.56,64,165,75,93,83,75,555,0.6587301587301587,1.0
70,110,70,115,70,90,525,0.75,70,85,70,60,70,50,405,0.28378378378378377,0.5
58,109,112,48,48,109,484,0.8805970149253731,76,65,45,92,42,91,411,0.7449664429530202,0.5
78,84,78,109,85,100,534,0.8646616541353384,75,95,60,65,60,115,470,0.8778625954198473,1.0
52,65,55,58,62,60,352,0.4482758620689655,170,90,45,90,45,60,500,0.427536231884058,1.0
150,80,44,90,54,80,498,0.625,100,128,90,77,77,128,600,0.959349593495935,0.0
70,90,45,15,45,50,315,0.3629032258064516,55,50,40,40,40,75,300,0.5945945945945946,1.0
66,65,48,62,57,52,350,0.36220472440944884,70,140,230,60,80,50,630,0.32432432432432434,0.5
30,40,70,70,25,60,295,0.41353383458646614,40,45,40,65,40,65,295,0.5661764705882353,1.0
90,132,105,132,105,30,594,0.4246575342465753,55,75,60,75,60,103,428,0.7982456140350878,1.0
74,108,133,83,65,32,495,0.32142857142857145,95,75,180,130,80,30,590,0.13793103448275862,0.5
43,30,55,40,65,97,330,0.6030534351145038,55,95,55,35,75,115,430,0.9380530973451328,1.0
255,10,10,75,135,55,540,0.3125,80,100,200,50,100,50,580,0.3472222222222222,0.5
100,150,90,180,160,90,770,0.7348484848484849,40,40,35,50,100,70,335,0.5031847133757962,0.5
50,160,110,160,110,110,700,0.8854961832061069,75,100,63,80,63,116,497,0.9345794392523364,1.0
50,50,40,30,30,50,250,0.2781954887218045,40,45,40,65,40,65,295,0.5661764705882353,2.0
55,45,50,45,65,80,340,0.5546218487394958,75,125,70,125,70,115,580,0.9037037037037037,1.0
125,170,100,120,90,95,700,0.77,45,60,30,80,50,65,330,0.4603174603174603,0.5
55,47,52,40,40,41,275,0.16806722689075632,150,100,120,100,120,90,680,0.6666666666666666,0.5
123,100,62,97,81,68,531,0.4806201550387597,103,93,67,71,61,84,479,0.7142857142857143,0.5
70,85,65,105,85,120,530,0.9262295081967213,68,65,65,125,115,80,518,0.6461538461538462,1.0
50,65,107,105,107,86,520,0.6991150442477876,40,45,65,100,120,90,460,0.5588235294117647,1.0
68,65,65,125,115,80,518,0.6461538461538462,46,57,40,40,40,50,273,0.25,1.0
60,55,145,75,150,40,525,0.2,90,110,80,100,80,95,555,0.7982456140350878,1.0
80,92,65,65,80,68,450,0.4824561403508772,80,82,83,100,100,80,525,0.6742424242424242,0.5
80,90,80,130,110,110,600,0.856,110,123,65,100,65,65,528,0.5217391304347826,1.0
120,100,85,30,85,45,465,0.22448979591836735,65,80,80,59,63,58,405,0.4411764705882353,1.0
70,70,70,70,70,70,420,0.5289256198347108,50,85,40,85,40,35,335,0.1746031746031746,1.0
60,62,80,63,80,60,405,0.4336283185840708,65,110,130,60,65,95,525,0.8278145695364238,0.5
65,105,60,60,70,95,455,63.0,70,95,125,65,75,45,475,0.33613445378151263,1.0
78,84,78,109,85,100,534,0.8646616541353384,76,104,71,104,71,108,534,0.912751677852349,1.0
130,65,60,110,95,65,525,0.5227272727272727,20,25,45,70,90,60,310,0.30833333333333335,1.0
70,135,105,60,105,20,495,0.5806451612903226,90,95,105,165,110,45,610,0.2890625,0.5
65,50,70,95,80,65,425,0.4262295081967213,45,30,40,105,50,20,290,0.031007751937984496,0.5
55,130,115,50,50,75,475,0.5982142857142857,70,115,60,115,60,55,475,0.4647887323943662,0.5
66,65,48,62,57,52,350,0.36220472440944884,35,65,35,65,35,65,300,0.46621621621621623,2.0
59,66,70,44,55,41,335,0.25190839694656486,45,45,55,45,55,63,308,0.4594594594594595,0.5
105,140,55,30,55,95,480,0.8195488721804511,50,65,90,35,35,15,290,0.14678899082568808,2.0
45,30,50,55,65,45,290,0.208,95,117,80,65,70,92,519,0.8409090909090909,0.0
80,125,75,40,95,85,500,0.6911764705882353,45,60,40,70,50,45,310,0.2846715328467153,0.5
85,105,85,40,50,40,405,0.211864406779661,75,100,66,60,66,115,482,0.918918918918919,2.0
60,70,50,100,50,65,395,0.5217391304347826,65,130,60,95,110,65,525,0.5303030303030303,0.5
60,75,100,55,80,50,420,0.3088235294117647,73,95,62,85,65,85,465,0.6666666666666666,1.0
85,90,80,70,80,130,535,0.9262295081967213,55,84,105,114,75,52,485,0.2890625,1.0
99,68,83,72,87,51,460,0.417910447761194,60,100,85,80,85,100,510,0.7007874015748031,2.0
55,70,55,40,55,85,360,0.7073170731707317,100,180,160,150,90,90,770,0.7520661157024794,1.0
100,100,125,110,50,50,535,0.384,65,95,57,100,85,93,495,0.7441860465116279,0.5
50,60,45,100,80,65,400,0.45689655172413796,60,60,75,60,75,80,410,0.7321428571428571,1.0
60,82,45,45,45,74,351,0.5752212389380531,77,59,50,67,63,46,362,0.23140495867768596,2.0
114,85,70,85,80,30,464,0.2066115702479339,45,85,50,55,50,65,350,0.5076923076923077,1.0
111,83,68,92,82,39,475,0.1774193548387097,56,61,65,48,45,38,313,0.17567567567567569,0.25
43,30,55,40,65,97,330,0.6030534351145038,39,52,43,60,50,65,309,0.49107142857142855,2.0
35,46,34,35,45,20,215,0.072,80,120,130,55,65,45,495,0.37037037037037035,0.5
65,85,70,75,70,40,405,0.203125,62,77,62,50,42,65,358,0.4838709677419355,2.0
45,30,35,20,20,45,195,0.14782608695652175,100,120,120,150,100,90,680,0.7880794701986755,0.5
50,85,40,85,40,35,335,0.1746031746031746,40,30,32,50,52,65,269,0.3671875,1.0
50,25,28,45,55,15,218,0.0625,78,130,111,130,85,100,634,0.8561151079136691,1.0
65,125,60,95,60,105,510,0.9236641221374046,101,72,72,99,89,29,462,0.1937984496124031,0.5
85,50,95,120,115,80,545,0.5793650793650794,30,42,118,42,88,30,350,0.112,0.125
79,103,120,135,115,78,630,0.5763888888888888,64,88,50,88,50,106,446,0.9111111111111111,1.0
54,78,103,53,45,22,355,0.23255813953488372,60,79,105,59,85,36,424,0.17054263565891473,2.0
90,120,75,60,60,45,450,0.29411764705882354,74,108,133,83,65,32,495,0.32142857142857145,1.0
40,45,35,30,40,55,245,0.3793103448275862,61,78,95,56,58,57,405,0.40336134453781514,4.0
68,165,95,65,115,110,618,0.8615384615384616,40,65,95,60,45,35,340,0.13986013986013987,1.0
64,66,68,81,76,50,405,0.25190839694656486,50,20,55,25,25,30,205,0.09774436090225563,1.0
42,52,67,39,56,50,306,0.2868217054263566,76,65,45,92,42,91,411,0.7449664429530202,2.0
55,66,44,44,56,85,350,0.6888888888888889,75,100,110,45,55,65,450,0.5333333333333333,1.0
60,62,63,80,80,60,405,0.38016528925619836,39,52,43,60,50,65,309,0.49107142857142855,0.5
80,145,150,105,110,110,700,0.8692307692307693,75,80,95,90,100,50,490,0.2158273381294964,1.0
35,85,45,35,35,75,310,0.6492537313432836,82,121,119,69,59,71,521,0.5394736842105263,0.25
76,65,45,92,42,91,411,0.7449664429530202,89,125,90,115,80,101,600,0.8725490196078431,1.0
100,77,77,128,128,90,600,0.6901408450704225,90,100,90,125,85,90,580,0.7352941176470589,1.0
105,125,100,60,100,100,590,0.8359375,110,65,75,125,85,30,490,0.15,1.0
70,150,140,65,100,75,600,0.55,40,29,45,29,45,36,224,0.14634146341463414,1.0
45,49,49,65,65,45,318,0.2781954887218045,68,85,65,165,135,100,618,0.8083333333333333,2.0
45,63,37,65,55,95,360,0.8055555555555556,55,40,50,65,85,40,335,0.3181818181818182,2.0
77,85,51,55,51,65,384,0.5163934426229508,85,110,76,65,82,56,474,0.3933333333333333,1.0
45,85,50,55,50,65,350,0.5076923076923077,48,61,40,61,40,50,300,0.2543859649122807,0.5
75,65,55,65,55,69,384,0.43548387096774194,60,65,80,170,95,130,600,0.8625954198473282,2.0
75,89,85,55,65,36,405,0.29545454545454547,75,105,75,105,75,45,480,0.3274336283185841,2.0
77,59,50,67,63,46,362,0.23140495867768596,70,100,115,30,65,30,410,0.24390243902439024,1.0
78,52,60,63,65,23,341,0.06015037593984962,75,100,66,60,66,115,482,0.918918918918919,1.0
95,75,110,100,80,30,490,0.15267175572519084,60,90,70,60,120,40,440,0.27419354838709675,1.0
50,64,50,45,50,41,300,0.22727272727272727,40,55,30,30,30,60,245,0.43548387096774194,0.0
70,95,85,55,65,70,440,0.5,45,100,45,45,45,10,290,0.2949640287769784,1.0
73,95,62,85,65,85,465,0.6666666666666666,103,60,86,60,86,50,445,0.3458646616541353,1.0
60,50,40,85,75,95,405,0.7540983606557377,72,60,30,20,30,25,237,0.11570247933884298,1.0
75,95,67,125,95,83,540,0.7117117117117117,55,130,115,50,50,75,475,0.5982142857142857,0.5
72,58,80,103,80,97,490,0.7171052631578947,75,98,63,98,63,101,498,0.849624060150376,1.0
95,155,109,70,130,81,640,0.6788321167883211,44,38,39,61,79,42,303,0.2251655629139073,0.5
50,35,55,25,25,15,205,0.05263157894736842,75,140,65,112,65,110,567,0.9140625,0.5
45,63,37,65,55,95,360,0.8055555555555556,75,100,63,80,63,116,497,0.9345794392523364,0.5
79,103,120,135,115,78,630,0.5763888888888888,52,65,50,45,50,38,300,0.27419354838709675,0.5
76,48,48,57,62,34,325,0.11688311688311688,74,48,76,83,81,104,466,0.7322834645669292,1.0
40,30,30,40,50,30,220,0.07936507936507936,57,80,91,80,87,75,470,0.5737704918032787,0.5
130,65,60,110,95,65,525,0.5227272727272727,65,65,60,130,95,110,525,0.823943661971831,1.0
30,45,55,70,55,85,340,0.5633802816901409,75,100,95,40,70,110,490,0.8717948717948718,1.0
55,35,50,55,110,85,390,0.6277372262773723,30,40,70,70,25,60,295,0.41353383458646614,1.0
50,95,180,85,45,70,525,0.5298507462686567,75,125,100,70,80,45,495,0.33035714285714285,2.0
60,60,60,85,85,85,435,0.631578947368421,50,50,62,40,62,65,329,0.4188034188034188,1.0
50,40,85,40,65,25,305,0.08870967741935484,44,50,91,24,86,10,305,0.1981981981981982,1.0
59,74,50,35,50,35,303,0.3125,58,109,112,48,48,109,484,0.8805970149253731,1.0
67,89,116,79,116,33,500,0.2624113475177305,97,165,60,65,50,58,495,0.3902439024390244,2.0
45,40,60,40,75,50,310,0.2926829268292683,75,38,38,56,56,67,330,0.5263157894736842,0.5
35,64,85,74,55,32,345,0.19827586206896552,60,85,69,60,69,77,420,0.518796992481203,1.0
60,50,100,85,70,65,430,0.47580645161290325,65,110,130,60,65,95,525,0.8278145695364238,1.0
85,80,70,135,75,90,535,0.7006802721088435,75,95,60,65,60,115,470,0.8778625954198473,1.0
80,185,115,40,105,75,600,0.6230769230769231,80,80,80,80,80,80,480,0.6015037593984962,2.0
40,65,40,80,40,65,330,0.5038167938931297,30,45,135,45,90,30,375,0.09285714285714286,1.0
100,164,150,95,120,71,700,0.5645161290322581,55,68,64,45,55,31,318,0.11666666666666667,1.0
70,110,80,55,80,105,500,0.8794326241134752,40,40,40,70,40,20,250,0.032520325203252036,0.5
70,145,88,140,70,112,625,0.8888888888888888,50,30,55,65,55,20,275,0.13675213675213677,0.0
60,80,110,50,80,45,425,0.2833333333333333,100,123,75,57,75,80,510,0.6923076923076923,0.0
50,85,125,85,115,20,480,0.4306569343065693,61,72,57,55,55,65,365,0.3984375,1.0
40,80,35,35,45,70,305,0.4661016949152542,106,110,90,154,90,130,680,0.926829268292683,0.5
150,80,44,90,54,80,498,0.625,50,120,53,35,110,87,455,0.640625,2.0
75,69,72,114,100,104,534,0.8253968253968254,65,50,70,95,80,65,425,0.4262295081967213,0.5
58,50,145,95,105,30,483,0.2459016393442623,38,35,40,27,25,35,200,0.08208955223880597,1.0
28,25,25,45,35,40,198,0.16083916083916083,100,120,100,150,120,90,680,0.728,1.0
65,90,120,85,70,60,490,0.43410852713178294,55,95,115,45,45,35,390,0.2116788321167883,0.25
70,120,40,95,40,95,460,0.8106060606060606,44,50,91,24,86,10,305,0.1981981981981982,0.5
45,30,35,20,20,45,195,0.14782608695652175,50,85,55,65,65,90,410,0.7478260869565218,0.5
78,84,78,109,85,100,534,0.8620689655172413,75,110,110,110,105,80,590,0.656934306569343,0.5
110,130,80,70,60,80,530,0.5862068965517241,45,30,15,85,65,65,305,0.36220472440944884,0.5
110,123,65,100,65,65,528,0.5217391304347826,50,53,48,53,48,64,316,0.358974358974359,0.5
95,125,79,60,100,81,540,0.6165413533834586,20,25,45,70,90,60,310,0.30833333333333335,1.0
55,81,60,50,70,97,413,0.7214285714285714,44,50,91,24,86,10,305,0.1981981981981982,0.5
40,40,55,40,70,55,300,0.40939597315436244,60,40,60,95,60,55,370,0.4222222222222222,2.0
75,95,67,125,95,83,540,0.7117117117117117,73,115,60,60,60,90,458,0.6694915254237288,1.0
55,55,55,85,55,30,335,0.1320754716981132,50,35,55,25,25,15,205,0.021739130434782608,1.0
40,55,70,45,60,30,300,0.10619469026548672,60,55,90,145,90,80,520,0.6071428571428571,0.5
40,55,30,30,30,85,270,0.688,70,90,90,135,90,125,600,0.9401709401709402,1.0
44,50,91,24,86,10,305,0.1981981981981982,60,60,60,105,105,105,495,0.848,1.0
50,50,40,50,40,64,294,0.45588235294117646,58,70,45,40,45,42,300,0.25925925925925924,1.0
90,75,75,90,100,70,500,0.5462184873949579,80,82,78,95,80,85,500,0.6869565217391305,0.5
30,40,55,40,55,60,280,0.3237410071942446,64,78,52,78,52,81,405,0.6422764227642277,1.0
30,30,30,30,30,30,180,0.12612612612612611,85,105,55,85,50,115,495,0.9032258064516129,2.0
55,55,85,65,85,35,380,0.2014388489208633,40,70,40,35,40,60,285,0.392,0.5
109,66,84,81,99,32,471,0.2013888888888889,108,112,118,68,72,47,525,0.2916666666666667,0.0
60,115,105,65,70,80,495,0.7181818181818181,108,112,118,68,72,47,525,0.2916666666666667,1.0
80,100,123,122,120,80,625,0.56,35,40,100,90,55,35,355,0.1796875,2.0
100,150,90,180,160,90,770,0.7348484848484849,95,60,79,100,125,81,540,0.6201550387596899,0.5
40,30,30,40,50,30,220,0.07936507936507936,60,70,50,100,50,65,395,0.5217391304347826,0.25
70,90,110,60,75,95,500,0.7333333333333333,55,75,85,25,25,15,280,0.1875,0.5
70,110,75,145,85,145,630,0.9444444444444444,100,134,110,95,100,61,600,0.4057971014492754,2.0
45,60,32,50,32,76,295,0.5925925925925926,91,72,90,129,90,108,580,0.8925619834710744,2.0
68,65,65,125,115,80,518,0.6461538461538462,65,95,75,55,55,85,430,0.6933333333333334,1.0
79,85,60,55,60,71,410,0.60431654676259,70,80,50,35,35,35,305,0.14,1.0
48,61,40,61,40,50,300,0.2543859649122807,50,47,50,57,50,65,319,0.463768115942029,0.5
70,70,115,130,90,60,535,0.5338983050847458,75,69,72,114,100,104,534,0.8253968253968254,0.5
75,105,75,105,75,45,480,0.3274336283185841,75,80,85,110,90,50,490,0.3548387096774194,0.5
60,95,80,60,80,30,405,0.19480519480519481,55,70,45,70,50,60,350,0.45,0.25
40,27,60,37,50,66,280,0.36220472440944884,75,123,67,95,85,95,540,0.7642276422764228,1.0
60,85,69,65,79,80,438,0.576,55,45,50,45,65,80,340,0.5546218487394958,2.0
45,63,37,65,55,95,360,0.8055555555555556,70,120,40,95,40,95,460,0.8106060606060606,2.0
55,75,60,75,60,103,428,0.7982456140350878,75,140,65,112,65,110,567,0.9140625,1.0
60,85,60,85,60,55,405,0.3673469387755102,100,100,100,100,100,100,600,0.8602941176470589,2.0
90,55,75,60,75,30,385,0.13970588235294118,75,100,66,60,66,115,482,0.918918918918919,1.0
67,58,57,81,67,101,431,0.8790322580645161,50,85,125,85,115,20,480,0.4306569343065693,2.0
60,50,50,60,70,50,340,0.28346456692913385,65,47,55,73,75,85,400,0.65,0.5
52,65,55,58,62,60,352,0.4482758620689655,45,100,45,45,45,10,290,0.2949640287769784,1.0
65,45,55,45,70,45,325,0.24369747899159663,49,66,70,44,55,51,335,0.4260869565217391,0.5
45,30,50,55,65,45,290,0.208,89,125,90,115,80,101,600,0.8725490196078431,2.0
255,10,10,75,135,55,540,0.3125,75,65,55,65,55,69,384,0.43548387096774194,1.0
63,63,47,41,41,74,329,0.56,59,63,80,65,80,58,405,0.41843971631205673,1.0
50,53,48,53,48,64,316,0.358974358974359,50,85,40,85,40,35,335,0.1746031746031746,0.5
60,25,35,70,80,60,330,0.3076923076923077,64,165,75,93,83,75,555,0.6587301587301587,1.0
70,65,65,55,55,70,380,0.5,100,100,100,100,100,100,600,0.8602941176470589,1.0
70,100,70,105,75,40,460,0.23214285714285715,30,65,100,45,25,40,305,0.1891891891891892,0.5
130,65,60,110,95,65,525,0.5227272727272727,75,75,75,125,95,40,485,0.15671641791044777,1.0
45,85,50,55,50,65,350,0.5076923076923077,55,75,60,75,60,103,428,0.7982456140350878,0.5
114,85,70,85,80,30,464,0.2066115702479339,45,55,45,65,45,75,330,0.5692307692307692,0.5
80,82,100,83,100,80,525,0.6821705426356589,45,30,50,55,65,45,290,0.208,1.0
79,115,70,125,80,111,580,0.8468468468468469,78,81,71,74,69,126,499,0.9090909090909091,1.0
60,75,85,100,85,115,520,0.8992248062015504,110,65,105,55,95,80,510,0.6258503401360545,0.0
100,164,150,95,120,71,700,0.5645161290322581,60,55,90,145,90,80,520,0.6071428571428571,4.0
80,90,80,130,110,110,600,0.856,90,55,75,60,75,30,385,0.13970588235294118,1.0
95,117,80,65,70,92,519,0.8409090909090909,65,45,55,45,70,45,325,0.24369747899159663,1.0
100,120,120,150,100,90,680,0.7880794701986755,60,48,45,43,90,42,328,0.21897810218978103,1.0
60,85,60,50,50,125,430,0.9090909090909091,255,10,10,75,135,55,540,0.3125,1.0
80,80,80,55,55,90,440,0.6417910447761194,101,72,72,99,89,29,462,0.1937984496124031,1.0
85,70,80,97,80,123,535,0.9304347826086956,25,35,70,95,55,45,325,0.16783216783216784,0.125
55,45,50,45,65,80,340,0.5546218487394958,80,82,78,95,80,85,500,0.6869565217391305,2.0
68,75,53,83,113,60,452,0.45384615384615384,65,130,60,75,60,75,465,0.689922480620155,1.0
50,92,108,92,108,35,485,0.2457627118644068,43,80,65,50,35,35,308,0.14193548387096774,1.0
50,70,160,70,160,90,600,0.7417218543046358,45,55,45,65,45,75,330,0.5692307692307692,1.0
44,75,35,63,33,45,295,0.2647058823529412,123,100,62,97,81,68,531,0.4806201550387597,1.0
35,55,40,45,40,60,275,0.35714285714285715,70,110,80,55,80,105,500,0.8794326241134752,2.0
67,57,55,77,55,114,425,0.8879310344827587,38,41,40,50,65,65,299,0.4108527131782946,1.0
50,53,48,53,48,64,316,0.4076923076923077,100,100,100,100,100,100,600,0.8805970149253731,2.0
100,100,125,110,50,50,535,0.384,70,120,100,145,105,20,560,0.2824427480916031,1.0
75,80,60,65,90,102,472,0.8625954198473282,71,82,64,64,59,112,452,0.9327731092436975,1.0
65,110,130,60,65,95,525,0.8278145695364238,50,65,85,35,35,55,325,0.32575757575757575,1.0
70,120,100,145,105,20,560,0.2824427480916031,150,160,100,95,65,100,670,0.8866666666666667,1.0
100,150,110,95,110,70,635,0.5923076923076923,50,30,55,65,55,20,275,0.13675213675213677,4.0
67,125,40,30,30,58,350,0.3431372549019608,100,120,120,150,100,90,680,0.7880794701986755,0.5
60,85,42,85,42,91,405,0.8227848101265823,95,109,105,75,85,56,525,0.34513274336283184,2.0
60,40,50,75,85,95,405,0.6044776119402985,55,130,115,50,50,75,475,0.5982142857142857,2.0
100,103,75,120,75,127,600,0.940677966101695,41,50,37,50,37,66,281,0.5175438596491229,1.0
90,92,87,75,85,76,505,0.5409836065573771,83,106,65,86,65,85,490,0.6640625,1.0
100,100,100,100,100,100,600,0.8345864661654135,115,115,85,90,75,100,580,0.8134328358208955,0.5
123,100,62,97,81,68,531,0.4806201550387597,52,65,55,58,62,60,352,0.4482758620689655,0.5
35,35,40,35,55,50,250,0.40336134453781514,45,30,50,65,50,45,285,0.13821138211382114,1.0
65,150,60,115,60,115,565,0.935251798561151,65,90,115,45,115,58,488,0.5041322314049587,0.25
66,41,77,61,87,23,355,0.12096774193548387,40,70,130,60,130,25,455,0.17355371900826447,1.0
75,95,122,58,75,69,494,0.5725806451612904,45,25,50,25,25,35,205,0.13076923076923078,0.25
60,50,50,60,70,50,340,0.28346456692913385,75,100,95,40,70,110,490,0.8717948717948718,1.0
62,50,58,73,54,72,369,0.4435483870967742,75,80,95,90,100,50,490,0.2158273381294964,2.0
35,55,35,30,30,35,220,0.23684210526315788,43,70,48,50,60,38,309,0.2391304347826087,2.0
99,68,83,72,87,51,460,0.417910447761194,75,75,130,75,130,95,580,0.7479674796747967,1.0
60,85,60,50,50,125,430,0.9090909090909091,75,123,67,95,85,95,540,0.7642276422764228,0.5
50,70,50,50,50,40,310,0.16296296296296298,165,75,80,40,45,65,470,0.5151515151515151,0.5
50,95,90,95,90,180,600,0.9172413793103448,35,80,50,50,70,120,405,0.84375,2.0
40,35,30,120,70,105,400,0.6692307692307692,72,85,70,65,70,58,420,0.41304347826086957,0.0
60,80,50,40,40,30,300,0.15328467153284672,67,58,57,81,67,101,431,0.8790322580645161,1.0
65,47,55,73,75,85,400,0.65,78,81,71,74,69,126,499,0.9090909090909091,0.25
55,130,115,50,50,75,475,0.5982142857142857,76,25,45,67,55,24,292,0.0390625,1.0
115,140,130,55,55,40,535,0.4519230769230769,45,35,45,62,53,35,275,0.11851851851851852,0.5
51,65,65,80,75,59,395,0.4365079365079365,65,73,55,47,75,85,400,0.6846846846846847,1.0
95,80,105,40,70,100,490,0.8046875,69,55,45,55,55,15,294,0.11666666666666667,1.0
45,55,39,35,39,42,255,0.18518518518518517,50,53,48,53,48,64,316,0.46153846153846156,1.0
78,92,75,74,63,118,500,0.8842975206611571,120,120,120,120,120,120,720,0.9344262295081968,2.0
60,82,45,45,45,74,351,0.5752212389380531,55,85,55,50,55,60,360,0.4233576642335766,1.0
85,135,130,60,80,25,515,0.40540540540540543,50,65,64,44,48,43,314,0.2196969696969697,1.0
65,65,65,50,50,90,385,0.72,63,63,47,41,41,74,329,0.56,1.0
75,105,75,105,75,45,480,0.3274336283185841,60,52,168,47,138,30,495,0.19834710743801653,2.0
45,65,34,40,34,45,263,0.2589928057553957,85,135,130,60,80,25,515,0.40540540540540543,1.0
110,135,60,50,65,88,508,0.7744360902255639,40,30,30,55,30,85,270,0.4666666666666667,0.0
78,130,111,130,85,100,634,0.8561151079136691,85,76,64,45,55,90,415,0.6739130434782609,1.0
75,90,140,60,60,40,465,0.3008130081300813,60,110,70,60,60,100,460,0.8461538461538461,0.5
55,85,122,58,75,99,494,0.8099173553719008,50,50,120,80,80,30,410,0.07258064516129033,1.0
30,45,55,70,55,85,340,0.5633802816901409,67,82,62,46,48,43,348,0.22033898305084745,1.0
50,65,107,105,107,86,520,0.7313432835820896,67,125,40,30,30,58,350,0.3431372549019608,2.0
50,65,107,105,107,86,520,0.6991150442477876,30,45,55,70,55,85,340,0.5633802816901409,1.0
45,75,37,70,55,83,365,0.6183206106870229,95,75,80,100,110,30,490,0.24242424242424243,0.5
65,90,122,58,75,84,494,0.71875,80,135,130,95,90,70,600,0.5181818181818182,1.0
85,110,90,45,90,80,500,0.6206896551724138,59,74,50,35,50,35,303,0.3125,0.0
56,61,65,48,45,38,313,0.17567567567567569,55,55,55,85,55,30,335,0.1320754716981132,1.0
60,60,60,35,35,30,280,0.11194029850746269,50,55,50,36,30,43,264,0.2922077922077922,1.0
64,78,52,78,52,81,405,0.6422764227642277,80,105,105,105,105,80,580,0.5939849624060151,0.5
54,45,47,75,98,52,371,0.39669421487603307,30,40,70,70,25,60,295,0.41353383458646614,1.0
55,50,40,40,40,75,300,0.5945945945945946,55,35,50,55,110,85,390,0.6277372262773723,1.0
111,83,68,92,82,39,475,0.1774193548387097,65,95,57,100,85,93,495,0.7441860465116279,4.0
66,41,77,61,87,23,355,0.12096774193548387,86,76,86,116,56,95,515,0.7982456140350878,1.0
60,45,70,75,85,55,390,0.3008130081300813,65,75,70,95,70,95,470,0.7272727272727273,0.5
75,95,95,95,95,85,540,0.6470588235294118,65,150,40,15,80,145,495,0.9663865546218487,1.0
100,120,100,150,120,90,680,0.728,100,150,120,120,100,90,680,0.6493506493506493,1.0
55,112,45,74,45,70,401,0.559322033898305,55,104,105,94,75,52,485,0.36363636363636365,1.0
35,45,160,30,45,70,385,0.48148148148148145,50,75,70,35,70,48,348,0.29357798165137616,0.5
85,50,95,120,115,80,545,0.5793650793650794,60,55,50,40,55,45,305,0.22377622377622378,1.0
85,115,80,105,80,50,515,0.3063063063063063,80,135,85,70,95,150,615,0.9844961240310077,2.0
50,40,85,40,65,25,305,0.08870967741935484,101,72,72,99,89,29,462,0.1937984496124031,0.5
60,85,60,85,60,55,405,0.3673469387755102,43,80,65,50,35,35,308,0.14193548387096774,0.5
105,180,100,180,100,115,780,0.9477611940298507,85,120,70,50,60,100,485,0.8308823529411765,1.0
67,89,116,79,116,33,500,0.2624113475177305,77,120,90,60,90,48,485,0.2785714285714286,1.0
65,47,55,73,75,85,400,0.65,30,80,90,55,45,55,355,0.4295774647887324,1.0
65,80,80,59,63,58,405,0.4411764705882353,65,100,70,80,80,105,500,0.8666666666666667,2.0
85,120,70,50,60,100,485,0.8308823529411765,90,110,80,100,80,95,555,0.7982456140350878,1.0
52,65,50,45,50,38,300,0.27419354838709675,80,110,60,150,130,70,600,0.5042016806722689,4.0
43,30,55,40,65,97,330,0.6030534351145038,130,65,60,110,95,65,525,0.5227272727272727,0.5
60,80,95,70,85,50,440,0.2231404958677686,95,124,78,69,71,58,495,0.37398373983739835,1.0
38,41,40,50,65,65,299,0.4108527131782946,43,30,55,40,65,97,330,0.6030534351145038,0.5
91,90,129,90,72,108,580,0.9140625,110,65,105,55,95,80,510,0.6258503401360545,1.0
80,100,123,122,120,80,625,0.56,110,85,95,80,95,50,515,0.2713178294573643,1.0
50,65,90,35,35,15,290,0.14678899082568808,65,90,40,45,80,75,395,0.625,0.5
165,75,80,40,45,65,470,0.5151515151515151,65,65,60,110,95,130,525,0.9253731343283582,1.0
45,67,60,35,50,63,320,0.5128205128205128,75,85,200,55,65,30,510,0.16778523489932887,2.0
65,50,70,95,80,65,425,0.4262295081967213,65,40,70,80,140,70,465,0.5954198473282443,1.0
100,90,130,45,65,55,485,0.4253731343283582,65,75,70,95,70,95,470,0.7272727272727273,2.0
75,125,100,70,80,45,495,0.33035714285714285,66,117,70,40,50,67,410,0.4573643410852713,1.0
30,56,35,25,35,72,253,0.48148148148148145,75,90,90,140,90,115,600,0.9481481481481482,1.0
55,104,105,94,75,52,485,0.36363636363636365,60,60,60,85,85,85,435,0.631578947368421,1.0
70,60,70,87,78,85,450,0.6228070175438597,80,115,80,65,55,93,488,0.7846153846153846,0.5
60,62,80,63,80,60,405,0.4336283185840708,43,80,65,50,35,35,308,0.14193548387096774,2.0
86,81,97,81,107,43,495,0.203125,73,95,62,85,65,85,465,0.6666666666666666,1.0
50,65,64,44,48,43,314,0.2196969696969697,50,55,50,36,30,43,264,0.2922077922077922,1.0
95,110,80,70,80,50,485,0.37209302325581395,110,65,105,55,95,80,510,0.6258503401360545,2.0
83,80,75,70,70,101,479,0.8615384615384616,35,55,40,50,50,90,320,0.6838235294117647,0.5
40,45,35,40,40,90,290,0.65,35,65,35,65,35,65,300,0.46621621621621623,1.0
110,135,60,50,65,88,508,0.7744360902255639,55,50,65,175,95,150,590,0.7818181818181819,1.0
115,115,85,90,75,100,580,0.8134328358208955,61,78,95,56,58,57,405,0.40336134453781514,2.0
70,55,75,45,65,60,370,0.45901639344262296,91,90,129,90,72,108,580,0.9140625,0.5
66,117,70,40,50,67,410,0.4573643410852713,77,120,90,60,90,48,485,0.2785714285714286,2.0
80,100,200,50,100,50,580,0.3472222222222222,91,134,95,100,100,80,600,0.6304347826086957,2.0
110,135,60,50,65,88,508,0.7744360902255639,60,110,70,60,60,100,460,0.8461538461538461,0.0
110,78,73,76,71,60,468,0.3333333333333333,100,75,115,90,115,85,580,0.6446280991735537,0.5
91,90,106,130,106,77,600,0.648854961832061,80,100,80,80,80,100,520,0.9051724137931034,0.5
50,60,45,100,80,65,400,0.45689655172413796,43,70,48,50,60,38,309,0.2391304347826087,0.5
55,84,105,114,75,52,485,0.2890625,60,50,70,50,90,65,385,0.39568345323741005,1.0
70,85,65,105,85,120,530,0.9262295081967213,80,82,100,83,100,80,525,0.6821705426356589,0.5
30,80,90,55,45,55,355,0.4295774647887324,190,33,58,33,58,33,405,0.13432835820895522,1.0
91,72,90,129,90,108,580,0.8925619834710744,109,66,84,81,99,32,471,0.2013888888888889,2.0
45,55,39,35,39,42,255,0.18518518518518517,70,100,70,105,75,40,460,0.23214285714285715,1.0
125,58,58,76,76,67,460,0.515625,45,35,50,70,50,30,280,0.15753424657534246,0.25
70,65,65,55,55,70,380,0.5,100,100,90,150,140,90,670,0.71875,1.0
55,50,65,175,95,150,590,0.7818181818181819,95,100,85,108,70,70,528,0.5652173913043478,1.0
100,100,100,100,100,100,600,0.8345864661654135,77,59,50,67,63,46,362,0.23140495867768596,2.0
68,72,78,38,42,32,330,0.23809523809523808,50,80,95,10,45,10,290,0.232,2.0
40,40,35,50,100,70,335,0.5031847133757962,70,60,75,110,75,90,480,0.7165354330708661,1.0
71,95,85,110,95,79,535,0.664,50,60,60,60,60,30,320,0.11290322580645161,0.5
100,100,100,100,100,100,600,0.8805970149253731,40,65,95,60,45,35,340,0.13986013986013987,1.0
75,70,90,70,105,80,490,0.656,45,20,50,60,120,50,345,0.24074074074074073,1.0
42,52,67,39,56,50,306,0.2868217054263566,90,85,100,95,125,85,580,0.6834532374100719,4.0
95,75,80,100,110,30,490,0.24242424242424243,71,120,95,120,95,99,600,0.8203125,0.5
60,70,50,100,50,65,395,0.5217391304347826,85,135,130,60,80,25,515,0.40540540540540543,0.5
40,50,90,30,55,65,330,0.44680851063829785,50,35,55,25,25,15,205,0.021739130434782608,1.0
50,50,150,50,150,50,500,0.2571428571428571,65,50,35,115,95,95,455,0.7333333333333333,2.0
45,50,55,75,65,30,320,0.06293706293706294,45,30,50,55,65,45,290,0.208,1.0
60,85,49,60,49,60,363,0.4444444444444444,46,87,60,30,40,57,320,0.37777777777777777,0.5
70,60,62,80,82,60,414,0.4375,80,80,50,40,50,25,325,0.176056338028169,0.5
50,70,100,40,40,30,330,0.2222222222222222,30,35,30,100,35,80,310,0.4765625,1.0
40,29,45,29,45,36,224,0.14634146341463414,126,131,95,131,98,99,680,0.8102189781021898,1.0
75,80,55,25,35,35,305,0.18666666666666668,85,100,122,58,75,54,494,0.3939393939393939,0.0
80,100,70,60,70,95,475,0.7416666666666667,80,105,105,105,105,80,580,0.5939849624060151,1.0
46,57,40,40,40,50,273,0.25,70,60,70,87,78,85,450,0.6228070175438597,2.0
45,100,135,65,135,45,525,0.29411764705882354,65,50,35,115,95,95,455,0.7333333333333333,2.0
60,52,168,47,138,30,495,0.19834710743801653,60,70,65,125,105,90,515,0.6911764705882353,1.0
85,110,76,65,82,56,474,0.3933333333333333,64,51,23,51,23,28,240,0.11363636363636363,0.0
72,95,67,103,71,122,530,0.9606299212598425,40,30,30,55,30,85,270,0.4666666666666667,0.5
65,105,60,60,70,95,455,63.0,80,160,60,170,130,80,680,0.6180555555555556,1.0
30,40,55,40,55,60,280,0.3237410071942446,76,147,90,60,70,97,540,0.8267716535433071,1.0
109,66,84,81,99,32,471,0.2013888888888889,60,59,85,79,105,36,424,0.16666666666666666,0.125
49,49,56,49,61,66,330,0.5190839694656488,60,70,65,125,105,90,515,0.6911764705882353,0.5
85,105,55,85,50,115,495,0.9032258064516129,75,100,66,60,66,115,482,0.918918918918919,1.0
95,85,85,65,65,35,430,0.2571428571428571,60,80,50,50,50,40,330,0.23853211009174313,1.0
75,80,60,65,90,102,472,0.8625954198473282,50,92,108,92,108,35,485,0.2457627118644068,0.0
30,40,70,70,25,60,295,0.41353383458646614,80,110,60,150,130,70,600,0.5042016806722689,1.0
45,67,60,35,50,63,320,0.5128205128205128,38,35,40,27,25,35,200,0.08208955223880597,1.0
79,103,120,135,115,78,630,0.5763888888888888,55,69,85,32,35,28,304,0.09302325581395349,1.0
70,140,70,110,65,105,560,0.95,50,65,107,105,107,86,520,0.6991150442477876,2.0
70,120,40,95,40,95,460,0.8106060606060606,95,135,80,110,80,100,600,0.8248175182481752,0.5
85,76,64,45,55,90,415,0.6739130434782609,115,45,20,45,25,20,270,0.11538461538461539,1.0
75,105,75,105,75,45,480,0.3274336283185841,78,81,71,74,69,126,499,0.9090909090909091,2.0
115,115,85,90,75,100,580,0.8134328358208955,95,65,110,60,130,65,525,0.5275590551181102,1.0
39,52,43,60,50,65,309,0.49107142857142855,65,65,60,110,95,130,525,0.9253731343283582,1.0
40,35,30,120,70,105,400,0.6692307692307692,55,95,115,45,45,35,390,0.2116788321167883,2.0
65,80,80,59,63,58,405,0.4411764705882353,85,105,85,40,50,40,405,0.211864406779661,1.0
90,95,95,70,90,70,510,0.5230769230769231,45,85,50,55,50,65,350,0.5076923076923077,1.0
100,150,140,100,90,90,670,0.7969924812030075,65,45,55,45,70,45,325,0.24369747899159663,1.0
40,45,35,30,40,55,245,0.3793103448275862,108,130,95,80,85,102,600,0.7637795275590551,0.5
75,87,63,87,63,98,473,0.865546218487395,79,103,120,135,115,78,630,0.5763888888888888,0.5
65,110,130,60,65,95,525,0.8278145695364238,75,98,63,98,63,101,498,0.889763779527559,0.5
60,70,50,100,50,65,395,0.5217391304347826,55,63,90,50,80,42,380,0.21138211382113822,8.0
75,125,70,125,70,115,580,0.9037037037037037,38,30,41,30,41,60,240,0.2897196261682243,1.0
65,75,70,95,70,95,470,0.7272727272727273,65,90,65,61,61,100,442,0.8373983739837398,1.0
72,60,30,20,30,25,237,0.11570247933884298,63,120,85,90,55,55,468,0.2809917355371901,2.0
70,62,67,55,55,56,365,0.38513513513513514,100,100,125,110,50,50,535,0.384,2.0
70,70,115,130,90,60,535,0.5338983050847458,45,40,60,40,75,50,310,0.2926829268292683,2.0
70,90,110,60,75,95,500,0.7333333333333333,125,58,58,76,76,67,460,0.515625,1.0
55,70,40,60,40,40,305,0.26956521739130435,74,48,76,83,81,104,466,0.7913043478260869,1.0
100,5,5,15,65,30,220,0.07692307692307693,20,40,15,35,35,60,205,0.34285714285714286,1.0
78,84,78,109,85,100,534,0.8620689655172413,45,55,39,35,39,42,255,0.18518518518518517,1.0
75,125,70,125,70,115,580,0.9037037037037037,90,70,80,70,95,70,475,0.5190839694656488,1.0
60,70,50,100,50,65,395,0.5217391304347826,100,110,90,85,90,60,535,0.47794117647058826,1.0
75,75,75,125,95,40,485,0.15671641791044777,72,105,115,54,86,68,500,0.5149253731343284,1.0
90,65,65,40,40,15,315,0.19672131147540983,40,50,90,30,55,65,330,0.44680851063829785,2.0
76,65,45,92,42,91,411,0.7449664429530202,99,68,83,72,87,51,460,0.417910447761194,2.0
55,55,45,63,45,45,308,0.25,70,90,90,135,90,125,600,0.9401709401709402,1.0
92,105,90,125,90,98,600,0.8217054263565892,70,90,90,135,90,125,600,0.9401709401709402,0.5
100,100,100,100,100,100,600,0.831858407079646,55,45,45,25,25,15,210,0.048,2.0
40,55,80,35,60,30,300,0.15037593984962405,50,65,90,35,35,15,290,0.14678899082568808,1.0
59,110,150,45,49,35,448,0.3333333333333333,38,30,85,55,65,30,303,0.21428571428571427,2.0
80,110,120,130,90,70,600,0.6198347107438017,116,55,85,107,95,29,487,0.06818181818181818,1.0
73,95,62,85,65,85,465,0.6666666666666666,40,30,30,55,30,85,270,0.4666666666666667,1.0
80,120,70,110,70,80,530,0.6422764227642277,73,115,60,60,60,90,458,0.6694915254237288,2.0
46,57,40,40,40,50,273,0.25,100,77,77,128,128,90,600,0.6901408450704225,1.0
72,58,80,103,80,97,490,0.7171052631578947,44,38,39,61,79,42,303,0.2251655629139073,1.0
75,75,55,105,85,30,425,0.1619718309859155,65,65,60,130,95,110,525,0.823943661971831,1.0
55,50,40,40,40,75,300,0.5945945945945946,90,120,120,60,60,50,500,0.35294117647058826,1.0
60,50,70,50,90,65,385,0.39568345323741005,85,70,80,97,80,123,535,0.9304347826086956,0.5
85,76,64,45,55,90,415,0.6739130434782609,50,95,90,95,90,180,600,0.9172413793103448,1.0
90,65,65,40,40,15,315,0.19672131147540983,108,130,95,80,85,102,600,0.7637795275590551,2.0
58,64,58,80,65,80,405,0.609271523178808,90,95,105,165,110,45,610,0.2890625,0.5
60,25,35,70,80,60,330,0.3076923076923077,74,48,76,83,81,104,466,0.7913043478260869,0.5
40,29,45,29,45,36,224,0.14634146341463414,50,85,55,65,65,90,410,0.7478260869565218,0.5
60,80,50,50,50,40,330,0.23853211009174313,50,40,85,40,65,25,305,0.08870967741935484,1.0
100,100,100,100,100,100,600,0.8758169934640523,75,80,70,65,75,90,455,0.7578125,2.0
78,84,78,109,85,100,534,0.8620689655172413,45,60,30,80,50,65,330,0.4603174603174603,0.5
38,35,35,65,55,50,278,0.2647058823529412,83,106,65,86,65,85,490,0.6640625,2.0
90,65,65,40,40,15,315,0.19672131147540983,40,70,40,35,40,60,285,0.392,1.0
116,55,85,107,95,29,487,0.06818181818181818,65,90,50,85,45,55,390,0.371900826446281,2.0
80,80,80,80,80,80,480,0.6015037593984962,82,80,86,85,75,72,480,0.6183206106870229,1.0
55,75,85,25,25,15,280,0.1875,45,30,35,20,20,45,195,0.14782608695652175,2.0
59,74,50,35,50,35,303,0.3125,40,40,40,70,40,20,250,0.032520325203252036,2.0
55,84,105,114,75,52,485,0.2890625,38,35,40,27,25,35,200,0.08208955223880597,1.0
60,40,80,60,45,40,325,0.23529411764705882,114,85,70,85,80,30,464,0.2066115702479339,0.5
85,110,90,45,90,80,500,0.6206896551724138,75,75,60,83,60,60,413,0.39344262295081966,1.0
62,73,55,56,52,84,382,0.7244094488188977,60,85,69,65,79,80,438,0.576,1.0
65,76,84,54,96,105,480,0.9008264462809917,80,82,83,100,100,80,525,0.6742424242424242,1.0
45,100,45,45,45,10,290,0.2949640287769784,135,85,40,40,85,5,390,0.6864406779661016,1.0
65,150,40,15,80,145,495,0.9663865546218487,68,75,53,83,113,60,452,0.45384615384615384,1.0
45,30,50,55,65,45,290,0.208,80,100,123,122,120,80,625,0.56,2.0
51,65,65,80,75,59,395,0.4365079365079365,170,90,45,90,45,60,500,0.427536231884058,0.5
90,130,80,65,85,55,505,0.4396551724137931,49,55,42,42,37,85,310,0.6068376068376068,2.0
65,80,140,40,70,70,465,0.5223880597014925,74,48,76,83,81,104,466,0.7322834645669292,1.0
75,125,230,55,95,30,610,0.3448275862068966,80,120,79,95,79,70,523,0.5833333333333334,1.0
60,90,55,90,80,110,485,0.8677685950413223,65,90,50,85,45,55,390,0.371900826446281,0.5
106,150,70,194,120,140,780,0.952,75,125,100,70,80,45,495,0.33035714285714285,1.0
58,109,112,48,48,109,484,0.8805970149253731,50,55,50,36,30,43,264,0.2922077922077922,0.5
78,81,71,74,69,126,499,0.9090909090909091,52,65,50,45,50,38,300,0.27419354838709675,0.5
75,100,110,45,55,65,450,0.5333333333333333,85,115,80,105,80,50,515,0.3063063063063063,2.0
80,110,60,150,130,70,600,0.5042016806722689,75,65,55,65,55,69,384,0.43548387096774194,2.0
105,95,75,85,75,74,509,0.5714285714285714,89,125,90,115,80,101,600,0.8725490196078431,0.0
65,90,122,58,75,84,494,0.71875,35,55,35,30,30,35,220,0.23684210526315788,0.5
30,30,30,30,30,30,180,0.12612612612612611,68,90,65,50,55,82,410,0.6165413533834586,1.0
100,150,90,180,160,90,770,0.7348484848484849,95,125,79,60,100,81,540,0.6165413533834586,0.5
49,66,70,44,55,51,335,0.4260869565217391,70,55,95,95,110,65,490,0.48872180451127817,2.0
50,85,125,85,115,20,480,0.4306569343065693,115,45,20,45,25,20,270,0.11538461538461539,0.0
68,85,65,165,135,100,618,0.8083333333333333,80,70,40,100,60,145,495,0.921875,1.0
105,125,100,60,100,100,590,0.8359375,70,90,45,15,45,50,315,0.3629032258064516,1.0
30,40,55,40,55,60,280,0.3237410071942446,55,70,55,40,55,85,360,0.7073170731707317,2.0
65,65,60,110,95,130,525,0.9253731343283582,70,85,70,60,70,50,405,0.28378378378378377,0.0
50,80,95,10,45,10,290,0.232,80,90,80,130,110,110,600,0.856,1.0
55,63,90,50,80,42,380,0.21138211382113822,20,40,90,30,90,25,295,0.11363636363636363,0.5
50,80,95,10,45,10,290,0.232,75,90,50,110,80,95,500,0.7985611510791367,2.0
123,100,62,97,81,68,531,0.4806201550387597,190,33,58,33,58,33,405,0.13432835820895522,1.0
90,130,80,65,85,55,505,0.4396551724137931,70,60,125,115,70,55,495,0.35507246376811596,2.0
55,20,35,20,45,75,250,0.37681159420289856,50,70,160,70,160,90,600,0.7417218543046358,1.0
130,70,35,70,35,60,400,0.4017857142857143,95,117,184,44,46,28,514,0.2975206611570248,1.0
108,112,118,68,72,47,525,0.2916666666666667,73,115,60,60,60,90,458,0.6694915254237288,1.0
78,130,111,130,85,100,634,0.8561151079136691,76,48,48,57,62,34,325,0.11688311688311688,0.5
100,150,120,120,100,90,680,0.6493506493506493,80,75,150,75,150,50,580,0.30973451327433627,0.5
50,50,95,40,50,35,320,0.20279720279720279,90,30,15,40,20,15,210,0.043478260869565216,1.0
85,120,70,50,60,100,485,0.8308823529411765,40,30,50,55,55,100,330,0.584070796460177,0.5
65,60,110,130,95,65,525,0.47761194029850745,50,65,45,85,65,95,405,0.7238095238095238,2.0
40,40,50,30,30,30,220,0.0873015873015873,38,41,40,50,65,65,299,0.4108527131782946,0.5
75,125,75,30,75,85,465,0.625,123,77,72,99,92,58,521,0.4621212121212121,4.0
89,124,80,55,80,55,483,0.5714285714285714,190,33,58,33,58,33,405,0.13432835820895522,2.0
65,60,70,85,75,40,395,0.1796875,60,40,60,95,60,55,370,0.4222222222222222,0.0
80,105,105,105,105,80,580,0.5939849624060151,50,180,20,180,20,150,600,0.9029850746268657,0.5
70,85,65,105,85,120,530,0.9262295081967213,78,65,68,112,154,75,552,0.628099173553719,1.0
63,60,55,50,50,71,349,0.5289256198347108,255,10,10,75,135,55,540,0.3125,1.0
55,45,50,45,65,80,340,0.5546218487394958,190,33,58,33,58,33,405,0.13432835820895522,1.0
70,75,80,135,80,135,575,0.917910447761194,45,95,50,40,50,75,355,0.54,1.0
65,136,94,54,96,135,580,0.9612403100775194,130,70,35,70,35,60,400,0.4017857142857143,1.0
55,50,40,40,40,75,300,0.5945945945945946,50,50,120,80,80,30,410,0.07258064516129033,0.5
40,45,35,30,40,55,245,0.3793103448275862,75,100,63,80,63,116,497,0.9345794392523364,0.5
76,147,90,60,70,97,540,0.8267716535433071,105,140,95,55,65,45,505,0.3,1.0
100,164,150,95,120,71,700,0.5645161290322581,1,90,45,30,30,40,236,0.33064516129032256,4.0
43,30,55,40,65,97,330,0.6030534351145038,67,82,62,46,48,43,348,0.22033898305084745,1.0
71,120,95,120,95,99,600,0.8203125,55,85,55,50,55,60,360,0.4233576642335766,0.25
40,55,80,35,60,30,300,0.15037593984962405,250,5,5,35,105,50,450,0.15306122448979592,1.0
65,136,94,54,96,135,580,0.9612403100775194,49,66,70,44,55,51,335,0.4260869565217391,0.0
75,38,38,56,56,67,330,0.5263157894736842,80,145,150,105,110,110,700,0.8692307692307693,1.0
40,50,90,30,55,65,330,0.44680851063829785,80,100,200,50,100,50,580,0.3472222222222222,0.5
40,55,70,45,60,30,300,0.10619469026548672,105,95,80,40,80,90,490,0.753968253968254,1.0
40,45,35,65,55,70,310,0.4482758620689655,60,60,60,35,35,30,280,0.11194029850746269,1.0
67,58,57,81,67,101,431,0.8790322580645161,70,62,67,55,55,56,365,0.38513513513513514,0.5
35,70,55,45,55,25,285,0.09420289855072464,45,40,60,40,75,50,310,0.2926829268292683,0.25
45,49,65,49,65,45,318,0.275,70,65,65,55,55,70,380,0.5,1.0
50,75,45,40,45,60,315,0.4380165289256198,67,125,40,30,30,58,350,0.3431372549019608,1.0
60,40,50,75,85,95,405,0.6044776119402985,20,25,45,70,90,60,310,0.30833333333333335,1.0
60,60,60,85,85,85,435,0.631578947368421,50,70,160,70,160,90,600,0.7417218543046358,2.0
48,72,48,72,48,48,336,0.25984251968503935,70,140,70,110,65,105,560,0.95,0.0
65,45,55,45,70,45,325,0.24369747899159663,45,30,50,55,65,45,290,0.208,1.0
60,40,50,75,85,95,405,0.6044776119402985,90,132,105,132,105,30,594,0.4246575342465753,0.5
60,90,70,60,120,40,440,0.27419354838709675,65,83,57,95,85,105,490,0.8914728682170543,1.0
50,95,90,95,90,180,600,0.9172413793103448,75,89,85,55,65,36,405,0.29545454545454547,1.0
60,80,110,50,80,45,425,0.2833333333333333,70,105,105,50,40,20,390,0.33587786259541985,2.0
100,70,70,65,65,45,415,0.1897810218978102,85,97,66,105,66,65,484,0.47107438016528924,1.0
70,80,70,80,70,110,480,0.6594202898550725,63,60,55,50,50,71,349,0.5289256198347108,0.0
50,60,45,100,80,65,400,0.45689655172413796,65,80,140,40,70,70,465,0.5223880597014925,0.0
100,164,150,95,120,71,700,0.5645161290322581,59,63,80,65,80,58,405,0.41843971631205673,1.0
55,130,115,50,50,75,475,0.5982142857142857,79,115,70,125,80,111,580,0.864,1.0
99,68,83,72,87,51,460,0.417910447761194,91,134,95,100,100,80,600,0.6304347826086957,0.25
42,52,67,39,56,50,306,0.2868217054263566,28,25,25,45,35,40,198,0.16083916083916083,1.0
76,147,90,60,70,97,540,0.8267716535433071,90,92,87,75,85,76,505,0.5409836065573771,1.0
100,150,90,180,160,90,770,0.7348484848484849,120,70,120,75,130,85,600,0.6694915254237288,1.0
75,70,90,70,105,80,490,0.656,100,150,120,120,100,90,680,0.6493506493506493,1.0
75,90,90,140,90,115,600,0.9481481481481482,55,68,64,45,55,31,318,0.11666666666666667,2.0
76,48,48,57,62,34,325,0.11688311688311688,1,90,45,30,30,40,236,0.33064516129032256,1.0
86,81,97,81,107,43,495,0.203125,75,80,55,25,35,35,305,0.18666666666666668,0.5
85,80,90,105,95,60,515,0.49074074074074076,80,50,100,100,200,50,580,0.2357142857142857,1.0
100,110,90,85,90,60,535,0.47794117647058826,50,25,28,45,55,15,218,0.0625,1.0
41,50,37,50,37,66,281,0.5175438596491229,105,30,105,140,105,55,540,0.3524590163934426,2.0
65,80,80,59,63,58,405,0.4411764705882353,45,30,50,65,50,45,285,0.13821138211382114,1.0
65,90,40,45,80,75,395,0.625,30,105,90,25,25,50,325,0.2773722627737226,1.0
40,55,30,30,30,60,245,0.43548387096774194,78,81,71,74,69,126,499,0.9090909090909091,1.0
65,76,84,54,96,105,480,0.9008264462809917,43,30,55,40,65,97,330,0.6030534351145038,1.0
126,131,95,131,98,99,680,0.8294573643410853,60,82,45,45,45,74,351,0.5752212389380531,2.0
100,123,75,57,75,80,510,0.6923076923076923,55,65,95,95,45,85,440,0.6610169491525424,1.0
38,36,38,32,36,57,237,0.3893805309734513,90,55,75,60,75,30,385,0.13970588235294118,1.0
54,66,70,44,55,46,335,0.4214876033057851,60,90,140,50,50,40,430,0.2535211267605634,1.0
30,40,70,70,25,60,295,0.41353383458646614,60,85,69,60,69,77,420,0.518796992481203,1.0
40,45,40,62,60,60,307,0.33884297520661155,55,20,35,20,45,75,250,0.37681159420289856,1.0
65,90,40,45,80,75,395,0.625,60,40,60,95,60,55,370,0.4222222222222222,0.125
64,165,75,93,83,75,555,0.6587301587301587,70,90,90,135,90,125,600,0.9401709401709402,0.5
150,120,100,120,100,90,680,0.664179104477612,125,130,90,130,90,95,660,0.7734375,2.0
70,105,105,50,40,20,390,0.33587786259541985,78,130,111,130,85,100,634,0.8561151079136691,2.0
55,45,50,45,65,80,340,0.5546218487394958,60,62,50,62,60,40,334,0.18181818181818182,1.0
190,33,58,33,58,33,405,0.13432835820895522,106,130,90,110,154,90,680,0.719626168224299,1.0
65,40,50,125,60,30,370,0.07258064516129033,50,65,107,105,107,86,520,0.7272727272727273,1.0
60,75,100,55,80,50,420,0.3088235294117647,80,80,80,55,55,90,440,0.6417910447761194,1.0
50,150,50,150,50,150,600,0.9339622641509434,65,65,60,110,95,130,525,0.9253731343283582,1.0
95,135,80,110,80,100,600,0.8248175182481752,40,80,35,35,45,70,305,0.4661016949152542,2.0
70,110,75,145,85,145,630,0.9444444444444444,50,95,180,85,45,70,525,0.5298507462686567,2.0
55,63,90,50,80,42,380,0.21138211382113822,73,76,75,81,100,100,505,0.8110236220472441,0.25
90,60,60,40,40,40,330,0.29545454545454547,60,65,60,130,75,110,500,0.7719298245614035,2.0
55,50,45,135,95,120,500,0.7714285714285715,65,105,60,60,70,95,455,63.0,1.0
45,100,135,65,135,45,525,0.29411764705882354,75,103,80,70,80,92,500,0.7933884297520661,1.0
62,77,62,50,42,65,358,0.4838709677419355,78,84,78,109,85,100,534,0.8646616541353384,1.0
105,95,75,85,75,74,509,0.5714285714285714,1,90,45,30,30,40,236,0.33064516129032256,0.5
36,50,50,65,60,44,305,0.16363636363636364,100,150,120,120,100,90,680,0.6493506493506493,2.0
60,50,50,60,70,50,340,0.28346456692913385,75,100,95,40,70,110,490,0.8717948717948718,1.0
55,35,50,55,110,85,390,0.6277372262773723,40,29,45,29,45,36,224,0.14634146341463414,2.0
90,75,85,115,90,55,510,0.3445378151260504,85,56,77,50,77,78,423,0.53125,0.0
38,36,38,32,36,57,237,0.3893805309734513,70,110,75,145,85,145,630,0.9444444444444444,1.0
60,85,49,60,49,60,363,0.4444444444444444,38,41,40,50,65,65,299,0.4108527131782946,1.0
63,63,47,41,41,74,329,0.56,50,70,100,40,40,30,330,0.2222222222222222,0.0
41,64,45,50,50,50,300,0.36752136752136755,72,95,67,103,71,122,530,0.9606299212598425,1.0
190,33,58,33,58,33,405,0.13432835820895522,80,70,70,90,100,70,480,0.5609756097560976,1.0
83,80,80,135,80,121,579,0.9444444444444444,50,65,107,105,107,86,520,0.6991150442477876,0.5
45,49,65,49,65,45,318,0.275,58,64,58,80,65,80,405,0.609271523178808,0.5
75,95,67,125,95,83,540,0.7117117117117117,85,56,77,50,77,78,423,0.53125,1.0
50,95,95,35,110,70,455,0.5179856115107914,30,35,30,100,35,80,310,0.4765625,0.0
70,92,65,80,55,98,460,0.8090909090909091,65,130,60,95,110,65,525,0.5303030303030303,2.0
100,77,77,128,128,90,600,0.6901408450704225,50,92,108,92,108,35,485,0.2457627118644068,0.0
100,100,100,100,100,100,600,0.8805970149253731,65,110,130,60,65,95,525,0.8278145695364238,0.5
75,80,85,110,90,50,490,0.3548387096774194,100,120,100,150,120,90,680,0.728,0.25
50,70,50,50,50,40,310,0.16296296296296298,65,60,110,130,95,65,525,0.47761194029850745,1.0
38,30,85,55,65,30,303,0.21428571428571427,85,110,76,65,82,56,474,0.3933333333333333,2.0
40,45,40,65,40,65,295,0.5661764705882353,190,33,58,33,58,33,405,0.13432835820895522,1.0
45,100,45,45,45,10,290,0.2949640287769784,62,73,55,56,52,84,382,0.7244094488188977,0.0
126,131,95,131,98,99,680,0.8294573643410853,40,70,130,60,130,25,455,0.17355371900826447,1.0
100,5,5,15,65,30,220,0.07692307692307693,90,95,95,70,90,70,510,0.5230769230769231,1.0
190,33,58,33,58,33,405,0.13432835820895522,30,56,35,25,35,72,253,0.48148148148148145,1.0
106,130,90,110,154,90,680,0.719626168224299,65,100,70,80,80,105,500,0.8666666666666667,0.5
75,38,38,56,56,67,330,0.5263157894736842,65,95,75,55,55,85,430,0.6933333333333334,1.0
62,48,66,59,57,49,341,0.33884297520661155,100,50,80,60,80,50,420,0.34375,1.0
40,30,32,50,52,65,269,0.3671875,60,59,85,79,105,36,424,0.16666666666666666,1.0
60,85,40,30,45,68,328,0.6422018348623854,60,48,45,43,90,42,328,0.21897810218978103,1.0
70,90,90,135,90,125,600,0.9401709401709402,55,65,35,60,30,85,330,0.6126126126126126,1.0
100,50,80,60,80,50,420,0.34375,65,136,94,54,96,135,580,0.9612403100775194,2.0
78,84,78,109,85,100,534,0.8646616541353384,65,63,45,45,45,45,308,0.2595419847328244,0.5
110,65,105,55,95,80,510,0.6258503401360545,100,50,80,60,80,50,420,0.34375,0.5
80,160,60,170,130,80,680,0.6180555555555556,40,30,50,55,55,100,330,0.584070796460177,1.0
108,130,95,80,85,102,600,0.7637795275590551,60,85,69,60,69,77,420,0.518796992481203,1.0
65,50,70,95,80,65,425,0.4262295081967213,45,60,40,70,50,45,310,0.2846715328467153,1.0
95,117,80,65,70,92,519,0.8409090909090909,65,80,65,35,65,60,370,0.38405797101449274,1.0
52,65,50,45,50,38,300,0.27419354838709675,95,117,184,44,46,28,514,0.2975206611570248,1.0
72,95,67,103,71,122,530,0.9606299212598425,55,70,40,60,40,40,305,0.26956521739130435,1.0
80,185,115,40,105,75,600,0.6230769230769231,45,50,35,55,75,40,300,0.21367521367521367,1.0
44,50,91,24,86,10,305,0.1981981981981982,116,55,85,107,95,29,487,0.06818181818181818,1.0
85,105,85,40,50,40,405,0.211864406779661,70,75,60,105,60,105,475,0.88,1.0
50,65,107,105,107,86,520,0.7272727272727273,28,25,25,45,35,40,198,0.16083916083916083,1.0
100,100,100,100,100,100,600,0.8805970149253731,100,100,125,110,50,50,535,0.384,0.5
43,80,65,50,35,35,308,0.14193548387096774,60,40,80,60,45,40,325,0.23529411764705882,0.5
190,33,58,33,58,33,405,0.13432835820895522,80,105,105,105,105,80,580,0.5939849624060151,0.5
44,50,91,24,86,10,305,0.1981981981981982,80,82,100,83,100,80,525,0.6821705426356589,0.5
100,103,75,120,75,127,600,0.940677966101695,106,130,90,110,154,90,680,0.719626168224299,0.25
55,70,45,70,50,60,350,0.45,53,51,53,61,56,40,314,0.14285714285714285,0.5
55,55,45,63,45,45,308,0.25,60,85,40,30,45,68,328,0.6422018348623854,2.0
90,120,100,150,120,100,680,0.7718120805369127,70,110,75,145,85,145,630,0.9444444444444444,0.5
85,97,66,105,66,65,484,0.47107438016528924,80,145,150,105,110,110,700,0.8692307692307693,2.0
50,75,35,70,30,40,300,0.21296296296296297,70,20,50,20,50,40,250,0.1557377049180328,4.0
75,123,67,95,85,95,540,0.7642276422764228,100,123,75,57,75,80,510,0.6923076923076923,2.0
100,120,100,150,120,90,680,0.728,70,140,70,110,65,105,560,0.95,0.5
75,125,70,125,70,115,580,0.9037037037037037,65,70,60,65,65,115,440,0.8583333333333333,1.0
60,65,60,130,75,110,500,0.7719298245614035,90,70,80,70,95,70,475,0.5190839694656488,1.0
150,80,44,90,54,80,498,0.625,85,110,90,45,90,80,500,0.6206896551724138,0.0
43,80,65,50,35,35,308,0.14193548387096774,45,22,60,27,30,29,213,0.07518796992481203,1.0
70,62,67,55,55,56,365,0.38513513513513514,65,75,90,97,123,44,494,0.1987179487179487,0.5
80,100,70,60,70,95,475,0.7416666666666667,50,65,90,35,35,15,290,0.14678899082568808,0.5
90,132,105,132,105,30,594,0.4246575342465753,90,60,70,75,70,45,410,0.23880597014925373,0.5
80,100,70,60,70,95,475,0.7416666666666667,110,78,73,76,71,60,468,0.3333333333333333,4.0
45,22,60,27,30,29,213,0.07518796992481203,60,45,50,90,80,70,395,0.625,0.5
101,72,72,99,89,29,462,0.1937984496124031,74,100,72,90,72,46,454,0.24561403508771928,1.0
65,100,70,80,80,105,500,0.8666666666666667,41,64,45,50,50,50,300,0.36752136752136755,0.5
40,65,40,80,40,65,330,0.5038167938931297,55,85,55,50,55,60,360,0.4233576642335766,1.0
105,105,75,65,100,50,500,0.37593984962406013,78,130,111,130,85,100,634,0.8561151079136691,1.0
30,65,100,45,25,40,305,0.1891891891891892,50,55,50,36,30,43,264,0.2922077922077922,1.0
70,65,65,55,55,70,380,0.5,30,80,90,55,45,55,355,0.4295774647887324,0.5
74,100,72,90,72,46,454,0.24561403508771928,75,95,95,95,95,85,540,0.6470588235294118,1.0
40,55,70,45,60,30,300,0.10619469026548672,78,65,68,112,154,75,552,0.628099173553719,0.5
85,76,64,45,55,90,415,0.6739130434782609,125,58,58,76,76,67,460,0.515625,1.0
60,85,69,65,79,80,438,0.576,91,90,106,130,106,77,600,0.648854961832061,0.0
90,70,80,70,95,70,475,0.5190839694656488,20,15,20,10,55,80,200,0.2682926829268293,0.25
85,110,76,65,82,56,474,0.3933333333333333,95,23,48,23,48,23,260,0.046153846153846156,2.0
255,10,10,75,135,55,540,0.3125,70,110,180,60,60,50,530,0.4117647058823529,0.25
72,105,115,54,86,68,500,0.5149253731343284,80,92,65,65,80,68,450,0.4824561403508772,0.5
50,53,48,53,48,64,316,0.46153846153846156,105,30,105,140,105,55,540,0.3524590163934426,0.5
103,60,86,60,86,50,445,0.3458646616541353,95,110,95,40,95,55,490,0.40336134453781514,1.0
90,50,34,60,44,70,348,0.6283185840707964,60,70,105,70,120,75,500,0.5983606557377049,2.0
60,60,60,60,60,60,360,0.38095238095238093,40,45,40,65,40,65,295,0.5661764705882353,1.0
65,80,65,35,65,60,370,0.38405797101449274,70,40,50,55,50,25,290,0.061068702290076333,1.0
65,47,55,73,75,85,400,0.65,77,59,50,67,63,46,362,0.23140495867768596,1.0
80,100,70,50,60,45,405,0.25806451612903225,45,63,37,65,55,95,360,0.8055555555555556,1.0
70,150,140,65,100,75,600,0.55,80,85,95,30,30,25,345,0.2857142857142857,2.0
90,50,34,60,44,70,348,0.6283185840707964,90,120,120,60,60,50,500,0.35294117647058826,1.0
65,75,70,95,70,95,470,0.7272727272727273,70,70,70,70,70,70,420,0.5289256198347108,1.0
95,95,85,125,65,55,520,0.3894736842105263,69,69,76,69,86,91,460,0.6554621848739496,2.0
130,70,35,70,35,60,400,0.4017857142857143,55,45,50,45,65,80,340,0.5546218487394958,0.5
108,112,118,68,72,47,525,0.2916666666666667,60,65,60,130,75,110,500,0.7719298245614035,2.0
70,20,50,20,50,40,250,0.1557377049180328,40,45,35,40,40,90,290,0.65,1.0
95,145,130,120,90,120,700,0.9398496240601504,60,60,60,85,85,85,435,0.631578947368421,1.0
60,85,49,60,49,60,363,0.4444444444444444,65,105,60,60,70,95,455,63.0,1.0
45,55,39,35,39,42,255,0.18518518518518517,65,80,80,59,63,58,405,0.4411764705882353,1.0
50,64,50,45,50,41,300,0.22727272727272727,70,70,40,60,40,60,340,0.4247787610619469,0.5
70,145,88,140,70,112,625,0.8888888888888888,70,20,50,20,50,40,250,0.1557377049180328,0.125
64,66,68,81,76,50,405,0.25190839694656486,77,59,50,67,63,46,362,0.23140495867768596,2.0
125,58,58,76,76,67,460,0.515625,40,60,40,40,40,30,250,0.0948905109489051,1.0
39,52,43,60,50,65,309,0.5041322314049587,60,60,60,105,105,105,495,0.848,1.0
80,135,130,95,90,70,600,0.5181818181818182,74,48,76,83,81,104,466,0.7322834645669292,0.5
110,130,80,70,60,80,530,0.5862068965517241,53,51,53,61,56,40,314,0.14285714285714285,0.5
45,25,50,25,25,35,205,0.13076923076923078,75,95,95,95,95,85,540,0.6470588235294118,1.0
60,95,80,60,80,30,405,0.19480519480519481,70,110,70,115,70,90,525,0.75,0.125
70,80,70,80,70,110,480,0.6594202898550725,60,82,45,45,45,74,351,0.5752212389380531,1.0
46,87,60,30,40,57,320,0.37777777777777777,55,66,44,44,56,85,350,0.6888888888888889,1.0
80,115,80,65,55,93,488,0.7846153846153846,80,80,80,80,80,80,480,0.5606060606060606,1.0
70,100,70,105,75,40,460,0.23214285714285715,30,42,118,42,88,30,350,0.112,4.0
100,100,100,100,100,100,600,0.8602941176470589,55,95,115,45,45,35,390,0.2116788321167883,4.0
45,55,39,35,39,42,255,0.18518518518518517,62,50,58,73,54,72,369,0.4435483870967742,1.0
70,80,70,80,70,110,480,0.6594202898550725,85,97,66,105,66,65,484,0.47107438016528924,0.5
123,100,62,97,81,68,531,0.4806201550387597,100,77,77,128,128,90,600,0.6901408450704225,1.0
60,62,50,62,60,40,334,0.18181818181818182,65,85,70,75,70,40,405,0.203125,1.0
80,45,65,90,110,80,470,0.5462962962962963,120,120,120,120,120,120,720,0.9344262295081968,1.0
70,120,65,45,85,125,510,0.9747899159663865,90,85,100,95,125,85,580,0.6834532374100719,1.0
90,60,60,40,40,40,330,0.29545454545454547,65,90,120,85,70,60,490,0.43410852713178294,2.0
40,55,99,40,79,47,360,0.26262626262626265,50,50,62,40,62,65,329,0.4188034188034188,0.25
67,82,62,46,48,43,348,0.22033898305084745,70,95,125,65,75,45,475,0.33613445378151263,1.0
43,30,55,40,65,97,330,0.6030534351145038,30,45,135,45,90,30,375,0.09285714285714286,2.0
46,57,40,40,40,50,273,0.25,100,50,80,60,80,50,420,0.34375,2.0
55,95,115,45,45,35,390,0.2116788321167883,65,60,70,85,75,40,395,0.1796875,1.0
78,52,60,63,65,23,341,0.06015037593984962,75,75,130,75,130,95,580,0.7479674796747967,1.0
55,40,50,65,85,40,335,0.3181818181818182,30,80,90,55,45,55,355,0.4295774647887324,1.0
79,103,120,135,115,78,630,0.5763888888888888,72,58,80,103,80,97,490,0.7171052631578947,1.0
30,40,55,40,55,60,280,0.3237410071942446,106,110,90,154,90,130,680,0.926829268292683,0.25
70,90,90,135,90,125,600,0.9401709401709402,70,60,125,115,70,55,495,0.35507246376811596,1.0
50,85,125,85,115,20,480,0.4306569343065693,80,110,60,150,130,70,600,0.5042016806722689,16.0
60,82,45,45,45,74,351,0.5752212389380531,40,55,70,45,60,30,300,0.10619469026548672,2.0
165,75,80,40,45,65,470,0.5151515151515151,35,80,50,50,70,120,405,0.84375,2.0
78,70,61,50,61,100,420,0.8145161290322581,70,92,65,80,55,98,460,0.8090909090909091,1.0
126,131,95,131,98,99,680,0.8102189781021898,57,80,91,80,87,75,470,0.5737704918032787,0.25
70,55,95,95,110,65,490,0.48872180451127817,80,45,65,90,110,80,470,0.5462962962962963,0.5
50,85,125,85,115,20,480,0.4306569343065693,80,100,70,50,60,45,405,0.25806451612903225,0.5
38,36,38,32,36,57,237,0.3893805309734513,60,80,110,50,80,45,425,0.2833333333333333,1.0
41,64,45,50,50,50,300,0.36752136752136755,80,80,80,80,80,80,480,0.5606060606060606,1.0
60,40,60,40,60,35,295,0.18055555555555555,60,60,60,85,85,85,435,0.631578947368421,1.0
80,160,60,170,130,80,680,0.6180555555555556,255,10,10,75,135,55,540,0.3125,1.0
103,60,126,80,126,50,545,0.36363636363636365,45,50,35,55,75,40,300,0.21367521367521367,2.0
45,30,40,105,50,20,290,0.031007751937984496,50,60,45,100,80,65,400,0.45689655172413796,2.0
40,45,35,65,55,70,310,0.4482758620689655,75,75,55,105,85,30,425,0.1619718309859155,0.5
75,95,95,95,95,85,540,0.6470588235294118,111,83,68,92,82,39,475,0.1774193548387097,1.0
65,65,45,75,45,95,390,0.72,25,20,15,105,55,90,310,0.32407407407407407,2.0
100,50,50,76,96,70,442,0.5,45,45,35,20,30,20,195,0.07246376811594203,2.0
1,90,45,30,30,40,236,0.33064516129032256,77,59,50,67,63,46,362,0.23140495867768596,1.0
45,22,60,27,30,29,213,0.07518796992481203,65,90,40,45,80,75,395,0.625,0.5
75,110,110,110,105,80,590,0.656934306569343,80,110,120,130,90,70,600,0.6198347107438017,0.5
92,105,90,125,90,98,600,0.8217054263565892,70,95,125,65,75,45,475,0.33613445378151263,1.0
60,90,140,50,50,40,430,0.2535211267605634,70,95,125,65,75,45,475,0.33613445378151263,4.0
95,117,184,44,46,28,514,0.2975206611570248,70,90,45,15,45,50,315,0.3629032258064516,0.5
111,83,68,92,82,39,475,0.1774193548387097,89,124,80,55,80,55,483,0.5714285714285714,2.0
100,75,115,90,115,85,580,0.6446280991735537,70,100,70,105,75,40,460,0.23214285714285715,4.0
70,77,60,97,60,108,472,0.8394160583941606,68,72,78,38,42,32,330,0.23809523809523808,0.0
51,65,65,80,75,59,395,0.4365079365079365,55,95,55,35,75,115,430,0.9380530973451328,0.5
100,123,75,57,75,80,510,0.6923076923076923,75,125,70,125,70,115,580,0.9037037037037037,1.0
100,120,120,150,100,90,680,0.7880794701986755,105,140,55,30,55,95,480,0.8195488721804511,0.5
55,50,40,40,40,75,300,0.5945945945945946,50,48,43,46,41,60,288,0.47297297297297297,1.0
190,33,58,33,58,33,405,0.13432835820895522,50,72,35,35,35,65,292,0.5373134328358209,0.0
65,130,60,95,110,65,525,0.5303030303030303,59,74,50,35,50,35,303,0.3125,1.0
80,120,130,55,65,45,495,0.37037037037037035,70,145,88,140,70,112,625,0.8888888888888888,0.5
38,36,38,32,36,57,237,0.3893805309734513,100,180,160,150,90,90,770,0.7520661157024794,1.0
76,104,71,104,71,108,534,0.912751677852349,72,85,70,65,70,58,420,0.41304347826086957,1.0
55,81,60,50,70,97,413,0.7214285714285714,80,100,70,60,70,95,475,0.7416666666666667,1.0
70,95,125,65,75,45,475,0.33613445378151263,45,100,45,45,45,10,290,0.2949640287769784,0.5
95,85,85,65,65,35,430,0.2571428571428571,75,75,130,75,130,95,580,0.7479674796747967,1.0
100,100,100,100,100,100,600,0.8778625954198473,40,50,90,30,55,65,330,0.44680851063829785,4.0
45,90,20,65,20,65,305,0.5116279069767442,108,130,95,80,85,102,600,0.7637795275590551,1.0
100,100,100,100,100,100,600,0.8758169934640523,73,76,75,81,100,100,505,0.8110236220472441,0.5
75,95,95,95,95,85,540,0.6470588235294118,95,124,78,69,71,58,495,0.37398373983739835,1.0
108,112,118,68,72,47,525,0.2916666666666667,40,30,30,55,30,85,270,0.4666666666666667,0.0
65,50,35,115,95,95,455,0.7333333333333333,55,95,55,35,75,115,430,0.9380530973451328,0.0
35,46,34,35,45,20,215,0.072,90,120,120,60,60,50,500,0.35294117647058826,1.0
53,51,53,61,56,40,314,0.14285714285714285,60,50,70,80,80,140,480,0.8449612403100775,1.0
80,125,75,40,95,85,500,0.6911764705882353,103,60,86,60,86,50,445,0.3458646616541353,2.0
80,120,80,120,80,100,580,0.8478260869565217,65,50,70,95,80,65,425,0.4262295081967213,1.0
62,55,52,109,94,109,481,0.7833333333333333,50,65,85,35,35,55,325,0.32575757575757575,0.5
75,125,230,55,95,30,610,0.3448275862068966,75,90,50,110,80,95,500,0.7985611510791367,1.0
255,10,10,75,135,55,540,0.3125,80,82,83,100,100,80,525,0.6742424242424242,1.0
50,75,35,70,30,40,300,0.21296296296296297,126,131,95,131,98,99,680,0.8102189781021898,0.5
109,66,84,81,99,32,471,0.2013888888888889,30,45,135,45,90,30,375,0.09285714285714286,2.0
123,77,72,99,92,58,521,0.4621212121212121,80,160,60,170,130,80,680,0.6180555555555556,1.0
65,95,75,55,55,85,430,0.6933333333333334,50,70,50,50,50,70,340,0.5645161290322581,0.5
75,65,55,65,55,69,384,0.43548387096774194,60,40,50,75,85,95,405,0.6044776119402985,2.0
100,150,120,120,100,90,680,0.6493506493506493,60,85,69,65,79,80,438,0.576,1.0
95,65,65,110,130,60,525,0.4016393442622951,55,63,90,50,80,42,380,0.21138211382113822,1.0
45,35,50,70,50,30,280,0.15753424657534246,100,90,130,45,65,55,485,0.4253731343283582,4.0
83,106,65,86,65,85,490,0.6640625,80,80,80,80,80,80,480,0.5606060606060606,1.0
95,23,48,23,48,23,260,0.046153846153846156,49,55,42,42,37,85,310,0.6068376068376068,1.0
70,92,65,80,55,98,460,0.8090909090909091,65,40,50,125,60,30,370,0.07258064516129033,1.0
60,50,50,60,70,50,340,0.28346456692913385,80,45,65,90,110,80,470,0.5462962962962963,1.0
80,50,100,100,200,50,580,0.2357142857142857,68,125,65,65,115,80,518,0.6277372262773723,1.0
40,30,50,55,55,100,330,0.584070796460177,60,70,105,70,120,75,500,0.5983606557377049,0.0
70,120,100,145,105,20,560,0.2824427480916031,72,58,80,103,80,97,490,0.7171052631578947,0.0
50,75,70,35,70,48,348,0.29357798165137616,60,70,65,125,105,90,515,0.6911764705882353,0.5
40,50,45,70,45,70,320,0.5517241379310345,50,85,85,55,55,50,380,0.3902439024390244,0.25
80,92,65,65,80,68,450,0.4824561403508772,60,65,80,170,95,130,600,0.8625954198473282,1.0
75,98,63,98,63,101,498,0.889763779527559,103,60,126,80,126,50,545,0.36363636363636365,1.0
45,60,32,50,32,76,295,0.5925925925925926,65,136,94,54,96,135,580,0.9612403100775194,1.0
120,120,120,120,120,120,720,0.9344262295081968,80,125,75,40,95,85,500,0.6911764705882353,1.0
70,100,70,105,75,40,460,0.23214285714285715,65,150,40,15,80,145,495,0.9663865546218487,2.0
85,80,90,105,95,60,515,0.49074074074074076,38,41,40,50,65,65,299,0.4108527131782946,1.0
60,90,140,50,50,40,430,0.2535211267605634,30,45,135,45,90,30,375,0.09285714285714286,2.0
80,70,40,100,60,145,495,0.921875,70,40,50,55,50,25,290,0.061068702290076333,1.0
70,85,65,105,85,120,530,0.9262295081967213,59,45,40,35,40,31,250,0.14285714285714285,1.0
60,62,50,62,60,40,334,0.18181818181818182,40,70,130,60,130,25,455,0.17355371900826447,1.0
55,75,85,25,25,15,280,0.1875,75,125,100,70,80,45,495,0.33035714285714285,2.0
55,55,50,45,65,55,325,0.37373737373737376,64,78,52,78,52,81,405,0.6422764227642277,1.0
40,45,65,100,120,90,460,0.5588235294117647,65,125,100,55,70,85,500,0.6532258064516129,1.0
75,98,63,98,63,101,498,0.889763779527559,100,110,90,85,90,60,535,0.47794117647058826,0.5
50,64,50,45,50,41,300,0.22727272727272727,125,170,100,120,90,95,700,0.77,2.0
95,155,109,70,130,81,640,0.6788321167883211,69,55,45,55,55,15,294,0.11666666666666667,0.5
40,35,30,120,70,105,400,0.6692307692307692,50,80,95,10,45,10,290,0.232,1.0
40,30,35,45,40,55,245,0.31496062992125984,50,53,48,53,48,64,316,0.358974358974359,1.0
57,80,91,80,87,75,470,0.5737704918032787,30,56,35,25,35,72,253,0.48148148148148145,1.0
60,110,70,60,60,100,460,0.8461538461538461,65,80,140,40,70,70,465,0.5223880597014925,0.25
40,45,35,65,55,70,310,0.4482758620689655,55,63,90,50,80,42,380,0.21138211382113822,0.25
70,40,50,55,50,25,290,0.061068702290076333,60,50,50,60,70,50,340,0.28346456692913385,0.25
40,30,50,55,55,100,330,0.584070796460177,80,100,70,60,70,95,475,0.7416666666666667,0.5
72,95,67,103,71,122,530,0.9606299212598425,68,65,65,125,115,80,518,0.6461538461538462,1.0
35,65,35,65,35,65,300,0.46621621621621623,60,130,80,60,60,70,460,0.5153846153846153,0.5
60,85,42,85,42,91,405,0.8227848101265823,70,55,65,95,85,70,440,0.5307692307692308,1.0
50,40,85,40,65,25,305,0.08870967741935484,150,160,100,95,65,100,670,0.8866666666666667,1.0
65,47,55,73,75,85,400,0.65,97,165,60,65,50,58,495,0.3902439024390244,1.0
20,10,55,15,20,80,200,0.17985611510791366,70,85,70,60,70,50,405,0.28378378378378377,1.0
70,115,60,115,60,55,475,0.4647887323943662,45,100,135,65,135,45,525,0.29411764705882354,2.0
40,27,60,37,50,66,280,0.36220472440944884,70,120,40,95,40,95,460,0.8106060606060606,4.0
60,45,70,45,90,95,405,0.7304964539007093,55,81,60,50,70,97,413,0.7214285714285714,1.0
62,55,52,109,94,109,481,0.7833333333333333,20,15,20,10,55,80,200,0.2682926829268293,2.0
105,95,80,40,80,90,490,0.753968253968254,100,110,90,85,90,60,535,0.47794117647058826,1.0
100,100,100,100,100,100,600,0.8805970149253731,35,80,50,50,70,120,405,0.84375,2.0
70,55,75,45,65,60,370,0.45901639344262296,55,40,50,65,85,40,335,0.3181818181818182,2.0
80,52,50,90,50,89,411,0.6666666666666666,80,110,120,130,90,70,600,0.6198347107438017,0.5
45,100,45,45,45,10,290,0.2949640287769784,95,23,48,23,48,23,260,0.046153846153846156,1.0
90,60,60,40,40,40,330,0.29545454545454547,91,129,90,72,90,108,580,0.8536585365853658,2.0
40,40,35,50,100,70,335,0.5031847133757962,50,85,40,85,40,35,335,0.1746031746031746,1.0
45,30,35,20,20,45,195,0.14782608695652175,70,90,110,60,75,95,500,0.7333333333333333,1.0
75,98,63,98,63,101,498,0.849624060150376,65,76,84,54,96,105,480,0.9008264462809917,1.0
90,120,75,60,60,45,450,0.29411764705882354,41,56,40,62,44,71,314,0.568,1.0
50,80,95,10,45,10,290,0.232,120,100,85,30,85,45,465,0.22448979591836735,0.5
60,80,110,50,80,45,425,0.2833333333333333,55,45,43,55,43,72,313,0.5853658536585366,0.0
50,70,160,70,160,90,600,0.7417218543046358,110,80,90,95,90,65,530,0.5033557046979866,1.0
61,78,95,56,58,57,405,0.40336134453781514,85,90,80,70,80,130,535,0.9262295081967213,0.25
50,65,85,35,35,55,325,0.32575757575757575,80,120,79,95,79,70,523,0.5833333333333334,1.0
65,75,90,97,123,44,494,0.1987179487179487,40,55,30,30,30,60,245,0.43548387096774194,1.0
100,150,120,120,100,90,680,0.6493506493506493,80,45,65,90,110,80,470,0.5462962962962963,1.0
55,35,50,55,110,85,390,0.6277372262773723,45,30,15,85,65,65,305,0.36220472440944884,2.0
80,45,65,90,110,80,470,0.5462962962962963,40,45,35,30,40,55,245,0.3793103448275862,2.0
69,69,76,69,86,91,460,0.6554621848739496,55,45,45,25,25,15,210,0.048,1.0
88,107,122,74,75,64,530,0.4596774193548387,100,50,80,60,80,50,420,0.34375,1.0
62,48,54,63,60,68,355,0.5178571428571429,58,89,77,45,45,48,362,0.3177570093457944,1.0
100,70,70,65,65,45,415,0.1897810218978102,120,100,85,30,85,45,465,0.22448979591836735,1.0
100,100,100,100,100,100,600,0.8758169934640523,50,70,160,70,160,90,600,0.7417218543046358,0.5
45,50,43,40,38,62,278,0.40441176470588236,30,40,70,70,25,60,295,0.41353383458646614,1.0
65,90,120,85,70,60,490,0.43410852713178294,65,110,130,60,65,95,525,0.8278145695364238,2.0
59,74,50,35,50,35,303,0.3125,65,76,84,54,96,105,480,0.9008264462809917,0.0
40,29,45,29,45,36,224,0.14634146341463414,65,95,75,55,55,85,430,0.6933333333333334,0.5
85,73,70,73,115,67,483,0.5126050420168067,50,95,95,35,110,70,455,0.5179856115107914,1.0
91,90,72,90,129,108,580,0.896,80,50,100,100,200,50,580,0.2357142857142857,2.0
80,105,65,60,75,130,515,0.9645390070921985,70,60,75,110,75,90,480,0.7165354330708661,2.0
70,77,60,97,60,108,472,0.8394160583941606,65,90,65,61,61,100,442,0.8373983739837398,1.0
85,105,100,79,83,78,530,0.5869565217391305,72,60,30,20,30,25,237,0.11570247933884298,1.0
60,80,50,50,50,40,330,0.23853211009174313,50,65,107,105,107,86,520,0.703125,1.0
100,120,120,150,100,90,680,0.7880794701986755,85,80,70,135,75,90,535,0.7006802721088435,1.0
75,69,72,114,100,104,534,0.8253968253968254,78,81,71,74,69,126,499,0.9090909090909091,0.5
60,45,50,90,80,70,395,0.625,60,50,70,80,80,140,480,0.8449612403100775,0.5
78,84,78,109,85,100,534,0.8620689655172413,55,85,55,50,55,60,360,0.4233576642335766,1.0
50,180,20,180,20,150,600,0.9029850746268657,150,100,120,100,120,90,680,0.6666666666666666,1.0
70,65,65,55,55,70,380,0.5,80,52,50,90,50,89,411,0.6666666666666666,1.0
80,80,90,110,130,110,600,0.8721804511278195,75,80,60,65,90,102,472,0.8625954198473282,1.0
68,65,65,125,115,80,518,0.6461538461538462,50,35,55,25,25,15,205,0.021739130434782608,1.0
95,60,79,100,125,81,540,0.6201550387596899,20,25,45,70,90,60,310,0.30833333333333335,1.0
41,64,45,50,50,50,300,0.36752136752136755,44,38,39,61,79,42,303,0.2251655629139073,0.0
55,75,50,40,40,80,340,0.6302521008403361,72,58,80,103,80,97,490,0.7171052631578947,1.0
45,30,50,65,50,45,285,0.13821138211382114,50,160,110,160,110,110,700,0.8854961832061069,1.0
49,49,56,49,61,66,330,0.5190839694656488,45,95,50,40,50,75,355,0.54,2.0
64,165,75,93,83,75,555,0.6587301587301587,65,90,122,58,75,84,494,0.71875,2.0
106,90,130,90,154,110,680,0.8699186991869918,95,75,110,100,80,30,490,0.15267175572519084,0.5
35,35,35,35,35,35,210,0.13385826771653545,45,90,20,65,20,65,305,0.5116279069767442,2.0
67,57,55,77,55,114,425,0.8879310344827587,55,95,55,35,75,115,430,0.9380530973451328,0.0
60,60,60,105,105,105,495,0.848,45,45,35,20,30,20,195,0.07246376811594203,1.0
40,55,80,35,60,30,300,0.15037593984962405,86,68,72,109,66,106,507,0.8099173553719008,0.5
70,43,53,43,53,40,302,0.19090909090909092,30,42,118,42,88,30,350,0.112,0.0
68,125,65,65,115,80,518,0.6277372262773723,75,75,55,105,85,30,425,0.1619718309859155,1.0
72,58,80,103,80,97,490,0.7171052631578947,150,100,120,100,120,90,680,0.6666666666666666,1.0
130,65,60,110,95,65,525,0.5227272727272727,71,82,64,64,59,112,452,0.9327731092436975,1.0
65,90,122,58,75,84,494,0.71875,49,49,56,49,61,66,330,0.5190839694656488,2.0
54,78,103,53,45,22,355,0.23255813953488372,70,55,75,45,65,60,370,0.45901639344262296,2.0
60,40,60,40,60,35,295,0.18055555555555555,54,63,52,83,56,97,405,0.7697841726618705,2.0
80,115,80,65,55,93,488,0.7846153846153846,85,135,130,60,80,25,515,0.40540540540540543,0.25
50,65,90,35,35,15,290,0.14678899082568808,65,75,90,97,123,44,494,0.1987179487179487,0.5
65,40,50,125,60,30,370,0.07258064516129033,50,70,50,50,50,40,310,0.16296296296296298,1.0
60,55,90,145,90,80,520,0.6071428571428571,80,80,80,55,55,90,440,0.6417910447761194,0.0
75,123,67,95,85,95,540,0.7642276422764228,30,80,90,55,45,55,355,0.4295774647887324,2.0
28,25,25,45,35,40,198,0.16083916083916083,39,52,43,60,50,65,309,0.49107142857142855,0.5
60,59,85,79,105,36,424,0.16666666666666666,80,120,79,95,79,70,523,0.5833333333333334,1.0
65,47,55,73,75,85,400,0.65,90,75,85,115,90,55,510,0.3445378151260504,1.0
60,60,75,60,75,80,410,0.7321428571428571,70,110,75,145,85,145,630,0.9444444444444444,1.0
75,80,70,65,75,90,455,0.7578125,40,40,35,50,100,70,335,0.5031847133757962,0.5
70,84,70,65,70,51,410,0.2949640287769784,55,40,40,65,45,35,280,0.16428571428571428,2.0
70,95,85,55,65,70,440,0.5,75,90,90,140,90,115,600,0.9481481481481482,0.0
30,30,30,30,30,30,180,0.12612612612612611,80,160,80,130,80,100,630,0.8455284552845529,0.5
90,85,75,115,100,115,580,0.9381443298969072,55,45,45,25,25,15,210,0.048,0.0
65,150,60,115,60,115,565,0.935251798561151,30,30,30,30,30,30,180,0.12612612612612611,1.0
50,95,95,35,110,70,455,0.5179856115107914,30,45,135,45,90,30,375,0.09285714285714286,2.0
50,40,85,40,65,25,305,0.08870967741935484,72,85,70,65,70,58,420,0.41304347826086957,2.0
50,50,120,80,80,30,410,0.07258064516129033,68,72,78,38,42,32,330,0.23809523809523808,0.5
109,66,84,81,99,32,471,0.2013888888888889,75,125,230,55,95,30,610,0.3448275862068966,0.0
45,75,37,70,55,83,365,0.6183206106870229,100,100,100,100,100,100,600,0.8805970149253731,0.5
75,69,72,114,100,104,534,0.8253968253968254,91,90,129,90,72,108,580,0.9140625,1.0
55,35,50,55,110,85,390,0.6277372262773723,60,85,60,50,50,125,430,0.9090909090909091,0.5
65,75,90,97,123,44,494,0.1987179487179487,40,45,40,65,40,65,295,0.5661764705882353,1.0
50,40,85,40,65,25,305,0.08870967741935484,70,140,230,60,80,50,630,0.32432432432432434,0.5
40,40,35,50,100,70,335,0.5031847133757962,80,100,123,122,120,80,625,0.56,0.5
40,60,30,31,31,70,262,0.4492753623188406,55,20,35,20,45,75,250,0.37681159420289856,1.0
80,185,115,40,105,75,600,0.6230769230769231,76,104,71,104,71,108,534,0.912751677852349,0.25
100,150,140,100,90,90,670,0.7969924812030075,70,75,80,135,80,135,575,0.917910447761194,2.0
60,55,50,40,55,45,305,0.22377622377622378,75,80,85,110,90,50,490,0.3548387096774194,1.0
90,110,80,100,80,95,555,0.7982456140350878,75,90,50,110,80,95,500,0.7985611510791367,0.5
95,65,65,110,130,60,525,0.4016393442622951,105,95,80,40,80,90,490,0.753968253968254,1.0
55,55,85,65,85,35,380,0.2014388489208633,60,100,89,55,69,112,485,0.9298245614035088,2.0
45,22,60,27,30,29,213,0.07518796992481203,110,123,65,100,65,65,528,0.5217391304347826,0.25
50,70,100,40,40,30,330,0.2222222222222222,60,50,100,85,70,65,430,0.47580645161290325,1.0
40,30,35,45,40,55,245,0.31496062992125984,77,85,51,55,51,65,384,0.5163934426229508,2.0
60,80,50,40,40,30,300,0.15328467153284672,80,110,60,150,130,70,600,0.5042016806722689,1.0
65,90,40,45,80,75,395,0.625,91,90,129,90,72,108,580,0.9140625,0.0
70,70,115,130,90,60,535,0.5338983050847458,40,40,40,70,40,20,250,0.032520325203252036,0.5
55,75,85,25,25,15,280,0.1875,55,40,85,80,105,40,405,0.23622047244094488,2.0
35,20,65,40,65,20,245,0.02459016393442623,40,55,80,35,60,30,300,0.15037593984962405,0.5
45,30,50,65,50,45,285,0.13821138211382114,104,91,63,91,73,68,490,0.5118110236220472,1.0
45,35,50,70,50,30,280,0.15753424657534246,20,10,55,15,20,80,200,0.17985611510791366,2.0
70,80,102,80,102,40,474,0.2677165354330709,45,30,15,85,65,65,305,0.36220472440944884,2.0
40,30,32,50,52,65,269,0.3671875,80,105,105,105,105,80,580,0.5939849624060151,2.0
75,80,70,65,75,90,455,0.7578125,95,75,110,100,80,30,490,0.15267175572519084,1.0
45,30,15,85,65,65,305,0.36220472440944884,85,120,70,50,60,100,485,0.8308823529411765,2.0
103,60,86,60,86,50,445,0.3458646616541353,67,89,116,79,116,33,500,0.2624113475177305,0.5
50,92,108,92,108,35,485,0.2457627118644068,78,104,78,159,115,100,634,0.8444444444444444,1.0
50,65,107,105,107,86,520,0.7758620689655172,65,125,100,55,70,85,500,0.6532258064516129,1.0
95,23,48,23,48,23,260,0.046153846153846156,55,70,55,40,55,85,360,0.7073170731707317,1.0
106,190,100,154,100,130,780,0.9259259259259259,60,65,60,130,75,110,500,0.7719298245614035,0.0
90,70,80,70,95,70,475,0.5190839694656488,103,60,86,60,86,50,445,0.3458646616541353,1.0
30,65,100,45,25,40,305,0.1891891891891892,50,85,55,65,65,90,410,0.7478260869565218,2.0
45,22,60,27,30,29,213,0.07518796992481203,70,105,105,50,40,20,390,0.33587786259541985,1.0
73,76,75,81,100,100,505,0.8110236220472441,100,100,80,60,60,50,450,0.3050847457627119,2.0
70,45,48,60,65,35,323,0.15748031496062992,73,76,75,81,100,100,505,0.8110236220472441,0.5
45,30,40,105,50,20,290,0.031007751937984496,40,30,35,50,70,55,280,0.28205128205128205,2.0
65,85,70,75,70,40,405,0.203125,130,85,80,85,95,60,535,0.43884892086330934,2.0
60,25,35,70,80,60,330,0.3076923076923077,70,55,95,95,110,65,490,0.48872180451127817,0.5
85,56,77,50,77,78,423,0.53125,86,81,97,81,107,43,495,0.203125,0.5
55,47,52,40,40,41,275,0.16806722689075632,95,124,78,69,71,58,495,0.37398373983739835,1.0
40,60,30,31,31,70,262,0.4492753623188406,46,87,60,30,40,57,320,0.37777777777777777,1.0
60,70,105,70,120,75,500,0.5983606557377049,75,55,70,55,95,110,460,0.8444444444444444,0.0
70,135,105,60,105,20,495,0.5806451612903226,57,80,91,80,87,75,470,0.5737704918032787,0.0625
40,45,40,62,60,60,307,0.33884297520661155,115,45,20,45,25,20,270,0.11538461538461539,1.0
45,30,15,85,65,65,305,0.36220472440944884,80,90,80,130,110,110,600,0.856,1.0
95,65,110,60,130,65,525,0.5275590551181102,84,71,43,71,43,48,360,0.25874125874125875,1.0
40,45,35,65,55,70,310,0.4482758620689655,45,55,39,35,39,42,255,0.18518518518518517,1.0
44,48,65,50,64,43,314,0.1623931623931624,43,70,48,50,60,38,309,0.2391304347826087,0.5
150,120,100,120,100,90,680,0.664179104477612,50,70,50,50,50,70,340,0.5645161290322581,2.0
75,75,130,75,130,95,580,0.7479674796747967,83,106,65,86,65,85,490,0.6640625,2.0
64,66,68,81,76,50,405,0.25190839694656486,65,125,60,95,60,105,510,0.9236641221374046,1.0
78,130,111,130,85,100,634,0.8561151079136691,30,45,59,30,39,57,260,0.2803030303030303,2.0
55,66,44,44,56,85,350,0.6888888888888889,40,80,100,30,30,20,300,0.11851851851851852,0.5
35,65,35,65,35,65,300,0.46621621621621623,35,20,65,40,65,20,245,0.02459016393442623,1.0
80,105,65,60,75,130,515,0.9645390070921985,80,75,150,75,150,50,580,0.30973451327433627,0.25
55,95,115,45,45,35,390,0.2116788321167883,80,82,100,83,100,80,525,0.6821705426356589,0.5
60,55,145,75,150,40,525,0.2,55,40,50,65,85,40,335,0.3181818181818182,0.5
55,75,60,75,60,103,428,0.7982456140350878,70,84,70,65,70,51,410,0.2949640287769784,0.0
70,115,60,115,60,55,475,0.4647887323943662,60,60,75,60,75,80,410,0.7321428571428571,1.0
85,105,100,79,83,78,530,0.5869565217391305,76,48,48,57,62,34,325,0.11688311688311688,0.5
61,90,45,50,50,160,456,0.9230769230769231,126,131,95,131,98,99,680,0.8102189781021898,1.0
60,85,69,65,79,80,438,0.576,46,87,60,30,40,57,320,0.37777777777777777,1.0
79,100,80,110,90,121,580,0.968,60,75,85,100,85,115,520,0.8992248062015504,1.0
80,82,100,83,100,80,525,0.6821705426356589,75,80,85,110,90,50,490,0.3548387096774194,0.25
100,150,90,180,160,90,770,0.7348484848484849,70,80,102,80,102,40,474,0.2677165354330709,1.0
105,130,120,45,45,40,485,0.4444444444444444,38,35,40,27,25,35,200,0.08208955223880597,1.0
90,100,90,125,85,90,580,0.7352941176470589,71,82,64,64,59,112,452,0.9327731092436975,1.0
90,100,60,90,60,80,480,0.6422764227642277,45,45,35,20,30,20,195,0.07246376811594203,0.5
105,105,75,65,100,50,500,0.37593984962406013,95,95,85,125,65,55,520,0.3894736842105263,2.0
60,62,80,63,80,60,405,0.4336283185840708,60,82,45,45,45,74,351,0.5752212389380531,2.0
89,145,90,105,80,91,600,0.8549618320610687,40,70,40,35,40,60,285,0.392,2.0
50,55,50,36,30,43,264,0.2922077922077922,65,65,60,130,95,110,525,0.823943661971831,1.0
70,84,70,65,70,51,410,0.2949640287769784,75,65,55,65,55,69,384,0.43548387096774194,0.5
65,95,75,55,55,85,430,0.6933333333333334,90,95,105,165,110,45,610,0.2890625,0.5
60,62,80,63,80,60,405,0.4336283185840708,88,107,122,74,75,64,530,0.4596774193548387,0.5
68,90,65,50,55,82,410,0.6165413533834586,65,90,122,58,75,84,494,0.71875,0.5
78,70,61,50,61,100,420,0.8145161290322581,65,50,35,115,95,95,455,0.7333333333333333,1.0
100,100,100,100,100,100,600,0.8345864661654135,91,134,95,100,100,80,600,0.6304347826086957,0.25
61,84,65,70,70,70,420,0.5,55,70,40,60,40,40,305,0.26956521739130435,1.0
60,110,70,60,60,100,460,0.8461538461538461,60,40,50,75,85,95,405,0.6044776119402985,0.5
71,73,88,120,89,59,500,0.43537414965986393,95,65,110,60,130,65,525,0.5275590551181102,1.0
41,64,45,50,50,50,300,0.36752136752136755,80,120,80,120,80,100,580,0.8478260869565217,1.0
126,131,95,131,98,99,680,0.8294573643410853,80,135,85,70,95,150,615,0.9844961240310077,1.0
95,155,109,70,130,81,640,0.6788321167883211,49,66,70,44,55,51,335,0.4260869565217391,1.0
85,70,80,97,80,123,535,0.9304347826086956,90,100,90,125,85,90,580,0.7352941176470589,1.0
71,95,85,110,95,79,535,0.664,65,90,50,85,45,55,390,0.371900826446281,2.0
55,85,122,58,75,99,494,0.8099173553719008,85,50,95,120,115,80,545,0.5793650793650794,0.5
66,41,77,61,87,23,355,0.12096774193548387,70,60,75,110,75,90,480,0.7165354330708661,0.5
60,45,70,45,90,95,405,0.7304964539007093,85,73,70,73,115,67,483,0.5126050420168067,1.0
70,70,115,130,90,60,535,0.5338983050847458,50,64,50,45,50,41,300,0.22727272727272727,0.0
90,95,95,70,90,70,510,0.5230769230769231,110,65,105,55,95,80,510,0.6258503401360545,1.0
75,95,125,45,75,95,510,0.8257575757575758,89,145,90,105,80,91,600,0.8549618320610687,0.0
55,70,45,70,50,60,350,0.45,79,105,70,145,80,101,580,0.8608695652173913,1.0
85,135,130,60,80,25,515,0.40540540540540543,50,120,53,35,110,87,455,0.640625,0.5
60,50,50,60,70,50,340,0.28346456692913385,65,75,90,97,123,44,494,0.1987179487179487,0.125
80,95,82,60,82,75,474,0.6,90,100,70,110,150,80,600,0.6037735849056604,1.0
100,150,140,100,90,90,670,0.7969924812030075,74,94,131,54,116,20,489,0.4485294117647059,1.0
70,40,50,55,50,25,290,0.061068702290076333,120,100,85,30,85,45,465,0.22448979591836735,1.0
91,90,129,90,72,108,580,0.9140625,50,75,45,40,45,60,315,0.4380165289256198,0.5
71,82,64,64,59,112,452,0.9327731092436975,106,90,130,90,154,110,680,0.8699186991869918,1.0
70,55,75,45,65,60,370,0.45901639344262296,89,145,90,105,80,91,600,0.8549618320610687,1.0
50,65,107,105,107,86,520,0.7758620689655172,90,60,60,40,40,40,330,0.29545454545454547,0.0
38,30,85,55,65,30,303,0.21428571428571427,50,75,35,70,30,40,300,0.21296296296296297,1.0
65,80,140,40,70,70,465,0.5223880597014925,91,72,90,129,90,108,580,0.8925619834710744,1.0
60,70,50,100,50,65,395,0.5217391304347826,35,65,35,65,35,65,300,0.46621621621621623,1.0
75,98,63,98,63,101,498,0.8091603053435115,55,104,105,94,75,52,485,0.36363636363636365,2.0
35,35,35,35,35,35,210,0.13385826771653545,55,35,50,55,110,85,390,0.6277372262773723,0.25
75,125,230,55,95,30,610,0.3448275862068966,64,115,65,83,63,65,455,0.5323741007194245,1.0
60,70,105,70,120,75,500,0.5983606557377049,70,70,70,70,70,70,420,0.5289256198347108,1.0
67,58,57,81,67,101,431,0.8790322580645161,58,64,58,80,65,80,405,0.609271523178808,0.5
55,45,45,25,25,15,210,0.048,95,75,180,130,80,30,590,0.13793103448275862,0.5
65,90,50,85,45,55,390,0.371900826446281,62,48,54,63,60,68,355,0.5178571428571429,1.0
50,75,70,35,70,48,348,0.29357798165137616,70,60,125,115,70,55,495,0.35507246376811596,2.0
44,38,39,61,79,42,303,0.2251655629139073,20,40,90,30,90,25,295,0.11363636363636363,1.0
50,52,48,65,50,55,320,0.33098591549295775,108,112,118,68,72,47,525,0.2916666666666667,2.0
50,70,160,70,160,90,600,0.7417218543046358,95,85,85,65,65,35,430,0.2571428571428571,2.0
90,130,80,65,85,55,505,0.4396551724137931,40,45,35,30,40,55,245,0.3793103448275862,0.25
65,76,84,54,96,105,480,0.9008264462809917,85,110,90,45,90,80,500,0.6206896551724138,1.0
55,47,52,40,40,41,275,0.16806722689075632,40,50,45,70,45,70,320,0.5517241379310345,1.0
76,65,45,92,42,91,411,0.7449664429530202,68,85,65,165,135,100,618,0.8083333333333333,1.0
55,70,45,70,50,60,350,0.45,50,65,64,44,48,43,314,0.2196969696969697,0.5
71,73,88,120,89,59,500,0.43537414965986393,62,55,52,109,94,109,481,0.7833333333333333,1.0
105,125,100,60,100,100,590,0.8359375,80,80,90,110,130,110,600,0.8721804511278195,1.0
50,20,55,25,25,30,205,0.09774436090225563,70,75,80,135,80,135,575,0.917910447761194,1.0
100,73,83,73,83,55,467,0.371900826446281,40,45,40,62,60,60,307,0.33884297520661155,1.0
55,104,105,94,75,52,485,0.36363636363636365,55,65,95,95,45,85,440,0.6610169491525424,0.5
70,100,70,105,75,40,460,0.23214285714285715,75,125,70,125,70,115,580,0.9037037037037037,1.0
100,123,75,57,75,80,510,0.6923076923076923,110,65,75,125,85,30,490,0.15,1.0
103,93,67,71,61,84,479,0.7142857142857143,45,100,45,45,45,10,290,0.2949640287769784,0.5
1,90,45,30,30,40,236,0.33064516129032256,105,95,75,85,75,74,509,0.5714285714285714,1.0
75,85,200,55,65,30,510,0.16778523489932887,40,30,35,45,40,55,245,0.31496062992125984,0.0
60,50,100,85,70,65,430,0.47580645161290325,86,76,86,116,56,95,515,0.7982456140350878,2.0
75,103,80,70,80,92,500,0.7933884297520661,68,125,65,65,115,80,518,0.6277372262773723,1.0
39,52,43,60,50,65,309,0.5041322314049587,63,63,47,41,41,74,329,0.56,1.0
72,95,67,103,71,122,530,0.9606299212598425,64,88,50,88,50,106,446,0.9111111111111111,0.5
38,35,35,65,55,50,278,0.2647058823529412,40,55,99,40,79,47,360,0.26262626262626265,1.0
60,45,50,90,80,70,395,0.625,60,60,75,60,75,80,410,0.7321428571428571,2.0
55,55,85,65,85,35,380,0.2014388489208633,45,50,55,75,65,30,320,0.06293706293706294,0.5
40,60,30,31,31,70,262,0.4492753623188406,64,88,50,88,50,106,446,0.9111111111111111,1.0
64,66,68,81,76,50,405,0.25190839694656486,110,160,110,80,110,100,670,0.8591549295774648,1.0
75,85,200,55,65,30,510,0.16778523489932887,30,40,70,70,25,60,295,0.41353383458646614,0.5
65,90,40,45,80,75,395,0.625,50,50,150,50,150,50,500,0.2571428571428571,0.5
50,53,48,53,48,64,316,0.4076923076923077,70,85,70,60,70,50,405,0.28378378378378377,4.0
50,180,20,180,20,150,600,0.9029850746268657,75,110,110,110,105,80,590,0.656934306569343,1.0
30,30,42,30,42,70,244,0.4230769230769231,80,160,80,130,80,100,630,0.8455284552845529,0.5
35,35,35,35,35,35,210,0.13385826771653545,75,125,70,125,70,115,580,0.9037037037037037,0.5
30,45,59,30,39,57,260,0.2803030303030303,30,35,30,100,35,80,310,0.4765625,0.0625
71,82,64,64,59,112,452,0.9327731092436975,100,100,100,100,100,100,600,0.8805970149253731,1.0
70,120,65,45,85,125,510,0.9747899159663865,90,85,100,95,125,85,580,0.6834532374100719,1.0
40,30,32,50,52,65,269,0.3671875,79,115,70,125,80,111,580,0.8468468468468469,0.5
70,65,60,90,75,90,450,0.6571428571428571,91,90,72,90,129,108,580,0.896,2.0
65,90,122,58,75,84,494,0.71875,55,70,40,60,40,40,305,0.26956521739130435,1.0
68,90,65,50,55,82,410,0.6165413533834586,50,53,62,58,63,44,330,0.13709677419354838,1.0
85,100,122,58,75,54,494,0.3939393939393939,45,75,60,40,30,50,300,0.304,0.5
40,45,40,65,40,65,295,0.5661764705882353,30,45,55,70,55,85,340,0.5633802816901409,2.0
60,150,50,150,50,60,520,0.5,80,82,78,95,80,85,500,0.6869565217391305,0.5
50,50,150,50,150,50,500,0.2571428571428571,55,50,65,175,95,150,590,0.7818181818181819,1.0
44,50,91,24,86,10,305,0.1981981981981982,67,57,55,77,55,114,425,0.8879310344827587,0.5
45,49,65,49,65,45,318,0.275,75,125,230,55,95,30,610,0.3448275862068966,1.0
75,95,60,65,60,115,470,0.8778625954198473,50,70,50,50,50,70,340,0.5645161290322581,1.0
108,170,115,120,95,92,700,0.7083333333333334,53,51,53,61,56,40,314,0.14285714285714285,1.0
50,65,107,105,107,86,520,0.7272727272727273,50,65,85,35,35,55,325,0.32575757575757575,1.0
55,85,55,50,55,60,360,0.4233576642335766,72,105,115,54,86,68,500,0.5149253731343284,0.25
70,100,115,30,65,30,410,0.24390243902439024,65,90,65,61,61,100,442,0.8373983739837398,2.0
130,70,35,70,35,60,400,0.4017857142857143,75,103,80,70,80,92,500,0.7933884297520661,0.5
65,110,130,60,65,95,525,0.8278145695364238,70,80,50,35,35,35,305,0.14,1.0
135,85,40,40,85,5,390,0.6864406779661016,70,94,50,94,50,66,424,0.48148148148148145,1.0
89,145,90,105,80,91,600,0.8549618320610687,160,110,65,65,110,30,540,0.35714285714285715,1.0
70,145,88,140,70,112,625,0.8888888888888888,90,130,80,65,85,55,505,0.4396551724137931,1.0
61,90,45,50,50,160,456,0.9230769230769231,55,95,55,35,75,115,430,0.9380530973451328,2.0
55,50,45,135,95,120,500,0.7714285714285715,95,23,48,23,48,23,260,0.046153846153846156,0.5
55,66,44,44,56,85,350,0.6888888888888889,43,80,65,50,35,35,308,0.14193548387096774,1.0
50,64,50,45,50,41,300,0.22727272727272727,50,50,77,95,77,91,440,0.5916666666666667,2.0
55,45,43,55,43,72,313,0.5853658536585366,40,55,99,40,79,47,360,0.26262626262626265,4.0
30,105,90,25,25,50,325,0.2773722627737226,95,109,105,75,85,56,525,0.34513274336283184,1.0
95,117,184,44,46,28,514,0.2975206611570248,63,60,55,50,50,71,349,0.5289256198347108,2.0
100,150,90,180,160,90,770,0.7348484848484849,75,75,130,75,130,95,580,0.7479674796747967,1.0
45,50,43,40,38,62,278,0.40441176470588236,95,125,79,60,100,81,540,0.6165413533834586,1.0
50,160,110,160,110,110,700,0.8854961832061069,70,40,50,55,50,25,290,0.061068702290076333,2.0
95,65,110,60,130,65,525,0.5275590551181102,80,115,80,65,55,93,488,0.7846153846153846,1.0
55,45,50,45,65,80,340,0.5546218487394958,60,60,50,40,50,75,335,0.5882352941176471,1.0
20,25,45,70,90,60,310,0.30833333333333335,50,52,48,65,50,55,320,0.33098591549295775,1.0
30,35,30,100,35,80,310,0.4765625,95,110,80,70,80,50,485,0.37209302325581395,1.0
85,105,100,79,83,78,530,0.5869565217391305,70,90,45,15,45,50,315,0.3629032258064516,2.0
77,120,90,60,90,48,485,0.2785714285714286,35,20,65,40,65,20,245,0.02459016393442623,0.0
50,50,77,95,77,91,440,0.5916666666666667,44,50,91,24,86,10,305,0.1981981981981982,0.5
90,120,100,150,120,100,680,0.7718120805369127,90,60,60,40,40,40,330,0.29545454545454547,2.0
60,85,60,50,50,125,430,0.9090909090909091,75,125,100,70,80,45,495,0.33035714285714285,0.5
65,105,60,60,70,95,455,63.0,70,40,50,55,50,25,290,0.061068702290076333,2.0
65,90,40,45,80,75,395,0.625,62,44,50,44,50,55,305,0.3629032258064516,0.5
35,35,35,35,35,35,210,0.13385826771653545,75,125,230,55,95,30,610,0.3448275862068966,2.0
80,145,150,105,110,110,700,0.8692307692307693,55,81,60,50,70,97,413,0.7214285714285714,1.0
75,125,100,70,80,45,495,0.33035714285714285,84,71,43,71,43,48,360,0.25874125874125875,1.0
100,128,90,77,77,128,600,0.959349593495935,80,52,50,90,50,89,411,0.6666666666666666,0.25
150,80,44,90,54,80,498,0.625,45,35,50,70,50,30,280,0.15753424657534246,2.0
70,110,80,55,80,105,500,0.8794326241134752,79,115,70,125,80,111,580,0.864,0.25
45,35,50,70,50,30,280,0.15753424657534246,125,58,58,76,76,67,460,0.515625,2.0
37,25,41,25,41,25,194,0.08870967741935484,80,80,80,80,80,80,480,0.5606060606060606,1.0
65,50,35,115,95,95,455,0.7333333333333333,85,110,76,65,82,56,474,0.3933333333333333,2.0
40,30,32,50,52,65,269,0.3671875,60,30,30,36,56,50,262,0.32432432432432434,0.5
70,70,40,60,40,60,340,0.4247787610619469,70,90,70,60,60,70,420,0.6390977443609023,0.5
110,123,65,100,65,65,528,0.5217391304347826,110,160,110,80,110,100,670,0.8591549295774648,2.0
55,50,65,175,95,150,590,0.7818181818181819,55,50,45,135,95,120,500,0.7714285714285715,0.5
60,25,35,70,80,60,330,0.3076923076923077,78,81,71,74,69,126,499,0.9090909090909091,1.0
76,65,45,92,42,91,411,0.7449664429530202,50,95,95,35,110,70,455,0.5179856115107914,2.0
79,115,70,125,80,111,580,0.8468468468468469,65,150,60,115,60,115,565,0.935251798561151,1.0
100,100,100,100,100,100,600,0.8805970149253731,30,35,30,100,35,80,310,0.4765625,1.0
60,85,49,60,49,60,363,0.4444444444444444,50,53,48,53,48,64,316,0.358974358974359,2.0
79,115,70,125,80,111,580,0.864,50,52,48,65,50,55,320,0.33098591549295775,2.0
46,57,40,40,40,50,273,0.25,50,75,75,65,65,50,380,0.4049586776859504,0.5
57,24,86,24,86,23,300,0.12727272727272726,109,66,84,81,99,32,471,0.2013888888888889,1.0
95,75,180,130,80,30,590,0.13793103448275862,65,80,140,40,70,70,465,0.5223880597014925,0.5
80,100,80,80,80,100,520,0.9051724137931034,60,85,40,30,45,68,328,0.6422018348623854,1.0
50,80,95,10,45,10,290,0.232,60,60,40,65,45,35,305,0.15833333333333333,1.0
60,150,50,150,50,60,520,0.5,115,45,20,45,25,20,270,0.11538461538461539,0.0
50,70,50,50,50,40,310,0.16296296296296298,35,80,50,50,70,120,405,0.84375,2.0
60,50,150,50,150,60,520,0.5206611570247934,70,75,60,105,60,105,475,0.88,0.5
60,62,50,62,60,40,334,0.18181818181818182,40,45,40,65,40,65,295,0.5661764705882353,1.0
45,63,37,65,55,95,360,0.8055555555555556,67,82,62,46,48,43,348,0.22033898305084745,1.0
65,80,65,35,65,60,370,0.38405797101449274,50,180,20,180,20,150,600,0.9029850746268657,1.0
40,65,40,80,40,65,330,0.5038167938931297,63,60,55,50,50,71,349,0.5289256198347108,1.0
30,30,42,30,42,70,244,0.4230769230769231,80,82,83,100,100,80,525,0.6742424242424242,2.0
45,100,135,65,135,45,525,0.29411764705882354,83,80,75,70,70,101,479,0.8615384615384616,0.0
76,25,45,67,55,24,292,0.0390625,79,105,70,145,80,101,580,0.8608695652173913,1.0
150,80,44,90,54,80,498,0.625,50,150,50,150,50,150,600,0.9339622641509434,2.0
91,90,72,90,129,108,580,0.896,60,45,70,45,90,95,405,0.7304964539007093,1.0
70,120,40,95,40,95,460,0.8106060606060606,80,160,60,170,130,80,680,0.6180555555555556,1.0
45,65,34,40,34,45,263,0.2589928057553957,70,145,88,140,70,112,625,0.8888888888888888,1.0
60,100,85,80,85,100,510,0.7007874015748031,75,100,63,80,63,116,497,0.9345794392523364,1.0
60,85,69,60,69,77,420,0.518796992481203,80,90,80,130,110,110,600,0.856,1.0
65,95,100,60,50,50,420,0.34959349593495936,60,115,105,65,70,80,495,0.7181818181818181,1.0
62,44,50,44,50,55,305,0.3629032258064516,83,80,75,70,70,101,479,0.8615384615384616,1.0
90,70,80,70,95,70,475,0.5190839694656488,60,40,60,40,60,35,295,0.18055555555555555,1.0
105,105,75,65,100,50,500,0.37593984962406013,75,95,95,95,95,85,540,0.6470588235294118,1.0
95,65,65,110,130,60,525,0.4016393442622951,59,59,58,90,70,73,409,0.5826086956521739,0.5
45,25,50,25,25,35,205,0.13076923076923078,104,91,63,91,73,68,490,0.5118110236220472,1.0
38,30,85,55,65,30,303,0.21428571428571427,71,95,85,110,95,79,535,0.664,1.0
60,60,60,35,35,30,280,0.11194029850746269,25,35,70,95,55,45,325,0.16783216783216784,0.5
65,73,55,47,75,85,400,0.6846846846846847,45,80,100,35,37,28,325,0.3125,0.25
50,25,28,45,55,15,218,0.0625,60,70,105,70,120,75,500,0.5983606557377049,1.0
70,70,115,130,90,60,535,0.5338983050847458,45,90,20,65,20,65,305,0.5116279069767442,1.0
75,98,63,98,63,101,498,0.8091603053435115,90,130,80,65,85,55,505,0.4396551724137931,1.0
79,85,60,55,60,71,410,0.60431654676259,70,95,125,65,75,45,475,0.33613445378151263,1.0
80,125,75,40,95,85,500,0.6911764705882353,78,81,71,74,69,126,499,0.9090909090909091,0.125
100,100,100,100,100,100,600,0.8602941176470589,78,92,75,74,63,118,500,0.8842975206611571,0.5
86,68,72,109,66,106,507,0.8099173553719008,100,134,110,95,100,61,600,0.4057971014492754,0.25
20,10,230,10,230,5,505,0.0,40,40,50,30,30,30,220,0.0873015873015873,2.0
100,150,110,95,110,70,635,0.5923076923076923,60,62,63,80,80,60,405,0.38016528925619836,0.5
60,100,85,80,85,100,510,0.7007874015748031,40,80,100,30,30,20,300,0.11851851851851852,4.0
76,147,90,60,70,97,540,0.8267716535433071,40,70,130,60,130,25,455,0.17355371900826447,1.0
64,165,75,93,83,75,555,0.6587301587301587,30,40,70,70,25,60,295,0.41353383458646614,1.0
70,40,50,55,50,25,290,0.061068702290076333,50,70,160,70,160,90,600,0.7417218543046358,1.0
20,40,90,30,90,25,295,0.11363636363636363,45,60,32,50,32,76,295,0.5925925925925926,1.0
85,105,55,85,50,115,495,0.9032258064516129,61,78,95,56,58,57,405,0.40336134453781514,0.5
60,40,60,95,60,55,370,0.4222222222222222,105,95,75,85,75,74,509,0.5714285714285714,0.5
65,90,122,58,75,84,494,0.71875,40,80,100,30,30,20,300,0.11851851851851852,4.0
120,100,85,30,85,45,465,0.22448979591836735,95,70,73,95,90,60,483,0.3983739837398374,0.5
50,50,77,95,77,91,440,0.5916666666666667,50,85,125,85,115,20,480,0.4306569343065693,1.0
35,40,100,90,55,35,355,0.1796875,160,110,65,65,110,30,540,0.35714285714285715,1.0
50,64,50,45,50,41,300,0.22727272727272727,90,75,85,115,90,55,510,0.3445378151260504,2.0
60,100,89,55,69,112,485,0.9298245614035088,123,77,72,99,92,58,521,0.4621212121212121,0.5
44,48,65,50,64,43,314,0.1623931623931624,70,45,48,60,65,35,323,0.15748031496062992,1.0
60,65,70,85,75,40,395,0.21705426356589147,78,92,75,74,63,118,500,0.8842975206611571,0.5
55,55,55,85,55,30,335,0.1320754716981132,44,50,91,24,86,10,305,0.1981981981981982,0.5
40,45,40,62,60,60,307,0.33884297520661155,60,60,60,35,35,30,280,0.11194029850746269,1.0
54,78,103,53,45,22,355,0.23255813953488372,60,50,70,50,90,65,385,0.39568345323741005,2.0
85,97,66,105,66,65,484,0.47107438016528924,58,50,145,95,105,30,483,0.2459016393442623,1.0
30,40,70,70,25,60,295,0.41353383458646614,45,49,49,65,65,45,318,0.2781954887218045,0.5
82,80,86,85,75,72,480,0.6183206106870229,40,29,45,29,45,36,224,0.14634146341463414,1.0
70,120,65,45,85,125,510,0.9747899159663865,45,95,50,40,50,75,355,0.54,1.0
73,76,75,81,100,100,505,0.8110236220472441,80,185,115,40,105,75,600,0.6230769230769231,2.0
60,48,45,43,90,42,328,0.21897810218978103,60,115,105,65,70,80,495,0.7181818181818181,1.0
76,147,90,60,70,97,540,0.8267716535433071,50,30,55,65,55,20,275,0.13675213675213677,1.0
75,95,125,45,75,95,510,0.8257575757575758,100,123,75,57,75,80,510,0.6923076923076923,0.0
80,160,80,130,80,100,630,0.8455284552845529,76,65,45,92,42,91,411,0.7449664429530202,1.0
20,10,230,10,230,5,505,0.0,80,105,105,105,105,80,580,0.5939849624060151,2.0
100,70,70,65,65,45,415,0.1897810218978102,36,50,50,65,60,44,305,0.16363636363636364,1.0
45,95,50,40,50,75,355,0.54,50,30,55,65,55,20,275,0.13675213675213677,0.5
95,85,85,65,65,35,430,0.2571428571428571,40,35,30,20,20,50,195,0.23423423423423423,1.0
75,80,95,90,100,50,490,0.2158273381294964,60,55,145,75,150,40,525,0.2,1.0
38,36,38,32,36,57,237,0.3893805309734513,72,58,80,103,80,97,490,0.7171052631578947,1.0
40,50,90,30,55,65,330,0.44680851063829785,57,24,86,24,86,23,300,0.12727272727272726,0.0
73,95,62,85,65,85,465,0.6666666666666666,62,77,62,50,42,65,358,0.4838709677419355,1.0
38,36,38,32,36,57,237,0.3893805309734513,75,80,70,65,75,90,455,0.7578125,1.0
65,75,105,35,65,85,430,0.6940298507462687,85,100,122,58,75,54,494,0.3939393939393939,1.0
40,65,95,60,45,35,340,0.13986013986013987,91,90,129,90,72,108,580,0.9140625,0.0
70,75,60,105,60,105,475,0.88,80,120,130,55,65,45,495,0.37037037037037035,0.0
74,48,76,83,81,104,466,0.7322834645669292,50,50,40,30,30,50,250,0.2781954887218045,2.0
65,76,84,54,96,105,480,0.9008264462809917,84,71,43,71,43,48,360,0.25874125874125875,1.0
44,58,44,58,44,61,309,0.41964285714285715,90,110,80,100,80,95,555,0.7982456140350878,0.5
35,46,34,35,45,20,215,0.072,91,90,129,90,72,108,580,0.9140625,0.5
80,160,80,130,80,100,630,0.8455284552845529,45,30,40,105,50,20,290,0.031007751937984496,0.5
65,83,57,95,85,105,490,0.8914728682170543,54,66,70,44,55,46,335,0.4214876033057851,0.5
60,50,70,50,90,65,385,0.39568345323741005,60,62,80,63,80,60,405,0.4336283185840708,4.0
100,150,140,100,90,90,670,0.7969924812030075,123,100,62,97,81,68,531,0.4806201550387597,0.5
70,60,125,115,70,55,495,0.35507246376811596,95,75,110,100,80,30,490,0.15267175572519084,0.5
60,75,100,55,80,50,420,0.3088235294117647,38,41,40,50,65,65,299,0.4108527131782946,0.5
85,97,66,105,66,65,484,0.47107438016528924,44,38,39,61,79,42,303,0.2251655629139073,1.0
70,95,125,65,75,45,475,0.33613445378151263,130,65,60,110,95,65,525,0.5227272727272727,1.0
55,95,115,45,45,35,390,0.2116788321167883,78,65,68,112,154,75,552,0.628099173553719,1.0
135,85,40,40,85,5,390,0.6864406779661016,40,70,40,35,40,60,285,0.392,1.0
25,35,70,95,55,45,325,0.16783216783216784,75,103,80,70,80,92,500,0.7933884297520661,0.5
106,90,130,90,154,110,680,0.8699186991869918,65,83,57,95,85,105,490,0.8914728682170543,0.5
40,60,40,40,40,30,250,0.0948905109489051,100,123,75,57,75,80,510,0.6923076923076923,0.5
35,64,85,74,55,32,345,0.19827586206896552,95,109,105,75,85,56,525,0.34513274336283184,1.0
41,64,45,50,50,50,300,0.36752136752136755,100,5,5,15,65,30,220,0.07692307692307693,1.0
65,80,140,40,70,70,465,0.5223880597014925,30,105,90,25,25,50,325,0.2773722627737226,0.5
58,70,45,40,45,42,300,0.25925925925925924,50,50,150,50,150,50,500,0.2571428571428571,0.0
108,100,121,81,95,95,600,0.7476635514018691,70,115,60,115,60,55,475,0.4647887323943662,0.5
45,90,20,65,20,65,305,0.5116279069767442,89,124,80,55,80,55,483,0.5714285714285714,4.0
70,110,180,60,60,50,530,0.4117647058823529,75,100,63,80,63,116,497,0.9345794392523364,0.5
35,35,40,35,55,50,250,0.40336134453781514,90,120,120,60,60,50,500,0.35294117647058826,2.0
80,82,78,95,80,85,500,0.6869565217391305,65,130,60,75,60,75,465,0.689922480620155,1.0
50,95,180,85,45,70,525,0.5298507462686567,45,30,40,105,50,20,290,0.031007751937984496,1.0
86,92,88,68,75,73,482,0.6835443037974683,50,60,60,60,60,30,320,0.11290322580645161,2.0
60,40,60,95,60,55,370,0.4222222222222222,40,40,50,30,30,30,220,0.0873015873015873,2.0
80,92,65,65,80,68,450,0.4824561403508772,52,65,50,45,50,38,300,0.27419354838709675,0.5
150,160,100,95,65,100,670,0.8866666666666667,70,60,125,115,70,55,495,0.35507246376811596,0.5
53,54,53,37,46,45,288,0.3090909090909091,55,45,43,55,43,72,313,0.5853658536585366,1.0
40,35,30,20,20,50,195,0.23423423423423423,50,105,79,35,110,76,455,0.6214285714285714,0.5
75,110,110,110,105,80,590,0.656934306569343,130,65,60,110,95,65,525,0.5227272727272727,1.0
64,165,75,93,83,75,555,0.6587301587301587,65,55,115,100,40,60,435,0.3798449612403101,1.0
70,120,40,95,40,95,460,0.8106060606060606,55,40,85,80,105,40,405,0.23622047244094488,0.5
100,100,80,60,60,50,450,0.3050847457627119,125,130,90,130,90,95,660,0.7734375,1.0
65,75,105,35,65,85,430,0.6940298507462687,91,72,90,129,90,108,580,0.8620689655172413,2.0
70,80,65,90,65,85,455,0.578125,78,92,75,74,63,118,500,0.8842975206611571,1.0
38,30,41,30,41,60,240,0.2897196261682243,105,125,100,60,100,100,590,0.8359375,1.0
80,120,80,120,80,100,580,0.8478260869565217,68,65,65,125,115,80,518,0.6461538461538462,1.0
73,95,62,85,65,85,465,0.6666666666666666,50,65,107,105,107,86,520,0.7313432835820896,1.0
100,75,115,90,115,85,580,0.6446280991735537,80,120,80,120,80,100,580,0.8478260869565217,1.0
50,72,35,35,35,65,292,0.5373134328358209,44,50,91,24,86,10,305,0.1981981981981982,1.0
80,50,100,100,200,50,580,0.2357142857142857,60,70,50,100,50,65,395,0.5217391304347826,2.0
65,150,60,115,60,115,565,0.935251798561151,70,90,90,135,90,125,600,0.9401709401709402,0.5
103,60,126,80,126,50,545,0.36363636363636365,50,120,53,35,110,87,455,0.640625,2.0
70,80,70,80,70,110,480,0.6594202898550725,76,25,45,67,55,24,292,0.0390625,2.0
65,150,60,115,60,115,565,0.935251798561151,20,10,230,10,230,5,505,0.0,1.0
65,110,130,60,65,95,525,0.8278145695364238,62,50,58,73,54,72,369,0.4435483870967742,0.5
54,45,47,75,98,52,371,0.39669421487603307,50,65,107,105,107,86,520,0.7272727272727273,1.0
90,92,87,75,85,76,505,0.5409836065573771,50,53,62,58,63,44,330,0.13709677419354838,1.0
85,76,64,45,55,90,415,0.6739130434782609,85,110,90,45,90,80,500,0.6206896551724138,1.0
60,65,70,85,75,40,395,0.21705426356589147,70,90,70,60,60,70,420,0.6390977443609023,1.0
80,135,85,70,95,150,615,0.9844961240310077,55,75,60,75,60,103,428,0.7982456140350878,1.0
60,70,50,100,50,65,395,0.5217391304347826,100,70,70,65,65,45,415,0.1897810218978102,1.0
40,27,60,37,50,66,280,0.36220472440944884,40,45,65,100,120,90,460,0.5588235294117647,1.0
51,65,65,80,75,59,395,0.4365079365079365,95,155,109,70,130,81,640,0.6788321167883211,0.5
110,85,95,80,95,50,515,0.2713178294573643,85,135,130,60,80,25,515,0.40540540540540543,0.5
60,60,75,60,75,80,410,0.7321428571428571,40,35,30,120,70,105,400,0.6692307692307692,0.25
60,70,50,100,50,65,395,0.5217391304347826,35,35,35,35,35,35,210,0.13385826771653545,1.0
100,90,130,45,65,55,485,0.4253731343283582,80,95,82,60,82,75,474,0.6,1.0
48,72,48,72,48,48,336,0.25984251968503935,104,91,63,91,73,68,490,0.5118110236220472,1.0
60,75,85,100,85,115,520,0.8992248062015504,62,55,52,109,94,109,481,0.7833333333333333,1.0
103,60,126,80,126,50,545,0.36363636363636365,60,60,60,85,85,85,435,0.631578947368421,0.0
65,60,110,130,95,65,525,0.47761194029850745,65,40,50,125,60,30,370,0.07258064516129033,1.0
70,90,110,60,75,95,500,0.7333333333333333,115,45,20,45,25,20,270,0.11538461538461539,1.0
67,125,40,30,30,58,350,0.3431372549019608,28,25,25,45,35,40,198,0.16083916083916083,1.0
45,60,32,50,32,76,295,0.5925925925925926,85,115,80,105,80,50,515,0.3063063063063063,0.5
67,89,116,79,116,33,500,0.2624113475177305,80,120,70,110,70,80,530,0.6422764227642277,0.5
90,30,15,40,20,15,210,0.043478260869565216,55,95,55,35,75,115,430,0.9380530973451328,2.0
65,105,60,60,70,95,455,63.0,40,45,35,65,55,70,310,0.4482758620689655,1.0
71,120,95,120,95,99,600,0.8203125,50,65,107,105,107,86,520,0.6991150442477876,0.125
126,131,95,131,98,99,680,0.8294573643410853,38,35,40,27,25,35,200,0.08208955223880597,1.0
60,40,80,60,45,40,325,0.23529411764705882,103,93,67,71,61,84,479,0.7142857142857143,0.0
50,160,110,160,110,110,700,0.8854961832061069,35,45,160,30,45,70,385,0.48148148148148145,0.5
91,90,106,130,106,77,600,0.648854961832061,65,75,90,97,123,44,494,0.1987179487179487,0.5
55,40,40,65,45,35,280,0.16428571428571428,70,110,180,60,60,50,530,0.4117647058823529,1.0
40,65,40,80,40,65,330,0.5038167938931297,80,92,65,65,80,68,450,0.4824561403508772,1.0
20,25,45,70,90,60,310,0.30833333333333335,50,95,90,95,90,180,600,0.9172413793103448,0.5
53,54,53,37,46,45,288,0.3090909090909091,65,60,70,85,75,40,395,0.1796875,1.0
80,120,79,95,79,70,523,0.5833333333333334,65,125,60,95,60,105,510,0.9236641221374046,1.0
70,70,70,70,70,70,420,0.5289256198347108,46,87,60,30,40,57,320,0.37777777777777777,1.0
65,90,50,85,45,55,390,0.371900826446281,75,87,63,87,63,98,473,0.865546218487395,1.0
60,55,90,145,90,80,520,0.6071428571428571,95,75,180,130,80,30,590,0.13793103448275862,1.0
135,85,40,40,85,5,390,0.6864406779661016,55,47,52,40,40,41,275,0.16806722689075632,1.0
80,80,90,110,130,110,600,0.8721804511278195,91,134,95,100,100,80,600,0.6304347826086957,2.0
55,40,50,65,85,40,335,0.3181818181818182,10,55,25,35,45,95,265,0.5396825396825397,2.0
80,50,100,100,200,50,580,0.2357142857142857,80,52,50,90,50,89,411,0.6666666666666666,2.0
76,25,45,67,55,24,292,0.0390625,60,40,60,95,60,55,370,0.4222222222222222,1.0
75,75,60,83,60,60,413,0.39344262295081966,75,103,80,70,80,92,500,0.7933884297520661,0.5
58,89,77,45,45,48,362,0.3177570093457944,70,135,105,60,105,20,495,0.5806451612903226,0.5
90,120,100,150,120,100,680,0.7718120805369127,75,90,90,140,90,115,600,0.9481481481481482,2.0
80,115,80,65,55,93,488,0.7846153846153846,45,60,40,70,50,45,310,0.2846715328467153,1.0
95,117,80,65,70,92,519,0.8409090909090909,95,100,85,108,70,70,528,0.5652173913043478,1.0
65,76,84,54,96,105,480,0.9008264462809917,60,100,115,70,85,90,520,0.7557251908396947,0.5
50,53,48,53,48,64,316,0.46153846153846156,40,35,30,20,20,50,195,0.23423423423423423,2.0
65,95,100,60,50,50,420,0.34959349593495936,90,95,105,165,110,45,610,0.2890625,2.0
95,125,79,60,100,81,540,0.6165413533834586,40,30,30,55,30,85,270,0.4666666666666667,0.5
75,80,95,90,100,50,490,0.2158273381294964,55,85,122,58,75,99,494,0.8099173553719008,0.5
106,190,100,154,100,130,780,0.9259259259259259,90,92,75,92,85,60,494,0.49586776859504134,2.0
50,52,48,65,50,55,320,0.33098591549295775,80,120,80,120,80,100,580,0.8478260869565217,1.0
116,55,85,107,95,29,487,0.06818181818181818,100,128,90,77,77,128,600,0.959349593495935,1.0
30,40,70,70,25,60,295,0.41353383458646614,70,70,70,70,70,70,420,0.5289256198347108,1.0
75,75,55,105,85,30,425,0.1619718309859155,84,86,88,111,101,60,530,0.4634146341463415,1.0
30,40,55,40,55,60,280,0.3237410071942446,90,60,70,75,70,45,410,0.23880597014925373,2.0
89,145,90,105,80,91,600,0.8549618320610687,110,130,80,70,60,80,530,0.5862068965517241,1.0
75,140,65,112,65,110,567,0.9140625,61,72,57,55,55,65,365,0.3984375,1.0
90,130,80,65,85,55,505,0.4396551724137931,95,125,79,60,100,81,540,0.6165413533834586,0.5
65,60,110,130,95,65,525,0.47761194029850745,62,77,62,50,42,65,358,0.4838709677419355,2.0
50,50,40,30,30,50,250,0.2781954887218045,100,100,100,100,100,100,600,0.831858407079646,1.0
50,64,50,45,50,41,300,0.22727272727272727,55,75,50,40,40,80,340,0.6302521008403361,0.0
80,185,115,40,105,75,600,0.6230769230769231,53,54,53,37,46,45,288,0.3090909090909091,4.0
50,25,28,45,55,15,218,0.0625,45,65,34,40,34,45,263,0.2589928057553957,1.0
50,55,50,36,30,43,264,0.2922077922077922,50,60,45,100,80,65,400,0.45689655172413796,2.0
77,120,90,60,90,48,485,0.2785714285714286,45,45,55,45,55,63,308,0.4594594594594595,1.0
80,135,130,95,90,70,600,0.5181818181818182,85,100,122,58,75,54,494,0.3939393939393939,1.0
105,140,55,30,55,95,480,0.8195488721804511,50,53,48,53,48,64,316,0.4076923076923077,2.0
90,90,85,125,90,100,580,0.768595041322314,90,85,100,95,125,85,580,0.6834532374100719,2.0
85,105,100,79,83,78,530,0.5869565217391305,70,120,100,145,105,20,560,0.2824427480916031,4.0
90,100,70,110,150,80,600,0.6037735849056604,38,35,35,65,55,50,278,0.2647058823529412,0.0
90,100,70,110,150,80,600,0.6037735849056604,150,100,120,100,120,90,680,0.6666666666666666,2.0
80,110,120,130,90,70,600,0.6198347107438017,60,95,80,60,80,30,405,0.19480519480519481,2.0
68,75,53,83,113,60,452,0.45384615384615384,65,75,90,97,123,44,494,0.1987179487179487,2.0
60,60,60,85,85,85,435,0.631578947368421,50,64,50,45,50,41,300,0.22727272727272727,1.0
95,60,79,100,125,81,540,0.6201550387596899,95,95,85,125,65,55,520,0.3894736842105263,0.5
60,80,110,50,80,45,425,0.2833333333333333,50,53,48,53,48,64,316,0.46153846153846156,2.0
165,75,80,40,45,65,470,0.5151515151515151,50,53,48,53,48,64,316,0.358974358974359,0.5
90,92,87,75,85,76,505,0.5409836065573771,68,75,53,83,113,60,452,0.45384615384615384,1.0
70,50,30,95,135,105,485,0.8040540540540541,60,85,69,65,79,80,438,0.576,1.0
40,40,55,40,70,55,300,0.40939597315436244,85,70,80,97,80,123,535,0.9304347826086956,0.0
35,55,35,30,30,35,220,0.23684210526315788,123,77,72,99,92,58,521,0.4621212121212121,1.0
40,20,30,40,80,55,265,0.22764227642276422,100,100,100,100,100,100,600,0.8602941176470589,4.0
67,125,40,30,30,58,350,0.3431372549019608,72,95,67,103,71,122,530,0.9606299212598425,1.0
65,47,55,73,75,85,400,0.65,35,45,160,30,45,70,385,0.48148148148148145,1.0
85,110,90,45,90,80,500,0.6206896551724138,75,98,63,98,63,101,498,0.889763779527559,1.0
65,63,45,45,45,45,308,0.2595419847328244,50,45,45,35,35,50,260,0.23529411764705882,1.0
60,85,69,65,79,80,438,0.576,55,45,43,55,43,72,313,0.5853658536585366,1.0
90,95,95,70,90,70,510,0.5230769230769231,70,40,50,55,50,25,290,0.061068702290076333,1.0
60,25,35,70,80,60,330,0.3076923076923077,40,50,90,30,55,65,330,0.44680851063829785,2.0
50,50,40,50,40,64,294,0.45588235294117646,110,78,73,76,71,60,468,0.3333333333333333,1.0
70,95,85,55,65,70,440,0.5,60,130,80,60,60,70,460,0.5153846153846153,0.5
71,73,88,120,89,59,500,0.43537414965986393,55,70,55,40,55,85,360,0.7073170731707317,1.0
45,35,45,62,53,35,275,0.11851851851851852,110,135,60,50,65,88,508,0.7744360902255639,1.0
84,71,43,71,43,48,360,0.25874125874125875,75,85,200,55,65,30,510,0.16778523489932887,0.5
76,147,90,60,70,97,540,0.8267716535433071,70,45,48,60,65,35,323,0.15748031496062992,0.0
100,100,100,100,100,100,600,0.8602941176470589,70,110,75,145,85,145,630,0.9444444444444444,0.25
60,55,50,40,55,45,305,0.22377622377622378,75,125,75,30,75,85,465,0.625,0.5
65,40,50,125,60,30,370,0.07258064516129033,35,70,55,45,55,25,285,0.09420289855072464,1.0
30,45,55,70,55,85,340,0.5633802816901409,100,150,110,95,110,70,635,0.5923076923076923,1.0
125,130,90,130,90,95,660,0.7734375,65,80,80,59,63,58,405,0.4411764705882353,0.5
95,124,78,69,71,58,495,0.37398373983739835,70,145,88,140,70,112,625,0.8888888888888888,1.0
41,50,37,50,37,66,281,0.5175438596491229,45,60,30,80,50,65,330,0.4603174603174603,0.5
40,55,30,30,30,60,245,0.43548387096774194,30,105,90,25,25,50,325,0.2773722627737226,1.0
65,47,55,73,75,85,400,0.65,100,150,90,180,160,90,770,0.7348484848484849,1.0
109,66,84,81,99,32,471,0.2013888888888889,60,85,69,60,69,77,420,0.518796992481203,1.0
75,75,60,83,60,60,413,0.39344262295081966,50,105,125,55,95,50,480,0.375886524822695,1.0
65,90,115,45,115,58,488,0.5041322314049587,65,75,105,35,65,85,430,0.6940298507462687,0.5
65,125,100,60,70,70,490,0.6099290780141844,91,134,95,100,100,80,600,0.6304347826086957,1.0
80,105,65,60,75,130,515,0.9645390070921985,46,87,60,30,40,57,320,0.37777777777777777,1.0
60,45,70,45,90,95,405,0.7304964539007093,255,10,10,75,135,55,540,0.3125,1.0
59,66,70,44,55,41,335,0.25190839694656486,44,58,44,58,44,61,309,0.41964285714285715,0.5
35,55,40,50,50,90,320,0.6838235294117647,20,10,230,10,230,5,505,0.0,1.0
110,123,65,100,65,65,528,0.5217391304347826,50,60,60,60,60,30,320,0.11290322580645161,0.25
95,145,130,120,90,120,700,0.9398496240601504,90,60,70,75,70,45,410,0.23880597014925373,1.0
43,80,65,50,35,35,308,0.14193548387096774,70,80,102,80,102,40,474,0.2677165354330709,1.0
123,77,72,99,92,58,521,0.4621212121212121,66,41,77,61,87,23,355,0.12096774193548387,2.0
85,80,70,135,75,90,535,0.7006802721088435,35,35,40,35,55,50,250,0.40336134453781514,1.0
99,68,83,72,87,51,460,0.417910447761194,92,105,90,125,90,98,600,0.8217054263565892,0.5
68,165,95,65,115,110,618,0.8615384615384616,60,60,40,65,45,35,305,0.15833333333333333,2.0
64,165,75,93,83,75,555,0.6587301587301587,55,35,50,55,110,85,390,0.6277372262773723,1.0
100,5,5,15,65,30,220,0.07692307692307693,39,52,43,60,50,65,309,0.5041322314049587,1.0
80,85,95,30,30,25,345,0.2857142857142857,80,160,80,130,80,100,630,0.8455284552845529,2.0
50,35,55,25,25,15,205,0.05263157894736842,97,165,60,65,50,58,495,0.3902439024390244,1.0
60,85,42,85,42,91,405,0.8227848101265823,60,70,65,125,105,90,515,0.6911764705882353,2.0
80,45,65,90,110,80,470,0.5462962962962963,40,80,35,35,45,70,305,0.4661016949152542,1.0
45,49,49,65,65,45,318,0.2781954887218045,30,45,135,45,90,30,375,0.09285714285714286,1.0
110,130,80,70,60,80,530,0.5862068965517241,100,70,70,65,65,45,415,0.1897810218978102,1.0
59,110,150,45,49,35,448,0.3333333333333333,55,70,40,60,40,40,305,0.26956521739130435,2.0
75,98,63,98,63,101,498,0.8091603053435115,95,23,48,23,48,23,260,0.046153846153846156,1.0
60,80,95,70,85,50,440,0.2231404958677686,65,95,75,55,55,85,430,0.6933333333333334,0.5
50,70,100,40,40,30,330,0.2222222222222222,40,55,99,40,79,47,360,0.26262626262626265,2.0
75,75,55,105,85,30,425,0.1619718309859155,50,50,40,50,40,64,294,0.45588235294117646,2.0
35,64,85,74,55,32,345,0.19827586206896552,60,100,89,55,69,112,485,0.9298245614035088,1.0
72,60,30,20,30,25,237,0.11570247933884298,80,75,150,75,150,50,580,0.30973451327433627,2.0
60,80,50,50,50,40,330,0.23853211009174313,80,145,150,105,110,110,700,0.8692307692307693,0.5
90,130,80,65,85,55,505,0.4396551724137931,100,100,100,100,100,100,600,0.8778625954198473,0.5
115,115,85,90,75,100,580,0.8134328358208955,126,131,95,131,98,99,680,0.8102189781021898,1.0
20,25,45,70,90,60,310,0.30833333333333335,78,70,61,50,61,100,420,0.8145161290322581,1.0
54,63,52,83,56,97,405,0.7697841726618705,90,70,80,70,95,70,475,0.5190839694656488,0.5
60,60,75,60,75,80,410,0.7321428571428571,86,81,97,81,107,43,495,0.203125,2.0
65,80,80,59,63,58,405,0.4411764705882353,55,70,45,70,50,60,350,0.45,2.0
70,70,70,70,70,70,420,0.5289256198347108,60,65,60,130,75,110,500,0.7719298245614035,0.0
110,65,75,125,85,30,490,0.15,40,50,45,70,45,70,320,0.5517241379310345,0.5
38,41,40,50,65,65,299,0.4108527131782946,65,75,105,35,65,85,430,0.6940298507462687,1.0
45,65,34,40,34,45,263,0.2589928057553957,70,115,60,115,60,55,475,0.4647887323943662,0.5
150,160,100,95,65,100,670,0.8866666666666667,65,155,120,65,90,105,600,0.8677685950413223,1.0
45,45,55,45,55,63,308,0.4594594594594595,40,70,40,35,40,60,285,0.392,1.0
65,90,120,85,70,60,490,0.43410852713178294,59,59,58,90,70,73,409,0.5826086956521739,1.0
100,50,80,60,80,50,420,0.34375,55,69,85,32,35,28,304,0.09302325581395349,1.0
85,97,66,105,66,65,484,0.47107438016528924,100,100,100,100,100,100,600,0.831858407079646,1.0
99,68,83,72,87,51,460,0.417910447761194,108,170,115,120,95,92,700,0.7083333333333334,1.0
55,50,65,175,95,150,590,0.7818181818181819,40,60,40,40,40,30,250,0.0948905109489051,2.0
73,115,60,60,60,90,458,0.6694915254237288,45,45,55,45,55,63,308,0.4594594594594595,1.0
80,120,79,95,79,70,523,0.5833333333333334,105,95,75,85,75,74,509,0.5714285714285714,0.0
40,45,35,65,55,70,310,0.4482758620689655,65,125,100,55,70,85,500,0.6532258064516129,0.5
80,105,105,105,105,80,580,0.5939849624060151,80,100,123,122,120,80,625,0.56,2.0
50,50,120,80,80,30,410,0.07258064516129033,45,30,15,85,65,65,305,0.36220472440944884,4.0
75,90,140,60,60,40,465,0.3008130081300813,45,100,135,65,135,45,525,0.29411764705882354,0.5
40,80,100,30,30,20,300,0.11851851851851852,70,60,125,115,70,55,495,0.35507246376811596,2.0
70,60,62,80,82,60,414,0.4375,106,130,90,110,154,90,680,0.719626168224299,0.25
75,80,85,110,90,50,490,0.3548387096774194,99,68,83,72,87,51,460,0.417910447761194,0.5
110,123,65,100,65,65,528,0.5217391304347826,86,81,97,81,107,43,495,0.203125,2.0
160,110,65,65,110,30,540,0.35714285714285715,20,40,15,35,35,60,205,0.34285714285714286,1.0
60,45,50,90,80,70,395,0.625,65,90,50,85,45,55,390,0.371900826446281,2.0
55,47,52,40,40,41,275,0.16806722689075632,35,45,160,30,45,70,385,0.48148148148148145,0.25
65,95,100,60,50,50,420,0.34959349593495936,80,80,90,110,130,110,600,0.8721804511278195,2.0
65,95,75,55,55,85,430,0.6933333333333334,70,55,75,45,65,60,370,0.45901639344262296,1.0
103,60,126,80,126,50,545,0.36363636363636365,90,60,60,40,40,40,330,0.29545454545454547,1.0
50,65,107,105,107,86,520,0.7758620689655172,55,85,55,50,55,60,360,0.4233576642335766,2.0
70,65,60,90,75,90,450,0.6571428571428571,60,110,70,60,60,100,460,0.8461538461538461,0.5
38,30,41,30,41,60,240,0.2897196261682243,60,50,70,50,90,65,385,0.39568345323741005,1.0
65,95,100,60,50,50,420,0.34959349593495936,55,104,105,94,75,52,485,0.36363636363636365,1.0
45,49,49,65,65,45,318,0.2781954887218045,55,40,40,65,45,35,280,0.16428571428571428,1.0
60,50,70,50,90,65,385,0.39568345323741005,95,65,110,60,130,65,525,0.5275590551181102,2.0
45,50,43,40,38,62,278,0.40441176470588236,95,145,130,120,90,120,700,0.9398496240601504,1.0
45,90,20,65,20,65,305,0.5116279069767442,45,80,100,35,37,28,325,0.3125,2.0
64,115,65,83,63,65,455,0.5323741007194245,91,72,90,129,90,108,580,0.8620689655172413,1.0
55,65,95,95,45,85,440,0.6610169491525424,55,70,55,40,55,85,360,0.7073170731707317,1.0
106,110,90,154,90,130,680,0.926829268292683,64,88,50,88,50,106,446,0.9111111111111111,0.0
45,50,55,75,65,30,320,0.06293706293706294,50,52,48,65,50,55,320,0.33098591549295775,2.0
95,23,48,23,48,23,260,0.046153846153846156,55,20,35,20,45,75,250,0.37681159420289856,1.0
100,100,100,100,100,100,600,0.8345864661654135,64,88,50,88,50,106,446,0.9111111111111111,0.0
45,45,35,20,30,20,195,0.07246376811594203,91,90,106,130,106,77,600,0.648854961832061,0.25
110,85,95,80,95,50,515,0.2713178294573643,60,60,60,105,105,105,495,0.848,0.0
70,20,50,20,50,40,250,0.1557377049180328,85,110,76,65,82,56,474,0.3933333333333333,0.5
75,80,60,65,90,102,472,0.8625954198473282,80,120,80,120,80,100,580,0.8478260869565217,1.0
150,160,100,95,65,100,670,0.8866666666666667,60,130,80,60,60,70,460,0.5153846153846153,1.0
40,27,60,37,50,66,280,0.36220472440944884,55,75,85,25,25,15,280,0.1875,2.0
41,64,45,50,50,50,300,0.36752136752136755,50,45,45,35,35,50,260,0.23529411764705882,1.0
80,82,100,83,100,80,525,0.6821705426356589,40,60,40,40,40,30,250,0.0948905109489051,0.25
80,130,100,160,120,110,700,0.8981481481481481,40,45,35,40,40,90,290,0.65,1.0
58,64,58,80,65,80,405,0.5423728813559322,70,92,65,80,55,98,460,0.8090909090909091,0.5
75,69,72,114,100,104,534,0.8253968253968254,74,108,133,83,65,32,495,0.32142857142857145,0.25
60,69,95,69,95,36,424,0.2608695652173913,55,81,60,50,70,97,413,0.7214285714285714,1.0
80,80,80,55,55,90,440,0.6417910447761194,74,94,131,54,116,20,489,0.4485294117647059,0.5
104,91,63,91,73,68,490,0.5118110236220472,95,125,79,60,100,81,540,0.6165413533834586,1.0
106,90,130,90,154,110,680,0.8699186991869918,70,130,100,55,80,65,500,0.608,0.5
150,120,100,120,100,90,680,0.664179104477612,80,52,50,90,50,89,411,0.6666666666666666,1.0
60,80,110,50,80,45,425,0.2833333333333333,70,80,70,80,70,110,480,0.6594202898550725,1.0
89,124,80,55,80,55,483,0.5714285714285714,55,55,85,65,85,35,380,0.2014388489208633,2.0
35,35,35,35,35,35,210,0.13385826771653545,75,80,85,110,90,50,490,0.3548387096774194,0.5
100,100,90,150,140,90,670,0.71875,80,130,100,160,120,110,700,0.8981481481481481,0.5
40,60,40,40,40,30,250,0.0948905109489051,100,100,100,100,100,100,600,0.8778625954198473,1.0
70,60,125,115,70,55,495,0.35507246376811596,85,115,80,105,80,50,515,0.3063063063063063,1.0
55,85,122,58,75,99,494,0.8099173553719008,38,41,40,50,65,65,299,0.4108527131782946,0.5
72,105,115,54,86,68,500,0.5149253731343284,70,60,125,115,70,55,495,0.35507246376811596,1.0
70,100,115,30,65,30,410,0.24390243902439024,65,65,45,75,45,95,390,0.72,4.0
60,62,80,63,80,60,405,0.4336283185840708,60,62,50,62,60,40,334,0.18181818181818182,0.5
50,60,45,100,80,65,400,0.45689655172413796,105,150,90,150,90,95,680,0.8285714285714286,0.25
82,80,86,85,75,72,480,0.6183206106870229,70,77,60,97,60,108,472,0.8394160583941606,1.0
74,100,72,90,72,46,454,0.24561403508771928,85,80,90,105,95,60,515,0.49074074074074076,1.0
78,84,78,109,85,100,534,0.8620689655172413,100,180,160,150,90,90,770,0.7520661157024794,0.5
65,75,70,95,70,95,470,0.7272727272727273,55,35,50,55,110,85,390,0.6277372262773723,2.0
50,85,55,65,65,90,410,0.7478260869565218,35,45,160,30,45,70,385,0.48148148148148145,0.5
20,40,15,35,35,60,205,0.34285714285714286,50,30,55,65,55,20,275,0.13675213675213677,1.0
69,69,76,69,86,91,460,0.6554621848739496,60,50,40,85,75,95,405,0.7540983606557377,1.0
76,147,90,60,70,97,540,0.8267716535433071,40,60,30,31,31,70,262,0.4492753623188406,1.0
40,65,95,60,45,35,340,0.13986013986013987,75,103,80,70,80,92,500,0.7933884297520661,2.0
45,60,45,25,45,55,275,0.29,110,123,65,100,65,65,528,0.5217391304347826,1.0
75,80,60,65,90,102,472,0.8625954198473282,90,85,75,115,100,115,580,0.9381443298969072,1.0
40,20,30,40,80,55,265,0.22764227642276422,40,45,40,65,40,65,295,0.5661764705882353,0.5
55,50,45,135,95,120,500,0.7714285714285715,78,104,78,159,115,100,634,0.8444444444444444,1.0
50,48,43,46,41,60,288,0.47297297297297297,90,120,100,150,120,100,680,0.7718120805369127,0.25
35,55,40,45,40,60,275,0.35714285714285715,50,50,150,50,150,50,500,0.2571428571428571,1.0
70,75,80,135,80,135,575,0.917910447761194,55,55,55,85,55,30,335,0.1320754716981132,1.0
70,60,75,110,75,90,480,0.7165354330708661,75,103,80,70,80,92,500,0.7933884297520661,0.25
75,80,95,90,100,50,490,0.2158273381294964,40,60,40,40,40,30,250,0.0948905109489051,0.25
60,45,50,90,80,70,395,0.625,57,24,86,24,86,23,300,0.12727272727272726,0.5
59,110,150,45,49,35,448,0.3333333333333333,60,85,69,60,69,77,420,0.518796992481203,0.0
95,155,109,70,130,81,640,0.6788321167883211,80,120,70,110,70,80,530,0.6422764227642277,1.0
40,30,30,55,30,85,270,0.4666666666666667,77,59,50,67,63,46,362,0.23140495867768596,1.0
70,65,60,90,75,90,450,0.6571428571428571,45,63,37,65,55,95,360,0.8055555555555556,1.0
65,45,55,45,70,45,325,0.24369747899159663,55,40,50,65,85,40,335,0.3181818181818182,0.5
50,35,55,25,25,15,205,0.021739130434782608,60,100,115,70,85,90,520,0.7557251908396947,0.5
55,50,40,40,40,75,300,0.5945945945945946,100,150,140,100,90,90,670,0.7969924812030075,1.0
65,130,60,75,60,75,465,0.689922480620155,45,100,135,65,135,45,525,0.29411764705882354,2.0
75,100,63,80,63,116,497,0.9345794392523364,65,110,130,60,65,95,525,0.8278145695364238,0.5
60,82,45,45,45,74,351,0.5752212389380531,65,75,70,95,70,95,470,0.7272727272727273,0.0
75,110,110,110,105,80,590,0.656934306569343,123,77,72,99,92,58,521,0.4621212121212121,1.0
115,45,20,45,25,20,270,0.11538461538461539,60,85,42,85,42,91,405,0.8227848101265823,2.0
86,76,86,116,56,95,515,0.7982456140350878,95,109,105,75,85,56,525,0.34513274336283184,4.0
80,105,105,105,105,80,580,0.5939849624060151,30,80,90,55,45,55,355,0.4295774647887324,1.0
76,104,71,104,71,108,534,0.912751677852349,40,60,40,40,40,30,250,0.0948905109489051,0.5
85,110,76,65,82,56,474,0.3933333333333333,80,70,40,100,60,145,495,0.921875,0.5
50,50,40,30,30,50,250,0.2781954887218045,100,150,110,95,110,70,635,0.5923076923076923,1.0
110,160,110,80,110,100,670,0.8591549295774648,101,72,72,99,89,29,462,0.1937984496124031,1.0
85,50,95,120,115,80,545,0.5793650793650794,64,88,50,88,50,106,446,0.9111111111111111,2.0
65,80,80,59,63,58,405,0.4411764705882353,58,109,112,48,48,109,484,0.8805970149253731,1.0
45,50,55,75,65,30,320,0.06293706293706294,60,55,50,40,55,45,305,0.22377622377622378,0.125
108,170,115,120,95,92,700,0.7083333333333334,40,65,95,60,45,35,340,0.13986013986013987,2.0
115,45,20,45,25,20,270,0.11538461538461539,31,45,90,30,30,40,266,0.21929824561403508,1.0
65,150,40,15,80,145,495,0.9663865546218487,45,95,50,40,50,75,355,0.54,0.5
65,65,45,75,45,95,390,0.72,64,88,50,88,50,106,446,0.9111111111111111,2.0
80,70,40,100,60,145,495,0.921875,111,83,68,92,82,39,475,0.1774193548387097,1.0
90,95,105,165,110,45,610,0.2890625,65,73,55,47,75,85,400,0.6846846846846847,1.0
100,128,90,77,77,128,600,0.959349593495935,85,76,64,45,55,90,415,0.6739130434782609,2.0
50,85,40,85,40,35,335,0.1746031746031746,55,65,35,60,30,85,330,0.6126126126126126,2.0
81,102,77,85,75,85,505,0.5642857142857143,90,75,75,90,100,70,500,0.5462184873949579,1.0
77,85,51,55,51,65,384,0.5163934426229508,105,105,75,65,100,50,500,0.37593984962406013,0.5
60,50,40,85,75,95,405,0.7540983606557377,85,50,95,120,115,80,545,0.5793650793650794,2.0
50,65,107,105,107,86,520,0.7313432835820896,64,51,23,51,23,28,240,0.11363636363636363,1.0
70,55,95,95,110,65,490,0.48872180451127817,60,50,70,80,80,140,480,0.8449612403100775,1.0
80,82,83,100,100,80,525,0.6742424242424242,95,100,85,108,70,70,528,0.5652173913043478,2.0
60,48,45,43,90,42,328,0.21897810218978103,60,90,140,50,50,40,430,0.2535211267605634,0.5
72,60,30,20,30,25,237,0.11570247933884298,80,100,80,80,80,100,520,0.9051724137931034,1.0
55,85,122,58,75,99,494,0.8099173553719008,69,69,76,69,86,91,460,0.6554621848739496,2.0
85,70,80,97,80,123,535,0.9304347826086956,58,64,58,80,65,80,405,0.5423728813559322,1.0
108,112,118,68,72,47,525,0.2916666666666667,40,80,35,35,45,70,305,0.4661016949152542,1.0
70,45,48,60,65,35,323,0.15748031496062992,50,75,35,70,30,40,300,0.21296296296296297,0.5
90,120,75,60,60,45,450,0.29411764705882354,83,80,80,135,80,121,579,0.9444444444444444,1.0
55,68,64,45,55,31,318,0.11666666666666667,70,75,60,105,60,105,475,0.88,1.0
75,110,110,110,105,80,590,0.656934306569343,68,85,65,165,135,100,618,0.8083333333333333,0.0
50,150,50,150,50,150,600,0.9339622641509434,110,65,75,125,85,30,490,0.15,0.5
45,80,100,35,37,28,325,0.3125,55,50,65,175,95,150,590,0.7818181818181819,2.0
53,54,53,37,46,45,288,0.3090909090909091,120,120,120,120,120,120,720,0.9344262295081968,1.0
130,65,60,110,95,65,525,0.5227272727272727,75,70,90,70,105,80,490,0.656,0.5
85,135,130,60,80,25,515,0.40540540540540543,95,95,85,125,65,55,520,0.3894736842105263,1.0
50,95,90,95,90,180,600,0.9172413793103448,50,35,55,25,25,15,205,0.021739130434782608,1.0
20,15,20,10,55,80,200,0.2682926829268293,135,85,40,40,85,5,390,0.6864406779661016,1.0
55,75,60,75,60,103,428,0.7982456140350878,35,55,35,30,30,35,220,0.23684210526315788,1.0
50,47,50,57,50,65,319,0.463768115942029,105,130,120,45,45,40,485,0.4444444444444444,0.0
70,140,70,110,65,105,560,0.95,40,29,45,29,45,36,224,0.14634146341463414,1.0
86,92,88,68,75,73,482,0.6835443037974683,95,110,80,70,80,50,485,0.37209302325581395,1.0
70,80,65,90,65,85,455,0.578125,76,25,45,67,55,24,292,0.0390625,0.5
45,85,50,55,50,65,350,0.5076923076923077,55,47,52,40,40,41,275,0.16806722689075632,0.5
75,80,95,90,100,50,490,0.2158273381294964,55,85,55,50,55,60,360,0.4233576642335766,0.25
28,25,25,45,35,40,198,0.16083916083916083,75,65,55,65,55,69,384,0.43548387096774194,2.0
104,91,63,91,73,68,490,0.5118110236220472,100,90,130,45,65,55,485,0.4253731343283582,0.5
60,52,168,47,138,30,495,0.19834710743801653,40,45,40,65,40,65,295,0.5661764705882353,0.5
60,110,70,60,60,100,460,0.8461538461538461,58,89,77,45,45,48,362,0.3177570093457944,0.25
45,49,49,65,65,45,318,0.2781954887218045,55,40,85,80,105,40,405,0.23622047244094488,1.0
60,130,80,60,60,70,460,0.5153846153846153,59,63,80,65,80,58,405,0.41843971631205673,2.0
40,45,40,62,60,60,307,0.33884297520661155,71,95,85,110,95,79,535,0.664,2.0
70,115,60,115,60,55,475,0.4647887323943662,59,74,50,35,50,35,303,0.3125,4.0
72,85,70,65,70,58,420,0.41304347826086957,62,73,55,56,52,84,382,0.7244094488188977,1.0
50,70,50,50,50,40,310,0.16296296296296298,30,105,90,25,25,50,325,0.2773722627737226,0.5
83,80,75,70,70,101,479,0.8615384615384616,60,82,45,45,45,74,351,0.5752212389380531,1.0
101,72,72,99,89,29,462,0.1937984496124031,10,55,25,35,45,95,265,0.5396825396825397,1.0
76,25,45,67,55,24,292,0.0390625,36,50,50,65,60,44,305,0.16363636363636364,1.0
80,110,120,130,90,70,600,0.6198347107438017,45,49,49,65,65,45,318,0.2781954887218045,1.0
90,95,95,70,90,70,510,0.5230769230769231,85,100,122,58,75,54,494,0.3939393939393939,0.0
71,73,88,120,89,59,500,0.43537414965986393,50,30,55,65,55,20,275,0.13675213675213677,2.0
50,55,50,36,30,43,264,0.2922077922077922,115,115,85,90,75,100,580,0.8134328358208955,1.0
46,87,60,30,40,57,320,0.37777777777777777,31,45,90,30,30,40,266,0.21929824561403508,1.0
55,40,50,65,85,40,335,0.3181818181818182,45,22,60,27,30,29,213,0.07518796992481203,1.0
60,62,80,63,80,60,405,0.4336283185840708,40,55,80,35,60,30,300,0.15037593984962405,0.5
80,135,85,70,95,150,615,0.9844961240310077,80,135,130,95,90,70,600,0.5181818181818182,0.25
106,110,90,154,90,130,680,0.926829268292683,55,70,40,60,40,40,305,0.26956521739130435,1.0
90,90,85,125,90,100,580,0.768595041322314,50,45,45,35,35,50,260,0.23529411764705882,1.0
105,125,100,60,100,100,590,0.8359375,50,50,120,80,80,30,410,0.07258064516129033,0.5
45,25,50,25,25,35,205,0.13076923076923078,45,100,135,65,135,45,525,0.29411764705882354,0.25
55,104,105,94,75,52,485,0.36363636363636365,60,85,42,85,42,91,405,0.8227848101265823,1.0
60,60,60,60,60,60,360,0.38095238095238093,70,100,115,30,65,30,410,0.24390243902439024,0.5
45,50,43,40,38,62,278,0.40441176470588236,95,60,79,100,125,81,540,0.6201550387596899,1.0
70,95,85,55,65,70,440,0.5,90,110,80,100,80,95,555,0.7982456140350878,2.0
60,105,60,120,60,105,510,0.8849557522123894,95,75,180,130,80,30,590,0.13793103448275862,2.0
45,30,50,65,50,45,285,0.13821138211382114,70,85,65,105,85,120,530,0.9262295081967213,1.0
101,72,72,99,89,29,462,0.1937984496124031,60,100,85,80,85,100,510,0.7007874015748031,2.0
44,75,35,63,33,45,295,0.2647058823529412,40,55,80,35,60,30,300,0.15037593984962405,2.0
95,100,85,108,70,70,528,0.5652173913043478,70,43,53,43,53,40,302,0.19090909090909092,1.0
85,105,55,85,50,115,495,0.9032258064516129,100,150,90,180,160,90,770,0.7348484848484849,0.5
105,125,100,60,100,100,590,0.8359375,90,132,105,132,105,30,594,0.4246575342465753,1.0
80,80,80,55,55,90,440,0.6417910447761194,70,43,53,43,53,40,302,0.19090909090909092,1.0
65,80,140,40,70,70,465,0.5223880597014925,58,89,77,45,45,48,362,0.3177570093457944,1.0
60,80,95,70,85,50,440,0.2231404958677686,70,60,125,115,70,55,495,0.35507246376811596,1.0
90,75,75,90,100,70,500,0.5462184873949579,35,70,55,45,55,25,285,0.09420289855072464,0.5
100,134,110,95,100,61,600,0.4057971014492754,110,160,110,80,110,100,670,0.8591549295774648,1.0
55,75,60,75,60,103,428,0.7982456140350878,40,55,80,35,60,30,300,0.15037593984962405,0.5
90,100,90,125,85,90,580,0.7352941176470589,60,100,115,70,85,90,520,0.7557251908396947,1.0
40,45,40,62,60,60,307,0.33884297520661155,41,64,45,50,50,50,300,0.36752136752136755,0.5
79,100,80,110,90,121,580,0.968,68,125,65,65,115,80,518,0.6277372262773723,2.0
68,90,65,50,55,82,410,0.6165413533834586,28,25,25,45,35,40,198,0.16083916083916083,0.0
100,150,90,180,160,90,770,0.7348484848484849,70,65,65,55,55,70,380,0.5,1.0
85,76,64,45,55,90,415,0.6739130434782609,67,57,55,77,55,114,425,0.8879310344827587,1.0
106,130,90,110,154,90,680,0.719626168224299,55,104,105,94,75,52,485,0.36363636363636365,0.5
55,104,105,94,75,52,485,0.36363636363636365,45,100,135,65,135,45,525,0.29411764705882354,1.0
84,71,43,71,43,48,360,0.25874125874125875,35,45,160,30,45,70,385,0.48148148148148145,0.5
60,59,85,79,105,36,424,0.16666666666666666,60,45,50,90,80,70,395,0.625,0.125
85,73,70,73,115,67,483,0.5126050420168067,86,68,72,109,66,106,507,0.8099173553719008,1.0
62,73,55,56,52,84,382,0.7244094488188977,65,90,120,85,70,60,490,0.43410852713178294,1.0
45,45,35,20,30,20,195,0.07246376811594203,50,65,64,44,48,43,314,0.2196969696969697,1.0
104,91,63,91,73,68,490,0.5118110236220472,83,80,80,135,80,121,579,0.9444444444444444,1.0
40,70,40,35,40,60,285,0.392,65,85,70,75,70,40,405,0.203125,1.0
31,45,90,30,30,40,266,0.21929824561403508,70,135,105,60,105,20,495,0.5806451612903226,0.5
100,123,75,57,75,80,510,0.6923076923076923,80,80,80,55,55,90,440,0.6417910447761194,1.0
100,100,100,100,100,100,600,0.8758169934640523,65,90,122,58,75,84,494,0.71875,1.0
70,75,80,135,80,135,575,0.917910447761194,59,63,80,65,80,58,405,0.41843971631205673,2.0
50,75,75,65,65,50,380,0.4049586776859504,84,71,43,71,43,48,360,0.25874125874125875,0.0
50,60,60,60,60,30,320,0.11290322580645161,74,100,72,90,72,46,454,0.24561403508771928,1.0
70,90,45,15,45,50,315,0.3629032258064516,40,60,40,40,40,30,250,0.0948905109489051,2.0
150,80,44,90,54,80,498,0.625,35,35,40,35,55,50,250,0.40336134453781514,2.0
45,75,37,70,55,83,365,0.6183206106870229,60,82,45,45,45,74,351,0.5752212389380531,1.0
60,100,115,70,85,90,520,0.7557251908396947,85,73,70,73,115,67,483,0.5126050420168067,1.0
80,100,70,60,70,95,475,0.7416666666666667,40,55,30,30,30,85,270,0.688,0.5
55,50,40,40,40,75,300,0.5945945945945946,40,55,80,35,60,30,300,0.15037593984962405,0.5
95,75,80,100,110,30,490,0.24242424242424243,45,90,20,65,20,65,305,0.5116279069767442,0.0
80,80,80,80,80,80,480,0.5606060606060606,55,81,60,50,70,97,413,0.7214285714285714,1.0
70,83,50,37,50,60,350,0.3360655737704918,60,90,55,90,80,110,485,0.8677685950413223,0.5
106,190,100,154,100,130,780,0.9259259259259259,100,150,120,120,100,90,680,0.6493506493506493,1.0
75,95,60,65,60,115,470,0.8778625954198473,60,80,110,50,80,45,425,0.2833333333333333,1.0
73,100,60,100,60,65,458,0.42657342657342656,70,92,65,80,55,98,460,0.8090909090909091,1.0
65,110,130,60,65,95,525,0.8278145695364238,60,70,65,125,105,90,515,0.6911764705882353,0.25
100,103,75,120,75,127,600,0.940677966101695,75,125,100,70,80,45,495,0.33035714285714285,1.0
80,80,90,110,130,110,600,0.8721804511278195,90,95,95,70,90,70,510,0.5230769230769231,1.0
80,100,200,50,100,50,580,0.3472222222222222,55,40,40,65,45,35,280,0.16428571428571428,1.0
85,60,65,135,105,100,550,0.7518248175182481,30,30,30,30,30,30,180,0.12612612612612611,4.0
49,49,56,49,61,66,330,0.5190839694656488,100,150,110,95,110,70,635,0.5923076923076923,1.0
160,110,65,65,110,30,540,0.35714285714285715,41,56,40,62,44,71,314,0.568,1.0
63,120,85,90,55,55,468,0.2809917355371901,65,65,60,130,95,110,525,0.823943661971831,2.0
75,85,200,55,65,30,510,0.16778523489932887,43,80,65,50,35,35,308,0.14193548387096774,0.5
40,55,30,30,30,85,270,0.688,58,64,58,80,65,80,405,0.5423728813559322,1.0
65,150,40,15,80,145,495,0.9663865546218487,70,150,140,65,100,75,600,0.55,0.0
60,60,60,35,35,30,280,0.11194029850746269,35,55,40,45,40,60,275,0.35714285714285715,1.0
40,45,40,35,35,56,251,0.373015873015873,45,65,34,40,34,45,263,0.2589928057553957,0.5
40,65,95,60,45,35,340,0.13986013986013987,57,24,86,24,86,23,300,0.12727272727272726,0.0
50,35,55,25,25,15,205,0.05263157894736842,108,170,115,120,95,92,700,0.7083333333333334,1.0
40,65,95,60,45,35,340,0.13986013986013987,95,95,85,125,65,55,520,0.3894736842105263,2.0
55,66,44,44,56,85,350,0.6888888888888889,60,79,105,59,85,36,424,0.17054263565891473,1.0
50,65,107,105,107,86,520,0.7272727272727273,50,75,75,65,65,50,380,0.4049586776859504,1.0
20,40,15,35,35,60,205,0.34285714285714286,100,70,70,65,65,45,415,0.1897810218978102,1.0
40,70,40,35,40,60,285,0.392,67,125,40,30,30,58,350,0.3431372549019608,2.0
64,51,23,51,23,28,240,0.11363636363636363,74,48,76,83,81,104,466,0.7322834645669292,1.0
44,38,33,61,43,70,289,0.5267857142857143,110,65,105,55,95,80,510,0.6258503401360545,2.0
80,45,65,90,110,80,470,0.5462962962962963,60,85,40,30,45,68,328,0.6422018348623854,2.0
80,160,60,170,130,80,680,0.6180555555555556,90,100,90,125,85,90,580,0.7352941176470589,1.0
45,35,50,70,50,30,280,0.15753424657534246,100,123,75,57,75,80,510,0.6923076923076923,0.5
30,40,70,70,25,60,295,0.41353383458646614,50,50,120,80,80,30,410,0.07258064516129033,4.0
82,121,119,69,59,71,521,0.5394736842105263,75,95,60,65,60,115,470,0.8778625954198473,1.0
65,85,70,75,70,40,405,0.203125,105,30,105,140,105,55,540,0.3524590163934426,1.0
68,125,65,65,115,80,518,0.6277372262773723,75,38,38,56,56,67,330,0.5263157894736842,1.0
90,132,105,132,105,30,594,0.4246575342465753,55,104,105,94,75,52,485,0.36363636363636365,1.0
67,57,55,77,55,114,425,0.8879310344827587,65,80,140,40,70,70,465,0.5223880597014925,0.25
75,125,230,55,95,30,610,0.3448275862068966,110,80,90,95,90,65,530,0.5033557046979866,1.0
45,30,50,65,50,45,285,0.13821138211382114,106,150,70,194,120,140,780,0.952,0.5
60,60,60,35,35,30,280,0.11194029850746269,70,60,125,115,70,55,495,0.35507246376811596,0.5
60,40,50,75,85,95,405,0.6044776119402985,75,100,66,60,66,115,482,0.918918918918919,1.0
85,105,55,85,50,115,495,0.9032258064516129,45,53,70,40,60,42,310,0.25735294117647056,0.5
1,90,45,30,30,40,236,0.33064516129032256,44,58,44,58,44,61,309,0.41964285714285715,0.5
50,64,50,45,50,41,300,0.22727272727272727,70,105,105,50,40,20,390,0.33587786259541985,2.0
74,100,72,90,72,46,454,0.24561403508771928,80,100,70,50,60,45,405,0.25806451612903225,1.0
78,104,78,159,115,100,634,0.8444444444444444,55,75,60,75,60,103,428,0.7982456140350878,0.5
73,115,60,60,60,90,458,0.6694915254237288,79,115,70,125,80,111,580,0.864,1.0
90,60,60,40,40,40,330,0.29545454545454547,65,90,65,61,61,100,442,0.8373983739837398,0.0
72,58,80,103,80,97,490,0.7171052631578947,50,20,55,25,25,30,205,0.09774436090225563,2.0
60,85,69,65,79,80,438,0.576,25,20,15,105,55,90,310,0.32407407407407407,1.0
74,94,131,54,116,20,489,0.4485294117647059,91,90,129,90,72,108,580,0.9140625,0.25
40,80,100,30,30,20,300,0.11851851851851852,85,105,85,40,50,40,405,0.211864406779661,0.5
50,85,85,55,55,50,380,0.3902439024390244,90,110,80,100,80,95,555,0.7982456140350878,0.25
40,40,55,40,70,55,300,0.40939597315436244,65,95,100,60,50,50,420,0.34959349593495936,1.0
95,65,65,110,130,60,525,0.4016393442622951,75,98,63,98,63,101,498,0.849624060150376,1.0
85,73,70,73,115,67,483,0.5126050420168067,65,95,100,60,50,50,420,0.34959349593495936,1.0
65,110,130,60,65,95,525,0.8278145695364238,67,57,55,77,55,114,425,0.8879310344827587,0.5
190,33,58,33,58,33,405,0.13432835820895522,60,85,42,85,42,91,405,0.8227848101265823,0.0
105,140,95,55,65,45,505,0.3,73,76,75,81,100,100,505,0.8110236220472441,1.0
60,80,95,70,85,50,440,0.2231404958677686,78,84,78,109,85,100,534,0.8620689655172413,0.5
38,35,35,65,55,50,278,0.2647058823529412,50,50,150,50,150,50,500,0.2571428571428571,1.0
44,75,35,63,33,45,295,0.2647058823529412,95,117,80,65,70,92,519,0.8409090909090909,0.5
100,100,100,100,100,100,600,0.8758169934640523,75,125,230,55,95,30,610,0.3448275862068966,0.5
80,105,65,60,75,130,515,0.9645390070921985,75,95,125,45,75,95,510,0.8257575757575758,1.0
60,55,145,75,150,40,525,0.2,100,110,90,85,90,60,535,0.47794117647058826,0.25
105,130,120,45,45,40,485,0.4444444444444444,38,30,41,30,41,60,240,0.2897196261682243,1.0
91,134,95,100,100,80,600,0.6304347826086957,95,65,110,60,130,65,525,0.5275590551181102,1.0
60,75,100,55,80,50,420,0.3088235294117647,72,95,67,103,71,122,530,0.9606299212598425,0.0
65,95,75,55,55,85,430,0.6933333333333334,70,80,70,80,70,110,480,0.6594202898550725,0.5
40,40,35,50,100,70,335,0.5031847133757962,77,120,90,60,90,48,485,0.2785714285714286,0.5
30,45,59,30,39,57,260,0.2803030303030303,90,92,75,92,85,60,494,0.49586776859504134,4.0
85,105,55,85,50,115,495,0.9032258064516129,80,80,80,80,80,80,480,0.5606060606060606,0.5
50,65,85,35,35,55,325,0.32575757575757575,55,85,122,58,75,99,494,0.8099173553719008,1.0
65,85,70,75,70,40,405,0.203125,67,82,62,46,48,43,348,0.22033898305084745,1.0
85,105,85,40,50,40,405,0.211864406779661,125,130,90,130,90,95,660,0.7734375,2.0
44,75,35,63,33,45,295,0.2647058823529412,60,45,70,45,90,95,405,0.7304964539007093,1.0
44,38,39,61,79,42,303,0.2251655629139073,50,30,55,65,55,20,275,0.13675213675213677,0.5
60,85,42,85,42,91,405,0.8227848101265823,72,105,115,54,86,68,500,0.5149253731343284,0.5
74,48,76,83,81,104,466,0.7913043478260869,75,125,70,125,70,115,580,0.9037037037037037,0.5
70,140,230,60,80,50,630,0.32432432432432434,50,65,85,35,35,55,325,0.32575757575757575,2.0
60,55,50,40,55,45,305,0.22377622377622378,85,105,55,85,50,115,495,0.9032258064516129,1.0
100,100,100,100,100,100,600,0.8602941176470589,74,94,131,54,116,20,489,0.4485294117647059,0.25
80,160,80,130,80,100,630,0.8455284552845529,83,80,75,70,70,101,479,0.8615384615384616,1.0
75,125,70,125,70,115,580,0.9037037037037037,40,60,40,40,40,30,250,0.0948905109489051,2.0
80,185,115,40,105,75,600,0.6230769230769231,61,84,65,70,70,70,420,0.5,1.0
30,45,59,30,39,57,260,0.2803030303030303,70,55,65,95,85,70,440,0.5307692307692308,1.0
20,40,15,35,35,60,205,0.34285714285714286,55,55,85,65,85,35,380,0.2014388489208633,2.0
60,50,70,50,90,65,385,0.39568345323741005,70,43,53,43,53,40,302,0.19090909090909092,0.25
80,110,60,150,130,70,600,0.5042016806722689,65,40,70,80,140,70,465,0.5954198473282443,1.0
55,69,85,32,35,28,304,0.09302325581395349,76,48,48,57,62,34,325,0.11688311688311688,0.5
50,150,50,150,50,150,600,0.9339622641509434,50,95,90,95,90,180,600,0.9172413793103448,0.5
90,100,70,110,150,80,600,0.6037735849056604,50,40,85,40,65,25,305,0.08870967741935484,1.0
75,95,122,58,75,69,494,0.5725806451612904,80,82,83,100,100,80,525,0.6742424242424242,0.25
100,50,80,60,80,50,420,0.34375,30,42,118,42,88,30,350,0.112,1.0
80,135,85,70,95,150,615,0.9844961240310077,38,35,40,27,25,35,200,0.08208955223880597,4.0
70,70,115,130,90,60,535,0.5338983050847458,45,85,50,55,50,65,350,0.5076923076923077,1.0
75,100,66,60,66,115,482,0.918918918918919,85,120,70,50,60,100,485,0.8308823529411765,1.0
77,59,50,67,63,46,362,0.23140495867768596,60,100,115,70,85,90,520,0.7557251908396947,0.25
60,105,60,120,60,105,510,0.8849557522123894,40,60,40,40,40,30,250,0.0948905109489051,1.0
50,35,55,25,25,15,205,0.05263157894736842,55,45,50,45,65,80,340,0.5546218487394958,1.0
123,77,72,99,92,58,521,0.4621212121212121,70,55,65,95,85,70,440,0.5307692307692308,1.0
60,59,85,79,105,36,424,0.16666666666666666,75,98,63,98,63,101,498,0.8091603053435115,1.0
55,85,55,50,55,60,360,0.4233576642335766,85,135,130,60,80,25,515,0.40540540540540543,0.5
60,70,65,125,105,90,515,0.6911764705882353,80,100,200,50,100,50,580,0.3472222222222222,1.0
95,109,105,75,85,56,525,0.34513274336283184,100,120,120,150,100,90,680,0.7880794701986755,0.5
60,55,50,40,55,45,305,0.22377622377622378,50,85,125,85,115,20,480,0.4306569343065693,0.5
85,100,122,58,75,54,494,0.3939393939393939,45,45,55,45,55,63,308,0.4594594594594595,0.5
90,100,60,90,60,80,480,0.6422764227642277,65,95,100,60,50,50,420,0.34959349593495936,0.5
60,50,70,50,90,65,385,0.39568345323741005,50,85,55,65,65,90,410,0.7478260869565218,0.5
1,90,45,30,30,40,236,0.33064516129032256,50,180,20,180,20,150,600,0.9029850746268657,4.0
95,100,85,108,70,70,528,0.5652173913043478,59,63,80,65,80,58,405,0.41843971631205673,0.5
50,53,48,53,48,64,316,0.46153846153846156,63,63,47,41,41,74,329,0.56,1.0
60,60,40,65,45,35,305,0.15833333333333333,60,85,40,30,45,68,328,0.6422018348623854,1.0
65,90,65,61,61,100,442,0.8373983739837398,20,10,55,15,20,80,200,0.17985611510791366,1.0
50,80,95,10,45,10,290,0.232,70,65,65,55,55,70,380,0.5,1.0
75,90,140,60,60,40,465,0.3008130081300813,110,135,60,50,65,88,508,0.7744360902255639,0.25
85,50,95,120,115,80,545,0.5793650793650794,72,85,70,65,70,58,420,0.41304347826086957,4.0
35,85,45,35,35,75,310,0.6492537313432836,50,70,100,40,40,30,330,0.2222222222222222,0.0625
45,25,50,25,25,35,205,0.13076923076923078,55,69,85,32,35,28,304,0.09302325581395349,1.0
65,155,120,65,90,105,600,0.8677685950413223,90,30,15,40,20,15,210,0.043478260869565216,0.5
55,75,60,75,60,103,428,0.7982456140350878,80,120,70,110,70,80,530,0.6422764227642277,2.0
45,100,135,65,135,45,525,0.29411764705882354,50,75,45,40,45,60,315,0.4380165289256198,1.0
65,55,115,100,40,60,435,0.3798449612403101,80,95,82,60,82,75,474,0.6,0.5
59,45,40,35,40,31,250,0.14285714285714285,45,22,60,27,30,29,213,0.07518796992481203,1.0
48,72,48,72,48,48,336,0.25984251968503935,60,40,60,95,60,55,370,0.4222222222222222,1.0
40,80,35,35,45,70,305,0.4661016949152542,50,95,95,35,110,70,455,0.5179856115107914,1.0
116,55,85,107,95,29,487,0.06818181818181818,85,80,70,135,75,90,535,0.7006802721088435,1.0
70,90,45,15,45,50,315,0.3629032258064516,90,100,60,90,60,80,480,0.6422764227642277,2.0
103,93,67,71,61,84,479,0.7142857142857143,75,38,38,56,56,67,330,0.5263157894736842,1.0
50,70,160,70,160,90,600,0.7417218543046358,50,53,48,53,48,64,316,0.4076923076923077,1.0
70,80,102,80,102,40,474,0.2677165354330709,55,20,35,20,45,75,250,0.37681159420289856,1.0
80,120,130,55,65,45,495,0.37037037037037035,20,10,230,10,230,5,505,0.0,2.0
55,50,45,135,95,120,500,0.7714285714285715,61,78,95,56,58,57,405,0.40336134453781514,1.0
70,65,65,55,55,70,380,0.5,45,55,45,65,45,75,330,0.5692307692307692,1.0
78,81,71,74,69,126,499,0.9090909090909091,80,70,40,100,60,145,495,0.921875,4.0
50,95,95,35,110,70,455,0.5179856115107914,41,50,37,50,37,66,281,0.5175438596491229,2.0
80,110,120,130,90,70,600,0.6198347107438017,90,120,75,60,60,45,450,0.29411764705882354,1.0
40,55,99,40,79,47,360,0.26262626262626265,86,81,97,81,107,43,495,0.203125,2.0
130,65,60,110,95,65,525,0.5227272727272727,60,60,60,105,105,105,495,0.848,1.0
76,147,90,60,70,97,540,0.8267716535433071,85,100,122,58,75,54,494,0.3939393939393939,1.0
71,120,95,120,95,99,600,0.8203125,30,35,30,100,35,80,310,0.4765625,0.25
55,68,64,45,55,31,318,0.11666666666666667,49,55,42,42,37,85,310,0.6068376068376068,1.0
45,55,45,65,45,75,330,0.5692307692307692,40,80,100,30,30,20,300,0.11851851851851852,1.0
50,50,50,50,50,50,300,0.30708661417322836,45,100,45,45,45,10,290,0.2949640287769784,2.0
77,120,90,60,90,48,485,0.2785714285714286,100,100,100,100,100,100,600,0.8778625954198473,1.0
38,35,35,65,55,50,278,0.2647058823529412,82,80,86,85,75,72,480,0.6183206106870229,1.0
70,130,100,55,80,65,500,0.608,62,77,62,50,42,65,358,0.4838709677419355,0.5
50,52,48,65,50,55,320,0.33098591549295775,40,65,95,60,45,35,340,0.13986013986013987,1.0
49,49,56,49,61,66,330,0.5190839694656488,35,35,35,35,35,35,210,0.13385826771653545,1.0
60,70,105,70,120,75,500,0.5983606557377049,106,190,100,154,100,130,780,0.9259259259259259,0.5
95,70,73,95,90,60,483,0.3983739837398374,120,120,120,120,120,120,720,0.9344262295081968,1.0
105,140,95,55,65,45,505,0.3,54,63,52,83,56,97,405,0.7697841726618705,1.0
75,65,55,65,55,69,384,0.43548387096774194,40,55,30,30,30,60,245,0.43548387096774194,0.0
105,180,100,180,100,115,780,0.9477611940298507,81,102,77,85,75,85,505,0.5642857142857143,1.0
165,75,80,40,45,65,470,0.5151515151515151,50,75,75,65,65,50,380,0.4049586776859504,1.0
60,85,69,60,69,77,420,0.518796992481203,50,70,50,50,50,70,340,0.5645161290322581,1.0
150,100,120,100,120,90,680,0.6666666666666666,55,55,85,65,85,35,380,0.2014388489208633,1.0
75,98,63,98,63,101,498,0.849624060150376,50,70,50,50,50,70,340,0.5645161290322581,1.0
50,55,50,36,30,43,264,0.2922077922077922,65,80,80,59,63,58,405,0.4411764705882353,1.0
45,50,45,115,55,95,405,0.6936936936936937,60,70,50,100,50,65,395,0.5217391304347826,1.0
58,50,145,95,105,30,483,0.2459016393442623,75,95,67,125,95,83,540,0.7117117117117117,1.0
75,85,200,55,65,30,510,0.16778523489932887,65,150,60,115,60,115,565,0.935251798561151,1.0
130,70,35,70,35,60,400,0.4017857142857143,66,117,70,40,50,67,410,0.4573643410852713,0.5
130,85,80,85,95,60,535,0.43884892086330934,35,85,45,35,35,75,310,0.6492537313432836,2.0
78,52,60,63,65,23,341,0.06015037593984962,50,40,85,40,65,25,305,0.08870967741935484,1.0
58,109,112,48,48,109,484,0.8805970149253731,70,65,60,90,75,90,450,0.6571428571428571,0.5
54,66,70,44,55,46,335,0.4214876033057851,40,55,70,45,60,30,300,0.10619469026548672,0.5
126,131,95,131,98,99,680,0.8102189781021898,55,75,60,75,60,103,428,0.7982456140350878,0.5
75,95,67,125,95,83,540,0.7117117117117117,20,40,90,30,90,25,295,0.11363636363636363,1.0
95,135,80,110,80,100,600,0.8248175182481752,54,63,52,83,56,97,405,0.7697841726618705,1.0
90,120,75,60,60,45,450,0.29411764705882354,70,60,62,80,82,60,414,0.4375,1.0
50,53,62,58,63,44,330,0.13709677419354838,52,65,55,58,62,60,352,0.4482758620689655,1.0
62,73,55,56,52,84,382,0.7244094488188977,85,60,65,135,105,100,550,0.7518248175182481,2.0
85,115,80,105,80,50,515,0.3063063063063063,80,80,80,80,80,80,480,0.5606060606060606,2.0
60,90,70,60,120,40,440,0.27419354838709675,110,135,60,50,65,88,508,0.7744360902255639,0.5
60,70,105,70,120,75,500,0.5983606557377049,70,75,60,105,60,105,475,0.88,2.0
30,42,118,42,88,30,350,0.112,73,115,60,60,60,90,458,0.6694915254237288,1.0
30,42,118,42,88,30,350,0.112,75,98,63,98,63,101,498,0.8091603053435115,1.0
65,125,100,55,70,85,500,0.6532258064516129,95,125,79,60,100,81,540,0.6165413533834586,0.5
20,10,55,15,20,80,200,0.17985611510791366,40,50,90,30,55,65,330,0.44680851063829785,1.0
60,60,60,85,85,85,435,0.631578947368421,45,22,60,27,30,29,213,0.07518796992481203,1.0
55,95,55,35,75,115,430,0.9380530973451328,70,50,30,95,135,105,485,0.8040540540540541,0.5
100,103,75,120,75,127,600,0.940677966101695,80,100,123,122,120,80,625,0.56,0.5
100,110,90,85,90,60,535,0.47794117647058826,50,45,45,35,35,50,260,0.23529411764705882,1.0
45,60,45,25,45,55,275,0.29,40,80,35,35,45,70,305,0.4661016949152542,1.0
65,50,35,115,95,95,455,0.7333333333333333,50,80,95,10,45,10,290,0.232,1.0
65,55,115,100,40,60,435,0.3798449612403101,50,20,40,20,40,20,190,0.0962962962962963,1.0
68,90,65,50,55,82,410,0.6165413533834586,40,30,30,40,50,30,220,0.07936507936507936,0.5
43,30,55,40,65,97,330,0.6030534351145038,75,125,100,70,80,45,495,0.33035714285714285,2.0
58,50,145,95,105,30,483,0.2459016393442623,90,100,60,90,60,80,480,0.6422764227642277,0.5
85,80,90,105,95,60,515,0.49074074074074076,108,130,95,80,85,102,600,0.7637795275590551,1.0
91,90,106,130,106,77,600,0.648854961832061,60,65,80,170,95,130,600,0.8625954198473282,1.0
85,105,55,85,50,115,495,0.9032258064516129,65,55,115,100,40,60,435,0.3798449612403101,0.5
60,65,80,170,95,130,600,0.8625954198473282,60,80,50,40,40,30,300,0.15328467153284672,2.0
46,57,40,40,40,50,273,0.25,60,50,50,60,70,50,340,0.28346456692913385,2.0
123,77,72,99,92,58,521,0.4621212121212121,108,112,118,68,72,47,525,0.2916666666666667,1.0
79,103,120,135,115,78,630,0.5763888888888888,55,63,90,50,80,42,380,0.21138211382113822,0.5
108,112,118,68,72,47,525,0.2916666666666667,45,45,35,20,30,20,195,0.07246376811594203,0.5
70,55,55,80,60,45,365,0.2222222222222222,55,66,44,44,56,85,350,0.6888888888888889,1.0
75,80,60,65,90,102,472,0.8625954198473282,42,52,67,39,56,50,306,0.2868217054263566,0.5
80,130,100,160,120,110,700,0.8981481481481481,64,115,65,83,63,65,455,0.5323741007194245,1.0
45,49,49,65,65,45,318,0.2781954887218045,50,55,50,36,30,43,264,0.2922077922077922,0.5
60,60,60,105,105,105,495,0.848,55,45,50,45,65,80,340,0.5546218487394958,1.0
60,70,50,100,50,65,395,0.5217391304347826,80,100,70,60,70,95,475,0.7416666666666667,4.0
78,104,78,159,115,100,634,0.8444444444444444,54,63,52,83,56,97,405,0.7697841726618705,0.5
50,70,160,70,160,90,600,0.7417218543046358,75,90,50,110,80,95,500,0.7985611510791367,0.0
45,35,45,62,53,35,275,0.11851851851851852,45,85,70,40,40,60,340,0.5229357798165137,0.5
110,65,75,125,85,30,490,0.15,69,55,45,55,55,15,294,0.11666666666666667,2.0
60,55,145,75,150,40,525,0.2,90,132,105,132,105,30,594,0.4246575342465753,4.0
90,100,60,90,60,80,480,0.6422764227642277,40,45,40,62,60,60,307,0.33884297520661155,0.5
75,90,140,60,60,40,465,0.3008130081300813,55,95,55,35,75,115,430,0.9380530973451328,4.0
80,100,123,122,120,80,625,0.56,45,35,50,70,50,30,280,0.15753424657534246,1.0
60,67,85,77,75,116,480,0.8888888888888888,106,110,90,154,90,130,680,0.926829268292683,1.0
36,50,50,65,60,44,305,0.16363636363636364,60,65,70,85,75,40,395,0.21705426356589147,2.0
90,55,75,60,75,30,385,0.13970588235294118,60,85,42,85,42,91,405,0.8227848101265823,1.0
58,89,77,45,45,48,362,0.3177570093457944,114,85,70,85,80,30,464,0.2066115702479339,1.0
105,105,75,65,100,50,500,0.37593984962406013,95,75,80,100,110,30,490,0.24242424242424243,1.0
75,80,85,110,90,50,490,0.3548387096774194,72,58,80,103,80,97,490,0.7171052631578947,0.5
40,40,55,40,70,55,300,0.40939597315436244,53,51,53,61,56,40,314,0.14285714285714285,1.0
70,105,105,50,40,20,390,0.33587786259541985,70,95,85,55,65,70,440,0.5,1.0
45,40,60,40,75,50,310,0.2926829268292683,90,110,80,100,80,95,555,0.7982456140350878,1.0
126,131,95,131,98,99,680,0.8102189781021898,70,135,105,60,105,20,495,0.5806451612903226,1.0
123,77,72,99,92,58,521,0.4621212121212121,80,115,80,65,55,93,488,0.7846153846153846,4.0
65,47,55,73,75,85,400,0.65,37,25,41,25,41,25,194,0.08870967741935484,1.0
68,85,65,165,135,100,618,0.8083333333333333,55,55,55,85,55,30,335,0.1320754716981132,0.5
45,50,43,40,38,62,278,0.40441176470588236,75,123,67,95,85,95,540,0.7642276422764228,0.5
70,65,65,55,55,70,380,0.5,95,65,65,110,130,60,525,0.4016393442622951,1.0
60,95,80,60,80,30,405,0.19480519480519481,73,115,60,60,60,90,458,0.6694915254237288,1.0
50,95,180,85,45,70,525,0.5298507462686567,84,71,43,71,43,48,360,0.25874125874125875,1.0
50,105,125,55,95,50,480,0.375886524822695,71,95,85,110,95,79,535,0.664,2.0
100,128,90,77,77,128,600,0.959349593495935,80,70,40,100,60,145,495,0.921875,0.5
35,70,55,45,55,25,285,0.09420289855072464,50,35,55,25,25,15,205,0.05263157894736842,0.5
20,10,55,15,20,80,200,0.17985611510791366,43,30,55,40,65,97,330,0.6030534351145038,0.5
30,45,59,30,39,57,260,0.2803030303030303,111,83,68,92,82,39,475,0.1774193548387097,0.5
31,45,90,30,30,40,266,0.21929824561403508,60,69,95,69,95,36,424,0.2608695652173913,0.5
55,85,55,50,55,60,360,0.4233576642335766,70,110,75,145,85,145,630,0.9444444444444444,2.0
70,60,75,110,75,90,480,0.7165354330708661,100,150,120,120,100,90,680,0.6493506493506493,0.5
110,85,95,80,95,50,515,0.2713178294573643,45,60,30,80,50,65,330,0.4603174603174603,1.0
43,30,55,40,65,97,330,0.6030534351145038,78,130,111,130,85,100,634,0.8561151079136691,1.0
92,105,90,125,90,98,600,0.8217054263565892,45,60,30,80,50,65,330,0.4603174603174603,0.5
55,20,35,20,45,75,250,0.37681159420289856,65,50,35,115,95,95,455,0.7333333333333333,1.0
105,180,100,180,100,115,780,0.9477611940298507,50,95,180,85,45,70,525,0.5298507462686567,1.0
104,91,63,91,73,68,490,0.5118110236220472,88,107,122,74,75,64,530,0.4596774193548387,1.0
40,80,35,35,45,70,305,0.4661016949152542,80,105,105,105,105,80,580,0.5939849624060151,0.5
100,100,125,110,50,50,535,0.384,76,65,45,92,42,91,411,0.7449664429530202,0.5
91,90,106,130,106,77,600,0.648854961832061,50,160,110,160,110,110,700,0.8854961832061069,0.5
58,64,58,80,65,80,405,0.5423728813559322,80,160,80,130,80,100,630,0.8455284552845529,0.5
75,55,70,55,95,110,460,0.8444444444444444,75,95,125,45,75,95,510,0.8257575757575758,1.0
110,160,110,80,110,100,670,0.8591549295774648,50,50,150,50,150,50,500,0.2571428571428571,0.5
50,53,48,53,48,64,316,0.358974358974359,95,110,80,70,80,50,485,0.37209302325581395,1.0
60,85,69,65,79,80,438,0.576,125,120,90,170,100,95,700,0.78125,1.0
35,80,50,50,70,120,405,0.84375,103,60,126,80,126,50,545,0.36363636363636365,1.0
75,75,95,75,95,113,528,0.9015151515151515,65,150,40,15,80,145,495,0.9663865546218487,0.25
20,10,230,10,230,5,505,0.0,35,35,35,35,35,35,210,0.13385826771653545,0.25
70,43,53,43,53,40,302,0.19090909090909092,100,50,80,60,80,50,420,0.34375,2.0
20,40,15,35,35,60,205,0.34285714285714286,60,45,70,45,90,95,405,0.7304964539007093,0.5
100,100,100,100,100,100,600,0.8758169934640523,45,22,60,27,30,29,213,0.07518796992481203,1.0
116,55,85,107,95,29,487,0.06818181818181818,80,75,150,75,150,50,580,0.30973451327433627,0.5
70,90,45,15,45,50,315,0.3629032258064516,80,90,80,130,110,110,600,0.856,0.5
30,40,70,70,25,60,295,0.41353383458646614,90,130,80,65,85,55,505,0.4396551724137931,1.0
85,60,65,135,105,100,550,0.7518248175182481,75,125,230,55,95,30,610,0.3448275862068966,1.0
45,20,50,60,120,50,345,0.24074074074074073,90,100,70,110,150,80,600,0.6037735849056604,0.5
70,94,50,94,50,66,424,0.48148148148148145,79,85,60,55,60,71,410,0.60431654676259,1.0
60,65,70,85,75,40,395,0.21705426356589147,65,50,35,115,95,95,455,0.7333333333333333,1.0
70,95,125,65,75,45,475,0.33613445378151263,105,30,105,140,105,55,540,0.3524590163934426,2.0
70,55,55,80,60,45,365,0.2222222222222222,65,90,122,58,75,84,494,0.71875,0.5
80,90,80,130,110,110,600,0.856,80,115,80,65,55,93,488,0.7846153846153846,1.0
75,125,230,55,95,30,610,0.3448275862068966,85,105,85,40,50,40,405,0.211864406779661,1.0
65,110,130,60,65,95,525,0.8278145695364238,80,185,115,40,105,75,600,0.6230769230769231,0.5
105,140,95,55,65,45,505,0.3,50,52,48,65,50,55,320,0.33098591549295775,1.0
100,120,120,150,100,90,680,0.7880794701986755,40,40,35,50,100,70,335,0.5031847133757962,0.5
40,65,40,80,40,65,330,0.5038167938931297,70,80,65,90,65,85,455,0.578125,2.0
55,75,85,25,25,15,280,0.1875,80,105,65,60,75,130,515,0.9645390070921985,2.0
65,75,90,97,123,44,494,0.1987179487179487,58,64,58,80,65,80,405,0.609271523178808,1.0
45,60,30,80,50,65,330,0.4603174603174603,90,65,65,40,40,15,315,0.19672131147540983,1.0
40,70,130,60,130,25,455,0.17355371900826447,85,110,90,45,90,80,500,0.6206896551724138,0.0
45,95,50,40,50,75,355,0.54,60,50,40,85,75,95,405,0.7540983606557377,1.0
75,38,38,56,56,67,330,0.5263157894736842,75,125,70,125,70,115,580,0.9037037037037037,1.0
95,125,79,60,100,81,540,0.6165413533834586,50,47,50,57,50,65,319,0.463768115942029,1.0
45,80,100,35,37,28,325,0.3125,70,135,105,60,105,20,495,0.5806451612903226,0.5
60,40,60,95,60,55,370,0.4222222222222222,75,85,200,55,65,30,510,0.16778523489932887,2.0
75,80,55,25,35,35,305,0.18666666666666668,89,124,80,55,80,55,483,0.5714285714285714,0.0
40,55,99,40,79,47,360,0.26262626262626265,80,105,105,105,105,80,580,0.5939849624060151,2.0
55,45,43,55,43,72,313,0.5853658536585366,75,125,100,70,80,45,495,0.33035714285714285,1.0
75,55,70,55,95,110,460,0.8444444444444444,60,90,70,60,120,40,440,0.27419354838709675,1.0
20,15,20,10,55,80,200,0.2682926829268293,60,52,168,47,138,30,495,0.19834710743801653,2.0
90,70,80,70,95,70,475,0.5190839694656488,80,120,70,110,70,80,530,0.6422764227642277,1.0
55,40,50,65,85,40,335,0.3181818181818182,103,60,126,80,126,50,545,0.36363636363636365,0.0
100,5,5,15,65,30,220,0.07692307692307693,45,75,60,40,30,50,300,0.304,1.0
50,50,62,40,62,65,329,0.4188034188034188,83,80,75,70,70,101,479,0.8615384615384616,1.0
70,75,60,105,60,105,475,0.88,108,170,115,120,95,92,700,0.7083333333333334,0.0
40,50,45,70,45,70,320,0.5517241379310345,44,50,91,24,86,10,305,0.1981981981981982,0.5
49,55,42,42,37,85,310,0.6068376068376068,105,140,95,55,65,45,505,0.3,1.0
50,65,45,85,65,95,405,0.7238095238095238,50,85,55,65,65,90,410,0.7478260869565218,0.5
40,45,65,100,120,90,460,0.5588235294117647,75,85,200,55,65,30,510,0.16778523489932887,0.5
65,75,105,35,65,85,430,0.6940298507462687,45,60,30,80,50,65,330,0.4603174603174603,2.0
75,80,55,25,35,35,305,0.18666666666666668,75,103,80,70,80,92,500,0.7933884297520661,0.5
67,82,62,46,48,43,348,0.22033898305084745,30,45,55,70,55,85,340,0.5633802816901409,1.0
20,10,230,10,230,5,505,0.0,78,84,78,109,85,100,534,0.8620689655172413,1.0
75,95,122,58,75,69,494,0.5725806451612904,70,140,70,110,65,105,560,0.95,1.0
75,95,122,58,75,69,494,0.5725806451612904,95,110,95,40,95,55,490,0.40336134453781514,0.0
126,131,95,131,98,99,680,0.8294573643410853,45,60,30,80,50,65,330,0.4603174603174603,1.0
45,100,45,45,45,10,290,0.2949640287769784,65,55,115,100,40,60,435,0.3798449612403101,0.5
30,40,70,70,25,60,295,0.41353383458646614,55,65,35,60,30,85,330,0.6126126126126126,0.5
75,95,67,125,95,83,540,0.7117117117117117,50,95,180,85,45,70,525,0.5298507462686567,1.0
40,30,35,45,40,55,245,0.31496062992125984,40,65,95,60,45,35,340,0.13986013986013987,1.0
100,100,100,100,100,100,600,0.831858407079646,100,5,5,15,65,30,220,0.07692307692307693,1.0
65,50,70,95,80,65,425,0.4262295081967213,106,150,70,194,120,140,780,0.952,0.5
80,80,80,80,80,80,480,0.6015037593984962,83,80,75,70,70,101,479,0.8615384615384616,2.0
170,90,45,90,45,60,500,0.427536231884058,50,30,55,65,55,20,275,0.13675213675213677,2.0
60,150,50,150,50,60,520,0.5,91,90,129,90,72,108,580,0.9140625,0.5
55,75,50,40,40,80,340,0.6302521008403361,38,35,40,27,25,35,200,0.08208955223880597,2.0
70,60,70,87,78,85,450,0.6228070175438597,60,45,70,75,85,55,390,0.3008130081300813,1.0
75,75,95,75,95,113,528,0.9015151515151515,70,90,70,60,60,70,420,0.6390977443609023,1.0
55,55,85,65,85,35,380,0.2014388489208633,75,65,55,65,55,69,384,0.43548387096774194,0.5
55,81,60,50,70,97,413,0.7214285714285714,35,60,44,40,54,55,288,0.366412213740458,1.0
49,55,42,42,37,85,310,0.6068376068376068,100,70,70,65,65,45,415,0.1897810218978102,1.0
30,45,55,70,55,85,340,0.5633802816901409,25,20,15,105,55,90,310,0.32407407407407407,1.0
110,123,65,100,65,65,528,0.5217391304347826,95,155,109,70,130,81,640,0.6788321167883211,1.0
110,65,75,125,85,30,490,0.15,35,65,35,65,35,65,300,0.46621621621621623,1.0
53,51,53,61,56,40,314,0.14285714285714285,70,95,85,55,65,70,440,0.5,2.0
95,65,110,60,130,65,525,0.5275590551181102,72,105,115,54,86,68,500,0.5149253731343284,1.0
60,85,69,60,69,77,420,0.518796992481203,40,40,40,70,40,20,250,0.032520325203252036,1.0
110,65,75,125,85,30,490,0.15,54,66,70,44,55,46,335,0.4214876033057851,1.0
20,40,90,30,90,25,295,0.11363636363636363,52,65,55,58,62,60,352,0.4482758620689655,0.0
75,75,60,83,60,60,413,0.39344262295081966,100,73,83,73,83,55,467,0.371900826446281,1.0
55,104,105,94,75,52,485,0.36363636363636365,75,80,85,110,90,50,490,0.3548387096774194,0.5
104,91,63,91,73,68,490,0.5118110236220472,50,70,50,50,50,70,340,0.5645161290322581,1.0
84,71,43,71,43,48,360,0.25874125874125875,80,80,80,55,55,90,440,0.6417910447761194,1.0
60,80,95,70,85,50,440,0.2231404958677686,60,50,100,85,70,65,430,0.47580645161290325,0.5
80,100,200,50,100,50,580,0.3472222222222222,65,150,60,115,60,115,565,0.935251798561151,1.0
78,81,71,74,69,126,499,0.9090909090909091,59,110,150,45,49,35,448,0.3333333333333333,1.0
45,85,70,40,40,60,340,0.5229357798165137,61,72,57,55,55,65,365,0.3984375,1.0
70,90,90,135,90,125,600,0.9401709401709402,50,105,79,35,110,76,455,0.6214285714285714,0.5
35,45,160,30,45,70,385,0.48148148148148145,40,55,30,30,30,60,245,0.43548387096774194,0.0
60,50,70,50,90,65,385,0.39568345323741005,78,81,71,74,69,126,499,0.9090909090909091,0.25
60,90,140,50,50,40,430,0.2535211267605634,70,40,50,55,50,25,290,0.061068702290076333,2.0
40,70,40,35,40,60,285,0.392,105,95,75,85,75,74,509,0.5714285714285714,1.0
70,90,110,60,75,95,500,0.7333333333333333,49,55,42,42,37,85,310,0.6068376068376068,1.0
75,75,95,75,95,113,528,0.9015151515151515,110,78,73,76,71,60,468,0.3333333333333333,4.0
95,75,180,130,80,30,590,0.13793103448275862,60,48,45,43,90,42,328,0.21897810218978103,0.5
105,125,100,60,100,100,590,0.8359375,30,45,135,45,90,30,375,0.09285714285714286,0.5
75,89,85,55,65,36,405,0.29545454545454547,95,75,180,130,80,30,590,0.13793103448275862,2.0
150,120,100,120,100,90,680,0.664179104477612,50,85,85,55,55,50,380,0.3902439024390244,0.0
75,80,95,90,100,50,490,0.2158273381294964,74,48,76,83,81,104,466,0.7322834645669292,1.0
60,85,60,50,50,125,430,0.9090909090909091,60,40,60,95,60,55,370,0.4222222222222222,0.0
50,85,40,85,40,35,335,0.1746031746031746,40,80,35,35,45,70,305,0.4661016949152542,1.0
78,81,71,74,69,126,499,0.9090909090909091,75,80,70,65,75,90,455,0.7578125,1.0
90,75,85,115,90,55,510,0.3445378151260504,90,100,90,125,85,90,580,0.7352941176470589,2.0
95,65,65,110,130,60,525,0.4016393442622951,40,30,32,50,52,65,269,0.3671875,1.0
45,20,50,60,120,50,345,0.24074074074074073,91,134,95,100,100,80,600,0.6304347826086957,0.5
130,70,35,70,35,60,400,0.4017857142857143,55,45,43,55,43,72,313,0.5853658536585366,1.0
95,75,180,130,80,30,590,0.13793103448275862,70,77,60,97,60,108,472,0.8394160583941606,1.0
65,95,57,100,85,93,495,0.7441860465116279,40,30,32,50,52,65,269,0.3671875,1.0
70,50,30,95,135,105,485,0.8040540540540541,73,76,75,81,100,100,505,0.8110236220472441,0.5
100,164,150,95,120,71,700,0.5645161290322581,68,125,65,65,115,80,518,0.6277372262773723,0.5
50,50,62,40,62,65,329,0.4188034188034188,100,103,75,120,75,127,600,0.940677966101695,2.0
70,85,65,105,85,120,530,0.9262295081967213,50,65,107,105,107,86,520,0.7313432835820896,0.5
89,145,90,105,80,91,600,0.8549618320610687,75,95,67,125,95,83,540,0.7117117117117117,2.0
80,82,83,100,100,80,525,0.6742424242424242,76,104,71,104,71,108,534,0.912751677852349,0.5
60,110,70,60,60,100,460,0.8461538461538461,65,65,65,50,50,90,385,0.72,1.0
50,70,160,70,160,90,600,0.7417218543046358,65,95,57,100,85,93,495,0.7441860465116279,1.0
150,80,44,90,54,80,498,0.625,60,70,50,100,50,65,395,0.5217391304347826,2.0
70,135,105,60,105,20,495,0.5806451612903226,62,55,52,109,94,109,481,0.7833333333333333,0.5
82,121,119,69,59,71,521,0.5394736842105263,60,60,60,35,35,30,280,0.11194029850746269,1.0
50,65,107,105,107,86,520,0.703125,65,80,65,35,65,60,370,0.38405797101449274,1.0
123,100,62,97,81,68,531,0.4806201550387597,62,77,62,50,42,65,358,0.4838709677419355,0.5
61,78,95,56,58,57,405,0.40336134453781514,78,52,60,63,65,23,341,0.06015037593984962,1.0
70,50,30,95,135,105,485,0.8040540540540541,60,50,40,85,75,95,405,0.7540983606557377,1.0
40,70,40,35,40,60,285,0.392,45,40,60,40,75,50,310,0.2926829268292683,1.0
99,68,83,72,87,51,460,0.417910447761194,123,100,62,97,81,68,531,0.4806201550387597,1.0
40,45,40,62,60,60,307,0.33884297520661155,75,95,125,45,75,95,510,0.8257575757575758,1.0
45,65,34,40,34,45,263,0.2589928057553957,103,60,86,60,86,50,445,0.3458646616541353,1.0
53,51,53,61,56,40,314,0.14285714285714285,80,125,75,40,95,85,500,0.6911764705882353,1.0
75,70,90,70,105,80,490,0.656,45,60,32,50,32,76,295,0.5925925925925926,0.5
55,81,60,50,70,97,413,0.7214285714285714,77,85,51,55,51,65,384,0.5163934426229508,1.0
30,80,90,55,45,55,355,0.4295774647887324,90,132,105,132,105,30,594,0.4246575342465753,1.0
75,95,125,45,75,95,510,0.8257575757575758,83,80,75,70,70,101,479,0.8615384615384616,0.0
80,125,75,40,95,85,500,0.6911764705882353,65,40,70,80,140,70,465,0.5954198473282443,0.25
40,50,45,70,45,70,320,0.5517241379310345,74,48,76,83,81,104,466,0.7322834645669292,0.5
100,128,90,77,77,128,600,0.959349593495935,100,164,150,95,120,71,700,0.5645161290322581,2.0
75,55,70,55,95,110,460,0.8444444444444444,64,66,68,81,76,50,405,0.25190839694656486,2.0
45,50,45,115,55,95,405,0.6936936936936937,80,92,65,65,80,68,450,0.4824561403508772,1.0
85,105,55,85,50,115,495,0.9032258064516129,106,130,90,110,154,90,680,0.719626168224299,2.0
62,48,54,63,60,68,355,0.5178571428571429,60,45,70,45,90,95,405,0.7304964539007093,1.0
91,72,90,129,90,108,580,0.8925619834710744,65,73,55,47,75,85,400,0.6846846846846847,0.5
45,67,60,35,50,63,320,0.5128205128205128,125,130,90,130,90,95,660,0.7734375,0.5
110,123,65,100,65,65,528,0.5217391304347826,80,100,123,122,120,80,625,0.56,1.0
55,85,55,50,55,60,360,0.4233576642335766,75,80,55,25,35,35,305,0.18666666666666668,0.5
78,92,75,74,63,118,500,0.8842975206611571,50,85,55,65,65,90,410,0.7478260869565218,1.0
59,74,50,35,50,35,303,0.3125,60,60,60,35,35,30,280,0.11194029850746269,0.0
88,107,122,74,75,64,530,0.4596774193548387,50,70,50,50,50,40,310,0.16296296296296298,2.0
57,80,91,80,87,75,470,0.5737704918032787,70,80,70,80,70,110,480,0.6594202898550725,2.0
105,140,95,55,65,45,505,0.3,89,145,90,105,80,91,600,0.8549618320610687,0.5
60,85,40,30,45,68,328,0.6422018348623854,57,80,91,80,87,75,470,0.5737704918032787,2.0
170,90,45,90,45,60,500,0.427536231884058,80,100,70,60,70,95,475,0.7416666666666667,0.5
65,90,40,45,80,75,395,0.625,66,65,48,62,57,52,350,0.36220472440944884,4.0
50,35,55,25,25,15,205,0.05263157894736842,106,150,70,194,120,140,780,0.952,2.0
75,95,125,45,75,95,510,0.8257575757575758,45,50,43,40,38,62,278,0.40441176470588236,0.0
45,30,15,85,65,65,305,0.36220472440944884,50,60,60,60,60,30,320,0.11290322580645161,1.0
60,80,95,70,85,50,440,0.2231404958677686,50,120,53,35,110,87,455,0.640625,1.0
65,90,120,85,70,60,490,0.43410852713178294,45,75,60,40,30,50,300,0.304,1.0
75,75,55,105,85,30,425,0.1619718309859155,55,55,50,45,65,55,325,0.37373737373737376,1.0
63,60,55,50,50,71,349,0.5289256198347108,35,70,55,45,55,25,285,0.09420289855072464,4.0
80,90,80,130,110,110,600,0.856,109,66,84,81,99,32,471,0.2013888888888889,2.0
65,80,65,35,65,60,370,0.38405797101449274,105,105,75,65,100,50,500,0.37593984962406013,1.0
100,134,110,95,100,61,600,0.4057971014492754,80,80,80,55,55,90,440,0.6417910447761194,1.0
79,100,80,110,90,121,580,0.968,50,35,55,25,25,15,205,0.021739130434782608,2.0
89,125,90,115,80,101,600,0.8725490196078431,64,88,50,88,50,106,446,0.9111111111111111,1.0
65,75,70,95,70,95,470,0.7272727272727273,73,76,75,81,100,100,505,0.8110236220472441,1.0
50,50,120,80,80,30,410,0.07258064516129033,25,20,15,105,55,90,310,0.32407407407407407,1.0
61,72,57,55,55,65,365,0.3984375,45,35,45,62,53,35,275,0.11851851851851852,2.0
60,90,140,50,50,40,430,0.2535211267605634,65,50,70,95,80,65,425,0.4262295081967213,1.0
55,70,45,70,50,60,350,0.45,45,49,49,65,65,45,318,0.2781954887218045,2.0
110,65,75,125,85,30,490,0.15,40,80,100,30,30,20,300,0.11851851851851852,2.0
40,60,30,31,31,70,262,0.4492753623188406,70,45,48,60,65,35,323,0.15748031496062992,1.0
73,76,75,81,100,100,505,0.8110236220472441,28,25,25,45,35,40,198,0.16083916083916083,1.0
40,20,30,40,80,55,265,0.22764227642276422,68,65,65,125,115,80,518,0.6461538461538462,1.0
50,65,107,105,107,86,520,0.7272727272727273,65,80,140,40,70,70,465,0.5223880597014925,1.0
95,75,110,100,80,30,490,0.15267175572519084,90,75,75,90,100,70,500,0.5462184873949579,0.5
70,90,110,60,75,95,500,0.7333333333333333,78,84,78,109,85,100,534,0.8646616541353384,1.0
58,70,45,40,45,42,300,0.25925925925925924,70,92,65,80,55,98,460,0.8090909090909091,1.0
104,91,63,91,73,68,490,0.5118110236220472,45,30,50,65,50,45,285,0.13821138211382114,1.0
68,65,65,125,115,80,518,0.6461538461538462,60,100,89,55,69,112,485,0.9298245614035088,1.0
35,40,100,90,55,35,355,0.1796875,45,60,30,80,50,65,330,0.4603174603174603,4.0
39,52,43,60,50,65,309,0.49107142857142855,50,53,62,58,63,44,330,0.13709677419354838,0.5
70,115,60,115,60,55,475,0.4647887323943662,60,85,60,85,60,55,405,0.3673469387755102,0.25
50,30,55,65,55,20,275,0.13675213675213677,49,55,42,42,37,85,310,0.6068376068376068,0.0
50,95,180,85,45,70,525,0.5298507462686567,42,52,67,39,56,50,306,0.2868217054263566,0.5
95,23,48,23,48,23,260,0.046153846153846156,75,75,60,83,60,60,413,0.39344262295081966,1.0
43,70,48,50,60,38,309,0.2391304347826087,40,45,35,65,55,70,310,0.4482758620689655,0.5
150,160,100,95,65,100,670,0.8866666666666667,50,35,55,25,25,15,205,0.021739130434782608,1.0
95,70,73,95,90,60,483,0.3983739837398374,50,80,95,10,45,10,290,0.232,1.0
78,92,75,74,63,118,500,0.8842975206611571,50,55,50,36,30,43,264,0.2922077922077922,1.0
111,83,68,92,82,39,475,0.1774193548387097,40,45,40,65,40,65,295,0.5661764705882353,2.0
50,53,62,58,63,44,330,0.13709677419354838,80,92,65,65,80,68,450,0.4824561403508772,0.5
80,125,75,40,95,85,500,0.6911764705882353,65,150,40,15,80,145,495,0.9663865546218487,0.125
75,80,85,110,90,50,490,0.3548387096774194,50,70,100,40,40,30,330,0.2222222222222222,0.0
58,89,77,45,45,48,362,0.3177570093457944,60,70,50,100,50,65,395,0.5217391304347826,4.0
35,35,40,35,55,50,250,0.40336134453781514,80,50,100,100,200,50,580,0.2357142857142857,1.0
100,150,120,120,100,90,680,0.6493506493506493,50,50,150,50,150,50,500,0.2571428571428571,0.0
100,120,120,150,100,90,680,0.7880794701986755,80,120,80,120,80,100,580,0.8478260869565217,2.0
90,95,95,70,90,70,510,0.5230769230769231,65,125,100,55,70,85,500,0.6532258064516129,0.5
58,64,58,80,65,80,405,0.609271523178808,76,147,90,60,70,97,540,0.8267716535433071,0.5
85,56,77,50,77,78,423,0.53125,65,60,70,85,75,40,395,0.1796875,1.0
83,106,65,86,65,85,490,0.6640625,80,135,85,70,95,150,615,0.9844961240310077,0.5
50,50,50,50,50,50,300,0.30708661417322836,45,49,49,65,65,45,318,0.2781954887218045,2.0
91,72,90,129,90,108,580,0.8620689655172413,65,47,55,73,75,85,400,0.65,0.5
50,53,48,53,48,64,316,0.46153846153846156,50,70,50,50,50,40,310,0.16296296296296298,0.5
75,75,130,75,130,95,580,0.7479674796747967,90,85,75,115,100,115,580,0.9381443298969072,1.0
75,98,63,98,63,101,498,0.889763779527559,41,64,45,50,50,50,300,0.36752136752136755,0.5
55,40,50,65,85,40,335,0.3181818181818182,38,30,41,30,41,60,240,0.2897196261682243,0.0
105,95,75,85,75,74,509,0.5714285714285714,100,100,100,100,100,100,600,0.8778625954198473,4.0
70,110,80,55,80,105,500,0.8794326241134752,64,115,65,83,63,65,455,0.5323741007194245,0.5
50,95,90,95,90,180,600,0.9172413793103448,35,80,50,50,70,120,405,0.84375,2.0
68,72,78,38,42,32,330,0.23809523809523808,55,69,85,32,35,28,304,0.09302325581395349,1.0
70,84,70,65,70,51,410,0.2949640287769784,50,55,50,36,30,43,264,0.2922077922077922,0.0
40,80,35,35,45,70,305,0.4661016949152542,55,65,95,95,45,85,440,0.6610169491525424,1.0
49,49,56,49,61,66,330,0.5190839694656488,50,60,60,60,60,30,320,0.11290322580645161,0.5
65,95,75,55,55,85,430,0.6933333333333334,80,82,83,100,100,80,525,0.6742424242424242,0.5
60,75,85,100,85,115,520,0.8992248062015504,45,30,50,55,65,45,290,0.208,0.5
60,55,145,75,150,40,525,0.2,80,100,70,60,70,95,475,0.7416666666666667,1.0
85,56,77,50,77,78,423,0.53125,35,46,34,35,45,20,215,0.072,1.0
50,75,75,65,65,50,380,0.4049586776859504,70,120,65,45,85,125,510,0.9747899159663865,0.25
74,108,133,83,65,32,495,0.32142857142857145,80,100,200,50,100,50,580,0.3472222222222222,2.0
65,85,70,75,70,40,405,0.203125,44,58,44,58,44,61,309,0.41964285714285715,1.0
90,75,75,90,100,70,500,0.5462184873949579,65,90,40,45,80,75,395,0.625,1.0
65,80,140,40,70,70,465,0.5223880597014925,85,60,65,135,105,100,550,0.7518248175182481,1.0
50,53,48,53,48,64,316,0.4076923076923077,75,75,75,125,95,40,485,0.15671641791044777,1.0
85,50,95,120,115,80,545,0.5793650793650794,79,115,70,125,80,111,580,0.8468468468468469,1.0
43,70,48,50,60,38,309,0.2391304347826087,50,53,48,53,48,64,316,0.4076923076923077,0.5
60,100,115,70,85,90,520,0.7557251908396947,50,85,55,65,65,90,410,0.7478260869565218,0.5
35,35,35,35,35,35,210,0.13385826771653545,65,100,70,80,80,105,500,0.8666666666666667,1.0
62,50,58,73,54,72,369,0.4435483870967742,54,78,103,53,45,22,355,0.23255813953488372,0.125
75,85,200,55,65,30,510,0.16778523489932887,40,30,32,50,52,65,269,0.3671875,0.25
80,105,65,60,75,130,515,0.9645390070921985,45,45,55,45,55,63,308,0.4594594594594595,2.0
60,105,60,120,60,105,510,0.8849557522123894,90,110,80,100,80,95,555,0.7982456140350878,1.0
65,125,100,55,70,85,500,0.6532258064516129,58,64,58,80,65,80,405,0.609271523178808,0.5
100,150,140,100,90,90,670,0.7969924812030075,80,82,83,100,100,80,525,0.6742424242424242,1.0
40,65,40,80,40,65,330,0.5038167938931297,50,52,48,65,50,55,320,0.33098591549295775,1.0
70,92,65,80,55,98,460,0.8090909090909091,44,58,44,58,44,61,309,0.41964285714285715,2.0
65,105,60,60,70,95,455,63.0,85,110,76,65,82,56,474,0.3933333333333333,0.0
78,84,78,109,85,100,534,0.8646616541353384,60,50,100,85,70,65,430,0.47580645161290325,0.5
65,90,122,58,75,84,494,0.71875,190,33,58,33,58,33,405,0.13432835820895522,2.0
75,95,122,58,75,69,494,0.5725806451612904,55,130,115,50,50,75,475,0.5982142857142857,2.0
40,45,65,100,120,90,460,0.5588235294117647,50,75,35,70,30,40,300,0.21296296296296297,1.0
70,145,88,140,70,112,625,0.8888888888888888,73,100,60,100,60,65,458,0.42657342657342656,0.5
30,40,70,70,25,60,295,0.41353383458646614,50,47,50,57,50,65,319,0.463768115942029,1.0
61,72,57,55,55,65,365,0.3984375,110,80,90,95,90,65,530,0.5033557046979866,1.0
60,90,55,90,80,110,485,0.8677685950413223,80,125,75,40,95,85,500,0.6911764705882353,1.0
72,60,30,20,30,25,237,0.11570247933884298,54,63,52,83,56,97,405,0.7697841726618705,1.0
25,20,15,105,55,90,310,0.32407407407407407,50,75,35,70,30,40,300,0.21296296296296297,2.0
65,40,70,80,140,70,465,0.5954198473282443,70,50,30,95,135,105,485,0.8040540540540541,1.0
25,35,70,95,55,45,325,0.16783216783216784,62,73,55,56,52,84,382,0.7244094488188977,1.0
45,65,34,40,34,45,263,0.2589928057553957,50,45,45,35,35,50,260,0.23529411764705882,1.0
80,82,78,95,80,85,500,0.6869565217391305,110,65,75,125,85,30,490,0.15,1.0
55,50,40,40,40,75,300,0.5945945945945946,50,72,35,35,35,65,292,0.5373134328358209,1.0
55,84,105,114,75,52,485,0.2890625,79,103,120,135,115,78,630,0.5763888888888888,0.5
120,70,120,75,130,85,600,0.6694915254237288,63,63,47,41,41,74,329,0.56,0.0
45,50,43,40,38,62,278,0.40441176470588236,46,87,60,30,40,57,320,0.37777777777777777,1.0
80,100,70,50,60,45,405,0.25806451612903225,70,65,65,55,55,70,380,0.5,2.0
40,55,30,30,30,60,245,0.43548387096774194,76,25,45,67,55,24,292,0.0390625,1.0
80,135,130,95,90,70,600,0.5181818181818182,50,95,95,35,110,70,455,0.5179856115107914,1.0
65,65,65,50,50,90,385,0.72,38,35,40,27,25,35,200,0.08208955223880597,1.0
60,50,40,85,75,95,405,0.7540983606557377,35,55,35,30,30,35,220,0.23684210526315788,1.0
50,50,50,50,50,50,300,0.30708661417322836,46,87,60,30,40,57,320,0.37777777777777777,2.0
70,145,88,140,70,112,625,0.8888888888888888,95,75,180,130,80,30,590,0.13793103448275862,0.25
80,105,65,60,75,130,515,0.9645390070921985,40,45,40,35,35,56,251,0.373015873015873,2.0
100,50,50,76,96,70,442,0.5,85,110,90,45,90,80,500,0.6206896551724138,1.0
55,70,55,40,55,85,360,0.7073170731707317,106,150,70,194,120,140,780,0.952,1.0
80,100,200,50,100,50,580,0.3472222222222222,50,80,95,10,45,10,290,0.232,1.0
1,90,45,30,30,40,236,0.33064516129032256,100,100,100,100,100,100,600,0.8778625954198473,2.0
65,45,55,45,70,45,325,0.24369747899159663,70,130,100,55,80,65,500,0.608,1.0
70,110,75,145,85,145,630,0.9444444444444444,75,103,80,70,80,92,500,0.7933884297520661,0.25
103,60,126,80,126,50,545,0.36363636363636365,70,90,45,15,45,50,315,0.3629032258064516,0.5
45,35,45,62,53,35,275,0.11851851851851852,70,110,80,55,80,105,500,0.8794326241134752,0.25
65,110,130,60,65,95,525,0.8278145695364238,35,45,160,30,45,70,385,0.48148148148148145,4.0
100,120,120,150,100,90,680,0.7880794701986755,89,125,90,115,80,101,600,0.8725490196078431,1.0
40,40,35,50,100,70,335,0.5031847133757962,40,45,40,35,35,56,251,0.373015873015873,1.0
50,50,62,40,62,65,329,0.4188034188034188,100,128,90,77,77,128,600,0.959349593495935,1.0
255,10,10,75,135,55,540,0.3125,75,95,122,58,75,69,494,0.5725806451612904,0.0
100,73,83,73,83,55,467,0.371900826446281,73,95,62,85,65,85,465,0.6666666666666666,1.0
45,85,70,40,40,60,340,0.5229357798165137,105,180,100,180,100,115,780,0.9477611940298507,1.0
50,70,50,50,50,70,340,0.5645161290322581,40,70,130,60,130,25,455,0.17355371900826447,1.0
71,73,88,120,89,59,500,0.43537414965986393,78,104,78,159,115,100,634,0.8444444444444444,2.0
50,53,48,53,48,64,316,0.358974358974359,100,100,100,100,100,100,600,0.8602941176470589,0.5
50,180,20,180,20,150,600,0.9029850746268657,91,90,106,130,106,77,600,0.648854961832061,0.5
105,95,80,40,80,90,490,0.753968253968254,65,80,65,35,65,60,370,0.38405797101449274,1.0
70,90,70,60,60,70,420,0.6390977443609023,65,65,60,110,95,130,525,0.9253731343283582,1.0
70,140,230,60,80,50,630,0.32432432432432434,95,65,110,60,130,65,525,0.5275590551181102,1.0
105,140,55,30,55,95,480,0.8195488721804511,35,80,50,50,70,120,405,0.84375,1.0
116,55,85,107,95,29,487,0.06818181818181818,68,72,78,38,42,32,330,0.23809523809523808,2.0
55,84,105,114,75,52,485,0.2890625,60,65,60,130,75,110,500,0.7719298245614035,1.0
84,71,43,71,43,48,360,0.25874125874125875,110,160,110,80,110,100,670,0.8591549295774648,1.0
55,40,50,65,85,40,335,0.3181818181818182,30,45,59,30,39,57,260,0.2803030303030303,1.0
38,30,85,55,65,30,303,0.21428571428571427,60,75,100,55,80,50,420,0.3088235294117647,2.0
70,100,115,30,65,30,410,0.24390243902439024,46,57,40,40,40,50,273,0.25,1.0
80,82,78,95,80,85,500,0.6869565217391305,60,67,85,77,75,116,480,0.8888888888888888,0.5
65,95,75,55,55,85,430,0.6933333333333334,59,66,70,44,55,41,335,0.25190839694656486,0.5
60,50,100,85,70,65,430,0.47580645161290325,60,100,115,70,85,90,520,0.7557251908396947,0.5
120,120,120,120,120,120,720,0.9344262295081968,45,45,35,20,30,20,195,0.07246376811594203,1.0
65,155,120,65,90,105,600,0.8677685950413223,45,35,45,62,53,35,275,0.11851851851851852,4.0
66,41,77,61,87,23,355,0.12096774193548387,45,45,35,20,30,20,195,0.07246376811594203,1.0
150,100,120,100,120,90,680,0.6666666666666666,65,45,55,45,70,45,325,0.24369747899159663,1.0
85,105,100,79,83,78,530,0.5869565217391305,100,100,100,100,100,100,600,0.8602941176470589,0.5
40,70,130,60,130,25,455,0.17355371900826447,120,120,120,120,120,120,720,0.9344262295081968,0.0
38,35,35,65,55,50,278,0.2647058823529412,20,10,55,15,20,80,200,0.17985611510791366,1.0
80,50,100,100,200,50,580,0.2357142857142857,50,40,85,40,65,25,305,0.08870967741935484,1.0
50,65,107,105,107,86,520,0.7313432835820896,63,60,55,50,50,71,349,0.5289256198347108,1.0
84,86,88,111,101,60,530,0.4634146341463415,50,65,107,105,107,86,520,0.703125,1.0
60,115,105,65,70,80,495,0.7181818181818181,78,52,60,63,65,23,341,0.06015037593984962,1.0
50,105,125,55,95,50,480,0.375886524822695,68,65,65,125,115,80,518,0.6461538461538462,0.5
68,90,65,50,55,82,410,0.6165413533834586,45,95,50,40,50,75,355,0.54,1.0
75,100,66,60,66,115,482,0.918918918918919,54,63,52,83,56,97,405,0.7697841726618705,1.0
99,68,83,72,87,51,460,0.417910447761194,103,93,67,71,61,84,479,0.7142857142857143,0.5
31,45,90,30,30,40,266,0.21929824561403508,60,60,60,105,105,105,495,0.848,0.5
40,40,50,30,30,30,220,0.0873015873015873,55,20,35,20,45,75,250,0.37681159420289856,1.0
31,45,90,30,30,40,266,0.21929824561403508,60,79,105,59,85,36,424,0.17054263565891473,0.5
60,100,89,55,69,112,485,0.9298245614035088,40,20,30,40,80,55,265,0.22764227642276422,0.5
65,100,70,80,80,105,500,0.8666666666666667,71,82,64,64,59,112,452,0.9327731092436975,1.0
70,75,60,105,60,105,475,0.88,65,40,50,125,60,30,370,0.07258064516129033,1.0
90,93,55,70,55,55,418,0.3819444444444444,60,70,50,100,50,65,395,0.5217391304347826,0.5
100,150,110,95,110,70,635,0.5923076923076923,70,62,67,55,55,56,365,0.38513513513513514,2.0
150,120,100,120,100,90,680,0.664179104477612,50,45,45,35,35,50,260,0.23529411764705882,0.0
100,90,130,45,65,55,485,0.4253731343283582,55,70,45,70,50,60,350,0.45,4.0
150,80,44,90,54,80,498,0.625,65,125,100,60,70,70,490,0.6099290780141844,0.25
80,45,65,90,110,80,470,0.5462962962962963,85,100,122,58,75,54,494,0.3939393939393939,1.0
58,64,58,80,65,80,405,0.609271523178808,50,53,62,58,63,44,330,0.13709677419354838,0.5
84,71,43,71,43,48,360,0.25874125874125875,73,100,60,100,60,65,458,0.42657342657342656,1.0
45,60,45,25,45,55,275,0.29,45,85,50,55,50,65,350,0.5076923076923077,1.0
50,85,85,55,55,50,380,0.3902439024390244,60,60,60,85,85,85,435,0.631578947368421,1.0
58,50,145,95,105,30,483,0.2459016393442623,60,67,85,77,75,116,480,0.8888888888888888,1.0
62,73,55,56,52,84,382,0.7244094488188977,70,120,100,145,105,20,560,0.2824427480916031,0.5
38,35,35,65,55,50,278,0.2647058823529412,25,35,70,95,55,45,325,0.16783216783216784,0.25
70,80,102,80,102,40,474,0.2677165354330709,120,100,85,30,85,45,465,0.22448979591836735,1.0
20,15,20,10,55,80,200,0.2682926829268293,70,43,53,43,53,40,302,0.19090909090909092,1.0
79,85,60,55,60,71,410,0.60431654676259,40,30,50,55,55,100,330,0.584070796460177,1.0
91,129,90,72,90,108,580,0.8536585365853658,68,90,65,50,55,82,410,0.6165413533834586,0.5
90,100,70,110,150,80,600,0.6037735849056604,40,30,30,55,30,85,270,0.4666666666666667,1.0
60,25,35,70,80,60,330,0.3076923076923077,77,85,51,55,51,65,384,0.5163934426229508,1.0
80,52,50,90,50,89,411,0.6666666666666666,106,90,130,90,154,110,680,0.8699186991869918,1.0
50,30,55,65,55,20,275,0.13675213675213677,50,50,95,40,50,35,320,0.20279720279720279,1.0
85,100,122,58,75,54,494,0.3939393939393939,50,35,55,25,25,15,205,0.021739130434782608,0.5
70,100,70,105,75,40,460,0.23214285714285715,65,73,55,47,75,85,400,0.6846846846846847,1.0
60,82,45,45,45,74,351,0.5752212389380531,50,85,40,85,40,35,335,0.1746031746031746,0.5
20,40,15,35,35,60,205,0.34285714285714286,85,90,80,70,80,130,535,0.9262295081967213,2.0
70,100,70,105,75,40,460,0.23214285714285715,45,25,50,25,25,35,205,0.13076923076923078,2.0
59,45,40,35,40,31,250,0.14285714285714285,115,45,20,45,25,20,270,0.11538461538461539,1.0
150,160,100,95,65,100,670,0.8866666666666667,54,63,52,83,56,97,405,0.7697841726618705,1.0
75,90,90,140,90,115,600,0.9481481481481482,70,50,30,95,135,105,485,0.8040540540540541,2.0
45,55,39,35,39,42,255,0.18518518518518517,68,75,53,83,113,60,452,0.45384615384615384,1.0
80,160,60,170,130,80,680,0.6180555555555556,40,60,30,31,31,70,262,0.4492753623188406,1.0
75,75,75,125,95,40,485,0.15671641791044777,75,80,70,65,75,90,455,0.7578125,2.0
85,110,76,65,82,56,474,0.3933333333333333,40,45,35,40,40,90,290,0.65,0.0
65,47,55,73,75,85,400,0.65,60,45,70,45,90,95,405,0.7304964539007093,1.0
123,77,72,99,92,58,521,0.4621212121212121,72,85,70,65,70,58,420,0.41304347826086957,2.0
45,30,15,85,65,65,305,0.36220472440944884,43,70,48,50,60,38,309,0.2391304347826087,2.0
71,120,95,120,95,99,600,0.8203125,45,50,43,40,38,62,278,0.40441176470588236,0.5
108,170,115,120,95,92,700,0.7083333333333334,150,160,100,95,65,100,670,0.8866666666666667,1.0
75,80,85,110,90,50,490,0.3548387096774194,50,70,100,40,40,30,330,0.2222222222222222,0.0
45,100,45,45,45,10,290,0.2949640287769784,50,60,60,60,60,30,320,0.11290322580645161,2.0
65,90,40,45,80,75,395,0.625,74,94,131,54,116,20,489,0.4485294117647059,0.0
65,63,45,45,45,45,308,0.2595419847328244,80,130,100,160,120,110,700,0.8981481481481481,0.5
60,130,80,60,60,70,460,0.5153846153846153,80,52,50,90,50,89,411,0.6666666666666666,0.0625
55,20,35,20,45,75,250,0.37681159420289856,49,66,70,44,55,51,335,0.4260869565217391,0.0
45,90,20,65,20,65,305,0.5116279069767442,78,84,78,109,85,100,534,0.8620689655172413,2.0
50,48,43,46,41,60,288,0.47297297297297297,100,128,90,77,77,128,600,0.959349593495935,1.0
70,60,75,110,75,90,480,0.7165354330708661,60,62,63,80,80,60,405,0.38016528925619836,0.25
75,80,85,110,90,50,490,0.3548387096774194,70,55,95,95,110,65,490,0.48872180451127817,1.0
85,97,66,105,66,65,484,0.47107438016528924,70,65,60,90,75,90,450,0.6571428571428571,2.0
65,90,120,85,70,60,490,0.43410852713178294,80,105,105,105,105,80,580,0.5939849624060151,1.0
80,110,60,150,130,70,600,0.5042016806722689,67,125,40,30,30,58,350,0.3431372549019608,1.0
65,95,57,100,85,93,495,0.7441860465116279,70,62,67,55,55,56,365,0.38513513513513514,1.0
114,85,70,85,80,30,464,0.2066115702479339,35,55,35,30,30,35,220,0.23684210526315788,1.0
70,135,105,60,105,20,495,0.5806451612903226,90,90,85,125,90,100,580,0.768595041322314,0.25
66,117,70,40,50,67,410,0.4573643410852713,86,92,88,68,75,73,482,0.6835443037974683,1.0
80,52,50,90,50,89,411,0.6666666666666666,25,20,15,105,55,90,310,0.32407407407407407,2.0
40,50,90,30,55,65,330,0.44680851063829785,90,75,75,90,100,70,500,0.5462184873949579,1.0
73,115,60,60,60,90,458,0.6694915254237288,70,120,40,95,40,95,460,0.8106060606060606,1.0
65,130,60,75,60,75,465,0.689922480620155,65,95,75,55,55,85,430,0.6933333333333334,1.0
40,80,35,35,45,70,305,0.4661016949152542,60,50,40,85,75,95,405,0.7540983606557377,1.0
65,136,94,54,96,135,580,0.9612403100775194,110,65,105,55,95,80,510,0.6258503401360545,1.0
115,140,130,55,55,40,535,0.4519230769230769,62,50,58,73,54,72,369,0.4435483870967742,4.0
65,45,55,45,70,45,325,0.24369747899159663,60,55,50,40,55,45,305,0.22377622377622378,1.0
48,61,40,61,40,50,300,0.2543859649122807,60,85,60,85,60,55,405,0.3673469387755102,1.0
95,109,105,75,85,56,525,0.34513274336283184,41,64,45,50,50,50,300,0.36752136752136755,0.5
150,120,100,120,100,90,680,0.664179104477612,75,110,110,110,105,80,590,0.656934306569343,0.0
70,110,70,115,70,90,525,0.75,50,35,55,25,25,15,205,0.021739130434782608,0.5
62,77,62,50,42,65,358,0.4838709677419355,37,25,41,25,41,25,194,0.08870967741935484,2.0
61,72,57,55,55,65,365,0.3984375,70,90,70,60,60,70,420,0.6390977443609023,1.0
75,103,80,70,80,92,500,0.7933884297520661,80,160,60,170,130,80,680,0.6180555555555556,4.0
70,135,105,60,105,20,495,0.5806451612903226,120,100,85,30,85,45,465,0.22448979591836735,0.5
100,150,110,95,110,70,635,0.5923076923076923,90,110,80,100,80,95,555,0.7982456140350878,4.0
70,110,180,60,60,50,530,0.4117647058823529,35,80,50,50,70,120,405,0.84375,0.5
71,73,88,120,89,59,500,0.43537414965986393,45,53,70,40,60,42,310,0.25735294117647056,0.5
50,45,45,35,35,50,260,0.23529411764705882,72,95,67,103,71,122,530,0.9606299212598425,1.0
50,50,40,50,40,64,294,0.45588235294117646,70,55,55,80,60,45,365,0.2222222222222222,1.0
45,100,135,65,135,45,525,0.29411764705882354,55,40,50,65,85,40,335,0.3181818181818182,2.0
105,95,75,85,75,74,509,0.5714285714285714,85,80,70,135,75,90,535,0.7006802721088435,1.0
95,109,105,75,85,56,525,0.34513274336283184,38,35,35,65,55,50,278,0.2647058823529412,1.0
126,131,95,131,98,99,680,0.8102189781021898,55,45,43,55,43,72,313,0.5853658536585366,2.0
30,30,42,30,42,70,244,0.4230769230769231,60,100,85,80,85,100,510,0.7007874015748031,2.0
65,105,60,60,70,95,455,63.0,41,56,40,62,44,71,314,0.568,1.0
55,40,85,80,105,40,405,0.23622047244094488,60,85,40,30,45,68,328,0.6422018348623854,1.0
62,48,66,59,57,49,341,0.33884297520661155,55,65,35,60,30,85,330,0.6126126126126126,1.0
120,100,85,30,85,45,465,0.22448979591836735,70,55,75,45,65,60,370,0.45901639344262296,1.0
50,150,50,150,50,150,600,0.9339622641509434,25,20,15,105,55,90,310,0.32407407407407407,0.5
45,65,34,40,34,45,263,0.2589928057553957,89,124,80,55,80,55,483,0.5714285714285714,0.0
100,73,83,73,83,55,467,0.371900826446281,75,80,85,110,90,50,490,0.3548387096774194,1.0
30,56,35,25,35,72,253,0.48148148148148145,75,140,65,112,65,110,567,0.9140625,0.5
65,65,45,75,45,95,390,0.72,45,25,50,25,25,35,205,0.13076923076923078,1.0
40,40,35,50,100,70,335,0.5031847133757962,58,64,58,80,65,80,405,0.609271523178808,2.0
66,41,77,61,87,23,355,0.12096774193548387,30,45,55,70,55,85,340,0.5633802816901409,2.0
91,134,95,100,100,80,600,0.6304347826086957,60,48,45,43,90,42,328,0.21897810218978103,1.0
105,95,80,40,80,90,490,0.753968253968254,65,65,60,110,95,130,525,0.9253731343283582,1.0
108,130,95,80,85,102,600,0.7637795275590551,45,55,45,65,45,75,330,0.5692307692307692,0.0
70,90,90,135,90,125,600,0.9401709401709402,55,66,44,44,56,85,350,0.6888888888888889,1.0
45,25,50,25,25,35,205,0.13076923076923078,35,85,45,35,35,75,310,0.6492537313432836,0.5
90,100,90,125,85,90,580,0.7352941176470589,55,55,85,65,85,35,380,0.2014388489208633,0.125
30,45,135,45,90,30,375,0.09285714285714286,44,50,91,24,86,10,305,0.1981981981981982,0.5
74,108,133,83,65,32,495,0.32142857142857145,150,160,100,95,65,100,670,0.8866666666666667,1.0
110,65,105,55,95,80,510,0.6258503401360545,126,131,95,131,98,99,680,0.8102189781021898,0.5
38,35,35,65,55,50,278,0.2647058823529412,60,50,150,50,150,60,520,0.5206611570247934,0.25
75,95,67,125,95,83,540,0.7117117117117117,50,92,108,92,108,35,485,0.2457627118644068,1.0
45,40,60,40,75,50,310,0.2926829268292683,65,90,50,85,45,55,390,0.371900826446281,2.0
97,165,60,65,50,58,495,0.3902439024390244,85,120,70,50,60,100,485,0.8308823529411765,2.0
85,76,64,45,55,90,415,0.6739130434782609,65,75,90,97,123,44,494,0.1987179487179487,1.0
60,60,60,105,105,105,495,0.848,75,95,125,45,75,95,510,0.8257575757575758,1.0
85,120,70,50,60,100,485,0.8308823529411765,45,63,37,65,55,95,360,0.8055555555555556,0.5
80,120,130,55,65,45,495,0.37037037037037035,45,60,32,50,32,76,295,0.5925925925925926,2.0
50,75,45,40,45,60,315,0.4380165289256198,41,50,37,50,37,66,281,0.5175438596491229,2.0
64,66,68,81,76,50,405,0.25190839694656486,64,115,65,83,63,65,455,0.5323741007194245,1.0
75,75,130,75,130,95,580,0.7479674796747967,35,70,55,45,55,25,285,0.09420289855072464,1.0
108,100,121,81,95,95,600,0.7476635514018691,55,65,95,95,45,85,440,0.6610169491525424,1.0
72,60,30,20,30,25,237,0.11570247933884298,85,115,80,105,80,50,515,0.3063063063063063,1.0
80,70,70,90,100,70,480,0.5609756097560976,60,75,100,55,80,50,420,0.3088235294117647,0.5
44,38,39,61,79,42,303,0.2251655629139073,60,60,60,60,60,60,360,0.38095238095238093,1.0
80,120,80,120,80,100,580,0.8478260869565217,95,75,110,100,80,30,490,0.15267175572519084,0.5
75,70,90,70,105,80,490,0.656,80,82,100,83,100,80,525,0.6821705426356589,2.0
80,105,65,60,75,130,515,0.9645390070921985,80,100,80,80,80,100,520,0.9051724137931034,0.5
50,92,108,92,108,35,485,0.2457627118644068,60,85,69,60,69,77,420,0.518796992481203,0.0
55,85,55,50,55,60,360,0.4233576642335766,75,80,85,110,90,50,490,0.3548387096774194,2.0
60,100,115,70,85,90,520,0.7557251908396947,40,45,65,100,120,90,460,0.5588235294117647,0.5
165,75,80,40,45,65,470,0.5151515151515151,65,76,84,54,96,105,480,0.9008264462809917,1.0
37,25,41,25,41,25,194,0.08870967741935484,35,46,34,35,45,20,215,0.072,1.0
76,25,45,67,55,24,292,0.0390625,123,100,62,97,81,68,531,0.4806201550387597,1.0
75,98,63,98,63,101,498,0.8091603053435115,43,70,48,50,60,38,309,0.2391304347826087,0.5
25,35,70,95,55,45,325,0.16783216783216784,50,47,50,57,50,65,319,0.463768115942029,0.25
75,38,38,56,56,67,330,0.5263157894736842,95,125,79,60,100,81,540,0.6165413533834586,2.0
70,115,60,115,60,55,475,0.4647887323943662,85,110,76,65,82,56,474,0.3933333333333333,1.0
60,65,60,130,75,110,500,0.7719298245614035,70,110,70,115,70,90,525,0.75,0.0
91,90,72,90,129,108,580,0.896,60,75,100,55,80,50,420,0.3088235294117647,0.5
120,70,120,75,130,85,600,0.6694915254237288,75,80,85,110,90,50,490,0.3548387096774194,2.0
65,75,90,97,123,44,494,0.1987179487179487,64,165,75,93,83,75,555,0.6587301587301587,0.5
50,85,125,85,115,20,480,0.4306569343065693,60,50,40,85,75,95,405,0.7540983606557377,1.0
90,95,105,165,110,45,610,0.2890625,65,65,65,50,50,90,385,0.72,2.0
75,69,72,114,100,104,534,0.8253968253968254,70,60,62,80,82,60,414,0.4375,2.0
70,100,70,105,75,40,460,0.23214285714285715,76,48,48,57,62,34,325,0.11688311688311688,0.5
95,109,105,75,85,56,525,0.34513274336283184,35,20,65,40,65,20,245,0.02459016393442623,1.0
70,145,88,140,70,112,625,0.8888888888888888,80,80,80,80,80,80,480,0.6015037593984962,4.0
78,104,78,159,115,100,634,0.8444444444444444,55,50,40,40,40,75,300,0.5945945945945946,1.0
85,135,130,60,80,25,515,0.40540540540540543,80,160,80,130,80,100,630,0.8455284552845529,1.0
75,80,60,65,90,102,472,0.8625954198473282,90,120,100,150,120,100,680,0.7718120805369127,1.0
106,190,100,154,100,130,780,0.9259259259259259,85,110,76,65,82,56,474,0.3933333333333333,0.0
100,70,70,65,65,45,415,0.1897810218978102,70,110,180,60,60,50,530,0.4117647058823529,0.25
40,27,60,37,50,66,280,0.36220472440944884,70,120,40,95,40,95,460,0.8106060606060606,4.0
50,50,40,50,40,64,294,0.45588235294117646,75,87,63,87,63,98,473,0.865546218487395,0.5
78,81,71,74,69,126,499,0.9090909090909091,110,130,80,70,60,80,530,0.5862068965517241,2.0
103,60,126,80,126,50,545,0.36363636363636365,100,103,75,120,75,127,600,0.940677966101695,1.0
50,65,107,105,107,86,520,0.7758620689655172,90,95,105,165,110,45,610,0.2890625,0.125
55,130,115,50,50,75,475,0.5982142857142857,75,110,110,110,105,80,590,0.656934306569343,0.5
70,70,115,130,90,60,535,0.5338983050847458,90,50,34,60,44,70,348,0.6283185840707964,2.0
70,110,70,115,70,90,525,0.75,80,90,80,130,110,110,600,0.856,0.5
59,45,40,35,40,31,250,0.14285714285714285,59,66,70,44,55,41,335,0.25190839694656486,0.0
58,89,77,45,45,48,362,0.3177570093457944,80,115,80,65,55,93,488,0.7846153846153846,2.0
50,60,45,100,80,65,400,0.45689655172413796,70,84,70,65,70,51,410,0.2949640287769784,1.0
60,85,60,85,60,55,405,0.3673469387755102,75,70,90,70,105,80,490,0.656,0.25
65,80,140,40,70,70,465,0.5223880597014925,40,40,35,50,100,70,335,0.5031847133757962,0.5
65,130,60,75,60,75,465,0.689922480620155,40,30,32,50,52,65,269,0.3671875,1.0
50,95,95,35,110,70,455,0.5179856115107914,82,80,86,85,75,72,480,0.6183206106870229,0.5
65,125,60,95,60,105,510,0.9236641221374046,80,120,79,95,79,70,523,0.5833333333333334,1.0
65,90,122,58,75,84,494,0.71875,60,150,50,150,50,60,520,0.5,1.0
100,5,5,15,65,30,220,0.07692307692307693,44,50,91,24,86,10,305,0.1981981981981982,0.5
70,110,70,115,70,90,525,0.75,35,40,100,90,55,35,355,0.1796875,2.0
62,48,66,59,57,49,341,0.33884297520661155,38,41,40,50,65,65,299,0.4108527131782946,0.5
58,70,45,40,45,42,300,0.25925925925925924,75,80,60,65,90,102,472,0.8625954198473282,1.0
106,150,70,194,120,140,780,0.952,65,125,100,55,70,85,500,0.6532258064516129,1.0
105,150,90,150,90,95,680,0.8285714285714286,110,85,95,80,95,50,515,0.2713178294573643,1.0
50,53,62,58,63,44,330,0.13709677419354838,50,75,35,70,30,40,300,0.21296296296296297,0.5
89,124,80,55,80,55,483,0.5714285714285714,75,69,72,114,100,104,534,0.8253968253968254,4.0
80,45,65,90,110,80,470,0.5462962962962963,78,84,78,109,85,100,534,0.8646616541353384,1.0
80,92,65,65,80,68,450,0.4824561403508772,91,90,106,130,106,77,600,0.648854961832061,2.0
60,70,105,70,120,75,500,0.5983606557377049,65,90,120,85,70,60,490,0.43410852713178294,4.0
40,70,40,35,40,60,285,0.392,90,75,75,90,100,70,500,0.5462184873949579,1.0
75,98,63,98,63,101,498,0.8091603053435115,65,95,75,55,55,85,430,0.6933333333333334,1.0
75,110,110,110,105,80,590,0.656934306569343,40,60,40,40,40,30,250,0.0948905109489051,0.5
125,170,100,120,90,95,700,0.77,45,50,55,75,65,30,320,0.06293706293706294,2.0
105,125,100,60,100,100,590,0.8359375,50,35,55,25,25,15,205,0.05263157894736842,1.0
40,55,30,30,30,85,270,0.688,65,40,70,80,140,70,465,0.5954198473282443,1.0
45,85,50,55,50,65,350,0.5076923076923077,75,95,122,58,75,69,494,0.5725806451612904,0.0
64,115,65,83,63,65,455,0.5323741007194245,50,50,62,40,62,65,329,0.4188034188034188,1.0
56,61,65,48,45,38,313,0.17567567567567569,35,55,35,30,30,35,220,0.23684210526315788,1.0
89,124,80,55,80,55,483,0.5714285714285714,90,130,80,65,85,55,505,0.4396551724137931,1.0
68,75,53,83,113,60,452,0.45384615384615384,109,66,84,81,99,32,471,0.2013888888888889,1.0
82,121,119,69,59,71,521,0.5394736842105263,95,117,80,65,70,92,519,0.8409090909090909,0.5
60,60,75,60,75,80,410,0.7321428571428571,68,72,78,38,42,32,330,0.23809523809523808,2.0
50,85,55,65,65,90,410,0.7478260869565218,40,45,35,65,55,70,310,0.4482758620689655,2.0
76,104,71,104,71,108,534,0.912751677852349,50,25,28,45,55,15,218,0.0625,0.5
60,100,115,70,85,90,520,0.7557251908396947,60,30,30,36,56,50,262,0.32432432432432434,1.0
75,38,38,56,56,67,330,0.5263157894736842,85,115,80,105,80,50,515,0.3063063063063063,0.5
77,85,51,55,51,65,384,0.5163934426229508,120,120,120,120,120,120,720,0.9344262295081968,1.0
67,125,40,30,30,58,350,0.3431372549019608,50,20,40,20,40,20,190,0.0962962962962963,1.0
74,48,76,83,81,104,466,0.7322834645669292,70,80,70,80,70,110,480,0.6594202898550725,1.0
100,50,80,60,80,50,420,0.34375,95,75,180,130,80,30,590,0.13793103448275862,0.5
75,75,60,83,60,60,413,0.39344262295081966,65,125,100,60,70,70,490,0.6099290780141844,1.0
50,47,50,57,50,65,319,0.463768115942029,40,35,30,20,20,50,195,0.23423423423423423,0.5
45,90,20,65,20,65,305,0.5116279069767442,77,120,90,60,90,48,485,0.2785714285714286,0.5
45,100,135,65,135,45,525,0.29411764705882354,65,90,122,58,75,84,494,0.71875,2.0
60,65,70,85,75,40,395,0.21705426356589147,95,110,95,40,95,55,490,0.40336134453781514,1.0
50,48,43,46,41,60,288,0.47297297297297297,40,50,90,30,55,65,330,0.44680851063829785,1.0
43,30,55,40,65,97,330,0.6030534351145038,85,50,95,120,115,80,545,0.5793650793650794,1.0
50,65,107,105,107,86,520,0.7313432835820896,85,90,80,70,80,130,535,0.9262295081967213,0.5
41,50,37,50,37,66,281,0.5175438596491229,70,90,45,15,45,50,315,0.3629032258064516,1.0
71,120,95,120,95,99,600,0.8203125,45,75,37,70,55,83,365,0.6183206106870229,0.25
101,72,72,99,89,29,462,0.1937984496124031,50,85,55,65,65,90,410,0.7478260869565218,0.5
50,105,79,35,110,76,455,0.6214285714285714,75,98,63,98,63,101,498,0.889763779527559,1.0
100,120,100,150,120,90,680,0.728,91,90,72,90,129,108,580,0.896,2.0
57,24,86,24,86,23,300,0.12727272727272726,40,30,30,40,50,30,220,0.07936507936507936,0.5
75,80,95,90,100,50,490,0.2158273381294964,66,65,48,62,57,52,350,0.36220472440944884,0.5
80,135,85,70,95,150,615,0.9844961240310077,46,87,60,30,40,57,320,0.37777777777777777,1.0
65,73,55,47,75,85,400,0.6846846846846847,60,40,60,95,60,55,370,0.4222222222222222,0.25
75,95,60,65,60,115,470,0.8778625954198473,109,66,84,81,99,32,471,0.2013888888888889,1.0
50,65,107,105,107,86,520,0.7272727272727273,60,60,75,60,75,80,410,0.7321428571428571,2.0
75,89,85,55,65,36,405,0.29545454545454547,80,120,80,120,80,100,580,0.8478260869565217,1.0
30,105,90,25,25,50,325,0.2773722627737226,45,95,50,40,50,75,355,0.54,2.0
100,70,70,65,65,45,415,0.1897810218978102,88,107,122,74,75,64,530,0.4596774193548387,1.0
86,76,86,116,56,95,515,0.7982456140350878,70,70,70,70,70,70,420,0.5289256198347108,1.0
50,75,75,65,65,50,380,0.4049586776859504,73,115,60,60,60,90,458,0.6694915254237288,0.0
100,180,160,150,90,90,770,0.7520661157024794,95,95,85,125,65,55,520,0.3894736842105263,1.0
41,50,37,50,37,66,281,0.5175438596491229,78,81,71,74,69,126,499,0.9090909090909091,1.0
80,80,80,80,80,80,480,0.5606060606060606,95,155,109,70,130,81,640,0.6788321167883211,0.5
65,125,100,60,70,70,490,0.6099290780141844,90,65,65,40,40,15,315,0.19672131147540983,1.0
45,50,55,75,65,30,320,0.06293706293706294,100,134,110,95,100,61,600,0.4057971014492754,1.0
126,131,95,131,98,99,680,0.8102189781021898,40,55,99,40,79,47,360,0.26262626262626265,2.0
45,100,45,45,45,10,290,0.2949640287769784,20,10,55,15,20,80,200,0.17985611510791366,1.0
80,130,100,160,120,110,700,0.8981481481481481,45,35,45,62,53,35,275,0.11851851851851852,1.0
95,85,85,65,65,35,430,0.2571428571428571,30,42,118,42,88,30,350,0.112,8.0
60,55,90,145,90,80,520,0.6071428571428571,35,55,40,50,50,90,320,0.6838235294117647,1.0
70,84,70,65,70,51,410,0.2949640287769784,108,130,95,80,85,102,600,0.7637795275590551,0.5
50,53,62,58,63,44,330,0.13709677419354838,70,85,140,85,70,20,470,0.272,2.0
50,45,45,35,35,50,260,0.23529411764705882,76,147,90,60,70,97,540,0.8267716535433071,1.0
80,45,65,90,110,80,470,0.5462962962962963,51,65,65,80,75,59,395,0.4365079365079365,1.0
50,30,55,65,55,20,275,0.13675213675213677,70,43,53,43,53,40,302,0.19090909090909092,1.0
50,53,62,58,63,44,330,0.13709677419354838,50,50,40,30,30,50,250,0.2781954887218045,2.0
20,25,45,70,90,60,310,0.30833333333333335,95,85,85,65,65,35,430,0.2571428571428571,2.0
85,115,80,105,80,50,515,0.3063063063063063,60,100,115,70,85,90,520,0.7557251908396947,1.0
71,82,64,64,59,112,452,0.9327731092436975,41,50,37,50,37,66,281,0.5175438596491229,1.0
75,80,85,110,90,50,490,0.3548387096774194,150,100,120,100,120,90,680,0.6666666666666666,0.25
50,50,40,30,30,50,250,0.2781954887218045,62,50,58,73,54,72,369,0.4435483870967742,1.0
80,120,70,110,70,80,530,0.6422764227642277,45,30,35,20,20,45,195,0.14782608695652175,1.0
110,123,65,100,65,65,528,0.5217391304347826,100,123,75,57,75,80,510,0.6923076923076923,1.0
60,105,60,120,60,105,510,0.8849557522123894,97,165,60,65,50,58,495,0.3902439024390244,1.0
73,76,75,81,100,100,505,0.8110236220472441,81,102,77,85,75,85,505,0.5642857142857143,1.0
65,136,94,54,96,135,580,0.9612403100775194,50,20,40,20,40,20,190,0.0962962962962963,1.0
65,85,70,75,70,40,405,0.203125,40,70,40,35,40,60,285,0.392,1.0
50,95,90,95,90,180,600,0.9172413793103448,50,53,48,53,48,64,316,0.4076923076923077,1.0
55,70,40,60,40,40,305,0.26956521739130435,68,72,78,38,42,32,330,0.23809523809523808,2.0
85,73,70,73,115,67,483,0.5126050420168067,83,106,65,86,65,85,490,0.6640625,2.0
50,35,55,25,25,15,205,0.05263157894736842,70,55,65,95,85,70,440,0.5307692307692308,2.0
85,80,70,135,75,90,535,0.7006802721088435,60,100,115,70,85,90,520,0.7557251908396947,0.5
45,35,45,62,53,35,275,0.11851851851851852,38,41,40,50,65,65,299,0.4108527131782946,0.5
55,45,43,55,43,72,313,0.5853658536585366,165,75,80,40,45,65,470,0.5151515151515151,1.0
45,60,30,80,50,65,330,0.4603174603174603,60,30,30,36,56,50,262,0.32432432432432434,1.0
45,75,60,40,30,50,300,0.304,40,27,60,37,50,66,280,0.36220472440944884,0.0
60,45,70,75,85,55,390,0.3008130081300813,100,150,90,180,160,90,770,0.7348484848484849,1.0
65,70,60,65,65,115,440,0.8583333333333333,75,95,67,125,95,83,540,0.7117117117117117,1.0
38,41,40,50,65,65,299,0.4108527131782946,100,90,130,45,65,55,485,0.4253731343283582,0.25
48,72,48,72,48,48,336,0.25984251968503935,40,40,55,40,70,55,300,0.40939597315436244,1.0
60,50,50,60,70,50,340,0.28346456692913385,50,35,55,25,25,15,205,0.021739130434782608,0.5
105,95,80,40,80,90,490,0.753968253968254,50,105,79,35,110,76,455,0.6214285714285714,1.0
95,117,184,44,46,28,514,0.2975206611570248,60,50,70,50,90,65,385,0.39568345323741005,1.0
60,50,50,60,70,50,340,0.28346456692913385,80,110,60,150,130,70,600,0.5042016806722689,1.0
54,78,103,53,45,22,355,0.23255813953488372,50,45,45,35,35,50,260,0.23529411764705882,1.0
81,102,77,85,75,85,505,0.5642857142857143,65,85,70,75,70,40,405,0.203125,2.0
39,52,43,60,50,65,309,0.49107142857142855,100,150,90,180,160,90,770,0.7348484848484849,0.5
90,70,80,70,95,70,475,0.5190839694656488,50,70,100,40,40,30,330,0.2222222222222222,1.0
70,55,75,45,65,60,370,0.45901639344262296,31,45,90,30,30,40,266,0.21929824561403508,2.0
45,30,35,20,20,45,195,0.14782608695652175,80,160,80,130,80,100,630,0.8455284552845529,0.25
70,90,70,60,60,70,420,0.6390977443609023,70,90,45,15,45,50,315,0.3629032258064516,1.0
38,30,41,30,41,60,240,0.2897196261682243,85,60,65,135,105,100,550,0.7518248175182481,1.0
65,45,55,45,70,45,325,0.24369747899159663,55,55,55,85,55,30,335,0.1320754716981132,1.0
60,85,49,60,49,60,363,0.4444444444444444,60,85,40,30,45,68,328,0.6422018348623854,0.0
67,125,40,30,30,58,350,0.3431372549019608,65,105,60,60,70,95,455,63.0,0.5
80,100,70,60,70,95,475,0.7416666666666667,95,95,85,125,65,55,520,0.3894736842105263,0.5
108,130,95,80,85,102,600,0.7637795275590551,79,115,70,125,80,111,580,0.864,0.0
39,52,43,60,50,65,309,0.49107142857142855,50,53,48,53,48,64,316,0.46153846153846156,0.5
67,57,55,77,55,114,425,0.8879310344827587,120,120,120,120,120,120,720,0.9344262295081968,1.0
70,150,140,65,100,75,600,0.55,60,62,80,63,80,60,405,0.4336283185840708,2.0
75,85,200,55,65,30,510,0.16778523489932887,50,50,150,50,150,50,500,0.2571428571428571,2.0
65,90,122,58,75,84,494,0.71875,45,67,60,35,50,63,320,0.5128205128205128,2.0
120,70,120,75,130,85,600,0.6694915254237288,55,85,55,50,55,60,360,0.4233576642335766,1.0
62,55,52,109,94,109,481,0.7833333333333333,20,15,20,10,55,80,200,0.2682926829268293,2.0
49,55,42,42,37,85,310,0.6068376068376068,100,50,80,60,80,50,420,0.34375,1.0
89,145,90,105,80,91,600,0.8549618320610687,106,130,90,110,154,90,680,0.719626168224299,0.0
80,185,115,40,105,75,600,0.6230769230769231,150,160,100,95,65,100,670,0.8866666666666667,2.0
100,5,5,15,65,30,220,0.07692307692307693,75,110,110,110,105,80,590,0.656934306569343,1.0
55,66,44,44,56,85,350,0.6888888888888889,100,50,80,60,80,50,420,0.34375,1.0
58,64,58,80,65,80,405,0.609271523178808,75,100,110,45,55,65,450,0.5333333333333333,1.0
80,80,50,40,50,25,325,0.176056338028169,125,130,90,130,90,95,660,0.7734375,1.0
75,75,130,75,130,95,580,0.7479674796747967,75,90,140,60,60,40,465,0.3008130081300813,0.5
75,69,72,114,100,104,534,0.8253968253968254,75,80,55,25,35,35,305,0.18666666666666668,1.0
55,47,52,40,40,41,275,0.16806722689075632,30,30,30,30,30,30,180,0.12612612612612611,2.0
60,70,50,100,50,65,395,0.5217391304347826,60,50,150,50,150,60,520,0.5206611570247934,0.125
60,100,115,70,85,90,520,0.7557251908396947,55,55,55,85,55,30,335,0.1320754716981132,1.0
30,30,30,30,30,30,180,0.12612612612612611,88,107,122,74,75,64,530,0.4596774193548387,0.5
65,75,90,97,123,44,494,0.1987179487179487,55,47,52,40,40,41,275,0.16806722689075632,0.5
62,48,66,59,57,49,341,0.33884297520661155,80,90,80,130,110,110,600,0.856,2.0
80,185,115,40,105,75,600,0.6230769230769231,50,65,45,85,65,95,405,0.7238095238095238,2.0
51,65,65,80,75,59,395,0.4365079365079365,70,80,102,80,102,40,474,0.2677165354330709,2.0
55,45,43,55,43,72,313,0.5853658536585366,35,65,35,65,35,65,300,0.46621621621621623,1.0
65,95,75,55,55,85,430,0.6933333333333334,70,95,125,65,75,45,475,0.33613445378151263,1.0
80,90,80,130,110,110,600,0.856,60,70,105,70,120,75,500,0.5983606557377049,1.0
100,77,77,128,128,90,600,0.6901408450704225,74,48,76,83,81,104,466,0.7913043478260869,0.5
55,85,55,50,55,60,360,0.4233576642335766,80,185,115,40,105,75,600,0.6230769230769231,1.0
68,72,78,38,42,32,330,0.23809523809523808,91,72,90,129,90,108,580,0.8620689655172413,1.0
60,50,70,80,80,140,480,0.8449612403100775,72,58,80,103,80,97,490,0.7171052631578947,2.0
35,60,44,40,54,55,288,0.366412213740458,45,49,65,49,65,45,318,0.275,2.0
250,5,5,35,105,50,450,0.15306122448979592,55,20,35,20,45,75,250,0.37681159420289856,1.0
70,50,30,95,135,105,485,0.8040540540540541,80,100,80,80,80,100,520,0.9051724137931034,4.0
170,90,45,90,45,60,500,0.427536231884058,80,100,200,50,100,50,580,0.3472222222222222,2.0
43,70,48,50,60,38,309,0.2391304347826087,45,49,65,49,65,45,318,0.275,0.5
40,60,30,31,31,70,262,0.4492753623188406,90,90,85,125,90,100,580,0.768595041322314,0.5
68,65,65,125,115,80,518,0.6461538461538462,70,110,180,60,60,50,530,0.4117647058823529,0.25
79,115,70,125,80,111,580,0.8468468468468469,62,48,54,63,60,68,355,0.5178571428571429,1.0
90,85,100,95,125,85,580,0.6834532374100719,70,95,125,65,75,45,475,0.33613445378151263,1.0
55,20,35,20,45,75,250,0.37681159420289856,59,45,40,35,40,31,250,0.14285714285714285,1.0
70,80,70,80,70,110,480,0.6594202898550725,90,60,70,75,70,45,410,0.23880597014925373,0.25
40,60,30,31,31,70,262,0.4492753623188406,30,42,118,42,88,30,350,0.112,0.0625
100,110,90,85,90,60,535,0.47794117647058826,38,35,35,65,55,50,278,0.2647058823529412,1.0
90,95,95,70,90,70,510,0.5230769230769231,70,40,50,55,50,25,290,0.061068702290076333,1.0
50,35,55,25,25,15,205,0.05263157894736842,45,75,60,40,30,50,300,0.304,1.0
100,150,110,95,110,70,635,0.5923076923076923,70,94,50,94,50,66,424,0.48148148148148145,0.0
85,70,80,97,80,123,535,0.9304347826086956,75,95,60,65,60,115,470,0.8778625954198473,1.0
65,75,70,95,70,95,470,0.7272727272727273,45,55,45,65,45,75,330,0.5692307692307692,1.0
100,120,100,150,120,90,680,0.728,75,80,85,110,90,50,490,0.3548387096774194,2.0
50,180,20,180,20,150,600,0.9029850746268657,50,53,48,53,48,64,316,0.4076923076923077,1.0
65,65,45,75,45,95,390,0.72,60,70,50,100,50,65,395,0.5217391304347826,1.0
100,100,90,150,140,90,670,0.71875,49,49,56,49,61,66,330,0.5190839694656488,0.5
70,43,53,43,53,40,302,0.19090909090909092,80,105,65,60,75,130,515,0.9645390070921985,0.5
65,125,60,95,60,105,510,0.9236641221374046,50,53,48,53,48,64,316,0.46153846153846156,1.0
103,60,126,80,126,50,545,0.36363636363636365,75,69,72,114,100,104,534,0.8253968253968254,0.5
75,80,85,110,90,50,490,0.3548387096774194,123,77,72,99,92,58,521,0.4621212121212121,1.0
80,82,100,83,100,80,525,0.6821705426356589,100,120,120,150,100,90,680,0.7880794701986755,0.25
80,80,80,55,55,90,440,0.6417910447761194,50,95,90,95,90,180,600,0.9172413793103448,1.0
55,70,40,60,40,40,305,0.26956521739130435,56,61,65,48,45,38,313,0.17567567567567569,2.0
75,140,65,112,65,110,567,0.9140625,80,95,82,60,82,75,474,0.6,1.0
130,85,80,85,95,60,535,0.43884892086330934,95,85,85,65,65,35,430,0.2571428571428571,1.0
91,134,95,100,100,80,600,0.6304347826086957,85,56,77,50,77,78,423,0.53125,1.0
109,66,84,81,99,32,471,0.2013888888888889,69,55,45,55,55,15,294,0.11666666666666667,0.5
70,115,60,115,60,55,475,0.4647887323943662,65,95,100,60,50,50,420,0.34959349593495936,0.5
105,130,120,45,45,40,485,0.4444444444444444,80,120,130,55,65,45,495,0.37037037037037035,1.0
99,68,83,72,87,51,460,0.417910447761194,74,48,76,83,81,104,466,0.7913043478260869,1.0
60,85,69,60,69,77,420,0.518796992481203,105,140,95,55,65,45,505,0.3,1.0
95,65,110,60,130,65,525,0.5275590551181102,45,25,50,25,25,35,205,0.13076923076923078,1.0
60,95,80,60,80,30,405,0.19480519480519481,70,90,90,135,90,125,600,0.9401709401709402,2.0
60,50,50,60,70,50,340,0.28346456692913385,55,112,45,74,45,70,401,0.559322033898305,2.0
55,75,60,75,60,103,428,0.7982456140350878,90,100,60,90,60,80,480,0.6422764227642277,1.0
85,76,64,45,55,90,415,0.6739130434782609,100,103,75,120,75,127,600,0.940677966101695,1.0
75,98,63,98,63,101,498,0.889763779527559,45,49,65,49,65,45,318,0.275,2.0
105,30,105,140,105,55,540,0.3524590163934426,76,48,48,57,62,34,325,0.11688311688311688,0.5
100,50,80,60,80,50,420,0.34375,60,40,60,40,60,35,295,0.18055555555555555,0.5
60,85,42,85,42,91,405,0.8227848101265823,35,70,55,45,55,25,285,0.09420289855072464,4.0
90,50,34,60,44,70,348,0.6283185840707964,80,95,82,60,82,75,474,0.6,1.0
77,85,51,55,51,65,384,0.5163934426229508,90,100,90,125,85,90,580,0.7352941176470589,0.25
70,70,40,60,40,60,340,0.4247787610619469,49,66,70,44,55,51,335,0.4260869565217391,1.0
100,100,100,100,100,100,600,0.831858407079646,55,55,45,63,45,45,308,0.25,1.0
60,100,115,70,85,90,520,0.7557251908396947,40,45,35,30,40,55,245,0.3793103448275862,1.0
35,46,34,35,45,20,215,0.072,65,80,80,59,63,58,405,0.4411764705882353,1.0
50,75,75,65,65,50,380,0.4049586776859504,37,25,41,25,41,25,194,0.08870967741935484,1.0
45,35,50,70,50,30,280,0.15753424657534246,40,40,55,40,70,55,300,0.40939597315436244,2.0
79,100,80,110,90,121,580,0.968,64,165,75,93,83,75,555,0.6587301587301587,1.0
60,85,69,65,79,80,438,0.576,100,164,150,95,120,71,700,0.5645161290322581,0.5
50,70,100,40,40,30,330,0.2222222222222222,80,100,70,60,70,95,475,0.7416666666666667,1.0
75,95,60,65,60,115,470,0.8778625954198473,79,115,70,125,80,111,580,0.864,1.0
75,103,80,70,80,92,500,0.7933884297520661,90,120,120,60,60,50,500,0.35294117647058826,2.0
79,115,70,125,80,111,580,0.8468468468468469,70,110,180,60,60,50,530,0.4117647058823529,0.25
59,63,80,65,80,58,405,0.41843971631205673,30,42,118,42,88,30,350,0.112,2.0
75,90,90,140,90,115,600,0.9481481481481482,75,125,75,30,75,85,465,0.625,0.5
65,75,70,95,70,95,470,0.7272727272727273,60,60,60,105,105,105,495,0.848,1.0
65,50,70,95,80,65,425,0.4262295081967213,100,90,130,45,65,55,485,0.4253731343283582,1.0
60,59,85,79,105,36,424,0.16666666666666666,65,63,45,45,45,45,308,0.2595419847328244,0.25
90,100,60,90,60,80,480,0.6422764227642277,55,50,40,40,40,75,300,0.5945945945945946,1.0
50,50,50,50,50,50,300,0.30708661417322836,20,40,15,35,35,60,205,0.34285714285714286,1.0
89,125,90,115,80,101,600,0.8725490196078431,55,40,40,65,45,35,280,0.16428571428571428,1.0
70,110,75,145,85,145,630,0.9444444444444444,75,75,55,105,85,30,425,0.1619718309859155,0.5
45,30,40,105,50,20,290,0.031007751937984496,100,150,90,180,160,90,770,0.7348484848484849,1.0
76,48,48,57,62,34,325,0.11688311688311688,110,130,80,70,60,80,530,0.5862068965517241,2.0
90,120,100,150,120,100,680,0.7718120805369127,60,60,60,35,35,30,280,0.11194029850746269,1.0
70,80,65,90,65,85,455,0.578125,100,164,150,95,120,71,700,0.5645161290322581,0.0
41,64,45,50,50,50,300,0.36752136752136755,76,104,71,104,71,108,534,0.912751677852349,1.0
58,70,45,40,45,42,300,0.25925925925925924,40,70,40,35,40,60,285,0.392,1.0
30,56,35,25,35,72,253,0.48148148148148145,80,135,85,70,95,150,615,0.9844961240310077,0.5
43,30,55,40,65,97,330,0.6030534351145038,70,80,65,90,65,85,455,0.578125,1.0
105,95,75,85,75,74,509,0.5714285714285714,100,75,115,90,115,85,580,0.6446280991735537,0.5
69,55,45,55,55,15,294,0.11666666666666667,90,65,65,40,40,15,315,0.19672131147540983,2.0
80,45,65,90,110,80,470,0.5462962962962963,70,84,70,65,70,51,410,0.2949640287769784,2.0
100,134,110,95,100,61,600,0.4057971014492754,80,80,90,110,130,110,600,0.8721804511278195,2.0
40,40,55,40,70,55,300,0.40939597315436244,40,70,40,35,40,60,285,0.392,1.0
90,70,80,70,95,70,475,0.5190839694656488,70,20,50,20,50,40,250,0.1557377049180328,0.25
60,69,95,69,95,36,424,0.2608695652173913,90,100,90,125,85,90,580,0.7352941176470589,0.125
75,123,67,95,85,95,540,0.7642276422764228,40,55,70,45,60,30,300,0.10619469026548672,1.0
80,120,130,55,65,45,495,0.37037037037037035,150,100,120,100,120,90,680,0.6666666666666666,1.0
75,65,55,65,55,69,384,0.43548387096774194,59,110,150,45,49,35,448,0.3333333333333333,2.0
90,85,75,115,100,115,580,0.9381443298969072,70,90,70,60,60,70,420,0.6390977443609023,1.0
50,65,107,105,107,86,520,0.703125,70,55,75,45,65,60,370,0.45901639344262296,4.0
30,45,59,30,39,57,260,0.2803030303030303,75,95,122,58,75,69,494,0.5725806451612904,1.0
79,115,70,125,80,111,580,0.8468468468468469,40,70,40,35,40,60,285,0.392,2.0
75,38,38,56,56,67,330,0.5263157894736842,36,50,50,65,60,44,305,0.16363636363636364,1.0
95,117,184,44,46,28,514,0.2975206611570248,76,65,45,92,42,91,411,0.7449664429530202,2.0
44,50,91,24,86,10,305,0.1981981981981982,62,77,62,50,42,65,358,0.4838709677419355,0.5
65,40,50,125,60,30,370,0.07258064516129033,60,60,60,35,35,30,280,0.11194029850746269,1.0
45,60,32,50,32,76,295,0.5925925925925926,83,106,65,86,65,85,490,0.6640625,1.0
60,60,60,85,85,85,435,0.631578947368421,58,50,145,95,105,30,483,0.2459016393442623,2.0
72,85,70,65,70,58,420,0.41304347826086957,100,120,120,150,100,90,680,0.7880794701986755,1.0
50,75,35,70,30,40,300,0.21296296296296297,70,55,75,45,65,60,370,0.45901639344262296,0.5
100,100,100,100,100,100,600,0.8805970149253731,50,75,45,40,45,60,315,0.4380165289256198,1.0
25,35,70,95,55,45,325,0.16783216783216784,115,115,85,90,75,100,580,0.8134328358208955,0.5
62,44,50,44,50,55,305,0.3629032258064516,68,65,65,125,115,80,518,0.6461538461538462,1.0
50,55,50,36,30,43,264,0.2922077922077922,30,45,55,70,55,85,340,0.5633802816901409,1.0
62,55,52,109,94,109,481,0.7833333333333333,54,78,103,53,45,22,355,0.23255813953488372,1.0
45,22,60,27,30,29,213,0.07518796992481203,90,60,70,75,70,45,410,0.23880597014925373,1.0
75,98,63,98,63,101,498,0.889763779527559,44,58,44,58,44,61,309,0.41964285714285715,0.5
95,80,105,40,70,100,490,0.8046875,90,120,75,60,60,45,450,0.29411764705882354,1.0
110,78,73,76,71,60,468,0.3333333333333333,44,58,44,58,44,61,309,0.41964285714285715,4.0
50,52,48,65,50,55,320,0.33098591549295775,55,45,43,55,43,72,313,0.5853658536585366,1.0
70,50,30,95,135,105,485,0.8040540540540541,105,150,90,150,90,95,680,0.8285714285714286,4.0
88,107,122,74,75,64,530,0.4596774193548387,78,104,78,159,115,100,634,0.8444444444444444,0.125
150,160,100,95,65,100,670,0.8866666666666667,30,105,90,25,25,50,325,0.2773722627737226,1.0
91,72,90,129,90,108,580,0.8620689655172413,85,97,66,105,66,65,484,0.47107438016528924,2.0
50,85,40,85,40,35,335,0.1746031746031746,89,124,80,55,80,55,483,0.5714285714285714,2.0
100,123,75,57,75,80,510,0.6923076923076923,90,55,75,60,75,30,385,0.13970588235294118,1.0
58,70,45,40,45,42,300,0.25925925925925924,50,105,125,55,95,50,480,0.375886524822695,0.0
41,50,37,50,37,66,281,0.5175438596491229,50,75,75,65,65,50,380,0.4049586776859504,1.0
45,55,45,65,45,75,330,0.5692307692307692,40,35,30,20,20,50,195,0.23423423423423423,2.0
40,40,35,50,100,70,335,0.5031847133757962,100,150,140,100,90,90,670,0.7969924812030075,1.0
165,75,80,40,45,65,470,0.5151515151515151,95,60,79,100,125,81,540,0.6201550387596899,0.5
66,41,77,61,87,23,355,0.12096774193548387,60,60,40,65,45,35,305,0.15833333333333333,1.0
95,75,80,100,110,30,490,0.24242424242424243,45,55,39,35,39,42,255,0.18518518518518517,1.0
62,50,58,73,54,72,369,0.4435483870967742,45,50,43,40,38,62,278,0.40441176470588236,1.0
100,70,70,65,65,45,415,0.1897810218978102,83,80,80,135,80,121,579,0.9444444444444444,1.0
95,124,78,69,71,58,495,0.37398373983739835,70,80,65,90,65,85,455,0.578125,2.0
55,104,105,94,75,52,485,0.36363636363636365,75,100,63,80,63,116,497,0.9345794392523364,1.0
79,100,80,110,90,121,580,0.968,20,40,90,30,90,25,295,0.11363636363636363,1.0
20,15,20,10,55,80,200,0.2682926829268293,45,50,55,75,65,30,320,0.06293706293706294,0.5
75,105,75,105,75,45,480,0.3274336283185841,95,75,110,100,80,30,490,0.15267175572519084,0.5
60,110,70,60,60,100,460,0.8461538461538461,50,85,40,85,40,35,335,0.1746031746031746,2.0
38,41,40,50,65,65,299,0.4108527131782946,55,66,44,44,56,85,350,0.6888888888888889,1.0
70,145,88,140,70,112,625,0.8888888888888888,126,131,95,131,98,99,680,0.8102189781021898,1.0
100,70,70,65,65,45,415,0.1897810218978102,25,35,70,95,55,45,325,0.16783216783216784,0.5
45,50,45,115,55,95,405,0.6936936936936937,74,100,72,90,72,46,454,0.24561403508771928,2.0
80,120,130,55,65,45,495,0.37037037037037035,70,85,70,60,70,50,405,0.28378378378378377,0.5
50,35,55,25,25,15,205,0.05263157894736842,70,80,50,35,35,35,305,0.14,0.5
75,125,230,55,95,30,610,0.3448275862068966,65,40,50,125,60,30,370,0.07258064516129033,1.0
77,85,51,55,51,65,384,0.5163934426229508,20,10,230,10,230,5,505,0.0,1.0
20,15,20,10,55,80,200,0.2682926829268293,90,120,75,60,60,45,450,0.29411764705882354,1.0
68,165,95,65,115,110,618,0.8615384615384616,45,49,65,49,65,45,318,0.275,1.0
71,95,85,110,95,79,535,0.664,64,115,65,83,63,65,455,0.5323741007194245,1.0
50,30,55,65,55,20,275,0.13675213675213677,126,131,95,131,98,99,680,0.8102189781021898,0.5
75,105,75,105,75,45,480,0.3274336283185841,75,100,66,60,66,115,482,0.918918918918919,1.0
106,110,90,154,90,130,680,0.926829268292683,77,59,50,67,63,46,362,0.23140495867768596,1.0
45,50,55,75,65,30,320,0.06293706293706294,55,85,55,50,55,60,360,0.4233576642335766,0.25
45,60,45,25,45,55,275,0.29,78,84,78,109,85,100,534,0.8646616541353384,1.0
86,68,72,109,66,106,507,0.8099173553719008,78,70,61,50,61,100,420,0.8145161290322581,1.0
54,63,52,83,56,97,405,0.7697841726618705,20,15,20,10,55,80,200,0.2682926829268293,0.5
50,65,85,35,35,55,325,0.32575757575757575,81,102,77,85,75,85,505,0.5642857142857143,0.25
75,38,38,56,56,67,330,0.5263157894736842,60,40,80,60,45,40,325,0.23529411764705882,0.25
85,105,100,79,83,78,530,0.5869565217391305,70,70,70,70,70,70,420,0.5289256198347108,1.0
50,92,108,92,108,35,485,0.2457627118644068,50,50,77,95,77,91,440,0.5916666666666667,4.0
50,65,107,105,107,86,520,0.7313432835820896,46,57,40,40,40,50,273,0.25,0.5
91,90,106,130,106,77,600,0.648854961832061,60,50,100,85,70,65,430,0.47580645161290325,0.25
105,105,75,65,100,50,500,0.37593984962406013,60,40,50,75,85,95,405,0.6044776119402985,1.0
106,150,70,194,120,140,780,0.952,70,85,140,85,70,20,470,0.272,1.0
50,100,150,100,150,50,600,0.37142857142857144,65,80,80,59,63,58,405,0.4411764705882353,1.0
35,80,50,50,70,120,405,0.84375,83,106,65,86,65,85,490,0.6640625,2.0
50,72,35,35,35,65,292,0.5373134328358209,70,95,85,55,65,70,440,0.5,4.0
70,110,70,115,70,90,525,0.75,85,56,77,50,77,78,423,0.53125,2.0
84,86,88,111,101,60,530,0.4634146341463415,90,90,85,125,90,100,580,0.768595041322314,0.5
70,120,40,95,40,95,460,0.8106060606060606,60,100,115,70,85,90,520,0.7557251908396947,1.0
45,45,35,20,30,20,195,0.07246376811594203,60,70,50,100,50,65,395,0.5217391304347826,0.5
50,65,90,35,35,15,290,0.14678899082568808,100,5,5,15,65,30,220,0.07692307692307693,1.0
37,25,41,25,41,25,194,0.08870967741935484,65,60,110,130,95,65,525,0.47761194029850745,1.0
70,110,180,60,60,50,530,0.4117647058823529,75,95,122,58,75,69,494,0.5725806451612904,1.0
30,80,90,55,45,55,355,0.4295774647887324,40,55,80,35,60,30,300,0.15037593984962405,0.5
80,160,60,170,130,80,680,0.6180555555555556,80,100,123,122,120,80,625,0.56,2.0
65,95,100,60,50,50,420,0.34959349593495936,57,24,86,24,86,23,300,0.12727272727272726,0.5
75,95,60,65,60,115,470,0.8778625954198473,114,85,70,85,80,30,464,0.2066115702479339,1.0
30,56,35,25,35,72,253,0.48148148148148145,80,110,60,150,130,70,600,0.5042016806722689,0.0
35,65,35,65,35,65,300,0.46621621621621623,72,105,115,54,86,68,500,0.5149253731343284,1.0
45,63,37,65,55,95,360,0.8055555555555556,80,82,100,83,100,80,525,0.6821705426356589,0.5
45,55,45,65,45,75,330,0.5692307692307692,50,70,50,50,50,40,310,0.16296296296296298,0.5
79,103,120,135,115,78,630,0.5763888888888888,100,50,50,76,96,70,442,0.5,1.0
55,55,85,65,85,35,380,0.2014388489208633,75,90,50,110,80,95,500,0.7985611510791367,4.0
90,75,85,115,90,55,510,0.3445378151260504,90,130,80,65,85,55,505,0.4396551724137931,1.0
80,95,82,60,82,75,474,0.6,63,120,85,90,55,55,468,0.2809917355371901,1.0
65,125,100,55,70,85,500,0.6532258064516129,59,74,50,35,50,35,303,0.3125,0.5
40,35,30,20,20,50,195,0.23423423423423423,80,82,83,100,100,80,525,0.6742424242424242,1.0
90,120,75,60,60,45,450,0.29411764705882354,30,65,100,45,25,40,305,0.1891891891891892,1.0
170,90,45,90,45,60,500,0.427536231884058,45,35,50,70,50,30,280,0.15753424657534246,0.5
100,77,77,128,128,90,600,0.6901408450704225,66,117,70,40,50,67,410,0.4573643410852713,1.0
72,95,67,103,71,122,530,0.9606299212598425,60,55,90,145,90,80,520,0.6071428571428571,4.0
60,85,49,60,49,60,363,0.4444444444444444,70,85,140,85,70,20,470,0.272,1.0
54,66,70,44,55,46,335,0.4214876033057851,80,82,78,95,80,85,500,0.6869565217391305,2.0
82,80,86,85,75,72,480,0.6183206106870229,110,135,60,50,65,88,508,0.7744360902255639,0.5
65,45,55,45,70,45,325,0.24369747899159663,50,40,85,40,65,25,305,0.08870967741935484,1.0
50,52,48,65,50,55,320,0.33098591549295775,69,69,76,69,86,91,460,0.6554621848739496,0.5
74,108,133,83,65,32,495,0.32142857142857145,60,100,115,70,85,90,520,0.7557251908396947,0.5
100,100,100,100,100,100,600,0.8758169934640523,60,25,35,70,80,60,330,0.3076923076923077,0.5
60,55,90,145,90,80,520,0.6071428571428571,70,80,65,90,65,85,455,0.578125,0.0
50,95,95,35,110,70,455,0.5179856115107914,90,120,75,60,60,45,450,0.29411764705882354,0.5
60,90,70,60,120,40,440,0.27419354838709675,30,45,59,30,39,57,260,0.2803030303030303,1.0
60,70,50,100,50,65,395,0.5217391304347826,60,60,60,60,60,60,360,0.38095238095238093,1.0
85,105,100,79,83,78,530,0.5869565217391305,97,165,60,65,50,58,495,0.3902439024390244,2.0
80,82,100,83,100,80,525,0.6821705426356589,40,70,40,35,40,60,285,0.392,1.0
60,55,50,40,55,45,305,0.22377622377622378,100,123,75,57,75,80,510,0.6923076923076923,0.5
44,75,35,63,33,45,295,0.2647058823529412,90,92,75,92,85,60,494,0.49586776859504134,1.0
54,63,52,83,56,97,405,0.7697841726618705,65,45,55,45,70,45,325,0.24369747899159663,0.5
74,94,131,54,116,20,489,0.4485294117647059,78,81,71,74,69,126,499,0.9090909090909091,0.125
50,105,79,35,110,76,455,0.6214285714285714,60,70,105,70,120,75,500,0.5983606557377049,0.5
60,50,70,50,90,65,385,0.39568345323741005,55,55,85,65,85,35,380,0.2014388489208633,0.5
70,62,67,55,55,56,365,0.38513513513513514,60,85,69,65,79,80,438,0.576,0.5
82,80,86,85,75,72,480,0.6183206106870229,80,120,79,95,79,70,523,0.5833333333333334,1.0
72,60,30,20,30,25,237,0.11570247933884298,130,85,80,85,95,60,535,0.43884892086330934,2.0
60,90,70,60,120,40,440,0.27419354838709675,75,80,70,65,75,90,455,0.7578125,1.0
90,65,65,40,40,15,315,0.19672131147540983,90,95,95,70,90,70,510,0.5230769230769231,0.5
60,110,70,60,60,100,460,0.8461538461538461,50,20,55,25,25,30,205,0.09774436090225563,2.0
75,90,90,140,90,115,600,0.9481481481481482,65,76,84,54,96,105,480,0.9008264462809917,1.0
73,76,75,81,100,100,505,0.8110236220472441,30,42,118,42,88,30,350,0.112,1.0
67,89,116,79,116,33,500,0.2624113475177305,76,147,90,60,70,97,540,0.8267716535433071,1.0
46,57,40,40,40,50,273,0.25,85,120,70,50,60,100,485,0.8308823529411765,1.0
85,100,122,58,75,54,494,0.3939393939393939,73,95,62,85,65,85,465,0.6666666666666666,0.0
70,115,60,115,60,55,475,0.4647887323943662,40,55,30,30,30,85,270,0.688,0.5
65,70,60,65,65,115,440,0.8583333333333333,106,130,90,110,154,90,680,0.719626168224299,1.0
110,85,95,80,95,50,515,0.2713178294573643,90,85,100,95,125,85,580,0.6834532374100719,1.0
38,36,38,32,36,57,237,0.3893805309734513,75,103,80,70,80,92,500,0.7933884297520661,1.0
40,30,30,55,30,85,270,0.4666666666666667,90,90,85,125,90,100,580,0.768595041322314,0.5
40,45,35,40,40,90,290,0.65,50,72,35,35,35,65,292,0.5373134328358209,1.0
30,45,59,30,39,57,260,0.2803030303030303,105,125,100,60,100,100,590,0.8359375,1.0
20,40,15,35,35,60,205,0.34285714285714286,50,65,107,105,107,86,520,0.6991150442477876,0.5
60,62,80,63,80,60,405,0.4336283185840708,60,60,60,35,35,30,280,0.11194029850746269,1.0
30,45,55,70,55,85,340,0.5633802816901409,50,45,45,35,35,50,260,0.23529411764705882,1.0
50,160,110,160,110,110,700,0.8854961832061069,50,64,50,45,50,41,300,0.22727272727272727,0.5
116,55,85,107,95,29,487,0.06818181818181818,41,50,37,50,37,66,281,0.5175438596491229,0.0
95,60,79,100,125,81,540,0.6201550387596899,70,83,50,37,50,60,350,0.3360655737704918,1.0
95,80,105,40,70,100,490,0.8046875,80,160,60,170,130,80,680,0.6180555555555556,1.0
75,125,75,30,75,85,465,0.625,30,56,35,25,35,72,253,0.48148148148148145,2.0
90,100,70,110,150,80,600,0.6037735849056604,55,104,105,94,75,52,485,0.36363636363636365,1.0
60,82,45,45,45,74,351,0.5752212389380531,60,85,42,85,42,91,405,0.8227848101265823,0.0
95,60,79,100,125,81,540,0.6201550387596899,41,64,45,50,50,50,300,0.36752136752136755,0.5
116,55,85,107,95,29,487,0.06818181818181818,70,100,115,30,65,30,410,0.24390243902439024,1.0
90,70,80,70,95,70,475,0.5190839694656488,80,45,65,90,110,80,470,0.5462962962962963,1.0
40,55,99,40,79,47,360,0.26262626262626265,30,45,135,45,90,30,375,0.09285714285714286,0.5
95,124,78,69,71,58,495,0.37398373983739835,70,110,180,60,60,50,530,0.4117647058823529,4.0
28,25,25,45,35,40,198,0.16083916083916083,43,70,48,50,60,38,309,0.2391304347826087,1.0
50,70,160,70,160,90,600,0.7417218543046358,100,134,110,95,100,61,600,0.4057971014492754,0.0
50,35,55,25,25,15,205,0.05263157894736842,55,20,35,20,45,75,250,0.37681159420289856,1.0
60,100,89,55,69,112,485,0.9298245614035088,63,60,55,50,50,71,349,0.5289256198347108,0.5
109,66,84,81,99,32,471,0.2013888888888889,40,80,100,30,30,20,300,0.11851851851851852,0.0
55,69,85,32,35,28,304,0.09302325581395349,55,47,52,40,40,41,275,0.16806722689075632,1.0
75,100,66,60,66,115,482,0.918918918918919,80,80,90,110,130,110,600,0.8721804511278195,1.0
30,40,70,70,25,60,295,0.41353383458646614,104,91,63,91,73,68,490,0.5118110236220472,1.0
72,58,80,103,80,97,490,0.7171052631578947,70,140,70,110,65,105,560,0.95,0.0
80,110,120,130,90,70,600,0.6198347107438017,53,54,53,37,46,45,288,0.3090909090909091,1.0
40,45,35,40,40,90,290,0.65,75,87,63,87,63,98,473,0.865546218487395,1.0
61,72,57,55,55,65,365,0.3984375,45,35,50,70,50,30,280,0.15753424657534246,2.0
90,75,85,115,90,55,510,0.3445378151260504,44,38,33,61,43,70,289,0.5267857142857143,0.5
65,47,55,73,75,85,400,0.65,85,80,90,105,95,60,515,0.49074074074074076,1.0
110,135,60,50,65,88,508,0.7744360902255639,73,95,62,85,65,85,465,0.6666666666666666,1.0
89,125,90,115,80,101,600,0.8725490196078431,49,66,70,44,55,51,335,0.4260869565217391,1.0
30,35,30,100,35,80,310,0.4765625,70,130,100,55,80,65,500,0.608,0.0
120,70,120,75,130,85,600,0.6694915254237288,60,40,50,75,85,95,405,0.6044776119402985,1.0
60,80,50,40,40,30,300,0.15328467153284672,79,105,70,145,80,101,580,0.8608695652173913,1.0
65,55,115,100,40,60,435,0.3798449612403101,45,35,50,70,50,30,280,0.15753424657534246,0.5
65,136,94,54,96,135,580,0.9612403100775194,70,70,40,60,40,60,340,0.4247787610619469,2.0
65,100,70,80,80,105,500,0.8666666666666667,100,50,80,60,80,50,420,0.34375,0.5
75,90,140,60,60,40,465,0.3008130081300813,75,80,60,65,90,102,472,0.8625954198473282,1.0
65,60,70,85,75,40,395,0.1796875,82,121,119,69,59,71,521,0.5394736842105263,0.5
58,64,58,80,65,80,405,0.5423728813559322,85,80,70,135,75,90,535,0.7006802721088435,1.0
20,10,55,15,20,80,200,0.17985611510791366,100,123,75,57,75,80,510,0.6923076923076923,1.0
50,53,48,53,48,64,316,0.4076923076923077,62,55,52,109,94,109,481,0.7833333333333333,1.0
60,50,150,50,150,60,520,0.5206611570247934,84,86,88,111,101,60,530,0.4634146341463415,0.25
40,30,35,45,40,55,245,0.31496062992125984,75,80,55,25,35,35,305,0.18666666666666668,2.0
65,65,65,50,50,90,385,0.72,71,120,95,120,95,99,600,0.8203125,1.0
50,53,48,53,48,64,316,0.46153846153846156,35,55,40,50,50,90,320,0.6838235294117647,1.0
75,80,70,65,75,90,455,0.7578125,65,90,65,61,61,100,442,0.8373983739837398,1.0
75,95,60,65,60,115,470,0.8778625954198473,70,94,50,94,50,66,424,0.48148148148148145,1.0
45,80,100,35,37,28,325,0.3125,45,50,43,40,38,62,278,0.40441176470588236,0.0
70,60,70,87,78,85,450,0.6228070175438597,60,60,60,105,105,105,495,0.848,1.0
85,50,95,120,115,80,545,0.5793650793650794,55,65,95,95,45,85,440,0.6610169491525424,1.0
60,70,105,70,120,75,500,0.5983606557377049,40,70,130,60,130,25,455,0.17355371900826447,1.0
50,65,107,105,107,86,520,0.7758620689655172,50,105,125,55,95,50,480,0.375886524822695,1.0
75,38,38,56,56,67,330,0.5263157894736842,100,50,80,60,80,50,420,0.34375,1.0
64,115,65,83,63,65,455,0.5323741007194245,111,83,68,92,82,39,475,0.1774193548387097,1.0
66,65,48,62,57,52,350,0.36220472440944884,79,105,70,145,80,101,580,0.8608695652173913,0.5
115,115,85,90,75,100,580,0.8134328358208955,110,130,80,70,60,80,530,0.5862068965517241,2.0
61,90,45,50,50,160,456,0.9230769230769231,100,100,100,100,100,100,600,0.831858407079646,2.0
90,92,75,92,85,60,494,0.49586776859504134,66,41,77,61,87,23,355,0.12096774193548387,2.0
73,115,60,60,60,90,458,0.6694915254237288,68,165,95,65,115,110,618,0.8615384615384616,1.0
58,64,58,80,65,80,405,0.609271523178808,114,85,70,85,80,30,464,0.2066115702479339,2.0
80,82,78,95,80,85,500,0.6869565217391305,40,45,40,62,60,60,307,0.33884297520661155,2.0
65,95,57,100,85,93,495,0.7441860465116279,55,63,90,50,80,42,380,0.21138211382113822,4.0
80,105,105,105,105,80,580,0.5939849624060151,58,70,45,40,45,42,300,0.25925925925925924,2.0
79,105,70,145,80,101,580,0.8608695652173913,60,130,80,60,60,70,460,0.5153846153846153,2.0
50,85,125,85,115,20,480,0.4306569343065693,126,131,95,131,98,99,680,0.8102189781021898,0.25
43,30,55,40,65,97,330,0.6030534351145038,108,100,121,81,95,95,600,0.7476635514018691,1.0
46,87,60,30,40,57,320,0.37777777777777777,70,120,100,145,105,20,560,0.2824427480916031,1.0
80,80,80,55,55,90,440,0.6417910447761194,60,50,150,50,150,60,520,0.5206611570247934,0.0
50,50,40,50,40,64,294,0.45588235294117646,100,100,90,150,140,90,670,0.71875,0.5
85,105,85,40,50,40,405,0.211864406779661,45,53,70,40,60,42,310,0.25735294117647056,0.5
90,120,120,60,60,50,500,0.35294117647058826,75,95,125,45,75,95,510,0.8257575757575758,0.0
39,52,43,60,50,65,309,0.5041322314049587,105,150,90,150,90,95,680,0.8285714285714286,0.5
60,60,60,35,35,30,280,0.11194029850746269,39,52,43,60,50,65,309,0.5041322314049587,1.0
100,50,80,60,80,50,420,0.34375,95,117,80,65,70,92,519,0.8409090909090909,4.0
100,100,100,100,100,100,600,0.831858407079646,85,115,80,105,80,50,515,0.3063063063063063,1.0
80,70,70,90,100,70,480,0.5609756097560976,55,75,60,75,60,103,428,0.7982456140350878,0.5
50,95,95,35,110,70,455,0.5179856115107914,91,72,90,129,90,108,580,0.8925619834710744,1.0
60,45,70,75,85,55,390,0.3008130081300813,70,115,60,115,60,55,475,0.4647887323943662,0.0
90,75,85,115,90,55,510,0.3445378151260504,55,45,43,55,43,72,313,0.5853658536585366,2.0
75,140,65,112,65,110,567,0.9140625,170,90,45,90,45,60,500,0.427536231884058,1.0
75,80,85,110,90,50,490,0.3548387096774194,100,100,80,60,60,50,450,0.3050847457627119,1.0
40,40,50,30,30,30,220,0.0873015873015873,95,75,80,100,110,30,490,0.24242424242424243,2.0
70,70,70,70,70,70,420,0.5289256198347108,55,40,40,65,45,35,280,0.16428571428571428,1.0
60,65,80,170,95,130,600,0.8625954198473282,70,80,70,80,70,110,480,0.6594202898550725,1.0
70,60,75,110,75,90,480,0.7165354330708661,75,100,63,80,63,116,497,0.9345794392523364,1.0
91,129,90,72,90,108,580,0.8536585365853658,75,100,63,80,63,116,497,0.9345794392523364,1.0
45,53,70,40,60,42,310,0.25735294117647056,90,92,75,92,85,60,494,0.49586776859504134,1.0
60,100,89,55,69,112,485,0.9298245614035088,81,102,77,85,75,85,505,0.5642857142857143,0.125
73,76,75,81,100,100,505,0.8110236220472441,55,68,64,45,55,31,318,0.11666666666666667,2.0
60,110,70,60,60,100,460,0.8461538461538461,55,95,115,45,45,35,390,0.2116788321167883,0.25
78,81,71,74,69,126,499,0.9090909090909091,120,100,85,30,85,45,465,0.22448979591836735,2.0
45,90,20,65,20,65,305,0.5116279069767442,120,70,120,75,130,85,600,0.6694915254237288,2.0
105,150,90,150,90,95,680,0.8285714285714286,95,125,79,60,100,81,540,0.6165413533834586,1.0
125,130,90,130,90,95,660,0.7734375,70,62,67,55,55,56,365,0.38513513513513514,1.0
65,65,45,75,45,95,390,0.72,86,92,88,68,75,73,482,0.6835443037974683,4.0
60,60,60,105,105,105,495,0.848,111,83,68,92,82,39,475,0.1774193548387097,1.0
50,150,50,150,50,150,600,0.9339622641509434,89,124,80,55,80,55,483,0.5714285714285714,2.0
45,45,55,45,55,63,308,0.4594594594594595,20,40,15,35,35,60,205,0.34285714285714286,1.0
115,115,85,90,75,100,580,0.8134328358208955,60,50,50,60,70,50,340,0.28346456692913385,1.0
75,123,67,95,85,95,540,0.7642276422764228,80,95,82,60,82,75,474,0.6,1.0
55,45,45,25,25,15,210,0.048,20,10,230,10,230,5,505,0.0,2.0
75,95,125,45,75,95,510,0.8257575757575758,40,30,35,50,70,55,280,0.28205128205128205,2.0
91,72,90,129,90,108,580,0.8620689655172413,50,20,40,20,40,20,190,0.0962962962962963,1.0
65,130,60,95,110,65,525,0.5303030303030303,40,65,40,80,40,65,330,0.5038167938931297,1.0
44,38,39,61,79,42,303,0.2251655629139073,45,60,40,70,50,45,310,0.2846715328467153,0.5
75,95,95,95,95,85,540,0.6470588235294118,60,60,75,60,75,80,410,0.7321428571428571,1.0
70,95,125,65,75,45,475,0.33613445378151263,91,134,95,100,100,80,600,0.6304347826086957,1.0
95,70,73,95,90,60,483,0.3983739837398374,66,117,70,40,50,67,410,0.4573643410852713,2.0
65,95,100,60,50,50,420,0.34959349593495936,75,75,55,105,85,30,425,0.1619718309859155,1.0
37,25,41,25,41,25,194,0.08870967741935484,46,57,40,40,40,50,273,0.25,0.5
97,165,60,65,50,58,495,0.3902439024390244,100,100,100,100,100,100,600,0.8805970149253731,1.0
70,94,50,94,50,66,424,0.48148148148148145,55,112,45,74,45,70,401,0.559322033898305,0.25
60,40,50,75,85,95,405,0.6044776119402985,150,100,120,100,120,90,680,0.6666666666666666,0.5
60,95,80,60,80,30,405,0.19480519480519481,60,59,85,79,105,36,424,0.16666666666666666,0.5
45,45,55,45,55,63,308,0.4594594594594595,55,50,40,40,40,75,300,0.5945945945945946,1.0
35,60,44,40,54,55,288,0.366412213740458,95,85,85,65,65,35,430,0.2571428571428571,0.5
95,135,80,110,80,100,600,0.8248175182481752,75,55,70,55,95,110,460,0.8444444444444444,2.0
20,10,230,10,230,5,505,0.0,45,45,35,20,30,20,195,0.07246376811594203,2.0
86,81,97,81,107,43,495,0.203125,50,53,48,53,48,64,316,0.358974358974359,2.0
105,180,100,180,100,115,780,0.9477611940298507,50,53,48,53,48,64,316,0.4076923076923077,2.0
60,80,95,70,85,50,440,0.2231404958677686,90,75,85,115,90,55,510,0.3445378151260504,0.5
95,117,80,65,70,92,519,0.8409090909090909,95,65,65,110,130,60,525,0.4016393442622951,0.5
45,65,34,40,34,45,263,0.2589928057553957,70,120,100,145,105,20,560,0.2824427480916031,0.0
60,65,70,85,75,40,395,0.21705426356589147,64,88,50,88,50,106,446,0.9111111111111111,1.0
63,60,55,50,50,71,349,0.5289256198347108,55,45,50,45,65,80,340,0.5546218487394958,2.0
80,82,78,95,80,85,500,0.6869565217391305,50,50,50,50,50,50,300,0.30708661417322836,1.0
64,51,23,51,23,28,240,0.11363636363636363,70,60,62,80,82,60,414,0.4375,1.0
50,180,20,180,20,150,600,0.9029850746268657,70,40,50,55,50,25,290,0.061068702290076333,1.0
45,50,45,115,55,95,405,0.6936936936936937,75,80,70,65,75,90,455,0.7578125,0.5
78,130,111,130,85,100,634,0.8561151079136691,85,73,70,73,115,67,483,0.5126050420168067,1.0
75,110,110,110,105,80,590,0.656934306569343,50,35,55,25,25,15,205,0.05263157894736842,1.0
60,75,100,55,80,50,420,0.3088235294117647,55,50,45,135,95,120,500,0.7714285714285715,0.5
160,110,65,65,110,30,540,0.35714285714285715,30,80,90,55,45,55,355,0.4295774647887324,0.5
55,104,105,94,75,52,485,0.36363636363636365,58,109,112,48,48,109,484,0.8805970149253731,1.0
70,110,180,60,60,50,530,0.4117647058823529,95,109,105,75,85,56,525,0.34513274336283184,0.5
67,57,55,77,55,114,425,0.8879310344827587,65,75,70,95,70,95,470,0.7272727272727273,0.5
65,90,65,61,61,100,442,0.8373983739837398,80,120,80,120,80,100,580,0.8478260869565217,1.0
70,110,75,145,85,145,630,0.9444444444444444,50,53,48,53,48,64,316,0.46153846153846156,0.5
89,145,90,105,80,91,600,0.8549618320610687,60,25,35,70,80,60,330,0.3076923076923077,1.0
30,105,90,25,25,50,325,0.2773722627737226,65,125,60,95,60,105,510,0.9236641221374046,1.0
80,90,80,130,110,110,600,0.856,60,55,145,75,150,40,525,0.2,0.25
50,100,150,100,150,50,600,0.37142857142857144,106,90,130,90,154,110,680,0.8699186991869918,2.0
95,135,80,110,80,100,600,0.8248175182481752,40,40,55,40,70,55,300,0.40939597315436244,1.0
75,75,60,83,60,60,413,0.39344262295081966,30,45,55,70,55,85,340,0.5633802816901409,0.5
50,53,48,53,48,64,316,0.4076923076923077,50,55,50,36,30,43,264,0.2922077922077922,0.5
75,75,130,75,130,95,580,0.7479674796747967,70,65,60,90,75,90,450,0.6571428571428571,2.0
65,55,115,100,40,60,435,0.3798449612403101,20,40,90,30,90,25,295,0.11363636363636363,1.0
70,65,60,90,75,90,450,0.6571428571428571,90,60,70,75,70,45,410,0.23880597014925373,1.0
35,80,50,50,70,120,405,0.84375,45,75,60,40,30,50,300,0.304,1.0
75,75,130,75,130,95,580,0.7479674796747967,67,125,40,30,30,58,350,0.3431372549019608,1.0
50,70,50,50,50,70,340,0.5645161290322581,65,65,65,50,50,90,385,0.72,1.0
40,45,35,40,40,90,290,0.65,75,100,63,80,63,116,497,0.9345794392523364,1.0
91,90,72,90,129,108,580,0.896,55,63,90,50,80,42,380,0.21138211382113822,0.125
95,155,109,70,130,81,640,0.6788321167883211,50,65,107,105,107,86,520,0.6991150442477876,2.0
30,45,135,45,90,30,375,0.09285714285714286,45,30,50,55,65,45,290,0.208,1.0
45,75,37,70,55,83,365,0.6183206106870229,100,100,100,100,100,100,600,0.8602941176470589,2.0
43,80,65,50,35,35,308,0.14193548387096774,90,90,85,125,90,100,580,0.768595041322314,1.0
31,45,90,30,30,40,266,0.21929824561403508,45,60,30,80,50,65,330,0.4603174603174603,2.0
40,55,70,45,60,30,300,0.10619469026548672,58,64,58,80,65,80,405,0.609271523178808,0.5
45,30,50,55,65,45,290,0.208,65,110,130,60,65,95,525,0.8278145695364238,1.0
58,70,45,40,45,42,300,0.25925925925925924,115,140,130,55,55,40,535,0.4519230769230769,2.0
40,60,30,31,31,70,262,0.4492753623188406,150,160,100,95,65,100,670,0.8866666666666667,1.0
60,30,30,36,56,50,262,0.32432432432432434,85,90,80,70,80,130,535,0.9262295081967213,1.0
50,40,85,40,65,25,305,0.08870967741935484,73,95,62,85,65,85,465,0.6666666666666666,1.0
66,65,48,62,57,52,350,0.36220472440944884,75,80,55,25,35,35,305,0.18666666666666668,1.0
82,121,119,69,59,71,521,0.5394736842105263,55,75,50,40,40,80,340,0.6302521008403361,2.0
59,66,70,44,55,41,335,0.25190839694656486,50,65,107,105,107,86,520,0.703125,1.0
115,140,130,55,55,40,535,0.4519230769230769,50,50,40,50,40,64,294,0.45588235294117646,1.0
55,20,35,20,45,75,250,0.37681159420289856,20,10,55,15,20,80,200,0.17985611510791366,1.0
40,20,30,40,80,55,265,0.22764227642276422,109,66,84,81,99,32,471,0.2013888888888889,0.5
106,110,90,154,90,130,680,0.926829268292683,40,65,95,60,45,35,340,0.13986013986013987,2.0
83,80,75,70,70,101,479,0.8615384615384616,55,47,52,40,40,41,275,0.16806722689075632,1.0
60,65,60,130,75,110,500,0.7719298245614035,76,65,45,92,42,91,411,0.7449664429530202,0.0
45,60,30,80,50,65,330,0.4603174603174603,70,150,140,65,100,75,600,0.55,4.0
25,35,70,95,55,45,325,0.16783216783216784,65,130,60,95,110,65,525,0.5303030303030303,0.5
35,35,35,35,35,35,210,0.13385826771653545,50,105,125,55,95,50,480,0.375886524822695,1.0
50,48,43,46,41,60,288,0.47297297297297297,65,83,57,95,85,105,490,0.8914728682170543,2.0
60,69,95,69,95,36,424,0.2608695652173913,100,5,5,15,65,30,220,0.07692307692307693,1.0
75,95,67,125,95,83,540,0.7117117117117117,52,65,50,45,50,38,300,0.27419354838709675,0.5
50,70,100,40,40,30,330,0.2222222222222222,60,115,105,65,70,80,495,0.7181818181818181,1.0
60,100,115,70,85,90,520,0.7557251908396947,106,110,90,154,90,130,680,0.926829268292683,1.0
20,10,55,15,20,80,200,0.17985611510791366,80,135,85,70,95,150,615,0.9844961240310077,2.0
50,85,40,85,40,35,335,0.1746031746031746,60,80,50,50,50,40,330,0.23853211009174313,1.0
80,100,70,50,60,45,405,0.25806451612903225,100,120,120,150,100,90,680,0.7880794701986755,2.0
64,88,50,88,50,106,446,0.9111111111111111,75,89,85,55,65,36,405,0.29545454545454547,1.0
65,125,100,60,70,70,490,0.6099290780141844,97,165,60,65,50,58,495,0.3902439024390244,2.0
40,45,35,40,40,90,290,0.65,75,80,95,90,100,50,490,0.2158273381294964,1.0
40,45,65,100,120,90,460,0.5588235294117647,95,117,80,65,70,92,519,0.8409090909090909,0.0
75,140,65,112,65,110,567,0.9140625,80,50,100,100,200,50,580,0.2357142857142857,2.0
78,104,78,159,115,100,634,0.8444444444444444,80,100,70,60,70,95,475,0.7416666666666667,4.0
50,52,48,65,50,55,320,0.33098591549295775,44,38,39,61,79,42,303,0.2251655629139073,1.0
70,50,30,95,135,105,485,0.8040540540540541,70,150,140,65,100,75,600,0.55,0.5
108,112,118,68,72,47,525,0.2916666666666667,99,68,83,72,87,51,460,0.417910447761194,0.0
80,50,100,100,200,50,580,0.2357142857142857,76,25,45,67,55,24,292,0.0390625,1.0
45,50,35,55,75,40,300,0.21367521367521367,78,84,78,109,85,100,534,0.8646616541353384,1.0
70,110,180,60,60,50,530,0.4117647058823529,35,35,35,35,35,35,210,0.13385826771653545,0.5
45,50,43,40,38,62,278,0.40441176470588236,70,95,125,65,75,45,475,0.33613445378151263,0.5
50,150,50,150,50,150,600,0.9339622641509434,60,85,69,60,69,77,420,0.518796992481203,1.0
60,60,60,35,35,30,280,0.11194029850746269,90,120,120,60,60,50,500,0.35294117647058826,1.0
40,60,30,31,31,70,262,0.4492753623188406,70,120,65,45,85,125,510,0.9747899159663865,1.0
50,80,95,10,45,10,290,0.232,80,80,80,55,55,90,440,0.6417910447761194,1.0
80,70,40,100,60,145,495,0.921875,50,45,45,35,35,50,260,0.23529411764705882,1.0
59,74,50,35,50,35,303,0.3125,78,84,78,109,85,100,534,0.8620689655172413,2.0
35,64,85,74,55,32,345,0.19827586206896552,95,124,78,69,71,58,495,0.37398373983739835,1.0
80,135,130,95,90,70,600,0.5181818181818182,73,76,75,81,100,100,505,0.8110236220472441,0.5
62,50,58,73,54,72,369,0.4435483870967742,25,35,70,95,55,45,325,0.16783216783216784,1.0
45,60,45,25,45,55,275,0.29,45,30,35,20,20,45,195,0.14782608695652175,1.0
80,105,105,105,105,80,580,0.5939849624060151,70,75,80,135,80,135,575,0.917910447761194,1.0
75,105,75,105,75,45,480,0.3274336283185841,108,130,95,80,85,102,600,0.7637795275590551,1.0
50,120,53,35,110,87,455,0.640625,54,63,52,83,56,97,405,0.7697841726618705,1.0
78,130,111,130,85,100,634,0.8561151079136691,88,107,122,74,75,64,530,0.4596774193548387,2.0
80,130,100,160,120,110,700,0.8981481481481481,65,90,115,45,115,58,488,0.5041322314049587,0.0
60,30,30,36,56,50,262,0.32432432432432434,125,130,90,130,90,95,660,0.7734375,1.0
80,145,150,105,110,110,700,0.8692307692307693,65,155,120,65,90,105,600,0.8677685950413223,1.0
60,50,70,80,80,140,480,0.8449612403100775,85,97,66,105,66,65,484,0.47107438016528924,1.0
55,55,55,85,55,30,335,0.1320754716981132,72,105,115,54,86,68,500,0.5149253731343284,1.0
50,53,48,53,48,64,316,0.46153846153846156,55,130,115,50,50,75,475,0.5982142857142857,0.5
55,70,40,60,40,40,305,0.26956521739130435,40,55,80,35,60,30,300,0.15037593984962405,0.5
80,80,90,110,130,110,600,0.8721804511278195,79,100,80,110,90,121,580,0.968,1.0
103,60,126,80,126,50,545,0.36363636363636365,78,104,78,159,115,100,634,0.8444444444444444,0.5
60,40,80,60,45,40,325,0.23529411764705882,72,95,67,103,71,122,530,0.9606299212598425,0.0
20,25,45,70,90,60,310,0.30833333333333335,60,48,45,43,90,42,328,0.21897810218978103,0.5
30,45,135,45,90,30,375,0.09285714285714286,50,50,40,30,30,50,250,0.2781954887218045,1.0
35,40,100,90,55,35,355,0.1796875,150,120,100,120,100,90,680,0.664179104477612,0.5
62,50,58,73,54,72,369,0.4435483870967742,75,85,200,55,65,30,510,0.16778523489932887,1.0
86,76,86,116,56,95,515,0.7982456140350878,50,50,62,40,62,65,329,0.4188034188034188,0.5
78,130,111,130,85,100,634,0.8561151079136691,95,75,180,130,80,30,590,0.13793103448275862,0.5
73,95,62,85,65,85,465,0.6666666666666666,80,135,85,70,95,150,615,0.9844961240310077,0.5
95,145,130,120,90,120,700,0.9398496240601504,40,55,30,30,30,85,270,0.688,1.0
114,85,70,85,80,30,464,0.2066115702479339,70,65,60,90,75,90,450,0.6571428571428571,0.125
79,103,120,135,115,78,630,0.5763888888888888,90,100,60,90,60,80,480,0.6422764227642277,0.5
65,110,130,60,65,95,525,0.8278145695364238,110,135,60,50,65,88,508,0.7744360902255639,1.0
65,80,65,35,65,60,370,0.38405797101449274,58,70,45,40,45,42,300,0.25925925925925924,1.0
110,65,105,55,95,80,510,0.6258503401360545,60,52,168,47,138,30,495,0.19834710743801653,0.25
55,50,45,135,95,120,500,0.7714285714285715,59,63,80,65,80,58,405,0.41843971631205673,1.0
60,40,50,75,85,95,405,0.6044776119402985,80,160,60,170,130,80,680,0.6180555555555556,1.0
80,160,80,130,80,100,630,0.8455284552845529,38,30,41,30,41,60,240,0.2897196261682243,2.0
40,80,35,35,45,70,305,0.4661016949152542,68,72,78,38,42,32,330,0.23809523809523808,1.0
70,94,50,94,50,66,424,0.48148148148148145,60,50,100,85,70,65,430,0.47580645161290325,0.5
70,60,70,87,78,85,450,0.6228070175438597,70,145,88,140,70,112,625,0.8888888888888888,0.5
70,60,125,115,70,55,495,0.35507246376811596,60,50,100,85,70,65,430,0.47580645161290325,1.0
95,65,65,110,130,60,525,0.4016393442622951,55,75,85,25,25,15,280,0.1875,1.0
60,52,168,47,138,30,495,0.19834710743801653,90,70,80,70,95,70,475,0.5190839694656488,2.0
45,75,60,40,30,50,300,0.304,80,50,100,100,200,50,580,0.2357142857142857,1.0
120,100,85,30,85,45,465,0.22448979591836735,43,70,48,50,60,38,309,0.2391304347826087,0.0
62,48,54,63,60,68,355,0.5178571428571429,125,130,90,130,90,95,660,0.7734375,1.0
85,135,130,60,80,25,515,0.40540540540540543,106,190,100,154,100,130,780,0.9259259259259259,0.5
60,100,85,80,85,100,510,0.7007874015748031,91,72,90,129,90,108,580,0.8620689655172413,1.0
90,95,105,165,110,45,610,0.2890625,86,81,97,81,107,43,495,0.203125,0.5
59,45,40,35,40,31,250,0.14285714285714285,35,45,160,30,45,70,385,0.48148148148148145,0.5
28,25,25,45,35,40,198,0.16083916083916083,58,64,58,80,65,80,405,0.609271523178808,0.5
50,95,90,95,90,180,600,0.9172413793103448,106,110,90,154,90,130,680,0.926829268292683,0.5
30,35,30,100,35,80,310,0.4765625,70,50,30,95,135,105,485,0.8040540540540541,1.0
68,75,53,83,113,60,452,0.45384615384615384,20,40,15,35,35,60,205,0.34285714285714286,1.0
49,66,70,44,55,51,335,0.4260869565217391,55,55,50,45,65,55,325,0.37373737373737376,0.0
105,125,100,60,100,100,590,0.8359375,70,115,60,115,60,55,475,0.4647887323943662,1.0
88,107,122,74,75,64,530,0.4596774193548387,70,130,100,55,80,65,500,0.608,0.25
70,70,40,60,40,60,340,0.4247787610619469,95,65,110,60,130,65,525,0.5275590551181102,0.5
108,170,115,120,95,92,700,0.7083333333333334,58,64,58,80,65,80,405,0.5423728813559322,2.0
50,70,50,50,50,70,340,0.5645161290322581,105,140,95,55,65,45,505,0.3,1.0
75,98,63,98,63,101,498,0.8091603053435115,60,69,95,69,95,36,424,0.2608695652173913,0.25
45,25,50,25,25,35,205,0.13076923076923078,68,85,65,165,135,100,618,0.8083333333333333,2.0
30,30,42,30,42,70,244,0.4230769230769231,75,75,75,125,95,40,485,0.15671641791044777,2.0
60,70,105,70,120,75,500,0.5983606557377049,40,55,70,45,60,30,300,0.10619469026548672,1.0
100,70,70,65,65,45,415,0.1897810218978102,95,145,130,120,90,120,700,0.9398496240601504,1.0
20,40,90,30,90,25,295,0.11363636363636363,70,70,70,70,70,70,420,0.5289256198347108,0.0
65,75,90,97,123,44,494,0.1987179487179487,50,65,107,105,107,86,520,0.6991150442477876,1.0
62,73,55,56,52,84,382,0.7244094488188977,105,140,55,30,55,95,480,0.8195488721804511,0.5
50,48,43,46,41,60,288,0.47297297297297297,81,102,77,85,75,85,505,0.5642857142857143,4.0
62,48,66,59,57,49,341,0.33884297520661155,65,40,70,80,140,70,465,0.5954198473282443,1.0
130,65,60,110,95,65,525,0.5227272727272727,40,55,99,40,79,47,360,0.26262626262626265,1.0
40,45,40,65,40,65,295,0.5661764705882353,55,85,122,58,75,99,494,0.8099173553719008,0.5
53,54,53,37,46,45,288,0.3090909090909091,65,80,65,35,65,60,370,0.38405797101449274,1.0
50,65,64,44,48,43,314,0.2196969696969697,50,75,70,35,70,48,348,0.29357798165137616,1.0
60,40,80,60,45,40,325,0.23529411764705882,45,85,50,55,50,65,350,0.5076923076923077,1.0
67,58,57,81,67,101,431,0.8790322580645161,55,85,55,50,55,60,360,0.4233576642335766,0.5
84,86,88,111,101,60,530,0.4634146341463415,75,80,85,110,90,50,490,0.3548387096774194,0.5
50,20,55,25,25,30,205,0.09774436090225563,70,90,90,135,90,125,600,0.9401709401709402,2.0
70,55,55,80,60,45,365,0.2222222222222222,40,27,60,37,50,66,280,0.36220472440944884,0.5
57,80,91,80,87,75,470,0.5737704918032787,72,60,30,20,30,25,237,0.11570247933884298,2.0
50,50,40,30,30,50,250,0.2781954887218045,100,150,90,180,160,90,770,0.7348484848484849,0.5
75,70,90,70,105,80,490,0.656,90,55,75,60,75,30,385,0.13970588235294118,1.0
35,80,50,50,70,120,405,0.84375,70,45,48,60,65,35,323,0.15748031496062992,1.0
40,55,30,30,30,60,245,0.43548387096774194,120,70,120,75,130,85,600,0.6694915254237288,1.0
45,100,45,45,45,10,290,0.2949640287769784,72,85,70,65,70,58,420,0.41304347826086957,1.0
70,77,60,97,60,108,472,0.8394160583941606,72,105,115,54,86,68,500,0.5149253731343284,2.0
44,48,65,50,64,43,314,0.1623931623931624,75,80,85,110,90,50,490,0.3548387096774194,0.5
48,72,48,72,48,48,336,0.25984251968503935,100,100,100,100,100,100,600,0.8758169934640523,0.25
70,84,70,65,70,51,410,0.2949640287769784,65,65,60,110,95,130,525,0.9253731343283582,2.0
54,63,52,83,56,97,405,0.7697841726618705,45,30,35,20,20,45,195,0.14782608695652175,1.0
40,29,45,29,45,36,224,0.14634146341463414,62,55,52,109,94,109,481,0.7833333333333333,1.0
30,30,42,30,42,70,244,0.4230769230769231,50,65,107,105,107,86,520,0.7313432835820896,2.0
58,64,58,80,65,80,405,0.609271523178808,40,40,50,30,30,30,220,0.0873015873015873,2.0
125,130,90,130,90,95,660,0.7734375,111,83,68,92,82,39,475,0.1774193548387097,1.0
70,84,70,65,70,51,410,0.2949640287769784,41,56,40,62,44,71,314,0.568,1.0
60,60,60,60,60,60,360,0.38095238095238093,83,80,80,135,80,121,579,0.9444444444444444,1.0
65,125,100,60,70,70,490,0.6099290780141844,60,40,80,60,45,40,325,0.23529411764705882,2.0
90,50,34,60,44,70,348,0.6283185840707964,52,65,50,45,50,38,300,0.27419354838709675,0.5
70,110,80,55,80,105,500,0.8794326241134752,68,165,95,65,115,110,618,0.8615384615384616,2.0
10,55,25,35,45,95,265,0.5396825396825397,85,56,77,50,77,78,423,0.53125,1.0
78,81,71,74,69,126,499,0.9090909090909091,60,75,85,100,85,115,520,0.8992248062015504,0.5
60,60,60,85,85,85,435,0.631578947368421,80,82,83,100,100,80,525,0.6742424242424242,1.0
90,132,105,132,105,30,594,0.4246575342465753,30,35,30,100,35,80,310,0.4765625,0.5
45,60,40,70,50,45,310,0.2846715328467153,80,80,80,55,55,90,440,0.6417910447761194,1.0
60,80,50,50,50,40,330,0.23853211009174313,28,25,25,45,35,40,198,0.16083916083916083,1.0
110,135,60,50,65,88,508,0.7744360902255639,45,100,135,65,135,45,525,0.29411764705882354,1.0
86,81,97,81,107,43,495,0.203125,45,67,60,35,50,63,320,0.5128205128205128,2.0
57,24,86,24,86,23,300,0.12727272727272726,40,70,130,60,130,25,455,0.17355371900826447,1.0
59,110,150,45,49,35,448,0.3333333333333333,70,80,65,90,65,85,455,0.578125,0.0
50,47,50,57,50,65,319,0.463768115942029,50,75,70,35,70,48,348,0.29357798165137616,1.0
95,85,85,65,65,35,430,0.2571428571428571,65,90,122,58,75,84,494,0.71875,0.25
58,109,112,48,48,109,484,0.8805970149253731,75,90,50,110,80,95,500,0.7985611510791367,0.5
110,123,65,100,65,65,528,0.5217391304347826,80,90,80,130,110,110,600,0.856,0.25
45,25,50,25,25,35,205,0.13076923076923078,62,44,50,44,50,55,305,0.3629032258064516,0.5
60,85,69,65,79,80,438,0.576,45,30,50,65,50,45,285,0.13821138211382114,1.0
105,105,75,65,100,50,500,0.37593984962406013,79,115,70,125,80,111,580,0.8468468468468469,1.0
70,145,88,140,70,112,625,0.8888888888888888,50,50,50,50,50,50,300,0.30708661417322836,4.0
50,40,85,40,65,25,305,0.08870967741935484,64,51,23,51,23,28,240,0.11363636363636363,1.0
60,105,60,120,60,105,510,0.8849557522123894,54,63,52,83,56,97,405,0.7697841726618705,1.0
70,120,65,45,85,125,510,0.9747899159663865,150,100,120,100,120,90,680,0.6666666666666666,4.0
62,48,54,63,60,68,355,0.5178571428571429,72,95,67,103,71,122,530,0.9606299212598425,0.0
40,40,35,50,100,70,335,0.5031847133757962,100,100,80,60,60,50,450,0.3050847457627119,1.0
50,55,50,36,30,43,264,0.2922077922077922,52,65,50,45,50,38,300,0.27419354838709675,1.0
51,65,65,80,75,59,395,0.4365079365079365,108,170,115,120,95,92,700,0.7083333333333334,4.0
41,64,45,50,50,50,300,0.36752136752136755,35,64,85,74,55,32,345,0.19827586206896552,1.0
50,70,50,50,50,70,340,0.5645161290322581,80,95,82,60,82,75,474,0.6,2.0
86,81,97,81,107,43,495,0.203125,78,81,71,74,69,126,499,0.9090909090909091,1.0
66,117,70,40,50,67,410,0.4573643410852713,80,70,40,100,60,145,495,0.921875,1.0
75,100,95,40,70,110,490,0.8717948717948718,90,95,95,70,90,70,510,0.5230769230769231,1.0
42,52,67,39,56,50,306,0.2868217054263566,125,120,90,170,100,95,700,0.78125,1.0
60,82,45,45,45,74,351,0.5752212389380531,60,50,70,50,90,65,385,0.39568345323741005,1.0
60,25,35,70,80,60,330,0.3076923076923077,80,100,200,50,100,50,580,0.3472222222222222,1.0
50,85,85,55,55,50,380,0.3902439024390244,90,92,87,75,85,76,505,0.5409836065573771,0.5
74,48,76,83,81,104,466,0.7322834645669292,65,130,60,95,110,65,525,0.5303030303030303,1.0
75,85,200,55,65,30,510,0.16778523489932887,20,10,55,15,20,80,200,0.17985611510791366,0.5
70,92,65,80,55,98,460,0.8090909090909091,65,110,130,60,65,95,525,0.8278145695364238,0.5
60,82,45,45,45,74,351,0.5752212389380531,80,50,100,100,200,50,580,0.2357142857142857,1.0
60,25,35,70,80,60,330,0.3076923076923077,75,75,60,83,60,60,413,0.39344262295081966,1.0
79,115,70,125,80,111,580,0.8468468468468469,50,25,28,45,55,15,218,0.0625,1.0
86,81,97,81,107,43,495,0.203125,59,45,40,35,40,31,250,0.14285714285714285,1.0
44,75,35,63,33,45,295,0.2647058823529412,90,95,95,70,90,70,510,0.5230769230769231,1.0
76,48,48,57,62,34,325,0.11688311688311688,50,85,40,85,40,35,335,0.1746031746031746,0.5
45,30,40,105,50,20,290,0.031007751937984496,80,100,70,60,70,95,475,0.7416666666666667,1.0
110,123,65,100,65,65,528,0.5217391304347826,120,100,85,30,85,45,465,0.22448979591836735,1.0
80,80,50,40,50,25,325,0.176056338028169,50,55,50,36,30,43,264,0.2922077922077922,1.0
63,120,85,90,55,55,468,0.2809917355371901,70,110,80,55,80,105,500,0.8794326241134752,1.0
35,35,35,35,35,35,210,0.13385826771653545,50,50,120,80,80,30,410,0.07258064516129033,2.0
40,40,35,50,100,70,335,0.5031847133757962,54,45,47,75,98,52,371,0.39669421487603307,2.0
50,70,50,50,50,40,310,0.16296296296296298,44,58,44,58,44,61,309,0.41964285714285715,2.0
50,45,45,35,35,50,260,0.23529411764705882,58,64,58,80,65,80,405,0.609271523178808,1.0
25,35,70,95,55,45,325,0.16783216783216784,57,80,91,80,87,75,470,0.5737704918032787,0.25
95,135,80,110,80,100,600,0.8248175182481752,70,130,100,55,80,65,500,0.608,0.5
40,55,70,45,60,30,300,0.10619469026548672,67,89,116,79,116,33,500,0.2624113475177305,0.5
150,80,44,90,54,80,498,0.625,135,85,40,40,85,5,390,0.6864406779661016,0.0
70,105,105,50,40,20,390,0.33587786259541985,75,98,63,98,63,101,498,0.8091603053435115,1.0
64,165,75,93,83,75,555,0.6587301587301587,65,90,40,45,80,75,395,0.625,1.0
70,90,90,135,90,125,600,0.9401709401709402,64,51,23,51,23,28,240,0.11363636363636363,1.0
83,80,80,135,80,121,579,0.9444444444444444,90,95,95,70,90,70,510,0.5230769230769231,2.0
50,20,40,20,40,20,190,0.0962962962962963,60,105,60,120,60,105,510,0.8849557522123894,2.0
65,75,70,95,70,95,470,0.7272727272727273,30,45,55,70,55,85,340,0.5633802816901409,1.0
38,41,40,50,65,65,299,0.4108527131782946,40,40,55,40,70,55,300,0.40939597315436244,1.0
60,79,105,59,85,36,424,0.17054263565891473,60,95,80,60,80,30,405,0.19480519480519481,0.5
86,68,72,109,66,106,507,0.8099173553719008,95,109,105,75,85,56,525,0.34513274336283184,2.0
75,140,65,112,65,110,567,0.9140625,59,66,70,44,55,41,335,0.25190839694656486,2.0
75,69,72,114,100,104,534,0.8253968253968254,45,60,40,70,50,45,310,0.2846715328467153,0.5
41,64,45,50,50,50,300,0.36752136752136755,30,45,55,70,55,85,340,0.5633802816901409,1.0
103,60,86,60,86,50,445,0.3458646616541353,80,100,70,50,60,45,405,0.25806451612903225,1.0
83,80,75,70,70,101,479,0.8615384615384616,40,55,70,45,60,30,300,0.10619469026548672,0.25
95,75,110,100,80,30,490,0.15267175572519084,60,60,60,35,35,30,280,0.11194029850746269,1.0
65,105,60,60,70,95,455,63.0,40,65,40,80,40,65,330,0.5038167938931297,2.0
55,95,115,45,45,35,390,0.2116788321167883,70,105,105,50,40,20,390,0.33587786259541985,2.0
65,125,100,55,70,85,500,0.6532258064516129,95,109,105,75,85,56,525,0.34513274336283184,2.0
55,68,64,45,55,31,318,0.11666666666666667,80,95,82,60,82,75,474,0.6,0.5
75,100,66,60,66,115,482,0.918918918918919,40,20,30,40,80,55,265,0.22764227642276422,1.0
59,110,150,45,49,35,448,0.3333333333333333,40,40,35,50,100,70,335,0.5031847133757962,0.5
71,95,85,110,95,79,535,0.664,60,45,70,75,85,55,390,0.3008130081300813,1.0
65,150,60,115,60,115,565,0.935251798561151,91,134,95,100,100,80,600,0.6304347826086957,1.0
55,95,55,35,75,115,430,0.9380530973451328,65,95,75,55,55,85,430,0.6933333333333334,0.5
80,145,150,105,110,110,700,0.8692307692307693,59,63,80,65,80,58,405,0.41843971631205673,0.5
60,85,60,50,50,125,430,0.9090909090909091,80,80,80,55,55,90,440,0.6417910447761194,1.0
65,105,60,60,70,95,455,63.0,100,123,75,57,75,80,510,0.6923076923076923,1.0
75,89,85,55,65,36,405,0.29545454545454547,62,77,62,50,42,65,358,0.4838709677419355,0.5
35,55,40,50,50,90,320,0.6838235294117647,80,70,65,80,120,100,515,0.8034188034188035,2.0
55,75,85,25,25,15,280,0.1875,65,110,130,60,65,95,525,0.8278145695364238,1.0
62,55,52,109,94,109,481,0.7833333333333333,54,45,47,75,98,52,371,0.39669421487603307,1.0
64,66,68,81,76,50,405,0.25190839694656486,38,41,40,50,65,65,299,0.4108527131782946,2.0
75,125,100,70,80,45,495,0.33035714285714285,106,150,70,194,120,140,780,0.952,2.0
55,45,43,55,43,72,313,0.5853658536585366,75,90,50,110,80,95,500,0.7985611510791367,0.0
50,50,77,95,77,91,440,0.5916666666666667,59,59,58,90,70,73,409,0.5826086956521739,1.0
80,160,80,130,80,100,630,0.8455284552845529,125,120,90,170,100,95,700,0.78125,2.0
50,65,107,105,107,86,520,0.7272727272727273,80,105,65,60,75,130,515,0.9645390070921985,1.0
65,95,100,60,50,50,420,0.34959349593495936,97,165,60,65,50,58,495,0.3902439024390244,1.0
50,105,79,35,110,76,455,0.6214285714285714,75,105,75,105,75,45,480,0.3274336283185841,1.0
40,35,30,120,70,105,400,0.6692307692307692,100,100,100,100,100,100,600,0.8602941176470589,1.0
55,40,85,80,105,40,405,0.23622047244094488,40,65,40,80,40,65,330,0.5038167938931297,2.0
60,60,60,60,60,60,360,0.38095238095238093,80,70,70,90,100,70,480,0.5609756097560976,1.0
80,75,150,75,150,50,580,0.30973451327433627,73,76,75,81,100,100,505,0.8110236220472441,0.5
90,93,55,70,55,55,418,0.3819444444444444,83,80,75,70,70,101,479,0.8615384615384616,1.0
65,125,100,55,70,85,500,0.6532258064516129,65,80,65,35,65,60,370,0.38405797101449274,1.0
106,90,130,90,154,110,680,0.8699186991869918,85,70,80,97,80,123,535,0.9304347826086956,1.0
95,117,184,44,46,28,514,0.2975206611570248,70,84,70,65,70,51,410,0.2949640287769784,2.0
65,130,60,75,60,75,465,0.689922480620155,71,73,88,120,89,59,500,0.43537414965986393,1.0
55,75,60,75,60,103,428,0.7982456140350878,60,55,90,145,90,80,520,0.6071428571428571,1.0
60,50,40,85,75,95,405,0.7540983606557377,90,93,55,70,55,55,418,0.3819444444444444,1.0
50,48,43,46,41,60,288,0.47297297297297297,70,55,65,95,85,70,440,0.5307692307692308,4.0
90,90,85,125,90,100,580,0.768595041322314,75,85,200,55,65,30,510,0.16778523489932887,0.0
50,75,75,65,65,50,380,0.4049586776859504,40,55,70,45,60,30,300,0.10619469026548672,1.0
65,130,60,95,110,65,525,0.5303030303030303,65,60,110,130,95,65,525,0.47761194029850745,2.0
68,125,65,65,115,80,518,0.6277372262773723,111,83,68,92,82,39,475,0.1774193548387097,2.0
74,94,131,54,116,20,489,0.4485294117647059,65,55,115,100,40,60,435,0.3798449612403101,0.5
65,125,60,95,60,105,510,0.9236641221374046,170,90,45,90,45,60,500,0.427536231884058,1.0
45,30,50,55,65,45,290,0.208,90,55,75,60,75,30,385,0.13970588235294118,1.0
73,95,62,85,65,85,465,0.6666666666666666,65,60,70,85,75,40,395,0.1796875,1.0
65,73,55,47,75,85,400,0.6846846846846847,64,165,75,93,83,75,555,0.6587301587301587,0.5
170,90,45,90,45,60,500,0.427536231884058,60,110,70,60,60,100,460,0.8461538461538461,1.0
64,66,68,81,76,50,405,0.25190839694656486,45,22,60,27,30,29,213,0.07518796992481203,1.0
100,90,130,45,65,55,485,0.4253731343283582,80,50,100,100,200,50,580,0.2357142857142857,2.0
41,64,45,50,50,50,300,0.36752136752136755,97,165,60,65,50,58,495,0.3902439024390244,1.0
70,80,102,80,102,40,474,0.2677165354330709,60,75,85,100,85,115,520,0.8992248062015504,2.0
40,65,95,60,45,35,340,0.13986013986013987,45,60,40,70,50,45,310,0.2846715328467153,1.0
100,100,100,100,100,100,600,0.8602941176470589,78,104,78,159,115,100,634,0.8444444444444444,0.25
50,70,160,70,160,90,600,0.7417218543046358,65,95,75,55,55,85,430,0.6933333333333334,2.0
78,65,68,112,154,75,552,0.628099173553719,130,65,60,110,95,65,525,0.5227272727272727,1.0
55,50,45,135,95,120,500,0.7714285714285715,64,66,68,81,76,50,405,0.25190839694656486,1.0
55,69,85,32,35,28,304,0.09302325581395349,80,70,65,80,120,100,515,0.8034188034188035,0.5
70,60,70,87,78,85,450,0.6228070175438597,95,75,110,100,80,30,490,0.15267175572519084,2.0
60,60,60,85,85,85,435,0.631578947368421,40,55,30,30,30,85,270,0.688,0.0
75,100,66,60,66,115,482,0.918918918918919,80,160,80,130,80,100,630,0.8455284552845529,1.0
79,105,70,145,80,101,580,0.8608695652173913,88,107,122,74,75,64,530,0.4596774193548387,2.0
76,104,71,104,71,108,534,0.912751677852349,45,60,45,25,45,55,275,0.29,2.0
70,115,60,115,60,55,475,0.4647887323943662,65,70,60,65,65,115,440,0.8583333333333333,1.0
65,125,100,60,70,70,490,0.6099290780141844,52,65,55,58,62,60,352,0.4482758620689655,1.0
130,70,35,70,35,60,400,0.4017857142857143,88,107,122,74,75,64,530,0.4596774193548387,0.5
130,70,35,70,35,60,400,0.4017857142857143,83,80,75,70,70,101,479,0.8615384615384616,1.0
40,45,35,30,40,55,245,0.3793103448275862,50,65,107,105,107,86,520,0.6991150442477876,0.5
45,50,55,75,65,30,320,0.06293706293706294,75,80,70,65,75,90,455,0.7578125,0.125
55,45,43,55,43,72,313,0.5853658536585366,35,55,35,30,30,35,220,0.23684210526315788,0.0
56,61,65,48,45,38,313,0.17567567567567569,50,65,107,105,107,86,520,0.703125,1.0
125,130,90,130,90,95,660,0.7734375,50,53,48,53,48,64,316,0.4076923076923077,2.0
46,87,60,30,40,57,320,0.37777777777777777,90,75,85,115,90,55,510,0.3445378151260504,1.0
90,132,105,132,105,30,594,0.4246575342465753,35,65,35,65,35,65,300,0.46621621621621623,1.0
40,80,100,30,30,20,300,0.11851851851851852,90,60,70,75,70,45,410,0.23880597014925373,2.0
45,80,100,35,37,28,325,0.3125,65,125,100,60,70,70,490,0.6099290780141844,0.25
75,65,55,65,55,69,384,0.43548387096774194,60,50,100,85,70,65,430,0.47580645161290325,0.0
60,62,50,62,60,40,334,0.18181818181818182,100,180,160,150,90,90,770,0.7520661157024794,1.0
70,80,65,90,65,85,455,0.578125,170,90,45,90,45,60,500,0.427536231884058,1.0
100,100,100,100,100,100,600,0.8805970149253731,68,125,65,65,115,80,518,0.6277372262773723,1.0
89,145,90,105,80,91,600,0.8549618320610687,100,100,100,100,100,100,600,0.8778625954198473,2.0
70,100,115,30,65,30,410,0.24390243902439024,20,10,230,10,230,5,505,0.0,2.0
75,98,63,98,63,101,498,0.849624060150376,50,70,50,50,50,70,340,0.5645161290322581,1.0
60,60,50,40,50,75,335,0.5882352941176471,71,95,85,110,95,79,535,0.664,1.0
80,145,150,105,110,110,700,0.8692307692307693,95,23,48,23,48,23,260,0.046153846153846156,0.5
110,78,73,76,71,60,468,0.3333333333333333,78,130,111,130,85,100,634,0.8561151079136691,2.0
85,105,55,85,50,115,495,0.9032258064516129,55,69,85,32,35,28,304,0.09302325581395349,1.0
60,59,85,79,105,36,424,0.16666666666666666,55,55,85,65,85,35,380,0.2014388489208633,4.0
55,75,85,25,25,15,280,0.1875,50,50,95,40,50,35,320,0.20279720279720279,0.5
100,150,140,100,90,90,670,0.7969924812030075,70,120,40,95,40,95,460,0.8106060606060606,1.0
55,69,85,32,35,28,304,0.09302325581395349,64,165,75,93,83,75,555,0.6587301587301587,1.0
70,100,70,105,75,40,460,0.23214285714285715,45,55,39,35,39,42,255,0.18518518518518517,1.0
95,60,79,100,125,81,540,0.6201550387596899,110,123,65,100,65,65,528,0.5217391304347826,2.0
70,140,230,60,80,50,630,0.32432432432432434,70,75,60,105,60,105,475,0.88,0.5
79,105,70,145,80,101,580,0.8608695652173913,71,73,88,120,89,59,500,0.43537414965986393,2.0
30,40,55,40,55,60,280,0.3237410071942446,70,60,62,80,82,60,414,0.4375,0.25
61,84,65,70,70,70,420,0.5,55,85,122,58,75,99,494,0.8099173553719008,1.0
60,60,40,65,45,35,305,0.15833333333333333,79,85,60,55,60,71,410,0.60431654676259,0.5
70,55,95,95,110,65,490,0.48872180451127817,50,92,108,92,108,35,485,0.2457627118644068,0.0
90,120,120,60,60,50,500,0.35294117647058826,68,65,65,125,115,80,518,0.6461538461538462,1.0
80,80,80,55,55,90,440,0.6417910447761194,50,40,85,40,65,25,305,0.08870967741935484,1.0
110,80,90,95,90,65,530,0.5033557046979866,75,75,95,75,95,113,528,0.9015151515151515,1.0
115,45,20,45,25,20,270,0.11538461538461539,65,75,90,97,123,44,494,0.1987179487179487,1.0
70,145,88,140,70,112,625,0.8888888888888888,67,57,55,77,55,114,425,0.8879310344827587,0.25
80,100,200,50,100,50,580,0.3472222222222222,40,40,35,50,100,70,335,0.5031847133757962,1.0
110,160,110,80,110,100,670,0.8591549295774648,65,65,60,130,95,110,525,0.823943661971831,1.0
60,40,60,95,60,55,370,0.4222222222222222,54,63,52,83,56,97,405,0.7697841726618705,0.5
80,70,65,80,120,100,515,0.8034188034188035,106,130,90,110,154,90,680,0.719626168224299,2.0
60,45,70,45,90,95,405,0.7304964539007093,50,53,48,53,48,64,316,0.46153846153846156,1.0
60,55,90,145,90,80,520,0.6071428571428571,80,105,105,105,105,80,580,0.5939849624060151,2.0
60,60,40,65,45,35,305,0.15833333333333333,60,150,50,150,50,60,520,0.5,4.0
70,80,102,80,102,40,474,0.2677165354330709,66,65,48,62,57,52,350,0.36220472440944884,4.0
45,95,50,40,50,75,355,0.54,58,109,112,48,48,109,484,0.8805970149253731,0.5
72,105,115,54,86,68,500,0.5149253731343284,60,40,60,40,60,35,295,0.18055555555555555,0.5
90,90,85,125,90,100,580,0.768595041322314,100,100,100,100,100,100,600,0.8758169934640523,0.5
70,85,140,85,70,20,470,0.272,70,80,70,80,70,110,480,0.6594202898550725,2.0
130,85,80,85,95,60,535,0.43884892086330934,90,85,75,115,100,115,580,0.9381443298969072,1.0
50,50,40,50,40,64,294,0.45588235294117646,65,136,94,54,96,135,580,0.9612403100775194,1.0
90,60,70,75,70,45,410,0.23880597014925373,85,56,77,50,77,78,423,0.53125,4.0
55,40,40,65,45,35,280,0.16428571428571428,70,85,140,85,70,20,470,0.272,1.0
55,70,45,70,50,60,350,0.45,95,124,78,69,71,58,495,0.37398373983739835,1.0
80,120,70,110,70,80,530,0.6422764227642277,50,75,45,40,45,60,315,0.4380165289256198,1.0
85,80,90,105,95,60,515,0.49074074074074076,70,94,50,94,50,66,424,0.48148148148148145,1.0
60,79,105,59,85,36,424,0.17054263565891473,91,134,95,100,100,80,600,0.6304347826086957,0.0
50,95,180,85,45,70,525,0.5298507462686567,165,75,80,40,45,65,470,0.5151515151515151,0.25
70,62,67,55,55,56,365,0.38513513513513514,60,65,60,130,75,110,500,0.7719298245614035,0.25
65,150,60,115,60,115,565,0.935251798561151,120,120,120,120,120,120,720,0.9344262295081968,1.0
55,75,85,25,25,15,280,0.1875,60,75,100,55,80,50,420,0.3088235294117647,0.5
85,56,77,50,77,78,423,0.53125,68,65,65,125,115,80,518,0.6461538461538462,1.0
60,105,60,120,60,105,510,0.8849557522123894,75,95,125,45,75,95,510,0.8257575757575758,1.0
100,100,100,100,100,100,600,0.8758169934640523,45,49,65,49,65,45,318,0.275,1.0
70,110,180,60,60,50,530,0.4117647058823529,55,45,50,45,65,80,340,0.5546218487394958,2.0
91,90,72,90,129,108,580,0.896,100,100,100,100,100,100,600,0.8778625954198473,0.25
45,60,30,80,50,65,330,0.4603174603174603,50,65,107,105,107,86,520,0.6991150442477876,0.5
30,42,118,42,88,30,350,0.112,70,60,62,80,82,60,414,0.4375,4.0
100,75,115,90,115,85,580,0.6446280991735537,40,40,55,40,70,55,300,0.40939597315436244,2.0
40,30,32,50,52,65,269,0.3671875,41,56,40,62,44,71,314,0.568,0.5
45,30,40,105,50,20,290,0.031007751937984496,74,108,133,83,65,32,495,0.32142857142857145,1.0
60,30,30,36,56,50,262,0.32432432432432434,65,90,115,45,115,58,488,0.5041322314049587,2.0
80,130,100,160,120,110,700,0.8981481481481481,75,80,85,110,90,50,490,0.3548387096774194,2.0
40,55,30,30,30,60,245,0.43548387096774194,60,50,50,60,70,50,340,0.28346456692913385,2.0
90,85,75,115,100,115,580,0.9381443298969072,99,68,83,72,87,51,460,0.417910447761194,1.0
50,75,70,35,70,48,348,0.29357798165137616,35,35,40,35,55,50,250,0.40336134453781514,0.5
103,60,86,60,86,50,445,0.3458646616541353,60,100,115,70,85,90,520,0.7557251908396947,0.5
109,66,84,81,99,32,471,0.2013888888888889,60,60,40,65,45,35,305,0.15833333333333333,0.0
40,45,65,100,120,90,460,0.5588235294117647,150,120,100,120,100,90,680,0.664179104477612,2.0
70,150,140,65,100,75,600,0.55,60,100,89,55,69,112,485,0.9298245614035088,0.5
56,61,65,48,45,38,313,0.17567567567567569,150,80,44,90,54,80,498,0.625,0.5
50,70,160,70,160,90,600,0.7417218543046358,40,45,35,40,40,90,290,0.65,1.0
38,30,85,55,65,30,303,0.21428571428571427,30,35,30,100,35,80,310,0.4765625,2.0
40,30,32,50,52,65,269,0.3671875,45,60,30,80,50,65,330,0.4603174603174603,2.0
38,30,85,55,65,30,303,0.21428571428571427,80,105,65,60,75,130,515,0.9645390070921985,1.0
53,51,53,61,56,40,314,0.14285714285714285,86,76,86,116,56,95,515,0.7982456140350878,1.0
57,80,91,80,87,75,470,0.5737704918032787,125,130,90,130,90,95,660,0.7734375,4.0
55,45,45,25,25,15,210,0.048,90,55,75,60,75,30,385,0.13970588235294118,1.0
60,85,60,50,50,125,430,0.9090909090909091,55,112,45,74,45,70,401,0.559322033898305,0.25
55,55,55,85,55,30,335,0.1320754716981132,40,40,50,30,30,30,220,0.0873015873015873,1.0
60,48,45,43,90,42,328,0.21897810218978103,54,66,70,44,55,46,335,0.4214876033057851,1.0
110,135,60,50,65,88,508,0.7744360902255639,64,66,68,81,76,50,405,0.25190839694656486,0.5
30,56,35,25,35,72,253,0.48148148148148145,85,80,90,105,95,60,515,0.49074074074074076,1.0
103,60,86,60,86,50,445,0.3458646616541353,66,41,77,61,87,23,355,0.12096774193548387,0.5
75,98,63,98,63,101,498,0.889763779527559,90,110,80,100,80,95,555,0.7982456140350878,0.5
89,124,80,55,80,55,483,0.5714285714285714,42,52,67,39,56,50,306,0.2868217054263566,2.0
65,95,75,55,55,85,430,0.6933333333333334,78,104,78,159,115,100,634,0.8444444444444444,2.0
45,55,45,65,45,75,330,0.5692307692307692,65,150,60,115,60,115,565,0.935251798561151,1.0
100,100,100,100,100,100,600,0.831858407079646,65,155,120,65,90,105,600,0.8677685950413223,1.0
25,35,70,95,55,45,325,0.16783216783216784,100,90,130,45,65,55,485,0.4253731343283582,2.0
105,180,100,180,100,115,780,0.9477611940298507,100,77,77,128,128,90,600,0.6901408450704225,1.0
50,48,43,46,41,60,288,0.47297297297297297,75,100,110,45,55,65,450,0.5333333333333333,2.0
70,120,40,95,40,95,460,0.8106060606060606,70,62,67,55,55,56,365,0.38513513513513514,1.0
45,50,35,55,75,40,300,0.21367521367521367,35,45,160,30,45,70,385,0.48148148148148145,1.0
85,80,90,105,95,60,515,0.49074074074074076,89,124,80,55,80,55,483,0.5714285714285714,0.0
50,60,60,60,60,30,320,0.11290322580645161,80,110,120,130,90,70,600,0.6198347107438017,1.0
65,80,65,35,65,60,370,0.38405797101449274,40,80,100,30,30,20,300,0.11851851851851852,0.5
62,44,50,44,50,55,305,0.3629032258064516,20,10,55,15,20,80,200,0.17985611510791366,0.5
40,55,70,45,60,30,300,0.10619469026548672,52,65,50,45,50,38,300,0.27419354838709675,1.0
77,120,90,60,90,48,485,0.2785714285714286,78,92,75,74,63,118,500,0.8842975206611571,1.0
50,70,160,70,160,90,600,0.7417218543046358,62,48,54,63,60,68,355,0.5178571428571429,0.5
45,60,40,70,50,45,310,0.2846715328467153,45,50,55,75,65,30,320,0.06293706293706294,2.0
75,75,60,83,60,60,413,0.39344262295081966,60,80,95,70,85,50,440,0.2231404958677686,1.0
60,30,30,36,56,50,262,0.32432432432432434,65,83,57,95,85,105,490,0.8914728682170543,0.5
45,75,60,40,30,50,300,0.304,35,20,65,40,65,20,245,0.02459016393442623,0.0
50,95,95,35,110,70,455,0.5179856115107914,80,82,100,83,100,80,525,0.6821705426356589,1.0
50,53,48,53,48,64,316,0.4076923076923077,65,90,65,61,61,100,442,0.8373983739837398,0.5
45,55,39,35,39,42,255,0.18518518518518517,79,115,70,125,80,111,580,0.864,1.0
20,10,55,15,20,80,200,0.17985611510791366,85,110,90,45,90,80,500,0.6206896551724138,1.0
70,60,125,115,70,55,495,0.35507246376811596,80,110,60,150,130,70,600,0.5042016806722689,1.0
110,80,90,95,90,65,530,0.5033557046979866,45,35,45,62,53,35,275,0.11851851851851852,1.0
80,80,80,80,80,80,480,0.5606060606060606,85,105,85,40,50,40,405,0.211864406779661,1.0
68,85,65,165,135,100,618,0.8083333333333333,80,80,90,110,130,110,600,0.8721804511278195,1.0
70,70,115,130,90,60,535,0.5338983050847458,60,48,45,43,90,42,328,0.21897810218978103,1.0
130,85,80,85,95,60,535,0.43884892086330934,45,25,50,25,25,35,205,0.13076923076923078,1.0
77,59,50,67,63,46,362,0.23140495867768596,100,100,100,100,100,100,600,0.8602941176470589,2.0
57,24,86,24,86,23,300,0.12727272727272726,65,80,80,59,63,58,405,0.4411764705882353,0.5
80,80,80,80,80,80,480,0.6015037593984962,35,70,55,45,55,25,285,0.09420289855072464,2.0
68,75,53,83,113,60,452,0.45384615384615384,65,65,60,130,95,110,525,0.823943661971831,1.0
70,110,70,115,70,90,525,0.75,60,90,70,60,120,40,440,0.27419354838709675,2.0
43,80,65,50,35,35,308,0.14193548387096774,75,87,63,87,63,98,473,0.865546218487395,0.5
75,90,140,60,60,40,465,0.3008130081300813,65,75,90,97,123,44,494,0.1987179487179487,0.5
50,65,90,35,35,15,290,0.14678899082568808,68,90,65,50,55,82,410,0.6165413533834586,1.0
50,25,28,45,55,15,218,0.0625,60,45,50,90,80,70,395,0.625,1.0
55,69,85,32,35,28,304,0.09302325581395349,45,30,50,55,65,45,290,0.208,1.0
40,30,30,55,30,85,270,0.4666666666666667,105,105,75,65,100,50,500,0.37593984962406013,1.0
45,100,135,65,135,45,525,0.29411764705882354,80,120,79,95,79,70,523,0.5833333333333334,1.0
85,80,70,135,75,90,535,0.7006802721088435,31,45,90,30,30,40,266,0.21929824561403508,1.0
75,110,110,110,105,80,590,0.656934306569343,60,60,60,105,105,105,495,0.848,1.0
60,70,50,100,50,65,395,0.5217391304347826,50,30,55,65,55,20,275,0.13675213675213677,0.25
105,130,120,45,45,40,485,0.4444444444444444,85,70,80,97,80,123,535,0.9304347826086956,0.0
45,35,50,70,50,30,280,0.15753424657534246,100,90,130,45,65,55,485,0.4253731343283582,4.0
70,85,140,85,70,20,470,0.272,50,20,40,20,40,20,190,0.0962962962962963,1.0
95,85,85,65,65,35,430,0.2571428571428571,45,49,49,65,65,45,318,0.2781954887218045,0.5
50,50,50,50,50,50,300,0.30708661417322836,59,45,40,35,40,31,250,0.14285714285714285,1.0
55,50,40,40,40,75,300,0.5945945945945946,75,95,125,45,75,95,510,0.8257575757575758,1.0
85,80,90,105,95,60,515,0.49074074074074076,95,125,79,60,100,81,540,0.6165413533834586,1.0
55,85,122,58,75,99,494,0.8099173553719008,100,120,120,150,100,90,680,0.7880794701986755,0.25
80,80,80,55,55,90,440,0.6417910447761194,60,52,168,47,138,30,495,0.19834710743801653,0.25
85,120,70,50,60,100,485,0.8308823529411765,70,45,48,60,65,35,323,0.15748031496062992,1.0
73,115,60,60,60,90,458,0.6694915254237288,72,95,67,103,71,122,530,0.9606299212598425,1.0
78,65,68,112,154,75,552,0.628099173553719,100,150,120,120,100,90,680,0.6493506493506493,2.0
105,30,105,140,105,55,540,0.3524590163934426,60,85,69,65,79,80,438,0.576,2.0
77,120,90,60,90,48,485,0.2785714285714286,60,80,50,40,40,30,300,0.15328467153284672,0.0
75,98,63,98,63,101,498,0.889763779527559,80,105,105,105,105,80,580,0.5939849624060151,1.0
55,84,105,114,75,52,485,0.2890625,105,30,105,140,105,55,540,0.3524590163934426,2.0
50,20,40,20,40,20,190,0.0962962962962963,95,75,80,100,110,30,490,0.24242424242424243,1.0
70,70,70,70,70,70,420,0.5289256198347108,49,55,42,42,37,85,310,0.6068376068376068,1.0
95,100,85,108,70,70,528,0.5652173913043478,100,100,100,100,100,100,600,0.8602941176470589,0.5
73,115,60,60,60,90,458,0.6694915254237288,90,130,80,65,85,55,505,0.4396551724137931,1.0
100,73,83,73,83,55,467,0.371900826446281,80,160,80,130,80,100,630,0.8455284552845529,1.0
75,98,63,98,63,101,498,0.8091603053435115,60,65,60,130,75,110,500,0.7719298245614035,0.5
45,90,20,65,20,65,305,0.5116279069767442,55,69,85,32,35,28,304,0.09302325581395349,1.0
44,38,33,61,43,70,289,0.5267857142857143,50,53,48,53,48,64,316,0.358974358974359,2.0
105,95,75,85,75,74,509,0.5714285714285714,55,85,55,50,55,60,360,0.4233576642335766,2.0
85,135,130,60,80,25,515,0.40540540540540543,75,90,50,110,80,95,500,0.7985611510791367,2.0
75,69,72,114,100,104,534,0.8253968253968254,100,50,50,76,96,70,442,0.5,1.0
67,57,55,77,55,114,425,0.8879310344827587,35,80,50,50,70,120,405,0.84375,2.0
30,105,90,25,25,50,325,0.2773722627737226,80,110,60,150,130,70,600,0.5042016806722689,1.0
74,108,133,83,65,32,495,0.32142857142857145,70,90,45,15,45,50,315,0.3629032258064516,4.0
70,65,60,90,75,90,450,0.6571428571428571,90,132,105,132,105,30,594,0.4246575342465753,4.0
60,48,45,43,90,42,328,0.21897810218978103,68,165,95,65,115,110,618,0.8615384615384616,0.5
55,70,45,70,50,60,350,0.45,40,80,100,30,30,20,300,0.11851851851851852,0.5
70,60,75,110,75,90,480,0.7165354330708661,79,105,70,145,80,101,580,0.8608695652173913,0.5
95,85,85,65,65,35,430,0.2571428571428571,100,77,77,128,128,90,600,0.6901408450704225,1.0
70,80,50,35,35,35,305,0.14,55,40,40,65,45,35,280,0.16428571428571428,1.0
70,85,140,85,70,20,470,0.272,75,98,63,98,63,101,498,0.849624060150376,0.5
70,80,50,35,35,35,305,0.14,60,69,95,69,95,36,424,0.2608695652173913,1.0
103,60,86,60,86,50,445,0.3458646616541353,90,132,105,132,105,30,594,0.4246575342465753,1.0
59,63,80,65,80,58,405,0.41843971631205673,123,77,72,99,92,58,521,0.4621212121212121,2.0
70,80,70,80,70,110,480,0.6594202898550725,85,76,64,45,55,90,415,0.6739130434782609,0.0
55,47,52,40,40,41,275,0.16806722689075632,50,150,50,150,50,150,600,0.9339622641509434,1.0
40,35,30,120,70,105,400,0.6692307692307692,70,110,80,55,80,105,500,0.8794326241134752,1.0
60,85,60,85,60,55,405,0.3673469387755102,100,90,130,45,65,55,485,0.4253731343283582,0.5
80,80,80,80,80,80,480,0.6015037593984962,106,130,90,110,154,90,680,0.719626168224299,1.0
90,120,120,60,60,50,500,0.35294117647058826,55,70,55,40,55,85,360,0.7073170731707317,1.0
62,48,66,59,57,49,341,0.33884297520661155,74,48,76,83,81,104,466,0.7322834645669292,1.0
135,85,40,40,85,5,390,0.6864406779661016,78,52,60,63,65,23,341,0.06015037593984962,1.0
55,68,64,45,55,31,318,0.11666666666666667,90,50,34,60,44,70,348,0.6283185840707964,0.5
60,60,60,35,35,30,280,0.11194029850746269,60,85,60,50,50,125,430,0.9090909090909091,1.0
80,80,90,110,130,110,600,0.8721804511278195,39,52,43,60,50,65,309,0.5041322314049587,1.0
120,70,120,75,130,85,600,0.6694915254237288,109,66,84,81,99,32,471,0.2013888888888889,2.0
50,50,120,80,80,30,410,0.07258064516129033,45,95,50,40,50,75,355,0.54,2.0
55,35,50,55,110,85,390,0.6277372262773723,45,40,60,40,75,50,310,0.2926829268292683,0.5
36,50,50,65,60,44,305,0.16363636363636364,46,87,60,30,40,57,320,0.37777777777777777,2.0
55,45,45,25,25,15,210,0.048,125,130,90,130,90,95,660,0.7734375,0.5
55,70,45,70,50,60,350,0.45,74,48,76,83,81,104,466,0.7913043478260869,1.0
90,60,60,40,40,40,330,0.29545454545454547,95,65,110,60,130,65,525,0.5275590551181102,1.0
45,75,37,70,55,83,365,0.6183206106870229,50,53,48,53,48,64,316,0.4076923076923077,2.0
105,140,95,55,65,45,505,0.3,50,65,107,105,107,86,520,0.7758620689655172,1.0
80,80,80,80,80,80,480,0.5606060606060606,65,65,60,110,95,130,525,0.9253731343283582,1.0
103,93,67,71,61,84,479,0.7142857142857143,95,125,79,60,100,81,540,0.6165413533834586,1.0
50,85,125,85,115,20,480,0.4306569343065693,91,90,72,90,129,108,580,0.896,0.5
95,65,110,60,130,65,525,0.5275590551181102,40,40,35,50,100,70,335,0.5031847133757962,1.0
100,100,100,100,100,100,600,0.8345864661654135,20,25,45,70,90,60,310,0.30833333333333335,0.5
170,90,45,90,45,60,500,0.427536231884058,74,94,131,54,116,20,489,0.4485294117647059,0.5
65,55,115,100,40,60,435,0.3798449612403101,70,140,230,60,80,50,630,0.32432432432432434,0.5
60,40,60,95,60,55,370,0.4222222222222222,65,90,50,85,45,55,390,0.371900826446281,2.0
79,103,120,135,115,78,630,0.5763888888888888,80,160,60,170,130,80,680,0.6180555555555556,1.0
65,60,70,85,75,40,395,0.1796875,95,65,110,60,130,65,525,0.5275590551181102,1.0
65,95,57,100,85,93,495,0.7441860465116279,116,55,85,107,95,29,487,0.06818181818181818,1.0
78,70,61,50,61,100,420,0.8145161290322581,72,85,70,65,70,58,420,0.41304347826086957,1.0
60,48,45,43,90,42,328,0.21897810218978103,65,110,130,60,65,95,525,0.8278145695364238,1.0
79,115,70,125,80,111,580,0.864,55,55,55,85,55,30,335,0.1320754716981132,1.0
54,45,47,75,98,52,371,0.39669421487603307,75,100,95,40,70,110,490,0.8717948717948718,1.0
110,135,60,50,65,88,508,0.7744360902255639,60,50,100,85,70,65,430,0.47580645161290325,0.0
110,130,80,70,60,80,530,0.5862068965517241,60,110,70,60,60,100,460,0.8461538461538461,0.0
77,59,50,67,63,46,362,0.23140495867768596,55,45,45,25,25,15,210,0.048,0.5
58,89,77,45,45,48,362,0.3177570093457944,45,30,50,55,65,45,290,0.208,1.0
75,90,50,110,80,95,500,0.7985611510791367,40,70,130,60,130,25,455,0.17355371900826447,2.0
20,10,55,15,20,80,200,0.17985611510791366,59,66,70,44,55,41,335,0.25190839694656486,0.5
70,55,65,95,85,70,440,0.5307692307692308,65,90,120,85,70,60,490,0.43410852713178294,2.0
50,65,107,105,107,86,520,0.7758620689655172,42,52,67,39,56,50,306,0.2868217054263566,2.0
90,130,80,65,85,55,505,0.4396551724137931,70,90,90,135,90,125,600,0.9401709401709402,2.0
72,60,30,20,30,25,237,0.11570247933884298,75,100,66,60,66,115,482,0.918918918918919,2.0
70,70,70,70,70,70,420,0.5289256198347108,59,66,70,44,55,41,335,0.25190839694656486,0.0
45,35,50,70,50,30,280,0.15753424657534246,55,75,50,40,40,80,340,0.6302521008403361,0.5
70,115,60,115,60,55,475,0.4647887323943662,45,30,50,65,50,45,285,0.13821138211382114,2.0
40,45,35,65,55,70,310,0.4482758620689655,55,55,50,45,65,55,325,0.37373737373737376,1.0
90,120,120,60,60,50,500,0.35294117647058826,50,75,70,35,70,48,348,0.29357798165137616,1.0
80,50,100,100,200,50,580,0.2357142857142857,58,64,58,80,65,80,405,0.5423728813559322,0.5
43,30,55,40,65,97,330,0.6030534351145038,38,41,40,50,65,65,299,0.4108527131782946,2.0
50,53,48,53,48,64,316,0.46153846153846156,75,89,85,55,65,36,405,0.29545454545454547,2.0
50,52,48,65,50,55,320,0.33098591549295775,60,70,65,125,105,90,515,0.6911764705882353,0.5
40,50,45,70,45,70,320,0.5517241379310345,65,50,70,95,80,65,425,0.4262295081967213,0.5
75,80,95,90,100,50,490,0.2158273381294964,67,57,55,77,55,114,425,0.8879310344827587,0.5
60,62,80,63,80,60,405,0.4336283185840708,60,60,60,105,105,105,495,0.848,1.0
95,23,48,23,48,23,260,0.046153846153846156,55,45,45,25,25,15,210,0.048,2.0
78,52,60,63,65,23,341,0.06015037593984962,95,117,184,44,46,28,514,0.2975206611570248,1.0
75,140,65,112,65,110,567,0.9140625,65,95,100,60,50,50,420,0.34959349593495936,1.0
105,150,90,150,90,95,680,0.8285714285714286,70,62,67,55,55,56,365,0.38513513513513514,1.0
65,40,50,125,60,30,370,0.07258064516129033,80,100,123,122,120,80,625,0.56,2.0
80,82,78,95,80,85,500,0.6869565217391305,85,135,130,60,80,25,515,0.40540540540540543,2.0
60,80,95,70,85,50,440,0.2231404958677686,75,75,130,75,130,95,580,0.7479674796747967,1.0
76,25,45,67,55,24,292,0.0390625,67,89,116,79,116,33,500,0.2624113475177305,0.25
71,73,88,120,89,59,500,0.43537414965986393,36,50,50,65,60,44,305,0.16363636363636364,1.0
70,70,40,60,40,60,340,0.4247787610619469,75,98,63,98,63,101,498,0.849624060150376,2.0
105,95,80,40,80,90,490,0.753968253968254,45,20,50,60,120,50,345,0.24074074074074073,1.0
60,40,60,40,60,35,295,0.18055555555555555,60,60,50,40,50,75,335,0.5882352941176471,0.5
55,35,50,55,110,85,390,0.6277372262773723,50,105,125,55,95,50,480,0.375886524822695,0.125
70,65,60,90,75,90,450,0.6571428571428571,39,52,43,60,50,65,309,0.5041322314049587,0.5
91,90,129,90,72,108,580,0.9140625,55,95,115,45,45,35,390,0.2116788321167883,4.0
50,85,125,85,115,20,480,0.4306569343065693,95,124,78,69,71,58,495,0.37398373983739835,0.125
65,90,65,61,61,100,442,0.8373983739837398,86,76,86,116,56,95,515,0.7982456140350878,2.0
60,130,80,60,60,70,460,0.5153846153846153,40,40,50,30,30,30,220,0.0873015873015873,0.5
65,136,94,54,96,135,580,0.9612403100775194,20,15,20,10,55,80,200,0.2682926829268293,1.0
100,103,75,120,75,127,600,0.940677966101695,60,69,95,69,95,36,424,0.2608695652173913,0.25
75,75,55,105,85,30,425,0.1619718309859155,45,45,35,20,30,20,195,0.07246376811594203,0.5
60,85,40,30,45,68,328,0.6422018348623854,74,100,72,90,72,46,454,0.24561403508771928,0.5
55,35,50,55,110,85,390,0.6277372262773723,60,79,105,59,85,36,424,0.17054263565891473,2.0
49,49,56,49,61,66,330,0.5190839694656488,40,45,40,65,40,65,295,0.5661764705882353,1.0
64,51,23,51,23,28,240,0.11363636363636363,50,65,107,105,107,86,520,0.6991150442477876,1.0
78,130,111,130,85,100,634,0.8561151079136691,55,81,60,50,70,97,413,0.7214285714285714,1.0
45,35,50,70,50,30,280,0.15753424657534246,40,30,30,55,30,85,270,0.4666666666666667,1.0
40,80,100,30,30,20,300,0.11851851851851852,50,65,107,105,107,86,520,0.7758620689655172,2.0
35,35,40,35,55,50,250,0.40336134453781514,45,50,43,40,38,62,278,0.40441176470588236,0.5
90,95,95,70,90,70,510,0.5230769230769231,100,150,110,95,110,70,635,0.5923076923076923,1.0
70,80,65,90,65,85,455,0.578125,80,80,80,55,55,90,440,0.6417910447761194,1.0
80,80,80,55,55,90,440,0.6417910447761194,40,65,40,80,40,65,330,0.5038167938931297,1.0
55,112,45,74,45,70,401,0.559322033898305,65,65,60,130,95,110,525,0.823943661971831,1.0
60,50,70,50,90,65,385,0.39568345323741005,36,50,50,65,60,44,305,0.16363636363636364,1.0
70,90,45,15,45,50,315,0.3629032258064516,85,76,64,45,55,90,415,0.6739130434782609,1.0
50,70,100,40,40,30,330,0.2222222222222222,58,64,58,80,65,80,405,0.609271523178808,1.0
36,50,50,65,60,44,305,0.16363636363636364,50,85,40,85,40,35,335,0.1746031746031746,2.0
60,25,35,70,80,60,330,0.3076923076923077,55,95,115,45,45,35,390,0.2116788321167883,2.0
190,33,58,33,58,33,405,0.13432835820895522,44,38,33,61,43,70,289,0.5267857142857143,1.0
60,85,40,30,45,68,328,0.6422018348623854,45,50,43,40,38,62,278,0.40441176470588236,0.0
57,80,91,80,87,75,470,0.5737704918032787,59,59,58,90,70,73,409,0.5826086956521739,0.25
68,85,65,165,135,100,618,0.8083333333333333,84,86,88,111,101,60,530,0.4634146341463415,0.25
100,164,150,95,120,71,700,0.5645161290322581,60,60,50,40,50,75,335,0.5882352941176471,1.0
80,80,90,110,130,110,600,0.8721804511278195,45,55,39,35,39,42,255,0.18518518518518517,1.0
90,95,95,70,90,70,510,0.5230769230769231,120,100,85,30,85,45,465,0.22448979591836735,1.0
100,100,100,100,100,100,600,0.8602941176470589,86,68,72,109,66,106,507,0.8099173553719008,0.5
39,52,43,60,50,65,309,0.49107142857142855,38,35,40,27,25,35,200,0.08208955223880597,2.0
70,77,60,97,60,108,472,0.8394160583941606,58,89,77,45,45,48,362,0.3177570093457944,0.5
60,90,55,90,80,110,485,0.8677685950413223,39,52,43,60,50,65,309,0.5041322314049587,1.0
100,100,90,150,140,90,670,0.71875,60,70,50,100,50,65,395,0.5217391304347826,1.0
100,150,110,95,110,70,635,0.5923076923076923,45,40,60,40,75,50,310,0.2926829268292683,0.0
40,35,30,20,20,50,195,0.23423423423423423,80,82,83,100,100,80,525,0.6742424242424242,1.0
75,98,63,98,63,101,498,0.889763779527559,48,61,40,61,40,50,300,0.2543859649122807,1.0
45,45,55,45,55,63,308,0.4594594594594595,65,90,122,58,75,84,494,0.71875,0.5
55,68,64,45,55,31,318,0.11666666666666667,44,75,35,63,33,45,295,0.2647058823529412,1.0
110,78,73,76,71,60,468,0.3333333333333333,45,30,50,65,50,45,285,0.13821138211382114,1.0
67,58,57,81,67,101,431,0.8790322580645161,44,58,44,58,44,61,309,0.41964285714285715,0.5
45,50,35,55,75,40,300,0.21367521367521367,74,94,131,54,116,20,489,0.4485294117647059,0.5
103,60,126,80,126,50,545,0.36363636363636365,50,35,55,25,25,15,205,0.05263157894736842,1.0
73,95,62,85,65,85,465,0.6666666666666666,55,55,45,63,45,45,308,0.25,1.0
80,100,70,60,70,95,475,0.7416666666666667,64,88,50,88,50,106,446,0.9111111111111111,1.0
72,95,67,103,71,122,530,0.9606299212598425,101,72,72,99,89,29,462,0.1937984496124031,0.5
110,65,105,55,95,80,510,0.6258503401360545,35,85,45,35,35,75,310,0.6492537313432836,1.0
55,20,35,20,45,75,250,0.37681159420289856,60,85,49,60,49,60,363,0.4444444444444444,1.0
70,85,65,105,85,120,530,0.9262295081967213,65,90,115,45,115,58,488,0.5041322314049587,1.0
120,100,85,30,85,45,465,0.22448979591836735,90,100,90,125,85,90,580,0.7352941176470589,0.5
90,95,95,70,90,70,510,0.5230769230769231,60,80,50,50,50,40,330,0.23853211009174313,2.0
60,70,50,100,50,65,395,0.5217391304347826,106,90,130,90,154,110,680,0.8699186991869918,1.0
50,47,50,57,50,65,319,0.463768115942029,60,55,145,75,150,40,525,0.2,0.5
45,53,70,40,60,42,310,0.25735294117647056,49,49,56,49,61,66,330,0.5190839694656488,2.0
85,135,130,60,80,25,515,0.40540540540540543,65,125,100,55,70,85,500,0.6532258064516129,2.0
125,130,90,130,90,95,660,0.7734375,65,65,60,130,95,110,525,0.823943661971831,1.0
90,55,75,60,75,30,385,0.13970588235294118,60,48,45,43,90,42,328,0.21897810218978103,1.0
75,90,140,60,60,40,465,0.3008130081300813,40,80,100,30,30,20,300,0.11851851851851852,2.0
60,69,95,69,95,36,424,0.2608695652173913,65,110,130,60,65,95,525,0.8278145695364238,2.0
90,60,60,40,40,40,330,0.29545454545454547,1,90,45,30,30,40,236,0.33064516129032256,0.5
65,125,60,95,60,105,510,0.9236641221374046,40,55,70,45,60,30,300,0.10619469026548672,2.0
95,100,85,108,70,70,528,0.5652173913043478,90,70,80,70,95,70,475,0.5190839694656488,0.5
108,130,95,80,85,102,600,0.7637795275590551,68,75,53,83,113,60,452,0.45384615384615384,2.0
65,95,57,100,85,93,495,0.7441860465116279,70,62,67,55,55,56,365,0.38513513513513514,1.0
60,60,60,105,105,105,495,0.848,62,55,52,109,94,109,481,0.7833333333333333,0.0
54,66,70,44,55,46,335,0.4214876033057851,50,70,100,40,40,30,330,0.2222222222222222,1.0
40,60,30,31,31,70,262,0.4492753623188406,65,95,57,100,85,93,495,0.7441860465116279,1.0
75,70,90,70,105,80,490,0.656,90,95,105,165,110,45,610,0.2890625,1.0
60,45,70,75,85,55,390,0.3008130081300813,60,85,69,65,79,80,438,0.576,2.0
35,35,40,35,55,50,250,0.40336134453781514,45,100,135,65,135,45,525,0.29411764705882354,1.0
52,65,50,45,50,38,300,0.27419354838709675,55,75,85,25,25,15,280,0.1875,1.0
79,105,70,145,80,101,580,0.8608695652173913,126,131,95,131,98,99,680,0.8102189781021898,2.0
45,85,70,40,40,60,340,0.5229357798165137,109,66,84,81,99,32,471,0.2013888888888889,0.5
95,80,105,40,70,100,490,0.8046875,65,150,60,115,60,115,565,0.935251798561151,1.0
106,110,90,154,90,130,680,0.926829268292683,90,90,85,125,90,100,580,0.768595041322314,1.0
41,56,40,62,44,71,314,0.568,55,55,45,63,45,45,308,0.25,0.5
40,30,35,45,40,55,245,0.31496062992125984,70,94,50,94,50,66,424,0.48148148148148145,2.0
38,30,85,55,65,30,303,0.21428571428571427,45,50,35,55,75,40,300,0.21367521367521367,1.0
45,35,50,70,50,30,280,0.15753424657534246,101,72,72,99,89,29,462,0.1937984496124031,1.0
70,92,65,80,55,98,460,0.8090909090909091,45,40,60,40,75,50,310,0.2926829268292683,1.0
90,55,75,60,75,30,385,0.13970588235294118,55,55,85,65,85,35,380,0.2014388489208633,0.5
30,40,55,40,55,60,280,0.3237410071942446,70,80,70,80,70,110,480,0.6594202898550725,0.0
57,24,86,24,86,23,300,0.12727272727272726,75,90,50,110,80,95,500,0.7985611510791367,0.0
60,90,55,90,80,110,485,0.8677685950413223,40,29,45,29,45,36,224,0.14634146341463414,1.0
40,30,50,55,55,100,330,0.584070796460177,100,100,100,100,100,100,600,0.8805970149253731,2.0
55,55,45,63,45,45,308,0.25,50,75,75,65,65,50,380,0.4049586776859504,1.0
90,85,75,115,100,115,580,0.9381443298969072,90,95,95,70,90,70,510,0.5230769230769231,2.0
38,30,85,55,65,30,303,0.21428571428571427,75,80,60,65,90,102,472,0.8625954198473282,0.0
95,75,180,130,80,30,590,0.13793103448275862,55,84,105,114,75,52,485,0.2890625,0.5
50,50,40,50,40,64,294,0.45588235294117646,70,140,230,60,80,50,630,0.32432432432432434,1.0
57,80,91,80,87,75,470,0.5737704918032787,65,76,84,54,96,105,480,0.9008264462809917,1.0
38,41,40,50,65,65,299,0.4108527131782946,65,136,94,54,96,135,580,0.9612403100775194,1.0
45,35,50,70,50,30,280,0.15753424657534246,62,50,58,73,54,72,369,0.4435483870967742,0.5
55,70,55,40,55,85,360,0.7073170731707317,49,66,70,44,55,51,335,0.4260869565217391,0.0
73,95,62,85,65,85,465,0.6666666666666666,50,160,110,160,110,110,700,0.8854961832061069,0.5
55,85,122,58,75,99,494,0.8099173553719008,66,117,70,40,50,67,410,0.4573643410852713,0.5
40,55,30,30,30,60,245,0.43548387096774194,80,120,80,120,80,100,580,0.8478260869565217,1.0
55,95,55,35,75,115,430,0.9380530973451328,43,70,48,50,60,38,309,0.2391304347826087,4.0
115,115,85,90,75,100,580,0.8134328358208955,108,130,95,80,85,102,600,0.7637795275590551,0.5
44,75,35,63,33,45,295,0.2647058823529412,50,25,28,45,55,15,218,0.0625,1.0
45,60,40,70,50,45,310,0.2846715328467153,75,80,95,90,100,50,490,0.2158273381294964,2.0
64,88,50,88,50,106,446,0.9111111111111111,95,124,78,69,71,58,495,0.37398373983739835,0.25
108,170,115,120,95,92,700,0.7083333333333334,44,38,33,61,43,70,289,0.5267857142857143,2.0
65,95,100,60,50,50,420,0.34959349593495936,90,85,75,115,100,115,580,0.9381443298969072,1.0
55,81,60,50,70,97,413,0.7214285714285714,75,140,65,112,65,110,567,0.9140625,0.5
51,65,65,80,75,59,395,0.4365079365079365,65,95,57,100,85,93,495,0.7441860465116279,0.5
75,55,70,55,95,110,460,0.8444444444444444,90,110,80,100,80,95,555,0.7982456140350878,0.5
52,65,50,45,50,38,300,0.27419354838709675,70,75,80,135,80,135,575,0.917910447761194,1.0
62,77,62,50,42,65,358,0.4838709677419355,45,100,45,45,45,10,290,0.2949640287769784,1.0
95,110,80,70,80,50,485,0.37209302325581395,70,80,50,35,35,35,305,0.14,1.0
30,40,70,70,25,60,295,0.41353383458646614,60,100,85,80,85,100,510,0.7007874015748031,1.0
123,100,62,97,81,68,531,0.4806201550387597,76,48,48,57,62,34,325,0.11688311688311688,2.0
110,80,90,95,90,65,530,0.5033557046979866,103,93,67,71,61,84,479,0.7142857142857143,1.0
50,72,35,35,35,65,292,0.5373134328358209,64,88,50,88,50,106,446,0.9111111111111111,0.5
50,60,60,60,60,30,320,0.11290322580645161,160,110,65,65,110,30,540,0.35714285714285715,1.0
105,95,75,85,75,74,509,0.5714285714285714,60,82,45,45,45,74,351,0.5752212389380531,2.0
45,60,40,70,50,45,310,0.2846715328467153,55,55,85,65,85,35,380,0.2014388489208633,0.25
50,72,35,35,35,65,292,0.5373134328358209,40,20,30,40,80,55,265,0.22764227642276422,0.0
45,35,45,62,53,35,275,0.11851851851851852,70,55,55,80,60,45,365,0.2222222222222222,1.0
44,50,91,24,86,10,305,0.1981981981981982,50,50,50,50,50,50,300,0.30708661417322836,2.0
80,125,75,40,95,85,500,0.6911764705882353,73,95,62,85,65,85,465,0.6666666666666666,2.0
60,62,63,80,80,60,405,0.38016528925619836,50,65,64,44,48,43,314,0.2196969696969697,2.0
91,90,129,90,72,108,580,0.9140625,45,50,35,55,75,40,300,0.21367521367521367,1.0
72,105,115,54,86,68,500,0.5149253731343284,55,95,55,35,75,115,430,0.9380530973451328,2.0
50,100,150,100,150,50,600,0.37142857142857144,50,85,85,55,55,50,380,0.3902439024390244,0.25
45,22,60,27,30,29,213,0.07518796992481203,50,65,90,35,35,15,290,0.14678899082568808,1.0
50,30,55,65,55,20,275,0.13675213675213677,45,75,60,40,30,50,300,0.304,0.5
90,100,70,110,150,80,600,0.6037735849056604,78,84,78,109,85,100,534,0.8646616541353384,1.0
65,70,60,65,65,115,440,0.8583333333333333,70,60,75,110,75,90,480,0.7165354330708661,1.0
75,95,67,125,95,83,540,0.7117117117117117,45,67,60,35,50,63,320,0.5128205128205128,0.5
75,100,63,80,63,116,497,0.9345794392523364,80,120,79,95,79,70,523,0.5833333333333334,0.5
54,66,70,44,55,46,335,0.4214876033057851,75,75,95,75,95,113,528,0.9015151515151515,0.5
82,121,119,69,59,71,521,0.5394736842105263,65,95,57,100,85,93,495,0.7441860465116279,2.0
100,100,100,100,100,100,600,0.8778625954198473,65,95,57,100,85,93,495,0.7441860465116279,0.5
60,59,85,79,105,36,424,0.16666666666666666,80,70,65,80,120,100,515,0.8034188034188035,0.5
55,45,43,55,43,72,313,0.5853658536585366,40,30,32,50,52,65,269,0.3671875,2.0
69,69,76,69,86,91,460,0.6554621848739496,100,100,100,100,100,100,600,0.8778625954198473,2.0
60,62,50,62,60,40,334,0.18181818181818182,63,60,55,50,50,71,349,0.5289256198347108,1.0
60,60,60,60,60,60,360,0.38095238095238093,60,75,85,100,85,115,520,0.8992248062015504,1.0
40,40,35,50,100,70,335,0.5031847133757962,38,41,40,50,65,65,299,0.4108527131782946,2.0
92,105,90,125,90,98,600,0.8217054263565892,65,150,60,115,60,115,565,0.935251798561151,0.5
75,98,63,98,63,101,498,0.889763779527559,45,49,49,65,65,45,318,0.2781954887218045,2.0
30,45,59,30,39,57,260,0.2803030303030303,90,100,90,125,85,90,580,0.7352941176470589,0.25
50,60,60,60,60,30,320,0.11290322580645161,80,135,85,70,95,150,615,0.9844961240310077,1.0
60,40,60,40,60,35,295,0.18055555555555555,60,75,100,55,80,50,420,0.3088235294117647,0.5
150,160,100,95,65,100,670,0.8866666666666667,78,130,111,130,85,100,634,0.8561151079136691,1.0
54,78,103,53,45,22,355,0.23255813953488372,65,90,115,45,115,58,488,0.5041322314049587,0.5
59,74,50,35,50,35,303,0.3125,45,35,45,62,53,35,275,0.11851851851851852,0.5
70,130,100,55,80,65,500,0.608,40,55,30,30,30,85,270,0.688,0.5
80,160,60,170,130,80,680,0.6180555555555556,60,60,60,60,60,60,360,0.38095238095238093,1.0
30,80,90,55,45,55,355,0.4295774647887324,75,87,63,87,63,98,473,0.865546218487395,1.0
54,45,47,75,98,52,371,0.39669421487603307,41,50,37,50,37,66,281,0.5175438596491229,2.0
30,40,55,40,55,60,280,0.3237410071942446,84,71,43,71,43,48,360,0.25874125874125875,2.0
60,48,45,43,90,42,328,0.21897810218978103,60,85,49,60,49,60,363,0.4444444444444444,1.0
35,45,160,30,45,70,385,0.48148148148148145,60,62,80,63,80,60,405,0.4336283185840708,0.5
110,160,110,80,110,100,670,0.8591549295774648,60,30,30,36,56,50,262,0.32432432432432434,1.0
80,105,105,105,105,80,580,0.5939849624060151,85,105,85,40,50,40,405,0.211864406779661,1.0
57,80,91,80,87,75,470,0.5737704918032787,85,110,76,65,82,56,474,0.3933333333333333,1.0
63,60,55,50,50,71,349,0.5289256198347108,100,120,120,150,100,90,680,0.7880794701986755,0.25
30,40,70,70,25,60,295,0.41353383458646614,90,93,55,70,55,55,418,0.3819444444444444,2.0
78,65,68,112,154,75,552,0.628099173553719,44,58,44,58,44,61,309,0.41964285714285715,0.5
44,48,65,50,64,43,314,0.1623931623931624,190,33,58,33,58,33,405,0.13432835820895522,1.0
95,155,109,70,130,81,640,0.6788321167883211,255,10,10,75,135,55,540,0.3125,1.0
55,45,43,55,43,72,313,0.5853658536585366,85,70,80,97,80,123,535,0.9304347826086956,1.0
105,150,90,150,90,95,680,0.8285714285714286,60,130,80,60,60,70,460,0.5153846153846153,4.0
70,90,110,60,75,95,500,0.7333333333333333,55,85,122,58,75,99,494,0.8099173553719008,2.0
70,60,70,87,78,85,450,0.6228070175438597,95,70,73,95,90,60,483,0.3983739837398374,1.0
100,100,125,110,50,50,535,0.384,78,52,60,63,65,23,341,0.06015037593984962,1.0
52,65,55,58,62,60,352,0.4482758620689655,130,70,35,70,35,60,400,0.4017857142857143,1.0
45,49,65,49,65,45,318,0.275,89,145,90,105,80,91,600,0.8549618320610687,1.0
65,60,110,130,95,65,525,0.47761194029850745,72,58,80,103,80,97,490,0.7171052631578947,2.0
108,112,118,68,72,47,525,0.2916666666666667,70,55,95,95,110,65,490,0.48872180451127817,1.0
75,125,75,30,75,85,465,0.625,64,66,68,81,76,50,405,0.25190839694656486,1.0
70,92,65,80,55,98,460,0.8090909090909091,30,45,59,30,39,57,260,0.2803030303030303,1.0
67,125,40,30,30,58,350,0.3431372549019608,50,53,62,58,63,44,330,0.13709677419354838,1.0
50,50,40,50,40,64,294,0.45588235294117646,65,100,70,80,80,105,500,0.8666666666666667,2.0
45,30,50,65,50,45,285,0.13821138211382114,41,50,37,50,37,66,281,0.5175438596491229,0.0
50,20,55,25,25,30,205,0.09774436090225563,70,80,102,80,102,40,474,0.2677165354330709,0.5
95,135,80,110,80,100,600,0.8248175182481752,70,105,105,50,40,20,390,0.33587786259541985,0.5
50,20,55,25,25,30,205,0.09774436090225563,89,145,90,105,80,91,600,0.8549618320610687,0.5
59,74,50,35,50,35,303,0.3125,60,60,40,65,45,35,305,0.15833333333333333,2.0
20,40,90,30,90,25,295,0.11363636363636363,100,77,77,128,128,90,600,0.6901408450704225,0.0
60,65,70,85,75,40,395,0.21705426356589147,45,60,45,25,45,55,275,0.29,1.0
80,80,80,80,80,80,480,0.6015037593984962,80,105,65,60,75,130,515,0.9645390070921985,2.0
100,164,150,95,120,71,700,0.5645161290322581,78,65,68,112,154,75,552,0.628099173553719,0.5
95,75,80,100,110,30,490,0.24242424242424243,75,125,70,125,70,115,580,0.9037037037037037,0.5
56,61,65,48,45,38,313,0.17567567567567569,80,100,123,122,120,80,625,0.56,0.25
30,80,90,55,45,55,355,0.4295774647887324,50,85,40,85,40,35,335,0.1746031746031746,0.5
45,45,35,20,30,20,195,0.07246376811594203,59,59,58,90,70,73,409,0.5826086956521739,0.5
80,50,100,100,200,50,580,0.2357142857142857,30,40,70,70,25,60,295,0.41353383458646614,0.5
42,52,67,39,56,50,306,0.2868217054263566,70,150,140,65,100,75,600,0.55,1.0
71,120,95,120,95,99,600,0.8203125,62,50,58,73,54,72,369,0.4435483870967742,0.25
55,112,45,74,45,70,401,0.559322033898305,56,61,65,48,45,38,313,0.17567567567567569,2.0
70,70,40,60,40,60,340,0.4247787610619469,61,84,65,70,70,70,420,0.5,0.5
70,50,30,95,135,105,485,0.8040540540540541,40,30,35,45,40,55,245,0.31496062992125984,4.0
95,95,85,125,65,55,520,0.3894736842105263,50,160,110,160,110,110,700,0.8854961832061069,2.0
35,35,35,35,35,35,210,0.13385826771653545,50,95,95,35,110,70,455,0.5179856115107914,1.0
63,60,55,50,50,71,349,0.5289256198347108,60,45,70,45,90,95,405,0.7304964539007093,0.5
50,20,55,25,25,30,205,0.09774436090225563,40,30,35,45,40,55,245,0.31496062992125984,0.5
50,72,35,35,35,65,292,0.5373134328358209,70,95,85,55,65,70,440,0.5,4.0
75,95,122,58,75,69,494,0.5725806451612904,54,45,47,75,98,52,371,0.39669421487603307,1.0
78,52,60,63,65,23,341,0.06015037593984962,165,75,80,40,45,65,470,0.5151515151515151,1.0
38,30,41,30,41,60,240,0.2897196261682243,49,66,70,44,55,51,335,0.4260869565217391,0.0
120,100,85,30,85,45,465,0.22448979591836735,65,125,60,95,60,105,510,0.9236641221374046,1.0
125,130,90,130,90,95,660,0.7734375,100,100,100,100,100,100,600,0.8602941176470589,2.0
80,100,123,122,120,80,625,0.56,70,90,70,60,60,70,420,0.6390977443609023,1.0
65,80,140,40,70,70,465,0.5223880597014925,95,155,109,70,130,81,640,0.6788321167883211,0.5
78,130,111,130,85,100,634,0.8561151079136691,40,55,99,40,79,47,360,0.26262626262626265,2.0
60,75,85,100,85,115,520,0.8992248062015504,60,100,115,70,85,90,520,0.7557251908396947,0.5
62,44,50,44,50,55,305,0.3629032258064516,45,20,50,60,120,50,345,0.24074074074074073,0.5
36,50,50,65,60,44,305,0.16363636363636364,55,20,35,20,45,75,250,0.37681159420289856,1.0
67,125,40,30,30,58,350,0.3431372549019608,68,90,65,50,55,82,410,0.6165413533834586,0.5
110,78,73,76,71,60,468,0.3333333333333333,60,50,70,80,80,140,480,0.8449612403100775,2.0
76,104,71,104,71,108,534,0.912751677852349,37,25,41,25,41,25,194,0.08870967741935484,1.0
35,40,100,90,55,35,355,0.1796875,75,75,55,105,85,30,425,0.1619718309859155,0.5
70,140,230,60,80,50,630,0.32432432432432434,95,117,80,65,70,92,519,0.8409090909090909,1.0
100,123,75,57,75,80,510,0.6923076923076923,105,140,95,55,65,45,505,0.3,2.0
40,40,40,70,40,20,250,0.032520325203252036,35,40,100,90,55,35,355,0.1796875,0.25
65,73,55,47,75,85,400,0.6846846846846847,71,95,85,110,95,79,535,0.664,1.0
45,30,35,20,20,45,195,0.14782608695652175,60,60,60,85,85,85,435,0.631578947368421,0.5
60,60,60,60,60,60,360,0.38095238095238093,95,75,180,130,80,30,590,0.13793103448275862,1.0
90,85,75,115,100,115,580,0.9381443298969072,75,98,63,98,63,101,498,0.849624060150376,2.0
95,85,85,65,65,35,430,0.2571428571428571,50,20,55,25,25,30,205,0.09774436090225563,0.5
30,45,55,70,55,85,340,0.5633802816901409,50,50,120,80,80,30,410,0.07258064516129033,4.0
35,55,40,50,50,90,320,0.6838235294117647,75,89,85,55,65,36,405,0.29545454545454547,0.5
60,40,50,75,85,95,405,0.6044776119402985,78,84,78,109,85,100,534,0.8646616541353384,2.0
75,85,200,55,65,30,510,0.16778523489932887,60,105,60,120,60,105,510,0.8849557522123894,1.0
75,95,122,58,75,69,494,0.5725806451612904,103,60,126,80,126,50,545,0.36363636363636365,0.0
60,82,45,45,45,74,351,0.5752212389380531,36,50,50,65,60,44,305,0.16363636363636364,1.0
60,45,70,75,85,55,390,0.3008130081300813,55,75,50,40,40,80,340,0.6302521008403361,1.0
65,80,80,59,63,58,405,0.4411764705882353,95,145,130,120,90,120,700,0.9398496240601504,0.5
90,95,95,70,90,70,510,0.5230769230769231,80,135,85,70,95,150,615,0.9844961240310077,2.0
90,70,80,70,95,70,475,0.5190839694656488,65,65,60,130,95,110,525,0.823943661971831,1.0
50,105,79,35,110,76,455,0.6214285714285714,108,112,118,68,72,47,525,0.2916666666666667,1.0
60,60,60,105,105,105,495,0.848,50,65,107,105,107,86,520,0.6991150442477876,1.0
55,104,105,94,75,52,485,0.36363636363636365,86,81,97,81,107,43,495,0.203125,1.0
79,115,70,125,80,111,580,0.8468468468468469,90,92,87,75,85,76,505,0.5409836065573771,1.0
58,109,112,48,48,109,484,0.8805970149253731,110,123,65,100,65,65,528,0.5217391304347826,0.125
85,50,95,120,115,80,545,0.5793650793650794,95,23,48,23,48,23,260,0.046153846153846156,1.0
91,90,72,90,129,108,580,0.896,79,100,80,110,90,121,580,0.968,0.25
20,10,55,15,20,80,200,0.17985611510791366,76,25,45,67,55,24,292,0.0390625,1.0
91,90,129,90,72,108,580,0.9140625,62,77,62,50,42,65,358,0.4838709677419355,1.0
60,95,80,60,80,30,405,0.19480519480519481,106,130,90,110,154,90,680,0.719626168224299,0.0625
63,60,55,50,50,71,349,0.5289256198347108,55,40,50,65,85,40,335,0.3181818181818182,0.0
70,110,80,55,80,105,500,0.8794326241134752,45,35,45,62,53,35,275,0.11851851851851852,4.0
74,48,76,83,81,104,466,0.7913043478260869,95,135,80,110,80,100,600,0.8248175182481752,1.0
70,94,50,94,50,66,424,0.48148148148148145,50,85,55,65,65,90,410,0.7478260869565218,0.5
38,35,40,27,25,35,200,0.08208955223880597,105,95,80,40,80,90,490,0.753968253968254,1.0
60,60,60,35,35,30,280,0.11194029850746269,60,115,105,65,70,80,495,0.7181818181818181,0.5
66,41,77,61,87,23,355,0.12096774193548387,123,100,62,97,81,68,531,0.4806201550387597,0.5
65,150,40,15,80,145,495,0.9663865546218487,68,90,65,50,55,82,410,0.6165413533834586,0.5
45,25,50,25,25,35,205,0.13076923076923078,65,125,60,95,60,105,510,0.9236641221374046,0.5
72,85,70,65,70,58,420,0.41304347826086957,75,95,95,95,95,85,540,0.6470588235294118,2.0
56,61,65,48,45,38,313,0.17567567567567569,65,40,50,125,60,30,370,0.07258064516129033,1.0
90,30,15,40,20,15,210,0.043478260869565216,65,95,57,100,85,93,495,0.7441860465116279,0.5
75,95,67,125,95,83,540,0.7117117117117117,53,54,53,37,46,45,288,0.3090909090909091,1.0
120,70,120,75,130,85,600,0.6694915254237288,70,60,62,80,82,60,414,0.4375,1.0
92,105,90,125,90,98,600,0.8217054263565892,70,110,80,55,80,105,500,0.8794326241134752,1.0
45,65,34,40,34,45,263,0.2589928057553957,85,90,80,70,80,130,535,0.9262295081967213,2.0
95,65,110,60,130,65,525,0.5275590551181102,71,73,88,120,89,59,500,0.43537414965986393,1.0
60,70,65,125,105,90,515,0.6911764705882353,65,50,70,95,80,65,425,0.4262295081967213,1.0
45,55,39,35,39,42,255,0.18518518518518517,50,75,45,40,45,60,315,0.4380165289256198,1.0
64,165,75,93,83,75,555,0.6587301587301587,38,35,40,27,25,35,200,0.08208955223880597,1.0
99,68,83,72,87,51,460,0.417910447761194,60,45,70,45,90,95,405,0.7304964539007093,0.5
55,55,45,63,45,45,308,0.25,100,73,83,73,83,55,467,0.371900826446281,1.0
80,135,85,70,95,150,615,0.9844961240310077,64,88,50,88,50,106,446,0.9111111111111111,1.0
80,50,100,100,200,50,580,0.2357142857142857,63,63,47,41,41,74,329,0.56,1.0
65,63,45,45,45,45,308,0.2595419847328244,70,80,102,80,102,40,474,0.2677165354330709,2.0
65,95,57,100,85,93,495,0.7441860465116279,85,105,55,85,50,115,495,0.9032258064516129,0.5
92,105,90,125,90,98,600,0.8217054263565892,130,65,60,110,95,65,525,0.5227272727272727,1.0
86,76,86,116,56,95,515,0.7982456140350878,110,80,90,95,90,65,530,0.5033557046979866,1.0
65,95,100,60,50,50,420,0.34959349593495936,125,120,90,170,100,95,700,0.78125,2.0
73,100,60,100,60,65,458,0.42657342657342656,75,90,90,140,90,115,600,0.9481481481481482,1.0
83,80,80,135,80,121,579,0.9444444444444444,100,123,75,57,75,80,510,0.6923076923076923,1.0
100,120,120,150,100,90,680,0.7880794701986755,35,70,55,45,55,25,285,0.09420289855072464,1.0
53,51,53,61,56,40,314,0.14285714285714285,65,47,55,73,75,85,400,0.65,1.0
78,92,75,74,63,118,500,0.8842975206611571,45,75,60,40,30,50,300,0.304,1.0
78,70,61,50,61,100,420,0.8145161290322581,60,70,65,125,105,90,515,0.6911764705882353,1.0
100,110,90,85,90,60,535,0.47794117647058826,45,30,40,105,50,20,290,0.031007751937984496,1.0
80,80,80,80,80,80,480,0.5606060606060606,105,95,80,40,80,90,490,0.753968253968254,1.0
50,100,150,100,150,50,600,0.37142857142857144,105,180,100,180,100,115,780,0.9477611940298507,4.0
39,52,43,60,50,65,309,0.5041322314049587,61,84,65,70,70,70,420,0.5,0.5
80,95,82,60,82,75,474,0.6,58,50,145,95,105,30,483,0.2459016393442623,0.5
65,75,70,95,70,95,470,0.7272727272727273,40,55,30,30,30,85,270,0.688,1.0
48,72,48,72,48,48,336,0.25984251968503935,60,90,55,90,80,110,485,0.8677685950413223,1.0
63,60,55,50,50,71,349,0.5289256198347108,65,40,50,125,60,30,370,0.07258064516129033,1.0
80,100,70,60,70,95,475,0.7416666666666667,55,55,50,45,65,55,325,0.37373737373737376,1.0
60,60,60,105,105,105,495,0.848,60,85,69,60,69,77,420,0.518796992481203,0.0
60,75,100,55,80,50,420,0.3088235294117647,65,65,45,75,45,95,390,0.72,1.0
106,130,90,110,154,90,680,0.719626168224299,56,61,65,48,45,38,313,0.17567567567567569,4.0
68,165,95,65,115,110,618,0.8615384615384616,43,70,48,50,60,38,309,0.2391304347826087,0.0
70,60,125,115,70,55,495,0.35507246376811596,89,125,90,115,80,101,600,0.8725490196078431,2.0
60,70,105,70,120,75,500,0.5983606557377049,50,180,20,180,20,150,600,0.9029850746268657,0.5
35,46,34,35,45,20,215,0.072,55,70,45,70,50,60,350,0.45,1.0
65,65,45,75,45,95,390,0.72,20,40,90,30,90,25,295,0.11363636363636363,0.5
80,115,80,65,55,93,488,0.7846153846153846,76,48,48,57,62,34,325,0.11688311688311688,1.0
73,100,60,100,60,65,458,0.42657342657342656,190,33,58,33,58,33,405,0.13432835820895522,1.0
80,80,90,110,130,110,600,0.8721804511278195,77,120,90,60,90,48,485,0.2785714285714286,2.0
45,45,55,45,55,63,308,0.4594594594594595,165,75,80,40,45,65,470,0.5151515151515151,2.0
60,130,80,60,60,70,460,0.5153846153846153,70,120,65,45,85,125,510,0.9747899159663865,4.0
75,75,75,125,95,40,485,0.15671641791044777,110,78,73,76,71,60,468,0.3333333333333333,2.0
36,50,50,65,60,44,305,0.16363636363636364,75,80,70,65,75,90,455,0.7578125,2.0
95,110,80,70,80,50,485,0.37209302325581395,60,60,60,105,105,105,495,0.848,1.0
70,70,40,60,40,60,340,0.4247787610619469,65,70,60,65,65,115,440,0.8583333333333333,1.0
75,75,55,105,85,30,425,0.1619718309859155,50,105,125,55,95,50,480,0.375886524822695,0.5
75,125,70,125,70,115,580,0.9037037037037037,120,100,85,30,85,45,465,0.22448979591836735,1.0
45,60,32,50,32,76,295,0.5925925925925926,67,58,57,81,67,101,431,0.8790322580645161,0.5
80,80,80,80,80,80,480,0.5606060606060606,78,65,68,112,154,75,552,0.628099173553719,1.0
10,55,25,35,45,95,265,0.5396825396825397,50,55,50,36,30,43,264,0.2922077922077922,0.0
78,92,75,74,63,118,500,0.8842975206611571,45,85,50,55,50,65,350,0.5076923076923077,2.0
64,66,68,81,76,50,405,0.25190839694656486,116,55,85,107,95,29,487,0.06818181818181818,1.0
67,57,55,77,55,114,425,0.8879310344827587,55,40,40,65,45,35,280,0.16428571428571428,0.5
45,45,55,45,55,63,308,0.4594594594594595,42,52,67,39,56,50,306,0.2868217054263566,4.0
95,125,79,60,100,81,540,0.6165413533834586,60,100,115,70,85,90,520,0.7557251908396947,0.5
90,92,75,92,85,60,494,0.49586776859504134,50,53,48,53,48,64,316,0.46153846153846156,0.25
100,100,100,100,100,100,600,0.8758169934640523,55,104,105,94,75,52,485,0.36363636363636365,0.5
100,120,120,150,100,90,680,0.7880794701986755,44,48,65,50,64,43,314,0.1623931623931624,0.5
43,30,55,40,65,97,330,0.6030534351145038,80,90,80,130,110,110,600,0.856,0.5
100,73,83,73,83,55,467,0.371900826446281,50,65,107,105,107,86,520,0.703125,1.0
85,100,122,58,75,54,494,0.3939393939393939,55,130,115,50,50,75,475,0.5982142857142857,2.0
60,105,60,120,60,105,510,0.8849557522123894,100,100,100,100,100,100,600,0.8602941176470589,1.0
30,105,90,25,25,50,325,0.2773722627737226,50,65,90,35,35,15,290,0.14678899082568808,1.0
75,65,55,65,55,69,384,0.43548387096774194,60,90,140,50,50,40,430,0.2535211267605634,8.0
64,88,50,88,50,106,446,0.9111111111111111,50,65,107,105,107,86,520,0.7313432835820896,1.0
82,121,119,69,59,71,521,0.5394736842105263,55,65,95,95,45,85,440,0.6610169491525424,1.0
54,66,70,44,55,46,335,0.4214876033057851,45,63,37,65,55,95,360,0.8055555555555556,1.0
86,92,88,68,75,73,482,0.6835443037974683,60,40,50,75,85,95,405,0.6044776119402985,1.0
61,84,65,70,70,70,420,0.5,65,80,65,35,65,60,370,0.38405797101449274,1.0
92,105,90,125,90,98,600,0.8217054263565892,20,10,230,10,230,5,505,0.0,1.0
80,80,80,55,55,90,440,0.6417910447761194,70,83,50,37,50,60,350,0.3360655737704918,1.0
91,134,95,100,100,80,600,0.6304347826086957,60,50,70,50,90,65,385,0.39568345323741005,2.0
90,75,85,115,90,55,510,0.3445378151260504,55,66,44,44,56,85,350,0.6888888888888889,1.0
45,30,40,105,50,20,290,0.031007751937984496,60,95,80,60,80,30,405,0.19480519480519481,1.0
70,85,70,60,70,50,405,0.28378378378378377,84,71,43,71,43,48,360,0.25874125874125875,1.0
90,100,90,125,85,90,580,0.7352941176470589,100,100,80,60,60,50,450,0.3050847457627119,2.0
55,55,45,63,45,45,308,0.25,78,130,111,130,85,100,634,0.8561151079136691,1.0
59,110,150,45,49,35,448,0.3333333333333333,59,74,50,35,50,35,303,0.3125,2.0
58,50,145,95,105,30,483,0.2459016393442623,50,53,48,53,48,64,316,0.46153846153846156,1.0
50,160,110,160,110,110,700,0.8854961832061069,50,50,95,40,50,35,320,0.20279720279720279,0.5
110,135,60,50,65,88,508,0.7744360902255639,61,90,45,50,50,160,456,0.9230769230769231,0.0
123,100,62,97,81,68,531,0.4806201550387597,77,85,51,55,51,65,384,0.5163934426229508,0.5
59,66,70,44,55,41,335,0.25190839694656486,60,75,85,100,85,115,520,0.8992248062015504,4.0
65,90,40,45,80,75,395,0.625,75,38,38,56,56,67,330,0.5263157894736842,1.0
80,110,60,150,130,70,600,0.5042016806722689,78,104,78,159,115,100,634,0.8444444444444444,1.0
45,95,50,40,50,75,355,0.54,105,150,90,150,90,95,680,0.8285714285714286,1.0
67,82,62,46,48,43,348,0.22033898305084745,70,70,115,130,90,60,535,0.5338983050847458,2.0
35,20,65,40,65,20,245,0.02459016393442623,65,110,130,60,65,95,525,0.8278145695364238,1.0
95,124,78,69,71,58,495,0.37398373983739835,60,55,145,75,150,40,525,0.2,4.0
75,80,70,65,75,90,455,0.7578125,60,60,40,65,45,35,305,0.15833333333333333,0.5
80,125,75,40,95,85,500,0.6911764705882353,45,75,37,70,55,83,365,0.6183206106870229,0.5
62,44,50,44,50,55,305,0.3629032258064516,85,120,70,50,60,100,485,0.8308823529411765,1.0
60,67,85,77,75,116,480,0.8888888888888888,40,55,99,40,79,47,360,0.26262626262626265,0.125
67,82,62,46,48,43,348,0.22033898305084745,75,90,50,110,80,95,500,0.7985611510791367,2.0
45,60,40,70,50,45,310,0.2846715328467153,80,80,50,40,50,25,325,0.176056338028169,1.0
45,22,60,27,30,29,213,0.07518796992481203,90,60,60,40,40,40,330,0.29545454545454547,1.0
45,75,60,40,30,50,300,0.304,45,60,30,80,50,65,330,0.4603174603174603,1.0
90,95,95,70,90,70,510,0.5230769230769231,85,105,55,85,50,115,495,0.9032258064516129,0.5
95,85,85,65,65,35,430,0.2571428571428571,95,23,48,23,48,23,260,0.046153846153846156,1.0
95,109,105,75,85,56,525,0.34513274336283184,91,90,106,130,106,77,600,0.648854961832061,1.0
106,110,90,154,90,130,680,0.926829268292683,95,145,130,120,90,120,700,0.9398496240601504,1.0
80,95,82,60,82,75,474,0.6,75,103,80,70,80,92,500,0.7933884297520661,2.0
70,84,70,65,70,51,410,0.2949640287769784,100,100,100,100,100,100,600,0.8805970149253731,1.0
103,60,126,80,126,50,545,0.36363636363636365,65,150,60,115,60,115,565,0.935251798561151,2.0
44,48,65,50,64,43,314,0.1623931623931624,70,150,140,65,100,75,600,0.55,1.0
59,45,40,35,40,31,250,0.14285714285714285,70,140,70,110,65,105,560,0.95,1.0
115,115,85,90,75,100,580,0.8134328358208955,60,40,50,75,85,95,405,0.6044776119402985,1.0
126,131,95,131,98,99,680,0.8102189781021898,60,65,70,85,75,40,395,0.21705426356589147,2.0
104,91,63,91,73,68,490,0.5118110236220472,100,100,100,100,100,100,600,0.8345864661654135,1.0
45,60,32,50,32,76,295,0.5925925925925926,50,150,50,150,50,150,600,0.9339622641509434,1.0
126,131,95,131,98,99,680,0.8294573643410853,77,120,90,60,90,48,485,0.2785714285714286,2.0
60,60,60,105,105,105,495,0.848,44,48,65,50,64,43,314,0.1623931623931624,1.0
45,60,45,25,45,55,275,0.29,100,150,90,180,160,90,770,0.7348484848484849,1.0
60,52,168,47,138,30,495,0.19834710743801653,60,62,80,63,80,60,405,0.4336283185840708,1.0
35,35,35,35,35,35,210,0.13385826771653545,85,105,85,40,50,40,405,0.211864406779661,1.0
90,30,15,40,20,15,210,0.043478260869565216,50,50,95,40,50,35,320,0.20279720279720279,1.0
70,95,85,55,65,70,440,0.5,95,65,110,60,130,65,525,0.5275590551181102,0.0
41,50,37,50,37,66,281,0.5175438596491229,100,180,160,150,90,90,770,0.7520661157024794,1.0
61,90,45,50,50,160,456,0.9230769230769231,79,103,120,135,115,78,630,0.5763888888888888,1.0
35,55,35,30,30,35,220,0.23684210526315788,70,75,80,135,80,135,575,0.917910447761194,1.0
75,98,63,98,63,101,498,0.889763779527559,70,110,180,60,60,50,530,0.4117647058823529,1.0
103,60,86,60,86,50,445,0.3458646616541353,50,100,150,100,150,50,600,0.37142857142857144,0.5
100,123,75,57,75,80,510,0.6923076923076923,70,95,85,55,65,70,440,0.5,0.25
45,35,50,70,50,30,280,0.15753424657534246,75,75,60,83,60,60,413,0.39344262295081966,2.0
110,135,60,50,65,88,508,0.7744360902255639,106,110,90,154,90,130,680,0.926829268292683,1.0
35,85,45,35,35,75,310,0.6492537313432836,35,80,50,50,70,120,405,0.84375,1.0
44,50,91,24,86,10,305,0.1981981981981982,90,75,85,115,90,55,510,0.3445378151260504,0.5
40,55,30,30,30,85,270,0.688,75,75,55,105,85,30,425,0.1619718309859155,2.0
55,20,35,20,45,75,250,0.37681159420289856,30,45,55,70,55,85,340,0.5633802816901409,1.0
43,80,65,50,35,35,308,0.14193548387096774,150,160,100,95,65,100,670,0.8866666666666667,1.0
65,63,45,45,45,45,308,0.2595419847328244,50,35,55,25,25,15,205,0.05263157894736842,2.0
40,55,80,35,60,30,300,0.15037593984962405,100,50,80,60,80,50,420,0.34375,0.25
60,150,50,150,50,60,520,0.5,30,45,55,70,55,85,340,0.5633802816901409,0.5
100,128,90,77,77,128,600,0.959349593495935,30,80,90,55,45,55,355,0.4295774647887324,1.0
55,85,122,58,75,99,494,0.8099173553719008,106,150,70,194,120,140,780,0.952,2.0
95,75,180,130,80,30,590,0.13793103448275862,160,110,65,65,110,30,540,0.35714285714285715,1.0
44,48,65,50,64,43,314,0.1623931623931624,85,105,85,40,50,40,405,0.211864406779661,1.0
60,65,60,130,75,110,500,0.7719298245614035,50,70,50,50,50,40,310,0.16296296296296298,1.0
79,115,70,125,80,111,580,0.864,75,125,75,30,75,85,465,0.625,2.0
50,65,90,35,35,15,290,0.14678899082568808,75,80,55,25,35,35,305,0.18666666666666668,0.5
70,20,50,20,50,40,250,0.1557377049180328,60,70,105,70,120,75,500,0.5983606557377049,2.0
55,130,115,50,50,75,475,0.5982142857142857,65,76,84,54,96,105,480,0.9008264462809917,1.0
114,85,70,85,80,30,464,0.2066115702479339,108,130,95,80,85,102,600,0.7637795275590551,0.5
108,170,115,120,95,92,700,0.7083333333333334,80,100,70,60,70,95,475,0.7416666666666667,0.5
50,75,75,65,65,50,380,0.4049586776859504,60,65,60,130,75,110,500,0.7719298245614035,4.0
55,45,45,25,25,15,210,0.048,74,94,131,54,116,20,489,0.4485294117647059,0.5
74,94,131,54,116,20,489,0.4485294117647059,59,66,70,44,55,41,335,0.25190839694656486,0.5
65,90,65,61,61,100,442,0.8373983739837398,80,80,80,80,80,80,480,0.5606060606060606,1.0
67,125,40,30,30,58,350,0.3431372549019608,50,85,85,55,55,50,380,0.3902439024390244,0.5
62,50,58,73,54,72,369,0.4435483870967742,100,100,100,100,100,100,600,0.8758169934640523,1.0
70,90,110,60,75,95,500,0.7333333333333333,40,45,40,65,40,65,295,0.5661764705882353,1.0
75,75,55,105,85,30,425,0.1619718309859155,60,48,45,43,90,42,328,0.21897810218978103,1.0
60,100,85,80,85,100,510,0.7007874015748031,76,48,48,57,62,34,325,0.11688311688311688,1.0
75,75,60,83,60,60,413,0.39344262295081966,50,50,40,50,40,64,294,0.45588235294117646,0.5
60,65,70,85,75,40,395,0.21705426356589147,55,55,55,85,55,30,335,0.1320754716981132,1.0
55,95,115,45,45,35,390,0.2116788321167883,60,85,60,85,60,55,405,0.3673469387755102,2.0
110,65,105,55,95,80,510,0.6258503401360545,125,130,90,130,90,95,660,0.7734375,1.0
65,90,120,85,70,60,490,0.43410852713178294,65,76,84,54,96,105,480,0.9008264462809917,1.0
68,90,65,50,55,82,410,0.6165413533834586,85,110,90,45,90,80,500,0.6206896551724138,1.0
60,50,50,60,70,50,340,0.28346456692913385,70,130,100,55,80,65,500,0.608,0.25
60,95,80,60,80,30,405,0.19480519480519481,75,80,85,110,90,50,490,0.3548387096774194,0.25
65,80,140,40,70,70,465,0.5223880597014925,42,52,67,39,56,50,306,0.2868217054263566,0.5
100,50,80,60,80,50,420,0.34375,67,57,55,77,55,114,425,0.8879310344827587,1.0
90,60,70,75,70,45,410,0.23880597014925373,70,77,60,97,60,108,472,0.8394160583941606,1.0
55,66,44,44,56,85,350,0.6888888888888889,82,121,119,69,59,71,521,0.5394736842105263,0.5
72,60,30,20,30,25,237,0.11570247933884298,75,95,95,95,95,85,540,0.6470588235294118,1.0
60,40,50,75,85,95,405,0.6044776119402985,75,98,63,98,63,101,498,0.8091603053435115,0.5
60,90,140,50,50,40,430,0.2535211267605634,76,25,45,67,55,24,292,0.0390625,1.0
75,55,70,55,95,110,460,0.8444444444444444,75,100,95,40,70,110,490,0.8717948717948718,1.0
91,90,129,90,72,108,580,0.9140625,45,20,50,60,120,50,345,0.24074074074074073,0.25
60,85,69,65,79,80,438,0.576,38,36,38,32,36,57,237,0.3893805309734513,1.0
59,45,40,35,40,31,250,0.14285714285714285,60,115,105,65,70,80,495,0.7181818181818181,0.5
70,60,70,87,78,85,450,0.6228070175438597,65,40,70,80,140,70,465,0.5954198473282443,1.0
105,95,80,40,80,90,490,0.753968253968254,60,48,45,43,90,42,328,0.21897810218978103,1.0
60,70,65,125,105,90,515,0.6911764705882353,60,45,70,45,90,95,405,0.7304964539007093,1.0
59,45,40,35,40,31,250,0.14285714285714285,50,50,120,80,80,30,410,0.07258064516129033,0.5
35,35,35,35,35,35,210,0.13385826771653545,90,50,34,60,44,70,348,0.6283185840707964,0.0
50,70,50,50,50,70,340,0.5645161290322581,58,64,58,80,65,80,405,0.609271523178808,2.0
65,65,65,50,50,90,385,0.72,60,59,85,79,105,36,424,0.16666666666666666,0.5
106,150,70,194,120,140,780,0.952,60,60,60,35,35,30,280,0.11194029850746269,1.0
57,80,91,80,87,75,470,0.5737704918032787,45,95,50,40,50,75,355,0.54,2.0
35,35,40,35,55,50,250,0.40336134453781514,59,74,50,35,50,35,303,0.3125,2.0
61,72,57,55,55,65,365,0.3984375,75,95,67,125,95,83,540,0.7117117117117117,1.0
100,134,110,95,100,61,600,0.4057971014492754,100,120,120,150,100,90,680,0.7880794701986755,0.5
65,130,60,95,110,65,525,0.5303030303030303,60,25,35,70,80,60,330,0.3076923076923077,1.0
60,40,50,75,85,95,405,0.6044776119402985,135,85,40,40,85,5,390,0.6864406779661016,1.0
70,55,95,95,110,65,490,0.48872180451127817,54,66,70,44,55,46,335,0.4214876033057851,1.0
45,25,50,25,25,35,205,0.13076923076923078,50,64,50,45,50,41,300,0.22727272727272727,0.25
70,85,70,60,70,50,405,0.28378378378378377,100,150,120,120,100,90,680,0.6493506493506493,1.0
60,82,45,45,45,74,351,0.5752212389380531,50,50,40,50,40,64,294,0.45588235294117646,1.0
60,60,40,65,45,35,305,0.15833333333333333,110,65,105,55,95,80,510,0.6258503401360545,0.0
95,125,79,60,100,81,540,0.6165413533834586,40,40,40,70,40,20,250,0.032520325203252036,2.0
55,63,90,50,80,42,380,0.21138211382113822,60,95,80,60,80,30,405,0.19480519480519481,0.5
45,50,55,75,65,30,320,0.06293706293706294,91,90,129,90,72,108,580,0.9140625,0.0
75,65,55,65,55,69,384,0.43548387096774194,55,50,45,135,95,120,500,0.7714285714285715,1.0
75,80,55,25,35,35,305,0.18666666666666668,54,66,70,44,55,46,335,0.4214876033057851,0.0
91,90,129,90,72,108,580,0.9140625,104,91,63,91,73,68,490,0.5118110236220472,2.0
100,150,140,100,90,90,670,0.7969924812030075,80,82,78,95,80,85,500,0.6869565217391305,1.0
40,45,40,62,60,60,307,0.33884297520661155,35,85,45,35,35,75,310,0.6492537313432836,1.0
54,78,103,53,45,22,355,0.23255813953488372,70,70,115,130,90,60,535,0.5338983050847458,0.5
250,5,5,35,105,50,450,0.15306122448979592,60,60,60,60,60,60,360,0.38095238095238093,1.0
78,52,60,63,65,23,341,0.06015037593984962,95,155,109,70,130,81,640,0.6788321167883211,2.0
44,75,35,63,33,45,295,0.2647058823529412,70,100,70,105,75,40,460,0.23214285714285715,1.0
45,35,45,62,53,35,275,0.11851851851851852,74,94,131,54,116,20,489,0.4485294117647059,0.25
65,70,60,65,65,115,440,0.8583333333333333,70,140,230,60,80,50,630,0.32432432432432434,0.5
75,105,75,105,75,45,480,0.3274336283185841,80,82,100,83,100,80,525,0.6821705426356589,0.5
30,45,135,45,90,30,375,0.09285714285714286,35,55,40,45,40,60,275,0.35714285714285715,1.0
79,85,60,55,60,71,410,0.60431654676259,55,40,50,65,85,40,335,0.3181818181818182,0.0
75,75,60,83,60,60,413,0.39344262295081966,60,100,115,70,85,90,520,0.7557251908396947,1.0
60,150,50,150,50,60,520,0.5,80,105,105,105,105,80,580,0.5939849624060151,2.0
65,125,100,55,70,85,500,0.6532258064516129,65,63,45,45,45,45,308,0.2595419847328244,0.5
50,65,107,105,107,86,520,0.703125,31,45,90,30,30,40,266,0.21929824561403508,0.0
110,130,80,70,60,80,530,0.5862068965517241,30,80,90,55,45,55,355,0.4295774647887324,1.0
78,52,60,63,65,23,341,0.06015037593984962,80,80,80,80,80,80,480,0.5606060606060606,1.0
55,85,122,58,75,99,494,0.8099173553719008,45,65,34,40,34,45,263,0.2589928057553957,1.0
81,102,77,85,75,85,505,0.5642857142857143,60,60,60,105,105,105,495,0.848,0.5
75,100,110,45,55,65,450,0.5333333333333333,70,85,140,85,70,20,470,0.272,2.0
65,40,70,80,140,70,465,0.5954198473282443,125,130,90,130,90,95,660,0.7734375,0.5
74,48,76,83,81,104,466,0.7913043478260869,54,66,70,44,55,46,335,0.4214876033057851,1.0
59,59,58,90,70,73,409,0.5826086956521739,77,85,51,55,51,65,384,0.5163934426229508,2.0
190,33,58,33,58,33,405,0.13432835820895522,75,123,67,95,85,95,540,0.7642276422764228,1.0
97,165,60,65,50,58,495,0.3902439024390244,90,85,100,95,125,85,580,0.6834532374100719,4.0
100,150,140,100,90,90,670,0.7969924812030075,64,66,68,81,76,50,405,0.25190839694656486,1.0
70,80,65,90,65,85,455,0.578125,92,105,90,125,90,98,600,0.8217054263565892,0.0
70,80,50,35,35,35,305,0.14,70,65,60,90,75,90,450,0.6571428571428571,0.25
90,50,34,60,44,70,348,0.6283185840707964,60,95,80,60,80,30,405,0.19480519480519481,4.0
60,59,85,79,105,36,424,0.16666666666666666,130,65,60,110,95,65,525,0.5227272727272727,2.0
62,55,52,109,94,109,481,0.7833333333333333,110,65,75,125,85,30,490,0.15,1.0
75,98,63,98,63,101,498,0.849624060150376,80,95,82,60,82,75,474,0.6,1.0
100,100,100,100,100,100,600,0.831858407079646,68,125,65,65,115,80,518,0.6277372262773723,0.5
73,76,75,81,100,100,505,0.8110236220472441,90,92,75,92,85,60,494,0.49586776859504134,4.0
78,65,68,112,154,75,552,0.628099173553719,60,80,95,70,85,50,440,0.2231404958677686,0.5
30,30,42,30,42,70,244,0.4230769230769231,80,70,40,100,60,145,495,0.921875,2.0
108,170,115,120,95,92,700,0.7083333333333334,75,100,95,40,70,110,490,0.8717948717948718,1.0
45,30,15,85,65,65,305,0.36220472440944884,91,72,90,129,90,108,580,0.8925619834710744,0.5
50,53,62,58,63,44,330,0.13709677419354838,76,65,45,92,42,91,411,0.7449664429530202,1.0
60,50,150,50,150,60,520,0.5206611570247934,35,55,40,50,50,90,320,0.6838235294117647,0.5
109,66,84,81,99,32,471,0.2013888888888889,60,95,80,60,80,30,405,0.19480519480519481,0.125
100,77,77,128,128,90,600,0.6901408450704225,79,100,80,110,90,121,580,0.968,1.0
70,130,100,55,80,65,500,0.608,55,95,115,45,45,35,390,0.2116788321167883,2.0
25,35,70,95,55,45,325,0.16783216783216784,45,30,35,20,20,45,195,0.14782608695652175,1.0
40,35,30,20,20,50,195,0.23423423423423423,1,90,45,30,30,40,236,0.33064516129032256,0.25
75,98,63,98,63,101,498,0.849624060150376,60,130,80,60,60,70,460,0.5153846153846153,0.5
65,125,100,55,70,85,500,0.6532258064516129,95,75,180,130,80,30,590,0.13793103448275862,2.0
64,115,65,83,63,65,455,0.5323741007194245,1,90,45,30,30,40,236,0.33064516129032256,2.0
36,50,50,65,60,44,305,0.16363636363636364,70,95,125,65,75,45,475,0.33613445378151263,1.0
45,50,35,55,75,40,300,0.21367521367521367,80,80,80,80,80,80,480,0.6015037593984962,1.0
73,115,60,60,60,90,458,0.6694915254237288,105,140,95,55,65,45,505,0.3,1.0
95,65,110,60,130,65,525,0.5275590551181102,60,62,80,63,80,60,405,0.4336283185840708,1.0
70,60,125,115,70,55,495,0.35507246376811596,85,100,122,58,75,54,494,0.3939393939393939,0.5
90,100,60,90,60,80,480,0.6422764227642277,75,95,95,95,95,85,540,0.6470588235294118,1.0
95,124,78,69,71,58,495,0.37398373983739835,55,65,35,60,30,85,330,0.6126126126126126,1.0
65,60,70,85,75,40,395,0.1796875,54,78,103,53,45,22,355,0.23255813953488372,0.5
90,100,60,90,60,80,480,0.6422764227642277,72,58,80,103,80,97,490,0.7171052631578947,1.0
40,35,30,20,20,50,195,0.23423423423423423,108,112,118,68,72,47,525,0.2916666666666667,0.5
60,60,60,35,35,30,280,0.11194029850746269,65,50,70,95,80,65,425,0.4262295081967213,1.0
60,60,50,40,50,75,335,0.5882352941176471,100,50,80,60,80,50,420,0.34375,2.0
100,73,83,73,83,55,467,0.371900826446281,40,45,40,35,35,56,251,0.373015873015873,1.0
75,98,63,98,63,101,498,0.889763779527559,60,60,60,105,105,105,495,0.848,1.0
89,145,90,105,80,91,600,0.8549618320610687,36,50,50,65,60,44,305,0.16363636363636364,1.0
100,77,77,128,128,90,600,0.6901408450704225,85,105,85,40,50,40,405,0.211864406779661,1.0
75,98,63,98,63,101,498,0.8091603053435115,40,65,95,60,45,35,340,0.13986013986013987,0.5
40,50,90,30,55,65,330,0.44680851063829785,75,95,60,65,60,115,470,0.8778625954198473,1.0
62,44,50,44,50,55,305,0.3629032258064516,78,104,78,159,115,100,634,0.8444444444444444,2.0
78,70,61,50,61,100,420,0.8145161290322581,70,130,100,55,80,65,500,0.608,0.5
55,40,85,80,105,40,405,0.23622047244094488,39,52,43,60,50,65,309,0.49107142857142855,0.5
60,50,150,50,150,60,520,0.5206611570247934,75,75,95,75,95,113,528,0.9015151515151515,1.0
80,135,130,95,90,70,600,0.5181818181818182,100,73,83,73,83,55,467,0.371900826446281,2.0
75,100,110,45,55,65,450,0.5333333333333333,90,95,105,165,110,45,610,0.2890625,2.0
115,140,130,55,55,40,535,0.4519230769230769,79,115,70,125,80,111,580,0.8468468468468469,0.0
80,80,80,55,55,90,440,0.6417910447761194,85,100,122,58,75,54,494,0.3939393939393939,0.0
54,78,103,53,45,22,355,0.23255813953488372,70,145,88,140,70,112,625,0.8888888888888888,0.25
62,73,55,56,52,84,382,0.7244094488188977,62,48,54,63,60,68,355,0.5178571428571429,1.0
50,85,40,85,40,35,335,0.1746031746031746,35,65,35,65,35,65,300,0.46621621621621623,2.0
70,80,70,80,70,110,480,0.6594202898550725,80,85,95,30,30,25,345,0.2857142857142857,2.0
70,115,60,115,60,55,475,0.4647887323943662,50,47,50,57,50,65,319,0.463768115942029,0.5
95,80,105,40,70,100,490,0.8046875,80,105,65,60,75,130,515,0.9645390070921985,0.5
46,87,60,30,40,57,320,0.37777777777777777,50,65,107,105,107,86,520,0.7272727272727273,1.0
55,70,55,40,55,85,360,0.7073170731707317,90,85,75,115,100,115,580,0.9381443298969072,1.0
66,41,77,61,87,23,355,0.12096774193548387,45,25,50,25,25,35,205,0.13076923076923078,0.5
70,84,70,65,70,51,410,0.2949640287769784,40,27,60,37,50,66,280,0.36220472440944884,0.5
55,69,85,32,35,28,304,0.09302325581395349,45,65,34,40,34,45,263,0.2589928057553957,1.0
60,80,110,50,80,45,425,0.2833333333333333,65,95,75,55,55,85,430,0.6933333333333334,2.0
82,121,119,69,59,71,521,0.5394736842105263,105,140,55,30,55,95,480,0.8195488721804511,2.0
40,40,35,50,100,70,335,0.5031847133757962,90,120,75,60,60,45,450,0.29411764705882354,2.0
38,35,40,27,25,35,200,0.08208955223880597,72,85,70,65,70,58,420,0.41304347826086957,2.0
123,100,62,97,81,68,531,0.4806201550387597,85,115,80,105,80,50,515,0.3063063063063063,1.0
95,80,105,40,70,100,490,0.8046875,150,160,100,95,65,100,670,0.8866666666666667,1.0
43,80,65,50,35,35,308,0.14193548387096774,85,76,64,45,55,90,415,0.6739130434782609,1.0
65,150,40,15,80,145,495,0.9663865546218487,40,45,35,30,40,55,245,0.3793103448275862,0.125
50,95,180,85,45,70,525,0.5298507462686567,78,65,68,112,154,75,552,0.628099173553719,1.0
35,55,40,50,50,90,320,0.6838235294117647,59,110,150,45,49,35,448,0.3333333333333333,1.0
60,90,70,60,120,40,440,0.27419354838709675,100,100,125,110,50,50,535,0.384,1.0
35,20,65,40,65,20,245,0.02459016393442623,60,60,40,65,45,35,305,0.15833333333333333,0.5
62,55,52,109,94,109,481,0.7833333333333333,95,23,48,23,48,23,260,0.046153846153846156,1.0
85,70,80,97,80,123,535,0.9304347826086956,130,85,80,85,95,60,535,0.43884892086330934,1.0
45,30,15,85,65,65,305,0.36220472440944884,30,35,30,100,35,80,310,0.4765625,2.0
95,75,180,130,80,30,590,0.13793103448275862,65,90,115,45,115,58,488,0.5041322314049587,0.0
70,92,65,80,55,98,460,0.8090909090909091,55,55,85,65,85,35,380,0.2014388489208633,1.0
28,25,25,45,35,40,198,0.16083916083916083,75,100,95,40,70,110,490,0.8717948717948718,1.0
65,90,65,61,61,100,442,0.8373983739837398,85,80,90,105,95,60,515,0.49074074074074076,1.0
100,180,160,150,90,90,770,0.7520661157024794,35,64,85,74,55,32,345,0.19827586206896552,0.5
55,104,105,94,75,52,485,0.36363636363636365,50,48,43,46,41,60,288,0.47297297297297297,1.0
70,130,100,55,80,65,500,0.608,80,80,50,40,50,25,325,0.176056338028169,0.5
85,50,95,120,115,80,545,0.5793650793650794,100,150,140,100,90,90,670,0.7969924812030075,1.0
80,80,80,80,80,80,480,0.6015037593984962,190,33,58,33,58,33,405,0.13432835820895522,1.0
75,140,65,112,65,110,567,0.9140625,95,125,79,60,100,81,540,0.6165413533834586,2.0
40,40,55,40,70,55,300,0.40939597315436244,71,73,88,120,89,59,500,0.43537414965986393,1.0
75,75,60,83,60,60,413,0.39344262295081966,65,105,60,60,70,95,455,63.0,1.0
100,75,115,90,115,85,580,0.6446280991735537,55,47,52,40,40,41,275,0.16806722689075632,1.0
100,75,115,90,115,85,580,0.6446280991735537,130,70,35,70,35,60,400,0.4017857142857143,0.5
150,100,120,100,120,90,680,0.6666666666666666,75,90,90,140,90,115,600,0.9481481481481482,0.5
70,60,125,115,70,55,495,0.35507246376811596,95,75,110,100,80,30,490,0.15267175572519084,0.5
80,120,130,55,65,45,495,0.37037037037037035,108,100,121,81,95,95,600,0.7476635514018691,0.5
68,165,95,65,115,110,618,0.8615384615384616,60,85,42,85,42,91,405,0.8227848101265823,0.0
60,85,49,60,49,60,363,0.4444444444444444,95,60,79,100,125,81,540,0.6201550387596899,2.0
100,150,120,120,100,90,680,0.6493506493506493,95,60,79,100,125,81,540,0.6201550387596899,2.0
75,70,90,70,105,80,490,0.656,70,94,50,94,50,66,424,0.48148148148148145,2.0
75,75,130,75,130,95,580,0.7479674796747967,30,45,55,70,55,85,340,0.5633802816901409,1.0
50,50,77,95,77,91,440,0.5916666666666667,67,82,62,46,48,43,348,0.22033898305084745,1.0
114,85,70,85,80,30,464,0.2066115702479339,70,75,80,135,80,135,575,0.917910447761194,1.0
60,62,80,63,80,60,405,0.4336283185840708,65,65,60,110,95,130,525,0.9253731343283582,1.0
55,20,35,20,45,75,250,0.37681159420289856,67,58,57,81,67,101,431,0.8790322580645161,1.0
45,20,50,60,120,50,345,0.24074074074074073,92,105,90,125,90,98,600,0.8217054263565892,0.5
65,75,70,95,70,95,470,0.7272727272727273,89,124,80,55,80,55,483,0.5714285714285714,2.0
67,82,62,46,48,43,348,0.22033898305084745,90,92,75,92,85,60,494,0.49586776859504134,2.0
60,70,50,100,50,65,395,0.5217391304347826,75,75,130,75,130,95,580,0.7479674796747967,2.0
90,95,95,70,90,70,510,0.5230769230769231,35,35,40,35,55,50,250,0.40336134453781514,0.25
35,20,65,40,65,20,245,0.02459016393442623,55,66,44,44,56,85,350,0.6888888888888889,1.0
40,55,30,30,30,60,245,0.43548387096774194,65,60,70,85,75,40,395,0.1796875,1.0
60,80,50,40,40,30,300,0.15328467153284672,90,95,95,70,90,70,510,0.5230769230769231,2.0
83,80,80,135,80,121,579,0.9444444444444444,50,53,62,58,63,44,330,0.13709677419354838,1.0
40,30,32,50,52,65,269,0.3671875,50,60,45,100,80,65,400,0.45689655172413796,0.5
55,95,115,45,45,35,390,0.2116788321167883,76,104,71,104,71,108,534,0.912751677852349,2.0
100,100,100,100,100,100,600,0.831858407079646,65,45,55,45,70,45,325,0.24369747899159663,1.0
35,65,35,65,35,65,300,0.46621621621621623,54,66,70,44,55,46,335,0.4214876033057851,0.5
40,45,35,40,40,90,290,0.65,54,66,70,44,55,46,335,0.4214876033057851,0.0
70,140,70,110,65,105,560,0.95,90,100,90,125,85,90,580,0.7352941176470589,2.0
70,45,48,60,65,35,323,0.15748031496062992,67,125,40,30,30,58,350,0.3431372549019608,1.0
45,30,35,20,20,45,195,0.14782608695652175,50,55,50,36,30,43,264,0.2922077922077922,0.5
50,105,125,55,95,50,480,0.375886524822695,70,110,75,145,85,145,630,0.9444444444444444,2.0
30,30,30,30,30,30,180,0.12612612612612611,90,70,80,70,95,70,475,0.5190839694656488,2.0
50,95,95,35,110,70,455,0.5179856115107914,84,71,43,71,43,48,360,0.25874125874125875,2.0
70,55,65,95,85,70,440,0.5307692307692308,95,135,80,110,80,100,600,0.8248175182481752,2.0
95,80,105,40,70,100,490,0.8046875,250,5,5,35,105,50,450,0.15306122448979592,1.0
67,125,40,30,30,58,350,0.3431372549019608,59,59,58,90,70,73,409,0.5826086956521739,2.0
38,35,40,27,25,35,200,0.08208955223880597,50,65,107,105,107,86,520,0.7313432835820896,2.0
50,65,45,85,65,95,405,0.7238095238095238,53,51,53,61,56,40,314,0.14285714285714285,2.0
105,125,100,60,100,100,590,0.8359375,40,60,40,40,40,30,250,0.0948905109489051,1.0
90,93,55,70,55,55,418,0.3819444444444444,70,120,100,145,105,20,560,0.2824427480916031,0.5
80,120,130,55,65,45,495,0.37037037037037035,45,50,43,40,38,62,278,0.40441176470588236,0.0
80,185,115,40,105,75,600,0.6230769230769231,60,30,30,36,56,50,262,0.32432432432432434,0.5
75,125,75,30,75,85,465,0.625,50,65,107,105,107,86,520,0.7758620689655172,1.0
40,27,60,37,50,66,280,0.36220472440944884,58,109,112,48,48,109,484,0.8805970149253731,0.125
60,79,105,59,85,36,424,0.17054263565891473,55,65,95,95,45,85,440,0.6610169491525424,1.0
59,110,150,45,49,35,448,0.3333333333333333,150,160,100,95,65,100,670,0.8866666666666667,0.0
70,65,65,55,55,70,380,0.5,50,53,48,53,48,64,316,0.4076923076923077,1.0
90,100,70,110,150,80,600,0.6037735849056604,90,50,34,60,44,70,348,0.6283185840707964,1.0
40,55,30,30,30,60,245,0.43548387096774194,110,65,75,125,85,30,490,0.15,1.0
40,50,90,30,55,65,330,0.44680851063829785,70,95,125,65,75,45,475,0.33613445378151263,0.5
110,130,80,70,60,80,530,0.5862068965517241,85,105,100,79,83,78,530,0.5869565217391305,0.5
75,80,85,110,90,50,490,0.3548387096774194,65,150,40,15,80,145,495,0.9663865546218487,0.125
50,47,50,57,50,65,319,0.463768115942029,60,70,105,70,120,75,500,0.5983606557377049,0.0
100,73,83,73,83,55,467,0.371900826446281,80,52,50,90,50,89,411,0.6666666666666666,1.0
100,110,90,85,90,60,535,0.47794117647058826,50,70,100,40,40,30,330,0.2222222222222222,8.0
110,123,65,100,65,65,528,0.5217391304347826,75,95,67,125,95,83,540,0.7117117117117117,0.5
90,110,80,100,80,95,555,0.7982456140350878,70,100,115,30,65,30,410,0.24390243902439024,0.5
110,135,60,50,65,88,508,0.7744360902255639,57,80,91,80,87,75,470,0.5737704918032787,0.5
64,165,75,93,83,75,555,0.6587301587301587,70,84,70,65,70,51,410,0.2949640287769784,1.0
62,44,50,44,50,55,305,0.3629032258064516,80,120,70,110,70,80,530,0.6422764227642277,4.0
71,95,85,110,95,79,535,0.664,45,30,50,65,50,45,285,0.13821138211382114,1.0
65,95,100,60,50,50,420,0.34959349593495936,90,130,80,65,85,55,505,0.4396551724137931,1.0
35,55,40,45,40,60,275,0.35714285714285715,79,103,120,135,115,78,630,0.5763888888888888,2.0
75,105,75,105,75,45,480,0.3274336283185841,38,36,38,32,36,57,237,0.3893805309734513,1.0
40,55,30,30,30,85,270,0.688,90,120,100,150,120,100,680,0.7718120805369127,1.0
60,85,49,60,49,60,363,0.4444444444444444,80,100,70,50,60,45,405,0.25806451612903225,1.0
45,35,50,70,50,30,280,0.15753424657534246,50,72,35,35,35,65,292,0.5373134328358209,2.0
80,70,65,80,120,100,515,0.8034188034188035,40,40,50,30,30,30,220,0.0873015873015873,1.0
91,90,106,130,106,77,600,0.648854961832061,1,90,45,30,30,40,236,0.33064516129032256,2.0
55,20,35,20,45,75,250,0.37681159420289856,65,150,60,115,60,115,565,0.935251798561151,1.0
125,120,90,170,100,95,700,0.78125,50,70,100,40,40,30,330,0.2222222222222222,0.25
45,35,45,62,53,35,275,0.11851851851851852,110,130,80,70,60,80,530,0.5862068965517241,2.0
40,80,100,30,30,20,300,0.11851851851851852,54,45,47,75,98,52,371,0.39669421487603307,1.0
100,164,150,95,120,71,700,0.5645161290322581,40,27,60,37,50,66,280,0.36220472440944884,0.5
90,95,105,165,110,45,610,0.2890625,55,40,85,80,105,40,405,0.23622047244094488,0.0
60,60,40,65,45,35,305,0.15833333333333333,100,90,130,45,65,55,485,0.4253731343283582,0.5
78,65,68,112,154,75,552,0.628099173553719,50,85,125,85,115,20,480,0.4306569343065693,2.0
55,70,55,40,55,85,360,0.7073170731707317,65,65,65,50,50,90,385,0.72,1.0
55,75,50,40,40,80,340,0.6302521008403361,38,41,40,50,65,65,299,0.4108527131782946,1.0
86,76,86,116,56,95,515,0.7982456140350878,20,15,20,10,55,80,200,0.2682926829268293,1.0
85,70,80,97,80,123,535,0.9304347826086956,75,80,70,65,75,90,455,0.7578125,1.0
125,170,100,120,90,95,700,0.77,50,48,43,46,41,60,288,0.47297297297297297,1.0
75,75,130,75,130,95,580,0.7479674796747967,54,66,70,44,55,46,335,0.4214876033057851,1.0
40,50,90,30,55,65,330,0.44680851063829785,62,48,66,59,57,49,341,0.33884297520661155,1.0
55,95,55,35,75,115,430,0.9380530973451328,110,65,105,55,95,80,510,0.6258503401360545,1.0
40,30,50,55,55,100,330,0.584070796460177,100,90,130,45,65,55,485,0.4253731343283582,2.0
100,150,120,120,100,90,680,0.6493506493506493,65,150,60,115,60,115,565,0.935251798561151,1.0
45,30,40,105,50,20,290,0.031007751937984496,95,23,48,23,48,23,260,0.046153846153846156,0.5
65,90,115,45,115,58,488,0.5041322314049587,85,70,80,97,80,123,535,0.9304347826086956,0.5
72,60,30,20,30,25,237,0.11570247933884298,62,73,55,56,52,84,382,0.7244094488188977,0.5
20,10,55,15,20,80,200,0.17985611510791366,89,124,80,55,80,55,483,0.5714285714285714,2.0
100,100,100,100,100,100,600,0.8778625954198473,60,50,70,80,80,140,480,0.8449612403100775,1.0
105,140,55,30,55,95,480,0.8195488721804511,40,40,55,40,70,55,300,0.40939597315436244,1.0
111,83,68,92,82,39,475,0.1774193548387097,70,120,40,95,40,95,460,0.8106060606060606,0.5
76,104,71,104,71,108,534,0.912751677852349,65,155,120,65,90,105,600,0.8677685950413223,0.5
55,63,90,50,80,42,380,0.21138211382113822,70,120,100,145,105,20,560,0.2824427480916031,0.5
30,45,55,70,55,85,340,0.5633802816901409,70,110,180,60,60,50,530,0.4117647058823529,2.0
50,95,90,95,90,180,600,0.9172413793103448,63,120,85,90,55,55,468,0.2809917355371901,0.0
100,100,125,110,50,50,535,0.384,62,77,62,50,42,65,358,0.4838709677419355,0.5
70,110,180,60,60,50,530,0.4117647058823529,50,65,107,105,107,86,520,0.7313432835820896,0.5
45,45,35,20,30,20,195,0.07246376811594203,58,64,58,80,65,80,405,0.5423728813559322,0.5
95,65,65,110,130,60,525,0.4016393442622951,65,125,100,60,70,70,490,0.6099290780141844,1.0
60,82,45,45,45,74,351,0.5752212389380531,35,20,65,40,65,20,245,0.02459016393442623,0.5
71,82,64,64,59,112,452,0.9327731092436975,50,120,53,35,110,87,455,0.640625,1.0
40,20,30,40,80,55,265,0.22764227642276422,65,85,70,75,70,40,405,0.203125,0.5
45,35,50,70,50,30,280,0.15753424657534246,75,125,75,30,75,85,465,0.625,1.0
75,98,63,98,63,101,498,0.889763779527559,25,20,15,105,55,90,310,0.32407407407407407,1.0
105,105,75,65,100,50,500,0.37593984962406013,51,65,65,80,75,59,395,0.4365079365079365,1.0
50,50,120,80,80,30,410,0.07258064516129033,100,134,110,95,100,61,600,0.4057971014492754,0.5
50,65,107,105,107,86,520,0.7272727272727273,55,130,115,50,50,75,475,0.5982142857142857,2.0
80,45,65,90,110,80,470,0.5462962962962963,70,110,75,145,85,145,630,0.9444444444444444,1.0
50,70,50,50,50,70,340,0.5645161290322581,90,95,105,165,110,45,610,0.2890625,4.0
30,35,30,100,35,80,310,0.4765625,75,95,60,65,60,115,470,0.8778625954198473,0.0
70,95,85,55,65,70,440,0.5,40,45,40,35,35,56,251,0.373015873015873,2.0
108,170,115,120,95,92,700,0.7083333333333334,70,120,100,145,105,20,560,0.2824427480916031,2.0
65,90,122,58,75,84,494,0.71875,75,80,70,65,75,90,455,0.7578125,0.25
35,65,35,65,35,65,300,0.46621621621621623,70,80,65,90,65,85,455,0.578125,1.0
75,140,65,112,65,110,567,0.9140625,70,60,70,87,78,85,450,0.6228070175438597,2.0
70,92,65,80,55,98,460,0.8090909090909091,65,110,130,60,65,95,525,0.8278145695364238,0.5
70,77,60,97,60,108,472,0.8394160583941606,106,90,130,90,154,110,680,0.8699186991869918,2.0
70,65,65,55,55,70,380,0.5,95,117,184,44,46,28,514,0.2975206611570248,1.0
55,40,85,80,105,40,405,0.23622047244094488,75,80,70,65,75,90,455,0.7578125,0.5
40,40,35,50,100,70,335,0.5031847133757962,38,35,35,65,55,50,278,0.2647058823529412,2.0
80,70,70,90,100,70,480,0.5609756097560976,30,35,30,100,35,80,310,0.4765625,0.5
70,85,140,85,70,20,470,0.272,90,132,105,132,105,30,594,0.4246575342465753,4.0
95,155,109,70,130,81,640,0.6788321167883211,65,95,75,55,55,85,430,0.6933333333333334,0.5
56,61,65,48,45,38,313,0.17567567567567569,75,75,75,125,95,40,485,0.15671641791044777,1.0
76,65,45,92,42,91,411,0.7449664429530202,79,85,60,55,60,71,410,0.60431654676259,1.0
65,136,94,54,96,135,580,0.9612403100775194,91,90,72,90,129,108,580,0.896,1.0
125,170,100,120,90,95,700,0.77,80,100,70,50,60,45,405,0.25806451612903225,1.0
86,76,86,116,56,95,515,0.7982456140350878,50,50,150,50,150,50,500,0.2571428571428571,0.25
105,150,90,150,90,95,680,0.8285714285714286,68,72,78,38,42,32,330,0.23809523809523808,1.0
130,70,35,70,35,60,400,0.4017857142857143,100,100,100,100,100,100,600,0.8602941176470589,0.5
105,95,80,40,80,90,490,0.753968253968254,80,105,65,60,75,130,515,0.9645390070921985,0.5
70,94,50,94,50,66,424,0.48148148148148145,110,160,110,80,110,100,670,0.8591549295774648,1.0
80,100,123,122,120,80,625,0.56,50,160,110,160,110,110,700,0.8854961832061069,2.0
50,70,100,40,40,30,330,0.2222222222222222,190,33,58,33,58,33,405,0.13432835820895522,1.0
55,50,45,135,95,120,500,0.7714285714285715,60,70,50,100,50,65,395,0.5217391304347826,1.0
60,45,50,90,80,70,395,0.625,50,50,120,80,80,30,410,0.07258064516129033,0.25
40,35,30,120,70,105,400,0.6692307692307692,62,55,52,109,94,109,481,0.7833333333333333,1.0
65,47,55,73,75,85,400,0.65,76,104,71,104,71,108,534,0.912751677852349,0.25
40,40,55,40,70,55,300,0.40939597315436244,81,102,77,85,75,85,505,0.5642857142857143,8.0
50,20,40,20,40,20,190,0.0962962962962963,75,38,38,56,56,67,330,0.5263157894736842,1.0
50,50,40,50,40,64,294,0.45588235294117646,55,75,60,75,60,103,428,0.7982456140350878,1.0
95,124,78,69,71,58,495,0.37398373983739835,70,55,95,95,110,65,490,0.48872180451127817,1.0
51,65,65,80,75,59,395,0.4365079365079365,55,104,105,94,75,52,485,0.36363636363636365,0.5
105,140,55,30,55,95,480,0.8195488721804511,80,70,40,100,60,145,495,0.921875,2.0
52,65,55,58,62,60,352,0.4482758620689655,43,70,48,50,60,38,309,0.2391304347826087,0.0
75,90,50,110,80,95,500,0.7985611510791367,65,90,65,61,61,100,442,0.8373983739837398,1.0
40,40,50,30,30,30,220,0.0873015873015873,55,75,50,40,40,80,340,0.6302521008403361,0.5
72,95,67,103,71,122,530,0.9606299212598425,63,120,85,90,55,55,468,0.2809917355371901,0.25
30,42,118,42,88,30,350,0.112,90,50,34,60,44,70,348,0.6283185840707964,2.0
40,30,30,55,30,85,270,0.4666666666666667,85,50,95,120,115,80,545,0.5793650793650794,1.0
65,95,57,100,85,93,495,0.7441860465116279,85,90,80,70,80,130,535,0.9262295081967213,1.0
20,40,90,30,90,25,295,0.11363636363636363,160,110,65,65,110,30,540,0.35714285714285715,0.0
108,112,118,68,72,47,525,0.2916666666666667,79,115,70,125,80,111,580,0.8468468468468469,0.0
71,73,88,120,89,59,500,0.43537414965986393,80,100,200,50,100,50,580,0.3472222222222222,2.0
79,100,80,110,90,121,580,0.968,100,50,50,76,96,70,442,0.5,1.0
1,90,45,30,30,40,236,0.33064516129032256,40,65,40,80,40,65,330,0.5038167938931297,1.0
40,27,60,37,50,66,280,0.36220472440944884,50,55,50,36,30,43,264,0.2922077922077922,0.5
81,102,77,85,75,85,505,0.5642857142857143,50,150,50,150,50,150,600,0.9339622641509434,1.0
90,60,70,75,70,45,410,0.23880597014925373,70,94,50,94,50,66,424,0.48148148148148145,2.0
50,50,62,40,62,65,329,0.4188034188034188,90,70,80,70,95,70,475,0.5190839694656488,1.0
55,50,40,40,40,75,300,0.5945945945945946,109,66,84,81,99,32,471,0.2013888888888889,1.0
67,58,57,81,67,101,431,0.8790322580645161,80,80,80,55,55,90,440,0.6417910447761194,1.0
71,95,85,110,95,79,535,0.664,78,84,78,109,85,100,534,0.8646616541353384,1.0
65,65,60,130,95,110,525,0.823943661971831,45,90,20,65,20,65,305,0.5116279069767442,0.0
39,52,43,60,50,65,309,0.49107142857142855,90,55,75,60,75,30,385,0.13970588235294118,1.0
72,105,115,54,86,68,500,0.5149253731343284,55,75,60,75,60,103,428,0.7982456140350878,2.0
55,47,52,40,40,41,275,0.16806722689075632,80,90,80,130,110,110,600,0.856,1.0
70,100,70,105,75,40,460,0.23214285714285715,65,70,60,65,65,115,440,0.8583333333333333,1.0
50,95,180,85,45,70,525,0.5298507462686567,80,92,65,65,80,68,450,0.4824561403508772,0.25
75,75,55,105,85,30,425,0.1619718309859155,65,125,100,55,70,85,500,0.6532258064516129,0.5
67,82,62,46,48,43,348,0.22033898305084745,68,125,65,65,115,80,518,0.6277372262773723,0.5
68,165,95,65,115,110,618,0.8615384615384616,30,30,42,30,42,70,244,0.4230769230769231,0.25
70,70,115,130,90,60,535,0.5338983050847458,49,66,70,44,55,51,335,0.4260869565217391,0.5
38,30,41,30,41,60,240,0.2897196261682243,45,60,30,80,50,65,330,0.4603174603174603,1.0
50,65,45,85,65,95,405,0.7238095238095238,40,65,95,60,45,35,340,0.13986013986013987,0.5
65,75,90,97,123,44,494,0.1987179487179487,55,75,60,75,60,103,428,0.7982456140350878,1.0
50,70,50,50,50,70,340,0.5645161290322581,70,80,50,35,35,35,305,0.14,1.0
70,140,230,60,80,50,630,0.32432432432432434,70,20,50,20,50,40,250,0.1557377049180328,0.25
108,170,115,120,95,92,700,0.7083333333333334,95,117,80,65,70,92,519,0.8409090909090909,1.0
60,65,70,85,75,40,395,0.21705426356589147,70,110,70,115,70,90,525,0.75,0.0
58,109,112,48,48,109,484,0.8805970149253731,65,80,65,35,65,60,370,0.38405797101449274,1.0
50,53,48,53,48,64,316,0.4076923076923077,50,65,85,35,35,55,325,0.32575757575757575,1.0
65,90,65,61,61,100,442,0.8373983739837398,50,72,35,35,35,65,292,0.5373134328358209,1.0
70,70,70,70,70,70,420,0.5289256198347108,65,83,57,95,85,105,490,0.8914728682170543,1.0
50,50,77,95,77,91,440,0.5916666666666667,65,90,120,85,70,60,490,0.43410852713178294,1.0
80,110,60,150,130,70,600,0.5042016806722689,110,78,73,76,71,60,468,0.3333333333333333,2.0
84,86,88,111,101,60,530,0.4634146341463415,92,105,90,125,90,98,600,0.8217054263565892,0.5
90,100,90,125,85,90,580,0.7352941176470589,85,135,130,60,80,25,515,0.40540540540540543,0.25
50,75,35,70,30,40,300,0.21296296296296297,85,115,80,105,80,50,515,0.3063063063063063,1.0
53,54,53,37,46,45,288,0.3090909090909091,55,75,50,40,40,80,340,0.6302521008403361,1.0
80,85,95,30,30,25,345,0.2857142857142857,67,58,57,81,67,101,431,0.8790322580645161,2.0
35,35,40,35,55,50,250,0.40336134453781514,65,55,115,100,40,60,435,0.3798449612403101,1.0
45,45,55,45,55,63,308,0.4594594594594595,50,85,85,55,55,50,380,0.3902439024390244,0.5
55,65,35,60,30,85,330,0.6126126126126126,100,90,130,45,65,55,485,0.4253731343283582,1.0
74,94,131,54,116,20,489,0.4485294117647059,100,75,115,90,115,85,580,0.6446280991735537,1.0
56,61,65,48,45,38,313,0.17567567567567569,45,85,70,40,40,60,340,0.5229357798165137,0.5
75,95,125,45,75,95,510,0.8257575757575758,90,60,70,75,70,45,410,0.23880597014925373,1.0
85,110,76,65,82,56,474,0.3933333333333333,55,95,115,45,45,35,390,0.2116788321167883,4.0
20,40,90,30,90,25,295,0.11363636363636363,75,95,125,45,75,95,510,0.8257575757575758,1.0
40,55,80,35,60,30,300,0.15037593984962405,70,60,125,115,70,55,495,0.35507246376811596,1.0
80,70,40,100,60,145,495,0.921875,72,95,67,103,71,122,530,0.9606299212598425,2.0
65,76,84,54,96,105,480,0.9008264462809917,65,90,50,85,45,55,390,0.371900826446281,1.0
66,41,77,61,87,23,355,0.12096774193548387,50,30,55,65,55,20,275,0.13675213675213677,1.0
40,45,35,30,40,55,245,0.3793103448275862,68,85,65,165,135,100,618,0.8083333333333333,2.0
90,132,105,132,105,30,594,0.4246575342465753,95,109,105,75,85,56,525,0.34513274336283184,4.0
95,95,85,125,65,55,520,0.3894736842105263,105,140,95,55,65,45,505,0.3,1.0
53,54,53,37,46,45,288,0.3090909090909091,75,95,67,125,95,83,540,0.7117117117117117,1.0
35,45,160,30,45,70,385,0.48148148148148145,50,70,160,70,160,90,600,0.7417218543046358,1.0
80,80,80,80,80,80,480,0.5606060606060606,95,117,80,65,70,92,519,0.8409090909090909,2.0
84,71,43,71,43,48,360,0.25874125874125875,72,95,67,103,71,122,530,0.9606299212598425,1.0
54,78,103,53,45,22,355,0.23255813953488372,50,75,45,40,45,60,315,0.4380165289256198,2.0
65,85,70,75,70,40,405,0.203125,30,35,30,100,35,80,310,0.4765625,1.0
55,95,55,35,75,115,430,0.9380530973451328,45,67,60,35,50,63,320,0.5128205128205128,0.5
70,40,50,55,50,25,290,0.061068702290076333,110,65,75,125,85,30,490,0.15,1.0
77,59,50,67,63,46,362,0.23140495867768596,85,105,100,79,83,78,530,0.5869565217391305,0.5
50,65,107,105,107,86,520,0.703125,100,70,70,65,65,45,415,0.1897810218978102,1.0
74,94,131,54,116,20,489,0.4485294117647059,100,50,50,76,96,70,442,0.5,0.5
38,35,35,65,55,50,278,0.2647058823529412,100,103,75,120,75,127,600,0.940677966101695,1.0
95,155,109,70,130,81,640,0.6788321167883211,70,55,75,45,65,60,370,0.45901639344262296,0.5
91,90,106,130,106,77,600,0.648854961832061,250,5,5,35,105,50,450,0.15306122448979592,1.0
97,165,60,65,50,58,495,0.3902439024390244,105,140,55,30,55,95,480,0.8195488721804511,2.0
95,70,73,95,90,60,483,0.3983739837398374,71,120,95,120,95,99,600,0.8203125,0.5
95,95,85,125,65,55,520,0.3894736842105263,70,77,60,97,60,108,472,0.8394160583941606,0.5
85,90,80,70,80,130,535,0.9262295081967213,40,65,95,60,45,35,340,0.13986013986013987,0.5
76,65,45,92,42,91,411,0.7449664429530202,64,51,23,51,23,28,240,0.11363636363636363,1.0
50,45,45,35,35,50,260,0.23529411764705882,50,75,35,70,30,40,300,0.21296296296296297,1.0
50,20,55,25,25,30,205,0.09774436090225563,60,85,60,85,60,55,405,0.3673469387755102,0.25
80,115,80,65,55,93,488,0.7846153846153846,79,100,80,110,90,121,580,0.968,1.0
110,65,75,125,85,30,490,0.15,45,45,55,45,55,63,308,0.4594594594594595,1.0
95,65,65,110,130,60,525,0.4016393442622951,75,69,72,114,100,104,534,0.8253968253968254,0.5
60,59,85,79,105,36,424,0.16666666666666666,60,82,45,45,45,74,351,0.5752212389380531,4.0
60,67,85,77,75,116,480,0.8888888888888888,45,60,45,25,45,55,275,0.29,1.0
95,65,65,110,130,60,525,0.4016393442622951,50,53,48,53,48,64,316,0.4076923076923077,1.0
67,57,55,77,55,114,425,0.8879310344827587,120,100,85,30,85,45,465,0.22448979591836735,2.0
38,35,40,27,25,35,200,0.08208955223880597,100,103,75,120,75,127,600,0.940677966101695,1.0
50,95,95,35,110,70,455,0.5179856115107914,55,45,45,25,25,15,210,0.048,1.0
43,70,48,50,60,38,309,0.2391304347826087,55,55,45,63,45,45,308,0.25,2.0
65,125,100,55,70,85,500,0.6532258064516129,65,75,105,35,65,85,430,0.6940298507462687,0.5
70,110,180,60,60,50,530,0.4117647058823529,65,105,60,60,70,95,455,63.0,0.5
50,180,20,180,20,150,600,0.9029850746268657,66,117,70,40,50,67,410,0.4573643410852713,1.0
90,60,60,40,40,40,330,0.29545454545454547,95,145,130,120,90,120,700,0.9398496240601504,0.0
95,80,105,40,70,100,490,0.8046875,54,66,70,44,55,46,335,0.4214876033057851,0.0
62,77,62,50,42,65,358,0.4838709677419355,83,106,65,86,65,85,490,0.6640625,2.0
95,117,80,65,70,92,519,0.8409090909090909,80,120,79,95,79,70,523,0.5833333333333334,2.0
75,123,67,95,85,95,540,0.7642276422764228,39,52,43,60,50,65,309,0.5041322314049587,1.0
90,75,75,90,100,70,500,0.5462184873949579,70,120,40,95,40,95,460,0.8106060606060606,0.5
38,35,40,27,25,35,200,0.08208955223880597,50,65,107,105,107,86,520,0.7272727272727273,0.5
75,90,90,140,90,115,600,0.9481481481481482,72,85,70,65,70,58,420,0.41304347826086957,0.25
46,87,60,30,40,57,320,0.37777777777777777,108,130,95,80,85,102,600,0.7637795275590551,2.0
60,85,42,85,42,91,405,0.8227848101265823,45,50,43,40,38,62,278,0.40441176470588236,1.0
30,40,70,70,25,60,295,0.41353383458646614,10,55,25,35,45,95,265,0.5396825396825397,2.0
45,30,15,85,65,65,305,0.36220472440944884,90,60,60,40,40,40,330,0.29545454545454547,4.0
50,75,35,70,30,40,300,0.21296296296296297,105,150,90,150,90,95,680,0.8285714285714286,0.25
71,73,88,120,89,59,500,0.43537414965986393,70,90,110,60,75,95,500,0.7333333333333333,1.0
59,59,58,90,70,73,409,0.5826086956521739,100,120,120,150,100,90,680,0.7880794701986755,1.0
78,84,78,109,85,100,534,0.8646616541353384,40,65,95,60,45,35,340,0.13986013986013987,1.0
75,80,95,90,100,50,490,0.2158273381294964,80,110,60,150,130,70,600,0.5042016806722689,1.0
80,100,70,50,60,45,405,0.25806451612903225,100,150,140,100,90,90,670,0.7969924812030075,1.0
45,40,60,40,75,50,310,0.2926829268292683,70,40,50,55,50,25,290,0.061068702290076333,1.0
45,40,60,40,75,50,310,0.2926829268292683,38,30,85,55,65,30,303,0.21428571428571427,0.0
42,52,67,39,56,50,306,0.2868217054263566,58,89,77,45,45,48,362,0.3177570093457944,1.0
65,45,55,45,70,45,325,0.24369747899159663,50,60,45,100,80,65,400,0.45689655172413796,0.5
41,64,45,50,50,50,300,0.36752136752136755,114,85,70,85,80,30,464,0.2066115702479339,1.0
50,100,150,100,150,50,600,0.37142857142857144,82,121,119,69,59,71,521,0.5394736842105263,2.0
50,105,79,35,110,76,455,0.6214285714285714,58,70,45,40,45,42,300,0.25925925925925924,1.0
85,105,100,79,83,78,530,0.5869565217391305,111,83,68,92,82,39,475,0.1774193548387097,1.0
50,50,120,80,80,30,410,0.07258064516129033,60,40,60,40,60,35,295,0.18055555555555555,2.0
60,90,140,50,50,40,430,0.2535211267605634,65,90,115,45,115,58,488,0.5041322314049587,0.5
50,50,95,40,50,35,320,0.20279720279720279,62,44,50,44,50,55,305,0.3629032258064516,0.0
50,160,110,160,110,110,700,0.8854961832061069,70,90,110,60,75,95,500,0.7333333333333333,1.0
75,70,90,70,105,80,490,0.656,90,120,75,60,60,45,450,0.29411764705882354,0.0
80,100,123,122,120,80,625,0.56,75,55,70,55,95,110,460,0.8444444444444444,0.5
40,40,55,40,70,55,300,0.40939597315436244,60,65,70,85,75,40,395,0.21705426356589147,2.0
70,85,140,85,70,20,470,0.272,65,90,120,85,70,60,490,0.43410852713178294,1.0
65,47,55,73,75,85,400,0.65,65,105,60,60,70,95,455,63.0,0.5
60,85,60,85,60,55,405,0.3673469387755102,55,75,60,75,60,103,428,0.7982456140350878,0.5
30,30,42,30,42,70,244,0.4230769230769231,110,85,95,80,95,50,515,0.2713178294573643,1.0
60,75,85,100,85,115,520,0.8992248062015504,54,45,47,75,98,52,371,0.39669421487603307,1.0
86,92,88,68,75,73,482,0.6835443037974683,68,125,65,65,115,80,518,0.6277372262773723,0.5
42,52,67,39,56,50,306,0.2868217054263566,45,35,50,70,50,30,280,0.15753424657534246,0.5
100,73,83,73,83,55,467,0.371900826446281,70,70,115,130,90,60,535,0.5338983050847458,0.0
50,60,60,60,60,30,320,0.11290322580645161,50,20,40,20,40,20,190,0.0962962962962963,2.0
60,85,60,85,60,55,405,0.3673469387755102,44,75,35,63,33,45,295,0.2647058823529412,0.0
50,64,50,45,50,41,300,0.22727272727272727,58,89,77,45,45,48,362,0.3177570093457944,2.0
76,48,48,57,62,34,325,0.11688311688311688,39,52,43,60,50,65,309,0.49107142857142855,2.0
38,30,85,55,65,30,303,0.21428571428571427,60,62,63,80,80,60,405,0.38016528925619836,1.0
68,90,65,50,55,82,410,0.6165413533834586,123,100,62,97,81,68,531,0.4806201550387597,0.5
50,65,45,85,65,95,405,0.7238095238095238,115,45,20,45,25,20,270,0.11538461538461539,1.0
170,90,45,90,45,60,500,0.427536231884058,45,55,45,65,45,75,330,0.5692307692307692,1.0
110,78,73,76,71,60,468,0.3333333333333333,60,52,168,47,138,30,495,0.19834710743801653,8.0
110,65,105,55,95,80,510,0.6258503401360545,60,90,55,90,80,110,485,0.8677685950413223,0.5
70,110,70,115,70,90,525,0.75,104,91,63,91,73,68,490,0.5118110236220472,2.0
86,92,88,68,75,73,482,0.6835443037974683,50,53,48,53,48,64,316,0.46153846153846156,1.0
28,25,25,45,35,40,198,0.16083916083916083,35,70,55,45,55,25,285,0.09420289855072464,1.0
60,55,90,145,90,80,520,0.6071428571428571,100,100,100,100,100,100,600,0.831858407079646,2.0
70,120,100,145,105,20,560,0.2824427480916031,50,65,64,44,48,43,314,0.2196969696969697,0.5
64,165,75,93,83,75,555,0.6587301587301587,65,130,60,75,60,75,465,0.689922480620155,0.5
55,55,85,65,85,35,380,0.2014388489208633,110,160,110,80,110,100,670,0.8591549295774648,1.0
105,180,100,180,100,115,780,0.9477611940298507,86,92,88,68,75,73,482,0.6835443037974683,1.0
37,25,41,25,41,25,194,0.08870967741935484,70,110,180,60,60,50,530,0.4117647058823529,0.5
44,38,33,61,43,70,289,0.5267857142857143,45,50,43,40,38,62,278,0.40441176470588236,2.0
60,50,40,85,75,95,405,0.7540983606557377,125,120,90,170,100,95,700,0.78125,0.5
100,110,90,85,90,60,535,0.47794117647058826,75,80,55,25,35,35,305,0.18666666666666668,1.0
71,73,88,120,89,59,500,0.43537414965986393,104,91,63,91,73,68,490,0.5118110236220472,1.0
90,120,100,150,120,100,680,0.7718120805369127,80,115,80,65,55,93,488,0.7846153846153846,1.0
60,50,40,85,75,95,405,0.7540983606557377,65,90,65,61,61,100,442,0.8373983739837398,2.0
70,55,65,95,85,70,440,0.5307692307692308,50,65,107,105,107,86,520,0.7313432835820896,1.0
35,80,50,50,70,120,405,0.84375,30,45,59,30,39,57,260,0.2803030303030303,1.0
105,130,120,45,45,40,485,0.4444444444444444,90,85,100,95,125,85,580,0.6834532374100719,0.0
68,85,65,165,135,100,618,0.8083333333333333,60,90,140,50,50,40,430,0.2535211267605634,0.25
50,40,85,40,65,25,305,0.08870967741935484,63,120,85,90,55,55,468,0.2809917355371901,2.0
79,115,70,125,80,111,580,0.864,120,120,120,120,120,120,720,0.9344262295081968,1.0
65,73,55,47,75,85,400,0.6846846846846847,65,80,140,40,70,70,465,0.5223880597014925,0.25
40,35,30,120,70,105,400,0.6692307692307692,55,40,50,65,85,40,335,0.3181818181818182,1.0
78,84,78,109,85,100,534,0.8646616541353384,65,47,55,73,75,85,400,0.65,4.0
49,55,42,42,37,85,310,0.6068376068376068,60,85,42,85,42,91,405,0.8227848101265823,1.0
57,24,86,24,86,23,300,0.12727272727272726,73,95,62,85,65,85,465,0.6666666666666666,1.0
30,45,135,45,90,30,375,0.09285714285714286,45,45,55,45,55,63,308,0.4594594594594595,1.0
74,94,131,54,116,20,489,0.4485294117647059,59,66,70,44,55,41,335,0.25190839694656486,0.5
40,70,40,35,40,60,285,0.392,59,74,50,35,50,35,303,0.3125,0.0
135,85,40,40,85,5,390,0.6864406779661016,40,30,30,55,30,85,270,0.4666666666666667,1.0
80,90,80,130,110,110,600,0.856,50,53,48,53,48,64,316,0.358974358974359,1.0
75,80,60,65,90,102,472,0.8625954198473282,85,60,65,135,105,100,550,0.7518248175182481,1.0
70,100,70,105,75,40,460,0.23214285714285715,62,44,50,44,50,55,305,0.3629032258064516,0.0
35,35,40,35,55,50,250,0.40336134453781514,68,125,65,65,115,80,518,0.6277372262773723,2.0
70,50,30,95,135,105,485,0.8040540540540541,60,40,60,40,60,35,295,0.18055555555555555,2.0
40,55,80,35,60,30,300,0.15037593984962405,80,145,150,105,110,110,700,0.8692307692307693,0.125
82,121,119,69,59,71,521,0.5394736842105263,60,40,50,75,85,95,405,0.6044776119402985,1.0
100,150,110,95,110,70,635,0.5923076923076923,35,35,35,35,35,35,210,0.13385826771653545,1.0
50,75,35,70,30,40,300,0.21296296296296297,55,75,85,25,25,15,280,0.1875,1.0
50,95,180,85,45,70,525,0.5298507462686567,40,80,35,35,45,70,305,0.4661016949152542,1.0
50,75,35,70,30,40,300,0.21296296296296297,74,94,131,54,116,20,489,0.4485294117647059,0.0
50,120,53,35,110,87,455,0.640625,45,45,55,45,55,63,308,0.4594594594594595,1.0
60,65,60,130,75,110,500,0.7719298245614035,50,53,48,53,48,64,316,0.46153846153846156,1.0
75,105,75,105,75,45,480,0.3274336283185841,100,50,50,76,96,70,442,0.5,1.0
85,80,90,105,95,60,515,0.49074074074074076,67,58,57,81,67,101,431,0.8790322580645161,1.0
66,117,70,40,50,67,410,0.4573643410852713,123,100,62,97,81,68,531,0.4806201550387597,1.0
68,65,65,125,115,80,518,0.6461538461538462,79,100,80,110,90,121,580,0.968,1.0
50,50,40,50,40,64,294,0.45588235294117646,95,135,80,110,80,100,600,0.8248175182481752,0.5
65,47,55,73,75,85,400,0.65,50,35,55,25,25,15,205,0.05263157894736842,1.0
70,75,60,105,60,105,475,0.88,91,72,90,129,90,108,580,0.8925619834710744,2.0
65,90,40,45,80,75,395,0.625,76,104,71,104,71,108,534,0.912751677852349,0.25
78,104,78,159,115,100,634,0.8444444444444444,50,150,50,150,50,150,600,0.9339622641509434,1.0
37,25,41,25,41,25,194,0.08870967741935484,95,110,80,70,80,50,485,0.37209302325581395,1.0
50,64,50,45,50,41,300,0.22727272727272727,111,83,68,92,82,39,475,0.1774193548387097,0.5
66,41,77,61,87,23,355,0.12096774193548387,115,45,20,45,25,20,270,0.11538461538461539,1.0
60,100,115,70,85,90,520,0.7557251908396947,85,135,130,60,80,25,515,0.40540540540540543,2.0
85,110,76,65,82,56,474,0.3933333333333333,55,95,115,45,45,35,390,0.2116788321167883,4.0
75,80,60,65,90,102,472,0.8625954198473282,95,109,105,75,85,56,525,0.34513274336283184,1.0
60,79,105,59,85,36,424,0.17054263565891473,65,136,94,54,96,135,580,0.9612403100775194,0.5
95,60,79,100,125,81,540,0.6201550387596899,90,120,120,60,60,50,500,0.35294117647058826,2.0
91,134,95,100,100,80,600,0.6304347826086957,64,78,52,78,52,81,405,0.6422764227642277,2.0
76,48,48,57,62,34,325,0.11688311688311688,90,85,100,95,125,85,580,0.6834532374100719,1.0
80,45,65,90,110,80,470,0.5462962962962963,45,30,50,55,65,45,290,0.208,0.5
65,90,65,61,61,100,442,0.8373983739837398,100,75,115,90,115,85,580,0.6446280991735537,1.0
75,80,85,110,90,50,490,0.3548387096774194,120,120,120,120,120,120,720,0.9344262295081968,1.0
65,50,35,115,95,95,455,0.7333333333333333,80,120,80,120,80,100,580,0.8478260869565217,0.5
45,30,15,85,65,65,305,0.36220472440944884,66,65,48,62,57,52,350,0.36220472440944884,2.0
55,112,45,74,45,70,401,0.559322033898305,65,105,60,60,70,95,455,63.0,1.0
100,90,130,45,65,55,485,0.4253731343283582,45,65,34,40,34,45,263,0.2589928057553957,1.0
70,60,62,80,82,60,414,0.4375,60,45,70,75,85,55,390,0.3008130081300813,2.0
95,75,180,130,80,30,590,0.13793103448275862,90,60,70,75,70,45,410,0.23880597014925373,0.5
60,50,70,50,90,65,385,0.39568345323741005,20,40,15,35,35,60,205,0.34285714285714286,1.0
44,75,35,63,33,45,295,0.2647058823529412,40,40,35,50,100,70,335,0.5031847133757962,1.0
65,90,40,45,80,75,395,0.625,40,35,30,120,70,105,400,0.6692307692307692,2.0
75,95,95,95,95,85,540,0.6470588235294118,25,20,15,105,55,90,310,0.32407407407407407,1.0
60,59,85,79,105,36,424,0.16666666666666666,50,85,85,55,55,50,380,0.3902439024390244,0.125
70,75,60,105,60,105,475,0.88,72,58,80,103,80,97,490,0.7171052631578947,2.0
75,70,90,70,105,80,490,0.656,65,45,55,45,70,45,325,0.24369747899159663,1.0
81,102,77,85,75,85,505,0.5642857142857143,67,58,57,81,67,101,431,0.8790322580645161,4.0
40,40,50,30,30,30,220,0.0873015873015873,115,115,85,90,75,100,580,0.8134328358208955,0.5
43,80,65,50,35,35,308,0.14193548387096774,65,136,94,54,96,135,580,0.9612403100775194,1.0
114,85,70,85,80,30,464,0.2066115702479339,60,30,30,36,56,50,262,0.32432432432432434,0.5
72,95,67,103,71,122,530,0.9606299212598425,75,125,75,30,75,85,465,0.625,0.5
70,120,100,145,105,20,560,0.2824427480916031,75,87,63,87,63,98,473,0.865546218487395,0.0
110,123,65,100,65,65,528,0.5217391304347826,85,70,80,97,80,123,535,0.9304347826086956,0.25
250,5,5,35,105,50,450,0.15306122448979592,150,100,120,100,120,90,680,0.6666666666666666,0.0
105,130,120,45,45,40,485,0.4444444444444444,80,82,78,95,80,85,500,0.6869565217391305,1.0
80,145,150,105,110,110,700,0.8692307692307693,95,23,48,23,48,23,260,0.046153846153846156,0.5
90,60,60,40,40,40,330,0.29545454545454547,70,130,100,55,80,65,500,0.608,1.0
85,90,80,70,80,130,535,0.9262295081967213,40,30,30,40,50,30,220,0.07936507936507936,4.0
79,115,70,125,80,111,580,0.864,60,30,30,36,56,50,262,0.32432432432432434,2.0
58,50,145,95,105,30,483,0.2459016393442623,45,100,45,45,45,10,290,0.2949640287769784,1.0
60,60,60,85,85,85,435,0.631578947368421,50,47,50,57,50,65,319,0.463768115942029,1.0
89,124,80,55,80,55,483,0.5714285714285714,57,24,86,24,86,23,300,0.12727272727272726,4.0
100,50,50,76,96,70,442,0.5,86,92,88,68,75,73,482,0.6835443037974683,1.0
40,60,40,40,40,30,250,0.0948905109489051,55,50,65,175,95,150,590,0.7818181818181819,2.0
63,120,85,90,55,55,468,0.2809917355371901,50,64,50,45,50,41,300,0.22727272727272727,4.0
60,45,70,75,85,55,390,0.3008130081300813,55,85,55,50,55,60,360,0.4233576642335766,1.0
41,64,45,50,50,50,300,0.36752136752136755,70,70,115,130,90,60,535,0.5338983050847458,0.5
90,30,15,40,20,15,210,0.043478260869565216,70,90,90,135,90,125,600,0.9401709401709402,2.0
72,95,67,103,71,122,530,0.9606299212598425,65,130,60,75,60,75,465,0.689922480620155,0.5
99,68,83,72,87,51,460,0.417910447761194,80,75,150,75,150,50,580,0.30973451327433627,0.25
70,80,70,80,70,110,480,0.6594202898550725,80,80,80,55,55,90,440,0.6417910447761194,0.0
90,100,60,90,60,80,480,0.6422764227642277,59,63,80,65,80,58,405,0.41843971631205673,2.0
105,140,55,30,55,95,480,0.8195488721804511,100,103,75,120,75,127,600,0.940677966101695,2.0
95,80,105,40,70,100,490,0.8046875,105,30,105,140,105,55,540,0.3524590163934426,1.0
65,80,80,59,63,58,405,0.4411764705882353,60,65,80,170,95,130,600,0.8625954198473282,1.0
78,70,61,50,61,100,420,0.8145161290322581,70,83,50,37,50,60,350,0.3360655737704918,1.0
90,85,100,95,125,85,580,0.6834532374100719,70,94,50,94,50,66,424,0.48148148148148145,4.0
110,65,105,55,95,80,510,0.6258503401360545,75,75,130,75,130,95,580,0.7479674796747967,2.0
82,121,119,69,59,71,521,0.5394736842105263,85,80,90,105,95,60,515,0.49074074074074076,1.0
75,103,80,70,80,92,500,0.7933884297520661,60,82,45,45,45,74,351,0.5752212389380531,4.0
89,145,90,105,80,91,600,0.8549618320610687,74,100,72,90,72,46,454,0.24561403508771928,1.0
77,120,90,60,90,48,485,0.2785714285714286,45,53,70,40,60,42,310,0.25735294117647056,1.0
50,40,85,40,65,25,305,0.08870967741935484,59,66,70,44,55,41,335,0.25190839694656486,1.0
65,150,40,15,80,145,495,0.9663865546218487,44,38,33,61,43,70,289,0.5267857142857143,1.0
50,47,50,57,50,65,319,0.463768115942029,80,80,80,80,80,80,480,0.5606060606060606,2.0
59,59,58,90,70,73,409,0.5826086956521739,75,80,95,90,100,50,490,0.2158273381294964,2.0
75,75,95,75,95,113,528,0.9015151515151515,60,65,60,130,75,110,500,0.7719298245614035,0.5
60,50,40,85,75,95,405,0.7540983606557377,40,30,35,45,40,55,245,0.31496062992125984,1.0
55,68,64,45,55,31,318,0.11666666666666667,95,65,65,110,130,60,525,0.4016393442622951,1.0
50,53,62,58,63,44,330,0.13709677419354838,59,74,50,35,50,35,303,0.3125,2.0
45,35,45,62,53,35,275,0.11851851851851852,70,60,62,80,82,60,414,0.4375,0.25
37,25,41,25,41,25,194,0.08870967741935484,91,90,72,90,129,108,580,0.896,1.0
65,75,70,95,70,95,470,0.7272727272727273,45,100,135,65,135,45,525,0.29411764705882354,1.0
85,110,90,45,90,80,500,0.6206896551724138,40,60,30,31,31,70,262,0.4492753623188406,1.0
75,125,230,55,95,30,610,0.3448275862068966,43,70,48,50,60,38,309,0.2391304347826087,0.5
44,58,44,58,44,61,309,0.41964285714285715,70,83,50,37,50,60,350,0.3360655737704918,1.0
50,65,107,105,107,86,520,0.7313432835820896,70,80,70,80,70,110,480,0.6594202898550725,1.0
79,103,120,135,115,78,630,0.5763888888888888,125,58,58,76,76,67,460,0.515625,0.5
50,53,48,53,48,64,316,0.358974358974359,70,60,70,87,78,85,450,0.6228070175438597,0.5
75,125,75,30,75,85,465,0.625,30,56,35,25,35,72,253,0.48148148148148145,2.0
62,48,66,59,57,49,341,0.33884297520661155,55,63,90,50,80,42,380,0.21138211382113822,1.0
105,30,105,140,105,55,540,0.3524590163934426,70,75,80,135,80,135,575,0.917910447761194,1.0
44,38,39,61,79,42,303,0.2251655629139073,90,92,75,92,85,60,494,0.49586776859504134,1.0
45,49,65,49,65,45,318,0.275,60,69,95,69,95,36,424,0.2608695652173913,0.25
70,20,50,20,50,40,250,0.1557377049180328,35,20,65,40,65,20,245,0.02459016393442623,1.0
60,80,50,40,40,30,300,0.15328467153284672,92,105,90,125,90,98,600,0.8217054263565892,4.0
50,65,107,105,107,86,520,0.703125,65,95,75,55,55,85,430,0.6933333333333334,1.0
55,55,85,65,85,35,380,0.2014388489208633,55,55,55,85,55,30,335,0.1320754716981132,1.0
72,95,67,103,71,122,530,0.9606299212598425,90,130,80,65,85,55,505,0.4396551724137931,0.5
75,95,60,65,60,115,470,0.8778625954198473,55,81,60,50,70,97,413,0.7214285714285714,1.0
80,185,115,40,105,75,600,0.6230769230769231,70,140,70,110,65,105,560,0.95,4.0
40,45,40,35,35,56,251,0.373015873015873,95,109,105,75,85,56,525,0.34513274336283184,2.0
40,29,45,29,45,36,224,0.14634146341463414,80,100,200,50,100,50,580,0.3472222222222222,1.0
61,78,95,56,58,57,405,0.40336134453781514,50,50,40,50,40,64,294,0.45588235294117646,2.0
85,80,90,105,95,60,515,0.49074074074074076,90,92,87,75,85,76,505,0.5409836065573771,1.0
60,67,85,77,75,116,480,0.8888888888888888,40,55,30,30,30,85,270,0.688,0.5
40,80,35,35,45,70,305,0.4661016949152542,70,80,70,80,70,110,480,0.6594202898550725,0.0
50,180,20,180,20,150,600,0.9029850746268657,115,140,130,55,55,40,535,0.4519230769230769,2.0
36,50,50,65,60,44,305,0.16363636363636364,35,35,40,35,55,50,250,0.40336134453781514,4.0
35,64,85,74,55,32,345,0.19827586206896552,65,70,60,65,65,115,440,0.8583333333333333,1.0
91,90,129,90,72,108,580,0.9140625,55,63,90,50,80,42,380,0.21138211382113822,0.5
48,72,48,72,48,48,336,0.25984251968503935,115,140,130,55,55,40,535,0.4519230769230769,2.0
65,80,65,35,65,60,370,0.38405797101449274,60,45,50,90,80,70,395,0.625,1.0
65,60,70,85,75,40,395,0.1796875,70,90,45,15,45,50,315,0.3629032258064516,1.0
105,140,55,30,55,95,480,0.8195488721804511,40,45,35,65,55,70,310,0.4482758620689655,2.0
50,65,90,35,35,15,290,0.14678899082568808,45,95,50,40,50,75,355,0.54,1.0
50,20,40,20,40,20,190,0.0962962962962963,65,130,60,75,60,75,465,0.689922480620155,2.0
85,100,122,58,75,54,494,0.3939393939393939,70,110,75,145,85,145,630,0.9444444444444444,0.25
35,35,40,35,55,50,250,0.40336134453781514,105,30,105,140,105,55,540,0.3524590163934426,0.5
80,120,79,95,79,70,523,0.5833333333333334,50,48,43,46,41,60,288,0.47297297297297297,0.0
40,45,40,35,35,56,251,0.373015873015873,70,95,125,65,75,45,475,0.33613445378151263,0.5
89,125,90,115,80,101,600,0.8725490196078431,40,65,40,80,40,65,330,0.5038167938931297,1.0
75,110,110,110,105,80,590,0.656934306569343,30,80,90,55,45,55,355,0.4295774647887324,1.0
95,23,48,23,48,23,260,0.046153846153846156,38,36,38,32,36,57,237,0.3893805309734513,1.0
40,30,50,55,55,100,330,0.584070796460177,78,84,78,109,85,100,534,0.8620689655172413,1.0
99,68,83,72,87,51,460,0.417910447761194,84,86,88,111,101,60,530,0.4634146341463415,0.5
65,95,57,100,85,93,495,0.7441860465116279,64,51,23,51,23,28,240,0.11363636363636363,1.0
75,75,130,75,130,95,580,0.7479674796747967,45,75,60,40,30,50,300,0.304,1.0
100,77,77,128,128,90,600,0.6901408450704225,60,55,90,145,90,80,520,0.6071428571428571,0.0
80,185,115,40,105,75,600,0.6230769230769231,91,90,72,90,129,108,580,0.896,1.0
95,135,80,110,80,100,600,0.8248175182481752,60,60,60,105,105,105,495,0.848,1.0
60,60,60,85,85,85,435,0.631578947368421,80,90,80,130,110,110,600,0.856,2.0
64,78,52,78,52,81,405,0.6422764227642277,85,50,95,120,115,80,545,0.5793650793650794,0.25
62,44,50,44,50,55,305,0.3629032258064516,80,125,75,40,95,85,500,0.6911764705882353,4.0
80,100,70,60,70,95,475,0.7416666666666667,75,80,55,25,35,35,305,0.18666666666666668,1.0
78,92,75,74,63,118,500,0.8842975206611571,48,72,48,72,48,48,336,0.25984251968503935,0.5
70,65,65,55,55,70,380,0.5,70,85,70,60,70,50,405,0.28378378378378377,1.0
125,120,90,170,100,95,700,0.78125,70,80,102,80,102,40,474,0.2677165354330709,2.0
28,25,25,45,35,40,198,0.16083916083916083,30,56,35,25,35,72,253,0.48148148148148145,1.0
75,89,85,55,65,36,405,0.29545454545454547,70,70,40,60,40,60,340,0.4247787610619469,0.5
106,150,70,194,120,140,780,0.952,45,60,45,25,45,55,275,0.29,1.0
35,40,100,90,55,35,355,0.1796875,70,70,70,70,70,70,420,0.5289256198347108,1.0
50,52,48,65,50,55,320,0.33098591549295775,80,80,80,80,80,80,480,0.5606060606060606,0.5
44,50,91,24,86,10,305,0.1981981981981982,40,30,35,50,70,55,280,0.28205128205128205,0.25
60,25,35,70,80,60,330,0.3076923076923077,55,40,40,65,45,35,280,0.16428571428571428,1.0
75,98,63,98,63,101,498,0.8091603053435115,40,27,60,37,50,66,280,0.36220472440944884,0.5
61,90,45,50,50,160,456,0.9230769230769231,20,10,55,15,20,80,200,0.17985611510791366,1.0
100,123,75,57,75,80,510,0.6923076923076923,50,65,107,105,107,86,520,0.7272727272727273,0.5
74,94,131,54,116,20,489,0.4485294117647059,45,49,65,49,65,45,318,0.275,0.5
78,81,71,74,69,126,499,0.9090909090909091,60,45,50,90,80,70,395,0.625,4.0
80,50,100,100,200,50,580,0.2357142857142857,126,131,95,131,98,99,680,0.8102189781021898,2.0
70,70,40,60,40,60,340,0.4247787610619469,106,150,70,194,120,140,780,0.952,2.0
65,80,80,59,63,58,405,0.4411764705882353,80,120,70,110,70,80,530,0.6422764227642277,2.0
59,59,58,90,70,73,409,0.5826086956521739,45,30,35,20,20,45,195,0.14782608695652175,2.0
55,81,60,50,70,97,413,0.7214285714285714,55,66,44,44,56,85,350,0.6888888888888889,1.0
50,75,70,35,70,48,348,0.29357798165137616,65,75,70,95,70,95,470,0.7272727272727273,0.5
75,95,122,58,75,69,494,0.5725806451612904,45,60,40,70,50,45,310,0.2846715328467153,0.5
90,85,75,115,100,115,580,0.9381443298969072,78,92,75,74,63,118,500,0.8842975206611571,2.0
35,70,55,45,55,25,285,0.09420289855072464,75,65,55,65,55,69,384,0.43548387096774194,4.0
125,170,100,120,90,95,700,0.77,75,90,90,140,90,115,600,0.9481481481481482,0.5
70,75,60,105,60,105,475,0.88,43,30,55,40,65,97,330,0.6030534351145038,2.0
80,100,70,60,70,95,475,0.7416666666666667,78,70,61,50,61,100,420,0.8145161290322581,1.0
91,129,90,72,90,108,580,0.8536585365853658,60,85,60,50,50,125,430,0.9090909090909091,2.0
78,70,61,50,61,100,420,0.8145161290322581,75,98,63,98,63,101,498,0.889763779527559,1.0
60,85,69,60,69,77,420,0.518796992481203,78,84,78,109,85,100,534,0.8646616541353384,1.0
60,80,50,40,40,30,300,0.15328467153284672,70,100,115,30,65,30,410,0.24390243902439024,1.0
35,55,40,45,40,60,275,0.35714285714285715,67,82,62,46,48,43,348,0.22033898305084745,1.0
69,69,76,69,86,91,460,0.6554621848739496,75,98,63,98,63,101,498,0.8091603053435115,0.5
40,35,30,120,70,105,400,0.6692307692307692,90,75,85,115,90,55,510,0.3445378151260504,1.0
60,69,95,69,95,36,424,0.2608695652173913,85,105,55,85,50,115,495,0.9032258064516129,0.5
80,135,85,70,95,150,615,0.9844961240310077,80,160,60,170,130,80,680,0.6180555555555556,1.0
70,90,70,60,60,70,420,0.6390977443609023,95,117,184,44,46,28,514,0.2975206611570248,1.0
65,65,45,75,45,95,390,0.72,53,51,53,61,56,40,314,0.14285714285714285,1.0
65,105,60,60,70,95,455,63.0,65,80,140,40,70,70,465,0.5223880597014925,1.0
100,77,77,128,128,90,600,0.6901408450704225,45,50,45,115,55,95,405,0.6936936936936937,0.0
60,79,105,59,85,36,424,0.17054263565891473,100,123,75,57,75,80,510,0.6923076923076923,0.0
80,90,80,130,110,110,600,0.856,70,60,62,80,82,60,414,0.4375,1.0
80,50,100,100,200,50,580,0.2357142857142857,45,49,65,49,65,45,318,0.275,2.0
30,30,42,30,42,70,244,0.4230769230769231,60,55,145,75,150,40,525,0.2,0.125
62,73,55,56,52,84,382,0.7244094488188977,56,61,65,48,45,38,313,0.17567567567567569,4.0
50,80,95,10,45,10,290,0.232,50,70,100,40,40,30,330,0.2222222222222222,0.5
70,50,30,95,135,105,485,0.8040540540540541,54,45,47,75,98,52,371,0.39669421487603307,1.0
114,85,70,85,80,30,464,0.2066115702479339,123,77,72,99,92,58,521,0.4621212121212121,1.0
35,20,65,40,65,20,245,0.02459016393442623,50,60,45,100,80,65,400,0.45689655172413796,0.5
90,85,100,95,125,85,580,0.6834532374100719,55,45,45,25,25,15,210,0.048,1.0
70,90,70,60,60,70,420,0.6390977443609023,70,115,60,115,60,55,475,0.4647887323943662,0.5
65,155,120,65,90,105,600,0.8677685950413223,50,150,50,150,50,150,600,0.9339622641509434,2.0
100,90,130,45,65,55,485,0.4253731343283582,65,125,100,60,70,70,490,0.6099290780141844,0.5
103,93,67,71,61,84,479,0.7142857142857143,95,80,105,40,70,100,490,0.8046875,1.0
67,57,55,77,55,114,425,0.8879310344827587,40,70,130,60,130,25,455,0.17355371900826447,1.0
35,20,65,40,65,20,245,0.02459016393442623,123,100,62,97,81,68,531,0.4806201550387597,1.0
60,55,145,75,150,40,525,0.2,50,92,108,92,108,35,485,0.2457627118644068,1.0
45,20,50,60,120,50,345,0.24074074074074073,45,49,49,65,65,45,318,0.2781954887218045,1.0
40,55,70,45,60,30,300,0.10619469026548672,50,150,50,150,50,150,600,0.9339622641509434,1.0
50,52,48,65,50,55,320,0.33098591549295775,50,50,77,95,77,91,440,0.5916666666666667,1.0
70,70,70,70,70,70,420,0.5289256198347108,10,55,25,35,45,95,265,0.5396825396825397,1.0
50,47,50,57,50,65,319,0.463768115942029,68,125,65,65,115,80,518,0.6277372262773723,1.0
45,35,45,62,53,35,275,0.11851851851851852,80,70,40,100,60,145,495,0.921875,0.5
44,48,65,50,64,43,314,0.1623931623931624,30,30,42,30,42,70,244,0.4230769230769231,1.0
65,73,55,47,75,85,400,0.6846846846846847,73,95,62,85,65,85,465,0.6666666666666666,1.0
50,65,107,105,107,86,520,0.6991150442477876,40,60,30,31,31,70,262,0.4492753623188406,2.0
65,90,50,85,45,55,390,0.371900826446281,40,30,30,40,50,30,220,0.07936507936507936,2.0
55,70,45,70,50,60,350,0.45,79,103,120,135,115,78,630,0.5763888888888888,0.5
75,80,60,65,90,102,472,0.8625954198473282,80,82,100,83,100,80,525,0.6821705426356589,1.0
35,35,40,35,55,50,250,0.40336134453781514,60,60,40,65,45,35,305,0.15833333333333333,1.0
55,40,40,65,45,35,280,0.16428571428571428,40,45,65,100,120,90,460,0.5588235294117647,1.0
44,50,91,24,86,10,305,0.1981981981981982,65,76,84,54,96,105,480,0.9008264462809917,1.0
100,100,100,100,100,100,600,0.8345864661654135,50,95,90,95,90,180,600,0.9172413793103448,0.5
35,64,85,74,55,32,345,0.19827586206896552,78,104,78,159,115,100,634,0.8444444444444444,2.0
49,49,56,49,61,66,330,0.5190839694656488,40,30,30,55,30,85,270,0.4666666666666667,0.5
55,85,55,50,55,60,360,0.4233576642335766,40,45,35,40,40,90,290,0.65,1.0
50,70,50,50,50,40,310,0.16296296296296298,95,117,184,44,46,28,514,0.2975206611570248,1.0
95,124,78,69,71,58,495,0.37398373983739835,52,65,55,58,62,60,352,0.4482758620689655,1.0
50,70,100,40,40,30,330,0.2222222222222222,60,85,49,60,49,60,363,0.4444444444444444,0.5
42,52,67,39,56,50,306,0.2868217054263566,80,120,70,110,70,80,530,0.6422764227642277,2.0
35,65,35,65,35,65,300,0.46621621621621623,60,85,49,60,49,60,363,0.4444444444444444,1.0
80,120,79,95,79,70,523,0.5833333333333334,75,75,55,105,85,30,425,0.1619718309859155,0.5
100,150,90,180,160,90,770,0.7348484848484849,60,60,60,60,60,60,360,0.38095238095238093,1.0
90,60,70,75,70,45,410,0.23880597014925373,75,100,110,45,55,65,450,0.5333333333333333,4.0
60,115,105,65,70,80,495,0.7181818181818181,65,150,60,115,60,115,565,0.935251798561151,1.0
77,120,90,60,90,48,485,0.2785714285714286,90,95,95,70,90,70,510,0.5230769230769231,1.0
75,98,63,98,63,101,498,0.8091603053435115,77,59,50,67,63,46,362,0.23140495867768596,2.0
80,80,80,80,80,80,480,0.6015037593984962,100,180,160,150,90,90,770,0.7520661157024794,1.0
50,30,55,65,55,20,275,0.13675213675213677,45,85,50,55,50,65,350,0.5076923076923077,1.0
50,47,50,57,50,65,319,0.463768115942029,45,30,40,105,50,20,290,0.031007751937984496,2.0
110,160,110,80,110,100,670,0.8591549295774648,115,140,130,55,55,40,535,0.4519230769230769,0.5
80,80,80,55,55,90,440,0.6417910447761194,64,78,52,78,52,81,405,0.6422764227642277,1.0
65,55,115,100,40,60,435,0.3798449612403101,78,65,68,112,154,75,552,0.628099173553719,1.0
50,65,90,35,35,15,290,0.14678899082568808,70,70,115,130,90,60,535,0.5338983050847458,0.5
85,90,80,70,80,130,535,0.9262295081967213,75,80,85,110,90,50,490,0.3548387096774194,2.0
115,115,85,90,75,100,580,0.8134328358208955,30,45,55,70,55,85,340,0.5633802816901409,0.5
40,45,35,30,40,55,245,0.3793103448275862,35,45,160,30,45,70,385,0.48148148148148145,0.125
60,55,145,75,150,40,525,0.2,50,30,55,65,55,20,275,0.13675213675213677,1.0
73,76,75,81,100,100,505,0.8110236220472441,60,130,80,60,60,70,460,0.5153846153846153,2.0
165,75,80,40,45,65,470,0.5151515151515151,70,55,65,95,85,70,440,0.5307692307692308,2.0
55,68,64,45,55,31,318,0.11666666666666667,75,75,95,75,95,113,528,0.9015151515151515,0.5
70,40,50,55,50,25,290,0.061068702290076333,60,105,60,120,60,105,510,0.8849557522123894,1.0
80,82,100,83,100,80,525,0.6821705426356589,50,52,48,65,50,55,320,0.33098591549295775,2.0
57,24,86,24,86,23,300,0.12727272727272726,100,134,110,95,100,61,600,0.4057971014492754,0.0
71,95,85,110,95,79,535,0.664,109,66,84,81,99,32,471,0.2013888888888889,2.0
110,135,60,50,65,88,508,0.7744360902255639,59,110,150,45,49,35,448,0.3333333333333333,1.0
39,52,43,60,50,65,309,0.5041322314049587,100,50,50,76,96,70,442,0.5,1.0
100,150,120,120,100,90,680,0.6493506493506493,55,81,60,50,70,97,413,0.7214285714285714,1.0
50,150,50,150,50,150,600,0.9339622641509434,55,104,105,94,75,52,485,0.36363636363636365,1.0
80,120,70,110,70,80,530,0.6422764227642277,85,80,70,135,75,90,535,0.7006802721088435,2.0
65,136,94,54,96,135,580,0.9612403100775194,75,55,70,55,95,110,460,0.8444444444444444,0.5
40,55,30,30,30,60,245,0.43548387096774194,55,70,55,40,55,85,360,0.7073170731707317,1.0
55,70,45,70,50,60,350,0.45,78,104,78,159,115,100,634,0.8444444444444444,0.5
95,95,85,125,65,55,520,0.3894736842105263,20,10,55,15,20,80,200,0.17985611510791366,2.0
70,83,50,37,50,60,350,0.3360655737704918,65,60,110,130,95,65,525,0.47761194029850745,1.0
72,60,30,20,30,25,237,0.11570247933884298,50,35,55,25,25,15,205,0.05263157894736842,0.5
70,60,125,115,70,55,495,0.35507246376811596,97,165,60,65,50,58,495,0.3902439024390244,2.0
70,60,125,115,70,55,495,0.35507246376811596,20,10,230,10,230,5,505,0.0,4.0
68,75,53,83,113,60,452,0.45384615384615384,75,125,230,55,95,30,610,0.3448275862068966,0.5
70,43,53,43,53,40,302,0.19090909090909092,70,100,115,30,65,30,410,0.24390243902439024,0.5
80,92,65,65,80,68,450,0.4824561403508772,65,80,140,40,70,70,465,0.5223880597014925,1.0
110,160,110,80,110,100,670,0.8591549295774648,78,81,71,74,69,126,499,0.9090909090909091,1.0
65,95,57,100,85,93,495,0.7441860465116279,45,85,50,55,50,65,350,0.5076923076923077,1.0
80,82,83,100,100,80,525,0.6742424242424242,100,50,50,76,96,70,442,0.5,0.5
65,90,40,45,80,75,395,0.625,89,125,90,115,80,101,600,0.8725490196078431,0.25
30,105,90,25,25,50,325,0.2773722627737226,80,92,65,65,80,68,450,0.4824561403508772,0.5
70,80,102,80,102,40,474,0.2677165354330709,78,104,78,159,115,100,634,0.8444444444444444,0.25
41,56,40,62,44,71,314,0.568,75,55,70,55,95,110,460,0.8444444444444444,0.5
90,95,105,165,110,45,610,0.2890625,123,77,72,99,92,58,521,0.4621212121212121,1.0
83,80,75,70,70,101,479,0.8615384615384616,40,40,40,70,40,20,250,0.032520325203252036,1.0
59,45,40,35,40,31,250,0.14285714285714285,55,70,40,60,40,40,305,0.26956521739130435,1.0
70,150,140,65,100,75,600,0.55,83,106,65,86,65,85,490,0.6640625,0.25
90,60,70,75,70,45,410,0.23880597014925373,55,70,55,40,55,85,360,0.7073170731707317,1.0
65,155,120,65,90,105,600,0.8677685950413223,68,72,78,38,42,32,330,0.23809523809523808,1.0
65,75,90,97,123,44,494,0.1987179487179487,75,98,63,98,63,101,498,0.849624060150376,1.0
79,105,70,145,80,101,580,0.8608695652173913,65,60,110,130,95,65,525,0.47761194029850745,1.0
50,60,60,60,60,30,320,0.11290322580645161,75,75,60,83,60,60,413,0.39344262295081966,0.5
57,24,86,24,86,23,300,0.12727272727272726,100,70,70,65,65,45,415,0.1897810218978102,1.0
80,80,50,40,50,25,325,0.176056338028169,115,115,85,90,75,100,580,0.8134328358208955,1.0
126,131,95,131,98,99,680,0.8294573643410853,65,85,70,75,70,40,405,0.203125,1.0
40,45,35,65,55,70,310,0.4482758620689655,35,55,40,50,50,90,320,0.6838235294117647,1.0
70,20,50,20,50,40,250,0.1557377049180328,35,85,45,35,35,75,310,0.6492537313432836,1.0
90,93,55,70,55,55,418,0.3819444444444444,35,60,44,40,54,55,288,0.366412213740458,0.5
100,100,100,100,100,100,600,0.8805970149253731,70,95,85,55,65,70,440,0.5,2.0
70,90,70,60,60,70,420,0.6390977443609023,84,71,43,71,43,48,360,0.25874125874125875,1.0
40,20,30,40,80,55,265,0.22764227642276422,51,65,65,80,75,59,395,0.4365079365079365,1.0
40,80,35,35,45,70,305,0.4661016949152542,125,170,100,120,90,95,700,0.77,2.0
35,55,40,50,50,90,320,0.6838235294117647,106,110,90,154,90,130,680,0.926829268292683,1.0
80,130,100,160,120,110,700,0.8981481481481481,60,62,80,63,80,60,405,0.4336283185840708,1.0
35,55,35,30,30,35,220,0.23684210526315788,58,64,58,80,65,80,405,0.609271523178808,1.0
65,110,130,60,65,95,525,0.8278145695364238,55,68,64,45,55,31,318,0.11666666666666667,0.5
70,60,62,80,82,60,414,0.4375,70,110,70,115,70,90,525,0.75,0.25
70,43,53,43,53,40,302,0.19090909090909092,150,80,44,90,54,80,498,0.625,0.5
55,70,45,70,50,60,350,0.45,49,55,42,42,37,85,310,0.6068376068376068,1.0
50,50,77,95,77,91,440,0.5916666666666667,62,73,55,56,52,84,382,0.7244094488188977,2.0
60,25,35,70,80,60,330,0.3076923076923077,50,70,100,40,40,30,330,0.2222222222222222,0.5
90,95,105,165,110,45,610,0.2890625,50,35,55,25,25,15,205,0.021739130434782608,1.0
91,72,90,129,90,108,580,0.8925619834710744,35,85,45,35,35,75,310,0.6492537313432836,1.0
65,75,105,35,65,85,430,0.6940298507462687,50,50,150,50,150,50,500,0.2571428571428571,1.0
50,25,28,45,55,15,218,0.0625,55,40,40,65,45,35,280,0.16428571428571428,1.0
125,130,90,130,90,95,660,0.7734375,150,120,100,120,100,90,680,0.664179104477612,4.0
85,60,65,135,105,100,550,0.7518248175182481,65,100,70,80,80,105,500,0.8666666666666667,0.25
100,134,110,95,100,61,600,0.4057971014492754,100,100,100,100,100,100,600,0.8602941176470589,1.0
125,120,90,170,100,95,700,0.78125,68,165,95,65,115,110,618,0.8615384615384616,1.0
85,105,100,79,83,78,530,0.5869565217391305,53,54,53,37,46,45,288,0.3090909090909091,1.0
85,110,90,45,90,80,500,0.6206896551724138,60,60,50,40,50,75,335,0.5882352941176471,1.0
103,93,67,71,61,84,479,0.7142857142857143,60,62,63,80,80,60,405,0.38016528925619836,1.0
40,40,35,50,100,70,335,0.5031847133757962,80,185,115,40,105,75,600,0.6230769230769231,1.0
80,80,80,80,80,80,480,0.6015037593984962,59,66,70,44,55,41,335,0.25190839694656486,2.0
108,130,95,80,85,102,600,0.7637795275590551,70,70,70,70,70,70,420,0.5289256198347108,1.0
70,110,180,60,60,50,530,0.4117647058823529,60,52,168,47,138,30,495,0.19834710743801653,0.5
75,103,80,70,80,92,500,0.7933884297520661,95,100,85,108,70,70,528,0.5652173913043478,2.0
77,85,51,55,51,65,384,0.5163934426229508,30,30,30,30,30,30,180,0.12612612612612611,2.0
35,55,40,50,50,90,320,0.6838235294117647,49,55,42,42,37,85,310,0.6068376068376068,1.0
100,75,115,90,115,85,580,0.6446280991735537,75,98,63,98,63,101,498,0.8091603053435115,0.5
35,85,45,35,35,75,310,0.6492537313432836,90,65,65,40,40,15,315,0.19672131147540983,1.0
65,125,100,60,70,70,490,0.6099290780141844,100,180,160,150,90,90,770,0.7520661157024794,0.5
90,95,95,70,90,70,510,0.5230769230769231,75,85,200,55,65,30,510,0.16778523489932887,4.0
64,66,68,81,76,50,405,0.25190839694656486,100,150,140,100,90,90,670,0.7969924812030075,2.0
65,90,40,45,80,75,395,0.625,74,100,72,90,72,46,454,0.24561403508771928,4.0
60,40,80,60,45,40,325,0.23529411764705882,72,95,67,103,71,122,530,0.9606299212598425,0.0
108,100,121,81,95,95,600,0.7476635514018691,40,35,30,20,20,50,195,0.23423423423423423,1.0
70,120,100,145,105,20,560,0.2824427480916031,31,45,90,30,30,40,266,0.21929824561403508,1.0
110,78,73,76,71,60,468,0.3333333333333333,50,70,50,50,50,70,340,0.5645161290322581,1.0
56,61,65,48,45,38,313,0.17567567567567569,60,80,50,50,50,40,330,0.23853211009174313,1.0
55,104,105,94,75,52,485,0.36363636363636365,100,100,100,100,100,100,600,0.8805970149253731,0.5
50,105,79,35,110,76,455,0.6214285714285714,55,45,45,25,25,15,210,0.048,1.0
69,55,45,55,55,15,294,0.11666666666666667,57,80,91,80,87,75,470,0.5737704918032787,0.0
80,105,65,60,75,130,515,0.9645390070921985,57,24,86,24,86,23,300,0.12727272727272726,0.25
58,109,112,48,48,109,484,0.8805970149253731,66,117,70,40,50,67,410,0.4573643410852713,1.0
55,85,55,50,55,60,360,0.4233576642335766,80,105,65,60,75,130,515,0.9645390070921985,0.25
90,95,95,70,90,70,510,0.5230769230769231,80,100,80,80,80,100,520,0.9051724137931034,1.0
55,75,85,25,25,15,280,0.1875,60,50,70,50,90,65,385,0.39568345323741005,2.0
60,100,85,80,85,100,510,0.7007874015748031,75,140,65,112,65,110,567,0.9140625,1.0
115,115,85,90,75,100,580,0.8134328358208955,79,103,120,135,115,78,630,0.5763888888888888,0.5
68,125,65,65,115,80,518,0.6277372262773723,75,70,90,70,105,80,490,0.656,0.5
43,80,65,50,35,35,308,0.14193548387096774,80,160,80,130,80,100,630,0.8455284552845529,2.0
95,100,85,108,70,70,528,0.5652173913043478,69,69,76,69,86,91,460,0.6554621848739496,0.5
80,185,115,40,105,75,600,0.6230769230769231,59,45,40,35,40,31,250,0.14285714285714285,2.0
75,80,70,65,75,90,455,0.7578125,91,134,95,100,100,80,600,0.6304347826086957,1.0
150,80,44,90,54,80,498,0.625,54,78,103,53,45,22,355,0.23255813953488372,0.5
45,35,50,70,50,30,280,0.15753424657534246,35,46,34,35,45,20,215,0.072,1.0
60,95,80,60,80,30,405,0.19480519480519481,30,40,70,70,25,60,295,0.41353383458646614,2.0
58,89,77,45,45,48,362,0.3177570093457944,92,105,90,125,90,98,600,0.8217054263565892,2.0
65,125,100,55,70,85,500,0.6532258064516129,75,98,63,98,63,101,498,0.849624060150376,1.0
40,30,32,50,52,65,269,0.3671875,60,25,35,70,80,60,330,0.3076923076923077,2.0
44,48,65,50,64,43,314,0.1623931623931624,65,125,60,95,60,105,510,0.9236641221374046,1.0
75,75,60,83,60,60,413,0.39344262295081966,85,105,85,40,50,40,405,0.211864406779661,1.0
60,70,65,125,105,90,515,0.6911764705882353,65,65,65,50,50,90,385,0.72,2.0
100,100,100,100,100,100,600,0.8758169934640523,126,131,95,131,98,99,680,0.8102189781021898,0.0
100,50,50,76,96,70,442,0.5,40,70,130,60,130,25,455,0.17355371900826447,0.0
20,10,55,15,20,80,200,0.17985611510791366,70,65,65,55,55,70,380,0.5,1.0
30,45,135,45,90,30,375,0.09285714285714286,40,60,30,31,31,70,262,0.4492753623188406,2.0
1,90,45,30,30,40,236,0.33064516129032256,130,70,35,70,35,60,400,0.4017857142857143,1.0
110,65,105,55,95,80,510,0.6258503401360545,95,85,85,65,65,35,430,0.2571428571428571,1.0
60,45,70,75,85,55,390,0.3008130081300813,60,60,75,60,75,80,410,0.7321428571428571,0.5
50,35,55,25,25,15,205,0.05263157894736842,84,86,88,111,101,60,530,0.4634146341463415,0.5
57,24,86,24,86,23,300,0.12727272727272726,20,10,55,15,20,80,200,0.17985611510791366,0.5
62,73,55,56,52,84,382,0.7244094488188977,54,78,103,53,45,22,355,0.23255813953488372,0.125
111,83,68,92,82,39,475,0.1774193548387097,65,150,40,15,80,145,495,0.9663865546218487,1.0
65,65,45,75,45,95,390,0.72,81,102,77,85,75,85,505,0.5642857142857143,0.5
30,35,30,100,35,80,310,0.4765625,80,50,100,100,200,50,580,0.2357142857142857,1.0
45,30,50,65,50,45,285,0.13821138211382114,70,100,70,105,75,40,460,0.23214285714285715,2.0
70,90,70,60,60,70,420,0.6390977443609023,109,66,84,81,99,32,471,0.2013888888888889,1.0
100,123,75,57,75,80,510,0.6923076923076923,65,83,57,95,85,105,490,0.8914728682170543,0.5
40,45,35,40,40,90,290,0.65,105,140,95,55,65,45,505,0.3,1.0
62,48,66,59,57,49,341,0.33884297520661155,55,45,45,25,25,15,210,0.048,1.0
25,35,70,95,55,45,325,0.16783216783216784,67,89,116,79,116,33,500,0.2624113475177305,0.5
60,80,50,50,50,40,330,0.23853211009174313,80,120,130,55,65,45,495,0.37037037037037035,0.5
50,50,150,50,150,50,500,0.2571428571428571,89,145,90,105,80,91,600,0.8549618320610687,1.0
50,50,62,40,62,65,329,0.4188034188034188,65,80,80,59,63,58,405,0.4411764705882353,1.0
60,40,60,95,60,55,370,0.4222222222222222,40,70,40,35,40,60,285,0.392,1.0
75,95,67,125,95,83,540,0.7117117117117117,70,75,80,135,80,135,575,0.917910447761194,1.0
55,104,105,94,75,52,485,0.36363636363636365,50,60,45,100,80,65,400,0.45689655172413796,0.5
60,50,70,50,90,65,385,0.39568345323741005,35,55,35,30,30,35,220,0.23684210526315788,2.0
70,55,95,95,110,65,490,0.48872180451127817,55,75,85,25,25,15,280,0.1875,1.0
86,92,88,68,75,73,482,0.6835443037974683,75,95,122,58,75,69,494,0.5725806451612904,2.0
70,62,67,55,55,56,365,0.38513513513513514,80,100,200,50,100,50,580,0.3472222222222222,0.5
45,30,50,55,65,45,290,0.208,110,123,65,100,65,65,528,0.5217391304347826,1.0
63,63,47,41,41,74,329,0.56,50,65,107,105,107,86,520,0.7758620689655172,1.0
55,84,105,114,75,52,485,0.2890625,90,50,34,60,44,70,348,0.6283185840707964,1.0
45,35,45,62,53,35,275,0.11851851851851852,60,100,115,70,85,90,520,0.7557251908396947,0.5
91,90,106,130,106,77,600,0.648854961832061,45,60,30,80,50,65,330,0.4603174603174603,0.25
45,60,32,50,32,76,295,0.5925925925925926,45,45,35,20,30,20,195,0.07246376811594203,1.0
70,150,140,65,100,75,600,0.55,65,125,100,55,70,85,500,0.6532258064516129,1.0
115,45,20,45,25,20,270,0.11538461538461539,60,79,105,59,85,36,424,0.17054263565891473,1.0
70,110,180,60,60,50,530,0.4117647058823529,69,69,76,69,86,91,460,0.6554621848739496,0.5
123,100,62,97,81,68,531,0.4806201550387597,60,45,50,90,80,70,395,0.625,0.25
40,40,55,40,70,55,300,0.40939597315436244,60,85,60,50,50,125,430,0.9090909090909091,0.0
123,77,72,99,92,58,521,0.4621212121212121,30,105,90,25,25,50,325,0.2773722627737226,0.5
40,80,100,30,30,20,300,0.11851851851851852,55,55,45,63,45,45,308,0.25,1.0
95,155,109,70,130,81,640,0.6788321167883211,65,80,80,59,63,58,405,0.4411764705882353,0.5
60,85,69,65,79,80,438,0.576,70,95,125,65,75,45,475,0.33613445378151263,0.5
55,45,43,55,43,72,313,0.5853658536585366,66,117,70,40,50,67,410,0.4573643410852713,1.0
45,100,45,45,45,10,290,0.2949640287769784,95,75,180,130,80,30,590,0.13793103448275862,1.0
75,75,130,75,130,95,580,0.7479674796747967,95,145,130,120,90,120,700,0.9398496240601504,1.0
90,120,100,150,120,100,680,0.7718120805369127,65,60,110,130,95,65,525,0.47761194029850745,1.0
104,91,63,91,73,68,490,0.5118110236220472,50,70,160,70,160,90,600,0.7417218543046358,1.0
45,65,34,40,34,45,263,0.2589928057553957,30,65,100,45,25,40,305,0.1891891891891892,2.0
40,20,30,40,80,55,265,0.22764227642276422,80,100,70,50,60,45,405,0.25806451612903225,1.0
125,130,90,130,90,95,660,0.7734375,80,70,65,80,120,100,515,0.8034188034188035,0.5
85,60,65,135,105,100,550,0.7518248175182481,45,30,50,65,50,45,285,0.13821138211382114,2.0
90,92,75,92,85,60,494,0.49586776859504134,60,59,85,79,105,36,424,0.16666666666666666,0.5
55,35,50,55,110,85,390,0.6277372262773723,60,62,63,80,80,60,405,0.38016528925619836,2.0
100,100,80,60,60,50,450,0.3050847457627119,50,72,35,35,35,65,292,0.5373134328358209,2.0
40,50,90,30,55,65,330,0.44680851063829785,90,90,85,125,90,100,580,0.768595041322314,0.5
65,85,70,75,70,40,405,0.203125,59,110,150,45,49,35,448,0.3333333333333333,1.0
75,80,60,65,90,102,472,0.8625954198473282,55,81,60,50,70,97,413,0.7214285714285714,1.0
41,64,45,50,50,50,300,0.36752136752136755,50,75,70,35,70,48,348,0.29357798165137616,1.0
60,60,40,65,45,35,305,0.15833333333333333,105,130,120,45,45,40,485,0.4444444444444444,1.0
85,105,85,40,50,40,405,0.211864406779661,40,40,40,70,40,20,250,0.032520325203252036,1.0
55,50,45,135,95,120,500,0.7714285714285715,130,85,80,85,95,60,535,0.43884892086330934,1.0
75,105,75,105,75,45,480,0.3274336283185841,75,100,63,80,63,116,497,0.9345794392523364,1.0
95,125,79,60,100,81,540,0.6165413533834586,70,20,50,20,50,40,250,0.1557377049180328,0.5
135,85,40,40,85,5,390,0.6864406779661016,60,55,50,40,55,45,305,0.22377622377622378,1.0
45,67,60,35,50,63,320,0.5128205128205128,60,80,50,40,40,30,300,0.15328467153284672,1.0
30,65,100,45,25,40,305,0.1891891891891892,190,33,58,33,58,33,405,0.13432835820895522,1.0
90,70,80,70,95,70,475,0.5190839694656488,75,103,80,70,80,92,500,0.7933884297520661,1.0
60,60,60,35,35,30,280,0.11194029850746269,70,90,110,60,75,95,500,0.7333333333333333,1.0
49,66,70,44,55,51,335,0.4260869565217391,106,90,130,90,154,110,680,0.8699186991869918,1.0
60,50,150,50,150,60,520,0.5206611570247934,65,90,120,85,70,60,490,0.43410852713178294,1.0
45,35,45,62,53,35,275,0.11851851851851852,50,150,50,150,50,150,600,0.9339622641509434,1.0
60,75,100,55,80,50,420,0.3088235294117647,55,35,50,55,110,85,390,0.6277372262773723,1.0
60,70,65,125,105,90,515,0.6911764705882353,38,35,35,65,55,50,278,0.2647058823529412,2.0
72,85,70,65,70,58,420,0.41304347826086957,95,75,180,130,80,30,590,0.13793103448275862,2.0
40,45,35,30,40,55,245,0.3793103448275862,75,80,95,90,100,50,490,0.2158273381294964,4.0
106,130,90,110,154,90,680,0.719626168224299,75,98,63,98,63,101,498,0.889763779527559,0.5
90,110,80,100,80,95,555,0.7982456140350878,45,63,37,65,55,95,360,0.8055555555555556,1.0
105,30,105,140,105,55,540,0.3524590163934426,65,63,45,45,45,45,308,0.2595419847328244,0.5
50,80,95,10,45,10,290,0.232,65,80,80,59,63,58,405,0.4411764705882353,1.0
59,63,80,65,80,58,405,0.41843971631205673,75,95,60,65,60,115,470,0.8778625954198473,1.0
70,80,65,90,65,85,455,0.578125,60,62,80,63,80,60,405,0.4336283185840708,1.0
100,103,75,120,75,127,600,0.940677966101695,106,110,90,154,90,130,680,0.926829268292683,1.0
71,73,88,120,89,59,500,0.43537414965986393,50,70,100,40,40,30,330,0.2222222222222222,2.0
65,65,60,130,95,110,525,0.823943661971831,50,85,40,85,40,35,335,0.1746031746031746,1.0
40,65,95,60,45,35,340,0.13986013986013987,100,100,125,110,50,50,535,0.384,2.0
58,64,58,80,65,80,405,0.5423728813559322,59,66,70,44,55,41,335,0.25190839694656486,2.0
80,100,80,80,80,100,520,0.9051724137931034,125,58,58,76,76,67,460,0.515625,2.0
55,50,65,175,95,150,590,0.7818181818181819,40,40,40,70,40,20,250,0.032520325203252036,1.0
45,75,37,70,55,83,365,0.6183206106870229,120,100,85,30,85,45,465,0.22448979591836735,1.0
39,52,43,60,50,65,309,0.5041322314049587,25,20,15,105,55,90,310,0.32407407407407407,1.0
90,85,75,115,100,115,580,0.9381443298969072,86,76,86,116,56,95,515,0.7982456140350878,2.0
68,165,95,65,115,110,618,0.8615384615384616,65,125,60,95,60,105,510,0.9236641221374046,1.0
73,100,60,100,60,65,458,0.42657342657342656,70,80,50,35,35,35,305,0.14,1.0
45,30,35,20,20,45,195,0.14782608695652175,60,50,150,50,150,60,520,0.5206611570247934,0.25
60,55,50,40,55,45,305,0.22377622377622378,71,120,95,120,95,99,600,0.8203125,0.0
90,92,75,92,85,60,494,0.49586776859504134,90,120,75,60,60,45,450,0.29411764705882354,1.0
45,60,32,50,32,76,295,0.5925925925925926,100,134,110,95,100,61,600,0.4057971014492754,1.0
70,60,75,110,75,90,480,0.7165354330708661,95,110,80,70,80,50,485,0.37209302325581395,1.0
30,35,30,100,35,80,310,0.4765625,95,125,79,60,100,81,540,0.6165413533834586,1.0
75,140,65,112,65,110,567,0.9140625,45,55,45,65,45,75,330,0.5692307692307692,4.0
55,65,95,95,45,85,440,0.6610169491525424,65,130,60,75,60,75,465,0.689922480620155,1.0
50,53,48,53,48,64,316,0.358974358974359,70,77,60,97,60,108,472,0.8394160583941606,1.0
85,73,70,73,115,67,483,0.5126050420168067,59,45,40,35,40,31,250,0.14285714285714285,1.0
45,35,45,62,53,35,275,0.11851851851851852,59,45,40,35,40,31,250,0.14285714285714285,1.0
106,90,130,90,154,110,680,0.8699186991869918,41,56,40,62,44,71,314,0.568,1.0
60,65,70,85,75,40,395,0.21705426356589147,66,117,70,40,50,67,410,0.4573643410852713,0.5
25,20,15,105,55,90,310,0.32407407407407407,35,64,85,74,55,32,345,0.19827586206896552,1.0
50,160,110,160,110,110,700,0.8854961832061069,30,56,35,25,35,72,253,0.48148148148148145,1.0
50,120,53,35,110,87,455,0.640625,70,90,70,60,60,70,420,0.6390977443609023,2.0
40,65,40,80,40,65,330,0.5038167938931297,50,95,95,35,110,70,455,0.5179856115107914,0.5
68,90,65,50,55,82,410,0.6165413533834586,60,85,40,30,45,68,328,0.6422018348623854,1.0
60,70,65,125,105,90,515,0.6911764705882353,50,50,150,50,150,50,500,0.2571428571428571,2.0
59,45,40,35,40,31,250,0.14285714285714285,80,160,60,170,130,80,680,0.6180555555555556,1.0
110,85,95,80,95,50,515,0.2713178294573643,100,50,80,60,80,50,420,0.34375,1.0
50,50,120,80,80,30,410,0.07258064516129033,62,48,66,59,57,49,341,0.33884297520661155,1.0
40,40,50,30,30,30,220,0.0873015873015873,65,55,115,100,40,60,435,0.3798449612403101,0.5
75,95,95,95,95,85,540,0.6470588235294118,50,60,45,100,80,65,400,0.45689655172413796,0.5
55,55,50,45,65,55,325,0.37373737373737376,58,70,45,40,45,42,300,0.25925925925925924,1.0
73,100,60,100,60,65,458,0.42657342657342656,50,30,55,65,55,20,275,0.13675213675213677,0.5
80,45,65,90,110,80,470,0.5462962962962963,83,80,80,135,80,121,579,0.9444444444444444,1.0
70,55,65,95,85,70,440,0.5307692307692308,125,130,90,130,90,95,660,0.7734375,2.0
45,85,70,40,40,60,340,0.5229357798165137,95,117,80,65,70,92,519,0.8409090909090909,0.5
70,80,50,35,35,35,305,0.14,70,135,105,60,105,20,495,0.5806451612903226,1.0
60,52,168,47,138,30,495,0.19834710743801653,60,100,85,80,85,100,510,0.7007874015748031,0.5
70,50,30,95,135,105,485,0.8040540540540541,116,55,85,107,95,29,487,0.06818181818181818,1.0
255,10,10,75,135,55,540,0.3125,100,110,90,85,90,60,535,0.47794117647058826,1.0
70,110,80,55,80,105,500,0.8794326241134752,75,89,85,55,65,36,405,0.29545454545454547,4.0
50,180,20,180,20,150,600,0.9029850746268657,66,41,77,61,87,23,355,0.12096774193548387,1.0
90,92,87,75,85,76,505,0.5409836065573771,39,52,43,60,50,65,309,0.5041322314049587,2.0
100,150,90,180,160,90,770,0.7348484848484849,123,100,62,97,81,68,531,0.4806201550387597,0.5
55,55,55,85,55,30,335,0.1320754716981132,125,120,90,170,100,95,700,0.78125,1.0
50,60,60,60,60,30,320,0.11290322580645161,70,70,115,130,90,60,535,0.5338983050847458,0.0
110,80,90,95,90,65,530,0.5033557046979866,100,123,75,57,75,80,510,0.6923076923076923,2.0
55,47,52,40,40,41,275,0.16806722689075632,40,70,40,35,40,60,285,0.392,1.0
95,135,80,110,80,100,600,0.8248175182481752,45,80,100,35,37,28,325,0.3125,0.25
60,90,70,60,120,40,440,0.27419354838709675,110,135,60,50,65,88,508,0.7744360902255639,0.5
150,120,100,120,100,90,680,0.664179104477612,49,55,42,42,37,85,310,0.6068376068376068,0.0
60,40,80,60,45,40,325,0.23529411764705882,60,40,60,95,60,55,370,0.4222222222222222,0.5
60,50,40,85,75,95,405,0.7540983606557377,80,85,95,30,30,25,345,0.2857142857142857,0.0
55,20,35,20,45,75,250,0.37681159420289856,43,70,48,50,60,38,309,0.2391304347826087,0.0
50,85,55,65,65,90,410,0.7478260869565218,126,131,95,131,98,99,680,0.8294573643410853,1.0
105,125,100,60,100,100,590,0.8359375,76,25,45,67,55,24,292,0.0390625,1.0
101,72,72,99,89,29,462,0.1937984496124031,45,65,34,40,34,45,263,0.2589928057553957,1.0
35,85,45,35,35,75,310,0.6492537313432836,62,73,55,56,52,84,382,0.7244094488188977,1.0
45,95,50,40,50,75,355,0.54,120,70,120,75,130,85,600,0.6694915254237288,2.0
85,110,76,65,82,56,474,0.3933333333333333,70,75,80,135,80,135,575,0.917910447761194,1.0
40,45,65,100,120,90,460,0.5588235294117647,80,120,70,110,70,80,530,0.6422764227642277,1.0
85,90,80,70,80,130,535,0.9262295081967213,120,70,120,75,130,85,600,0.6694915254237288,1.0
70,120,40,95,40,95,460,0.8106060606060606,83,80,80,135,80,121,579,0.9444444444444444,1.0
103,93,67,71,61,84,479,0.7142857142857143,20,15,20,10,55,80,200,0.2682926829268293,1.0
40,80,100,30,30,20,300,0.11851851851851852,35,70,55,45,55,25,285,0.09420289855072464,0.5
105,95,80,40,80,90,490,0.753968253968254,20,40,90,30,90,25,295,0.11363636363636363,0.0
64,115,65,83,63,65,455,0.5323741007194245,50,75,70,35,70,48,348,0.29357798165137616,0.5
50,47,50,57,50,65,319,0.463768115942029,68,165,95,65,115,110,618,0.8615384615384616,1.0
80,110,60,150,130,70,600,0.5042016806722689,55,45,45,25,25,15,210,0.048,2.0
70,85,140,85,70,20,470,0.272,45,30,50,55,65,45,290,0.208,1.0
80,110,120,130,90,70,600,0.6198347107438017,100,100,90,150,140,90,670,0.71875,0.25
108,100,121,81,95,95,600,0.7476635514018691,35,65,35,65,35,65,300,0.46621621621621623,1.0
49,55,42,42,37,85,310,0.6068376068376068,20,25,45,70,90,60,310,0.30833333333333335,1.0
60,90,55,90,80,110,485,0.8677685950413223,110,160,110,80,110,100,670,0.8591549295774648,1.0
100,123,75,57,75,80,510,0.6923076923076923,50,85,125,85,115,20,480,0.4306569343065693,0.0
45,45,55,45,55,63,308,0.4594594594594595,50,80,95,10,45,10,290,0.232,2.0
66,65,48,62,57,52,350,0.36220472440944884,60,70,50,100,50,65,395,0.5217391304347826,0.25
50,53,48,53,48,64,316,0.4076923076923077,39,52,43,60,50,65,309,0.49107142857142855,0.5
45,67,60,35,50,63,320,0.5128205128205128,58,89,77,45,45,48,362,0.3177570093457944,1.0
90,90,85,125,90,100,580,0.768595041322314,50,50,120,80,80,30,410,0.07258064516129033,0.5
71,120,95,120,95,99,600,0.8203125,50,150,50,150,50,150,600,0.9339622641509434,2.0
55,55,45,63,45,45,308,0.25,106,130,90,110,154,90,680,0.719626168224299,2.0
75,80,95,90,100,50,490,0.2158273381294964,40,45,35,30,40,55,245,0.3793103448275862,0.25
80,185,115,40,105,75,600,0.6230769230769231,45,35,50,70,50,30,280,0.15753424657534246,2.0
64,165,75,93,83,75,555,0.6587301587301587,100,150,120,120,100,90,680,0.6493506493506493,1.0
79,103,120,135,115,78,630,0.5763888888888888,70,85,65,105,85,120,530,0.9262295081967213,0.5
58,109,112,48,48,109,484,0.8805970149253731,41,56,40,62,44,71,314,0.568,0.5
78,92,75,74,63,118,500,0.8842975206611571,95,125,79,60,100,81,540,0.6165413533834586,0.5
65,63,45,45,45,45,308,0.2595419847328244,65,136,94,54,96,135,580,0.9612403100775194,1.0
58,70,45,40,45,42,300,0.25925925925925924,60,50,50,60,70,50,340,0.28346456692913385,0.5
91,90,106,130,106,77,600,0.648854961832061,100,164,150,95,120,71,700,0.5645161290322581,1.0
53,51,53,61,56,40,314,0.14285714285714285,68,75,53,83,113,60,452,0.45384615384615384,0.5
65,130,60,75,60,75,465,0.689922480620155,67,125,40,30,30,58,350,0.3431372549019608,1.0
80,100,80,80,80,100,520,0.9051724137931034,60,85,69,65,79,80,438,0.576,2.0
44,58,44,58,44,61,309,0.41964285714285715,65,90,50,85,45,55,390,0.371900826446281,2.0
45,50,55,75,65,30,320,0.06293706293706294,90,95,105,165,110,45,610,0.2890625,0.5
65,65,65,50,50,90,385,0.72,79,105,70,145,80,101,580,0.8608695652173913,1.0
90,120,100,150,120,100,680,0.7718120805369127,44,38,39,61,79,42,303,0.2251655629139073,0.0
38,30,85,55,65,30,303,0.21428571428571427,60,85,69,65,79,80,438,0.576,1.0
68,165,95,65,115,110,618,0.8615384615384616,38,41,40,50,65,65,299,0.4108527131782946,1.0
70,135,105,60,105,20,495,0.5806451612903226,55,85,55,50,55,60,360,0.4233576642335766,0.25
50,65,107,105,107,86,520,0.7272727272727273,55,47,52,40,40,41,275,0.16806722689075632,1.0
85,105,85,40,50,40,405,0.211864406779661,45,30,35,20,20,45,195,0.14782608695652175,0.5
89,145,90,105,80,91,600,0.8549618320610687,35,45,160,30,45,70,385,0.48148148148148145,1.0
68,90,65,50,55,82,410,0.6165413533834586,55,95,115,45,45,35,390,0.2116788321167883,2.0
100,120,120,150,100,90,680,0.7880794701986755,40,30,30,55,30,85,270,0.4666666666666667,0.5
110,65,75,125,85,30,490,0.15,50,53,48,53,48,64,316,0.46153846153846156,1.0
79,105,70,145,80,101,580,0.8608695652173913,82,121,119,69,59,71,521,0.5394736842105263,0.25
90,93,55,70,55,55,418,0.3819444444444444,10,55,25,35,45,95,265,0.5396825396825397,1.0
95,110,95,40,95,55,490,0.40336134453781514,80,80,50,40,50,25,325,0.176056338028169,1.0
65,95,100,60,50,50,420,0.34959349593495936,60,45,70,45,90,95,405,0.7304964539007093,1.0
70,120,40,95,40,95,460,0.8106060606060606,64,66,68,81,76,50,405,0.25190839694656486,0.5
75,75,130,75,130,95,580,0.7479674796747967,45,55,45,65,45,75,330,0.5692307692307692,1.0
40,30,30,55,30,85,270,0.4666666666666667,65,50,70,95,80,65,425,0.4262295081967213,1.0
255,10,10,75,135,55,540,0.3125,50,120,53,35,110,87,455,0.640625,1.0
75,80,70,65,75,90,455,0.7578125,75,125,230,55,95,30,610,0.3448275862068966,0.0
50,20,55,25,25,30,205,0.09774436090225563,80,185,115,40,105,75,600,0.6230769230769231,0.5
43,80,65,50,35,35,308,0.14193548387096774,70,83,50,37,50,60,350,0.3360655737704918,1.0
45,50,43,40,38,62,278,0.40441176470588236,135,85,40,40,85,5,390,0.6864406779661016,1.0
75,89,85,55,65,36,405,0.29545454545454547,90,85,100,95,125,85,580,0.6834532374100719,0.5
55,85,55,50,55,60,360,0.4233576642335766,45,65,34,40,34,45,263,0.2589928057553957,1.0
60,100,115,70,85,90,520,0.7557251908396947,100,5,5,15,65,30,220,0.07692307692307693,1.0
45,45,35,20,30,20,195,0.07246376811594203,100,100,100,100,100,100,600,0.8805970149253731,1.0
85,76,64,45,55,90,415,0.6739130434782609,45,30,50,65,50,45,285,0.13821138211382114,1.0
53,54,53,37,46,45,288,0.3090909090909091,75,98,63,98,63,101,498,0.849624060150376,1.0
103,93,67,71,61,84,479,0.7142857142857143,60,52,168,47,138,30,495,0.19834710743801653,0.0
50,53,48,53,48,64,316,0.46153846153846156,40,40,55,40,70,55,300,0.40939597315436244,1.0
106,190,100,154,100,130,780,0.9259259259259259,75,95,67,125,95,83,540,0.7117117117117117,1.0
100,100,90,150,140,90,670,0.71875,50,53,48,53,48,64,316,0.46153846153846156,2.0
135,85,40,40,85,5,390,0.6864406779661016,70,83,50,37,50,60,350,0.3360655737704918,1.0
70,110,180,60,60,50,530,0.4117647058823529,63,63,47,41,41,74,329,0.56,1.0
40,50,45,70,45,70,320,0.5517241379310345,70,85,65,105,85,120,530,0.9262295081967213,2.0
71,95,85,110,95,79,535,0.664,45,35,45,62,53,35,275,0.11851851851851852,2.0
70,150,140,65,100,75,600,0.55,60,62,50,62,60,40,334,0.18181818181818182,4.0
80,80,90,110,130,110,600,0.8721804511278195,70,90,90,135,90,125,600,0.9401709401709402,0.0
150,100,120,100,120,90,680,0.6666666666666666,55,45,43,55,43,72,313,0.5853658536585366,2.0
50,85,55,65,65,90,410,0.7478260869565218,100,50,80,60,80,50,420,0.34375,0.5
68,65,65,125,115,80,518,0.6461538461538462,85,80,90,105,95,60,515,0.49074074074074076,1.0
70,110,180,60,60,50,530,0.4117647058823529,106,150,70,194,120,140,780,0.952,1.0
91,90,129,90,72,108,580,0.9140625,75,80,85,110,90,50,490,0.3548387096774194,0.5
39,52,43,60,50,65,309,0.49107142857142855,57,24,86,24,86,23,300,0.12727272727272726,2.0
95,65,110,60,130,65,525,0.5275590551181102,95,70,73,95,90,60,483,0.3983739837398374,0.5
60,60,40,65,45,35,305,0.15833333333333333,20,40,90,30,90,25,295,0.11363636363636363,1.0
80,100,80,80,80,100,520,0.9051724137931034,100,100,100,100,100,100,600,0.831858407079646,1.0
60,50,70,50,90,65,385,0.39568345323741005,65,95,57,100,85,93,495,0.7441860465116279,0.5
103,60,126,80,126,50,545,0.36363636363636365,75,95,95,95,95,85,540,0.6470588235294118,2.0
35,35,40,35,55,50,250,0.40336134453781514,70,60,70,87,78,85,450,0.6228070175438597,1.0
40,35,30,120,70,105,400,0.6692307692307692,103,60,86,60,86,50,445,0.3458646616541353,1.0
85,80,70,135,75,90,535,0.7006802721088435,95,110,80,70,80,50,485,0.37209302325581395,1.0
160,110,65,65,110,30,540,0.35714285714285715,85,105,55,85,50,115,495,0.9032258064516129,1.0
75,75,55,105,85,30,425,0.1619718309859155,73,95,62,85,65,85,465,0.6666666666666666,1.0
65,90,115,45,115,58,488,0.5041322314049587,70,84,70,65,70,51,410,0.2949640287769784,2.0
105,95,80,40,80,90,490,0.753968253968254,35,40,100,90,55,35,355,0.1796875,0.5
90,55,75,60,75,30,385,0.13970588235294118,50,70,50,50,50,70,340,0.5645161290322581,1.0
86,92,88,68,75,73,482,0.6835443037974683,40,65,95,60,45,35,340,0.13986013986013987,2.0
40,30,32,50,52,65,269,0.3671875,60,50,70,80,80,140,480,0.8449612403100775,1.0
72,58,80,103,80,97,490,0.7171052631578947,75,98,63,98,63,101,498,0.8091603053435115,2.0
70,20,50,20,50,40,250,0.1557377049180328,60,40,60,40,60,35,295,0.18055555555555555,0.5
45,25,50,25,25,35,205,0.13076923076923078,45,50,43,40,38,62,278,0.40441176470588236,0.5
50,50,62,40,62,65,329,0.4188034188034188,130,85,80,85,95,60,535,0.43884892086330934,1.0
55,45,50,45,65,80,340,0.5546218487394958,83,80,80,135,80,121,579,0.9444444444444444,0.5
30,45,135,45,90,30,375,0.09285714285714286,25,20,15,105,55,90,310,0.32407407407407407,1.0
60,60,60,60,60,60,360,0.38095238095238093,110,130,80,70,60,80,530,0.5862068965517241,1.0
70,110,180,60,60,50,530,0.4117647058823529,60,110,70,60,60,100,460,0.8461538461538461,2.0
75,75,130,75,130,95,580,0.7479674796747967,80,45,65,90,110,80,470,0.5462962962962963,0.5
75,103,80,70,80,92,500,0.7933884297520661,106,110,90,154,90,130,680,0.926829268292683,2.0
20,15,20,10,55,80,200,0.2682926829268293,70,65,65,55,55,70,380,0.5,1.0
45,49,49,65,65,45,318,0.2781954887218045,65,63,45,45,45,45,308,0.2595419847328244,0.5
50,75,45,40,45,60,315,0.4380165289256198,75,98,63,98,63,101,498,0.849624060150376,1.0
100,100,100,100,100,100,600,0.8778625954198473,90,92,87,75,85,76,505,0.5409836065573771,4.0
50,160,110,160,110,110,700,0.8854961832061069,55,45,45,25,25,15,210,0.048,0.5
70,80,65,90,65,85,455,0.578125,95,75,110,100,80,30,490,0.15267175572519084,0.5
70,55,65,95,85,70,440,0.5307692307692308,55,70,40,60,40,40,305,0.26956521739130435,2.0
60,60,75,60,75,80,410,0.7321428571428571,50,75,75,65,65,50,380,0.4049586776859504,0.0
100,134,110,95,100,61,600,0.4057971014492754,75,80,60,65,90,102,472,0.8625954198473282,1.0
60,85,42,85,42,91,405,0.8227848101265823,60,80,95,70,85,50,440,0.2231404958677686,0.5
72,105,115,54,86,68,500,0.5149253731343284,50,75,75,65,65,50,380,0.4049586776859504,1.0
59,63,80,65,80,58,405,0.41843971631205673,75,90,50,110,80,95,500,0.7985611510791367,2.0
77,120,90,60,90,48,485,0.2785714285714286,55,66,44,44,56,85,350,0.6888888888888889,1.0
55,75,85,25,25,15,280,0.1875,84,71,43,71,43,48,360,0.25874125874125875,1.0
65,110,130,60,65,95,525,0.8278145695364238,25,20,15,105,55,90,310,0.32407407407407407,1.0
40,30,35,45,40,55,245,0.31496062992125984,75,80,60,65,90,102,472,0.8625954198473282,1.0
80,90,80,130,110,110,600,0.856,65,90,65,61,61,100,442,0.8373983739837398,1.0
76,147,90,60,70,97,540,0.8267716535433071,67,82,62,46,48,43,348,0.22033898305084745,1.0
70,110,180,60,60,50,530,0.4117647058823529,58,64,58,80,65,80,405,0.609271523178808,1.0
55,35,50,55,110,85,390,0.6277372262773723,90,120,120,60,60,50,500,0.35294117647058826,1.0
85,97,66,105,66,65,484,0.47107438016528924,60,110,70,60,60,100,460,0.8461538461538461,1.0
50,64,50,45,50,41,300,0.22727272727272727,45,50,55,75,65,30,320,0.06293706293706294,1.0
80,160,60,170,130,80,680,0.6180555555555556,85,105,85,40,50,40,405,0.211864406779661,0.5
70,75,80,135,80,135,575,0.917910447761194,110,65,105,55,95,80,510,0.6258503401360545,2.0
45,50,45,115,55,95,405,0.6936936936936937,80,130,100,160,120,110,700,0.8981481481481481,2.0
70,43,53,43,53,40,302,0.19090909090909092,45,49,65,49,65,45,318,0.275,2.0
70,20,50,20,50,40,250,0.1557377049180328,45,65,34,40,34,45,263,0.2589928057553957,1.0
51,65,65,80,75,59,395,0.4365079365079365,80,75,150,75,150,50,580,0.30973451327433627,0.5
100,50,50,76,96,70,442,0.5,75,125,230,55,95,30,610,0.3448275862068966,0.25
55,75,85,25,25,15,280,0.1875,70,80,102,80,102,40,474,0.2677165354330709,4.0
65,90,122,58,75,84,494,0.71875,80,80,80,80,80,80,480,0.6015037593984962,1.0
85,100,122,58,75,54,494,0.3939393939393939,110,135,60,50,65,88,508,0.7744360902255639,1.0
70,140,230,60,80,50,630,0.32432432432432434,50,65,85,35,35,55,325,0.32575757575757575,2.0
60,150,50,150,50,60,520,0.5,70,77,60,97,60,108,472,0.8394160583941606,0.5
59,66,70,44,55,41,335,0.25190839694656486,40,55,70,45,60,30,300,0.10619469026548672,0.5
60,50,70,80,80,140,480,0.8449612403100775,50,53,48,53,48,64,316,0.4076923076923077,0.5
45,50,55,75,65,30,320,0.06293706293706294,65,65,45,75,45,95,390,0.72,0.25
70,55,65,95,85,70,440,0.5307692307692308,45,60,32,50,32,76,295,0.5925925925925926,1.0
43,70,48,50,60,38,309,0.2391304347826087,80,120,79,95,79,70,523,0.5833333333333334,1.0
73,100,60,100,60,65,458,0.42657342657342656,78,130,111,130,85,100,634,0.8561151079136691,1.0
120,70,120,75,130,85,600,0.6694915254237288,80,100,123,122,120,80,625,0.56,2.0
45,80,100,35,37,28,325,0.3125,55,45,43,55,43,72,313,0.5853658536585366,2.0
126,131,95,131,98,99,680,0.8102189781021898,37,25,41,25,41,25,194,0.08870967741935484,2.0
60,110,70,60,60,100,460,0.8461538461538461,70,70,115,130,90,60,535,0.5338983050847458,0.125
55,68,64,45,55,31,318,0.11666666666666667,75,80,95,90,100,50,490,0.2158273381294964,0.5
65,80,65,35,65,60,370,0.38405797101449274,60,55,145,75,150,40,525,0.2,0.25
55,69,85,32,35,28,304,0.09302325581395349,62,50,58,73,54,72,369,0.4435483870967742,0.5
100,90,130,45,65,55,485,0.4253731343283582,95,110,80,70,80,50,485,0.37209302325581395,2.0
60,45,70,75,85,55,390,0.3008130081300813,79,85,60,55,60,71,410,0.60431654676259,1.0
45,50,43,40,38,62,278,0.40441176470588236,38,36,38,32,36,57,237,0.3893805309734513,1.0
50,75,75,65,65,50,380,0.4049586776859504,55,50,65,175,95,150,590,0.7818181818181819,4.0
58,64,58,80,65,80,405,0.609271523178808,80,135,130,95,90,70,600,0.5181818181818182,2.0
58,109,112,48,48,109,484,0.8805970149253731,45,60,40,70,50,45,310,0.2846715328467153,0.25
95,125,79,60,100,81,540,0.6165413533834586,60,45,70,75,85,55,390,0.3008130081300813,1.0
75,98,63,98,63,101,498,0.8091603053435115,50,85,55,65,65,90,410,0.7478260869565218,0.5
70,140,230,60,80,50,630,0.32432432432432434,91,72,90,129,90,108,580,0.8925619834710744,0.5
55,69,85,32,35,28,304,0.09302325581395349,100,150,140,100,90,90,670,0.7969924812030075,2.0
50,85,85,55,55,50,380,0.3902439024390244,85,80,70,135,75,90,535,0.7006802721088435,1.0
65,50,70,95,80,65,425,0.4262295081967213,60,75,85,100,85,115,520,0.8992248062015504,0.5
82,121,119,69,59,71,521,0.5394736842105263,65,130,60,95,110,65,525,0.5303030303030303,2.0
50,70,100,40,40,30,330,0.2222222222222222,100,100,100,100,100,100,600,0.831858407079646,1.0
80,185,115,40,105,75,600,0.6230769230769231,126,131,95,131,98,99,680,0.8294573643410853,0.25
80,70,40,100,60,145,495,0.921875,64,115,65,83,63,65,455,0.5323741007194245,0.5
45,49,65,49,65,45,318,0.275,90,92,87,75,85,76,505,0.5409836065573771,1.0
50,100,150,100,150,50,600,0.37142857142857144,53,51,53,61,56,40,314,0.14285714285714285,1.0
60,48,45,43,90,42,328,0.21897810218978103,40,29,45,29,45,36,224,0.14634146341463414,1.0
100,100,100,100,100,100,600,0.8602941176470589,50,72,35,35,35,65,292,0.5373134328358209,2.0
65,65,60,110,95,130,525,0.9253731343283582,60,100,115,70,85,90,520,0.7557251908396947,1.0
44,48,65,50,64,43,314,0.1623931623931624,91,90,129,90,72,108,580,0.9140625,1.0
70,75,60,105,60,105,475,0.88,80,70,65,80,120,100,515,0.8034188034188035,2.0
75,80,60,65,90,102,472,0.8625954198473282,65,76,84,54,96,105,480,0.9008264462809917,1.0
78,81,71,74,69,126,499,0.9090909090909091,60,85,42,85,42,91,405,0.8227848101265823,1.0
60,90,55,90,80,110,485,0.8677685950413223,50,70,160,70,160,90,600,0.7417218543046358,1.0
65,55,115,100,40,60,435,0.3798449612403101,50,53,48,53,48,64,316,0.4076923076923077,0.5
60,150,50,150,50,60,520,0.5,60,60,60,85,85,85,435,0.631578947368421,2.0
80,90,80,130,110,110,600,0.856,65,150,60,115,60,115,565,0.935251798561151,0.0
60,60,75,60,75,80,410,0.7321428571428571,66,41,77,61,87,23,355,0.12096774193548387,2.0
75,69,72,114,100,104,534,0.8253968253968254,45,75,60,40,30,50,300,0.304,0.5
66,41,77,61,87,23,355,0.12096774193548387,74,48,76,83,81,104,466,0.7913043478260869,1.0
55,40,50,65,85,40,335,0.3181818181818182,106,190,100,154,100,130,780,0.9259259259259259,2.0
35,20,65,40,65,20,245,0.02459016393442623,55,65,35,60,30,85,330,0.6126126126126126,1.0
55,65,95,95,45,85,440,0.6610169491525424,60,60,60,105,105,105,495,0.848,1.0
65,90,120,85,70,60,490,0.43410852713178294,50,35,55,25,25,15,205,0.021739130434782608,1.0
100,100,100,100,100,100,600,0.831858407079646,190,33,58,33,58,33,405,0.13432835820895522,0.5
65,110,130,60,65,95,525,0.8278145695364238,45,65,34,40,34,45,263,0.2589928057553957,1.0
40,45,40,35,35,56,251,0.373015873015873,70,100,70,105,75,40,460,0.23214285714285715,1.0
40,30,50,55,55,100,330,0.584070796460177,65,80,65,35,65,60,370,0.38405797101449274,1.0
100,123,75,57,75,80,510,0.6923076923076923,70,45,48,60,65,35,323,0.15748031496062992,1.0
90,95,95,70,90,70,510,0.5230769230769231,82,80,86,85,75,72,480,0.6183206106870229,0.5
79,103,120,135,115,78,630,0.5763888888888888,103,60,126,80,126,50,545,0.36363636363636365,1.0
70,135,105,60,105,20,495,0.5806451612903226,79,115,70,125,80,111,580,0.864,0.25
80,135,85,70,95,150,615,0.9844961240310077,104,91,63,91,73,68,490,0.5118110236220472,1.0
77,120,90,60,90,48,485,0.2785714285714286,55,70,40,60,40,40,305,0.26956521739130435,1.0
60,30,30,36,56,50,262,0.32432432432432434,75,87,63,87,63,98,473,0.865546218487395,1.0
80,120,79,95,79,70,523,0.5833333333333334,91,90,129,90,72,108,580,0.9140625,1.0
85,110,76,65,82,56,474,0.3933333333333333,72,85,70,65,70,58,420,0.41304347826086957,0.25
85,60,65,135,105,100,550,0.7518248175182481,100,100,100,100,100,100,600,0.8602941176470589,4.0
105,95,80,40,80,90,490,0.753968253968254,30,80,90,55,45,55,355,0.4295774647887324,0.5
45,100,45,45,45,10,290,0.2949640287769784,70,70,70,70,70,70,420,0.5289256198347108,1.0
95,135,80,110,80,100,600,0.8248175182481752,40,45,35,65,55,70,310,0.4482758620689655,2.0
65,105,60,60,70,95,455,63.0,45,85,70,40,40,60,340,0.5229357798165137,4.0
45,85,50,55,50,65,350,0.5076923076923077,50,53,48,53,48,64,316,0.4076923076923077,1.0
50,50,120,80,80,30,410,0.07258064516129033,91,90,72,90,129,108,580,0.896,1.0
65,85,70,75,70,40,405,0.203125,62,50,58,73,54,72,369,0.4435483870967742,1.0
64,78,52,78,52,81,405,0.6422764227642277,40,30,35,45,40,55,245,0.31496062992125984,0.25
85,76,64,45,55,90,415,0.6739130434782609,65,100,70,80,80,105,500,0.8666666666666667,1.0
55,50,40,40,40,75,300,0.5945945945945946,60,85,60,85,60,55,405,0.3673469387755102,1.0
60,60,60,60,60,60,360,0.38095238095238093,70,43,53,43,53,40,302,0.19090909090909092,1.0
70,90,110,60,75,95,500,0.7333333333333333,79,105,70,145,80,101,580,0.8608695652173913,1.0
75,100,95,40,70,110,490,0.8717948717948718,67,57,55,77,55,114,425,0.8879310344827587,1.0
70,90,90,135,90,125,600,0.9401709401709402,130,70,35,70,35,60,400,0.4017857142857143,1.0
60,50,100,85,70,65,430,0.47580645161290325,50,65,107,105,107,86,520,0.6991150442477876,1.0
80,125,75,40,95,85,500,0.6911764705882353,44,38,39,61,79,42,303,0.2251655629139073,0.25
50,50,95,40,50,35,320,0.20279720279720279,120,100,85,30,85,45,465,0.22448979591836735,1.0
80,135,130,95,90,70,600,0.5181818181818182,48,72,48,72,48,48,336,0.25984251968503935,0.5
45,85,70,40,40,60,340,0.5229357798165137,50,100,150,100,150,50,600,0.37142857142857144,0.5
103,60,126,80,126,50,545,0.36363636363636365,40,70,130,60,130,25,455,0.17355371900826447,0.0
95,110,95,40,95,55,490,0.40336134453781514,92,105,90,125,90,98,600,0.8217054263565892,1.0
50,65,90,35,35,15,290,0.14678899082568808,50,64,50,45,50,41,300,0.22727272727272727,1.0
66,41,77,61,87,23,355,0.12096774193548387,65,75,105,35,65,85,430,0.6940298507462687,1.0
80,95,82,60,82,75,474,0.6,70,120,100,145,105,20,560,0.2824427480916031,0.5
60,50,150,50,150,60,520,0.5206611570247934,65,130,60,95,110,65,525,0.5303030303030303,0.5
150,100,120,100,120,90,680,0.6666666666666666,70,110,80,55,80,105,500,0.8794326241134752,1.0
20,25,45,70,90,60,310,0.30833333333333335,45,30,40,105,50,20,290,0.031007751937984496,0.5
90,132,105,132,105,30,594,0.4246575342465753,100,5,5,15,65,30,220,0.07692307692307693,1.0
30,56,35,25,35,72,253,0.48148148148148145,39,52,43,60,50,65,309,0.49107142857142855,1.0
90,130,80,65,85,55,505,0.4396551724137931,74,108,133,83,65,32,495,0.32142857142857145,2.0
65,65,60,130,95,110,525,0.823943661971831,83,80,80,135,80,121,579,0.9444444444444444,1.0
60,95,80,60,80,30,405,0.19480519480519481,90,85,100,95,125,85,580,0.6834532374100719,0.25
75,85,200,55,65,30,510,0.16778523489932887,50,65,64,44,48,43,314,0.2196969696969697,0.5
43,80,65,50,35,35,308,0.14193548387096774,65,105,60,60,70,95,455,63.0,1.0
106,90,130,90,154,110,680,0.8699186991869918,114,85,70,85,80,30,464,0.2066115702479339,4.0
70,40,50,55,50,25,290,0.061068702290076333,40,70,40,35,40,60,285,0.392,1.0
100,150,140,100,90,90,670,0.7969924812030075,64,115,65,83,63,65,455,0.5323741007194245,1.0
70,80,102,80,102,40,474,0.2677165354330709,100,100,100,100,100,100,600,0.8602941176470589,4.0
105,150,90,150,90,95,680,0.8285714285714286,105,180,100,180,100,115,780,0.9477611940298507,2.0
85,70,80,97,80,123,535,0.9304347826086956,123,100,62,97,81,68,531,0.4806201550387597,2.0
70,80,50,35,35,35,305,0.14,150,100,120,100,120,90,680,0.6666666666666666,0.0
44,38,39,61,79,42,303,0.2251655629139073,120,70,120,75,130,85,600,0.6694915254237288,1.0
75,90,140,60,60,40,465,0.3008130081300813,80,70,70,90,100,70,480,0.5609756097560976,1.0
40,27,60,37,50,66,280,0.36220472440944884,55,55,45,63,45,45,308,0.25,2.0
38,41,40,50,65,65,299,0.4108527131782946,61,84,65,70,70,70,420,0.5,0.5
45,50,35,55,75,40,300,0.21367521367521367,30,80,90,55,45,55,355,0.4295774647887324,1.0
60,45,50,90,80,70,395,0.625,62,77,62,50,42,65,358,0.4838709677419355,0.5
50,95,90,95,90,180,600,0.9172413793103448,125,58,58,76,76,67,460,0.515625,1.0
100,120,120,150,100,90,680,0.7880794701986755,105,130,120,45,45,40,485,0.4444444444444444,2.0
56,61,65,48,45,38,313,0.17567567567567569,50,65,107,105,107,86,520,0.7272727272727273,0.5
95,110,95,40,95,55,490,0.40336134453781514,76,65,45,92,42,91,411,0.7449664429530202,1.0
77,59,50,67,63,46,362,0.23140495867768596,61,84,65,70,70,70,420,0.5,2.0
85,115,80,105,80,50,515,0.3063063063063063,100,150,90,180,160,90,770,0.7348484848484849,2.0
45,100,45,45,45,10,290,0.2949640287769784,60,75,85,100,85,115,520,0.8992248062015504,1.0
60,45,70,45,90,95,405,0.7304964539007093,90,132,105,132,105,30,594,0.4246575342465753,0.5
65,130,60,95,110,65,525,0.5303030303030303,20,40,15,35,35,60,205,0.34285714285714286,1.0
95,65,65,110,130,60,525,0.4016393442622951,66,117,70,40,50,67,410,0.4573643410852713,2.0
55,40,85,80,105,40,405,0.23622047244094488,71,82,64,64,59,112,452,0.9327731092436975,1.0
70,110,180,60,60,50,530,0.4117647058823529,80,82,100,83,100,80,525,0.6821705426356589,1.0
53,51,53,61,56,40,314,0.14285714285714285,80,70,40,100,60,145,495,0.921875,1.0
105,105,75,65,100,50,500,0.37593984962406013,70,120,40,95,40,95,460,0.8106060606060606,1.0
60,85,42,85,42,91,405,0.8227848101265823,110,80,90,95,90,65,530,0.5033557046979866,1.0
110,65,75,125,85,30,490,0.15,60,85,60,50,50,125,430,0.9090909090909091,1.0
89,145,90,105,80,91,600,0.8549618320610687,70,55,65,95,85,70,440,0.5307692307692308,1.0
95,75,80,100,110,30,490,0.24242424242424243,56,61,65,48,45,38,313,0.17567567567567569,0.5
45,35,45,62,53,35,275,0.11851851851851852,126,131,95,131,98,99,680,0.8294573643410853,1.0
70,65,60,90,75,90,450,0.6571428571428571,58,64,58,80,65,80,405,0.5423728813559322,0.5
55,70,45,70,50,60,350,0.45,45,30,40,105,50,20,290,0.031007751937984496,1.0
109,66,84,81,99,32,471,0.2013888888888889,60,70,50,100,50,65,395,0.5217391304347826,0.0
65,90,50,85,45,55,390,0.371900826446281,63,120,85,90,55,55,468,0.2809917355371901,2.0
81,102,77,85,75,85,505,0.5642857142857143,68,75,53,83,113,60,452,0.45384615384615384,1.0
65,95,75,55,55,85,430,0.6933333333333334,60,130,80,60,60,70,460,0.5153846153846153,1.0
80,130,100,160,120,110,700,0.8981481481481481,55,85,55,50,55,60,360,0.4233576642335766,1.0
135,85,40,40,85,5,390,0.6864406779661016,40,35,30,120,70,105,400,0.6692307692307692,1.0
170,90,45,90,45,60,500,0.427536231884058,30,40,55,40,55,60,280,0.3237410071942446,1.0
44,38,39,61,79,42,303,0.2251655629139073,79,103,120,135,115,78,630,0.5763888888888888,1.0
20,40,90,30,90,25,295,0.11363636363636363,50,40,85,40,65,25,305,0.08870967741935484,1.0
60,50,100,85,70,65,430,0.47580645161290325,79,103,120,135,115,78,630,0.5763888888888888,0.5
70,83,50,37,50,60,350,0.3360655737704918,60,110,70,60,60,100,460,0.8461538461538461,1.0
65,150,60,115,60,115,565,0.935251798561151,85,60,65,135,105,100,550,0.7518248175182481,1.0
86,68,72,109,66,106,507,0.8099173553719008,55,55,85,65,85,35,380,0.2014388489208633,0.125
74,48,76,83,81,104,466,0.7322834645669292,60,90,55,90,80,110,485,0.8677685950413223,1.0
65,80,80,59,63,58,405,0.4411764705882353,65,47,55,73,75,85,400,0.65,1.0
100,123,75,57,75,80,510,0.6923076923076923,165,75,80,40,45,65,470,0.5151515151515151,1.0
20,10,230,10,230,5,505,0.0,10,55,25,35,45,95,265,0.5396825396825397,0.5
91,72,90,129,90,108,580,0.8620689655172413,40,20,30,40,80,55,265,0.22764227642276422,0.25
70,70,70,70,70,70,420,0.5289256198347108,35,40,100,90,55,35,355,0.1796875,0.5
60,85,40,30,45,68,328,0.6422018348623854,55,130,115,50,50,75,475,0.5982142857142857,1.0
60,60,50,40,50,75,335,0.5882352941176471,40,30,30,40,50,30,220,0.07936507936507936,1.0
100,100,100,100,100,100,600,0.8805970149253731,90,85,75,115,100,115,580,0.9381443298969072,1.0
126,131,95,131,98,99,680,0.8294573643410853,50,85,40,85,40,35,335,0.1746031746031746,1.0
76,25,45,67,55,24,292,0.0390625,55,40,85,80,105,40,405,0.23622047244094488,1.0
75,55,70,55,95,110,460,0.8444444444444444,70,110,180,60,60,50,530,0.4117647058823529,0.25
126,131,95,131,98,99,680,0.8294573643410853,30,56,35,25,35,72,253,0.48148148148148145,1.0
50,75,35,70,30,40,300,0.21296296296296297,60,150,50,150,50,60,520,0.5,0.0
43,30,55,40,65,97,330,0.6030534351145038,50,160,110,160,110,110,700,0.8854961832061069,2.0
67,89,116,79,116,33,500,0.2624113475177305,55,40,85,80,105,40,405,0.23622047244094488,0.5
40,30,30,40,50,30,220,0.07936507936507936,64,51,23,51,23,28,240,0.11363636363636363,1.0
65,60,110,130,95,65,525,0.47761194029850745,42,52,67,39,56,50,306,0.2868217054263566,0.5
80,120,70,110,70,80,530,0.6422764227642277,85,50,95,120,115,80,545,0.5793650793650794,0.25
60,40,60,40,60,35,295,0.18055555555555555,45,53,70,40,60,42,310,0.25735294117647056,0.25
50,65,85,35,35,55,325,0.32575757575757575,70,65,60,90,75,90,450,0.6571428571428571,1.0
35,80,50,50,70,120,405,0.84375,54,78,103,53,45,22,355,0.23255813953488372,2.0
99,68,83,72,87,51,460,0.417910447761194,50,105,125,55,95,50,480,0.375886524822695,0.25
55,55,50,45,65,55,325,0.37373737373737376,103,60,126,80,126,50,545,0.36363636363636365,1.0
45,85,70,40,40,60,340,0.5229357798165137,45,30,15,85,65,65,305,0.36220472440944884,4.0
35,55,40,45,40,60,275,0.35714285714285715,53,54,53,37,46,45,288,0.3090909090909091,1.0
85,105,100,79,83,78,530,0.5869565217391305,75,95,60,65,60,115,470,0.8778625954198473,1.0
55,50,65,175,95,150,590,0.7818181818181819,91,72,90,129,90,108,580,0.8925619834710744,1.0
60,50,40,85,75,95,405,0.7540983606557377,75,125,100,70,80,45,495,0.33035714285714285,1.0
65,90,40,45,80,75,395,0.625,40,30,30,40,50,30,220,0.07936507936507936,4.0
60,40,60,40,60,35,295,0.18055555555555555,40,50,45,70,45,70,320,0.5517241379310345,0.5
55,95,115,45,45,35,390,0.2116788321167883,68,85,65,165,135,100,618,0.8083333333333333,1.0
50,75,45,40,45,60,315,0.4380165289256198,60,90,140,50,50,40,430,0.2535211267605634,0.5
74,100,72,90,72,46,454,0.24561403508771928,60,75,100,55,80,50,420,0.3088235294117647,0.5
30,42,118,42,88,30,350,0.112,71,120,95,120,95,99,600,0.8203125,0.5
55,66,44,44,56,85,350,0.6888888888888889,125,130,90,130,90,95,660,0.7734375,1.0
38,30,85,55,65,30,303,0.21428571428571427,95,110,95,40,95,55,490,0.40336134453781514,0.0
55,112,45,74,45,70,401,0.559322033898305,60,90,70,60,120,40,440,0.27419354838709675,1.0
60,55,50,40,55,45,305,0.22377622377622378,78,130,111,130,85,100,634,0.8561151079136691,0.5
55,63,90,50,80,42,380,0.21138211382113822,75,75,60,83,60,60,413,0.39344262295081966,2.0
55,130,115,50,50,75,475,0.5982142857142857,76,65,45,92,42,91,411,0.7449664429530202,1.0
46,57,40,40,40,50,273,0.25,95,75,110,100,80,30,490,0.15267175572519084,1.0
50,85,40,85,40,35,335,0.1746031746031746,45,45,55,45,55,63,308,0.4594594594594595,0.5
63,120,85,90,55,55,468,0.2809917355371901,30,105,90,25,25,50,325,0.2773722627737226,0.5
55,68,64,45,55,31,318,0.11666666666666667,60,48,45,43,90,42,328,0.21897810218978103,1.0
90,60,70,75,70,45,410,0.23880597014925373,63,63,47,41,41,74,329,0.56,1.0
101,72,72,99,89,29,462,0.1937984496124031,75,95,60,65,60,115,470,0.8778625954198473,1.0
100,100,100,100,100,100,600,0.8778625954198473,50,70,50,50,50,40,310,0.16296296296296298,0.5
59,59,58,90,70,73,409,0.5826086956521739,70,80,102,80,102,40,474,0.2677165354330709,2.0
75,75,95,75,95,113,528,0.9015151515151515,60,25,35,70,80,60,330,0.3076923076923077,1.0
79,103,120,135,115,78,630,0.5763888888888888,75,80,70,65,75,90,455,0.7578125,1.0
60,130,80,60,60,70,460,0.5153846153846153,38,30,85,55,65,30,303,0.21428571428571427,0.0
71,95,85,110,95,79,535,0.664,78,104,78,159,115,100,634,0.8444444444444444,1.0
60,85,42,85,42,91,405,0.8227848101265823,55,55,50,45,65,55,325,0.37373737373737376,1.0
20,25,45,70,90,60,310,0.30833333333333335,44,50,91,24,86,10,305,0.1981981981981982,0.25
50,65,107,105,107,86,520,0.7758620689655172,80,110,60,150,130,70,600,0.5042016806722689,1.0
59,59,58,90,70,73,409,0.5826086956521739,66,117,70,40,50,67,410,0.4573643410852713,0.5
100,150,140,100,90,90,670,0.7969924812030075,78,92,75,74,63,118,500,0.8842975206611571,0.0
75,110,110,110,105,80,590,0.656934306569343,72,105,115,54,86,68,500,0.5149253731343284,1.0
70,95,125,65,75,45,475,0.33613445378151263,85,60,65,135,105,100,550,0.7518248175182481,2.0
74,100,72,90,72,46,454,0.24561403508771928,62,48,54,63,60,68,355,0.5178571428571429,1.0
50,92,108,92,108,35,485,0.2457627118644068,70,60,125,115,70,55,495,0.35507246376811596,1.0
41,56,40,62,44,71,314,0.568,45,95,50,40,50,75,355,0.54,2.0
55,68,64,45,55,31,318,0.11666666666666667,80,100,200,50,100,50,580,0.3472222222222222,2.0
80,120,70,110,70,80,530,0.6422764227642277,45,50,43,40,38,62,278,0.40441176470588236,1.0
45,75,37,70,55,83,365,0.6183206106870229,49,55,42,42,37,85,310,0.6068376068376068,1.0
45,75,37,70,55,83,365,0.6183206106870229,95,75,80,100,110,30,490,0.24242424242424243,0.5
44,48,65,50,64,43,314,0.1623931623931624,52,65,55,58,62,60,352,0.4482758620689655,1.0
40,35,30,120,70,105,400,0.6692307692307692,95,117,184,44,46,28,514,0.2975206611570248,1.0
38,35,40,27,25,35,200,0.08208955223880597,100,75,115,90,115,85,580,0.6446280991735537,1.0
30,105,90,25,25,50,325,0.2773722627737226,35,40,100,90,55,35,355,0.1796875,1.0
70,115,60,115,60,55,475,0.4647887323943662,50,65,85,35,35,55,325,0.32575757575757575,1.0
80,45,65,90,110,80,470,0.5462962962962963,50,65,107,105,107,86,520,0.6991150442477876,1.0
91,90,72,90,129,108,580,0.896,54,78,103,53,45,22,355,0.23255813953488372,8.0
73,95,62,85,65,85,465,0.6666666666666666,60,85,69,60,69,77,420,0.518796992481203,1.0
50,100,150,100,150,50,600,0.37142857142857144,55,95,115,45,45,35,390,0.2116788321167883,0.5
70,140,230,60,80,50,630,0.32432432432432434,1,90,45,30,30,40,236,0.33064516129032256,1.0
75,55,70,55,95,110,460,0.8444444444444444,65,100,70,80,80,105,500,0.8666666666666667,0.5
53,51,53,61,56,40,314,0.14285714285714285,85,105,100,79,83,78,530,0.5869565217391305,0.5
70,77,60,97,60,108,472,0.8394160583941606,60,82,45,45,45,74,351,0.5752212389380531,0.0
40,45,40,62,60,60,307,0.33884297520661155,30,42,118,42,88,30,350,0.112,1.0
75,75,55,105,85,30,425,0.1619718309859155,75,100,110,45,55,65,450,0.5333333333333333,2.0
90,90,85,125,90,100,580,0.768595041322314,78,84,78,109,85,100,534,0.8646616541353384,2.0
60,60,60,60,60,60,360,0.38095238095238093,95,60,79,100,125,81,540,0.6201550387596899,1.0
100,100,100,100,100,100,600,0.831858407079646,80,80,80,80,80,80,480,0.5606060606060606,1.0
53,51,53,61,56,40,314,0.14285714285714285,70,62,67,55,55,56,365,0.38513513513513514,1.0
70,77,60,97,60,108,472,0.8394160583941606,64,78,52,78,52,81,405,0.6422764227642277,0.25
35,60,44,40,54,55,288,0.366412213740458,75,100,95,40,70,110,490,0.8717948717948718,1.0
65,90,40,45,80,75,395,0.625,85,73,70,73,115,67,483,0.5126050420168067,2.0
73,115,60,60,60,90,458,0.6694915254237288,43,30,55,40,65,97,330,0.6030534351145038,1.0
78,84,78,109,85,100,534,0.8620689655172413,35,65,35,65,35,65,300,0.46621621621621623,0.5
80,52,50,90,50,89,411,0.6666666666666666,110,123,65,100,65,65,528,0.5217391304347826,0.5
100,120,120,150,100,90,680,0.7880794701986755,123,100,62,97,81,68,531,0.4806201550387597,1.0
80,75,150,75,150,50,580,0.30973451327433627,50,64,50,45,50,41,300,0.22727272727272727,2.0
65,155,120,65,90,105,600,0.8677685950413223,40,45,35,40,40,90,290,0.65,1.0
55,63,90,50,80,42,380,0.21138211382113822,50,48,43,46,41,60,288,0.47297297297297297,4.0
56,61,65,48,45,38,313,0.17567567567567569,70,77,60,97,60,108,472,0.8394160583941606,0.5
85,110,76,65,82,56,474,0.3933333333333333,60,50,150,50,150,60,520,0.5206611570247934,1.0
85,105,85,40,50,40,405,0.211864406779661,40,65,95,60,45,35,340,0.13986013986013987,0.5
30,42,118,42,88,30,350,0.112,35,55,40,45,40,60,275,0.35714285714285715,0.5
76,147,90,60,70,97,540,0.8267716535433071,95,75,110,100,80,30,490,0.15267175572519084,1.0
55,55,45,63,45,45,308,0.25,70,100,115,30,65,30,410,0.24390243902439024,2.0
67,58,57,81,67,101,431,0.8790322580645161,30,40,70,70,25,60,295,0.41353383458646614,2.0
100,100,125,110,50,50,535,0.384,110,160,110,80,110,100,670,0.8591549295774648,1.0
79,105,70,145,80,101,580,0.8608695652173913,50,65,64,44,48,43,314,0.2196969696969697,2.0
68,165,95,65,115,110,618,0.8615384615384616,65,65,45,75,45,95,390,0.72,0.25
65,65,60,110,95,130,525,0.9253731343283582,80,110,60,150,130,70,600,0.5042016806722689,1.0
50,85,40,85,40,35,335,0.1746031746031746,50,47,50,57,50,65,319,0.463768115942029,0.5
25,35,70,95,55,45,325,0.16783216783216784,103,93,67,71,61,84,479,0.7142857142857143,1.0
65,136,94,54,96,135,580,0.9612403100775194,64,66,68,81,76,50,405,0.25190839694656486,1.0
95,23,48,23,48,23,260,0.046153846153846156,62,77,62,50,42,65,358,0.4838709677419355,1.0
10,55,25,35,45,95,265,0.5396825396825397,65,155,120,65,90,105,600,0.8677685950413223,0.0
20,40,90,30,90,25,295,0.11363636363636363,106,150,70,194,120,140,780,0.952,2.0
50,65,90,35,35,15,290,0.14678899082568808,95,145,130,120,90,120,700,0.9398496240601504,0.5
55,75,85,25,25,15,280,0.1875,40,80,35,35,45,70,305,0.4661016949152542,0.5
81,102,77,85,75,85,505,0.5642857142857143,75,110,110,110,105,80,590,0.656934306569343,2.0
86,68,72,109,66,106,507,0.8099173553719008,30,30,42,30,42,70,244,0.4230769230769231,2.0
45,35,50,70,50,30,280,0.15753424657534246,50,47,50,57,50,65,319,0.463768115942029,0.5
70,60,70,87,78,85,450,0.6228070175438597,105,125,100,60,100,100,590,0.8359375,1.0
135,85,40,40,85,5,390,0.6864406779661016,70,80,70,80,70,110,480,0.6594202898550725,0.0
100,120,120,150,100,90,680,0.7880794701986755,55,112,45,74,45,70,401,0.559322033898305,2.0
70,120,65,45,85,125,510,0.9747899159663865,75,125,230,55,95,30,610,0.3448275862068966,1.0
80,82,78,95,80,85,500,0.6869565217391305,50,105,79,35,110,76,455,0.6214285714285714,1.0
40,60,30,31,31,70,262,0.4492753623188406,80,52,50,90,50,89,411,0.6666666666666666,2.0
60,150,50,150,50,60,520,0.5,108,112,118,68,72,47,525,0.2916666666666667,1.0
95,100,85,108,70,70,528,0.5652173913043478,100,150,90,180,160,90,770,0.7348484848484849,0.5
60,60,60,105,105,105,495,0.848,40,30,30,55,30,85,270,0.4666666666666667,1.0
105,180,100,180,100,115,780,0.9477611940298507,72,58,80,103,80,97,490,0.7171052631578947,1.0
90,85,100,95,125,85,580,0.6834532374100719,70,90,70,60,60,70,420,0.6390977443609023,1.0
70,90,70,60,60,70,420,0.6390977443609023,70,80,50,35,35,35,305,0.14,0.5
45,50,55,75,65,30,320,0.06293706293706294,90,93,55,70,55,55,418,0.3819444444444444,0.5
43,30,55,40,65,97,330,0.6030534351145038,80,120,130,55,65,45,495,0.37037037037037035,4.0
44,38,39,61,79,42,303,0.2251655629139073,75,125,230,55,95,30,610,0.3448275862068966,0.5
75,75,75,125,95,40,485,0.15671641791044777,50,47,50,57,50,65,319,0.463768115942029,1.0
44,48,65,50,64,43,314,0.1623931623931624,106,130,90,110,154,90,680,0.719626168224299,2.0
68,125,65,65,115,80,518,0.6277372262773723,50,47,50,57,50,65,319,0.463768115942029,0.5
85,70,80,97,80,123,535,0.9304347826086956,66,41,77,61,87,23,355,0.12096774193548387,1.0
35,64,85,74,55,32,345,0.19827586206896552,100,128,90,77,77,128,600,0.959349593495935,1.0
60,130,80,60,60,70,460,0.5153846153846153,85,60,65,135,105,100,550,0.7518248175182481,0.125
135,85,40,40,85,5,390,0.6864406779661016,45,55,45,65,45,75,330,0.5692307692307692,1.0
40,45,35,40,40,90,290,0.65,106,150,70,194,120,140,780,0.952,1.0
100,100,100,100,100,100,600,0.8778625954198473,50,35,55,25,25,15,205,0.05263157894736842,2.0
60,55,145,75,150,40,525,0.2,105,105,75,65,100,50,500,0.37593984962406013,1.0
50,70,160,70,160,90,600,0.7417218543046358,75,80,95,90,100,50,490,0.2158273381294964,1.0
70,120,100,145,105,20,560,0.2824427480916031,50,30,55,65,55,20,275,0.13675213675213677,1.0
120,120,120,120,120,120,720,0.9344262295081968,75,69,72,114,100,104,534,0.8253968253968254,1.0
40,80,35,35,45,70,305,0.4661016949152542,75,80,70,65,75,90,455,0.7578125,0.25
85,50,95,120,115,80,545,0.5793650793650794,1,90,45,30,30,40,236,0.33064516129032256,2.0
150,120,100,120,100,90,680,0.664179104477612,75,75,75,125,95,40,485,0.15671641791044777,2.0
50,50,95,40,50,35,320,0.20279720279720279,70,95,85,55,65,70,440,0.5,2.0
45,60,32,50,32,76,295,0.5925925925925926,55,45,45,25,25,15,210,0.048,0.0
60,50,70,50,90,65,385,0.39568345323741005,60,50,50,60,70,50,340,0.28346456692913385,4.0
78,81,71,74,69,126,499,0.9090909090909091,100,150,90,180,160,90,770,0.7348484848484849,0.5
60,100,89,55,69,112,485,0.9298245614035088,100,120,100,150,120,90,680,0.728,0.5
90,95,105,165,110,45,610,0.2890625,30,40,55,40,55,60,280,0.3237410071942446,1.0
68,65,65,125,115,80,518,0.6461538461538462,73,100,60,100,60,65,458,0.42657342657342656,1.0
255,10,10,75,135,55,540,0.3125,100,110,90,85,90,60,535,0.47794117647058826,1.0
60,62,63,80,80,60,405,0.38016528925619836,50,100,150,100,150,50,600,0.37142857142857144,2.0
60,82,45,45,45,74,351,0.5752212389380531,80,92,65,65,80,68,450,0.4824561403508772,1.0
75,123,67,95,85,95,540,0.7642276422764228,55,65,95,95,45,85,440,0.6610169491525424,2.0
54,78,103,53,45,22,355,0.23255813953488372,65,130,60,95,110,65,525,0.5303030303030303,4.0
64,88,50,88,50,106,446,0.9111111111111111,90,100,60,90,60,80,480,0.6422764227642277,0.5
75,85,200,55,65,30,510,0.16778523489932887,91,90,106,130,106,77,600,0.648854961832061,1.0
40,50,45,70,45,70,320,0.5517241379310345,49,49,56,49,61,66,330,0.5190839694656488,1.0
60,82,45,45,45,74,351,0.5752212389380531,45,60,45,25,45,55,275,0.29,1.0
130,85,80,85,95,60,535,0.43884892086330934,95,109,105,75,85,56,525,0.34513274336283184,4.0
70,100,115,30,65,30,410,0.24390243902439024,80,160,60,170,130,80,680,0.6180555555555556,1.0
66,65,48,62,57,52,350,0.36220472440944884,45,45,55,45,55,63,308,0.4594594594594595,0.5
45,55,39,35,39,42,255,0.18518518518518517,50,47,50,57,50,65,319,0.463768115942029,1.0
68,125,65,65,115,80,518,0.6277372262773723,66,117,70,40,50,67,410,0.4573643410852713,1.0
55,84,105,114,75,52,485,0.2890625,60,65,70,85,75,40,395,0.21705426356589147,0.5
99,68,83,72,87,51,460,0.417910447761194,62,55,52,109,94,109,481,0.7833333333333333,0.5
73,76,75,81,100,100,505,0.8110236220472441,65,125,100,60,70,70,490,0.6099290780141844,2.0
65,50,70,95,80,65,425,0.4262295081967213,100,150,90,180,160,90,770,0.7348484848484849,1.0
70,65,60,90,75,90,450,0.6571428571428571,105,125,100,60,100,100,590,0.8359375,1.0
126,131,95,131,98,99,680,0.8294573643410853,65,60,70,85,75,40,395,0.1796875,1.0
90,93,55,70,55,55,418,0.3819444444444444,70,100,115,30,65,30,410,0.24390243902439024,1.0
105,95,75,85,75,74,509,0.5714285714285714,67,89,116,79,116,33,500,0.2624113475177305,2.0
50,95,180,85,45,70,525,0.5298507462686567,110,160,110,80,110,100,670,0.8591549295774648,1.0
80,82,83,100,100,80,525,0.6742424242424242,75,110,110,110,105,80,590,0.656934306569343,1.0
64,165,75,93,83,75,555,0.6587301587301587,65,40,70,80,140,70,465,0.5954198473282443,1.0
45,20,50,60,120,50,345,0.24074074074074073,55,85,122,58,75,99,494,0.8099173553719008,1.0
60,55,90,145,90,80,520,0.6071428571428571,65,90,115,45,115,58,488,0.5041322314049587,0.5
65,83,57,95,85,105,490,0.8914728682170543,75,75,55,105,85,30,425,0.1619718309859155,0.5
77,59,50,67,63,46,362,0.23140495867768596,57,24,86,24,86,23,300,0.12727272727272726,0.25
59,66,70,44,55,41,335,0.25190839694656486,85,105,100,79,83,78,530,0.5869565217391305,2.0
60,80,50,50,50,40,330,0.23853211009174313,55,63,90,50,80,42,380,0.21138211382113822,1.0
95,135,80,110,80,100,600,0.8248175182481752,69,69,76,69,86,91,460,0.6554621848739496,1.0
75,75,130,75,130,95,580,0.7479674796747967,80,135,130,95,90,70,600,0.5181818181818182,0.25
50,50,40,30,30,50,250,0.2781954887218045,105,130,120,45,45,40,485,0.4444444444444444,4.0
115,115,85,90,75,100,580,0.8134328358208955,105,140,95,55,65,45,505,0.3,1.0
45,95,50,40,50,75,355,0.54,45,55,45,65,45,75,330,0.5692307692307692,2.0
68,75,53,83,113,60,452,0.45384615384615384,78,84,78,109,85,100,534,0.8620689655172413,1.0
40,70,130,60,130,25,455,0.17355371900826447,70,75,60,105,60,105,475,0.88,1.0
52,65,55,58,62,60,352,0.4482758620689655,65,155,120,65,90,105,600,0.8677685950413223,2.0
55,70,40,60,40,40,305,0.26956521739130435,60,60,60,35,35,30,280,0.11194029850746269,1.0
30,30,42,30,42,70,244,0.4230769230769231,75,95,60,65,60,115,470,0.8778625954198473,1.0
60,69,95,69,95,36,424,0.2608695652173913,55,69,85,32,35,28,304,0.09302325581395349,2.0
80,90,80,130,110,110,600,0.856,100,150,110,95,110,70,635,0.5923076923076923,2.0
55,75,85,25,25,15,280,0.1875,65,110,130,60,65,95,525,0.8278145695364238,1.0
50,72,35,35,35,65,292,0.5373134328358209,75,125,70,125,70,115,580,0.9037037037037037,2.0
70,95,125,65,75,45,475,0.33613445378151263,120,100,85,30,85,45,465,0.22448979591836735,0.25
55,104,105,94,75,52,485,0.36363636363636365,60,62,50,62,60,40,334,0.18181818181818182,0.5
40,70,40,35,40,60,285,0.392,45,55,45,65,45,75,330,0.5692307692307692,1.0
61,72,57,55,55,65,365,0.3984375,45,55,45,65,45,75,330,0.5692307692307692,1.0
100,120,100,150,120,90,680,0.728,86,92,88,68,75,73,482,0.6835443037974683,1.0
70,55,95,95,110,65,490,0.48872180451127817,45,35,45,62,53,35,275,0.11851851851851852,1.0
55,65,35,60,30,85,330,0.6126126126126126,82,121,119,69,59,71,521,0.5394736842105263,1.0
30,56,35,25,35,72,253,0.48148148148148145,35,45,160,30,45,70,385,0.48148148148148145,0.5
88,107,122,74,75,64,530,0.4596774193548387,76,147,90,60,70,97,540,0.8267716535433071,0.5
65,90,65,61,61,100,442,0.8373983739837398,95,100,85,108,70,70,528,0.5652173913043478,1.0
60,130,80,60,60,70,460,0.5153846153846153,95,124,78,69,71,58,495,0.37398373983739835,2.0
100,100,100,100,100,100,600,0.8758169934640523,35,60,44,40,54,55,288,0.366412213740458,2.0
91,90,129,90,72,108,580,0.9140625,30,105,90,25,25,50,325,0.2773722627737226,0.5
115,45,20,45,25,20,270,0.11538461538461539,40,30,50,55,55,100,330,0.584070796460177,1.0
53,54,53,37,46,45,288,0.3090909090909091,50,48,43,46,41,60,288,0.47297297297297297,2.0
95,135,80,110,80,100,600,0.8248175182481752,49,55,42,42,37,85,310,0.6068376068376068,1.0
90,100,90,125,85,90,580,0.7352941176470589,85,50,95,120,115,80,545,0.5793650793650794,1.0
105,95,75,85,75,74,509,0.5714285714285714,76,147,90,60,70,97,540,0.8267716535433071,0.5
44,48,65,50,64,43,314,0.1623931623931624,43,70,48,50,60,38,309,0.2391304347826087,0.5
56,61,65,48,45,38,313,0.17567567567567569,35,35,35,35,35,35,210,0.13385826771653545,1.0
73,115,60,60,60,90,458,0.6694915254237288,30,105,90,25,25,50,325,0.2773722627737226,1.0
80,85,95,30,30,25,345,0.2857142857142857,50,105,79,35,110,76,455,0.6214285714285714,0.5
50,60,45,100,80,65,400,0.45689655172413796,59,66,70,44,55,41,335,0.25190839694656486,0.5
70,110,180,60,60,50,530,0.4117647058823529,50,85,55,65,65,90,410,0.7478260869565218,1.0
90,100,90,125,85,90,580,0.7352941176470589,110,85,95,80,95,50,515,0.2713178294573643,1.0
71,120,95,120,95,99,600,0.8203125,90,100,90,125,85,90,580,0.7352941176470589,0.125
170,90,45,90,45,60,500,0.427536231884058,67,89,116,79,116,33,500,0.2624113475177305,1.0
40,50,90,30,55,65,330,0.44680851063829785,70,70,40,60,40,60,340,0.4247787610619469,8.0
70,45,48,60,65,35,323,0.15748031496062992,130,70,35,70,35,60,400,0.4017857142857143,1.0
55,45,45,25,25,15,210,0.048,70,94,50,94,50,66,424,0.48148148148148145,0.0
90,120,120,60,60,50,500,0.35294117647058826,45,60,40,70,50,45,310,0.2846715328467153,2.0
90,120,100,150,120,100,680,0.7718120805369127,78,70,61,50,61,100,420,0.8145161290322581,1.0
60,150,50,150,50,60,520,0.5,80,160,80,130,80,100,630,0.8455284552845529,0.5
40,35,30,120,70,105,400,0.6692307692307692,95,110,95,40,95,55,490,0.40336134453781514,1.0
60,40,60,95,60,55,370,0.4222222222222222,40,55,70,45,60,30,300,0.10619469026548672,2.0
80,160,80,130,80,100,630,0.8455284552845529,60,75,100,55,80,50,420,0.3088235294117647,2.0
73,100,60,100,60,65,458,0.42657342657342656,40,55,80,35,60,30,300,0.15037593984962405,0.0
50,60,60,60,60,30,320,0.11290322580645161,74,108,133,83,65,32,495,0.32142857142857145,0.5
75,90,90,140,90,115,600,0.9481481481481482,45,35,45,62,53,35,275,0.11851851851851852,2.0
90,85,100,95,125,85,580,0.6834532374100719,50,70,100,40,40,30,330,0.2222222222222222,0.125
65,83,57,95,85,105,490,0.8914728682170543,65,125,100,55,70,85,500,0.6532258064516129,1.0
100,164,150,95,120,71,700,0.5645161290322581,65,90,40,45,80,75,395,0.625,2.0
65,75,70,95,70,95,470,0.7272727272727273,67,58,57,81,67,101,431,0.8790322580645161,0.5
75,38,38,56,56,67,330,0.5263157894736842,60,115,105,65,70,80,495,0.7181818181818181,2.0
70,75,60,105,60,105,475,0.88,50,65,85,35,35,55,325,0.32575757575757575,1.0
80,82,83,100,100,80,525,0.6742424242424242,82,80,86,85,75,72,480,0.6183206106870229,2.0
75,75,75,125,95,40,485,0.15671641791044777,50,65,107,105,107,86,520,0.6991150442477876,1.0
90,93,55,70,55,55,418,0.3819444444444444,120,100,85,30,85,45,465,0.22448979591836735,1.0
60,90,55,90,80,110,485,0.8677685950413223,100,120,100,150,120,90,680,0.728,0.5
95,75,110,100,80,30,490,0.15267175572519084,95,109,105,75,85,56,525,0.34513274336283184,2.0
83,106,65,86,65,85,490,0.6640625,100,110,90,85,90,60,535,0.47794117647058826,0.5
100,134,110,95,100,61,600,0.4057971014492754,45,63,37,65,55,95,360,0.8055555555555556,1.0
45,50,35,55,75,40,300,0.21367521367521367,50,65,85,35,35,55,325,0.32575757575757575,1.0
90,110,80,100,80,95,555,0.7982456140350878,65,80,80,59,63,58,405,0.4411764705882353,0.5
65,136,94,54,96,135,580,0.9612403100775194,59,63,80,65,80,58,405,0.41843971631205673,1.0
51,65,65,80,75,59,395,0.4365079365079365,60,80,95,70,85,50,440,0.2231404958677686,0.5
65,95,57,100,85,93,495,0.7441860465116279,45,67,60,35,50,63,320,0.5128205128205128,0.5
50,160,110,160,110,110,700,0.8854961832061069,100,100,100,100,100,100,600,0.8345864661654135,1.0
80,80,80,55,55,90,440,0.6417910447761194,60,110,70,60,60,100,460,0.8461538461538461,1.0
30,40,55,40,55,60,280,0.3237410071942446,100,128,90,77,77,128,600,0.959349593495935,2.0
95,110,80,70,80,50,485,0.37209302325581395,50,60,45,100,80,65,400,0.45689655172413796,2.0
105,105,75,65,100,50,500,0.37593984962406013,70,83,50,37,50,60,350,0.3360655737704918,1.0
80,135,130,95,90,70,600,0.5181818181818182,65,150,40,15,80,145,495,0.9663865546218487,2.0
30,42,118,42,88,30,350,0.112,72,95,67,103,71,122,530,0.9606299212598425,0.5
70,120,100,145,105,20,560,0.2824427480916031,80,100,80,80,80,100,520,0.9051724137931034,0.5
50,52,48,65,50,55,320,0.33098591549295775,85,80,90,105,95,60,515,0.49074074074074076,1.0
80,160,60,170,130,80,680,0.6180555555555556,91,129,90,72,90,108,580,0.8536585365853658,0.5
70,62,67,55,55,56,365,0.38513513513513514,108,130,95,80,85,102,600,0.7637795275590551,0.5
95,145,130,120,90,120,700,0.9398496240601504,65,80,140,40,70,70,465,0.5223880597014925,0.25
30,56,35,25,35,72,253,0.48148148148148145,108,112,118,68,72,47,525,0.2916666666666667,1.0
95,75,80,100,110,30,490,0.24242424242424243,65,136,94,54,96,135,580,0.9612403100775194,1.0
70,110,80,55,80,105,500,0.8794326241134752,80,100,200,50,100,50,580,0.3472222222222222,0.5
75,80,55,25,35,35,305,0.18666666666666668,90,100,60,90,60,80,480,0.6422764227642277,2.0
165,75,80,40,45,65,470,0.5151515151515151,60,50,70,50,90,65,385,0.39568345323741005,1.0
40,55,99,40,79,47,360,0.26262626262626265,50,65,107,105,107,86,520,0.6991150442477876,0.5
91,90,106,130,106,77,600,0.648854961832061,100,120,120,150,100,90,680,0.7880794701986755,0.5
65,60,70,85,75,40,395,0.1796875,95,110,95,40,95,55,490,0.40336134453781514,1.0
39,52,43,60,50,65,309,0.5041322314049587,65,136,94,54,96,135,580,0.9612403100775194,1.0
65,80,65,35,65,60,370,0.38405797101449274,48,72,48,72,48,48,336,0.25984251968503935,1.0
45,22,60,27,30,29,213,0.07518796992481203,75,95,60,65,60,115,470,0.8778625954198473,1.0
70,120,100,145,105,20,560,0.2824427480916031,65,95,100,60,50,50,420,0.34959349593495936,0.5
41,50,37,50,37,66,281,0.5175438596491229,45,85,50,55,50,65,350,0.5076923076923077,0.5
50,60,60,60,60,30,320,0.11290322580645161,91,90,106,130,106,77,600,0.648854961832061,0.0
63,63,47,41,41,74,329,0.56,80,80,80,80,80,80,480,0.5606060606060606,1.0
190,33,58,33,58,33,405,0.13432835820895522,60,90,55,90,80,110,485,0.8677685950413223,1.0
38,41,40,50,65,65,299,0.4108527131782946,64,51,23,51,23,28,240,0.11363636363636363,1.0
85,105,100,79,83,78,530,0.5869565217391305,95,65,110,60,130,65,525,0.5275590551181102,1.0
75,85,200,55,65,30,510,0.16778523489932887,165,75,80,40,45,65,470,0.5151515151515151,0.5
86,68,72,109,66,106,507,0.8099173553719008,64,78,52,78,52,81,405,0.6422764227642277,0.5
57,80,91,80,87,75,470,0.5737704918032787,60,80,110,50,80,45,425,0.2833333333333333,1.0
45,35,50,70,50,30,280,0.15753424657534246,74,48,76,83,81,104,466,0.7913043478260869,1.0
91,72,90,129,90,108,580,0.8925619834710744,35,46,34,35,45,20,215,0.072,2.0
45,95,50,40,50,75,355,0.54,45,60,40,70,50,45,310,0.2846715328467153,1.0
70,40,50,55,50,25,290,0.061068702290076333,58,70,45,40,45,42,300,0.25925925925925924,4.0
110,85,95,80,95,50,515,0.2713178294573643,50,65,107,105,107,86,520,0.703125,1.0
90,95,105,165,110,45,610,0.2890625,45,85,70,40,40,60,340,0.5229357798165137,0.5
68,85,65,165,135,100,618,0.8083333333333333,45,50,55,75,65,30,320,0.06293706293706294,1.0
55,63,90,50,80,42,380,0.21138211382113822,95,75,180,130,80,30,590,0.13793103448275862,4.0
55,65,95,95,45,85,440,0.6610169491525424,66,65,48,62,57,52,350,0.36220472440944884,0.5
65,130,60,95,110,65,525,0.5303030303030303,30,30,42,30,42,70,244,0.4230769230769231,2.0
57,80,91,80,87,75,470,0.5737704918032787,48,61,40,61,40,50,300,0.2543859649122807,1.0
125,170,100,120,90,95,700,0.77,80,135,130,95,90,70,600,0.5181818181818182,0.25
80,45,65,90,110,80,470,0.5462962962962963,90,110,80,100,80,95,555,0.7982456140350878,1.0
55,66,44,44,56,85,350,0.6888888888888889,59,59,58,90,70,73,409,0.5826086956521739,1.0
100,100,80,60,60,50,450,0.3050847457627119,63,60,55,50,50,71,349,0.5289256198347108,0.0
50,95,90,95,90,180,600,0.9172413793103448,20,15,20,10,55,80,200,0.2682926829268293,1.0
75,87,63,87,63,98,473,0.865546218487395,95,117,184,44,46,28,514,0.2975206611570248,1.0
75,75,55,105,85,30,425,0.1619718309859155,55,70,40,60,40,40,305,0.26956521739130435,1.0
80,80,50,40,50,25,325,0.176056338028169,50,70,160,70,160,90,600,0.7417218543046358,1.0
76,65,45,92,42,91,411,0.7449664429530202,50,50,40,30,30,50,250,0.2781954887218045,1.0
55,55,50,45,65,55,325,0.37373737373737376,170,90,45,90,45,60,500,0.427536231884058,1.0
53,54,53,37,46,45,288,0.3090909090909091,106,90,130,90,154,110,680,0.8699186991869918,1.0
40,30,30,55,30,85,270,0.4666666666666667,65,95,75,55,55,85,430,0.6933333333333334,0.5
109,66,84,81,99,32,471,0.2013888888888889,105,95,75,85,75,74,509,0.5714285714285714,0.0
63,63,47,41,41,74,329,0.56,50,105,125,55,95,50,480,0.375886524822695,0.0
150,160,100,95,65,100,670,0.8866666666666667,76,147,90,60,70,97,540,0.8267716535433071,1.0
60,55,90,145,90,80,520,0.6071428571428571,53,51,53,61,56,40,314,0.14285714285714285,0.5
65,90,40,45,80,75,395,0.625,81,102,77,85,75,85,505,0.5642857142857143,0.125
100,120,120,150,100,90,680,0.7880794701986755,78,104,78,159,115,100,634,0.8444444444444444,0.5
73,95,62,85,65,85,465,0.6666666666666666,70,145,88,140,70,112,625,0.8888888888888888,0.5
40,40,35,50,100,70,335,0.5031847133757962,78,84,78,109,85,100,534,0.8620689655172413,2.0
100,150,140,100,90,90,670,0.7969924812030075,55,45,50,45,65,80,340,0.5546218487394958,0.0
50,65,85,35,35,55,325,0.32575757575757575,40,30,35,50,70,55,280,0.28205128205128205,1.0
60,79,105,59,85,36,424,0.17054263565891473,51,65,65,80,75,59,395,0.4365079365079365,1.0
75,75,95,75,95,113,528,0.9015151515151515,64,88,50,88,50,106,446,0.9111111111111111,1.0
50,70,100,40,40,30,330,0.2222222222222222,55,55,55,85,55,30,335,0.1320754716981132,1.0
59,110,150,45,49,35,448,0.3333333333333333,75,75,60,83,60,60,413,0.39344262295081966,0.5
75,100,63,80,63,116,497,0.9345794392523364,60,100,89,55,69,112,485,0.9298245614035088,1.0
65,76,84,54,96,105,480,0.9008264462809917,65,55,115,100,40,60,435,0.3798449612403101,1.0
65,90,65,61,61,100,442,0.8373983739837398,45,30,50,55,65,45,290,0.208,1.0
75,95,67,125,95,83,540,0.7117117117117117,55,40,85,80,105,40,405,0.23622047244094488,1.0
74,48,76,83,81,104,466,0.7322834645669292,75,125,230,55,95,30,610,0.3448275862068966,1.0
50,70,160,70,160,90,600,0.7417218543046358,65,85,70,75,70,40,405,0.203125,1.0
80,80,80,80,80,80,480,0.6015037593984962,105,95,80,40,80,90,490,0.753968253968254,1.0
150,80,44,90,54,80,498,0.625,70,110,75,145,85,145,630,0.9444444444444444,2.0
100,180,160,150,90,90,770,0.7520661157024794,61,78,95,56,58,57,405,0.40336134453781514,1.0
71,95,85,110,95,79,535,0.664,100,150,110,95,110,70,635,0.5923076923076923,1.0
80,80,80,55,55,90,440,0.6417910447761194,86,92,88,68,75,73,482,0.6835443037974683,1.0
45,50,55,75,65,30,320,0.06293706293706294,55,75,85,25,25,15,280,0.1875,1.0
75,123,67,95,85,95,540,0.7642276422764228,50,72,35,35,35,65,292,0.5373134328358209,0.0
70,45,48,60,65,35,323,0.15748031496062992,100,77,77,128,128,90,600,0.6901408450704225,1.0
73,95,62,85,65,85,465,0.6666666666666666,45,50,43,40,38,62,278,0.40441176470588236,1.0
50,53,48,53,48,64,316,0.358974358974359,125,130,90,130,90,95,660,0.7734375,0.5
82,80,86,85,75,72,480,0.6183206106870229,50,60,45,100,80,65,400,0.45689655172413796,0.5
106,90,130,90,154,110,680,0.8699186991869918,60,40,60,95,60,55,370,0.4222222222222222,1.0
90,100,60,90,60,80,480,0.6422764227642277,30,45,135,45,90,30,375,0.09285714285714286,2.0
78,84,78,109,85,100,534,0.8620689655172413,45,100,45,45,45,10,290,0.2949640287769784,1.0
120,120,120,120,120,120,720,0.9344262295081968,65,65,60,130,95,110,525,0.823943661971831,1.0
45,60,32,50,32,76,295,0.5925925925925926,60,150,50,150,50,60,520,0.5,1.0
60,79,105,59,85,36,424,0.17054263565891473,60,60,75,60,75,80,410,0.7321428571428571,1.0
100,100,100,100,100,100,600,0.8345864661654135,55,69,85,32,35,28,304,0.09302325581395349,1.0
97,165,60,65,50,58,495,0.3902439024390244,50,65,107,105,107,86,520,0.7272727272727273,2.0
60,60,60,85,85,85,435,0.631578947368421,55,75,85,25,25,15,280,0.1875,1.0
80,135,130,95,90,70,600,0.5181818181818182,45,80,100,35,37,28,325,0.3125,0.25
85,70,80,97,80,123,535,0.9304347826086956,85,50,95,120,115,80,545,0.5793650793650794,0.0
55,65,95,95,45,85,440,0.6610169491525424,150,120,100,120,100,90,680,0.664179104477612,0.5
60,85,42,85,42,91,405,0.8227848101265823,100,100,100,100,100,100,600,0.8805970149253731,1.0
70,55,95,95,110,65,490,0.48872180451127817,70,90,90,135,90,125,600,0.9401709401709402,0.0
80,125,75,40,95,85,500,0.6911764705882353,58,64,58,80,65,80,405,0.5423728813559322,0.5
79,100,80,110,90,121,580,0.968,91,134,95,100,100,80,600,0.6304347826086957,1.0
40,30,30,40,50,30,220,0.07936507936507936,90,50,34,60,44,70,348,0.6283185840707964,0.5
100,100,100,100,100,100,600,0.8805970149253731,40,30,32,50,52,65,269,0.3671875,0.5
50,70,100,40,40,30,330,0.2222222222222222,35,85,45,35,35,75,310,0.6492537313432836,2.0
72,60,30,20,30,25,237,0.11570247933884298,65,63,45,45,45,45,308,0.2595419847328244,1.0
75,75,130,75,130,95,580,0.7479674796747967,60,60,60,60,60,60,360,0.38095238095238093,1.0
95,23,48,23,48,23,260,0.046153846153846156,100,180,160,150,90,90,770,0.7520661157024794,2.0
95,85,85,65,65,35,430,0.2571428571428571,95,135,80,110,80,100,600,0.8248175182481752,0.0
65,75,105,35,65,85,430,0.6940298507462687,103,60,86,60,86,50,445,0.3458646616541353,1.0
50,50,150,50,150,50,500,0.2571428571428571,95,124,78,69,71,58,495,0.37398373983739835,2.0
108,170,115,120,95,92,700,0.7083333333333334,70,135,105,60,105,20,495,0.5806451612903226,0.5
86,81,97,81,107,43,495,0.203125,40,40,55,40,70,55,300,0.40939597315436244,1.0
73,76,75,81,100,100,505,0.8110236220472441,75,103,80,70,80,92,500,0.7933884297520661,4.0
60,40,60,40,60,35,295,0.18055555555555555,80,70,70,90,100,70,480,0.5609756097560976,1.0
90,93,55,70,55,55,418,0.3819444444444444,69,55,45,55,55,15,294,0.11666666666666667,1.0
40,27,60,37,50,66,280,0.36220472440944884,35,65,35,65,35,65,300,0.46621621621621623,2.0
75,89,85,55,65,36,405,0.29545454545454547,62,48,66,59,57,49,341,0.33884297520661155,1.0
123,77,72,99,92,58,521,0.4621212121212121,120,120,120,120,120,120,720,0.9344262295081968,1.0
55,85,122,58,75,99,494,0.8099173553719008,40,20,30,40,80,55,265,0.22764227642276422,0.25
86,92,88,68,75,73,482,0.6835443037974683,85,56,77,50,77,78,423,0.53125,2.0
74,48,76,83,81,104,466,0.7322834645669292,103,60,126,80,126,50,545,0.36363636363636365,1.0
65,65,60,130,95,110,525,0.823943661971831,106,90,130,90,154,110,680,0.8699186991869918,0.5
35,20,65,40,65,20,245,0.02459016393442623,70,62,67,55,55,56,365,0.38513513513513514,0.5
70,40,50,55,50,25,290,0.061068702290076333,62,48,66,59,57,49,341,0.33884297520661155,1.0
100,100,100,100,100,100,600,0.8805970149253731,55,75,60,75,60,103,428,0.7982456140350878,1.0
100,150,140,100,90,90,670,0.7969924812030075,55,75,85,25,25,15,280,0.1875,2.0
109,66,84,81,99,32,471,0.2013888888888889,56,61,65,48,45,38,313,0.17567567567567569,0.25
45,30,50,55,65,45,290,0.208,40,50,90,30,55,65,330,0.44680851063829785,2.0
58,89,77,45,45,48,362,0.3177570093457944,90,100,70,110,150,80,600,0.6037735849056604,2.0
50,75,35,70,30,40,300,0.21296296296296297,45,40,60,40,75,50,310,0.2926829268292683,0.5
85,135,130,60,80,25,515,0.40540540540540543,55,40,50,65,85,40,335,0.3181818181818182,1.0
55,45,50,45,65,80,340,0.5546218487394958,71,82,64,64,59,112,452,0.9327731092436975,1.0
60,65,80,170,95,130,600,0.8625954198473282,68,165,95,65,115,110,618,0.8615384615384616,2.0
75,80,95,90,100,50,490,0.2158273381294964,65,95,75,55,55,85,430,0.6933333333333334,1.0
70,65,65,55,55,70,380,0.5,45,30,35,20,20,45,195,0.14782608695652175,1.0
35,46,34,35,45,20,215,0.072,55,63,90,50,80,42,380,0.21138211382113822,1.0
43,30,55,40,65,97,330,0.6030534351145038,91,90,106,130,106,77,600,0.648854961832061,2.0
70,90,45,15,45,50,315,0.3629032258064516,55,65,35,60,30,85,330,0.6126126126126126,0.5
95,75,80,100,110,30,490,0.24242424242424243,70,70,70,70,70,70,420,0.5289256198347108,1.0
108,100,121,81,95,95,600,0.7476635514018691,85,97,66,105,66,65,484,0.47107438016528924,2.0
45,49,49,65,65,45,318,0.2781954887218045,70,55,95,95,110,65,490,0.48872180451127817,1.0
105,125,100,60,100,100,590,0.8359375,68,65,65,125,115,80,518,0.6461538461538462,1.0
38,35,40,27,25,35,200,0.08208955223880597,35,35,35,35,35,35,210,0.13385826771653545,0.5
80,90,80,130,110,110,600,0.856,55,75,60,75,60,103,428,0.7982456140350878,1.0
45,30,50,55,65,45,290,0.208,100,128,90,77,77,128,600,0.959349593495935,1.0
100,50,80,60,80,50,420,0.34375,45,30,40,105,50,20,290,0.031007751937984496,1.0
80,105,105,105,105,80,580,0.5939849624060151,75,38,38,56,56,67,330,0.5263157894736842,1.0
74,108,133,83,65,32,495,0.32142857142857145,70,77,60,97,60,108,472,0.8394160583941606,2.0
80,160,60,170,130,80,680,0.6180555555555556,50,85,40,85,40,35,335,0.1746031746031746,1.0
80,185,115,40,105,75,600,0.6230769230769231,70,130,100,55,80,65,500,0.608,0.5
62,77,62,50,42,65,358,0.4838709677419355,60,70,65,125,105,90,515,0.6911764705882353,2.0
40,30,32,50,52,65,269,0.3671875,105,95,75,85,75,74,509,0.5714285714285714,1.0
75,75,60,83,60,60,413,0.39344262295081966,85,115,80,105,80,50,515,0.3063063063063063,1.0
45,30,35,20,20,45,195,0.14782608695652175,74,48,76,83,81,104,466,0.7913043478260869,2.0
125,58,58,76,76,67,460,0.515625,50,35,55,25,25,15,205,0.05263157894736842,1.0
81,102,77,85,75,85,505,0.5642857142857143,74,48,76,83,81,104,466,0.7913043478260869,1.0
75,95,60,65,60,115,470,0.8778625954198473,60,80,95,70,85,50,440,0.2231404958677686,0.5
50,75,45,40,45,60,315,0.4380165289256198,50,55,50,36,30,43,264,0.2922077922077922,0.5
35,46,34,35,45,20,215,0.072,68,65,65,125,115,80,518,0.6461538461538462,1.0
70,60,70,87,78,85,450,0.6228070175438597,60,80,95,70,85,50,440,0.2231404958677686,0.5
100,150,90,180,160,90,770,0.7348484848484849,106,110,90,154,90,130,680,0.926829268292683,1.0
25,20,15,105,55,90,310,0.32407407407407407,91,90,129,90,72,108,580,0.9140625,0.5
61,72,57,55,55,65,365,0.3984375,50,65,90,35,35,15,290,0.14678899082568808,1.0
55,40,40,65,45,35,280,0.16428571428571428,85,110,76,65,82,56,474,0.3933333333333333,0.5
100,123,75,57,75,80,510,0.6923076923076923,90,85,75,115,100,115,580,0.9381443298969072,0.5
60,85,42,85,42,91,405,0.8227848101265823,62,48,66,59,57,49,341,0.33884297520661155,0.5
50,75,35,70,30,40,300,0.21296296296296297,92,105,90,125,90,98,600,0.8217054263565892,0.5
48,72,48,72,48,48,336,0.25984251968503935,50,50,62,40,62,65,329,0.4188034188034188,2.0
70,130,100,55,80,65,500,0.608,105,105,75,65,100,50,500,0.37593984962406013,0.5
95,75,110,100,80,30,490,0.15267175572519084,92,105,90,125,90,98,600,0.8217054263565892,0.0
60,95,80,60,80,30,405,0.19480519480519481,60,40,80,60,45,40,325,0.23529411764705882,2.0
62,44,50,44,50,55,305,0.3629032258064516,60,90,70,60,120,40,440,0.27419354838709675,1.0
30,30,30,30,30,30,180,0.12612612612612611,90,90,85,125,90,100,580,0.768595041322314,0.5
80,82,83,100,100,80,525,0.6742424242424242,44,75,35,63,33,45,295,0.2647058823529412,0.5
100,150,90,180,160,90,770,0.7348484848484849,75,75,95,75,95,113,528,0.9015151515151515,0.5
30,65,100,45,25,40,305,0.1891891891891892,70,115,60,115,60,55,475,0.4647887323943662,0.5
65,63,45,45,45,45,308,0.2595419847328244,55,70,40,60,40,40,305,0.26956521739130435,2.0
50,65,107,105,107,86,520,0.7272727272727273,54,45,47,75,98,52,371,0.39669421487603307,1.0
59,63,80,65,80,58,405,0.41843971631205673,30,105,90,25,25,50,325,0.2773722627737226,0.5
70,140,70,110,65,105,560,0.95,60,85,69,65,79,80,438,0.576,1.0
50,105,79,35,110,76,455,0.6214285714285714,76,65,45,92,42,91,411,0.7449664429530202,1.0
40,27,60,37,50,66,280,0.36220472440944884,43,80,65,50,35,35,308,0.14193548387096774,2.0
100,164,150,95,120,71,700,0.5645161290322581,72,58,80,103,80,97,490,0.7171052631578947,4.0
126,131,95,131,98,99,680,0.8102189781021898,60,80,95,70,85,50,440,0.2231404958677686,0.5
50,85,40,85,40,35,335,0.1746031746031746,60,50,50,60,70,50,340,0.28346456692913385,1.0
110,135,60,50,65,88,508,0.7744360902255639,90,120,75,60,60,45,450,0.29411764705882354,0.5
80,105,65,60,75,130,515,0.9645390070921985,50,75,45,40,45,60,315,0.4380165289256198,4.0
67,89,116,79,116,33,500,0.2624113475177305,45,60,30,80,50,65,330,0.4603174603174603,0.0
100,100,125,110,50,50,535,0.384,44,48,65,50,64,43,314,0.1623931623931624,2.0
85,135,130,60,80,25,515,0.40540540540540543,80,120,70,110,70,80,530,0.6422764227642277,1.0
50,53,48,53,48,64,316,0.4076923076923077,30,45,135,45,90,30,375,0.09285714285714286,2.0
75,80,95,90,100,50,490,0.2158273381294964,49,55,42,42,37,85,310,0.6068376068376068,1.0
80,82,78,95,80,85,500,0.6869565217391305,70,95,85,55,65,70,440,0.5,2.0
80,80,90,110,130,110,600,0.8721804511278195,61,78,95,56,58,57,405,0.40336134453781514,1.0
64,66,68,81,76,50,405,0.25190839694656486,50,75,35,70,30,40,300,0.21296296296296297,0.5
73,95,62,85,65,85,465,0.6666666666666666,70,40,50,55,50,25,290,0.061068702290076333,1.0
65,80,80,59,63,58,405,0.4411764705882353,60,25,35,70,80,60,330,0.3076923076923077,1.0
62,50,58,73,54,72,369,0.4435483870967742,116,55,85,107,95,29,487,0.06818181818181818,1.0
40,40,55,40,70,55,300,0.40939597315436244,60,85,69,60,69,77,420,0.518796992481203,1.0
75,69,72,114,100,104,534,0.8253968253968254,65,90,122,58,75,84,494,0.71875,2.0
89,145,90,105,80,91,600,0.8549618320610687,100,100,100,100,100,100,600,0.8758169934640523,1.0
50,70,100,40,40,30,330,0.2222222222222222,50,65,107,105,107,86,520,0.6991150442477876,0.5
20,25,45,70,90,60,310,0.30833333333333335,95,135,80,110,80,100,600,0.8248175182481752,2.0
114,85,70,85,80,30,464,0.2066115702479339,50,75,45,40,45,60,315,0.4380165289256198,0.5
72,95,67,103,71,122,530,0.9606299212598425,60,70,65,125,105,90,515,0.6911764705882353,0.5
71,73,88,120,89,59,500,0.43537414965986393,60,80,50,40,40,30,300,0.15328467153284672,1.0
44,38,39,61,79,42,303,0.2251655629139073,45,25,50,25,25,35,205,0.13076923076923078,0.5
109,66,84,81,99,32,471,0.2013888888888889,55,70,45,70,50,60,350,0.45,2.0
90,95,105,165,110,45,610,0.2890625,91,72,90,129,90,108,580,0.8620689655172413,2.0
100,150,120,120,100,90,680,0.6493506493506493,80,52,50,90,50,89,411,0.6666666666666666,2.0
72,58,80,103,80,97,490,0.7171052631578947,45,30,50,65,50,45,285,0.13821138211382114,0.5
65,50,70,95,80,65,425,0.4262295081967213,60,59,85,79,105,36,424,0.16666666666666666,1.0
100,150,110,95,110,70,635,0.5923076923076923,50,95,180,85,45,70,525,0.5298507462686567,0.5
70,60,70,87,78,85,450,0.6228070175438597,70,62,67,55,55,56,365,0.38513513513513514,0.5
100,150,140,100,90,90,670,0.7969924812030075,65,83,57,95,85,105,490,0.8914728682170543,2.0
90,60,70,75,70,45,410,0.23880597014925373,80,70,40,100,60,145,495,0.921875,1.0
45,95,50,40,50,75,355,0.54,90,50,34,60,44,70,348,0.6283185840707964,0.5
30,45,55,70,55,85,340,0.5633802816901409,70,150,140,65,100,75,600,0.55,1.0
55,55,55,85,55,30,335,0.1320754716981132,66,117,70,40,50,67,410,0.4573643410852713,1.0
108,130,95,80,85,102,600,0.7637795275590551,90,65,65,40,40,15,315,0.19672131147540983,1.0
50,65,90,35,35,15,290,0.14678899082568808,45,20,50,60,120,50,345,0.24074074074074073,0.5
50,64,50,45,50,41,300,0.22727272727272727,40,45,35,40,40,90,290,0.65,1.0
45,50,55,75,65,30,320,0.06293706293706294,68,65,65,125,115,80,518,0.6461538461538462,2.0
70,120,100,145,105,20,560,0.2824427480916031,55,63,90,50,80,42,380,0.21138211382113822,1.0
95,85,85,65,65,35,430,0.2571428571428571,55,45,45,25,25,15,210,0.048,1.0
55,70,55,40,55,85,360,0.7073170731707317,70,80,50,35,35,35,305,0.14,1.0
45,30,50,65,50,45,285,0.13821138211382114,50,65,107,105,107,86,520,0.703125,1.0
60,85,69,60,69,77,420,0.518796992481203,49,66,70,44,55,51,335,0.4260869565217391,0.0
45,35,50,70,50,30,280,0.15753424657534246,61,72,57,55,55,65,365,0.3984375,0.5
40,30,30,55,30,85,270,0.4666666666666667,30,30,30,30,30,30,180,0.12612612612612611,1.0
100,100,100,100,100,100,600,0.8602941176470589,100,100,100,100,100,100,600,0.8778625954198473,0.5
60,80,110,50,80,45,425,0.2833333333333333,50,72,35,35,35,65,292,0.5373134328358209,1.0
100,128,90,77,77,128,600,0.959349593495935,60,40,50,75,85,95,405,0.6044776119402985,1.0
50,45,45,35,35,50,260,0.23529411764705882,60,60,60,35,35,30,280,0.11194029850746269,1.0
110,135,60,50,65,88,508,0.7744360902255639,60,62,80,63,80,60,405,0.4336283185840708,0.5
125,120,90,170,100,95,700,0.78125,40,27,60,37,50,66,280,0.36220472440944884,0.0
74,48,76,83,81,104,466,0.7913043478260869,45,20,50,60,120,50,345,0.24074074074074073,1.0
35,65,35,65,35,65,300,0.46621621621621623,114,85,70,85,80,30,464,0.2066115702479339,0.5
71,73,88,120,89,59,500,0.43537414965986393,70,105,105,50,40,20,390,0.33587786259541985,2.0
50,20,40,20,40,20,190,0.0962962962962963,78,65,68,112,154,75,552,0.628099173553719,1.0
45,50,55,75,65,30,320,0.06293706293706294,64,78,52,78,52,81,405,0.6422764227642277,0.5
95,117,184,44,46,28,514,0.2975206611570248,45,65,34,40,34,45,263,0.2589928057553957,1.0
120,70,120,75,130,85,600,0.6694915254237288,43,70,48,50,60,38,309,0.2391304347826087,1.0
73,115,60,60,60,90,458,0.6694915254237288,70,130,100,55,80,65,500,0.608,0.5
60,80,50,50,50,40,330,0.23853211009174313,50,48,43,46,41,60,288,0.47297297297297297,1.0
63,120,85,90,55,55,468,0.2809917355371901,65,47,55,73,75,85,400,0.65,1.0
90,95,95,70,90,70,510,0.5230769230769231,103,60,126,80,126,50,545,0.36363636363636365,1.0
60,85,60,85,60,55,405,0.3673469387755102,108,100,121,81,95,95,600,0.7476635514018691,0.5
50,35,55,25,25,15,205,0.021739130434782608,78,70,61,50,61,100,420,0.8145161290322581,1.0
60,50,70,80,80,140,480,0.8449612403100775,80,105,65,60,75,130,515,0.9645390070921985,2.0
125,170,100,120,90,95,700,0.77,80,110,60,150,130,70,600,0.5042016806722689,1.0
45,100,135,65,135,45,525,0.29411764705882354,123,77,72,99,92,58,521,0.4621212121212121,1.0
100,50,80,60,80,50,420,0.34375,55,84,105,114,75,52,485,0.2890625,0.5
65,80,65,35,65,60,370,0.38405797101449274,58,50,145,95,105,30,483,0.2459016393442623,0.0
75,75,75,125,95,40,485,0.15671641791044777,65,150,60,115,60,115,565,0.935251798561151,0.0
90,120,120,60,60,50,500,0.35294117647058826,80,145,150,105,110,110,700,0.8692307692307693,2.0
20,15,20,10,55,80,200,0.2682926829268293,58,70,45,40,45,42,300,0.25925925925925924,1.0
75,103,80,70,80,92,500,0.7933884297520661,65,150,60,115,60,115,565,0.935251798561151,2.0
73,95,62,85,65,85,465,0.6666666666666666,75,75,130,75,130,95,580,0.7479674796747967,1.0
73,115,60,60,60,90,458,0.6694915254237288,76,25,45,67,55,24,292,0.0390625,1.0
75,100,66,60,66,115,482,0.918918918918919,75,125,100,70,80,45,495,0.33035714285714285,0.5
60,55,50,40,55,45,305,0.22377622377622378,50,95,180,85,45,70,525,0.5298507462686567,1.0
65,90,115,45,115,58,488,0.5041322314049587,75,80,95,90,100,50,490,0.2158273381294964,1.0
80,135,130,95,90,70,600,0.5181818181818182,50,65,107,105,107,86,520,0.7758620689655172,0.25
60,55,90,145,90,80,520,0.6071428571428571,40,45,40,35,35,56,251,0.373015873015873,0.0
66,41,77,61,87,23,355,0.12096774193548387,50,85,125,85,115,20,480,0.4306569343065693,1.0
45,67,60,35,50,63,320,0.5128205128205128,42,52,67,39,56,50,306,0.2868217054263566,1.0
55,75,50,40,40,80,340,0.6302521008403361,50,65,45,85,65,95,405,0.7238095238095238,2.0
50,65,64,44,48,43,314,0.2196969696969697,72,85,70,65,70,58,420,0.41304347826086957,0.5
70,110,75,145,85,145,630,0.9444444444444444,65,95,100,60,50,50,420,0.34959349593495936,1.0
85,56,77,50,77,78,423,0.53125,67,57,55,77,55,114,425,0.8879310344827587,0.0
105,95,75,85,75,74,509,0.5714285714285714,65,136,94,54,96,135,580,0.9612403100775194,1.0
69,55,45,55,55,15,294,0.11666666666666667,65,73,55,47,75,85,400,0.6846846846846847,0.5
80,70,70,90,100,70,480,0.5609756097560976,120,100,85,30,85,45,465,0.22448979591836735,1.0
44,58,44,58,44,61,309,0.41964285714285715,60,50,70,80,80,140,480,0.8449612403100775,1.0
90,95,105,165,110,45,610,0.2890625,30,30,42,30,42,70,244,0.4230769230769231,2.0
85,135,130,60,80,25,515,0.40540540540540543,75,100,95,40,70,110,490,0.8717948717948718,1.0
75,75,75,125,95,40,485,0.15671641791044777,106,90,130,90,154,110,680,0.8699186991869918,0.5
50,100,150,100,150,50,600,0.37142857142857144,75,125,230,55,95,30,610,0.3448275862068966,0.125
60,60,60,60,60,60,360,0.38095238095238093,150,120,100,120,100,90,680,0.664179104477612,0.0
95,60,79,100,125,81,540,0.6201550387596899,50,85,40,85,40,35,335,0.1746031746031746,0.5
65,125,100,60,70,70,490,0.6099290780141844,1,90,45,30,30,40,236,0.33064516129032256,2.0
40,45,40,62,60,60,307,0.33884297520661155,85,100,122,58,75,54,494,0.3939393939393939,2.0
68,165,95,65,115,110,618,0.8615384615384616,70,75,80,135,80,135,575,0.917910447761194,1.0
72,58,80,103,80,97,490,0.7171052631578947,100,150,110,95,110,70,635,0.5923076923076923,2.0
80,185,115,40,105,75,600,0.6230769230769231,79,115,70,125,80,111,580,0.864,0.25
55,50,45,135,95,120,500,0.7714285714285715,60,45,50,90,80,70,395,0.625,1.0
78,65,68,112,154,75,552,0.628099173553719,103,60,126,80,126,50,545,0.36363636363636365,1.0
78,104,78,159,115,100,634,0.8444444444444444,62,48,66,59,57,49,341,0.33884297520661155,1.0
97,165,60,65,50,58,495,0.3902439024390244,50,50,40,30,30,50,250,0.2781954887218045,1.0
85,120,70,50,60,100,485,0.8308823529411765,77,120,90,60,90,48,485,0.2785714285714286,1.0
100,110,90,85,90,60,535,0.47794117647058826,49,49,56,49,61,66,330,0.5190839694656488,0.5
46,57,40,40,40,50,273,0.25,75,75,75,125,95,40,485,0.15671641791044777,1.0
40,60,30,31,31,70,262,0.4492753623188406,255,10,10,75,135,55,540,0.3125,1.0
40,40,35,50,100,70,335,0.5031847133757962,80,80,80,80,80,80,480,0.5606060606060606,0.5
35,85,45,35,35,75,310,0.6492537313432836,95,110,80,70,80,50,485,0.37209302325581395,1.0
55,63,90,50,80,42,380,0.21138211382113822,70,115,60,115,60,55,475,0.4647887323943662,2.0
59,59,58,90,70,73,409,0.5826086956521739,44,50,91,24,86,10,305,0.1981981981981982,4.0
95,80,105,40,70,100,490,0.8046875,75,125,100,70,80,45,495,0.33035714285714285,0.5
70,85,140,85,70,20,470,0.272,55,75,85,25,25,15,280,0.1875,0.5
60,105,60,120,60,105,510,0.8849557522123894,110,65,75,125,85,30,490,0.15,2.0
105,30,105,140,105,55,540,0.3524590163934426,90,120,100,150,120,100,680,0.7718120805369127,0.25
50,100,150,100,150,50,600,0.37142857142857144,30,42,118,42,88,30,350,0.112,0.25
85,97,66,105,66,65,484,0.47107438016528924,89,124,80,55,80,55,483,0.5714285714285714,1.0
75,75,75,125,95,40,485,0.15671641791044777,59,63,80,65,80,58,405,0.41843971631205673,1.0
70,115,60,115,60,55,475,0.4647887323943662,70,90,70,60,60,70,420,0.6390977443609023,0.5
70,115,60,115,60,55,475,0.4647887323943662,45,25,50,25,25,35,205,0.13076923076923078,0.25
54,66,70,44,55,46,335,0.4214876033057851,75,123,67,95,85,95,540,0.7642276422764228,1.0
40,65,40,80,40,65,330,0.5038167938931297,40,40,55,40,70,55,300,0.40939597315436244,2.0
65,73,55,47,75,85,400,0.6846846846846847,105,150,90,150,90,95,680,0.8285714285714286,0.5
110,160,110,80,110,100,670,0.8591549295774648,55,63,90,50,80,42,380,0.21138211382113822,1.0
73,76,75,81,100,100,505,0.8110236220472441,40,60,30,31,31,70,262,0.4492753623188406,1.0
50,52,48,65,50,55,320,0.33098591549295775,41,50,37,50,37,66,281,0.5175438596491229,1.0
50,50,40,30,30,50,250,0.2781954887218045,66,117,70,40,50,67,410,0.4573643410852713,2.0
40,40,35,50,100,70,335,0.5031847133757962,80,135,85,70,95,150,615,0.9844961240310077,1.0
70,75,80,135,80,135,575,0.917910447761194,50,48,43,46,41,60,288,0.47297297297297297,0.0
74,108,133,83,65,32,495,0.32142857142857145,80,100,70,50,60,45,405,0.25806451612903225,0.5
50,50,120,80,80,30,410,0.07258064516129033,123,100,62,97,81,68,531,0.4806201550387597,2.0
40,55,30,30,30,60,245,0.43548387096774194,64,66,68,81,76,50,405,0.25190839694656486,1.0
100,75,115,90,115,85,580,0.6446280991735537,80,82,100,83,100,80,525,0.6821705426356589,0.5
77,85,51,55,51,65,384,0.5163934426229508,60,25,35,70,80,60,330,0.3076923076923077,2.0
150,120,100,120,100,90,680,0.664179104477612,75,85,200,55,65,30,510,0.16778523489932887,0.5
90,75,85,115,90,55,510,0.3445378151260504,50,65,90,35,35,15,290,0.14678899082568808,1.0
40,30,35,45,40,55,245,0.31496062992125984,74,94,131,54,116,20,489,0.4485294117647059,0.5
70,75,80,135,80,135,575,0.917910447761194,75,80,55,25,35,35,305,0.18666666666666668,1.0
50,75,75,65,65,50,380,0.4049586776859504,40,30,32,50,52,65,269,0.3671875,1.0
65,95,57,100,85,93,495,0.7441860465116279,50,52,48,65,50,55,320,0.33098591549295775,0.5
45,30,40,105,50,20,290,0.031007751937984496,60,50,70,50,90,65,385,0.39568345323741005,2.0
95,75,80,100,110,30,490,0.24242424242424243,100,103,75,120,75,127,600,0.940677966101695,0.5
65,90,122,58,75,84,494,0.71875,55,40,40,65,45,35,280,0.16428571428571428,1.0
20,40,90,30,90,25,295,0.11363636363636363,60,65,60,130,75,110,500,0.7719298245614035,2.0
70,70,40,60,40,60,340,0.4247787610619469,70,110,80,55,80,105,500,0.8794326241134752,0.25
70,43,53,43,53,40,302,0.19090909090909092,40,45,35,30,40,55,245,0.3793103448275862,0.5
83,80,80,135,80,121,579,0.9444444444444444,55,75,85,25,25,15,280,0.1875,0.25
38,41,40,50,65,65,299,0.4108527131782946,95,65,65,110,130,60,525,0.4016393442622951,1.0
62,48,66,59,57,49,341,0.33884297520661155,110,78,73,76,71,60,468,0.3333333333333333,1.0
72,105,115,54,86,68,500,0.5149253731343284,100,100,100,100,100,100,600,0.8778625954198473,4.0
65,65,65,50,50,90,385,0.72,50,50,95,40,50,35,320,0.20279720279720279,2.0
77,85,51,55,51,65,384,0.5163934426229508,40,40,50,30,30,30,220,0.0873015873015873,2.0
45,100,45,45,45,10,290,0.2949640287769784,105,150,90,150,90,95,680,0.8285714285714286,0.0
80,100,123,122,120,80,625,0.56,104,91,63,91,73,68,490,0.5118110236220472,1.0
106,130,90,110,154,90,680,0.719626168224299,75,95,125,45,75,95,510,0.8257575757575758,1.0
70,60,62,80,82,60,414,0.4375,100,164,150,95,120,71,700,0.5645161290322581,1.0
70,55,55,80,60,45,365,0.2222222222222222,56,61,65,48,45,38,313,0.17567567567567569,0.5
85,70,80,97,80,123,535,0.9304347826086956,65,70,60,65,65,115,440,0.8583333333333333,1.0
76,65,45,92,42,91,411,0.7449664429530202,40,40,50,30,30,30,220,0.0873015873015873,2.0
65,40,50,125,60,30,370,0.07258064516129033,62,77,62,50,42,65,358,0.4838709677419355,1.0
75,95,95,95,95,85,540,0.6470588235294118,40,55,30,30,30,85,270,0.688,1.0
50,48,43,46,41,60,288,0.47297297297297297,44,75,35,63,33,45,295,0.2647058823529412,1.0
90,85,100,95,125,85,580,0.6834532374100719,110,80,90,95,90,65,530,0.5033557046979866,0.25
40,40,40,70,40,20,250,0.032520325203252036,110,130,80,70,60,80,530,0.5862068965517241,2.0
80,120,79,95,79,70,523,0.5833333333333334,50,53,62,58,63,44,330,0.13709677419354838,2.0
75,98,63,98,63,101,498,0.889763779527559,50,70,50,50,50,40,310,0.16296296296296298,0.5
55,95,55,35,75,115,430,0.9380530973451328,90,75,75,90,100,70,500,0.5462184873949579,0.5
75,140,65,112,65,110,567,0.9140625,50,50,50,50,50,50,300,0.30708661417322836,2.0
44,75,35,63,33,45,295,0.2647058823529412,55,81,60,50,70,97,413,0.7214285714285714,0.0
80,80,80,55,55,90,440,0.6417910447761194,75,103,80,70,80,92,500,0.7933884297520661,1.0
35,55,35,30,30,35,220,0.23684210526315788,80,135,85,70,95,150,615,0.9844961240310077,1.0
80,115,80,65,55,93,488,0.7846153846153846,50,20,40,20,40,20,190,0.0962962962962963,1.0
50,95,180,85,45,70,525,0.5298507462686567,40,55,70,45,60,30,300,0.10619469026548672,0.5
100,150,140,100,90,90,670,0.7969924812030075,78,65,68,112,154,75,552,0.628099173553719,1.0
65,90,115,45,115,58,488,0.5041322314049587,70,120,40,95,40,95,460,0.8106060606060606,1.0
65,75,70,95,70,95,470,0.7272727272727273,45,30,50,65,50,45,285,0.13821138211382114,0.5
55,95,115,45,45,35,390,0.2116788321167883,80,120,130,55,65,45,495,0.37037037037037035,1.0
40,65,95,60,45,35,340,0.13986013986013987,80,80,80,80,80,80,480,0.6015037593984962,1.0
50,180,20,180,20,150,600,0.9029850746268657,95,117,80,65,70,92,519,0.8409090909090909,0.0
50,120,53,35,110,87,455,0.640625,105,105,75,65,100,50,500,0.37593984962406013,0.5
40,40,55,40,70,55,300,0.40939597315436244,50,65,107,105,107,86,520,0.703125,2.0
45,35,45,62,53,35,275,0.11851851851851852,78,84,78,109,85,100,534,0.8646616541353384,0.25
55,81,60,50,70,97,413,0.7214285714285714,60,62,63,80,80,60,405,0.38016528925619836,1.0
38,35,40,27,25,35,200,0.08208955223880597,116,55,85,107,95,29,487,0.06818181818181818,2.0
30,45,55,70,55,85,340,0.5633802816901409,150,100,120,100,120,90,680,0.6666666666666666,0.5
61,72,57,55,55,65,365,0.3984375,60,69,95,69,95,36,424,0.2608695652173913,0.0
90,55,75,60,75,30,385,0.13970588235294118,110,85,95,80,95,50,515,0.2713178294573643,1.0
63,63,47,41,41,74,329,0.56,85,120,70,50,60,100,485,0.8308823529411765,1.0
53,51,53,61,56,40,314,0.14285714285714285,60,90,70,60,120,40,440,0.27419354838709675,1.0
45,55,39,35,39,42,255,0.18518518518518517,80,110,60,150,130,70,600,0.5042016806722689,0.0
85,100,122,58,75,54,494,0.3939393939393939,75,123,67,95,85,95,540,0.7642276422764228,1.0
60,59,85,79,105,36,424,0.16666666666666666,60,40,60,40,60,35,295,0.18055555555555555,1.0
60,115,105,65,70,80,495,0.7181818181818181,75,98,63,98,63,101,498,0.849624060150376,0.5
100,75,115,90,115,85,580,0.6446280991735537,70,135,105,60,105,20,495,0.5806451612903226,1.0
64,78,52,78,52,81,405,0.6422764227642277,64,115,65,83,63,65,455,0.5323741007194245,0.0
60,80,50,50,50,40,330,0.23853211009174313,55,75,50,40,40,80,340,0.6302521008403361,1.0
70,60,125,115,70,55,495,0.35507246376811596,20,15,20,10,55,80,200,0.2682926829268293,0.5
95,109,105,75,85,56,525,0.34513274336283184,65,110,130,60,65,95,525,0.8278145695364238,0.25
70,110,75,145,85,145,630,0.9444444444444444,60,40,80,60,45,40,325,0.23529411764705882,0.5
50,53,48,53,48,64,316,0.4076923076923077,45,65,34,40,34,45,263,0.2589928057553957,1.0
54,45,47,75,98,52,371,0.39669421487603307,105,150,90,150,90,95,680,0.8285714285714286,2.0
54,45,47,75,98,52,371,0.39669421487603307,55,63,90,50,80,42,380,0.21138211382113822,1.0
125,120,90,170,100,95,700,0.78125,35,55,35,30,30,35,220,0.23684210526315788,1.0
55,50,40,40,40,75,300,0.5945945945945946,40,30,35,50,70,55,280,0.28205128205128205,1.0
60,45,70,45,90,95,405,0.7304964539007093,55,20,35,20,45,75,250,0.37681159420289856,1.0
76,147,90,60,70,97,540,0.8267716535433071,64,88,50,88,50,106,446,0.9111111111111111,1.0
50,20,40,20,40,20,190,0.0962962962962963,100,100,100,100,100,100,600,0.8602941176470589,1.0
40,55,30,30,30,85,270,0.688,20,10,230,10,230,5,505,0.0,0.5
50,80,95,10,45,10,290,0.232,40,70,130,60,130,25,455,0.17355371900826447,1.0
80,120,79,95,79,70,523,0.5833333333333334,80,100,70,60,70,95,475,0.7416666666666667,0.5
25,35,70,95,55,45,325,0.16783216783216784,45,55,39,35,39,42,255,0.18518518518518517,1.0
55,40,50,65,85,40,335,0.3181818181818182,45,30,40,105,50,20,290,0.031007751937984496,2.0
50,52,48,65,50,55,320,0.33098591549295775,100,134,110,95,100,61,600,0.4057971014492754,2.0
55,84,105,114,75,52,485,0.2890625,45,85,70,40,40,60,340,0.5229357798165137,1.0
76,48,48,57,62,34,325,0.11688311688311688,35,60,44,40,54,55,288,0.366412213740458,1.0
61,90,45,50,50,160,456,0.9230769230769231,50,75,35,70,30,40,300,0.21296296296296297,2.0
50,65,85,35,35,55,325,0.32575757575757575,75,125,70,125,70,115,580,0.9037037037037037,2.0
65,130,60,95,110,65,525,0.5303030303030303,70,65,60,90,75,90,450,0.6571428571428571,2.0
100,100,100,100,100,100,600,0.8602941176470589,30,45,55,70,55,85,340,0.5633802816901409,2.0
50,52,48,65,50,55,320,0.33098591549295775,85,50,95,120,115,80,545,0.5793650793650794,1.0
95,75,110,100,80,30,490,0.15267175572519084,70,140,230,60,80,50,630,0.32432432432432434,0.5
135,85,40,40,85,5,390,0.6864406779661016,50,47,50,57,50,65,319,0.463768115942029,1.0
49,66,70,44,55,51,335,0.4260869565217391,68,125,65,65,115,80,518,0.6277372262773723,2.0
80,120,79,95,79,70,523,0.5833333333333334,88,107,122,74,75,64,530,0.4596774193548387,0.5
250,5,5,35,105,50,450,0.15306122448979592,80,115,80,65,55,93,488,0.7846153846153846,1.0
60,65,70,85,75,40,395,0.21705426356589147,76,48,48,57,62,34,325,0.11688311688311688,2.0
40,65,95,60,45,35,340,0.13986013986013987,75,75,60,83,60,60,413,0.39344262295081966,1.0
60,90,55,90,80,110,485,0.8677685950413223,83,80,80,135,80,121,579,0.9444444444444444,2.0
70,45,48,60,65,35,323,0.15748031496062992,76,25,45,67,55,24,292,0.0390625,1.0
65,70,60,65,65,115,440,0.8583333333333333,45,25,50,25,25,35,205,0.13076923076923078,1.0
38,41,40,50,65,65,299,0.4108527131782946,50,47,50,57,50,65,319,0.463768115942029,2.0
50,65,107,105,107,86,520,0.7758620689655172,105,180,100,180,100,115,780,0.9477611940298507,0.5
55,112,45,74,45,70,401,0.559322033898305,45,30,50,55,65,45,290,0.208,1.0
75,75,60,83,60,60,413,0.39344262295081966,65,50,35,115,95,95,455,0.7333333333333333,1.0
35,80,50,50,70,120,405,0.84375,114,85,70,85,80,30,464,0.2066115702479339,1.0
90,65,65,40,40,15,315,0.19672131147540983,60,80,110,50,80,45,425,0.2833333333333333,4.0
39,52,43,60,50,65,309,0.5041322314049587,60,85,60,85,60,55,405,0.3673469387755102,0.5
43,70,48,50,60,38,309,0.2391304347826087,160,110,65,65,110,30,540,0.35714285714285715,0.0
70,110,70,115,70,90,525,0.75,75,100,66,60,66,115,482,0.918918918918919,2.0
59,74,50,35,50,35,303,0.3125,60,70,65,125,105,90,515,0.6911764705882353,1.0
70,85,140,85,70,20,470,0.272,74,108,133,83,65,32,495,0.32142857142857145,0.25
70,110,180,60,60,50,530,0.4117647058823529,70,85,65,105,85,120,530,0.9262295081967213,1.0
45,30,35,20,20,45,195,0.14782608695652175,81,102,77,85,75,85,505,0.5642857142857143,0.5
75,85,200,55,65,30,510,0.16778523489932887,65,105,60,60,70,95,455,63.0,1.0
75,95,67,125,95,83,540,0.7117117117117117,190,33,58,33,58,33,405,0.13432835820895522,1.0
70,80,65,90,65,85,455,0.578125,74,94,131,54,116,20,489,0.4485294117647059,0.25
49,55,42,42,37,85,310,0.6068376068376068,105,125,100,60,100,100,590,0.8359375,1.0
40,45,40,35,35,56,251,0.373015873015873,42,52,67,39,56,50,306,0.2868217054263566,0.25
30,30,42,30,42,70,244,0.4230769230769231,95,65,110,60,130,65,525,0.5275590551181102,2.0
95,60,79,100,125,81,540,0.6201550387596899,90,55,75,60,75,30,385,0.13970588235294118,1.0
55,84,105,114,75,52,485,0.2890625,72,105,115,54,86,68,500,0.5149253731343284,1.0
55,81,60,50,70,97,413,0.7214285714285714,60,110,70,60,60,100,460,0.8461538461538461,1.0
50,65,85,35,35,55,325,0.32575757575757575,30,105,90,25,25,50,325,0.2773722627737226,1.0
63,60,55,50,50,71,349,0.5289256198347108,65,105,60,60,70,95,455,63.0,2.0
58,70,45,40,45,42,300,0.25925925925925924,75,90,90,140,90,115,600,0.9481481481481482,2.0
30,42,118,42,88,30,350,0.112,100,90,130,45,65,55,485,0.4253731343283582,1.0
80,80,90,110,130,110,600,0.8721804511278195,90,93,55,70,55,55,418,0.3819444444444444,1.0
60,50,50,60,70,50,340,0.28346456692913385,40,45,35,40,40,90,290,0.65,1.0
65,47,55,73,75,85,400,0.65,80,80,50,40,50,25,325,0.176056338028169,0.5
63,120,85,90,55,55,468,0.2809917355371901,50,50,120,80,80,30,410,0.07258064516129033,4.0
55,40,40,65,45,35,280,0.16428571428571428,56,61,65,48,45,38,313,0.17567567567567569,0.5
75,90,50,110,80,95,500,0.7985611510791367,49,49,56,49,61,66,330,0.5190839694656488,0.5
60,69,95,69,95,36,424,0.2608695652173913,50,85,40,85,40,35,335,0.1746031746031746,2.0
77,85,51,55,51,65,384,0.5163934426229508,101,72,72,99,89,29,462,0.1937984496124031,0.5
55,75,50,40,40,80,340,0.6302521008403361,70,90,90,135,90,125,600,0.9401709401709402,1.0
50,60,45,100,80,65,400,0.45689655172413796,30,45,135,45,90,30,375,0.09285714285714286,1.0
55,50,40,40,40,75,300,0.5945945945945946,60,90,55,90,80,110,485,0.8677685950413223,1.0
60,65,70,85,75,40,395,0.21705426356589147,100,100,100,100,100,100,600,0.8805970149253731,2.0
95,70,73,95,90,60,483,0.3983739837398374,90,30,15,40,20,15,210,0.043478260869565216,1.0
101,72,72,99,89,29,462,0.1937984496124031,65,76,84,54,96,105,480,0.9008264462809917,1.0
55,55,45,63,45,45,308,0.25,60,50,40,85,75,95,405,0.7540983606557377,1.0
80,90,80,130,110,110,600,0.856,78,84,78,109,85,100,534,0.8646616541353384,1.0
41,50,37,50,37,66,281,0.5175438596491229,70,45,48,60,65,35,323,0.15748031496062992,0.5
35,60,44,40,54,55,288,0.366412213740458,70,140,70,110,65,105,560,0.95,1.0
90,70,80,70,95,70,475,0.5190839694656488,76,25,45,67,55,24,292,0.0390625,1.0
75,90,140,60,60,40,465,0.3008130081300813,35,35,35,35,35,35,210,0.13385826771653545,0.5
45,75,37,70,55,83,365,0.6183206106870229,40,55,30,30,30,60,245,0.43548387096774194,1.0
45,49,65,49,65,45,318,0.275,80,80,80,80,80,80,480,0.5606060606060606,2.0
60,85,60,50,50,125,430,0.9090909090909091,95,135,80,110,80,100,600,0.8248175182481752,1.0
80,100,70,50,60,45,405,0.25806451612903225,10,55,25,35,45,95,265,0.5396825396825397,1.0
50,65,45,85,65,95,405,0.7238095238095238,80,135,85,70,95,150,615,0.9844961240310077,1.0
65,125,60,95,60,105,510,0.9236641221374046,65,90,50,85,45,55,390,0.371900826446281,0.5
55,45,43,55,43,72,313,0.5853658536585366,57,24,86,24,86,23,300,0.12727272727272726,0.125
60,40,80,60,45,40,325,0.23529411764705882,103,60,86,60,86,50,445,0.3458646616541353,1.0
55,50,45,135,95,120,500,0.7714285714285715,110,78,73,76,71,60,468,0.3333333333333333,2.0
20,40,90,30,90,25,295,0.11363636363636363,44,38,39,61,79,42,303,0.2251655629139073,1.0
54,78,103,53,45,22,355,0.23255813953488372,79,100,80,110,90,121,580,0.968,2.0
100,50,80,60,80,50,420,0.34375,80,125,75,40,95,85,500,0.6911764705882353,2.0
65,40,70,80,140,70,465,0.5954198473282443,60,30,30,36,56,50,262,0.32432432432432434,1.0
70,150,140,65,100,75,600,0.55,91,72,90,129,90,108,580,0.8925619834710744,0.25
50,65,107,105,107,86,520,0.703125,61,90,45,50,50,160,456,0.9230769230769231,4.0
38,30,85,55,65,30,303,0.21428571428571427,50,105,79,35,110,76,455,0.6214285714285714,1.0
60,48,45,43,90,42,328,0.21897810218978103,40,70,40,35,40,60,285,0.392,1.0
95,70,73,95,90,60,483,0.3983739837398374,45,45,35,20,30,20,195,0.07246376811594203,1.0
40,55,70,45,60,30,300,0.10619469026548672,85,97,66,105,66,65,484,0.47107438016528924,0.5
76,25,45,67,55,24,292,0.0390625,65,40,70,80,140,70,465,0.5954198473282443,1.0
45,50,55,75,65,30,320,0.06293706293706294,55,75,85,25,25,15,280,0.1875,1.0
70,130,100,55,80,65,500,0.608,80,100,70,50,60,45,405,0.25806451612903225,0.5
40,27,60,37,50,66,280,0.36220472440944884,70,85,140,85,70,20,470,0.272,0.25
70,45,48,60,65,35,323,0.15748031496062992,78,104,78,159,115,100,634,0.8444444444444444,0.5
52,65,50,45,50,38,300,0.27419354838709675,78,84,78,109,85,100,534,0.8620689655172413,1.0
95,155,109,70,130,81,640,0.6788321167883211,55,45,43,55,43,72,313,0.5853658536585366,2.0
45,55,39,35,39,42,255,0.18518518518518517,41,56,40,62,44,71,314,0.568,1.0
45,100,135,65,135,45,525,0.29411764705882354,90,92,87,75,85,76,505,0.5409836065573771,1.0
40,80,35,35,45,70,305,0.4661016949152542,55,66,44,44,56,85,350,0.6888888888888889,2.0
50,52,48,65,50,55,320,0.33098591549295775,31,45,90,30,30,40,266,0.21929824561403508,2.0
60,62,80,63,80,60,405,0.4336283185840708,50,65,107,105,107,86,520,0.7758620689655172,2.0
40,40,50,30,30,30,220,0.0873015873015873,30,30,42,30,42,70,244,0.4230769230769231,0.25
90,65,65,40,40,15,315,0.19672131147540983,60,52,168,47,138,30,495,0.19834710743801653,1.0
75,75,75,125,95,40,485,0.15671641791044777,70,70,40,60,40,60,340,0.4247787610619469,0.0
90,120,120,60,60,50,500,0.35294117647058826,60,69,95,69,95,36,424,0.2608695652173913,1.0
62,50,58,73,54,72,369,0.4435483870967742,50,70,50,50,50,70,340,0.5645161290322581,0.5
65,50,35,115,95,95,455,0.7333333333333333,90,95,95,70,90,70,510,0.5230769230769231,0.5
90,50,34,60,44,70,348,0.6283185840707964,30,35,30,100,35,80,310,0.4765625,2.0
75,123,67,95,85,95,540,0.7642276422764228,38,35,35,65,55,50,278,0.2647058823529412,1.0
45,35,50,70,50,30,280,0.15753424657534246,65,55,115,100,40,60,435,0.3798449612403101,0.5
45,30,40,105,50,20,290,0.031007751937984496,50,100,150,100,150,50,600,0.37142857142857144,1.0
50,70,50,50,50,70,340,0.5645161290322581,109,66,84,81,99,32,471,0.2013888888888889,2.0
45,45,35,20,30,20,195,0.07246376811594203,74,48,76,83,81,104,466,0.7913043478260869,2.0
49,49,56,49,61,66,330,0.5190839694656488,108,130,95,80,85,102,600,0.7637795275590551,1.0
45,85,50,55,50,65,350,0.5076923076923077,60,85,49,60,49,60,363,0.4444444444444444,1.0
80,70,70,90,100,70,480,0.5609756097560976,75,95,60,65,60,115,470,0.8778625954198473,1.0
60,45,70,75,85,55,390,0.3008130081300813,120,70,120,75,130,85,600,0.6694915254237288,0.5
40,35,30,120,70,105,400,0.6692307692307692,95,124,78,69,71,58,495,0.37398373983739835,0.0
63,60,55,50,50,71,349,0.5289256198347108,82,121,119,69,59,71,521,0.5394736842105263,0.25
70,120,100,145,105,20,560,0.2824427480916031,50,53,48,53,48,64,316,0.46153846153846156,1.0
75,98,63,98,63,101,498,0.8091603053435115,30,105,90,25,25,50,325,0.2773722627737226,2.0
72,85,70,65,70,58,420,0.41304347826086957,91,90,72,90,129,108,580,0.896,0.5
38,30,41,30,41,60,240,0.2897196261682243,65,100,70,80,80,105,500,0.8666666666666667,1.0
60,75,100,55,80,50,420,0.3088235294117647,40,20,30,40,80,55,265,0.22764227642276422,1.0
40,55,30,30,30,60,245,0.43548387096774194,50,72,35,35,35,65,292,0.5373134328358209,1.0
75,89,85,55,65,36,405,0.29545454545454547,70,77,60,97,60,108,472,0.8394160583941606,0.5
40,50,90,30,55,65,330,0.44680851063829785,42,52,67,39,56,50,306,0.2868217054263566,0.5
70,110,80,55,80,105,500,0.8794326241134752,60,90,140,50,50,40,430,0.2535211267605634,0.125
105,140,55,30,55,95,480,0.8195488721804511,110,160,110,80,110,100,670,0.8591549295774648,1.0
80,82,78,95,80,85,500,0.6869565217391305,60,80,110,50,80,45,425,0.2833333333333333,2.0
50,65,107,105,107,86,520,0.703125,65,73,55,47,75,85,400,0.6846846846846847,1.0
85,76,64,45,55,90,415,0.6739130434782609,84,71,43,71,43,48,360,0.25874125874125875,1.0
80,135,85,70,95,150,615,0.9844961240310077,50,95,180,85,45,70,525,0.5298507462686567,2.0
110,123,65,100,65,65,528,0.5217391304347826,50,35,55,25,25,15,205,0.021739130434782608,1.0
60,100,115,70,85,90,520,0.7557251908396947,130,65,60,110,95,65,525,0.5227272727272727,0.5
70,100,115,30,65,30,410,0.24390243902439024,78,104,78,159,115,100,634,0.8444444444444444,4.0
35,40,100,90,55,35,355,0.1796875,71,95,85,110,95,79,535,0.664,2.0
60,80,110,50,80,45,425,0.2833333333333333,80,105,65,60,75,130,515,0.9645390070921985,0.0
62,73,55,56,52,84,382,0.7244094488188977,55,20,35,20,45,75,250,0.37681159420289856,1.0
55,70,40,60,40,40,305,0.26956521739130435,95,23,48,23,48,23,260,0.046153846153846156,1.0
78,130,111,130,85,100,634,0.8561151079136691,165,75,80,40,45,65,470,0.5151515151515151,0.5
65,80,65,35,65,60,370,0.38405797101449274,90,93,55,70,55,55,418,0.3819444444444444,1.0
43,70,48,50,60,38,309,0.2391304347826087,69,69,76,69,86,91,460,0.6554621848739496,2.0
85,80,70,135,75,90,535,0.7006802721088435,45,50,45,115,55,95,405,0.6936936936936937,0.0
60,50,70,80,80,140,480,0.8449612403100775,106,130,90,110,154,90,680,0.719626168224299,2.0
39,52,43,60,50,65,309,0.5041322314049587,78,84,78,109,85,100,534,0.8646616541353384,0.5
48,61,40,61,40,50,300,0.2543859649122807,80,70,40,100,60,145,495,0.921875,0.5
41,50,37,50,37,66,281,0.5175438596491229,68,165,95,65,115,110,618,0.8615384615384616,1.0
95,95,85,125,65,55,520,0.3894736842105263,40,45,35,30,40,55,245,0.3793103448275862,0.5
40,50,45,70,45,70,320,0.5517241379310345,100,77,77,128,128,90,600,0.6901408450704225,0.5
35,55,40,50,50,90,320,0.6838235294117647,60,52,168,47,138,30,495,0.19834710743801653,1.0
70,80,50,35,35,35,305,0.14,57,24,86,24,86,23,300,0.12727272727272726,1.0
48,72,48,72,48,48,336,0.25984251968503935,25,20,15,105,55,90,310,0.32407407407407407,0.5
105,150,90,150,90,95,680,0.8285714285714286,25,20,15,105,55,90,310,0.32407407407407407,1.0
105,180,100,180,100,115,780,0.9477611940298507,37,25,41,25,41,25,194,0.08870967741935484,2.0
135,85,40,40,85,5,390,0.6864406779661016,61,78,95,56,58,57,405,0.40336134453781514,1.0
55,45,45,25,25,15,210,0.048,76,25,45,67,55,24,292,0.0390625,1.0
72,58,80,103,80,97,490,0.7171052631578947,45,75,60,40,30,50,300,0.304,1.0
70,80,50,35,35,35,305,0.14,64,78,52,78,52,81,405,0.6422764227642277,1.0
45,30,50,65,50,45,285,0.13821138211382114,65,150,60,115,60,115,565,0.935251798561151,0.0
65,50,35,115,95,95,455,0.7333333333333333,63,60,55,50,50,71,349,0.5289256198347108,2.0
80,85,95,30,30,25,345,0.2857142857142857,53,54,53,37,46,45,288,0.3090909090909091,1.0
80,135,130,95,90,70,600,0.5181818181818182,80,185,115,40,105,75,600,0.6230769230769231,1.0
60,79,105,59,85,36,424,0.17054263565891473,61,84,65,70,70,70,420,0.5,1.0
95,75,180,130,80,30,590,0.13793103448275862,100,150,90,180,160,90,770,0.7348484848484849,0.5
90,132,105,132,105,30,594,0.4246575342465753,90,92,75,92,85,60,494,0.49586776859504134,0.5
45,100,45,45,45,10,290,0.2949640287769784,20,40,90,30,90,25,295,0.11363636363636363,1.0
42,52,67,39,56,50,306,0.2868217054263566,76,65,45,92,42,91,411,0.7449664429530202,2.0
100,100,100,100,100,100,600,0.8758169934640523,60,50,70,50,90,65,385,0.39568345323741005,2.0
45,49,65,49,65,45,318,0.275,70,75,60,105,60,105,475,0.88,1.0
62,73,55,56,52,84,382,0.7244094488188977,44,75,35,63,33,45,295,0.2647058823529412,1.0
55,50,45,135,95,120,500,0.7714285714285715,73,76,75,81,100,100,505,0.8110236220472441,1.0
70,100,115,30,65,30,410,0.24390243902439024,85,60,65,135,105,100,550,0.7518248175182481,4.0
76,48,48,57,62,34,325,0.11688311688311688,150,160,100,95,65,100,670,0.8866666666666667,1.0
63,63,47,41,41,74,329,0.56,30,45,135,45,90,30,375,0.09285714285714286,0.5
45,49,49,65,65,45,318,0.2781954887218045,90,120,75,60,60,45,450,0.29411764705882354,2.0
30,30,42,30,42,70,244,0.4230769230769231,105,105,75,65,100,50,500,0.37593984962406013,0.5
45,30,50,65,50,45,285,0.13821138211382114,60,50,150,50,150,60,520,0.5206611570247934,0.5
123,100,62,97,81,68,531,0.4806201550387597,50,65,107,105,107,86,520,0.703125,1.0
50,47,50,57,50,65,319,0.463768115942029,70,80,102,80,102,40,474,0.2677165354330709,1.0
46,57,40,40,40,50,273,0.25,70,60,62,80,82,60,414,0.4375,1.0
40,55,70,45,60,30,300,0.10619469026548672,75,80,70,65,75,90,455,0.7578125,1.0
90,92,75,92,85,60,494,0.49586776859504134,59,74,50,35,50,35,303,0.3125,4.0
45,100,135,65,135,45,525,0.29411764705882354,97,165,60,65,50,58,495,0.3902439024390244,1.0
45,30,15,85,65,65,305,0.36220472440944884,190,33,58,33,58,33,405,0.13432835820895522,0.5
150,80,44,90,54,80,498,0.625,60,85,69,60,69,77,420,0.518796992481203,0.0
40,35,30,20,20,50,195,0.23423423423423423,60,130,80,60,60,70,460,0.5153846153846153,2.0
105,30,105,140,105,55,540,0.3524590163934426,75,87,63,87,63,98,473,0.865546218487395,0.5
45,75,37,70,55,83,365,0.6183206106870229,123,77,72,99,92,58,521,0.4621212121212121,1.0
70,65,60,90,75,90,450,0.6571428571428571,73,95,62,85,65,85,465,0.6666666666666666,1.0
97,165,60,65,50,58,495,0.3902439024390244,40,30,30,55,30,85,270,0.4666666666666667,2.0
190,33,58,33,58,33,405,0.13432835820895522,64,88,50,88,50,106,446,0.9111111111111111,0.0
45,30,35,20,20,45,195,0.14782608695652175,80,82,100,83,100,80,525,0.6821705426356589,2.0
78,65,68,112,154,75,552,0.628099173553719,65,65,60,130,95,110,525,0.823943661971831,1.0
70,84,70,65,70,51,410,0.2949640287769784,75,100,66,60,66,115,482,0.918918918918919,1.0
76,48,48,57,62,34,325,0.11688311688311688,115,115,85,90,75,100,580,0.8134328358208955,2.0
40,45,40,35,35,56,251,0.373015873015873,45,75,37,70,55,83,365,0.6183206106870229,1.0
70,84,70,65,70,51,410,0.2949640287769784,45,100,135,65,135,45,525,0.29411764705882354,1.0
85,100,122,58,75,54,494,0.3939393939393939,91,90,106,130,106,77,600,0.648854961832061,0.25
50,50,40,30,30,50,250,0.2781954887218045,105,95,75,85,75,74,509,0.5714285714285714,1.0
75,80,55,25,35,35,305,0.18666666666666668,55,63,90,50,80,42,380,0.21138211382113822,0.5
100,150,120,120,100,90,680,0.6493506493506493,80,100,123,122,120,80,625,0.56,0.5
20,15,20,10,55,80,200,0.2682926829268293,65,150,60,115,60,115,565,0.935251798561151,1.0
60,70,65,125,105,90,515,0.6911764705882353,54,45,47,75,98,52,371,0.39669421487603307,2.0
105,140,55,30,55,95,480,0.8195488721804511,55,50,65,175,95,150,590,0.7818181818181819,1.0
60,55,145,75,150,40,525,0.2,70,140,230,60,80,50,630,0.32432432432432434,0.25
90,100,90,125,85,90,580,0.7352941176470589,41,64,45,50,50,50,300,0.36752136752136755,0.5
58,109,112,48,48,109,484,0.8805970149253731,70,110,75,145,85,145,630,0.9444444444444444,2.0
70,50,30,95,135,105,485,0.8040540540540541,50,150,50,150,50,150,600,0.9339622641509434,1.0
60,55,145,75,150,40,525,0.2,58,50,145,95,105,30,483,0.2459016393442623,1.0
89,125,90,115,80,101,600,0.8725490196078431,50,65,107,105,107,86,520,0.6991150442477876,2.0
40,55,30,30,30,85,270,0.688,62,44,50,44,50,55,305,0.3629032258064516,1.0
76,147,90,60,70,97,540,0.8267716535433071,105,140,55,30,55,95,480,0.8195488721804511,1.0
60,40,50,75,85,95,405,0.6044776119402985,80,185,115,40,105,75,600,0.6230769230769231,1.0
50,65,64,44,48,43,314,0.2196969696969697,91,72,90,129,90,108,580,0.8620689655172413,0.5
40,50,45,70,45,70,320,0.5517241379310345,65,50,35,115,95,95,455,0.7333333333333333,0.5
70,95,85,55,65,70,440,0.5,60,50,50,60,70,50,340,0.28346456692913385,1.0
55,85,122,58,75,99,494,0.8099173553719008,65,75,90,97,123,44,494,0.1987179487179487,0.25
85,105,85,40,50,40,405,0.211864406779661,150,160,100,95,65,100,670,0.8866666666666667,2.0
105,130,120,45,45,40,485,0.4444444444444444,80,95,82,60,82,75,474,0.6,2.0
76,25,45,67,55,24,292,0.0390625,49,49,56,49,61,66,330,0.5190839694656488,1.0
70,120,65,45,85,125,510,0.9747899159663865,60,45,70,75,85,55,390,0.3008130081300813,2.0
85,56,77,50,77,78,423,0.53125,89,124,80,55,80,55,483,0.5714285714285714,0.0
75,89,85,55,65,36,405,0.29545454545454547,74,108,133,83,65,32,495,0.32142857142857145,4.0
90,93,55,70,55,55,418,0.3819444444444444,85,56,77,50,77,78,423,0.53125,2.0
69,55,45,55,55,15,294,0.11666666666666667,90,70,80,70,95,70,475,0.5190839694656488,2.0
20,40,90,30,90,25,295,0.11363636363636363,60,65,60,130,75,110,500,0.7719298245614035,2.0
75,80,55,25,35,35,305,0.18666666666666668,60,100,115,70,85,90,520,0.7557251908396947,2.0
75,75,60,83,60,60,413,0.39344262295081966,55,84,105,114,75,52,485,0.2890625,0.5
60,100,89,55,69,112,485,0.9298245614035088,125,130,90,130,90,95,660,0.7734375,1.0
72,60,30,20,30,25,237,0.11570247933884298,50,55,50,36,30,43,264,0.2922077922077922,1.0
85,100,122,58,75,54,494,0.3939393939393939,45,90,20,65,20,65,305,0.5116279069767442,1.0
75,75,55,105,85,30,425,0.1619718309859155,55,85,122,58,75,99,494,0.8099173553719008,0.5
45,30,50,55,65,45,290,0.208,70,62,67,55,55,56,365,0.38513513513513514,2.0
53,51,53,61,56,40,314,0.14285714285714285,60,75,100,55,80,50,420,0.3088235294117647,1.0
40,30,32,50,52,65,269,0.3671875,35,60,44,40,54,55,288,0.366412213740458,0.5
89,145,90,105,80,91,600,0.8549618320610687,35,20,65,40,65,20,245,0.02459016393442623,1.0
50,65,45,85,65,95,405,0.7238095238095238,60,85,60,85,60,55,405,0.3673469387755102,0.5
70,94,50,94,50,66,424,0.48148148148148145,65,130,60,95,110,65,525,0.5303030303030303,0.5
90,120,75,60,60,45,450,0.29411764705882354,70,45,48,60,65,35,323,0.15748031496062992,1.0
60,50,70,50,90,65,385,0.39568345323741005,125,58,58,76,76,67,460,0.515625,1.0
55,55,85,65,85,35,380,0.2014388489208633,70,80,70,80,70,110,480,0.6594202898550725,2.0
64,78,52,78,52,81,405,0.6422764227642277,85,80,70,135,75,90,535,0.7006802721088435,2.0
50,55,50,36,30,43,264,0.2922077922077922,80,80,80,80,80,80,480,0.5606060606060606,1.0
62,48,66,59,57,49,341,0.33884297520661155,109,66,84,81,99,32,471,0.2013888888888889,1.0
105,140,55,30,55,95,480,0.8195488721804511,65,65,65,50,50,90,385,0.72,0.5
80,105,105,105,105,80,580,0.5939849624060151,100,100,90,150,140,90,670,0.71875,1.0
100,50,50,76,96,70,442,0.5,40,30,30,40,50,30,220,0.07936507936507936,2.0
70,90,90,135,90,125,600,0.9401709401709402,65,73,55,47,75,85,400,0.6846846846846847,1.0
115,140,130,55,55,40,535,0.4519230769230769,110,65,105,55,95,80,510,0.6258503401360545,0.0
78,104,78,159,115,100,634,0.8444444444444444,60,45,70,75,85,55,390,0.3008130081300813,1.0
58,109,112,48,48,109,484,0.8805970149253731,10,55,25,35,45,95,265,0.5396825396825397,1.0
86,81,97,81,107,43,495,0.203125,70,84,70,65,70,51,410,0.2949640287769784,2.0
45,50,43,40,38,62,278,0.40441176470588236,50,65,85,35,35,55,325,0.32575757575757575,0.5
65,40,50,125,60,30,370,0.07258064516129033,78,104,78,159,115,100,634,0.8444444444444444,1.0
60,62,50,62,60,40,334,0.18181818181818182,68,85,65,165,135,100,618,0.8083333333333333,1.0
40,30,30,55,30,85,270,0.4666666666666667,65,90,40,45,80,75,395,0.625,2.0
95,65,110,60,130,65,525,0.5275590551181102,40,45,40,65,40,65,295,0.5661764705882353,1.0
65,90,40,45,80,75,395,0.625,45,35,45,62,53,35,275,0.11851851851851852,4.0
36,50,50,65,60,44,305,0.16363636363636364,92,105,90,125,90,98,600,0.8217054263565892,2.0
100,100,100,100,100,100,600,0.8602941176470589,60,50,150,50,150,60,520,0.5206611570247934,0.5
50,80,95,10,45,10,290,0.232,50,45,45,35,35,50,260,0.23529411764705882,1.0
70,85,140,85,70,20,470,0.272,74,94,131,54,116,20,489,0.4485294117647059,4.0
62,44,50,44,50,55,305,0.3629032258064516,70,83,50,37,50,60,350,0.3360655737704918,1.0
70,92,65,80,55,98,460,0.8090909090909091,50,120,53,35,110,87,455,0.640625,1.0
95,75,80,100,110,30,490,0.24242424242424243,80,90,80,130,110,110,600,0.856,0.25
86,68,72,109,66,106,507,0.8099173553719008,135,85,40,40,85,5,390,0.6864406779661016,1.0
65,80,140,40,70,70,465,0.5223880597014925,30,80,90,55,45,55,355,0.4295774647887324,0.5
100,150,110,95,110,70,635,0.5923076923076923,86,81,97,81,107,43,495,0.203125,1.0
35,65,35,65,35,65,300,0.46621621621621623,90,60,60,40,40,40,330,0.29545454545454547,2.0
81,102,77,85,75,85,505,0.5642857142857143,91,134,95,100,100,80,600,0.6304347826086957,0.0
80,160,60,170,130,80,680,0.6180555555555556,80,70,65,80,120,100,515,0.8034188034188035,2.0
56,61,65,48,45,38,313,0.17567567567567569,80,115,80,65,55,93,488,0.7846153846153846,0.5
55,95,115,45,45,35,390,0.2116788321167883,170,90,45,90,45,60,500,0.427536231884058,1.0
70,55,65,95,85,70,440,0.5307692307692308,55,40,85,80,105,40,405,0.23622047244094488,2.0
65,75,90,97,123,44,494,0.1987179487179487,35,60,44,40,54,55,288,0.366412213740458,0.5
80,90,80,130,110,110,600,0.856,55,55,85,65,85,35,380,0.2014388489208633,1.0
50,52,48,65,50,55,320,0.33098591549295775,60,150,50,150,50,60,520,0.5,1.0
50,50,62,40,62,65,329,0.4188034188034188,77,59,50,67,63,46,362,0.23140495867768596,0.5
60,80,50,40,40,30,300,0.15328467153284672,40,55,30,30,30,85,270,0.688,1.0
35,35,35,35,35,35,210,0.13385826771653545,45,63,37,65,55,95,360,0.8055555555555556,1.0
70,110,80,55,80,105,500,0.8794326241134752,75,90,90,140,90,115,600,0.9481481481481482,1.0
60,50,150,50,150,60,520,0.5206611570247934,65,75,70,95,70,95,470,0.7272727272727273,2.0
60,85,40,30,45,68,328,0.6422018348623854,50,60,45,100,80,65,400,0.45689655172413796,1.0
70,120,100,145,105,20,560,0.2824427480916031,75,103,80,70,80,92,500,0.7933884297520661,1.0
80,120,79,95,79,70,523,0.5833333333333334,75,80,85,110,90,50,490,0.3548387096774194,0.5
50,25,28,45,55,15,218,0.0625,44,38,39,61,79,42,303,0.2251655629139073,1.0
60,90,55,90,80,110,485,0.8677685950413223,60,55,145,75,150,40,525,0.2,1.0
110,130,80,70,60,80,530,0.5862068965517241,65,47,55,73,75,85,400,0.65,0.5
80,185,115,40,105,75,600,0.6230769230769231,40,60,30,31,31,70,262,0.4492753623188406,0.5
65,75,70,95,70,95,470,0.7272727272727273,110,160,110,80,110,100,670,0.8591549295774648,1.0
75,140,65,112,65,110,567,0.9140625,66,65,48,62,57,52,350,0.36220472440944884,2.0
44,38,39,61,79,42,303,0.2251655629139073,100,120,120,150,100,90,680,0.7880794701986755,1.0
68,85,65,165,135,100,618,0.8083333333333333,90,50,34,60,44,70,348,0.6283185840707964,1.0
50,65,107,105,107,86,520,0.6991150442477876,45,55,45,65,45,75,330,0.5692307692307692,4.0
65,90,115,45,115,58,488,0.5041322314049587,85,105,100,79,83,78,530,0.5869565217391305,1.0
71,95,85,110,95,79,535,0.664,35,85,45,35,35,75,310,0.6492537313432836,2.0
91,90,106,130,106,77,600,0.648854961832061,50,53,48,53,48,64,316,0.4076923076923077,2.0
68,90,65,50,55,82,410,0.6165413533834586,59,110,150,45,49,35,448,0.3333333333333333,1.0
45,63,37,65,55,95,360,0.8055555555555556,70,90,70,60,60,70,420,0.6390977443609023,1.0
105,150,90,150,90,95,680,0.8285714285714286,130,85,80,85,95,60,535,0.43884892086330934,1.0
70,50,30,95,135,105,485,0.8040540540540541,59,110,150,45,49,35,448,0.3333333333333333,0.5
80,160,60,170,130,80,680,0.6180555555555556,65,45,55,45,70,45,325,0.24369747899159663,1.0
99,68,83,72,87,51,460,0.417910447761194,45,65,34,40,34,45,263,0.2589928057553957,0.5
83,80,75,70,70,101,479,0.8615384615384616,110,160,110,80,110,100,670,0.8591549295774648,1.0
60,100,115,70,85,90,520,0.7557251908396947,59,63,80,65,80,58,405,0.41843971631205673,0.5
108,130,95,80,85,102,600,0.7637795275590551,50,35,55,25,25,15,205,0.05263157894736842,0.5
60,100,85,80,85,100,510,0.7007874015748031,30,65,100,45,25,40,305,0.1891891891891892,1.0
50,80,95,10,45,10,290,0.232,55,45,43,55,43,72,313,0.5853658536585366,2.0
60,45,70,75,85,55,390,0.3008130081300813,150,120,100,120,100,90,680,0.664179104477612,1.0
70,85,70,60,70,50,405,0.28378378378378377,100,134,110,95,100,61,600,0.4057971014492754,4.0
71,120,95,120,95,99,600,0.8203125,60,69,95,69,95,36,424,0.2608695652173913,0.25
65,50,35,115,95,95,455,0.7333333333333333,59,59,58,90,70,73,409,0.5826086956521739,0.5
80,110,120,130,90,70,600,0.6198347107438017,50,45,45,35,35,50,260,0.23529411764705882,1.0
70,75,60,105,60,105,475,0.88,80,100,70,60,70,95,475,0.7416666666666667,0.5
60,40,60,40,60,35,295,0.18055555555555555,95,85,85,65,65,35,430,0.2571428571428571,4.0
55,95,115,45,45,35,390,0.2116788321167883,60,85,40,30,45,68,328,0.6422018348623854,0.5
55,55,45,63,45,45,308,0.25,78,84,78,109,85,100,534,0.8620689655172413,2.0
70,85,140,85,70,20,470,0.272,89,124,80,55,80,55,483,0.5714285714285714,1.0
65,90,122,58,75,84,494,0.71875,78,130,111,130,85,100,634,0.8561151079136691,0.25
50,47,50,57,50,65,319,0.463768115942029,40,55,70,45,60,30,300,0.10619469026548672,0.5
60,80,95,70,85,50,440,0.2231404958677686,66,117,70,40,50,67,410,0.4573643410852713,1.0
80,130,100,160,120,110,700,0.8981481481481481,78,81,71,74,69,126,499,0.9090909090909091,1.0
80,100,70,50,60,45,405,0.25806451612903225,55,70,45,70,50,60,350,0.45,1.0
20,10,55,15,20,80,200,0.17985611510791366,75,75,55,105,85,30,425,0.1619718309859155,0.5
75,75,130,75,130,95,580,0.7479674796747967,103,93,67,71,61,84,479,0.7142857142857143,0.0
80,100,70,60,70,95,475,0.7416666666666667,80,92,65,65,80,68,450,0.4824561403508772,2.0
75,80,55,25,35,35,305,0.18666666666666668,105,30,105,140,105,55,540,0.3524590163934426,0.5
75,98,63,98,63,101,498,0.889763779527559,45,20,50,60,120,50,345,0.24074074074074073,0.5
89,125,90,115,80,101,600,0.8725490196078431,60,62,63,80,80,60,405,0.38016528925619836,2.0
42,52,67,39,56,50,306,0.2868217054263566,50,65,107,105,107,86,520,0.6991150442477876,4.0
90,92,75,92,85,60,494,0.49586776859504134,74,100,72,90,72,46,454,0.24561403508771928,1.0
61,90,45,50,50,160,456,0.9230769230769231,86,92,88,68,75,73,482,0.6835443037974683,4.0
35,46,34,35,45,20,215,0.072,165,75,80,40,45,65,470,0.5151515151515151,1.0
108,130,95,80,85,102,600,0.7637795275590551,91,129,90,72,90,108,580,0.8536585365853658,2.0
77,85,51,55,51,65,384,0.5163934426229508,100,100,90,150,140,90,670,0.71875,1.0
90,60,70,75,70,45,410,0.23880597014925373,75,80,85,110,90,50,490,0.3548387096774194,1.0
55,75,85,25,25,15,280,0.1875,65,95,75,55,55,85,430,0.6933333333333334,1.0
40,45,35,65,55,70,310,0.4482758620689655,100,150,110,95,110,70,635,0.5923076923076923,4.0
70,110,80,55,80,105,500,0.8794326241134752,45,85,70,40,40,60,340,0.5229357798165137,0.5
75,80,95,90,100,50,490,0.2158273381294964,60,80,50,40,40,30,300,0.15328467153284672,1.0
86,92,88,68,75,73,482,0.6835443037974683,100,77,77,128,128,90,600,0.6901408450704225,1.0
100,100,100,100,100,100,600,0.8758169934640523,75,103,80,70,80,92,500,0.7933884297520661,1.0
68,125,65,65,115,80,518,0.6277372262773723,50,85,125,85,115,20,480,0.4306569343065693,0.0
86,76,86,116,56,95,515,0.7982456140350878,170,90,45,90,45,60,500,0.427536231884058,1.0
45,60,40,70,50,45,310,0.2846715328467153,80,100,80,80,80,100,520,0.9051724137931034,0.5
65,90,40,45,80,75,395,0.625,106,90,130,90,154,110,680,0.8699186991869918,1.0
58,109,112,48,48,109,484,0.8805970149253731,70,110,80,55,80,105,500,0.8794326241134752,0.5
45,90,20,65,20,65,305,0.5116279069767442,85,50,95,120,115,80,545,0.5793650793650794,0.5
86,68,72,109,66,106,507,0.8099173553719008,76,48,48,57,62,34,325,0.11688311688311688,0.5
100,100,100,100,100,100,600,0.831858407079646,45,35,45,62,53,35,275,0.11851851851851852,1.0
75,65,55,65,55,69,384,0.43548387096774194,109,66,84,81,99,32,471,0.2013888888888889,4.0
75,80,70,65,75,90,455,0.7578125,95,124,78,69,71,58,495,0.37398373983739835,2.0
75,80,85,110,90,50,490,0.3548387096774194,55,40,40,65,45,35,280,0.16428571428571428,1.0
70,70,115,130,90,60,535,0.5338983050847458,40,55,99,40,79,47,360,0.26262626262626265,1.0
46,87,60,30,40,57,320,0.37777777777777777,50,95,90,95,90,180,600,0.9172413793103448,1.0
50,100,150,100,150,50,600,0.37142857142857144,30,45,59,30,39,57,260,0.2803030303030303,1.0
40,20,30,40,80,55,265,0.22764227642276422,10,55,25,35,45,95,265,0.5396825396825397,1.0
85,76,64,45,55,90,415,0.6739130434782609,80,80,50,40,50,25,325,0.176056338028169,1.0
35,55,35,30,30,35,220,0.23684210526315788,80,50,100,100,200,50,580,0.2357142857142857,1.0
45,50,35,55,75,40,300,0.21367521367521367,104,91,63,91,73,68,490,0.5118110236220472,1.0
100,180,160,150,90,90,770,0.7520661157024794,55,55,85,65,85,35,380,0.2014388489208633,0.5
64,88,50,88,50,106,446,0.9111111111111111,75,75,95,75,95,113,528,0.9015151515151515,1.0
90,85,100,95,125,85,580,0.6834532374100719,40,30,32,50,52,65,269,0.3671875,1.0
30,30,42,30,42,70,244,0.4230769230769231,55,45,43,55,43,72,313,0.5853658536585366,1.0
50,120,53,35,110,87,455,0.640625,50,95,95,35,110,70,455,0.5179856115107914,1.0
50,65,90,35,35,15,290,0.14678899082568808,55,55,85,65,85,35,380,0.2014388489208633,1.0
65,125,100,60,70,70,490,0.6099290780141844,101,72,72,99,89,29,462,0.1937984496124031,0.25
40,30,32,50,52,65,269,0.3671875,120,100,85,30,85,45,465,0.22448979591836735,0.5
68,90,65,50,55,82,410,0.6165413533834586,110,85,95,80,95,50,515,0.2713178294573643,1.0
75,80,95,90,100,50,490,0.2158273381294964,65,136,94,54,96,135,580,0.9612403100775194,1.0
70,70,70,70,70,70,420,0.5289256198347108,65,105,60,60,70,95,455,63.0,1.0
60,69,95,69,95,36,424,0.2608695652173913,65,65,45,75,45,95,390,0.72,0.5
95,65,65,110,130,60,525,0.4016393442622951,67,82,62,46,48,43,348,0.22033898305084745,2.0
40,30,30,55,30,85,270,0.4666666666666667,80,90,80,130,110,110,600,0.856,0.5
70,110,180,60,60,50,530,0.4117647058823529,70,75,60,105,60,105,475,0.88,0.5
100,103,75,120,75,127,600,0.940677966101695,40,30,35,50,70,55,280,0.28205128205128205,0.5
65,90,40,45,80,75,395,0.625,71,120,95,120,95,99,600,0.8203125,0.0
75,89,85,55,65,36,405,0.29545454545454547,35,35,35,35,35,35,210,0.13385826771653545,1.0
65,90,50,85,45,55,390,0.371900826446281,65,80,140,40,70,70,465,0.5223880597014925,0.0
80,130,100,160,120,110,700,0.8981481481481481,40,55,30,30,30,60,245,0.43548387096774194,1.0
80,70,40,100,60,145,495,0.921875,110,80,90,95,90,65,530,0.5033557046979866,1.0
100,77,77,128,128,90,600,0.6901408450704225,104,91,63,91,73,68,490,0.5118110236220472,1.0
89,145,90,105,80,91,600,0.8549618320610687,78,52,60,63,65,23,341,0.06015037593984962,1.0
80,92,65,65,80,68,450,0.4824561403508772,45,30,50,55,65,45,290,0.208,1.0
30,45,135,45,90,30,375,0.09285714285714286,70,100,115,30,65,30,410,0.24390243902439024,1.0
20,10,230,10,230,5,505,0.0,55,40,85,80,105,40,405,0.23622047244094488,0.5
30,45,55,70,55,85,340,0.5633802816901409,100,75,115,90,115,85,580,0.6446280991735537,0.5
110,78,73,76,71,60,468,0.3333333333333333,60,60,60,85,85,85,435,0.631578947368421,1.0
71,73,88,120,89,59,500,0.43537414965986393,100,120,120,150,100,90,680,0.7880794701986755,0.5
90,100,90,125,85,90,580,0.7352941176470589,76,25,45,67,55,24,292,0.0390625,1.0
60,85,60,50,50,125,430,0.9090909090909091,80,52,50,90,50,89,411,0.6666666666666666,2.0
78,52,60,63,65,23,341,0.06015037593984962,60,82,45,45,45,74,351,0.5752212389380531,2.0
78,81,71,74,69,126,499,0.9090909090909091,50,95,95,35,110,70,455,0.5179856115107914,2.0
65,70,60,65,65,115,440,0.8583333333333333,80,80,80,80,80,80,480,0.6015037593984962,1.0
150,160,100,95,65,100,670,0.8866666666666667,65,95,75,55,55,85,430,0.6933333333333334,1.0
35,80,50,50,70,120,405,0.84375,70,55,95,95,110,65,490,0.48872180451127817,1.0
100,100,90,150,140,90,670,0.71875,80,110,60,150,130,70,600,0.5042016806722689,1.0
72,58,80,103,80,97,490,0.7171052631578947,60,65,60,130,75,110,500,0.7719298245614035,2.0
70,100,70,105,75,40,460,0.23214285714285715,75,103,80,70,80,92,500,0.7933884297520661,1.0
45,95,50,40,50,75,355,0.54,55,70,45,70,50,60,350,0.45,1.0
45,30,50,55,65,45,290,0.208,45,65,34,40,34,45,263,0.2589928057553957,1.0
120,70,120,75,130,85,600,0.6694915254237288,100,120,120,150,100,90,680,0.7880794701986755,0.5
75,103,80,70,80,92,500,0.7933884297520661,90,93,55,70,55,55,418,0.3819444444444444,0.125
100,77,77,128,128,90,600,0.6901408450704225,65,65,45,75,45,95,390,0.72,1.0
70,45,48,60,65,35,323,0.15748031496062992,50,65,85,35,35,55,325,0.32575757575757575,1.0
45,75,37,70,55,83,365,0.6183206106870229,64,165,75,93,83,75,555,0.6587301587301587,1.0
65,55,115,100,40,60,435,0.3798449612403101,109,66,84,81,99,32,471,0.2013888888888889,2.0
70,120,40,95,40,95,460,0.8106060606060606,60,65,80,170,95,130,600,0.8625954198473282,2.0
75,100,110,45,55,65,450,0.5333333333333333,75,98,63,98,63,101,498,0.8091603053435115,0.5
40,80,35,35,45,70,305,0.4661016949152542,45,45,35,20,30,20,195,0.07246376811594203,0.5
35,55,40,50,50,90,320,0.6838235294117647,55,95,55,35,75,115,430,0.9380530973451328,1.0
90,60,60,40,40,40,330,0.29545454545454547,83,106,65,86,65,85,490,0.6640625,2.0
90,92,75,92,85,60,494,0.49586776859504134,41,56,40,62,44,71,314,0.568,1.0
75,90,140,60,60,40,465,0.3008130081300813,85,110,76,65,82,56,474,0.3933333333333333,1.0
45,40,60,40,75,50,310,0.2926829268292683,100,100,80,60,60,50,450,0.3050847457627119,1.0
55,81,60,50,70,97,413,0.7214285714285714,70,80,102,80,102,40,474,0.2677165354330709,1.0
68,90,65,50,55,82,410,0.6165413533834586,85,80,70,135,75,90,535,0.7006802721088435,1.0
74,48,76,83,81,104,466,0.7913043478260869,80,110,60,150,130,70,600,0.5042016806722689,0.5
65,65,60,110,95,130,525,0.9253731343283582,77,85,51,55,51,65,384,0.5163934426229508,1.0
97,165,60,65,50,58,495,0.3902439024390244,35,70,55,45,55,25,285,0.09420289855072464,2.0
97,165,60,65,50,58,495,0.3902439024390244,65,80,80,59,63,58,405,0.4411764705882353,1.0
41,50,37,50,37,66,281,0.5175438596491229,55,81,60,50,70,97,413,0.7214285714285714,1.0
95,85,85,65,65,35,430,0.2571428571428571,70,40,50,55,50,25,290,0.061068702290076333,0.5
40,30,35,50,70,55,280,0.28205128205128205,65,95,57,100,85,93,495,0.7441860465116279,0.5
78,81,71,74,69,126,499,0.9090909090909091,70,65,60,90,75,90,450,0.6571428571428571,4.0
35,64,85,74,55,32,345,0.19827586206896552,70,55,95,95,110,65,490,0.48872180451127817,1.0
45,85,70,40,40,60,340,0.5229357798165137,53,51,53,61,56,40,314,0.14285714285714285,0.5
71,95,85,110,95,79,535,0.664,165,75,80,40,45,65,470,0.5151515151515151,0.5
70,80,50,35,35,35,305,0.14,50,80,95,10,45,10,290,0.232,2.0
55,20,35,20,45,75,250,0.37681159420289856,60,65,80,170,95,130,600,0.8625954198473282,0.0
55,50,40,40,40,75,300,0.5945945945945946,59,66,70,44,55,41,335,0.25190839694656486,0.0
120,70,120,75,130,85,600,0.6694915254237288,75,125,230,55,95,30,610,0.3448275862068966,1.0
65,47,55,73,75,85,400,0.65,30,80,90,55,45,55,355,0.4295774647887324,1.0
45,40,60,40,75,50,310,0.2926829268292683,43,80,65,50,35,35,308,0.14193548387096774,1.0
85,76,64,45,55,90,415,0.6739130434782609,50,53,62,58,63,44,330,0.13709677419354838,1.0
80,100,200,50,100,50,580,0.3472222222222222,40,55,80,35,60,30,300,0.15037593984962405,0.5
75,110,110,110,105,80,590,0.656934306569343,35,65,35,65,35,65,300,0.46621621621621623,1.0
76,25,45,67,55,24,292,0.0390625,75,80,60,65,90,102,472,0.8625954198473282,1.0
100,120,120,150,100,90,680,0.7880794701986755,108,112,118,68,72,47,525,0.2916666666666667,1.0
90,70,80,70,95,70,475,0.5190839694656488,95,70,73,95,90,60,483,0.3983739837398374,1.0
45,22,60,27,30,29,213,0.07518796992481203,125,120,90,170,100,95,700,0.78125,1.0
60,50,70,50,90,65,385,0.39568345323741005,70,75,80,135,80,135,575,0.917910447761194,1.0
95,100,85,108,70,70,528,0.5652173913043478,70,110,75,145,85,145,630,0.9444444444444444,0.25
55,70,55,40,55,85,360,0.7073170731707317,56,61,65,48,45,38,313,0.17567567567567569,1.0
73,95,62,85,65,85,465,0.6666666666666666,50,20,40,20,40,20,190,0.0962962962962963,1.0
90,100,60,90,60,80,480,0.6422764227642277,80,50,100,100,200,50,580,0.2357142857142857,1.0
50,40,85,40,65,25,305,0.08870967741935484,45,55,45,65,45,75,330,0.5692307692307692,0.5
150,100,120,100,120,90,680,0.6666666666666666,70,55,95,95,110,65,490,0.48872180451127817,2.0
40,30,30,40,50,30,220,0.07936507936507936,50,75,35,70,30,40,300,0.21296296296296297,0.125
65,55,115,100,40,60,435,0.3798449612403101,60,85,69,65,79,80,438,0.576,0.5
50,47,50,57,50,65,319,0.463768115942029,55,84,105,114,75,52,485,0.2890625,2.0
70,70,40,60,40,60,340,0.4247787610619469,86,76,86,116,56,95,515,0.7982456140350878,0.25
43,70,48,50,60,38,309,0.2391304347826087,60,30,30,36,56,50,262,0.32432432432432434,0.0
80,115,80,65,55,93,488,0.7846153846153846,20,40,90,30,90,25,295,0.11363636363636363,0.0
65,80,65,35,65,60,370,0.38405797101449274,68,65,65,125,115,80,518,0.6461538461538462,1.0
43,80,65,50,35,35,308,0.14193548387096774,40,70,40,35,40,60,285,0.392,1.0
72,60,30,20,30,25,237,0.11570247933884298,95,135,80,110,80,100,600,0.8248175182481752,0.5
20,40,15,35,35,60,205,0.34285714285714286,40,60,30,31,31,70,262,0.4492753623188406,2.0
68,75,53,83,113,60,452,0.45384615384615384,80,105,105,105,105,80,580,0.5939849624060151,1.0
55,75,50,40,40,80,340,0.6302521008403361,71,120,95,120,95,99,600,0.8203125,0.5
75,80,60,65,90,102,472,0.8625954198473282,130,70,35,70,35,60,400,0.4017857142857143,1.0
65,100,70,80,80,105,500,0.8666666666666667,55,65,35,60,30,85,330,0.6126126126126126,0.5
60,90,140,50,50,40,430,0.2535211267605634,60,40,80,60,45,40,325,0.23529411764705882,1.0
80,105,105,105,105,80,580,0.5939849624060151,90,75,85,115,90,55,510,0.3445378151260504,1.0
60,65,80,170,95,130,600,0.8625954198473282,67,57,55,77,55,114,425,0.8879310344827587,2.0
70,62,67,55,55,56,365,0.38513513513513514,50,47,50,57,50,65,319,0.463768115942029,1.0
100,120,100,150,120,90,680,0.728,86,76,86,116,56,95,515,0.7982456140350878,2.0
72,105,115,54,86,68,500,0.5149253731343284,99,68,83,72,87,51,460,0.417910447761194,1.0
43,30,55,40,65,97,330,0.6030534351145038,45,60,45,25,45,55,275,0.29,1.0
45,50,45,115,55,95,405,0.6936936936936937,54,66,70,44,55,46,335,0.4214876033057851,2.0
30,30,42,30,42,70,244,0.4230769230769231,110,85,95,80,95,50,515,0.2713178294573643,1.0
190,33,58,33,58,33,405,0.13432835820895522,55,55,50,45,65,55,325,0.37373737373737376,1.0
30,80,90,55,45,55,355,0.4295774647887324,70,100,70,105,75,40,460,0.23214285714285715,4.0
57,80,91,80,87,75,470,0.5737704918032787,20,40,90,30,90,25,295,0.11363636363636363,1.0
46,57,40,40,40,50,273,0.25,64,88,50,88,50,106,446,0.9111111111111111,1.0
58,89,77,45,45,48,362,0.3177570093457944,50,53,48,53,48,64,316,0.4076923076923077,1.0
65,90,65,61,61,100,442,0.8373983739837398,40,55,99,40,79,47,360,0.26262626262626265,2.0
50,50,150,50,150,50,500,0.2571428571428571,78,52,60,63,65,23,341,0.06015037593984962,1.0
100,150,110,95,110,70,635,0.5923076923076923,45,100,45,45,45,10,290,0.2949640287769784,2.0
70,55,65,95,85,70,440,0.5307692307692308,50,35,55,25,25,15,205,0.05263157894736842,2.0
70,45,48,60,65,35,323,0.15748031496062992,65,90,115,45,115,58,488,0.5041322314049587,4.0
79,105,70,145,80,101,580,0.8608695652173913,91,90,72,90,129,108,580,0.896,2.0
58,70,45,40,45,42,300,0.25925925925925924,75,80,55,25,35,35,305,0.18666666666666668,1.0
95,65,110,60,130,65,525,0.5275590551181102,100,164,150,95,120,71,700,0.5645161290322581,0.5
70,60,75,110,75,90,480,0.7165354330708661,95,23,48,23,48,23,260,0.046153846153846156,1.0
20,10,55,15,20,80,200,0.17985611510791366,61,90,45,50,50,160,456,0.9230769230769231,1.0
105,95,75,85,75,74,509,0.5714285714285714,105,140,95,55,65,45,505,0.3,1.0
58,89,77,45,45,48,362,0.3177570093457944,76,48,48,57,62,34,325,0.11688311688311688,1.0
75,75,75,125,95,40,485,0.15671641791044777,110,123,65,100,65,65,528,0.5217391304347826,1.0
84,86,88,111,101,60,530,0.4634146341463415,95,85,85,65,65,35,430,0.2571428571428571,0.5
44,38,33,61,43,70,289,0.5267857142857143,65,90,65,61,61,100,442,0.8373983739837398,2.0
45,30,35,20,20,45,195,0.14782608695652175,30,35,30,100,35,80,310,0.4765625,0.25
80,85,95,30,30,25,345,0.2857142857142857,50,50,40,50,40,64,294,0.45588235294117646,1.0
100,128,90,77,77,128,600,0.959349593495935,60,50,50,60,70,50,340,0.28346456692913385,1.0
60,45,50,90,80,70,395,0.625,91,134,95,100,100,80,600,0.6304347826086957,0.5
105,95,75,85,75,74,509,0.5714285714285714,80,160,60,170,130,80,680,0.6180555555555556,1.0
55,40,85,80,105,40,405,0.23622047244094488,20,10,55,15,20,80,200,0.17985611510791366,1.0
50,95,95,35,110,70,455,0.5179856115107914,85,56,77,50,77,78,423,0.53125,2.0
50,65,107,105,107,86,520,0.7272727272727273,110,130,80,70,60,80,530,0.5862068965517241,0.0
76,48,48,57,62,34,325,0.11688311688311688,45,100,45,45,45,10,290,0.2949640287769784,2.0
100,50,80,60,80,50,420,0.34375,70,50,30,95,135,105,485,0.8040540540540541,1.0
150,100,120,100,120,90,680,0.6666666666666666,75,80,95,90,100,50,490,0.2158273381294964,1.0
55,75,60,75,60,103,428,0.7982456140350878,75,75,55,105,85,30,425,0.1619718309859155,1.0
60,85,49,60,49,60,363,0.4444444444444444,100,75,115,90,115,85,580,0.6446280991735537,2.0
60,60,40,65,45,35,305,0.15833333333333333,100,120,100,150,120,90,680,0.728,0.5
74,108,133,83,65,32,495,0.32142857142857145,120,120,120,120,120,120,720,0.9344262295081968,1.0
80,82,100,83,100,80,525,0.6821705426356589,70,110,70,115,70,90,525,0.75,0.5
20,25,45,70,90,60,310,0.30833333333333335,40,35,30,120,70,105,400,0.6692307692307692,0.5
95,85,85,65,65,35,430,0.2571428571428571,89,145,90,105,80,91,600,0.8549618320610687,0.0
49,49,56,49,61,66,330,0.5190839694656488,50,50,62,40,62,65,329,0.4188034188034188,1.0
75,75,130,75,130,95,580,0.7479674796747967,100,150,110,95,110,70,635,0.5923076923076923,2.0
40,45,40,35,35,56,251,0.373015873015873,85,135,130,60,80,25,515,0.40540540540540543,0.25
90,90,85,125,90,100,580,0.768595041322314,100,120,100,150,120,90,680,0.728,0.5
55,55,85,65,85,35,380,0.2014388489208633,78,84,78,109,85,100,534,0.8620689655172413,4.0
150,160,100,95,65,100,670,0.8866666666666667,60,85,69,60,69,77,420,0.518796992481203,1.0
82,121,119,69,59,71,521,0.5394736842105263,38,30,85,55,65,30,303,0.21428571428571427,1.0
80,80,90,110,130,110,600,0.8721804511278195,40,45,35,30,40,55,245,0.3793103448275862,2.0
35,60,44,40,54,55,288,0.366412213740458,50,50,77,95,77,91,440,0.5916666666666667,0.5
30,65,100,45,25,40,305,0.1891891891891892,60,45,70,75,85,55,390,0.3008130081300813,1.0
95,75,80,100,110,30,490,0.24242424242424243,75,100,95,40,70,110,490,0.8717948717948718,1.0
115,140,130,55,55,40,535,0.4519230769230769,44,38,39,61,79,42,303,0.2251655629139073,1.0
60,40,80,60,45,40,325,0.23529411764705882,74,108,133,83,65,32,495,0.32142857142857145,4.0
60,70,65,125,105,90,515,0.6911764705882353,62,50,58,73,54,72,369,0.4435483870967742,0.5
90,75,85,115,90,55,510,0.3445378151260504,65,50,70,95,80,65,425,0.4262295081967213,1.0
68,165,95,65,115,110,618,0.8615384615384616,70,55,75,45,65,60,370,0.45901639344262296,0.0
86,76,86,116,56,95,515,0.7982456140350878,44,38,39,61,79,42,303,0.2251655629139073,0.5
70,95,85,55,65,70,440,0.5,35,20,65,40,65,20,245,0.02459016393442623,1.0
67,125,40,30,30,58,350,0.3431372549019608,95,75,110,100,80,30,490,0.15267175572519084,1.0
70,83,50,37,50,60,350,0.3360655737704918,45,67,60,35,50,63,320,0.5128205128205128,1.0
60,60,60,105,105,105,495,0.848,55,55,55,85,55,30,335,0.1320754716981132,2.0
70,120,100,145,105,20,560,0.2824427480916031,48,61,40,61,40,50,300,0.2543859649122807,2.0
50,50,40,50,40,64,294,0.45588235294117646,62,48,66,59,57,49,341,0.33884297520661155,1.0
70,55,75,45,65,60,370,0.45901639344262296,60,80,50,40,40,30,300,0.15328467153284672,0.5
73,76,75,81,100,100,505,0.8110236220472441,85,100,122,58,75,54,494,0.3939393939393939,2.0
41,56,40,62,44,71,314,0.568,85,100,122,58,75,54,494,0.3939393939393939,0.5
60,55,50,40,55,45,305,0.22377622377622378,40,30,35,50,70,55,280,0.28205128205128205,1.0
75,80,55,25,35,35,305,0.18666666666666668,100,100,100,100,100,100,600,0.8602941176470589,1.0
55,55,55,85,55,30,335,0.1320754716981132,55,63,90,50,80,42,380,0.21138211382113822,1.0
95,75,180,130,80,30,590,0.13793103448275862,76,25,45,67,55,24,292,0.0390625,0.5
70,105,105,50,40,20,390,0.33587786259541985,90,100,90,125,85,90,580,0.7352941176470589,4.0
75,98,63,98,63,101,498,0.889763779527559,60,105,60,120,60,105,510,0.8849557522123894,1.0
72,105,115,54,86,68,500,0.5149253731343284,44,75,35,63,33,45,295,0.2647058823529412,1.0
73,115,60,60,60,90,458,0.6694915254237288,50,120,53,35,110,87,455,0.640625,1.0
58,64,58,80,65,80,405,0.609271523178808,60,40,80,60,45,40,325,0.23529411764705882,2.0
40,45,40,65,40,65,295,0.5661764705882353,71,73,88,120,89,59,500,0.43537414965986393,2.0
100,50,50,76,96,70,442,0.5,80,80,90,110,130,110,600,0.8721804511278195,1.0
90,93,55,70,55,55,418,0.3819444444444444,79,100,80,110,90,121,580,0.968,0.5
123,100,62,97,81,68,531,0.4806201550387597,100,120,100,150,120,90,680,0.728,0.25
40,29,45,29,45,36,224,0.14634146341463414,40,60,30,31,31,70,262,0.4492753623188406,0.5
50,30,55,65,55,20,275,0.13675213675213677,55,95,115,45,45,35,390,0.2116788321167883,0.5
50,30,55,65,55,20,275,0.13675213675213677,60,90,55,90,80,110,485,0.8677685950413223,1.0
58,64,58,80,65,80,405,0.5423728813559322,130,85,80,85,95,60,535,0.43884892086330934,1.0
89,124,80,55,80,55,483,0.5714285714285714,30,56,35,25,35,72,253,0.48148148148148145,0.0
95,110,95,40,95,55,490,0.40336134453781514,65,150,60,115,60,115,565,0.935251798561151,1.0
38,35,40,27,25,35,200,0.08208955223880597,110,80,90,95,90,65,530,0.5033557046979866,1.0
55,63,90,50,80,42,380,0.21138211382113822,106,150,70,194,120,140,780,0.952,2.0
20,10,55,15,20,80,200,0.17985611510791366,100,100,100,100,100,100,600,0.8778625954198473,2.0
25,35,70,95,55,45,325,0.16783216783216784,20,15,20,10,55,80,200,0.2682926829268293,1.0
60,62,80,63,80,60,405,0.4336283185840708,63,60,55,50,50,71,349,0.5289256198347108,0.5
40,60,40,40,40,30,250,0.0948905109489051,67,58,57,81,67,101,431,0.8790322580645161,1.0
114,85,70,85,80,30,464,0.2066115702479339,60,45,70,45,90,95,405,0.7304964539007093,1.0
50,85,55,65,65,90,410,0.7478260869565218,91,72,90,129,90,108,580,0.8620689655172413,0.5
75,80,70,65,75,90,455,0.7578125,50,65,85,35,35,55,325,0.32575757575757575,0.5
60,50,150,50,150,60,520,0.5206611570247934,50,65,107,105,107,86,520,0.6991150442477876,0.25
45,60,32,50,32,76,295,0.5925925925925926,85,97,66,105,66,65,484,0.47107438016528924,1.0
77,120,90,60,90,48,485,0.2785714285714286,50,65,85,35,35,55,325,0.32575757575757575,1.0
50,85,85,55,55,50,380,0.3902439024390244,75,125,230,55,95,30,610,0.3448275862068966,0.25
150,160,100,95,65,100,670,0.8866666666666667,55,70,55,40,55,85,360,0.7073170731707317,1.0
100,100,90,150,140,90,670,0.71875,50,65,107,105,107,86,520,0.7313432835820896,0.5
45,75,37,70,55,83,365,0.6183206106870229,53,54,53,37,46,45,288,0.3090909090909091,1.0
95,75,80,100,110,30,490,0.24242424242424243,65,85,70,75,70,40,405,0.203125,1.0
76,25,45,67,55,24,292,0.0390625,50,53,48,53,48,64,316,0.46153846153846156,1.0
55,68,64,45,55,31,318,0.11666666666666667,90,50,34,60,44,70,348,0.6283185840707964,0.5
30,42,118,42,88,30,350,0.112,50,75,70,35,70,48,348,0.29357798165137616,0.5
44,58,44,58,44,61,309,0.41964285714285715,50,70,50,50,50,40,310,0.16296296296296298,0.5
70,140,230,60,80,50,630,0.32432432432432434,78,104,78,159,115,100,634,0.8444444444444444,0.5
115,45,20,45,25,20,270,0.11538461538461539,60,105,60,120,60,105,510,0.8849557522123894,2.0
82,121,119,69,59,71,521,0.5394736842105263,70,140,70,110,65,105,560,0.95,1.0
65,47,55,73,75,85,400,0.65,50,50,95,40,50,35,320,0.20279720279720279,1.0
30,45,135,45,90,30,375,0.09285714285714286,79,85,60,55,60,71,410,0.60431654676259,1.0
70,80,65,90,65,85,455,0.578125,85,135,130,60,80,25,515,0.40540540540540543,0.5
20,40,15,35,35,60,205,0.34285714285714286,77,120,90,60,90,48,485,0.2785714285714286,0.5
60,150,50,150,50,60,520,0.5,70,40,50,55,50,25,290,0.061068702290076333,1.0
80,90,80,130,110,110,600,0.856,95,110,80,70,80,50,485,0.37209302325581395,1.0
60,95,80,60,80,30,405,0.19480519480519481,88,107,122,74,75,64,530,0.4596774193548387,0.5
75,125,230,55,95,30,610,0.3448275862068966,82,121,119,69,59,71,521,0.5394736842105263,4.0
130,85,80,85,95,60,535,0.43884892086330934,82,121,119,69,59,71,521,0.5394736842105263,2.0
95,65,110,60,130,65,525,0.5275590551181102,89,145,90,105,80,91,600,0.8549618320610687,1.0
45,50,55,75,65,30,320,0.06293706293706294,80,120,70,110,70,80,530,0.6422764227642277,0.5
75,95,60,65,60,115,470,0.8778625954198473,79,103,120,135,115,78,630,0.5763888888888888,1.0
41,64,45,50,50,50,300,0.36752136752136755,75,85,200,55,65,30,510,0.16778523489932887,0.5
60,40,60,95,60,55,370,0.4222222222222222,35,55,35,30,30,35,220,0.23684210526315788,0.5
40,45,40,62,60,60,307,0.33884297520661155,85,110,76,65,82,56,474,0.3933333333333333,2.0
42,52,67,39,56,50,306,0.2868217054263566,50,85,55,65,65,90,410,0.7478260869565218,4.0
50,65,107,105,107,86,520,0.7758620689655172,75,80,95,90,100,50,490,0.2158273381294964,0.25
59,74,50,35,50,35,303,0.3125,50,70,50,50,50,70,340,0.5645161290322581,1.0
45,50,43,40,38,62,278,0.40441176470588236,60,110,70,60,60,100,460,0.8461538461538461,1.0
105,140,95,55,65,45,505,0.3,64,88,50,88,50,106,446,0.9111111111111111,2.0
90,93,55,70,55,55,418,0.3819444444444444,70,90,110,60,75,95,500,0.7333333333333333,1.0
75,80,55,25,35,35,305,0.18666666666666668,44,38,39,61,79,42,303,0.2251655629139073,0.5
70,92,65,80,55,98,460,0.8090909090909091,60,150,50,150,50,60,520,0.5,1.0
70,100,70,105,75,40,460,0.23214285714285715,106,130,90,110,154,90,680,0.719626168224299,0.0
170,90,45,90,45,60,500,0.427536231884058,95,117,184,44,46,28,514,0.2975206611570248,1.0
75,75,75,125,95,40,485,0.15671641791044777,85,80,90,105,95,60,515,0.49074074074074076,1.0
65,125,100,60,70,70,490,0.6099290780141844,65,95,75,55,55,85,430,0.6933333333333334,0.5
65,47,55,73,75,85,400,0.65,60,60,40,65,45,35,305,0.15833333333333333,0.5
75,95,125,45,75,95,510,0.8257575757575758,70,140,230,60,80,50,630,0.32432432432432434,1.0
91,72,90,129,90,108,580,0.8620689655172413,95,124,78,69,71,58,495,0.37398373983739835,2.0
79,85,60,55,60,71,410,0.60431654676259,60,85,69,65,79,80,438,0.576,1.0
55,75,50,40,40,80,340,0.6302521008403361,65,110,130,60,65,95,525,0.8278145695364238,2.0
100,100,100,100,100,100,600,0.8758169934640523,72,105,115,54,86,68,500,0.5149253731343284,1.0
65,150,40,15,80,145,495,0.9663865546218487,20,40,90,30,90,25,295,0.11363636363636363,0.25
50,47,50,57,50,65,319,0.463768115942029,45,55,45,65,45,75,330,0.5692307692307692,1.0
60,100,85,80,85,100,510,0.7007874015748031,100,150,90,180,160,90,770,0.7348484848484849,1.0
50,65,107,105,107,86,520,0.703125,50,120,53,35,110,87,455,0.640625,1.0
90,75,75,90,100,70,500,0.5462184873949579,44,38,33,61,43,70,289,0.5267857142857143,1.0
55,55,85,65,85,35,380,0.2014388489208633,50,35,55,25,25,15,205,0.05263157894736842,2.0
40,60,40,40,40,30,250,0.0948905109489051,50,55,50,36,30,43,264,0.2922077922077922,0.5
100,103,75,120,75,127,600,0.940677966101695,60,65,60,130,75,110,500,0.7719298245614035,0.5
40,40,35,50,100,70,335,0.5031847133757962,60,50,50,60,70,50,340,0.28346456692913385,0.5
50,70,50,50,50,40,310,0.16296296296296298,83,80,80,135,80,121,579,0.9444444444444444,1.0
59,74,50,35,50,35,303,0.3125,70,77,60,97,60,108,472,0.8394160583941606,1.0
85,115,80,105,80,50,515,0.3063063063063063,45,35,45,62,53,35,275,0.11851851851851852,0.5
85,115,80,105,80,50,515,0.3063063063063063,52,65,55,58,62,60,352,0.4482758620689655,2.0
44,50,91,24,86,10,305,0.1981981981981982,100,77,77,128,128,90,600,0.6901408450704225,1.0
90,65,65,40,40,15,315,0.19672131147540983,91,90,72,90,129,108,580,0.896,0.5
60,105,60,120,60,105,510,0.8849557522123894,50,75,75,65,65,50,380,0.4049586776859504,1.0
75,80,55,25,35,35,305,0.18666666666666668,106,90,130,90,154,110,680,0.8699186991869918,0.25
40,40,35,50,100,70,335,0.5031847133757962,80,92,65,65,80,68,450,0.4824561403508772,0.5
106,110,90,154,90,130,680,0.926829268292683,40,50,90,30,55,65,330,0.44680851063829785,2.0
75,90,140,60,60,40,465,0.3008130081300813,40,45,40,62,60,60,307,0.33884297520661155,0.25
53,54,53,37,46,45,288,0.3090909090909091,25,35,70,95,55,45,325,0.16783216783216784,0.5
45,63,37,65,55,95,360,0.8055555555555556,75,95,125,45,75,95,510,0.8257575757575758,0.0
60,80,50,40,40,30,300,0.15328467153284672,80,100,123,122,120,80,625,0.56,0.5
59,66,70,44,55,41,335,0.25190839694656486,100,90,130,45,65,55,485,0.4253731343283582,4.0
65,150,60,115,60,115,565,0.935251798561151,90,100,70,110,150,80,600,0.6037735849056604,1.0
60,100,115,70,85,90,520,0.7557251908396947,85,80,70,135,75,90,535,0.7006802721088435,1.0
70,85,140,85,70,20,470,0.272,41,56,40,62,44,71,314,0.568,0.5
55,35,50,55,110,85,390,0.6277372262773723,70,45,48,60,65,35,323,0.15748031496062992,0.5
105,30,105,140,105,55,540,0.3524590163934426,60,50,70,50,90,65,385,0.39568345323741005,4.0
100,100,100,100,100,100,600,0.8778625954198473,63,60,55,50,50,71,349,0.5289256198347108,1.0
70,70,70,70,70,70,420,0.5289256198347108,30,56,35,25,35,72,253,0.48148148148148145,1.0
95,155,109,70,130,81,640,0.6788321167883211,40,70,40,35,40,60,285,0.392,0.5
60,75,100,55,80,50,420,0.3088235294117647,50,50,120,80,80,30,410,0.07258064516129033,1.0
45,35,50,70,50,30,280,0.15753424657534246,79,85,60,55,60,71,410,0.60431654676259,2.0
85,105,55,85,50,115,495,0.9032258064516129,40,70,40,35,40,60,285,0.392,1.0
86,68,72,109,66,106,507,0.8099173553719008,73,95,62,85,65,85,465,0.6666666666666666,1.0
65,70,60,65,65,115,440,0.8583333333333333,70,62,67,55,55,56,365,0.38513513513513514,1.0
55,50,40,40,40,75,300,0.5945945945945946,95,95,85,125,65,55,520,0.3894736842105263,1.0
70,62,67,55,55,56,365,0.38513513513513514,50,35,55,25,25,15,205,0.05263157894736842,1.0
65,63,45,45,45,45,308,0.2595419847328244,80,185,115,40,105,75,600,0.6230769230769231,2.0
58,89,77,45,45,48,362,0.3177570093457944,86,81,97,81,107,43,495,0.203125,1.0
80,120,130,55,65,45,495,0.37037037037037035,150,160,100,95,65,100,670,0.8866666666666667,1.0
60,110,70,60,60,100,460,0.8461538461538461,38,35,40,27,25,35,200,0.08208955223880597,2.0
58,70,45,40,45,42,300,0.25925925925925924,45,30,15,85,65,65,305,0.36220472440944884,1.0
80,80,80,80,80,80,480,0.6015037593984962,70,95,85,55,65,70,440,0.5,1.0
110,135,60,50,65,88,508,0.7744360902255639,54,63,52,83,56,97,405,0.7697841726618705,0.5
88,107,122,74,75,64,530,0.4596774193548387,125,170,100,120,90,95,700,0.77,1.0
44,75,35,63,33,45,295,0.2647058823529412,39,52,43,60,50,65,309,0.49107142857142855,1.0
80,110,60,150,130,70,600,0.5042016806722689,45,100,135,65,135,45,525,0.29411764705882354,2.0
80,80,80,80,80,80,480,0.6015037593984962,91,129,90,72,90,108,580,0.8536585365853658,1.0
45,65,34,40,34,45,263,0.2589928057553957,70,75,60,105,60,105,475,0.88,0.5
80,160,60,170,130,80,680,0.6180555555555556,101,72,72,99,89,29,462,0.1937984496124031,0.5
89,124,80,55,80,55,483,0.5714285714285714,38,41,40,50,65,65,299,0.4108527131782946,2.0
35,46,34,35,45,20,215,0.072,60,60,50,40,50,75,335,0.5882352941176471,1.0
70,55,65,95,85,70,440,0.5307692307692308,55,40,50,65,85,40,335,0.3181818181818182,1.0
65,50,35,115,95,95,455,0.7333333333333333,90,75,85,115,90,55,510,0.3445378151260504,1.0
58,64,58,80,65,80,405,0.5423728813559322,70,80,102,80,102,40,474,0.2677165354330709,2.0
65,80,80,59,63,58,405,0.4411764705882353,40,60,40,40,40,30,250,0.0948905109489051,1.0
50,50,150,50,150,50,500,0.2571428571428571,109,66,84,81,99,32,471,0.2013888888888889,0.5
36,50,50,65,60,44,305,0.16363636363636364,55,50,40,40,40,75,300,0.5945945945945946,1.0
60,59,85,79,105,36,424,0.16666666666666666,70,85,70,60,70,50,405,0.28378378378378377,4.0
55,47,52,40,40,41,275,0.16806722689075632,91,129,90,72,90,108,580,0.8536585365853658,0.5
70,84,70,65,70,51,410,0.2949640287769784,105,95,80,40,80,90,490,0.753968253968254,1.0
78,81,71,74,69,126,499,0.9090909090909091,49,66,70,44,55,51,335,0.4260869565217391,4.0
50,50,120,80,80,30,410,0.07258064516129033,90,100,90,125,85,90,580,0.7352941176470589,2.0
77,59,50,67,63,46,362,0.23140495867768596,80,70,70,90,100,70,480,0.5609756097560976,1.0
49,49,56,49,61,66,330,0.5190839694656488,100,50,80,60,80,50,420,0.34375,0.5
59,63,80,65,80,58,405,0.41843971631205673,45,60,45,25,45,55,275,0.29,1.0
66,65,48,62,57,52,350,0.36220472440944884,45,55,45,65,45,75,330,0.5692307692307692,0.5
60,50,40,85,75,95,405,0.7540983606557377,64,165,75,93,83,75,555,0.6587301587301587,1.0
75,100,66,60,66,115,482,0.918918918918919,79,115,70,125,80,111,580,0.8468468468468469,1.0
75,95,125,45,75,95,510,0.8257575757575758,90,100,90,125,85,90,580,0.7352941176470589,0.0
75,95,67,125,95,83,540,0.7117117117117117,50,72,35,35,35,65,292,0.5373134328358209,1.0
51,65,65,80,75,59,395,0.4365079365079365,60,69,95,69,95,36,424,0.2608695652173913,0.5
150,160,100,95,65,100,670,0.8866666666666667,100,100,100,100,100,100,600,0.8758169934640523,0.5
110,80,90,95,90,65,530,0.5033557046979866,62,77,62,50,42,65,358,0.4838709677419355,2.0
30,80,90,55,45,55,355,0.4295774647887324,48,72,48,72,48,48,336,0.25984251968503935,1.0
40,45,35,65,55,70,310,0.4482758620689655,50,160,110,160,110,110,700,0.8854961832061069,2.0
50,65,90,35,35,15,290,0.14678899082568808,70,105,105,50,40,20,390,0.33587786259541985,1.0
40,35,30,120,70,105,400,0.6692307692307692,68,65,65,125,115,80,518,0.6461538461538462,0.5
60,60,50,40,50,75,335,0.5882352941176471,67,125,40,30,30,58,350,0.3431372549019608,1.0
54,45,47,75,98,52,371,0.39669421487603307,95,117,184,44,46,28,514,0.2975206611570248,1.0
35,40,100,90,55,35,355,0.1796875,20,40,15,35,35,60,205,0.34285714285714286,1.0
65,125,60,95,60,105,510,0.9236641221374046,55,104,105,94,75,52,485,0.36363636363636365,1.0
25,20,15,105,55,90,310,0.32407407407407407,85,135,130,60,80,25,515,0.40540540540540543,1.0
50,53,48,53,48,64,316,0.358974358974359,60,65,80,170,95,130,600,0.8625954198473282,1.0
50,65,107,105,107,86,520,0.7313432835820896,95,65,110,60,130,65,525,0.5275590551181102,1.0
65,65,60,110,95,130,525,0.9253731343283582,60,60,60,85,85,85,435,0.631578947368421,1.0
79,115,70,125,80,111,580,0.864,68,165,95,65,115,110,618,0.8615384615384616,2.0
60,79,105,59,85,36,424,0.17054263565891473,55,55,50,45,65,55,325,0.37373737373737376,1.0
105,140,95,55,65,45,505,0.3,70,95,85,55,65,70,440,0.5,1.0
60,79,105,59,85,36,424,0.17054263565891473,85,110,76,65,82,56,474,0.3933333333333333,0.5
40,40,35,50,100,70,335,0.5031847133757962,62,44,50,44,50,55,305,0.3629032258064516,0.5
106,130,90,110,154,90,680,0.719626168224299,62,50,58,73,54,72,369,0.4435483870967742,0.5
25,20,15,105,55,90,310,0.32407407407407407,80,82,100,83,100,80,525,0.6821705426356589,1.0
59,110,150,45,49,35,448,0.3333333333333333,62,44,50,44,50,55,305,0.3629032258064516,0.5
60,40,60,95,60,55,370,0.4222222222222222,60,75,100,55,80,50,420,0.3088235294117647,4.0
72,95,67,103,71,122,530,0.9606299212598425,64,88,50,88,50,106,446,0.9111111111111111,0.5
60,60,60,85,85,85,435,0.631578947368421,55,50,65,175,95,150,590,0.7818181818181819,2.0
62,48,54,63,60,68,355,0.5178571428571429,65,40,70,80,140,70,465,0.5954198473282443,1.0
60,95,80,60,80,30,405,0.19480519480519481,50,95,95,35,110,70,455,0.5179856115107914,0.5
45,50,55,75,65,30,320,0.06293706293706294,100,100,80,60,60,50,450,0.3050847457627119,1.0
85,100,122,58,75,54,494,0.3939393939393939,50,70,50,50,50,40,310,0.16296296296296298,2.0
45,67,60,35,50,63,320,0.5128205128205128,70,45,48,60,65,35,323,0.15748031496062992,1.0
80,52,50,90,50,89,411,0.6666666666666666,105,180,100,180,100,115,780,0.9477611940298507,0.5
65,90,120,85,70,60,490,0.43410852713178294,105,125,100,60,100,100,590,0.8359375,1.0
40,60,40,40,40,30,250,0.0948905109489051,120,70,120,75,130,85,600,0.6694915254237288,2.0
50,105,125,55,95,50,480,0.375886524822695,10,55,25,35,45,95,265,0.5396825396825397,1.0
95,65,110,60,130,65,525,0.5275590551181102,40,45,35,40,40,90,290,0.65,1.0
95,155,109,70,130,81,640,0.6788321167883211,100,100,100,100,100,100,600,0.8602941176470589,0.5
50,180,20,180,20,150,600,0.9029850746268657,55,85,122,58,75,99,494,0.8099173553719008,1.0
91,90,129,90,72,108,580,0.9140625,100,123,75,57,75,80,510,0.6923076923076923,1.0
95,124,78,69,71,58,495,0.37398373983739835,70,80,65,90,65,85,455,0.578125,2.0
80,110,60,150,130,70,600,0.5042016806722689,110,130,80,70,60,80,530,0.5862068965517241,2.0
50,25,28,45,55,15,218,0.0625,25,20,15,105,55,90,310,0.32407407407407407,1.0
95,70,73,95,90,60,483,0.3983739837398374,80,145,150,105,110,110,700,0.8692307692307693,0.5
95,125,79,60,100,81,540,0.6165413533834586,50,80,95,10,45,10,290,0.232,1.0
70,135,105,60,105,20,495,0.5806451612903226,60,95,80,60,80,30,405,0.19480519480519481,2.0
91,90,129,90,72,108,580,0.9140625,89,125,90,115,80,101,600,0.8725490196078431,0.5
50,95,90,95,90,180,600,0.9172413793103448,45,35,50,70,50,30,280,0.15753424657534246,1.0
66,65,48,62,57,52,350,0.36220472440944884,70,80,70,80,70,110,480,0.6594202898550725,1.0
50,105,79,35,110,76,455,0.6214285714285714,56,61,65,48,45,38,313,0.17567567567567569,1.0
50,65,107,105,107,86,520,0.7272727272727273,68,72,78,38,42,32,330,0.23809523809523808,0.0
95,85,85,65,65,35,430,0.2571428571428571,60,130,80,60,60,70,460,0.5153846153846153,0.25
80,80,80,55,55,90,440,0.6417910447761194,110,123,65,100,65,65,528,0.5217391304347826,1.0
111,83,68,92,82,39,475,0.1774193548387097,70,20,50,20,50,40,250,0.1557377049180328,0.5
78,81,71,74,69,126,499,0.9090909090909091,91,90,106,130,106,77,600,0.648854961832061,0.5
90,92,87,75,85,76,505,0.5409836065573771,49,55,42,42,37,85,310,0.6068376068376068,1.0
76,25,45,67,55,24,292,0.0390625,80,100,70,50,60,45,405,0.25806451612903225,1.0
65,65,60,130,95,110,525,0.823943661971831,80,100,80,80,80,100,520,0.9051724137931034,2.0
70,85,65,105,85,120,530,0.9262295081967213,65,65,60,110,95,130,525,0.9253731343283582,1.0
55,55,85,65,85,35,380,0.2014388489208633,62,55,52,109,94,109,481,0.7833333333333333,1.0
95,125,79,60,100,81,540,0.6165413533834586,45,25,50,25,25,35,205,0.13076923076923078,2.0
75,105,75,105,75,45,480,0.3274336283185841,70,55,65,95,85,70,440,0.5307692307692308,2.0
50,65,90,35,35,15,290,0.14678899082568808,60,65,60,130,75,110,500,0.7719298245614035,0.25
50,72,35,35,35,65,292,0.5373134328358209,75,80,55,25,35,35,305,0.18666666666666668,0.5
35,35,40,35,55,50,250,0.40336134453781514,71,73,88,120,89,59,500,0.43537414965986393,2.0
65,125,60,95,60,105,510,0.9236641221374046,70,55,65,95,85,70,440,0.5307692307692308,1.0
75,75,95,75,95,113,528,0.9015151515151515,50,45,45,35,35,50,260,0.23529411764705882,1.0
50,53,48,53,48,64,316,0.4076923076923077,75,80,70,65,75,90,455,0.7578125,0.25
85,115,80,105,80,50,515,0.3063063063063063,50,60,45,100,80,65,400,0.45689655172413796,0.5
91,90,129,90,72,108,580,0.9140625,75,100,110,45,55,65,450,0.5333333333333333,1.0
55,20,35,20,45,75,250,0.37681159420289856,60,60,60,105,105,105,495,0.848,0.0
55,81,60,50,70,97,413,0.7214285714285714,50,65,107,105,107,86,520,0.7313432835820896,1.0
58,64,58,80,65,80,405,0.5423728813559322,1,90,45,30,30,40,236,0.33064516129032256,2.0
100,120,120,150,100,90,680,0.7880794701986755,55,55,85,65,85,35,380,0.2014388489208633,1.0
84,86,88,111,101,60,530,0.4634146341463415,50,50,120,80,80,30,410,0.07258064516129033,4.0
130,65,60,110,95,65,525,0.5227272727272727,55,40,50,65,85,40,335,0.3181818181818182,0.5
100,100,100,100,100,100,600,0.8778625954198473,89,145,90,105,80,91,600,0.8549618320610687,2.0
30,42,118,42,88,30,350,0.112,73,100,60,100,60,65,458,0.42657342657342656,1.0
70,80,102,80,102,40,474,0.2677165354330709,55,50,45,135,95,120,500,0.7714285714285715,2.0
75,38,38,56,56,67,330,0.5263157894736842,60,65,70,85,75,40,395,0.21705426356589147,0.25
60,75,85,100,85,115,520,0.8992248062015504,80,82,100,83,100,80,525,0.6821705426356589,0.5
42,52,67,39,56,50,306,0.2868217054263566,65,100,70,80,80,105,500,0.8666666666666667,4.0
110,130,80,70,60,80,530,0.5862068965517241,115,45,20,45,25,20,270,0.11538461538461539,1.0
55,65,95,95,45,85,440,0.6610169491525424,46,87,60,30,40,57,320,0.37777777777777777,0.5
123,77,72,99,92,58,521,0.4621212121212121,55,45,43,55,43,72,313,0.5853658536585366,4.0
150,120,100,120,100,90,680,0.664179104477612,100,180,160,150,90,90,770,0.7520661157024794,1.0
50,40,85,40,65,25,305,0.08870967741935484,75,90,50,110,80,95,500,0.7985611510791367,1.0
63,120,85,90,55,55,468,0.2809917355371901,70,140,230,60,80,50,630,0.32432432432432434,1.0
58,64,58,80,65,80,405,0.5423728813559322,50,105,125,55,95,50,480,0.375886524822695,2.0
55,45,50,45,65,80,340,0.5546218487394958,79,115,70,125,80,111,580,0.864,0.25
60,62,63,80,80,60,405,0.38016528925619836,50,65,107,105,107,86,520,0.7758620689655172,2.0
110,123,65,100,65,65,528,0.5217391304347826,50,50,50,50,50,50,300,0.30708661417322836,4.0
160,110,65,65,110,30,540,0.35714285714285715,68,90,65,50,55,82,410,0.6165413533834586,1.0
55,20,35,20,45,75,250,0.37681159420289856,60,70,105,70,120,75,500,0.5983606557377049,1.0
80,145,150,105,110,110,700,0.8692307692307693,70,90,90,135,90,125,600,0.9401709401709402,0.0
70,40,50,55,50,25,290,0.061068702290076333,60,50,70,80,80,140,480,0.8449612403100775,1.0
70,60,125,115,70,55,495,0.35507246376811596,90,30,15,40,20,15,210,0.043478260869565216,1.0
40,45,65,100,120,90,460,0.5588235294117647,114,85,70,85,80,30,464,0.2066115702479339,1.0
80,100,70,60,70,95,475,0.7416666666666667,150,120,100,120,100,90,680,0.664179104477612,0.0
75,95,95,95,95,85,540,0.6470588235294118,65,70,60,65,65,115,440,0.8583333333333333,1.0
65,80,80,59,63,58,405,0.4411764705882353,68,85,65,165,135,100,618,0.8083333333333333,1.0
50,45,45,35,35,50,260,0.23529411764705882,50,85,125,85,115,20,480,0.4306569343065693,0.0
50,64,50,45,50,41,300,0.22727272727272727,80,185,115,40,105,75,600,0.6230769230769231,0.5
95,23,48,23,48,23,260,0.046153846153846156,75,80,60,65,90,102,472,0.8625954198473282,1.0
60,95,80,60,80,30,405,0.19480519480519481,65,125,100,60,70,70,490,0.6099290780141844,0.5
60,65,70,85,75,40,395,0.21705426356589147,65,65,65,50,50,90,385,0.72,2.0
100,100,100,100,100,100,600,0.8345864661654135,75,70,90,70,105,80,490,0.656,0.25
83,80,75,70,70,101,479,0.8615384615384616,62,77,62,50,42,65,358,0.4838709677419355,1.0
50,95,95,35,110,70,455,0.5179856115107914,45,100,45,45,45,10,290,0.2949640287769784,1.0
45,55,39,35,39,42,255,0.18518518518518517,110,65,105,55,95,80,510,0.6258503401360545,1.0
100,134,110,95,100,61,600,0.4057971014492754,125,120,90,170,100,95,700,0.78125,2.0
45,35,50,70,50,30,280,0.15753424657534246,80,80,80,80,80,80,480,0.5606060606060606,2.0
110,65,105,55,95,80,510,0.6258503401360545,68,125,65,65,115,80,518,0.6277372262773723,2.0
105,180,100,180,100,115,780,0.9477611940298507,70,135,105,60,105,20,495,0.5806451612903226,0.5
30,45,55,70,55,85,340,0.5633802816901409,85,76,64,45,55,90,415,0.6739130434782609,1.0
103,93,67,71,61,84,479,0.7142857142857143,60,85,69,60,69,77,420,0.518796992481203,1.0
90,60,60,40,40,40,330,0.29545454545454547,70,80,102,80,102,40,474,0.2677165354330709,0.0
60,50,100,85,70,65,430,0.47580645161290325,55,40,85,80,105,40,405,0.23622047244094488,1.0
40,40,35,50,100,70,335,0.5031847133757962,35,80,50,50,70,120,405,0.84375,1.0
80,135,130,95,90,70,600,0.5181818181818182,62,48,54,63,60,68,355,0.5178571428571429,0.5
70,85,140,85,70,20,470,0.272,67,82,62,46,48,43,348,0.22033898305084745,1.0
71,82,64,64,59,112,452,0.9327731092436975,40,45,40,62,60,60,307,0.33884297520661155,1.0
60,100,89,55,69,112,485,0.9298245614035088,92,105,90,125,90,98,600,0.8217054263565892,2.0
65,105,60,60,70,95,455,63.0,60,55,90,145,90,80,520,0.6071428571428571,0.0
120,100,85,30,85,45,465,0.22448979591836735,45,100,45,45,45,10,290,0.2949640287769784,1.0
70,85,140,85,70,20,470,0.272,30,45,59,30,39,57,260,0.2803030303030303,2.0
80,130,100,160,120,110,700,0.8981481481481481,100,100,90,150,140,90,670,0.71875,1.0
60,85,60,50,50,125,430,0.9090909090909091,40,45,35,40,40,90,290,0.65,1.0
60,130,80,60,60,70,460,0.5153846153846153,70,110,70,115,70,90,525,0.75,1.0
80,160,80,130,80,100,630,0.8455284552845529,90,92,87,75,85,76,505,0.5409836065573771,0.5
62,73,55,56,52,84,382,0.7244094488188977,75,98,63,98,63,101,498,0.8091603053435115,4.0
55,40,85,80,105,40,405,0.23622047244094488,50,105,79,35,110,76,455,0.6214285714285714,4.0
78,130,111,130,85,100,634,0.8561151079136691,35,45,160,30,45,70,385,0.48148148148148145,0.5
40,29,45,29,45,36,224,0.14634146341463414,40,40,35,50,100,70,335,0.5031847133757962,0.5
20,10,55,15,20,80,200,0.17985611510791366,100,120,100,150,120,90,680,0.728,1.0
71,95,85,110,95,79,535,0.664,90,60,70,75,70,45,410,0.23880597014925373,0.25
40,45,40,62,60,60,307,0.33884297520661155,60,67,85,77,75,116,480,0.8888888888888888,2.0
95,125,79,60,100,81,540,0.6165413533834586,100,75,115,90,115,85,580,0.6446280991735537,0.5
50,95,95,35,110,70,455,0.5179856115107914,60,75,100,55,80,50,420,0.3088235294117647,1.0
40,65,95,60,45,35,340,0.13986013986013987,59,66,70,44,55,41,335,0.25190839694656486,1.0
59,74,50,35,50,35,303,0.3125,45,30,50,55,65,45,290,0.208,2.0
100,100,100,100,100,100,600,0.8758169934640523,100,100,100,100,100,100,600,0.8778625954198473,0.25
40,27,60,37,50,66,280,0.36220472440944884,80,125,75,40,95,85,500,0.6911764705882353,1.0
85,110,90,45,90,80,500,0.6206896551724138,85,105,55,85,50,115,495,0.9032258064516129,1.0
60,45,70,75,85,55,390,0.3008130081300813,70,115,60,115,60,55,475,0.4647887323943662,0.0
40,60,40,40,40,30,250,0.0948905109489051,115,45,20,45,25,20,270,0.11538461538461539,1.0
50,20,55,25,25,30,205,0.09774436090225563,50,85,55,65,65,90,410,0.7478260869565218,0.5
80,82,100,83,100,80,525,0.6821705426356589,60,60,75,60,75,80,410,0.7321428571428571,1.0
69,69,76,69,86,91,460,0.6554621848739496,120,100,85,30,85,45,465,0.22448979591836735,1.0
55,40,40,65,45,35,280,0.16428571428571428,95,135,80,110,80,100,600,0.8248175182481752,1.0
55,50,40,40,40,75,300,0.5945945945945946,45,75,60,40,30,50,300,0.304,1.0
30,105,90,25,25,50,325,0.2773722627737226,75,98,63,98,63,101,498,0.849624060150376,0.5
45,49,65,49,65,45,318,0.275,60,55,145,75,150,40,525,0.2,1.0
80,95,82,60,82,75,474,0.6,55,45,50,45,65,80,340,0.5546218487394958,2.0
95,145,130,120,90,120,700,0.9398496240601504,150,100,120,100,120,90,680,0.6666666666666666,2.0
60,90,140,50,50,40,430,0.2535211267605634,62,48,54,63,60,68,355,0.5178571428571429,1.0
60,80,110,50,80,45,425,0.2833333333333333,35,35,35,35,35,35,210,0.13385826771653545,1.0
80,52,50,90,50,89,411,0.6666666666666666,70,85,140,85,70,20,470,0.272,0.5
40,30,50,55,55,100,330,0.584070796460177,90,90,85,125,90,100,580,0.768595041322314,1.0
70,80,50,35,35,35,305,0.14,95,155,109,70,130,81,640,0.6788321167883211,2.0
73,100,60,100,60,65,458,0.42657342657342656,55,63,90,50,80,42,380,0.21138211382113822,2.0
60,65,70,85,75,40,395,0.21705426356589147,100,50,80,60,80,50,420,0.34375,4.0
72,58,80,103,80,97,490,0.7171052631578947,69,69,76,69,86,91,460,0.6554621848739496,1.0
30,45,59,30,39,57,260,0.2803030303030303,75,90,140,60,60,40,465,0.3008130081300813,0.0
90,90,85,125,90,100,580,0.768595041322314,30,56,35,25,35,72,253,0.48148148148148145,1.0
55,104,105,94,75,52,485,0.36363636363636365,85,105,100,79,83,78,530,0.5869565217391305,0.5
76,65,45,92,42,91,411,0.7449664429530202,50,50,120,80,80,30,410,0.07258064516129033,0.25
58,89,77,45,45,48,362,0.3177570093457944,20,10,230,10,230,5,505,0.0,2.0
65,90,50,85,45,55,390,0.371900826446281,90,85,75,115,100,115,580,0.9381443298969072,1.0
60,79,105,59,85,36,424,0.17054263565891473,85,110,90,45,90,80,500,0.6206896551724138,1.0
35,20,65,40,65,20,245,0.02459016393442623,114,85,70,85,80,30,464,0.2066115702479339,0.5
79,115,70,125,80,111,580,0.864,75,89,85,55,65,36,405,0.29545454545454547,1.0
38,41,40,50,65,65,299,0.4108527131782946,80,185,115,40,105,75,600,0.6230769230769231,2.0
70,70,40,60,40,60,340,0.4247787610619469,100,75,115,90,115,85,580,0.6446280991735537,2.0
80,120,70,110,70,80,530,0.6422764227642277,95,95,85,125,65,55,520,0.3894736842105263,1.0
45,100,45,45,45,10,290,0.2949640287769784,40,27,60,37,50,66,280,0.36220472440944884,0.5
80,120,79,95,79,70,523,0.5833333333333334,65,90,120,85,70,60,490,0.43410852713178294,1.0
160,110,65,65,110,30,540,0.35714285714285715,100,100,125,110,50,50,535,0.384,1.0
75,89,85,55,65,36,405,0.29545454545454547,90,120,100,150,120,100,680,0.7718120805369127,1.0
69,55,45,55,55,15,294,0.11666666666666667,60,85,69,65,79,80,438,0.576,0.25
55,85,122,58,75,99,494,0.8099173553719008,45,90,20,65,20,65,305,0.5116279069767442,1.0
30,80,90,55,45,55,355,0.4295774647887324,85,80,70,135,75,90,535,0.7006802721088435,1.0
91,90,106,130,106,77,600,0.648854961832061,65,90,120,85,70,60,490,0.43410852713178294,1.0
75,125,230,55,95,30,610,0.3448275862068966,135,85,40,40,85,5,390,0.6864406779661016,1.0
40,30,50,55,55,100,330,0.584070796460177,70,120,65,45,85,125,510,0.9747899159663865,1.0
105,140,55,30,55,95,480,0.8195488721804511,60,80,95,70,85,50,440,0.2231404958677686,2.0
80,185,115,40,105,75,600,0.6230769230769231,77,85,51,55,51,65,384,0.5163934426229508,0.5
65,60,110,130,95,65,525,0.47761194029850745,75,38,38,56,56,67,330,0.5263157894736842,0.5
55,40,40,65,45,35,280,0.16428571428571428,48,61,40,61,40,50,300,0.2543859649122807,1.0
75,125,70,125,70,115,580,0.9037037037037037,75,95,67,125,95,83,540,0.7117117117117117,1.0
60,50,40,85,75,95,405,0.7540983606557377,79,85,60,55,60,71,410,0.60431654676259,2.0
75,80,85,110,90,50,490,0.3548387096774194,84,86,88,111,101,60,530,0.4634146341463415,0.0
85,97,66,105,66,65,484,0.47107438016528924,70,60,125,115,70,55,495,0.35507246376811596,0.25
165,75,80,40,45,65,470,0.5151515151515151,70,95,125,65,75,45,475,0.33613445378151263,2.0
90,132,105,132,105,30,594,0.4246575342465753,53,51,53,61,56,40,314,0.14285714285714285,1.0
97,165,60,65,50,58,495,0.3902439024390244,91,129,90,72,90,108,580,0.8536585365853658,0.5
67,82,62,46,48,43,348,0.22033898305084745,90,60,60,40,40,40,330,0.29545454545454547,1.0
60,50,40,85,75,95,405,0.7540983606557377,80,80,80,80,80,80,480,0.5606060606060606,2.0
90,120,120,60,60,50,500,0.35294117647058826,89,145,90,105,80,91,600,0.8549618320610687,0.0
40,60,30,31,31,70,262,0.4492753623188406,85,60,65,135,105,100,550,0.7518248175182481,2.0
80,95,82,60,82,75,474,0.6,53,54,53,37,46,45,288,0.3090909090909091,1.0
84,86,88,111,101,60,530,0.4634146341463415,105,150,90,150,90,95,680,0.8285714285714286,0.5
60,110,70,60,60,100,460,0.8461538461538461,59,74,50,35,50,35,303,0.3125,0.0
110,78,73,76,71,60,468,0.3333333333333333,45,67,60,35,50,63,320,0.5128205128205128,0.5
100,150,120,120,100,90,680,0.6493506493506493,80,105,65,60,75,130,515,0.9645390070921985,2.0
60,59,85,79,105,36,424,0.16666666666666666,36,50,50,65,60,44,305,0.16363636363636364,1.0
20,40,90,30,90,25,295,0.11363636363636363,109,66,84,81,99,32,471,0.2013888888888889,1.0
45,20,50,60,120,50,345,0.24074074074074073,105,180,100,180,100,115,780,0.9477611940298507,0.5
75,75,55,105,85,30,425,0.1619718309859155,45,100,135,65,135,45,525,0.29411764705882354,1.0
80,135,130,95,90,70,600,0.5181818181818182,60,45,70,75,85,55,390,0.3008130081300813,0.5
60,70,50,100,50,65,395,0.5217391304347826,44,48,65,50,64,43,314,0.1623931623931624,1.0
95,60,79,100,125,81,540,0.6201550387596899,57,24,86,24,86,23,300,0.12727272727272726,1.0
70,92,65,80,55,98,460,0.8090909090909091,100,180,160,150,90,90,770,0.7520661157024794,4.0
50,50,62,40,62,65,329,0.4188034188034188,35,40,100,90,55,35,355,0.1796875,0.5
100,100,100,100,100,100,600,0.8805970149253731,60,50,40,85,75,95,405,0.7540983606557377,1.0
80,160,80,130,80,100,630,0.8455284552845529,80,70,65,80,120,100,515,0.8034188034188035,0.25
50,65,107,105,107,86,520,0.7272727272727273,100,100,100,100,100,100,600,0.8345864661654135,1.0
50,35,55,25,25,15,205,0.05263157894736842,71,82,64,64,59,112,452,0.9327731092436975,1.0
50,150,50,150,50,150,600,0.9339622641509434,38,41,40,50,65,65,299,0.4108527131782946,1.0
75,69,72,114,100,104,534,0.8253968253968254,45,30,40,105,50,20,290,0.031007751937984496,0.5
90,60,70,75,70,45,410,0.23880597014925373,89,145,90,105,80,91,600,0.8549618320610687,8.0
52,65,50,45,50,38,300,0.27419354838709675,63,63,47,41,41,74,329,0.56,0.5
95,75,80,100,110,30,490,0.24242424242424243,100,150,140,100,90,90,670,0.7969924812030075,4.0
58,89,77,45,45,48,362,0.3177570093457944,50,20,55,25,25,30,205,0.09774436090225563,2.0
50,60,60,60,60,30,320,0.11290322580645161,70,92,65,80,55,98,460,0.8090909090909091,0.5
75,95,125,45,75,95,510,0.8257575757575758,90,100,90,125,85,90,580,0.7352941176470589,0.0
55,40,50,65,85,40,335,0.3181818181818182,60,55,50,40,55,45,305,0.22377622377622378,1.0
125,58,58,76,76,67,460,0.515625,50,65,107,105,107,86,520,0.7313432835820896,0.125
70,77,60,97,60,108,472,0.8394160583941606,74,100,72,90,72,46,454,0.24561403508771928,1.0
106,90,130,90,154,110,680,0.8699186991869918,80,70,70,90,100,70,480,0.5609756097560976,2.0
80,120,70,110,70,80,530,0.6422764227642277,78,84,78,109,85,100,534,0.8646616541353384,0.25
55,104,105,94,75,52,485,0.36363636363636365,78,52,60,63,65,23,341,0.06015037593984962,1.0
25,20,15,105,55,90,310,0.32407407407407407,65,125,60,95,60,105,510,0.9236641221374046,1.0
43,70,48,50,60,38,309,0.2391304347826087,85,80,70,135,75,90,535,0.7006802721088435,0.0
40,65,95,60,45,35,340,0.13986013986013987,65,95,100,60,50,50,420,0.34959349593495936,1.0
70,120,100,145,105,20,560,0.2824427480916031,64,165,75,93,83,75,555,0.6587301587301587,1.0
85,70,80,97,80,123,535,0.9304347826086956,65,75,105,35,65,85,430,0.6940298507462687,1.0
170,90,45,90,45,60,500,0.427536231884058,105,150,90,150,90,95,680,0.8285714285714286,0.5
56,61,65,48,45,38,313,0.17567567567567569,82,80,86,85,75,72,480,0.6183206106870229,1.0
55,47,52,40,40,41,275,0.16806722689075632,100,134,110,95,100,61,600,0.4057971014492754,0.5
45,60,32,50,32,76,295,0.5925925925925926,85,100,122,58,75,54,494,0.3939393939393939,0.5
80,95,82,60,82,75,474,0.6,70,55,75,45,65,60,370,0.45901639344262296,1.0
68,125,65,65,115,80,518,0.6277372262773723,95,117,184,44,46,28,514,0.2975206611570248,2.0
71,95,85,110,95,79,535,0.664,45,55,45,65,45,75,330,0.5692307692307692,1.0
72,85,70,65,70,58,420,0.41304347826086957,85,105,55,85,50,115,495,0.9032258064516129,1.0
60,60,60,105,105,105,495,0.848,95,75,110,100,80,30,490,0.15267175572519084,2.0
90,55,75,60,75,30,385,0.13970588235294118,65,83,57,95,85,105,490,0.8914728682170543,1.0
65,65,60,110,95,130,525,0.9253731343283582,70,60,70,87,78,85,450,0.6228070175438597,0.5
45,49,65,49,65,45,318,0.275,71,82,64,64,59,112,452,0.9327731092436975,1.0
60,105,60,120,60,105,510,0.8849557522123894,86,81,97,81,107,43,495,0.203125,1.0
30,105,90,25,25,50,325,0.2773722627737226,50,50,50,50,50,50,300,0.30708661417322836,1.0
105,130,120,45,45,40,485,0.4444444444444444,80,100,70,50,60,45,405,0.25806451612903225,0.5
40,65,95,60,45,35,340,0.13986013986013987,65,90,50,85,45,55,390,0.371900826446281,1.0
45,50,43,40,38,62,278,0.40441176470588236,45,60,32,50,32,76,295,0.5925925925925926,0.5
91,129,90,72,90,108,580,0.8536585365853658,63,120,85,90,55,55,468,0.2809917355371901,2.0
100,150,110,95,110,70,635,0.5923076923076923,40,30,50,55,55,100,330,0.584070796460177,2.0
55,75,85,25,25,15,280,0.1875,45,25,50,25,25,35,205,0.13076923076923078,2.0
62,73,55,56,52,84,382,0.7244094488188977,90,132,105,132,105,30,594,0.4246575342465753,8.0
116,55,85,107,95,29,487,0.06818181818181818,83,80,75,70,70,101,479,0.8615384615384616,1.0
85,105,85,40,50,40,405,0.211864406779661,55,81,60,50,70,97,413,0.7214285714285714,2.0
91,90,72,90,129,108,580,0.896,110,130,80,70,60,80,530,0.5862068965517241,4.0
45,100,45,45,45,10,290,0.2949640287769784,110,123,65,100,65,65,528,0.5217391304347826,2.0
58,70,45,40,45,42,300,0.25925925925925924,70,115,60,115,60,55,475,0.4647887323943662,0.5
59,63,80,65,80,58,405,0.41843971631205673,50,65,107,105,107,86,520,0.7272727272727273,1.0
50,60,60,60,60,30,320,0.11290322580645161,70,60,125,115,70,55,495,0.35507246376811596,0.5
60,45,50,90,80,70,395,0.625,160,110,65,65,110,30,540,0.35714285714285715,1.0
80,110,120,130,90,70,600,0.6198347107438017,90,92,75,92,85,60,494,0.49586776859504134,2.0
95,109,105,75,85,56,525,0.34513274336283184,45,100,135,65,135,45,525,0.29411764705882354,1.0
59,74,50,35,50,35,303,0.3125,45,85,50,55,50,65,350,0.5076923076923077,1.0
70,77,60,97,60,108,472,0.8394160583941606,130,65,60,110,95,65,525,0.5227272727272727,2.0
67,82,62,46,48,43,348,0.22033898305084745,100,75,115,90,115,85,580,0.6446280991735537,1.0
120,70,120,75,130,85,600,0.6694915254237288,85,70,80,97,80,123,535,0.9304347826086956,1.0
79,115,70,125,80,111,580,0.8468468468468469,35,80,50,50,70,120,405,0.84375,1.0
95,155,109,70,130,81,640,0.6788321167883211,65,50,70,95,80,65,425,0.4262295081967213,2.0
100,100,100,100,100,100,600,0.8778625954198473,44,48,65,50,64,43,314,0.1623931623931624,0.5
91,90,106,130,106,77,600,0.648854961832061,85,105,55,85,50,115,495,0.9032258064516129,0.25
40,45,65,100,120,90,460,0.5588235294117647,40,70,40,35,40,60,285,0.392,2.0
70,65,60,90,75,90,450,0.6571428571428571,104,91,63,91,73,68,490,0.5118110236220472,1.0
80,92,65,65,80,68,450,0.4824561403508772,160,110,65,65,110,30,540,0.35714285714285715,1.0
106,190,100,154,100,130,780,0.9259259259259259,70,55,55,80,60,45,365,0.2222222222222222,1.0
50,53,62,58,63,44,330,0.13709677419354838,80,115,80,65,55,93,488,0.7846153846153846,1.0
41,56,40,62,44,71,314,0.568,80,130,100,160,120,110,700,0.8981481481481481,0.5
59,74,50,35,50,35,303,0.3125,35,35,40,35,55,50,250,0.40336134453781514,0.0
61,90,45,50,50,160,456,0.9230769230769231,100,110,90,85,90,60,535,0.47794117647058826,1.0
50,70,50,50,50,70,340,0.5645161290322581,55,50,45,135,95,120,500,0.7714285714285715,1.0
75,75,75,125,95,40,485,0.15671641791044777,60,55,145,75,150,40,525,0.2,0.5
80,90,80,130,110,110,600,0.856,91,72,90,129,90,108,580,0.8925619834710744,1.0
40,50,90,30,55,65,330,0.44680851063829785,50,105,79,35,110,76,455,0.6214285714285714,0.5
61,72,57,55,55,65,365,0.3984375,80,82,100,83,100,80,525,0.6821705426356589,2.0
60,40,60,40,60,35,295,0.18055555555555555,60,60,60,105,105,105,495,0.848,1.0
120,100,85,30,85,45,465,0.22448979591836735,63,63,47,41,41,74,329,0.56,1.0
70,70,70,70,70,70,420,0.5289256198347108,73,76,75,81,100,100,505,0.8110236220472441,1.0
45,45,55,45,55,63,308,0.4594594594594595,80,95,82,60,82,75,474,0.6,0.5
100,5,5,15,65,30,220,0.07692307692307693,130,70,35,70,35,60,400,0.4017857142857143,1.0
106,90,130,90,154,110,680,0.8699186991869918,45,60,32,50,32,76,295,0.5925925925925926,0.5
125,170,100,120,90,95,700,0.77,60,80,50,50,50,40,330,0.23853211009174313,1.0
70,40,50,55,50,25,290,0.061068702290076333,50,65,64,44,48,43,314,0.2196969696969697,0.25
50,75,70,35,70,48,348,0.29357798165137616,150,100,120,100,120,90,680,0.6666666666666666,0.0
60,55,90,145,90,80,520,0.6071428571428571,55,75,85,25,25,15,280,0.1875,0.5
70,43,53,43,53,40,302,0.19090909090909092,95,145,130,120,90,120,700,0.9398496240601504,1.0
91,90,106,130,106,77,600,0.648854961832061,40,29,45,29,45,36,224,0.14634146341463414,2.0
80,120,79,95,79,70,523,0.5833333333333334,86,92,88,68,75,73,482,0.6835443037974683,1.0
50,35,55,25,25,15,205,0.021739130434782608,70,62,67,55,55,56,365,0.38513513513513514,0.5
100,150,110,95,110,70,635,0.5923076923076923,60,62,63,80,80,60,405,0.38016528925619836,0.5
88,107,122,74,75,64,530,0.4596774193548387,80,90,80,130,110,110,600,0.856,0.25
35,20,65,40,65,20,245,0.02459016393442623,60,75,85,100,85,115,520,0.8992248062015504,1.0
70,80,50,35,35,35,305,0.14,67,82,62,46,48,43,348,0.22033898305084745,1.0
80,82,83,100,100,80,525,0.6742424242424242,30,40,55,40,55,60,280,0.3237410071942446,1.0
50,20,40,20,40,20,190,0.0962962962962963,80,80,50,40,50,25,325,0.176056338028169,0.5
110,135,60,50,65,88,508,0.7744360902255639,75,100,63,80,63,116,497,0.9345794392523364,1.0
60,60,75,60,75,80,410,0.7321428571428571,95,109,105,75,85,56,525,0.34513274336283184,2.0
110,80,90,95,90,65,530,0.5033557046979866,60,60,60,35,35,30,280,0.11194029850746269,1.0
95,75,80,100,110,30,490,0.24242424242424243,68,65,65,125,115,80,518,0.6461538461538462,0.5
80,130,100,160,120,110,700,0.8981481481481481,85,70,80,97,80,123,535,0.9304347826086956,2.0
54,66,70,44,55,46,335,0.4214876033057851,65,90,40,45,80,75,395,0.625,0.25
106,190,100,154,100,130,780,0.9259259259259259,68,72,78,38,42,32,330,0.23809523809523808,2.0
50,85,85,55,55,50,380,0.3902439024390244,65,125,100,55,70,85,500,0.6532258064516129,1.0
35,20,65,40,65,20,245,0.02459016393442623,45,55,45,65,45,75,330,0.5692307692307692,1.0
108,170,115,120,95,92,700,0.7083333333333334,75,70,90,70,105,80,490,0.656,0.0
55,50,45,135,95,120,500,0.7714285714285715,55,70,55,40,55,85,360,0.7073170731707317,1.0
85,110,76,65,82,56,474,0.3933333333333333,39,52,43,60,50,65,309,0.5041322314049587,0.5
65,130,60,75,60,75,465,0.689922480620155,55,69,85,32,35,28,304,0.09302325581395349,1.0
40,45,35,40,40,90,290,0.65,60,55,145,75,150,40,525,0.2,0.25
30,40,55,40,55,60,280,0.3237410071942446,85,110,76,65,82,56,474,0.3933333333333333,0.0
50,30,55,65,55,20,275,0.13675213675213677,80,100,200,50,100,50,580,0.3472222222222222,0.5
60,45,70,75,85,55,390,0.3008130081300813,80,50,100,100,200,50,580,0.2357142857142857,1.0
60,50,100,85,70,65,430,0.47580645161290325,100,100,100,100,100,100,600,0.831858407079646,1.0
44,58,44,58,44,61,309,0.41964285714285715,126,131,95,131,98,99,680,0.8102189781021898,1.0
100,150,140,100,90,90,670,0.7969924812030075,40,55,30,30,30,85,270,0.688,0.0
50,50,50,50,50,50,300,0.30708661417322836,60,70,50,100,50,65,395,0.5217391304347826,2.0
60,40,80,60,45,40,325,0.23529411764705882,35,35,35,35,35,35,210,0.13385826771653545,1.0
70,105,105,50,40,20,390,0.33587786259541985,50,85,125,85,115,20,480,0.4306569343065693,1.0
50,45,45,35,35,50,260,0.23529411764705882,55,112,45,74,45,70,401,0.559322033898305,0.5
75,90,50,110,80,95,500,0.7985611510791367,50,20,40,20,40,20,190,0.0962962962962963,0.5
45,30,40,105,50,20,290,0.031007751937984496,65,55,115,100,40,60,435,0.3798449612403101,1.0
90,93,55,70,55,55,418,0.3819444444444444,73,76,75,81,100,100,505,0.8110236220472441,0.5
55,47,52,40,40,41,275,0.16806722689075632,95,60,79,100,125,81,540,0.6201550387596899,1.0
60,60,75,60,75,80,410,0.7321428571428571,55,55,85,65,85,35,380,0.2014388489208633,2.0
50,85,55,65,65,90,410,0.7478260869565218,90,100,90,125,85,90,580,0.7352941176470589,0.5
50,50,40,30,30,50,250,0.2781954887218045,75,65,55,65,55,69,384,0.43548387096774194,1.0
65,136,94,54,96,135,580,0.9612403100775194,85,120,70,50,60,100,485,0.8308823529411765,1.0
78,70,61,50,61,100,420,0.8145161290322581,50,95,90,95,90,180,600,0.9172413793103448,1.0
90,110,80,100,80,95,555,0.7982456140350878,109,66,84,81,99,32,471,0.2013888888888889,1.0
45,55,45,65,45,75,330,0.5692307692307692,91,90,106,130,106,77,600,0.648854961832061,0.125
71,73,88,120,89,59,500,0.43537414965986393,53,51,53,61,56,40,314,0.14285714285714285,0.5
85,80,70,135,75,90,535,0.7006802721088435,80,70,65,80,120,100,515,0.8034188034188035,1.0
50,92,108,92,108,35,485,0.2457627118644068,70,77,60,97,60,108,472,0.8394160583941606,1.0
70,94,50,94,50,66,424,0.48148148148148145,60,30,30,36,56,50,262,0.32432432432432434,0.5
60,115,105,65,70,80,495,0.7181818181818181,70,94,50,94,50,66,424,0.48148148148148145,4.0
60,79,105,59,85,36,424,0.17054263565891473,70,77,60,97,60,108,472,0.8394160583941606,1.0
50,85,55,65,65,90,410,0.7478260869565218,38,30,41,30,41,60,240,0.2897196261682243,1.0
70,100,70,105,75,40,460,0.23214285714285715,40,50,45,70,45,70,320,0.5517241379310345,0.0
61,90,45,50,50,160,456,0.9230769230769231,110,65,105,55,95,80,510,0.6258503401360545,1.0
45,75,60,40,30,50,300,0.304,80,145,150,105,110,110,700,0.8692307692307693,0.5
45,55,45,65,45,75,330,0.5692307692307692,20,10,55,15,20,80,200,0.17985611510791366,0.5
50,105,79,35,110,76,455,0.6214285714285714,70,110,70,115,70,90,525,0.75,2.0
65,63,45,45,45,45,308,0.2595419847328244,64,165,75,93,83,75,555,0.6587301587301587,1.0
40,50,45,70,45,70,320,0.5517241379310345,55,55,45,63,45,45,308,0.25,1.0
70,40,50,55,50,25,290,0.061068702290076333,62,48,54,63,60,68,355,0.5178571428571429,1.0
78,104,78,159,115,100,634,0.8444444444444444,40,20,30,40,80,55,265,0.22764227642276422,4.0
75,87,63,87,63,98,473,0.865546218487395,50,60,45,100,80,65,400,0.45689655172413796,1.0
60,50,100,85,70,65,430,0.47580645161290325,54,78,103,53,45,22,355,0.23255813953488372,0.5
85,90,80,70,80,130,535,0.9262295081967213,38,35,35,65,55,50,278,0.2647058823529412,2.0
90,92,75,92,85,60,494,0.49586776859504134,55,55,55,85,55,30,335,0.1320754716981132,1.0
75,90,90,140,90,115,600,0.9481481481481482,45,60,40,70,50,45,310,0.2846715328467153,0.5
50,64,50,45,50,41,300,0.22727272727272727,95,125,79,60,100,81,540,0.6165413533834586,0.0
30,40,70,70,25,60,295,0.41353383458646614,105,30,105,140,105,55,540,0.3524590163934426,2.0
60,45,50,90,80,70,395,0.625,50,40,85,40,65,25,305,0.08870967741935484,2.0
45,100,45,45,45,10,290,0.2949640287769784,30,105,90,25,25,50,325,0.2773722627737226,1.0
90,55,75,60,75,30,385,0.13970588235294118,65,150,40,15,80,145,495,0.9663865546218487,1.0
50,180,20,180,20,150,600,0.9029850746268657,86,81,97,81,107,43,495,0.203125,1.0
45,80,100,35,37,28,325,0.3125,70,83,50,37,50,60,350,0.3360655737704918,0.0
103,60,86,60,86,50,445,0.3458646616541353,60,80,110,50,80,45,425,0.2833333333333333,1.0
70,60,125,115,70,55,495,0.35507246376811596,84,86,88,111,101,60,530,0.4634146341463415,0.25
106,90,130,90,154,110,680,0.8699186991869918,50,95,180,85,45,70,525,0.5298507462686567,1.0
108,112,118,68,72,47,525,0.2916666666666667,70,83,50,37,50,60,350,0.3360655737704918,0.0
45,75,37,70,55,83,365,0.6183206106870229,55,84,105,114,75,52,485,0.2890625,0.5
65,90,40,45,80,75,395,0.625,40,30,30,40,50,30,220,0.07936507936507936,4.0
100,150,90,180,160,90,770,0.7348484848484849,65,90,50,85,45,55,390,0.371900826446281,0.5
106,90,130,90,154,110,680,0.8699186991869918,20,10,55,15,20,80,200,0.17985611510791366,1.0
70,110,70,115,70,90,525,0.75,70,115,60,115,60,55,475,0.4647887323943662,2.0
106,190,100,154,100,130,780,0.9259259259259259,60,48,45,43,90,42,328,0.21897810218978103,0.25
40,29,45,29,45,36,224,0.14634146341463414,40,40,35,50,100,70,335,0.5031847133757962,0.5
63,60,55,50,50,71,349,0.5289256198347108,70,77,60,97,60,108,472,0.8394160583941606,1.0
40,29,45,29,45,36,224,0.14634146341463414,126,131,95,131,98,99,680,0.8294573643410853,0.5
50,52,48,65,50,55,320,0.33098591549295775,85,110,90,45,90,80,500,0.6206896551724138,1.0
75,90,90,140,90,115,600,0.9481481481481482,40,55,80,35,60,30,300,0.15037593984962405,4.0
75,95,60,65,60,115,470,0.8778625954198473,60,80,95,70,85,50,440,0.2231404958677686,0.5
84,71,43,71,43,48,360,0.25874125874125875,80,120,79,95,79,70,523,0.5833333333333334,1.0
50,105,79,35,110,76,455,0.6214285714285714,78,130,111,130,85,100,634,0.8561151079136691,1.0
62,77,62,50,42,65,358,0.4838709677419355,60,95,80,60,80,30,405,0.19480519480519481,4.0
75,110,110,110,105,80,590,0.656934306569343,62,48,54,63,60,68,355,0.5178571428571429,1.0
52,65,50,45,50,38,300,0.27419354838709675,45,100,45,45,45,10,290,0.2949640287769784,1.0
50,55,50,36,30,43,264,0.2922077922077922,110,78,73,76,71,60,468,0.3333333333333333,1.0
60,85,42,85,42,91,405,0.8227848101265823,65,75,90,97,123,44,494,0.1987179487179487,1.0
80,92,65,65,80,68,450,0.4824561403508772,54,63,52,83,56,97,405,0.7697841726618705,0.5
60,80,95,70,85,50,440,0.2231404958677686,90,100,90,125,85,90,580,0.7352941176470589,0.5
100,164,150,95,120,71,700,0.5645161290322581,50,105,79,35,110,76,455,0.6214285714285714,0.25
39,52,43,60,50,65,309,0.49107142857142855,50,85,55,65,65,90,410,0.7478260869565218,0.5
100,50,50,76,96,70,442,0.5,45,30,50,55,65,45,290,0.208,1.0
75,125,75,30,75,85,465,0.625,95,125,79,60,100,81,540,0.6165413533834586,0.5
65,155,120,65,90,105,600,0.8677685950413223,45,35,45,62,53,35,275,0.11851851851851852,4.0
50,65,107,105,107,86,520,0.7313432835820896,59,66,70,44,55,41,335,0.25190839694656486,0.25
135,85,40,40,85,5,390,0.6864406779661016,68,72,78,38,42,32,330,0.23809523809523808,1.0
65,90,65,61,61,100,442,0.8373983739837398,50,60,60,60,60,30,320,0.11290322580645161,1.0
100,100,100,100,100,100,600,0.8345864661654135,65,60,70,85,75,40,395,0.1796875,1.0
64,51,23,51,23,28,240,0.11363636363636363,43,30,55,40,65,97,330,0.6030534351145038,1.0
45,60,40,70,50,45,310,0.2846715328467153,73,115,60,60,60,90,458,0.6694915254237288,1.0
70,150,140,65,100,75,600,0.55,75,100,95,40,70,110,490,0.8717948717948718,1.0
86,92,88,68,75,73,482,0.6835443037974683,50,105,79,35,110,76,455,0.6214285714285714,0.5
80,105,65,60,75,130,515,0.9645390070921985,82,80,86,85,75,72,480,0.6183206106870229,1.0
45,60,32,50,32,76,295,0.5925925925925926,30,45,59,30,39,57,260,0.2803030303030303,1.0
90,93,55,70,55,55,418,0.3819444444444444,45,30,50,55,65,45,290,0.208,0.5
50,75,75,65,65,50,380,0.4049586776859504,75,80,85,110,90,50,490,0.3548387096774194,1.0
75,95,125,45,75,95,510,0.8257575757575758,25,35,70,95,55,45,325,0.16783216783216784,1.0
60,100,89,55,69,112,485,0.9298245614035088,40,20,30,40,80,55,265,0.22764227642276422,0.5
69,55,45,55,55,15,294,0.11666666666666667,1,90,45,30,30,40,236,0.33064516129032256,0.25
100,50,50,76,96,70,442,0.5,100,103,75,120,75,127,600,0.940677966101695,2.0
106,130,90,110,154,90,680,0.719626168224299,78,104,78,159,115,100,634,0.8444444444444444,0.5
91,129,90,72,90,108,580,0.8536585365853658,115,115,85,90,75,100,580,0.8134328358208955,2.0
80,82,83,100,100,80,525,0.6742424242424242,44,38,39,61,79,42,303,0.2251655629139073,2.0
74,108,133,83,65,32,495,0.32142857142857145,75,87,63,87,63,98,473,0.865546218487395,1.0
58,50,145,95,105,30,483,0.2459016393442623,35,70,55,45,55,25,285,0.09420289855072464,1.0
10,55,25,35,45,95,265,0.5396825396825397,35,80,50,50,70,120,405,0.84375,1.0
50,55,50,36,30,43,264,0.2922077922077922,75,75,55,105,85,30,425,0.1619718309859155,2.0
65,130,60,95,110,65,525,0.5303030303030303,70,80,50,35,35,35,305,0.14,1.0
91,72,90,129,90,108,580,0.8620689655172413,255,10,10,75,135,55,540,0.3125,2.0
60,65,70,85,75,40,395,0.21705426356589147,45,63,37,65,55,95,360,0.8055555555555556,1.0
90,120,100,150,120,100,680,0.7718120805369127,75,80,55,25,35,35,305,0.18666666666666668,1.0
35,64,85,74,55,32,345,0.19827586206896552,70,83,50,37,50,60,350,0.3360655737704918,1.0
65,83,57,95,85,105,490,0.8914728682170543,65,85,70,75,70,40,405,0.203125,0.5
100,100,100,100,100,100,600,0.8602941176470589,100,90,130,45,65,55,485,0.4253731343283582,4.0
55,45,45,25,25,15,210,0.048,85,76,64,45,55,90,415,0.6739130434782609,1.0
110,65,105,55,95,80,510,0.6258503401360545,105,30,105,140,105,55,540,0.3524590163934426,2.0
70,92,65,80,55,98,460,0.8090909090909091,53,54,53,37,46,45,288,0.3090909090909091,1.0
85,120,70,50,60,100,485,0.8308823529411765,60,85,60,50,50,125,430,0.9090909090909091,1.0
60,85,42,85,42,91,405,0.8227848101265823,130,70,35,70,35,60,400,0.4017857142857143,1.0
73,100,60,100,60,65,458,0.42657342657342656,65,105,60,60,70,95,455,63.0,1.0
50,180,20,180,20,150,600,0.9029850746268657,85,100,122,58,75,54,494,0.3939393939393939,1.0
39,52,43,60,50,65,309,0.49107142857142855,20,15,20,10,55,80,200,0.2682926829268293,0.5
110,123,65,100,65,65,528,0.5217391304347826,62,48,66,59,57,49,341,0.33884297520661155,0.5
65,155,120,65,90,105,600,0.8677685950413223,48,72,48,72,48,48,336,0.25984251968503935,2.0
55,55,55,85,55,30,335,0.1320754716981132,50,150,50,150,50,150,600,0.9339622641509434,0.5
30,30,30,30,30,30,180,0.12612612612612611,55,45,45,25,25,15,210,0.048,4.0
45,30,40,105,50,20,290,0.031007751937984496,50,50,150,50,150,50,500,0.2571428571428571,1.0
55,50,65,175,95,150,590,0.7818181818181819,50,70,160,70,160,90,600,0.7417218543046358,0.5
100,150,120,120,100,90,680,0.6493506493506493,60,115,105,65,70,80,495,0.7181818181818181,2.0
90,93,55,70,55,55,418,0.3819444444444444,60,75,100,55,80,50,420,0.3088235294117647,2.0
30,40,55,40,55,60,280,0.3237410071942446,60,75,85,100,85,115,520,0.8992248062015504,0.25
50,65,107,105,107,86,520,0.703125,60,150,50,150,50,60,520,0.5,0.5
66,41,77,61,87,23,355,0.12096774193548387,80,100,200,50,100,50,580,0.3472222222222222,2.0
75,100,66,60,66,115,482,0.918918918918919,60,50,40,85,75,95,405,0.7540983606557377,1.0
90,92,75,92,85,60,494,0.49586776859504134,75,65,55,65,55,69,384,0.43548387096774194,4.0
70,70,40,60,40,60,340,0.4247787610619469,95,117,184,44,46,28,514,0.2975206611570248,1.0
75,95,122,58,75,69,494,0.5725806451612904,70,83,50,37,50,60,350,0.3360655737704918,0.0
68,125,65,65,115,80,518,0.6277372262773723,36,50,50,65,60,44,305,0.16363636363636364,2.0
40,35,30,120,70,105,400,0.6692307692307692,60,85,60,85,60,55,405,0.3673469387755102,1.0
106,190,100,154,100,130,780,0.9259259259259259,35,60,44,40,54,55,288,0.366412213740458,1.0
40,60,40,40,40,30,250,0.0948905109489051,75,100,110,45,55,65,450,0.5333333333333333,0.5
70,45,48,60,65,35,323,0.15748031496062992,44,58,44,58,44,61,309,0.41964285714285715,0.5
85,80,90,105,95,60,515,0.49074074074074076,62,48,54,63,60,68,355,0.5178571428571429,1.0
69,69,76,69,86,91,460,0.6554621848739496,78,70,61,50,61,100,420,0.8145161290322581,1.0
76,104,71,104,71,108,534,0.912751677852349,61,78,95,56,58,57,405,0.40336134453781514,2.0
60,85,60,85,60,55,405,0.3673469387755102,49,66,70,44,55,51,335,0.4260869565217391,0.0
38,30,85,55,65,30,303,0.21428571428571427,45,30,15,85,65,65,305,0.36220472440944884,2.0
70,83,50,37,50,60,350,0.3360655737704918,40,45,40,35,35,56,251,0.373015873015873,1.0
106,190,100,154,100,130,780,0.9259259259259259,65,80,65,35,65,60,370,0.38405797101449274,2.0
95,65,110,60,130,65,525,0.5275590551181102,60,62,63,80,80,60,405,0.38016528925619836,1.0
53,51,53,61,56,40,314,0.14285714285714285,55,85,122,58,75,99,494,0.8099173553719008,0.5
80,115,80,65,55,93,488,0.7846153846153846,38,30,41,30,41,60,240,0.2897196261682243,1.0
55,55,55,85,55,30,335,0.1320754716981132,50,35,55,25,25,15,205,0.021739130434782608,1.0
65,125,60,95,60,105,510,0.9236641221374046,90,93,55,70,55,55,418,0.3819444444444444,1.0
95,23,48,23,48,23,260,0.046153846153846156,70,80,65,90,65,85,455,0.578125,0.5
51,65,65,80,75,59,395,0.4365079365079365,40,30,35,50,70,55,280,0.28205128205128205,2.0
40,70,130,60,130,25,455,0.17355371900826447,88,107,122,74,75,64,530,0.4596774193548387,1.0
80,135,85,70,95,150,615,0.9844961240310077,74,48,76,83,81,104,466,0.7322834645669292,1.0
65,95,57,100,85,93,495,0.7441860465116279,20,15,20,10,55,80,200,0.2682926829268293,0.5
115,115,85,90,75,100,580,0.8134328358208955,35,85,45,35,35,75,310,0.6492537313432836,1.0
76,48,48,57,62,34,325,0.11688311688311688,54,45,47,75,98,52,371,0.39669421487603307,1.0
65,76,84,54,96,105,480,0.9008264462809917,65,95,57,100,85,93,495,0.7441860465116279,1.0
95,80,105,40,70,100,490,0.8046875,45,30,50,65,50,45,285,0.13821138211382114,1.0
86,76,86,116,56,95,515,0.7982456140350878,68,90,65,50,55,82,410,0.6165413533834586,1.0
68,65,65,125,115,80,518,0.6461538461538462,165,75,80,40,45,65,470,0.5151515151515151,1.0
80,120,70,110,70,80,530,0.6422764227642277,65,75,70,95,70,95,470,0.7272727272727273,0.25
39,52,43,60,50,65,309,0.49107142857142855,60,115,105,65,70,80,495,0.7181818181818181,0.25
45,30,40,105,50,20,290,0.031007751937984496,50,50,50,50,50,50,300,0.30708661417322836,1.0
85,56,77,50,77,78,423,0.53125,85,80,90,105,95,60,515,0.49074074074074076,1.0
70,130,100,55,80,65,500,0.608,30,45,55,70,55,85,340,0.5633802816901409,0.5
50,75,75,65,65,50,380,0.4049586776859504,103,93,67,71,61,84,479,0.7142857142857143,0.25
50,75,70,35,70,48,348,0.29357798165137616,76,104,71,104,71,108,534,0.912751677852349,0.5
75,125,230,55,95,30,610,0.3448275862068966,70,92,65,80,55,98,460,0.8090909090909091,0.5
100,100,100,100,100,100,600,0.8778625954198473,80,70,70,90,100,70,480,0.5609756097560976,1.0
75,85,200,55,65,30,510,0.16778523489932887,165,75,80,40,45,65,470,0.5151515151515151,0.5
65,60,110,130,95,65,525,0.47761194029850745,60,105,60,120,60,105,510,0.8849557522123894,1.0
45,53,70,40,60,42,310,0.25735294117647056,81,102,77,85,75,85,505,0.5642857142857143,0.5
103,60,86,60,86,50,445,0.3458646616541353,100,150,90,180,160,90,770,0.7348484848484849,1.0
75,125,70,125,70,115,580,0.9037037037037037,68,85,65,165,135,100,618,0.8083333333333333,0.5
43,30,55,40,65,97,330,0.6030534351145038,50,95,95,35,110,70,455,0.5179856115107914,1.0
50,70,100,40,40,30,330,0.2222222222222222,45,85,70,40,40,60,340,0.5229357798165137,0.25
125,120,90,170,100,95,700,0.78125,67,57,55,77,55,114,425,0.8879310344827587,2.0
106,150,70,194,120,140,780,0.952,100,100,100,100,100,100,600,0.8805970149253731,1.0
110,160,110,80,110,100,670,0.8591549295774648,115,45,20,45,25,20,270,0.11538461538461539,1.0
50,52,48,65,50,55,320,0.33098591549295775,44,38,39,61,79,42,303,0.2251655629139073,1.0
55,45,50,45,65,80,340,0.5546218487394958,40,55,70,45,60,30,300,0.10619469026548672,0.25
80,70,70,90,100,70,480,0.5609756097560976,60,50,70,80,80,140,480,0.8449612403100775,1.0
62,55,52,109,94,109,481,0.7833333333333333,75,123,67,95,85,95,540,0.7642276422764228,0.5
50,75,75,65,65,50,380,0.4049586776859504,60,40,60,40,60,35,295,0.18055555555555555,1.0
40,60,40,40,40,30,250,0.0948905109489051,30,56,35,25,35,72,253,0.48148148148148145,1.0
40,55,30,30,30,85,270,0.688,77,59,50,67,63,46,362,0.23140495867768596,0.25
90,65,65,40,40,15,315,0.19672131147540983,105,95,80,40,80,90,490,0.753968253968254,1.0
85,80,70,135,75,90,535,0.7006802721088435,45,80,100,35,37,28,325,0.3125,0.0
30,80,90,55,45,55,355,0.4295774647887324,85,120,70,50,60,100,485,0.8308823529411765,2.0
55,70,55,40,55,85,360,0.7073170731707317,70,85,65,105,85,120,530,0.9262295081967213,1.0
45,30,50,55,65,45,290,0.208,40,40,55,40,70,55,300,0.40939597315436244,1.0
72,85,70,65,70,58,420,0.41304347826086957,80,52,50,90,50,89,411,0.6666666666666666,1.0
76,25,45,67,55,24,292,0.0390625,85,56,77,50,77,78,423,0.53125,2.0
130,65,60,110,95,65,525,0.5227272727272727,49,49,56,49,61,66,330,0.5190839694656488,0.5
65,60,110,130,95,65,525,0.47761194029850745,95,85,85,65,65,35,430,0.2571428571428571,1.0
110,85,95,80,95,50,515,0.2713178294573643,63,63,47,41,41,74,329,0.56,1.0
60,45,50,90,80,70,395,0.625,61,72,57,55,55,65,365,0.3984375,0.5
62,77,62,50,42,65,358,0.4838709677419355,38,30,85,55,65,30,303,0.21428571428571427,0.0
20,15,20,10,55,80,200,0.2682926829268293,67,57,55,77,55,114,425,0.8879310344827587,1.0
114,85,70,85,80,30,464,0.2066115702479339,108,170,115,120,95,92,700,0.7083333333333334,0.5
60,80,95,70,85,50,440,0.2231404958677686,65,60,110,130,95,65,525,0.47761194029850745,2.0
130,70,35,70,35,60,400,0.4017857142857143,75,80,95,90,100,50,490,0.2158273381294964,0.5
75,100,95,40,70,110,490,0.8717948717948718,60,100,115,70,85,90,520,0.7557251908396947,0.5
75,95,67,125,95,83,540,0.7117117117117117,62,77,62,50,42,65,358,0.4838709677419355,1.0
40,30,30,55,30,85,270,0.4666666666666667,66,117,70,40,50,67,410,0.4573643410852713,0.5
72,85,70,65,70,58,420,0.41304347826086957,65,155,120,65,90,105,600,0.8677685950413223,1.0
55,50,40,40,40,75,300,0.5945945945945946,40,55,30,30,30,60,245,0.43548387096774194,1.0
85,56,77,50,77,78,423,0.53125,50,70,100,40,40,30,330,0.2222222222222222,1.0
80,82,100,83,100,80,525,0.6821705426356589,85,105,100,79,83,78,530,0.5869565217391305,2.0
68,65,65,125,115,80,518,0.6461538461538462,46,57,40,40,40,50,273,0.25,1.0
110,135,60,50,65,88,508,0.7744360902255639,95,65,65,110,130,60,525,0.4016393442622951,0.5
90,100,60,90,60,80,480,0.6422764227642277,70,140,70,110,65,105,560,0.95,1.0
70,20,50,20,50,40,250,0.1557377049180328,85,110,76,65,82,56,474,0.3933333333333333,0.5
40,35,30,20,20,50,195,0.23423423423423423,45,60,30,80,50,65,330,0.4603174603174603,1.0
45,40,60,40,75,50,310,0.2926829268292683,20,15,20,10,55,80,200,0.2682926829268293,1.0
75,75,75,125,95,40,485,0.15671641791044777,60,40,60,40,60,35,295,0.18055555555555555,1.0
100,100,100,100,100,100,600,0.8602941176470589,80,70,40,100,60,145,495,0.921875,0.5
59,45,40,35,40,31,250,0.14285714285714285,75,100,66,60,66,115,482,0.918918918918919,1.0
72,105,115,54,86,68,500,0.5149253731343284,95,117,184,44,46,28,514,0.2975206611570248,2.0
100,150,110,95,110,70,635,0.5923076923076923,90,75,75,90,100,70,500,0.5462184873949579,0.5
120,120,120,120,120,120,720,0.9344262295081968,35,55,40,45,40,60,275,0.35714285714285715,1.0
60,40,80,60,45,40,325,0.23529411764705882,50,65,90,35,35,15,290,0.14678899082568808,0.5
51,65,65,80,75,59,395,0.4365079365079365,108,100,121,81,95,95,600,0.7476635514018691,4.0
75,100,95,40,70,110,490,0.8717948717948718,50,80,95,10,45,10,290,0.232,0.5
55,75,50,40,40,80,340,0.6302521008403361,85,115,80,105,80,50,515,0.3063063063063063,0.5
40,65,95,60,45,35,340,0.13986013986013987,70,75,80,135,80,135,575,0.917910447761194,1.0
75,75,130,75,130,95,580,0.7479674796747967,59,110,150,45,49,35,448,0.3333333333333333,0.5
90,132,105,132,105,30,594,0.4246575342465753,40,30,35,45,40,55,245,0.31496062992125984,1.0
44,58,44,58,44,61,309,0.41964285714285715,31,45,90,30,30,40,266,0.21929824561403508,2.0
65,136,94,54,96,135,580,0.9612403100775194,100,150,110,95,110,70,635,0.5923076923076923,1.0
75,90,50,110,80,95,500,0.7985611510791367,85,120,70,50,60,100,485,0.8308823529411765,1.0
60,65,70,85,75,40,395,0.21705426356589147,40,30,30,40,50,30,220,0.07936507936507936,2.0
76,25,45,67,55,24,292,0.0390625,80,100,70,50,60,45,405,0.25806451612903225,1.0
109,66,84,81,99,32,471,0.2013888888888889,60,48,45,43,90,42,328,0.21897810218978103,1.0
65,50,35,115,95,95,455,0.7333333333333333,70,100,115,30,65,30,410,0.24390243902439024,1.0
95,100,85,108,70,70,528,0.5652173913043478,97,165,60,65,50,58,495,0.3902439024390244,2.0
109,66,84,81,99,32,471,0.2013888888888889,35,85,45,35,35,75,310,0.6492537313432836,0.0
60,52,168,47,138,30,495,0.19834710743801653,58,89,77,45,45,48,362,0.3177570093457944,2.0
76,65,45,92,42,91,411,0.7449664429530202,67,125,40,30,30,58,350,0.3431372549019608,0.25
35,60,44,40,54,55,288,0.366412213740458,95,80,105,40,70,100,490,0.8046875,1.0
105,30,105,140,105,55,540,0.3524590163934426,60,90,70,60,120,40,440,0.27419354838709675,1.0
68,65,65,125,115,80,518,0.6461538461538462,90,70,80,70,95,70,475,0.5190839694656488,1.0
80,145,150,105,110,110,700,0.8692307692307693,70,140,230,60,80,50,630,0.32432432432432434,0.25
60,65,60,130,75,110,500,0.7719298245614035,60,90,140,50,50,40,430,0.2535211267605634,0.0
49,55,42,42,37,85,310,0.6068376068376068,75,100,66,60,66,115,482,0.918918918918919,1.0
55,84,105,114,75,52,485,0.2890625,74,48,76,83,81,104,466,0.7913043478260869,1.0
50,25,28,45,55,15,218,0.0625,65,65,60,130,95,110,525,0.823943661971831,1.0
50,50,50,50,50,50,300,0.30708661417322836,20,10,230,10,230,5,505,0.0,1.0
69,69,76,69,86,91,460,0.6554621848739496,114,85,70,85,80,30,464,0.2066115702479339,0.5
67,57,55,77,55,114,425,0.8879310344827587,60,55,145,75,150,40,525,0.2,0.125
75,103,80,70,80,92,500,0.7933884297520661,73,95,62,85,65,85,465,0.6666666666666666,1.0
40,50,45,70,45,70,320,0.5517241379310345,80,160,80,130,80,100,630,0.8455284552845529,2.0
44,75,35,63,33,45,295,0.2647058823529412,59,74,50,35,50,35,303,0.3125,2.0
73,76,75,81,100,100,505,0.8110236220472441,45,40,60,40,75,50,310,0.2926829268292683,1.0
190,33,58,33,58,33,405,0.13432835820895522,60,75,85,100,85,115,520,0.8992248062015504,0.5
59,45,40,35,40,31,250,0.14285714285714285,100,123,75,57,75,80,510,0.6923076923076923,1.0
80,160,80,130,80,100,630,0.8455284552845529,64,51,23,51,23,28,240,0.11363636363636363,2.0
85,76,64,45,55,90,415,0.6739130434782609,60,60,60,85,85,85,435,0.631578947368421,0.0
75,140,65,112,65,110,567,0.9140625,84,71,43,71,43,48,360,0.25874125874125875,1.0
100,150,140,100,90,90,670,0.7969924812030075,130,70,35,70,35,60,400,0.4017857142857143,1.0
70,92,65,80,55,98,460,0.8090909090909091,50,64,50,45,50,41,300,0.22727272727272727,4.0
65,55,115,100,40,60,435,0.3798449612403101,40,45,65,100,120,90,460,0.5588235294117647,1.0
50,55,50,36,30,43,264,0.2922077922077922,90,60,60,40,40,40,330,0.29545454545454547,1.0
60,115,105,65,70,80,495,0.7181818181818181,80,160,60,170,130,80,680,0.6180555555555556,1.0
50,52,48,65,50,55,320,0.33098591549295775,105,30,105,140,105,55,540,0.3524590163934426,2.0
60,60,50,40,50,75,335,0.5882352941176471,65,80,65,35,65,60,370,0.38405797101449274,1.0
75,90,90,140,90,115,600,0.9481481481481482,35,85,45,35,35,75,310,0.6492537313432836,1.0
44,50,91,24,86,10,305,0.1981981981981982,55,70,45,70,50,60,350,0.45,0.25
80,70,40,100,60,145,495,0.921875,95,117,80,65,70,92,519,0.8409090909090909,2.0
50,95,90,95,90,180,600,0.9172413793103448,60,90,55,90,80,110,485,0.8677685950413223,1.0
50,95,180,85,45,70,525,0.5298507462686567,84,71,43,71,43,48,360,0.25874125874125875,1.0
95,80,105,40,70,100,490,0.8046875,50,50,150,50,150,50,500,0.2571428571428571,0.5
70,75,80,135,80,135,575,0.917910447761194,60,100,89,55,69,112,485,0.9298245614035088,1.0
125,58,58,76,76,67,460,0.515625,79,103,120,135,115,78,630,0.5763888888888888,1.0
55,35,50,55,110,85,390,0.6277372262773723,60,80,95,70,85,50,440,0.2231404958677686,0.25
60,100,85,80,85,100,510,0.7007874015748031,65,65,60,110,95,130,525,0.9253731343283582,1.0
70,45,48,60,65,35,323,0.15748031496062992,71,120,95,120,95,99,600,0.8203125,0.5
100,150,110,95,110,70,635,0.5923076923076923,68,75,53,83,113,60,452,0.45384615384615384,0.5
50,50,40,30,30,50,250,0.2781954887218045,90,55,75,60,75,30,385,0.13970588235294118,1.0
65,47,55,73,75,85,400,0.65,50,65,64,44,48,43,314,0.2196969696969697,1.0
38,35,40,27,25,35,200,0.08208955223880597,100,90,130,45,65,55,485,0.4253731343283582,1.0
65,100,70,80,80,105,500,0.8666666666666667,31,45,90,30,30,40,266,0.21929824561403508,2.0
50,85,125,85,115,20,480,0.4306569343065693,66,117,70,40,50,67,410,0.4573643410852713,1.0
74,94,131,54,116,20,489,0.4485294117647059,80,80,80,80,80,80,480,0.6015037593984962,2.0
44,38,33,61,43,70,289,0.5267857142857143,80,80,80,55,55,90,440,0.6417910447761194,1.0
75,95,95,95,95,85,540,0.6470588235294118,70,85,140,85,70,20,470,0.272,2.0
75,98,63,98,63,101,498,0.8091603053435115,60,52,168,47,138,30,495,0.19834710743801653,1.0
100,73,83,73,83,55,467,0.371900826446281,125,120,90,170,100,95,700,0.78125,1.0
45,30,50,55,65,45,290,0.208,50,85,55,65,65,90,410,0.7478260869565218,1.0
85,50,95,120,115,80,545,0.5793650793650794,20,10,55,15,20,80,200,0.17985611510791366,1.0
68,72,78,38,42,32,330,0.23809523809523808,123,100,62,97,81,68,531,0.4806201550387597,0.5
82,80,86,85,75,72,480,0.6183206106870229,40,30,30,40,50,30,220,0.07936507936507936,1.0
45,60,32,50,32,76,295,0.5925925925925926,44,75,35,63,33,45,295,0.2647058823529412,1.0
55,50,40,40,40,75,300,0.5945945945945946,65,63,45,45,45,45,308,0.2595419847328244,1.0
30,30,30,30,30,30,180,0.12612612612612611,60,65,70,85,75,40,395,0.21705426356589147,0.25
40,80,35,35,45,70,305,0.4661016949152542,71,82,64,64,59,112,452,0.9327731092436975,2.0
56,61,65,48,45,38,313,0.17567567567567569,50,65,107,105,107,86,520,0.7758620689655172,2.0
70,92,65,80,55,98,460,0.8090909090909091,60,79,105,59,85,36,424,0.17054263565891473,2.0
40,65,40,80,40,65,330,0.5038167938931297,105,30,105,140,105,55,540,0.3524590163934426,2.0
80,45,65,90,110,80,470,0.5462962962962963,90,60,70,75,70,45,410,0.23880597014925373,1.0
50,50,95,40,50,35,320,0.20279720279720279,55,45,43,55,43,72,313,0.5853658536585366,0.0
80,145,150,105,110,110,700,0.8692307692307693,65,150,60,115,60,115,565,0.935251798561151,0.0
45,35,45,62,53,35,275,0.11851851851851852,80,100,200,50,100,50,580,0.3472222222222222,2.0
60,55,50,40,55,45,305,0.22377622377622378,45,40,60,40,75,50,310,0.2926829268292683,0.5
85,50,95,120,115,80,545,0.5793650793650794,101,72,72,99,89,29,462,0.1937984496124031,1.0
50,53,48,53,48,64,316,0.4076923076923077,88,107,122,74,75,64,530,0.4596774193548387,0.5
255,10,10,75,135,55,540,0.3125,150,120,100,120,100,90,680,0.664179104477612,0.0
55,45,45,25,25,15,210,0.048,30,30,42,30,42,70,244,0.4230769230769231,0.0
75,80,55,25,35,35,305,0.18666666666666668,55,50,65,175,95,150,590,0.7818181818181819,0.5
105,95,80,40,80,90,490,0.753968253968254,50,50,150,50,150,50,500,0.2571428571428571,0.5
75,90,90,140,90,115,600,0.9481481481481482,110,130,80,70,60,80,530,0.5862068965517241,2.0
160,110,65,65,110,30,540,0.35714285714285715,38,35,35,65,55,50,278,0.2647058823529412,1.0
44,50,91,24,86,10,305,0.1981981981981982,65,75,70,95,70,95,470,0.7272727272727273,0.5
60,50,70,80,80,140,480,0.8449612403100775,100,180,160,150,90,90,770,0.7520661157024794,0.0
50,55,50,36,30,43,264,0.2922077922077922,60,50,100,85,70,65,430,0.47580645161290325,1.0
50,55,50,36,30,43,264,0.2922077922077922,75,75,75,125,95,40,485,0.15671641791044777,1.0
160,110,65,65,110,30,540,0.35714285714285715,105,95,75,85,75,74,509,0.5714285714285714,1.0
56,61,65,48,45,38,313,0.17567567567567569,90,95,105,165,110,45,610,0.2890625,0.5
50,53,48,53,48,64,316,0.46153846153846156,60,52,168,47,138,30,495,0.19834710743801653,1.0
30,40,55,40,55,60,280,0.3237410071942446,50,95,180,85,45,70,525,0.5298507462686567,2.0
61,72,57,55,55,65,365,0.3984375,91,134,95,100,100,80,600,0.6304347826086957,1.0
65,130,60,95,110,65,525,0.5303030303030303,50,80,95,10,45,10,290,0.232,0.5
85,100,122,58,75,54,494,0.3939393939393939,100,100,100,100,100,100,600,0.8758169934640523,1.0
49,66,70,44,55,51,335,0.4260869565217391,62,50,58,73,54,72,369,0.4435483870967742,0.0
75,100,110,45,55,65,450,0.5333333333333333,40,45,35,30,40,55,245,0.3793103448275862,0.0
40,55,80,35,60,30,300,0.15037593984962405,80,105,65,60,75,130,515,0.9645390070921985,2.0
55,45,50,45,65,80,340,0.5546218487394958,80,120,70,110,70,80,530,0.6422764227642277,1.0
86,81,97,81,107,43,495,0.203125,83,80,80,135,80,121,579,0.9444444444444444,1.0
65,40,70,80,140,70,465,0.5954198473282443,75,100,63,80,63,116,497,0.9345794392523364,0.5
60,30,30,36,56,50,262,0.32432432432432434,75,55,70,55,95,110,460,0.8444444444444444,2.0
65,65,60,130,95,110,525,0.823943661971831,50,105,125,55,95,50,480,0.375886524822695,0.5
65,90,50,85,45,55,390,0.371900826446281,45,30,50,55,65,45,290,0.208,1.0
38,30,41,30,41,60,240,0.2897196261682243,50,95,90,95,90,180,600,0.9172413793103448,1.0
35,40,100,90,55,35,355,0.1796875,40,45,35,30,40,55,245,0.3793103448275862,2.0
70,120,40,95,40,95,460,0.8106060606060606,90,90,85,125,90,100,580,0.768595041322314,1.0
60,45,70,75,85,55,390,0.3008130081300813,85,80,90,105,95,60,515,0.49074074074074076,1.0
170,90,45,90,45,60,500,0.427536231884058,70,150,140,65,100,75,600,0.55,1.0
85,97,66,105,66,65,484,0.47107438016528924,65,90,115,45,115,58,488,0.5041322314049587,1.0
80,120,130,55,65,45,495,0.37037037037037035,60,75,100,55,80,50,420,0.3088235294117647,1.0
65,75,105,35,65,85,430,0.6940298507462687,105,180,100,180,100,115,780,0.9477611940298507,0.0
80,105,65,60,75,130,515,0.9645390070921985,60,67,85,77,75,116,480,0.8888888888888888,2.0
55,55,85,65,85,35,380,0.2014388489208633,60,70,105,70,120,75,500,0.5983606557377049,1.0
70,100,70,105,75,40,460,0.23214285714285715,90,120,120,60,60,50,500,0.35294117647058826,1.0
40,45,35,30,40,55,245,0.3793103448275862,63,60,55,50,50,71,349,0.5289256198347108,1.0
70,100,115,30,65,30,410,0.24390243902439024,70,110,75,145,85,145,630,0.9444444444444444,1.0
78,81,71,74,69,126,499,0.9090909090909091,53,51,53,61,56,40,314,0.14285714285714285,0.5
50,53,48,53,48,64,316,0.46153846153846156,40,40,50,30,30,30,220,0.0873015873015873,2.0
45,80,100,35,37,28,325,0.3125,59,45,40,35,40,31,250,0.14285714285714285,0.0
190,33,58,33,58,33,405,0.13432835820895522,68,72,78,38,42,32,330,0.23809523809523808,2.0
70,140,230,60,80,50,630,0.32432432432432434,83,80,80,135,80,121,579,0.9444444444444444,1.0
40,30,35,45,40,55,245,0.31496062992125984,110,85,95,80,95,50,515,0.2713178294573643,1.0
65,65,60,110,95,130,525,0.9253731343283582,65,75,70,95,70,95,470,0.7272727272727273,2.0
85,97,66,105,66,65,484,0.47107438016528924,75,100,66,60,66,115,482,0.918918918918919,1.0
70,20,50,20,50,40,250,0.1557377049180328,40,45,40,62,60,60,307,0.33884297520661155,1.0
75,90,140,60,60,40,465,0.3008130081300813,50,75,45,40,45,60,315,0.4380165289256198,1.0
50,95,180,85,45,70,525,0.5298507462686567,55,95,55,35,75,115,430,0.9380530973451328,0.5
50,75,75,65,65,50,380,0.4049586776859504,50,45,45,35,35,50,260,0.23529411764705882,0.0
70,65,65,55,55,70,380,0.5,90,93,55,70,55,55,418,0.3819444444444444,1.0
50,95,180,85,45,70,525,0.5298507462686567,54,63,52,83,56,97,405,0.7697841726618705,0.25
60,50,150,50,150,60,520,0.5206611570247934,80,120,80,120,80,100,580,0.8478260869565217,2.0
95,75,110,100,80,30,490,0.15267175572519084,55,69,85,32,35,28,304,0.09302325581395349,1.0
75,90,140,60,60,40,465,0.3008130081300813,79,103,120,135,115,78,630,0.5763888888888888,0.5
86,68,72,109,66,106,507,0.8099173553719008,60,40,50,75,85,95,405,0.6044776119402985,1.0
20,15,20,10,55,80,200,0.2682926829268293,80,100,70,60,70,95,475,0.7416666666666667,0.5
70,55,95,95,110,65,490,0.48872180451127817,66,41,77,61,87,23,355,0.12096774193548387,1.0
95,109,105,75,85,56,525,0.34513274336283184,90,120,75,60,60,45,450,0.29411764705882354,1.0
75,65,55,65,55,69,384,0.43548387096774194,100,120,120,150,100,90,680,0.7880794701986755,1.0
65,105,60,60,70,95,455,63.0,43,30,55,40,65,97,330,0.6030534351145038,1.0
100,5,5,15,65,30,220,0.07692307692307693,60,80,95,70,85,50,440,0.2231404958677686,0.5
45,67,60,35,50,63,320,0.5128205128205128,100,164,150,95,120,71,700,0.5645161290322581,2.0
50,50,95,40,50,35,320,0.20279720279720279,80,160,60,170,130,80,680,0.6180555555555556,1.0
85,56,77,50,77,78,423,0.53125,116,55,85,107,95,29,487,0.06818181818181818,1.0
45,85,70,40,40,60,340,0.5229357798165137,106,110,90,154,90,130,680,0.926829268292683,2.0
40,30,35,45,40,55,245,0.31496062992125984,75,90,90,140,90,115,600,0.9481481481481482,1.0
60,60,75,60,75,80,410,0.7321428571428571,68,75,53,83,113,60,452,0.45384615384615384,1.0
100,100,90,150,140,90,670,0.71875,70,100,70,105,75,40,460,0.23214285714285715,4.0
85,97,66,105,66,65,484,0.47107438016528924,45,60,30,80,50,65,330,0.4603174603174603,0.5
150,120,100,120,100,90,680,0.664179104477612,60,90,140,50,50,40,430,0.2535211267605634,0.5
95,155,109,70,130,81,640,0.6788321167883211,80,80,80,55,55,90,440,0.6417910447761194,1.0
40,30,50,55,55,100,330,0.584070796460177,67,89,116,79,116,33,500,0.2624113475177305,1.0
90,90,85,125,90,100,580,0.768595041322314,73,115,60,60,60,90,458,0.6694915254237288,1.0
60,40,60,40,60,35,295,0.18055555555555555,30,35,30,100,35,80,310,0.4765625,0.5
85,105,100,79,83,78,530,0.5869565217391305,55,40,40,65,45,35,280,0.16428571428571428,1.0
40,29,45,29,45,36,224,0.14634146341463414,60,79,105,59,85,36,424,0.17054263565891473,1.0
70,110,70,115,70,90,525,0.75,65,65,60,130,95,110,525,0.823943661971831,0.5
71,95,85,110,95,79,535,0.664,30,40,55,40,55,60,280,0.3237410071942446,1.0
68,165,95,65,115,110,618,0.8615384615384616,150,100,120,100,120,90,680,0.6666666666666666,0.0
76,147,90,60,70,97,540,0.8267716535433071,45,75,60,40,30,50,300,0.304,2.0
65,65,60,130,95,110,525,0.823943661971831,85,70,80,97,80,123,535,0.9304347826086956,1.0
76,147,90,60,70,97,540,0.8267716535433071,80,145,150,105,110,110,700,0.8692307692307693,0.5
85,135,130,60,80,25,515,0.40540540540540543,110,135,60,50,65,88,508,0.7744360902255639,0.25
45,30,15,85,65,65,305,0.36220472440944884,70,120,100,145,105,20,560,0.2824427480916031,2.0
75,100,63,80,63,116,497,0.9345794392523364,110,65,75,125,85,30,490,0.15,1.0
76,48,48,57,62,34,325,0.11688311688311688,105,140,55,30,55,95,480,0.8195488721804511,2.0
55,70,45,70,50,60,350,0.45,92,105,90,125,90,98,600,0.8217054263565892,0.5
70,140,70,110,65,105,560,0.95,110,130,80,70,60,80,530,0.5862068965517241,2.0
70,110,80,55,80,105,500,0.8794326241134752,70,100,115,30,65,30,410,0.24390243902439024,0.5
55,40,50,65,85,40,335,0.3181818181818182,50,95,90,95,90,180,600,0.9172413793103448,2.0
50,55,50,36,30,43,264,0.2922077922077922,70,60,75,110,75,90,480,0.7165354330708661,2.0
76,147,90,60,70,97,540,0.8267716535433071,50,70,100,40,40,30,330,0.2222222222222222,0.5
110,130,80,70,60,80,530,0.5862068965517241,95,75,180,130,80,30,590,0.13793103448275862,0.5
30,45,59,30,39,57,260,0.2803030303030303,80,82,100,83,100,80,525,0.6821705426356589,4.0
40,45,35,40,40,90,290,0.65,54,63,52,83,56,97,405,0.7697841726618705,1.0
110,78,73,76,71,60,468,0.3333333333333333,50,70,50,50,50,40,310,0.16296296296296298,0.5
65,95,75,55,55,85,430,0.6933333333333334,95,75,80,100,110,30,490,0.24242424242424243,0.5
45,75,60,40,30,50,300,0.304,50,50,40,50,40,64,294,0.45588235294117646,1.0
45,85,50,55,50,65,350,0.5076923076923077,45,85,70,40,40,60,340,0.5229357798165137,4.0
59,110,150,45,49,35,448,0.3333333333333333,68,125,65,65,115,80,518,0.6277372262773723,2.0
70,90,110,60,75,95,500,0.7333333333333333,60,65,70,85,75,40,395,0.21705426356589147,1.0
65,125,100,60,70,70,490,0.6099290780141844,88,107,122,74,75,64,530,0.4596774193548387,0.5
25,35,70,95,55,45,325,0.16783216783216784,88,107,122,74,75,64,530,0.4596774193548387,0.5
38,35,40,27,25,35,200,0.08208955223880597,65,130,60,95,110,65,525,0.5303030303030303,0.5
60,115,105,65,70,80,495,0.7181818181818181,75,75,75,125,95,40,485,0.15671641791044777,1.0
110,65,105,55,95,80,510,0.6258503401360545,116,55,85,107,95,29,487,0.06818181818181818,2.0
55,70,40,60,40,40,305,0.26956521739130435,123,77,72,99,92,58,521,0.4621212121212121,0.5
45,60,32,50,32,76,295,0.5925925925925926,80,90,80,130,110,110,600,0.856,0.5
45,100,45,45,45,10,290,0.2949640287769784,90,65,65,40,40,15,315,0.19672131147540983,1.0
95,110,80,70,80,50,485,0.37209302325581395,75,75,130,75,130,95,580,0.7479674796747967,1.0
59,66,70,44,55,41,335,0.25190839694656486,108,112,118,68,72,47,525,0.2916666666666667,2.0
58,109,112,48,48,109,484,0.8805970149253731,50,60,45,100,80,65,400,0.45689655172413796,1.0
48,72,48,72,48,48,336,0.25984251968503935,40,55,70,45,60,30,300,0.10619469026548672,0.5
76,25,45,67,55,24,292,0.0390625,62,48,54,63,60,68,355,0.5178571428571429,0.5
85,76,64,45,55,90,415,0.6739130434782609,44,38,39,61,79,42,303,0.2251655629139073,1.0
50,65,107,105,107,86,520,0.6991150442477876,105,95,80,40,80,90,490,0.753968253968254,1.0
75,80,55,25,35,35,305,0.18666666666666668,65,125,100,60,70,70,490,0.6099290780141844,4.0
65,125,100,55,70,85,500,0.6532258064516129,79,103,120,135,115,78,630,0.5763888888888888,1.0
100,50,50,76,96,70,442,0.5,65,85,70,75,70,40,405,0.203125,0.5
54,45,47,75,98,52,371,0.39669421487603307,60,52,168,47,138,30,495,0.19834710743801653,0.5
50,95,95,35,110,70,455,0.5179856115107914,43,70,48,50,60,38,309,0.2391304347826087,0.0
135,85,40,40,85,5,390,0.6864406779661016,71,82,64,64,59,112,452,0.9327731092436975,1.0
130,85,80,85,95,60,535,0.43884892086330934,45,60,45,25,45,55,275,0.29,1.0
70,110,70,115,70,90,525,0.75,60,80,50,40,40,30,300,0.15328467153284672,0.25
45,30,50,65,50,45,285,0.13821138211382114,60,50,70,50,90,65,385,0.39568345323741005,2.0
100,150,140,100,90,90,670,0.7969924812030075,38,36,38,32,36,57,237,0.3893805309734513,1.0
70,85,70,60,70,50,405,0.28378378378378377,28,25,25,45,35,40,198,0.16083916083916083,1.0
130,70,35,70,35,60,400,0.4017857142857143,84,71,43,71,43,48,360,0.25874125874125875,1.0
110,135,60,50,65,88,508,0.7744360902255639,77,85,51,55,51,65,384,0.5163934426229508,0.5
55,70,40,60,40,40,305,0.26956521739130435,100,5,5,15,65,30,220,0.07692307692307693,1.0
45,65,34,40,34,45,263,0.2589928057553957,54,78,103,53,45,22,355,0.23255813953488372,2.0
60,50,70,80,80,140,480,0.8449612403100775,70,60,125,115,70,55,495,0.35507246376811596,2.0
65,75,105,35,65,85,430,0.6940298507462687,40,45,35,40,40,90,290,0.65,1.0
45,60,40,70,50,45,310,0.2846715328467153,80,120,79,95,79,70,523,0.5833333333333334,1.0
60,52,168,47,138,30,495,0.19834710743801653,44,38,39,61,79,42,303,0.2251655629139073,0.5
106,130,90,110,154,90,680,0.719626168224299,79,105,70,145,80,101,580,0.8608695652173913,0.5
95,117,80,65,70,92,519,0.8409090909090909,55,75,50,40,40,80,340,0.6302521008403361,0.0
54,66,70,44,55,46,335,0.4214876033057851,45,85,50,55,50,65,350,0.5076923076923077,1.0
60,150,50,150,50,60,520,0.5,50,65,107,105,107,86,520,0.7758620689655172,0.25
105,140,55,30,55,95,480,0.8195488721804511,70,90,45,15,45,50,315,0.3629032258064516,0.5
65,60,70,85,75,40,395,0.1796875,55,50,40,40,40,75,300,0.5945945945945946,1.0
80,115,80,65,55,93,488,0.7846153846153846,79,100,80,110,90,121,580,0.968,1.0
100,100,100,100,100,100,600,0.8345864661654135,70,120,100,145,105,20,560,0.2824427480916031,2.0
80,100,70,50,60,45,405,0.25806451612903225,65,130,60,75,60,75,465,0.689922480620155,2.0
73,100,60,100,60,65,458,0.42657342657342656,37,25,41,25,41,25,194,0.08870967741935484,1.0
45,75,60,40,30,50,300,0.304,40,45,35,30,40,55,245,0.3793103448275862,1.0
65,155,120,65,90,105,600,0.8677685950413223,80,105,105,105,105,80,580,0.5939849624060151,2.0
95,110,80,70,80,50,485,0.37209302325581395,55,81,60,50,70,97,413,0.7214285714285714,1.0
65,130,60,95,110,65,525,0.5303030303030303,68,72,78,38,42,32,330,0.23809523809523808,1.0
100,100,100,100,100,100,600,0.8602941176470589,114,85,70,85,80,30,464,0.2066115702479339,0.25
66,41,77,61,87,23,355,0.12096774193548387,50,45,45,35,35,50,260,0.23529411764705882,1.0
67,58,57,81,67,101,431,0.8790322580645161,86,92,88,68,75,73,482,0.6835443037974683,2.0
65,80,140,40,70,70,465,0.5223880597014925,79,103,120,135,115,78,630,0.5763888888888888,0.5
69,69,76,69,86,91,460,0.6554621848739496,62,77,62,50,42,65,358,0.4838709677419355,1.0
60,70,65,125,105,90,515,0.6911764705882353,60,85,60,85,60,55,405,0.3673469387755102,0.5
55,55,50,45,65,55,325,0.37373737373737376,65,65,45,75,45,95,390,0.72,1.0
50,60,60,60,60,30,320,0.11290322580645161,45,100,45,45,45,10,290,0.2949640287769784,1.0
50,65,107,105,107,86,520,0.703125,62,50,58,73,54,72,369,0.4435483870967742,0.5
70,60,70,87,78,85,450,0.6228070175438597,50,105,79,35,110,76,455,0.6214285714285714,1.0
60,85,42,85,42,91,405,0.8227848101265823,59,45,40,35,40,31,250,0.14285714285714285,1.0
105,95,80,40,80,90,490,0.753968253968254,85,56,77,50,77,78,423,0.53125,1.0
108,170,115,120,95,92,700,0.7083333333333334,70,110,75,145,85,145,630,0.9444444444444444,1.0
65,90,65,61,61,100,442,0.8373983739837398,80,82,83,100,100,80,525,0.6742424242424242,2.0
80,135,85,70,95,150,615,0.9844961240310077,80,130,100,160,120,110,700,0.8981481481481481,1.0
64,51,23,51,23,28,240,0.11363636363636363,55,55,55,85,55,30,335,0.1320754716981132,1.0
50,80,95,10,45,10,290,0.232,90,85,100,95,125,85,580,0.6834532374100719,4.0
80,52,50,90,50,89,411,0.6666666666666666,75,89,85,55,65,36,405,0.29545454545454547,4.0
45,35,45,62,53,35,275,0.11851851851851852,37,25,41,25,41,25,194,0.08870967741935484,0.5
62,73,55,56,52,84,382,0.7244094488188977,103,93,67,71,61,84,479,0.7142857142857143,1.0
80,135,130,95,90,70,600,0.5181818181818182,60,59,85,79,105,36,424,0.16666666666666666,1.0
106,110,90,154,90,130,680,0.926829268292683,85,105,100,79,83,78,530,0.5869565217391305,1.0
70,60,125,115,70,55,495,0.35507246376811596,70,110,70,115,70,90,525,0.75,0.25
80,160,60,170,130,80,680,0.6180555555555556,44,75,35,63,33,45,295,0.2647058823529412,2.0
45,25,50,25,25,35,205,0.13076923076923078,85,120,70,50,60,100,485,0.8308823529411765,0.5
106,130,90,110,154,90,680,0.719626168224299,85,105,100,79,83,78,530,0.5869565217391305,0.5
60,110,70,60,60,100,460,0.8461538461538461,40,35,30,20,20,50,195,0.23423423423423423,2.0
60,80,50,40,40,30,300,0.15328467153284672,61,90,45,50,50,160,456,0.9230769230769231,1.0
60,50,70,50,90,65,385,0.39568345323741005,75,80,95,90,100,50,490,0.2158273381294964,4.0
55,68,64,45,55,31,318,0.11666666666666667,50,75,75,65,65,50,380,0.4049586776859504,1.0
50,53,48,53,48,64,316,0.358974358974359,65,55,115,100,40,60,435,0.3798449612403101,0.5
43,80,65,50,35,35,308,0.14193548387096774,55,81,60,50,70,97,413,0.7214285714285714,1.0
90,120,75,60,60,45,450,0.29411764705882354,79,85,60,55,60,71,410,0.60431654676259,1.0
55,47,52,40,40,41,275,0.16806722689075632,64,115,65,83,63,65,455,0.5323741007194245,0.5
50,120,53,35,110,87,455,0.640625,100,150,140,100,90,90,670,0.7969924812030075,1.0
45,50,55,75,65,30,320,0.06293706293706294,45,85,70,40,40,60,340,0.5229357798165137,0.0
50,85,125,85,115,20,480,0.4306569343065693,125,58,58,76,76,67,460,0.515625,1.0
75,100,95,40,70,110,490,0.8717948717948718,60,62,80,63,80,60,405,0.4336283185840708,1.0
73,76,75,81,100,100,505,0.8110236220472441,65,155,120,65,90,105,600,0.8677685950413223,2.0
35,46,34,35,45,20,215,0.072,50,20,40,20,40,20,190,0.0962962962962963,1.0
40,30,30,55,30,85,270,0.4666666666666667,80,92,65,65,80,68,450,0.4824561403508772,0.5
106,150,70,194,120,140,780,0.952,64,88,50,88,50,106,446,0.9111111111111111,0.0
75,95,125,45,75,95,510,0.8257575757575758,50,60,60,60,60,30,320,0.11290322580645161,2.0
100,90,130,45,65,55,485,0.4253731343283582,55,95,115,45,45,35,390,0.2116788321167883,2.0
72,85,70,65,70,58,420,0.41304347826086957,60,85,60,85,60,55,405,0.3673469387755102,0.5
70,90,110,60,75,95,500,0.7333333333333333,72,58,80,103,80,97,490,0.7171052631578947,2.0
48,72,48,72,48,48,336,0.25984251968503935,70,55,75,45,65,60,370,0.45901639344262296,0.0
80,80,90,110,130,110,600,0.8721804511278195,50,65,107,105,107,86,520,0.7758620689655172,1.0
75,75,130,75,130,95,580,0.7479674796747967,78,81,71,74,69,126,499,0.9090909090909091,1.0
30,40,55,40,55,60,280,0.3237410071942446,45,95,50,40,50,75,355,0.54,1.0
83,80,75,70,70,101,479,0.8615384615384616,55,40,40,65,45,35,280,0.16428571428571428,0.5
89,124,80,55,80,55,483,0.5714285714285714,114,85,70,85,80,30,464,0.2066115702479339,1.0
53,51,53,61,56,40,314,0.14285714285714285,78,84,78,109,85,100,534,0.8646616541353384,2.0
65,90,40,45,80,75,395,0.625,103,60,126,80,126,50,545,0.36363636363636365,1.0
80,160,80,130,80,100,630,0.8455284552845529,70,150,140,65,100,75,600,0.55,4.0
65,90,40,45,80,75,395,0.625,60,50,50,60,70,50,340,0.28346456692913385,4.0
55,75,50,40,40,80,340,0.6302521008403361,70,110,80,55,80,105,500,0.8794326241134752,2.0
40,65,40,80,40,65,330,0.5038167938931297,72,95,67,103,71,122,530,0.9606299212598425,0.5
70,55,75,45,65,60,370,0.45901639344262296,54,45,47,75,98,52,371,0.39669421487603307,0.5
60,85,69,60,69,77,420,0.518796992481203,40,30,50,55,55,100,330,0.584070796460177,1.0
45,53,70,40,60,42,310,0.25735294117647056,111,83,68,92,82,39,475,0.1774193548387097,4.0
75,75,95,75,95,113,528,0.9015151515151515,95,109,105,75,85,56,525,0.34513274336283184,1.0
54,63,52,83,56,97,405,0.7697841726618705,60,50,150,50,150,60,520,0.5206611570247934,1.0
100,70,70,65,65,45,415,0.1897810218978102,56,61,65,48,45,38,313,0.17567567567567569,1.0
99,68,83,72,87,51,460,0.417910447761194,55,55,55,85,55,30,335,0.1320754716981132,1.0
50,120,53,35,110,87,455,0.640625,65,76,84,54,96,105,480,0.9008264462809917,2.0
85,70,80,97,80,123,535,0.9304347826086956,50,35,55,25,25,15,205,0.021739130434782608,2.0
48,72,48,72,48,48,336,0.25984251968503935,62,50,58,73,54,72,369,0.4435483870967742,1.0
55,69,85,32,35,28,304,0.09302325581395349,54,63,52,83,56,97,405,0.7697841726618705,0.5
92,105,90,125,90,98,600,0.8217054263565892,75,100,63,80,63,116,497,0.9345794392523364,1.0
45,85,70,40,40,60,340,0.5229357798165137,55,65,35,60,30,85,330,0.6126126126126126,0.5
85,73,70,73,115,67,483,0.5126050420168067,92,105,90,125,90,98,600,0.8217054263565892,0.0
95,75,110,100,80,30,490,0.15267175572519084,60,62,80,63,80,60,405,0.4336283185840708,0.5
75,75,130,75,130,95,580,0.7479674796747967,50,65,85,35,35,55,325,0.32575757575757575,1.0
80,120,79,95,79,70,523,0.5833333333333334,40,70,40,35,40,60,285,0.392,1.0
44,48,65,50,64,43,314,0.1623931623931624,45,50,45,115,55,95,405,0.6936936936936937,1.0
103,93,67,71,61,84,479,0.7142857142857143,100,150,90,180,160,90,770,0.7348484848484849,1.0
80,80,80,80,80,80,480,0.5606060606060606,45,50,55,75,65,30,320,0.06293706293706294,0.5
40,20,30,40,80,55,265,0.22764227642276422,135,85,40,40,85,5,390,0.6864406779661016,1.0
50,50,95,40,50,35,320,0.20279720279720279,50,105,79,35,110,76,455,0.6214285714285714,1.0
90,132,105,132,105,30,594,0.4246575342465753,20,40,90,30,90,25,295,0.11363636363636363,1.0
62,50,58,73,54,72,369,0.4435483870967742,79,115,70,125,80,111,580,0.864,1.0
70,92,65,80,55,98,460,0.8090909090909091,75,90,50,110,80,95,500,0.7985611510791367,2.0
45,49,49,65,65,45,318,0.2781954887218045,50,65,107,105,107,86,520,0.6991150442477876,0.5
66,41,77,61,87,23,355,0.12096774193548387,85,80,90,105,95,60,515,0.49074074074074076,1.0
60,45,70,45,90,95,405,0.7304964539007093,75,75,95,75,95,113,528,0.9015151515151515,0.5
68,65,65,125,115,80,518,0.6461538461538462,250,5,5,35,105,50,450,0.15306122448979592,1.0
37,25,41,25,41,25,194,0.08870967741935484,55,68,64,45,55,31,318,0.11666666666666667,2.0
59,74,50,35,50,35,303,0.3125,40,30,35,50,70,55,280,0.28205128205128205,1.0
77,120,90,60,90,48,485,0.2785714285714286,60,85,49,60,49,60,363,0.4444444444444444,1.0
106,130,90,110,154,90,680,0.719626168224299,50,80,95,10,45,10,290,0.232,0.25
40,50,90,30,55,65,330,0.44680851063829785,90,92,87,75,85,76,505,0.5409836065573771,0.125
90,60,70,75,70,45,410,0.23880597014925373,43,80,65,50,35,35,308,0.14193548387096774,0.25
95,85,85,65,65,35,430,0.2571428571428571,58,64,58,80,65,80,405,0.5423728813559322,4.0
72,60,30,20,30,25,237,0.11570247933884298,83,106,65,86,65,85,490,0.6640625,0.5
80,120,130,55,65,45,495,0.37037037037037035,30,30,42,30,42,70,244,0.4230769230769231,0.0
100,150,120,120,100,90,680,0.6493506493506493,95,85,85,65,65,35,430,0.2571428571428571,0.0
60,45,70,45,90,95,405,0.7304964539007093,60,95,80,60,80,30,405,0.19480519480519481,0.5
59,45,40,35,40,31,250,0.14285714285714285,40,30,30,40,50,30,220,0.07936507936507936,1.0
45,60,30,80,50,65,330,0.4603174603174603,50,47,50,57,50,65,319,0.463768115942029,2.0
38,35,40,27,25,35,200,0.08208955223880597,75,125,100,70,80,45,495,0.33035714285714285,1.0
79,115,70,125,80,111,580,0.864,35,65,35,65,35,65,300,0.46621621621621623,2.0
30,45,55,70,55,85,340,0.5633802816901409,70,60,70,87,78,85,450,0.6228070175438597,0.5
45,25,50,25,25,35,205,0.13076923076923078,35,80,50,50,70,120,405,0.84375,0.5
76,65,45,92,42,91,411,0.7449664429530202,60,95,80,60,80,30,405,0.19480519480519481,4.0
55,84,105,114,75,52,485,0.2890625,52,65,55,58,62,60,352,0.4482758620689655,1.0
100,100,100,100,100,100,600,0.8758169934640523,40,30,30,40,50,30,220,0.07936507936507936,0.5
50,50,95,40,50,35,320,0.20279720279720279,126,131,95,131,98,99,680,0.8102189781021898,0.0
30,42,118,42,88,30,350,0.112,39,52,43,60,50,65,309,0.5041322314049587,1.0
65,95,100,60,50,50,420,0.34959349593495936,77,120,90,60,90,48,485,0.2785714285714286,2.0
90,100,90,125,85,90,580,0.7352941176470589,65,90,50,85,45,55,390,0.371900826446281,4.0
60,50,70,50,90,65,385,0.39568345323741005,77,85,51,55,51,65,384,0.5163934426229508,1.0
70,80,65,90,65,85,455,0.578125,65,105,60,60,70,95,455,63.0,1.0
45,55,39,35,39,42,255,0.18518518518518517,78,84,78,109,85,100,534,0.8646616541353384,1.0
68,65,65,125,115,80,518,0.6461538461538462,80,75,150,75,150,50,580,0.30973451327433627,0.25
40,55,30,30,30,85,270,0.688,65,130,60,95,110,65,525,0.5303030303030303,1.0
67,125,40,30,30,58,350,0.3431372549019608,64,115,65,83,63,65,455,0.5323741007194245,1.0
75,69,72,114,100,104,534,0.8253968253968254,50,53,48,53,48,64,316,0.46153846153846156,0.5
60,70,50,100,50,65,395,0.5217391304347826,45,60,30,80,50,65,330,0.4603174603174603,1.0
35,60,44,40,54,55,288,0.366412213740458,50,65,64,44,48,43,314,0.2196969696969697,1.0
85,73,70,73,115,67,483,0.5126050420168067,80,130,100,160,120,110,700,0.8981481481481481,0.5
30,45,59,30,39,57,260,0.2803030303030303,40,55,80,35,60,30,300,0.15037593984962405,0.0
48,61,40,61,40,50,300,0.2543859649122807,69,69,76,69,86,91,460,0.6554621848739496,1.0
55,55,55,85,55,30,335,0.1320754716981132,70,105,105,50,40,20,390,0.33587786259541985,1.0
40,40,35,50,100,70,335,0.5031847133757962,90,92,87,75,85,76,505,0.5409836065573771,0.5
120,70,120,75,130,85,600,0.6694915254237288,65,75,90,97,123,44,494,0.1987179487179487,2.0
105,140,95,55,65,45,505,0.3,50,65,64,44,48,43,314,0.2196969696969697,1.0
61,78,95,56,58,57,405,0.40336134453781514,95,124,78,69,71,58,495,0.37398373983739835,1.0
43,70,48,50,60,38,309,0.2391304347826087,45,30,50,55,65,45,290,0.208,2.0
55,50,65,175,95,150,590,0.7818181818181819,90,65,65,40,40,15,315,0.19672131147540983,0.5
123,77,72,99,92,58,521,0.4621212121212121,71,120,95,120,95,99,600,0.8203125,0.5
50,48,43,46,41,60,288,0.47297297297297297,76,104,71,104,71,108,534,0.912751677852349,4.0
50,65,107,105,107,86,520,0.7313432835820896,45,85,50,55,50,65,350,0.5076923076923077,1.0
85,60,65,135,105,100,550,0.7518248175182481,106,110,90,154,90,130,680,0.926829268292683,2.0
100,77,77,128,128,90,600,0.6901408450704225,60,50,70,80,80,140,480,0.8449612403100775,1.0
75,80,70,65,75,90,455,0.7578125,75,110,110,110,105,80,590,0.656934306569343,2.0
50,95,90,95,90,180,600,0.9172413793103448,55,66,44,44,56,85,350,0.6888888888888889,1.0
75,75,75,125,95,40,485,0.15671641791044777,76,104,71,104,71,108,534,0.912751677852349,1.0
42,52,67,39,56,50,306,0.2868217054263566,50,65,107,105,107,86,520,0.7313432835820896,0.5
65,125,100,55,70,85,500,0.6532258064516129,55,85,55,50,55,60,360,0.4233576642335766,0.5
90,120,75,60,60,45,450,0.29411764705882354,100,100,100,100,100,100,600,0.8778625954198473,0.5
90,85,100,95,125,85,580,0.6834532374100719,50,70,50,50,50,40,310,0.16296296296296298,0.5
50,45,45,35,35,50,260,0.23529411764705882,65,73,55,47,75,85,400,0.6846846846846847,1.0
55,50,45,135,95,120,500,0.7714285714285715,60,105,60,120,60,105,510,0.8849557522123894,0.0
95,145,130,120,90,120,700,0.9398496240601504,100,150,140,100,90,90,670,0.7969924812030075,1.0
45,85,70,40,40,60,340,0.5229357798165137,60,55,145,75,150,40,525,0.2,1.0
74,100,72,90,72,46,454,0.24561403508771928,85,97,66,105,66,65,484,0.47107438016528924,0.5
30,45,55,70,55,85,340,0.5633802816901409,83,80,80,135,80,121,579,0.9444444444444444,1.0
50,53,48,53,48,64,316,0.358974358974359,43,30,55,40,65,97,330,0.6030534351145038,0.5
75,75,130,75,130,95,580,0.7479674796747967,65,95,75,55,55,85,430,0.6933333333333334,2.0
40,45,65,100,120,90,460,0.5588235294117647,45,60,32,50,32,76,295,0.5925925925925926,1.0
44,38,39,61,79,42,303,0.2251655629139073,45,25,50,25,25,35,205,0.13076923076923078,0.5
38,41,40,50,65,65,299,0.4108527131782946,70,60,70,87,78,85,450,0.6228070175438597,2.0
60,85,69,60,69,77,420,0.518796992481203,61,78,95,56,58,57,405,0.40336134453781514,1.0
74,100,72,90,72,46,454,0.24561403508771928,50,85,125,85,115,20,480,0.4306569343065693,1.0
40,55,99,40,79,47,360,0.26262626262626265,110,135,60,50,65,88,508,0.7744360902255639,0.0
31,45,90,30,30,40,266,0.21929824561403508,60,80,50,50,50,40,330,0.23853211009174313,1.0
50,47,50,57,50,65,319,0.463768115942029,65,75,90,97,123,44,494,0.1987179487179487,0.25
65,75,105,35,65,85,430,0.6940298507462687,40,30,32,50,52,65,269,0.3671875,1.0
20,40,90,30,90,25,295,0.11363636363636363,135,85,40,40,85,5,390,0.6864406779661016,0.0
70,55,55,80,60,45,365,0.2222222222222222,60,55,50,40,55,45,305,0.22377622377622378,1.0
105,95,75,85,75,74,509,0.5714285714285714,76,48,48,57,62,34,325,0.11688311688311688,0.5
115,115,85,90,75,100,580,0.8134328358208955,57,80,91,80,87,75,470,0.5737704918032787,2.0
37,25,41,25,41,25,194,0.08870967741935484,81,102,77,85,75,85,505,0.5642857142857143,0.5
59,45,40,35,40,31,250,0.14285714285714285,70,110,80,55,80,105,500,0.8794326241134752,1.0
75,95,125,45,75,95,510,0.8257575757575758,95,65,65,110,130,60,525,0.4016393442622951,1.0
60,50,40,85,75,95,405,0.7540983606557377,59,74,50,35,50,35,303,0.3125,0.0
30,35,30,100,35,80,310,0.4765625,50,85,55,65,65,90,410,0.7478260869565218,1.0
72,60,30,20,30,25,237,0.11570247933884298,106,150,70,194,120,140,780,0.952,0.5
80,75,150,75,150,50,580,0.30973451327433627,130,85,80,85,95,60,535,0.43884892086330934,1.0
81,102,77,85,75,85,505,0.5642857142857143,60,60,60,35,35,30,280,0.11194029850746269,1.0
90,100,60,90,60,80,480,0.6422764227642277,70,95,85,55,65,70,440,0.5,4.0
70,65,65,55,55,70,380,0.5,100,128,90,77,77,128,600,0.959349593495935,1.0
60,45,70,75,85,55,390,0.3008130081300813,68,165,95,65,115,110,618,0.8615384615384616,0.5
63,60,55,50,50,71,349,0.5289256198347108,105,150,90,150,90,95,680,0.8285714285714286,1.0
110,135,60,50,65,88,508,0.7744360902255639,110,123,65,100,65,65,528,0.5217391304347826,1.0
90,85,100,95,125,85,580,0.6834532374100719,100,100,100,100,100,100,600,0.831858407079646,1.0
30,30,42,30,42,70,244,0.4230769230769231,61,72,57,55,55,65,365,0.3984375,0.5
103,93,67,71,61,84,479,0.7142857142857143,40,55,70,45,60,30,300,0.10619469026548672,0.0
103,60,126,80,126,50,545,0.36363636363636365,50,70,100,40,40,30,330,0.2222222222222222,0.125
1,90,45,30,30,40,236,0.33064516129032256,60,70,50,100,50,65,395,0.5217391304347826,0.5
70,105,105,50,40,20,390,0.33587786259541985,58,50,145,95,105,30,483,0.2459016393442623,1.0
40,30,50,55,55,100,330,0.584070796460177,40,50,90,30,55,65,330,0.44680851063829785,1.0
50,53,48,53,48,64,316,0.4076923076923077,65,130,60,75,60,75,465,0.689922480620155,1.0
75,75,75,125,95,40,485,0.15671641791044777,75,125,100,70,80,45,495,0.33035714285714285,1.0
105,95,80,40,80,90,490,0.753968253968254,53,51,53,61,56,40,314,0.14285714285714285,1.0
80,105,105,105,105,80,580,0.5939849624060151,74,48,76,83,81,104,466,0.7913043478260869,0.5
90,93,55,70,55,55,418,0.3819444444444444,40,55,80,35,60,30,300,0.15037593984962405,2.0
45,30,50,65,50,45,285,0.13821138211382114,60,70,50,100,50,65,395,0.5217391304347826,1.0
40,45,40,62,60,60,307,0.33884297520661155,65,75,90,97,123,44,494,0.1987179487179487,0.5
83,80,75,70,70,101,479,0.8615384615384616,72,58,80,103,80,97,490,0.7171052631578947,1.0
40,55,70,45,60,30,300,0.10619469026548672,90,70,80,70,95,70,475,0.5190839694656488,1.0
80,82,100,83,100,80,525,0.6821705426356589,60,30,30,36,56,50,262,0.32432432432432434,0.5
90,110,80,100,80,95,555,0.7982456140350878,50,50,77,95,77,91,440,0.5916666666666667,1.0
60,55,145,75,150,40,525,0.2,100,150,110,95,110,70,635,0.5923076923076923,0.25
110,130,80,70,60,80,530,0.5862068965517241,70,110,180,60,60,50,530,0.4117647058823529,2.0
58,109,112,48,48,109,484,0.8805970149253731,50,95,90,95,90,180,600,0.9172413793103448,2.0
100,128,90,77,77,128,600,0.959349593495935,84,86,88,111,101,60,530,0.4634146341463415,1.0
95,70,73,95,90,60,483,0.3983739837398374,70,75,60,105,60,105,475,0.88,1.0
80,95,82,60,82,75,474,0.6,56,61,65,48,45,38,313,0.17567567567567569,2.0
80,80,80,80,80,80,480,0.6015037593984962,50,100,150,100,150,50,600,0.37142857142857144,1.0
41,56,40,62,44,71,314,0.568,74,108,133,83,65,32,495,0.32142857142857145,1.0
30,65,100,45,25,40,305,0.1891891891891892,73,100,60,100,60,65,458,0.42657342657342656,1.0
85,100,122,58,75,54,494,0.3939393939393939,65,65,60,130,95,110,525,0.823943661971831,2.0
82,80,86,85,75,72,480,0.6183206106870229,110,65,105,55,95,80,510,0.6258503401360545,2.0
46,57,40,40,40,50,273,0.25,70,94,50,94,50,66,424,0.48148148148148145,1.0
65,130,60,75,60,75,465,0.689922480620155,68,90,65,50,55,82,410,0.6165413533834586,1.0
55,85,122,58,75,99,494,0.8099173553719008,65,75,70,95,70,95,470,0.7272727272727273,1.0
60,55,145,75,150,40,525,0.2,70,85,65,105,85,120,530,0.9262295081967213,1.0
70,100,115,30,65,30,410,0.24390243902439024,80,135,85,70,95,150,615,0.9844961240310077,2.0
130,65,60,110,95,65,525,0.5227272727272727,70,45,48,60,65,35,323,0.15748031496062992,1.0
60,150,50,150,50,60,520,0.5,65,95,100,60,50,50,420,0.34959349593495936,1.0
79,85,60,55,60,71,410,0.60431654676259,40,40,40,70,40,20,250,0.032520325203252036,2.0
75,70,90,70,105,80,490,0.656,70,83,50,37,50,60,350,0.3360655737704918,1.0
65,150,40,15,80,145,495,0.9663865546218487,60,50,100,85,70,65,430,0.47580645161290325,0.5
50,47,50,57,50,65,319,0.463768115942029,105,140,55,30,55,95,480,0.8195488721804511,0.5
65,65,45,75,45,95,390,0.72,50,65,45,85,65,95,405,0.7238095238095238,4.0
110,65,105,55,95,80,510,0.6258503401360545,100,100,90,150,140,90,670,0.71875,1.0
45,55,39,35,39,42,255,0.18518518518518517,40,30,35,45,40,55,245,0.31496062992125984,1.0
83,106,65,86,65,85,490,0.6640625,108,130,95,80,85,102,600,0.7637795275590551,0.5
35,80,50,50,70,120,405,0.84375,60,40,60,40,60,35,295,0.18055555555555555,0.5
38,35,40,27,25,35,200,0.08208955223880597,65,50,70,95,80,65,425,0.4262295081967213,2.0
79,105,70,145,80,101,580,0.8608695652173913,70,75,80,135,80,135,575,0.917910447761194,0.25
90,120,100,150,120,100,680,0.7718120805369127,70,75,60,105,60,105,475,0.88,1.0
50,95,90,95,90,180,600,0.9172413793103448,50,70,50,50,50,70,340,0.5645161290322581,2.0
110,78,73,76,71,60,468,0.3333333333333333,60,105,60,120,60,105,510,0.8849557522123894,1.0
43,80,65,50,35,35,308,0.14193548387096774,108,112,118,68,72,47,525,0.2916666666666667,2.0
53,54,53,37,46,45,288,0.3090909090909091,46,87,60,30,40,57,320,0.37777777777777777,1.0
120,100,85,30,85,45,465,0.22448979591836735,86,92,88,68,75,73,482,0.6835443037974683,1.0
80,85,95,30,30,25,345,0.2857142857142857,55,40,40,65,45,35,280,0.16428571428571428,2.0
63,120,85,90,55,55,468,0.2809917355371901,75,80,70,65,75,90,455,0.7578125,1.0
60,70,105,70,120,75,500,0.5983606557377049,45,75,37,70,55,83,365,0.6183206106870229,2.0
60,40,50,75,85,95,405,0.6044776119402985,70,110,75,145,85,145,630,0.9444444444444444,0.25
70,150,140,65,100,75,600,0.55,60,65,60,130,75,110,500,0.7719298245614035,0.25
95,75,80,100,110,30,490,0.24242424242424243,108,170,115,120,95,92,700,0.7083333333333334,2.0
65,45,55,45,70,45,325,0.24369747899159663,70,120,40,95,40,95,460,0.8106060606060606,0.5
75,95,125,45,75,95,510,0.8257575757575758,100,103,75,120,75,127,600,0.940677966101695,0.0
58,64,58,80,65,80,405,0.5423728813559322,40,55,30,30,30,85,270,0.688,1.0
50,70,100,40,40,30,330,0.2222222222222222,40,29,45,29,45,36,224,0.14634146341463414,2.0
105,30,105,140,105,55,540,0.3524590163934426,50,75,75,65,65,50,380,0.4049586776859504,0.0
75,100,66,60,66,115,482,0.918918918918919,50,65,85,35,35,55,325,0.32575757575757575,0.5
85,100,122,58,75,54,494,0.3939393939393939,70,60,75,110,75,90,480,0.7165354330708661,0.5
70,43,53,43,53,40,302,0.19090909090909092,65,90,120,85,70,60,490,0.43410852713178294,0.5
78,84,78,109,85,100,534,0.8620689655172413,69,55,45,55,55,15,294,0.11666666666666667,2.0
100,70,70,65,65,45,415,0.1897810218978102,72,58,80,103,80,97,490,0.7171052631578947,1.0
90,75,75,90,100,70,500,0.5462184873949579,40,80,100,30,30,20,300,0.11851851851851852,4.0
75,80,60,65,90,102,472,0.8625954198473282,83,106,65,86,65,85,490,0.6640625,1.0
85,60,65,135,105,100,550,0.7518248175182481,10,55,25,35,45,95,265,0.5396825396825397,1.0
65,125,60,95,60,105,510,0.9236641221374046,45,45,55,45,55,63,308,0.4594594594594595,1.0
35,45,160,30,45,70,385,0.48148148148148145,100,150,110,95,110,70,635,0.5923076923076923,0.5
100,50,80,60,80,50,420,0.34375,60,85,60,85,60,55,405,0.3673469387755102,2.0
54,63,52,83,56,97,405,0.7697841726618705,55,35,50,55,110,85,390,0.6277372262773723,1.0
70,60,70,87,78,85,450,0.6228070175438597,65,90,115,45,115,58,488,0.5041322314049587,1.0
40,45,35,65,55,70,310,0.4482758620689655,75,95,60,65,60,115,470,0.8778625954198473,1.0
70,150,140,65,100,75,600,0.55,55,68,64,45,55,31,318,0.11666666666666667,2.0
30,30,30,30,30,30,180,0.12612612612612611,68,72,78,38,42,32,330,0.23809523809523808,2.0
90,100,90,125,85,90,580,0.7352941176470589,76,65,45,92,42,91,411,0.7449664429530202,1.0
60,52,168,47,138,30,495,0.19834710743801653,60,65,70,85,75,40,395,0.21705426356589147,1.0
60,130,80,60,60,70,460,0.5153846153846153,90,120,120,60,60,50,500,0.35294117647058826,2.0
44,38,39,61,79,42,303,0.2251655629139073,80,120,130,55,65,45,495,0.37037037037037035,1.0
55,50,40,40,40,75,300,0.5945945945945946,50,65,107,105,107,86,520,0.7313432835820896,1.0
60,100,89,55,69,112,485,0.9298245614035088,111,83,68,92,82,39,475,0.1774193548387097,0.5
45,95,50,40,50,75,355,0.54,60,85,49,60,49,60,363,0.4444444444444444,1.0
40,30,35,45,40,55,245,0.31496062992125984,90,60,60,40,40,40,330,0.29545454545454547,1.0
40,80,35,35,45,70,305,0.4661016949152542,68,85,65,165,135,100,618,0.8083333333333333,0.25
45,60,32,50,32,76,295,0.5925925925925926,82,80,86,85,75,72,480,0.6183206106870229,1.0
65,45,55,45,70,45,325,0.24369747899159663,65,155,120,65,90,105,600,0.8677685950413223,1.0
95,155,109,70,130,81,640,0.6788321167883211,30,105,90,25,25,50,325,0.2773722627737226,0.5
35,80,50,50,70,120,405,0.84375,60,30,30,36,56,50,262,0.32432432432432434,0.0
75,98,63,98,63,101,498,0.849624060150376,95,75,80,100,110,30,490,0.24242424242424243,0.5
44,50,91,24,86,10,305,0.1981981981981982,60,70,50,100,50,65,395,0.5217391304347826,0.25
30,45,59,30,39,57,260,0.2803030303030303,65,65,65,50,50,90,385,0.72,1.0
70,80,50,35,35,35,305,0.14,95,100,85,108,70,70,528,0.5652173913043478,1.0
125,58,58,76,76,67,460,0.515625,68,165,95,65,115,110,618,0.8615384615384616,1.0
95,100,85,108,70,70,528,0.5652173913043478,62,44,50,44,50,55,305,0.3629032258064516,0.5
65,70,60,65,65,115,440,0.8583333333333333,63,60,55,50,50,71,349,0.5289256198347108,1.0
60,60,60,105,105,105,495,0.848,104,91,63,91,73,68,490,0.5118110236220472,0.0
62,73,55,56,52,84,382,0.7244094488188977,80,110,60,150,130,70,600,0.5042016806722689,1.0
61,72,57,55,55,65,365,0.3984375,60,45,70,75,85,55,390,0.3008130081300813,1.0
60,69,95,69,95,36,424,0.2608695652173913,126,131,95,131,98,99,680,0.8102189781021898,1.0
88,107,122,74,75,64,530,0.4596774193548387,30,30,42,30,42,70,244,0.4230769230769231,0.0625
80,110,60,150,130,70,600,0.5042016806722689,55,55,50,45,65,55,325,0.37373737373737376,0.0
95,124,78,69,71,58,495,0.37398373983739835,60,85,42,85,42,91,405,0.8227848101265823,0.5
60,45,50,90,80,70,395,0.625,40,35,30,20,20,50,195,0.23423423423423423,1.0
40,60,40,40,40,30,250,0.0948905109489051,55,95,115,45,45,35,390,0.2116788321167883,0.25
45,55,39,35,39,42,255,0.18518518518518517,68,90,65,50,55,82,410,0.6165413533834586,1.0
86,68,72,109,66,106,507,0.8099173553719008,35,40,100,90,55,35,355,0.1796875,0.125
80,70,70,90,100,70,480,0.5609756097560976,60,100,85,80,85,100,510,0.7007874015748031,1.0
80,100,200,50,100,50,580,0.3472222222222222,105,140,95,55,65,45,505,0.3,0.5
65,155,120,65,90,105,600,0.8677685950413223,78,52,60,63,65,23,341,0.06015037593984962,0.5
50,92,108,92,108,35,485,0.2457627118644068,61,78,95,56,58,57,405,0.40336134453781514,1.0
90,95,105,165,110,45,610,0.2890625,60,90,55,90,80,110,485,0.8677685950413223,0.5
60,59,85,79,105,36,424,0.16666666666666666,50,50,62,40,62,65,329,0.4188034188034188,0.25
75,123,67,95,85,95,540,0.7642276422764228,65,150,40,15,80,145,495,0.9663865546218487,1.0
100,100,100,100,100,100,600,0.8345864661654135,100,150,110,95,110,70,635,0.5923076923076923,8.0
55,55,45,63,45,45,308,0.25,90,100,90,125,85,90,580,0.7352941176470589,2.0
45,100,45,45,45,10,290,0.2949640287769784,60,40,80,60,45,40,325,0.23529411764705882,0.5
70,60,62,80,82,60,414,0.4375,40,55,80,35,60,30,300,0.15037593984962405,0.5
40,45,35,30,40,55,245,0.3793103448275862,75,38,38,56,56,67,330,0.5263157894736842,0.5
65,65,45,75,45,95,390,0.72,40,55,80,35,60,30,300,0.15037593984962405,0.5
86,81,97,81,107,43,495,0.203125,70,45,48,60,65,35,323,0.15748031496062992,1.0
65,83,57,95,85,105,490,0.8914728682170543,70,83,50,37,50,60,350,0.3360655737704918,2.0
55,55,55,85,55,30,335,0.1320754716981132,65,136,94,54,96,135,580,0.9612403100775194,1.0
95,135,80,110,80,100,600,0.8248175182481752,60,85,40,30,45,68,328,0.6422018348623854,1.0
76,65,45,92,42,91,411,0.7449664429530202,64,78,52,78,52,81,405,0.6422764227642277,2.0
110,160,110,80,110,100,670,0.8591549295774648,89,145,90,105,80,91,600,0.8549618320610687,1.0
78,104,78,159,115,100,634,0.8444444444444444,100,150,90,180,160,90,770,0.7348484848484849,0.5
40,30,35,45,40,55,245,0.31496062992125984,95,117,184,44,46,28,514,0.2975206611570248,1.0
115,115,85,90,75,100,580,0.8134328358208955,70,115,60,115,60,55,475,0.4647887323943662,2.0
75,125,100,70,80,45,495,0.33035714285714285,75,80,60,65,90,102,472,0.8625954198473282,1.0
90,120,100,150,120,100,680,0.7718120805369127,95,80,105,40,70,100,490,0.8046875,1.0
100,77,77,128,128,90,600,0.6901408450704225,50,65,107,105,107,86,520,0.6991150442477876,1.0
70,45,48,60,65,35,323,0.15748031496062992,79,105,70,145,80,101,580,0.8608695652173913,1.0
78,92,75,74,63,118,500,0.8842975206611571,65,60,110,130,95,65,525,0.47761194029850745,2.0
105,105,75,65,100,50,500,0.37593984962406013,75,80,55,25,35,35,305,0.18666666666666668,1.0
75,87,63,87,63,98,473,0.865546218487395,75,123,67,95,85,95,540,0.7642276422764228,0.5
75,95,95,95,95,85,540,0.6470588235294118,44,48,65,50,64,43,314,0.1623931623931624,0.5
70,43,53,43,53,40,302,0.19090909090909092,79,100,80,110,90,121,580,0.968,1.0
70,60,75,110,75,90,480,0.7165354330708661,45,63,37,65,55,95,360,0.8055555555555556,1.0
70,75,80,135,80,135,575,0.917910447761194,50,53,62,58,63,44,330,0.13709677419354838,2.0
50,50,40,50,40,64,294,0.45588235294117646,90,92,75,92,85,60,494,0.49586776859504134,0.5
80,120,80,120,80,100,580,0.8478260869565217,60,40,60,95,60,55,370,0.4222222222222222,0.5
50,65,90,35,35,15,290,0.14678899082568808,59,63,80,65,80,58,405,0.41843971631205673,1.0
65,125,100,60,70,70,490,0.6099290780141844,50,75,70,35,70,48,348,0.29357798165137616,0.25
55,40,50,65,85,40,335,0.3181818181818182,70,85,140,85,70,20,470,0.272,2.0
40,45,35,65,55,70,310,0.4482758620689655,120,120,120,120,120,120,720,0.9344262295081968,1.0
86,76,86,116,56,95,515,0.7982456140350878,68,125,65,65,115,80,518,0.6277372262773723,2.0
40,40,55,40,70,55,300,0.40939597315436244,60,100,115,70,85,90,520,0.7557251908396947,1.0
70,55,95,95,110,65,490,0.48872180451127817,95,155,109,70,130,81,640,0.6788321167883211,0.0
95,80,105,40,70,100,490,0.8046875,60,85,69,60,69,77,420,0.518796992481203,1.0
65,100,70,80,80,105,500,0.8666666666666667,90,92,75,92,85,60,494,0.49586776859504134,4.0
75,95,67,125,95,83,540,0.7117117117117117,20,40,15,35,35,60,205,0.34285714285714286,1.0
105,180,100,180,100,115,780,0.9477611940298507,58,89,77,45,45,48,362,0.3177570093457944,1.0
70,95,85,55,65,70,440,0.5,70,84,70,65,70,51,410,0.2949640287769784,1.0
80,120,80,120,80,100,580,0.8478260869565217,55,95,55,35,75,115,430,0.9380530973451328,0.5
68,165,95,65,115,110,618,0.8615384615384616,80,120,130,55,65,45,495,0.37037037037037035,4.0
65,130,60,75,60,75,465,0.689922480620155,60,50,100,85,70,65,430,0.47580645161290325,1.0
105,105,75,65,100,50,500,0.37593984962406013,46,87,60,30,40,57,320,0.37777777777777777,1.0
40,80,35,35,45,70,305,0.4661016949152542,150,160,100,95,65,100,670,0.8866666666666667,2.0
35,65,35,65,35,65,300,0.46621621621621623,38,36,38,32,36,57,237,0.3893805309734513,1.0
150,80,44,90,54,80,498,0.625,80,80,50,40,50,25,325,0.176056338028169,1.0
40,65,95,60,45,35,340,0.13986013986013987,40,40,50,30,30,30,220,0.0873015873015873,2.0
65,80,65,35,65,60,370,0.38405797101449274,85,73,70,73,115,67,483,0.5126050420168067,1.0
95,80,105,40,70,100,490,0.8046875,78,70,61,50,61,100,420,0.8145161290322581,1.0
45,35,50,70,50,30,280,0.15753424657534246,59,59,58,90,70,73,409,0.5826086956521739,0.5
45,35,45,62,53,35,275,0.11851851851851852,60,80,50,40,40,30,300,0.15328467153284672,1.0
45,35,50,70,50,30,280,0.15753424657534246,65,75,70,95,70,95,470,0.7272727272727273,0.5
60,52,168,47,138,30,495,0.19834710743801653,44,38,33,61,43,70,289,0.5267857142857143,0.5
105,95,80,40,80,90,490,0.753968253968254,70,50,30,95,135,105,485,0.8040540540540541,1.0
55,75,60,75,60,103,428,0.7982456140350878,60,67,85,77,75,116,480,0.8888888888888888,1.0
45,80,100,35,37,28,325,0.3125,100,5,5,15,65,30,220,0.07692307692307693,0.0
90,110,80,100,80,95,555,0.7982456140350878,70,84,70,65,70,51,410,0.2949640287769784,0.5
54,45,47,75,98,52,371,0.39669421487603307,61,78,95,56,58,57,405,0.40336134453781514,1.0
125,170,100,120,90,95,700,0.77,60,60,50,40,50,75,335,0.5882352941176471,2.0
75,90,140,60,60,40,465,0.3008130081300813,30,35,30,100,35,80,310,0.4765625,0.25
55,40,50,65,85,40,335,0.3181818181818182,50,50,150,50,150,50,500,0.2571428571428571,2.0
75,125,230,55,95,30,610,0.3448275862068966,30,40,55,40,55,60,280,0.3237410071942446,1.0
65,40,50,125,60,30,370,0.07258064516129033,65,90,40,45,80,75,395,0.625,2.0
70,110,180,60,60,50,530,0.4117647058823529,55,84,105,114,75,52,485,0.2890625,0.5
105,30,105,140,105,55,540,0.3524590163934426,90,132,105,132,105,30,594,0.4246575342465753,4.0
35,20,65,40,65,20,245,0.02459016393442623,53,51,53,61,56,40,314,0.14285714285714285,1.0
106,150,70,194,120,140,780,0.952,64,165,75,93,83,75,555,0.6587301587301587,1.0
35,80,50,50,70,120,405,0.84375,55,50,40,40,40,75,300,0.5945945945945946,1.0
60,62,63,80,80,60,405,0.38016528925619836,45,35,50,70,50,30,280,0.15753424657534246,1.0
104,91,63,91,73,68,490,0.5118110236220472,62,73,55,56,52,84,382,0.7244094488188977,1.0
60,110,70,60,60,100,460,0.8461538461538461,40,60,30,31,31,70,262,0.4492753623188406,1.0
58,70,45,40,45,42,300,0.25925925925925924,60,45,50,90,80,70,395,0.625,0.0
40,27,60,37,50,66,280,0.36220472440944884,85,73,70,73,115,67,483,0.5126050420168067,1.0
75,100,66,60,66,115,482,0.918918918918919,45,75,60,40,30,50,300,0.304,1.0
65,90,50,85,45,55,390,0.371900826446281,90,120,100,150,120,100,680,0.7718120805369127,1.0
70,55,75,45,65,60,370,0.45901639344262296,90,110,80,100,80,95,555,0.7982456140350878,1.0
35,55,40,50,50,90,320,0.6838235294117647,79,115,70,125,80,111,580,0.8468468468468469,2.0
65,150,40,15,80,145,495,0.9663865546218487,40,60,40,40,40,30,250,0.0948905109489051,0.25
55,95,55,35,75,115,430,0.9380530973451328,62,77,62,50,42,65,358,0.4838709677419355,2.0
70,55,55,80,60,45,365,0.2222222222222222,59,59,58,90,70,73,409,0.5826086956521739,1.0
50,50,150,50,150,50,500,0.2571428571428571,95,117,80,65,70,92,519,0.8409090909090909,1.0
55,55,45,63,45,45,308,0.25,75,100,63,80,63,116,497,0.9345794392523364,1.0
70,83,50,37,50,60,350,0.3360655737704918,63,120,85,90,55,55,468,0.2809917355371901,1.0
40,45,35,40,40,90,290,0.65,95,75,180,130,80,30,590,0.13793103448275862,1.0
106,150,70,194,120,140,780,0.952,95,110,95,40,95,55,490,0.40336134453781514,1.0
73,76,75,81,100,100,505,0.8110236220472441,57,24,86,24,86,23,300,0.12727272727272726,2.0
95,145,130,120,90,120,700,0.9398496240601504,50,25,28,45,55,15,218,0.0625,0.0
45,30,40,105,50,20,290,0.031007751937984496,90,30,15,40,20,15,210,0.043478260869565216,1.0
85,50,95,120,115,80,545,0.5793650793650794,78,52,60,63,65,23,341,0.06015037593984962,1.0
71,73,88,120,89,59,500,0.43537414965986393,65,136,94,54,96,135,580,0.9612403100775194,1.0
91,90,106,130,106,77,600,0.648854961832061,65,65,60,110,95,130,525,0.9253731343283582,0.5
50,150,50,150,50,150,600,0.9339622641509434,105,95,80,40,80,90,490,0.753968253968254,1.0
80,185,115,40,105,75,600,0.6230769230769231,59,74,50,35,50,35,303,0.3125,0.0
20,25,45,70,90,60,310,0.30833333333333335,135,85,40,40,85,5,390,0.6864406779661016,1.0
57,24,86,24,86,23,300,0.12727272727272726,70,43,53,43,53,40,302,0.19090909090909092,2.0
80,100,123,122,120,80,625,0.56,70,80,50,35,35,35,305,0.14,1.0
74,48,76,83,81,104,466,0.7322834645669292,106,190,100,154,100,130,780,0.9259259259259259,0.5
100,100,100,100,100,100,600,0.831858407079646,100,150,140,100,90,90,670,0.7969924812030075,2.0
50,65,85,35,35,55,325,0.32575757575757575,65,75,70,95,70,95,470,0.7272727272727273,2.0
92,105,90,125,90,98,600,0.8217054263565892,40,55,30,30,30,60,245,0.43548387096774194,1.0
40,29,45,29,45,36,224,0.14634146341463414,74,100,72,90,72,46,454,0.24561403508771928,2.0
71,120,95,120,95,99,600,0.8203125,45,45,35,20,30,20,195,0.07246376811594203,1.0
65,100,70,80,80,105,500,0.8666666666666667,40,70,40,35,40,60,285,0.392,1.0
50,60,60,60,60,30,320,0.11290322580645161,20,40,15,35,35,60,205,0.34285714285714286,1.0
125,130,90,130,90,95,660,0.7734375,74,94,131,54,116,20,489,0.4485294117647059,0.5
50,60,60,60,60,30,320,0.11290322580645161,78,84,78,109,85,100,534,0.8620689655172413,2.0
50,85,85,55,55,50,380,0.3902439024390244,105,130,120,45,45,40,485,0.4444444444444444,2.0
65,155,120,65,90,105,600,0.8677685950413223,80,80,50,40,50,25,325,0.176056338028169,0.5
50,65,107,105,107,86,520,0.703125,66,65,48,62,57,52,350,0.36220472440944884,1.0
55,55,45,63,45,45,308,0.25,70,120,65,45,85,125,510,0.9747899159663865,1.0
60,50,70,50,90,65,385,0.39568345323741005,60,60,60,105,105,105,495,0.848,0.25
95,65,110,60,130,65,525,0.5275590551181102,190,33,58,33,58,33,405,0.13432835820895522,2.0
95,135,80,110,80,100,600,0.8248175182481752,74,108,133,83,65,32,495,0.32142857142857145,0.5
80,95,82,60,82,75,474,0.6,97,165,60,65,50,58,495,0.3902439024390244,0.5
75,80,60,65,90,102,472,0.8625954198473282,35,85,45,35,35,75,310,0.6492537313432836,1.0
60,65,60,130,75,110,500,0.7719298245614035,70,50,30,95,135,105,485,0.8040540540540541,1.0
20,25,45,70,90,60,310,0.30833333333333335,63,60,55,50,50,71,349,0.5289256198347108,1.0
50,85,125,85,115,20,480,0.4306569343065693,60,50,150,50,150,60,520,0.5206611570247934,4.0
77,85,51,55,51,65,384,0.5163934426229508,100,123,75,57,75,80,510,0.6923076923076923,0.5
59,74,50,35,50,35,303,0.3125,81,102,77,85,75,85,505,0.5642857142857143,2.0
35,55,40,45,40,60,275,0.35714285714285715,75,105,75,105,75,45,480,0.3274336283185841,2.0
49,55,42,42,37,85,310,0.6068376068376068,65,150,60,115,60,115,565,0.935251798561151,1.0
60,62,50,62,60,40,334,0.18181818181818182,91,72,90,129,90,108,580,0.8925619834710744,1.0
60,79,105,59,85,36,424,0.17054263565891473,79,105,70,145,80,101,580,0.8608695652173913,0.0
54,66,70,44,55,46,335,0.4214876033057851,70,110,70,115,70,90,525,0.75,0.5
100,110,90,85,90,60,535,0.47794117647058826,110,130,80,70,60,80,530,0.5862068965517241,2.0
50,20,40,20,40,20,190,0.0962962962962963,60,55,50,40,55,45,305,0.22377622377622378,0.5
123,100,62,97,81,68,531,0.4806201550387597,35,40,100,90,55,35,355,0.1796875,4.0
55,75,60,75,60,103,428,0.7982456140350878,65,130,60,95,110,65,525,0.5303030303030303,1.0
80,145,150,105,110,110,700,0.8692307692307693,40,30,30,55,30,85,270,0.4666666666666667,0.5
114,85,70,85,80,30,464,0.2066115702479339,50,65,107,105,107,86,520,0.703125,1.0
66,65,48,62,57,52,350,0.36220472440944884,71,120,95,120,95,99,600,0.8203125,0.25
78,104,78,159,115,100,634,0.8444444444444444,60,50,70,50,90,65,385,0.39568345323741005,4.0
45,40,60,40,75,50,310,0.2926829268292683,40,30,35,45,40,55,245,0.31496062992125984,1.0
40,45,35,30,40,55,245,0.3793103448275862,75,75,60,83,60,60,413,0.39344262295081966,1.0
55,68,64,45,55,31,318,0.11666666666666667,55,95,55,35,75,115,430,0.9380530973451328,1.0
80,110,120,130,90,70,600,0.6198347107438017,60,48,45,43,90,42,328,0.21897810218978103,1.0
150,80,44,90,54,80,498,0.625,90,120,100,150,120,100,680,0.7718120805369127,1.0
80,100,123,122,120,80,625,0.56,55,35,50,55,110,85,390,0.6277372262773723,0.25
49,49,56,49,61,66,330,0.5190839694656488,80,125,75,40,95,85,500,0.6911764705882353,1.0
70,55,55,80,60,45,365,0.2222222222222222,40,65,95,60,45,35,340,0.13986013986013987,1.0
50,65,85,35,35,55,325,0.32575757575757575,50,95,90,95,90,180,600,0.9172413793103448,2.0
56,61,65,48,45,38,313,0.17567567567567569,60,65,80,170,95,130,600,0.8625954198473282,0.5
75,100,63,80,63,116,497,0.9345794392523364,70,55,75,45,65,60,370,0.45901639344262296,2.0
65,90,40,45,80,75,395,0.625,60,62,80,63,80,60,405,0.4336283185840708,4.0
45,40,60,40,75,50,310,0.2926829268292683,80,110,120,130,90,70,600,0.6198347107438017,1.0
75,65,55,65,55,69,384,0.43548387096774194,73,76,75,81,100,100,505,0.8110236220472441,4.0
64,51,23,51,23,28,240,0.11363636363636363,76,65,45,92,42,91,411,0.7449664429530202,1.0
100,77,77,128,128,90,600,0.6901408450704225,90,120,100,150,120,100,680,0.7718120805369127,1.0
70,80,70,80,70,110,480,0.6594202898550725,150,120,100,120,100,90,680,0.664179104477612,4.0
45,60,30,80,50,65,330,0.4603174603174603,85,105,85,40,50,40,405,0.211864406779661,0.5
90,93,55,70,55,55,418,0.3819444444444444,80,70,70,90,100,70,480,0.5609756097560976,1.0
50,50,120,80,80,30,410,0.07258064516129033,50,65,107,105,107,86,520,0.6991150442477876,1.0
71,73,88,120,89,59,500,0.43537414965986393,75,100,95,40,70,110,490,0.8717948717948718,1.0
58,70,45,40,45,42,300,0.25925925925925924,100,150,110,95,110,70,635,0.5923076923076923,1.0
45,40,60,40,75,50,310,0.2926829268292683,50,65,107,105,107,86,520,0.7758620689655172,0.5
58,50,145,95,105,30,483,0.2459016393442623,79,85,60,55,60,71,410,0.60431654676259,0.0
80,120,79,95,79,70,523,0.5833333333333334,70,130,100,55,80,65,500,0.608,1.0
45,65,34,40,34,45,263,0.2589928057553957,60,85,42,85,42,91,405,0.8227848101265823,2.0
49,49,56,49,61,66,330,0.5190839694656488,50,150,50,150,50,150,600,0.9339622641509434,1.0
50,35,55,25,25,15,205,0.021739130434782608,45,35,45,62,53,35,275,0.11851851851851852,2.0
50,50,120,80,80,30,410,0.07258064516129033,108,112,118,68,72,47,525,0.2916666666666667,0.5
45,90,20,65,20,65,305,0.5116279069767442,60,50,40,85,75,95,405,0.7540983606557377,1.0
60,105,60,120,60,105,510,0.8849557522123894,55,35,50,55,110,85,390,0.6277372262773723,1.0
78,65,68,112,154,75,552,0.628099173553719,83,80,75,70,70,101,479,0.8615384615384616,1.0
61,90,45,50,50,160,456,0.9230769230769231,55,70,45,70,50,60,350,0.45,0.5
80,120,130,55,65,45,495,0.37037037037037035,90,70,80,70,95,70,475,0.5190839694656488,2.0
74,108,133,83,65,32,495,0.32142857142857145,55,75,85,25,25,15,280,0.1875,2.0
75,69,72,114,100,104,534,0.8253968253968254,58,89,77,45,45,48,362,0.3177570093457944,0.25
55,45,50,45,65,80,340,0.5546218487394958,55,75,50,40,40,80,340,0.6302521008403361,0.5
55,70,45,70,50,60,350,0.45,75,38,38,56,56,67,330,0.5263157894736842,0.5
40,50,45,70,45,70,320,0.5517241379310345,60,25,35,70,80,60,330,0.3076923076923077,0.5
60,50,100,85,70,65,430,0.47580645161290325,70,55,95,95,110,65,490,0.48872180451127817,1.0
38,35,40,27,25,35,200,0.08208955223880597,50,92,108,92,108,35,485,0.2457627118644068,1.0
70,100,115,30,65,30,410,0.24390243902439024,85,120,70,50,60,100,485,0.8308823529411765,2.0
75,65,55,65,55,69,384,0.43548387096774194,35,35,40,35,55,50,250,0.40336134453781514,0.0
58,64,58,80,65,80,405,0.5423728813559322,67,82,62,46,48,43,348,0.22033898305084745,1.0
68,165,95,65,115,110,618,0.8615384615384616,80,110,60,150,130,70,600,0.5042016806722689,0.0
70,90,90,135,90,125,600,0.9401709401709402,50,105,125,55,95,50,480,0.375886524822695,0.5
45,25,50,25,25,35,205,0.13076923076923078,65,130,60,95,110,65,525,0.5303030303030303,0.5
45,25,50,25,25,35,205,0.13076923076923078,78,52,60,63,65,23,341,0.06015037593984962,1.0
50,100,150,100,150,50,600,0.37142857142857144,45,30,15,85,65,65,305,0.36220472440944884,2.0
65,76,84,54,96,105,480,0.9008264462809917,40,65,95,60,45,35,340,0.13986013986013987,1.0
50,85,55,65,65,90,410,0.7478260869565218,76,104,71,104,71,108,534,0.912751677852349,0.5
105,140,95,55,65,45,505,0.3,110,80,90,95,90,65,530,0.5033557046979866,2.0
75,95,60,65,60,115,470,0.8778625954198473,90,95,95,70,90,70,510,0.5230769230769231,1.0
80,185,115,40,105,75,600,0.6230769230769231,49,55,42,42,37,85,310,0.6068376068376068,2.0
65,75,90,97,123,44,494,0.1987179487179487,76,147,90,60,70,97,540,0.8267716535433071,2.0
30,105,90,25,25,50,325,0.2773722627737226,68,75,53,83,113,60,452,0.45384615384615384,0.5
50,64,50,45,50,41,300,0.22727272727272727,100,123,75,57,75,80,510,0.6923076923076923,0.0
100,75,115,90,115,85,580,0.6446280991735537,95,75,80,100,110,30,490,0.24242424242424243,0.5
45,50,35,55,75,40,300,0.21367521367521367,100,50,80,60,80,50,420,0.34375,0.0
55,50,45,135,95,120,500,0.7714285714285715,50,75,35,70,30,40,300,0.21296296296296297,2.0
80,82,78,95,80,85,500,0.6869565217391305,100,150,140,100,90,90,670,0.7969924812030075,2.0
65,130,60,95,110,65,525,0.5303030303030303,100,5,5,15,65,30,220,0.07692307692307693,1.0
85,110,76,65,82,56,474,0.3933333333333333,52,65,50,45,50,38,300,0.27419354838709675,0.25
55,75,85,25,25,15,280,0.1875,71,120,95,120,95,99,600,0.8203125,1.0
65,90,120,85,70,60,490,0.43410852713178294,86,92,88,68,75,73,482,0.6835443037974683,1.0
40,29,45,29,45,36,224,0.14634146341463414,85,105,55,85,50,115,495,0.9032258064516129,1.0
50,53,48,53,48,64,316,0.358974358974359,165,75,80,40,45,65,470,0.5151515151515151,0.5
40,55,70,45,60,30,300,0.10619469026548672,55,112,45,74,45,70,401,0.559322033898305,2.0
80,80,50,40,50,25,325,0.176056338028169,90,90,85,125,90,100,580,0.768595041322314,1.0
75,38,38,56,56,67,330,0.5263157894736842,101,72,72,99,89,29,462,0.1937984496124031,1.0
61,84,65,70,70,70,420,0.5,52,65,50,45,50,38,300,0.27419354838709675,2.0
89,125,90,115,80,101,600,0.8725490196078431,45,50,45,115,55,95,405,0.6936936936936937,2.0
85,73,70,73,115,67,483,0.5126050420168067,50,50,50,50,50,50,300,0.30708661417322836,1.0
40,45,40,35,35,56,251,0.373015873015873,45,49,49,65,65,45,318,0.2781954887218045,2.0
100,128,90,77,77,128,600,0.959349593495935,44,58,44,58,44,61,309,0.41964285714285715,1.0
65,105,60,60,70,95,455,63.0,99,68,83,72,87,51,460,0.417910447761194,0.5
83,106,65,86,65,85,490,0.6640625,40,50,90,30,55,65,330,0.44680851063829785,0.125
45,30,40,105,50,20,290,0.031007751937984496,88,107,122,74,75,64,530,0.4596774193548387,1.0
50,50,62,40,62,65,329,0.4188034188034188,41,56,40,62,44,71,314,0.568,1.0
45,90,20,65,20,65,305,0.5116279069767442,80,95,82,60,82,75,474,0.6,1.0
79,85,60,55,60,71,410,0.60431654676259,65,40,50,125,60,30,370,0.07258064516129033,1.0
35,35,40,35,55,50,250,0.40336134453781514,105,130,120,45,45,40,485,0.4444444444444444,2.0
60,60,60,35,35,30,280,0.11194029850746269,60,90,70,60,120,40,440,0.27419354838709675,1.0
80,95,82,60,82,75,474,0.6,55,84,105,114,75,52,485,0.2890625,1.0
105,125,100,60,100,100,590,0.8359375,70,110,75,145,85,145,630,0.9444444444444444,1.0
40,30,30,55,30,85,270,0.4666666666666667,65,63,45,45,45,45,308,0.2595419847328244,2.0
60,70,105,70,120,75,500,0.5983606557377049,46,57,40,40,40,50,273,0.25,4.0
66,117,70,40,50,67,410,0.4573643410852713,28,25,25,45,35,40,198,0.16083916083916083,0.0
55,55,55,85,55,30,335,0.1320754716981132,70,84,70,65,70,51,410,0.2949640287769784,2.0
75,90,140,60,60,40,465,0.3008130081300813,31,45,90,30,30,40,266,0.21929824561403508,1.0
80,70,65,80,120,100,515,0.8034188034188035,50,65,85,35,35,55,325,0.32575757575757575,1.0
51,65,65,80,75,59,395,0.4365079365079365,80,145,150,105,110,110,700,0.8692307692307693,0.5
60,75,85,100,85,115,520,0.8992248062015504,50,20,55,25,25,30,205,0.09774436090225563,1.0
71,95,85,110,95,79,535,0.664,60,60,75,60,75,80,410,0.7321428571428571,1.0
50,85,55,65,65,90,410,0.7478260869565218,115,115,85,90,75,100,580,0.8134328358208955,0.5
65,45,55,45,70,45,325,0.24369747899159663,54,66,70,44,55,46,335,0.4214876033057851,0.5
41,56,40,62,44,71,314,0.568,40,55,80,35,60,30,300,0.15037593984962405,1.0
135,85,40,40,85,5,390,0.6864406779661016,75,103,80,70,80,92,500,0.7933884297520661,1.0
90,130,80,65,85,55,505,0.4396551724137931,80,110,60,150,130,70,600,0.5042016806722689,0.0
70,60,70,87,78,85,450,0.6228070175438597,65,110,130,60,65,95,525,0.8278145695364238,0.5
60,50,100,85,70,65,430,0.47580645161290325,70,84,70,65,70,51,410,0.2949640287769784,2.0
75,98,63,98,63,101,498,0.849624060150376,91,90,106,130,106,77,600,0.648854961832061,2.0
60,85,42,85,42,91,405,0.8227848101265823,76,25,45,67,55,24,292,0.0390625,2.0
90,70,80,70,95,70,475,0.5190839694656488,40,45,40,35,35,56,251,0.373015873015873,2.0
75,89,85,55,65,36,405,0.29545454545454547,91,90,72,90,129,108,580,0.896,0.5
90,95,95,70,90,70,510,0.5230769230769231,50,60,45,100,80,65,400,0.45689655172413796,0.25
250,5,5,35,105,50,450,0.15306122448979592,65,105,60,60,70,95,455,63.0,1.0
63,63,47,41,41,74,329,0.56,60,50,70,50,90,65,385,0.39568345323741005,0.5
60,65,80,170,95,130,600,0.8625954198473282,100,50,80,60,80,50,420,0.34375,2.0
90,60,60,40,40,40,330,0.29545454545454547,25,35,70,95,55,45,325,0.16783216783216784,4.0
60,65,70,85,75,40,395,0.21705426356589147,59,110,150,45,49,35,448,0.3333333333333333,0.0
50,53,48,53,48,64,316,0.4076923076923077,90,75,75,90,100,70,500,0.5462184873949579,2.0
65,65,60,110,95,130,525,0.9253731343283582,90,93,55,70,55,55,418,0.3819444444444444,1.0
106,190,100,154,100,130,780,0.9259259259259259,50,70,160,70,160,90,600,0.7417218543046358,0.25
65,75,105,35,65,85,430,0.6940298507462687,44,50,91,24,86,10,305,0.1981981981981982,1.0
100,90,130,45,65,55,485,0.4253731343283582,60,100,85,80,85,100,510,0.7007874015748031,0.5
70,80,102,80,102,40,474,0.2677165354330709,80,90,80,130,110,110,600,0.856,2.0
81,102,77,85,75,85,505,0.5642857142857143,60,60,75,60,75,80,410,0.7321428571428571,1.0
86,81,97,81,107,43,495,0.203125,126,131,95,131,98,99,680,0.8102189781021898,1.0
60,59,85,79,105,36,424,0.16666666666666666,110,135,60,50,65,88,508,0.7744360902255639,0.5
79,85,60,55,60,71,410,0.60431654676259,65,85,70,75,70,40,405,0.203125,1.0
110,78,73,76,71,60,468,0.3333333333333333,45,60,32,50,32,76,295,0.5925925925925926,2.0
40,40,40,70,40,20,250,0.032520325203252036,40,70,40,35,40,60,285,0.392,1.0
80,70,65,80,120,100,515,0.8034188034188035,70,62,67,55,55,56,365,0.38513513513513514,0.5
80,80,50,40,50,25,325,0.176056338028169,80,100,70,60,70,95,475,0.7416666666666667,2.0
75,65,55,65,55,69,384,0.43548387096774194,53,51,53,61,56,40,314,0.14285714285714285,0.5
40,27,60,37,50,66,280,0.36220472440944884,67,125,40,30,30,58,350,0.3431372549019608,2.0
25,35,70,95,55,45,325,0.16783216783216784,48,61,40,61,40,50,300,0.2543859649122807,1.0
50,70,50,50,50,70,340,0.5645161290322581,78,84,78,109,85,100,534,0.8646616541353384,0.0
89,125,90,115,80,101,600,0.8725490196078431,85,80,70,135,75,90,535,0.7006802721088435,1.0
75,80,55,25,35,35,305,0.18666666666666668,68,85,65,165,135,100,618,0.8083333333333333,0.25
50,105,79,35,110,76,455,0.6214285714285714,70,95,125,65,75,45,475,0.33613445378151263,1.0
50,48,43,46,41,60,288,0.47297297297297297,65,85,70,75,70,40,405,0.203125,2.0
50,35,55,25,25,15,205,0.05263157894736842,45,60,40,70,50,45,310,0.2846715328467153,0.5
84,86,88,111,101,60,530,0.4634146341463415,65,95,75,55,55,85,430,0.6933333333333334,0.25
90,95,105,165,110,45,610,0.2890625,64,66,68,81,76,50,405,0.25190839694656486,2.0
80,105,105,105,105,80,580,0.5939849624060151,70,120,65,45,85,125,510,0.9747899159663865,0.0
70,145,88,140,70,112,625,0.8888888888888888,40,40,35,50,100,70,335,0.5031847133757962,0.25
100,100,100,100,100,100,600,0.8805970149253731,65,130,60,75,60,75,465,0.689922480620155,1.0
126,131,95,131,98,99,680,0.8102189781021898,65,90,122,58,75,84,494,0.71875,4.0
71,95,85,110,95,79,535,0.664,40,40,35,50,100,70,335,0.5031847133757962,0.5
106,190,100,154,100,130,780,0.9259259259259259,50,50,62,40,62,65,329,0.4188034188034188,1.0
74,94,131,54,116,20,489,0.4485294117647059,35,85,45,35,35,75,310,0.6492537313432836,0.5
86,76,86,116,56,95,515,0.7982456140350878,85,73,70,73,115,67,483,0.5126050420168067,2.0
150,80,44,90,54,80,498,0.625,50,65,107,105,107,86,520,0.703125,0.5
95,110,95,40,95,55,490,0.40336134453781514,50,105,125,55,95,50,480,0.375886524822695,0.5
90,30,15,40,20,15,210,0.043478260869565216,80,70,40,100,60,145,495,0.921875,1.0
58,50,145,95,105,30,483,0.2459016393442623,72,60,30,20,30,25,237,0.11570247933884298,1.0
100,50,50,76,96,70,442,0.5,105,140,95,55,65,45,505,0.3,2.0
81,102,77,85,75,85,505,0.5642857142857143,76,147,90,60,70,97,540,0.8267716535433071,1.0
55,104,105,94,75,52,485,0.36363636363636365,50,95,180,85,45,70,525,0.5298507462686567,0.5
55,40,40,65,45,35,280,0.16428571428571428,40,45,35,30,40,55,245,0.3793103448275862,2.0
60,105,60,120,60,105,510,0.8849557522123894,60,60,60,60,60,60,360,0.38095238095238093,1.0
85,97,66,105,66,65,484,0.47107438016528924,70,65,65,55,55,70,380,0.5,1.0
70,60,75,110,75,90,480,0.7165354330708661,100,70,70,65,65,45,415,0.1897810218978102,1.0
110,85,95,80,95,50,515,0.2713178294573643,85,80,70,135,75,90,535,0.7006802721088435,1.0
160,110,65,65,110,30,540,0.35714285714285715,73,76,75,81,100,100,505,0.8110236220472441,1.0
83,80,75,70,70,101,479,0.8615384615384616,55,66,44,44,56,85,350,0.6888888888888889,1.0
80,92,65,65,80,68,450,0.4824561403508772,70,94,50,94,50,66,424,0.48148148148148145,1.0
115,140,130,55,55,40,535,0.4519230769230769,61,90,45,50,50,160,456,0.9230769230769231,0.0
77,59,50,67,63,46,362,0.23140495867768596,55,95,115,45,45,35,390,0.2116788321167883,1.0
75,100,110,45,55,65,450,0.5333333333333333,90,120,75,60,60,45,450,0.29411764705882354,1.0
70,80,50,35,35,35,305,0.14,50,53,48,53,48,64,316,0.4076923076923077,1.0
80,135,85,70,95,150,615,0.9844961240310077,50,65,90,35,35,15,290,0.14678899082568808,4.0
78,84,78,109,85,100,534,0.8646616541353384,52,65,55,58,62,60,352,0.4482758620689655,1.0
80,70,40,100,60,145,495,0.921875,70,55,95,95,110,65,490,0.48872180451127817,2.0
60,80,95,70,85,50,440,0.2231404958677686,77,85,51,55,51,65,384,0.5163934426229508,1.0
45,49,49,65,65,45,318,0.2781954887218045,65,60,110,130,95,65,525,0.47761194029850745,1.0
45,60,45,25,45,55,275,0.29,70,60,62,80,82,60,414,0.4375,1.0
55,55,50,45,65,55,325,0.37373737373737376,70,110,180,60,60,50,530,0.4117647058823529,0.25
70,150,140,65,100,75,600,0.55,75,75,55,105,85,30,425,0.1619718309859155,2.0
75,89,85,55,65,36,405,0.29545454545454547,100,100,100,100,100,100,600,0.8778625954198473,0.5
70,60,62,80,82,60,414,0.4375,95,124,78,69,71,58,495,0.37398373983739835,2.0
70,105,105,50,40,20,390,0.33587786259541985,50,20,40,20,40,20,190,0.0962962962962963,1.0
60,60,75,60,75,80,410,0.7321428571428571,100,70,70,65,65,45,415,0.1897810218978102,2.0
45,25,50,25,25,35,205,0.13076923076923078,90,100,90,125,85,90,580,0.7352941176470589,0.25
30,30,30,30,30,30,180,0.12612612612612611,100,120,120,150,100,90,680,0.7880794701986755,0.25
70,80,70,80,70,110,480,0.6594202898550725,97,165,60,65,50,58,495,0.3902439024390244,1.0
61,78,95,56,58,57,405,0.40336134453781514,80,110,120,130,90,70,600,0.6198347107438017,1.0
135,85,40,40,85,5,390,0.6864406779661016,65,73,55,47,75,85,400,0.6846846846846847,1.0
60,70,50,100,50,65,395,0.5217391304347826,75,38,38,56,56,67,330,0.5263157894736842,0.5
110,65,105,55,95,80,510,0.6258503401360545,50,70,100,40,40,30,330,0.2222222222222222,0.25
80,82,83,100,100,80,525,0.6742424242424242,60,80,95,70,85,50,440,0.2231404958677686,0.0
60,55,145,75,150,40,525,0.2,72,105,115,54,86,68,500,0.5149253731343284,1.0
84,86,88,111,101,60,530,0.4634146341463415,100,50,50,76,96,70,442,0.5,1.0
50,47,50,57,50,65,319,0.463768115942029,70,60,62,80,82,60,414,0.4375,1.0
45,67,60,35,50,63,320,0.5128205128205128,50,70,100,40,40,30,330,0.2222222222222222,2.0
45,55,39,35,39,42,255,0.18518518518518517,70,60,75,110,75,90,480,0.7165354330708661,1.0
50,85,85,55,55,50,380,0.3902439024390244,90,85,75,115,100,115,580,0.9381443298969072,0.5
40,30,35,50,70,55,280,0.28205128205128205,45,30,50,65,50,45,285,0.13821138211382114,1.0
50,70,50,50,50,40,310,0.16296296296296298,90,120,120,60,60,50,500,0.35294117647058826,2.0
60,150,50,150,50,60,520,0.5,64,115,65,83,63,65,455,0.5323741007194245,2.0
75,75,130,75,130,95,580,0.7479674796747967,55,112,45,74,45,70,401,0.559322033898305,1.0
35,55,40,50,50,90,320,0.6838235294117647,50,50,150,50,150,50,500,0.2571428571428571,1.0
105,105,75,65,100,50,500,0.37593984962406013,100,5,5,15,65,30,220,0.07692307692307693,1.0
40,80,100,30,30,20,300,0.11851851851851852,100,134,110,95,100,61,600,0.4057971014492754,2.0
106,90,130,90,154,110,680,0.8699186991869918,35,60,44,40,54,55,288,0.366412213740458,2.0
60,40,80,60,45,40,325,0.23529411764705882,65,75,105,35,65,85,430,0.6940298507462687,2.0
100,50,80,60,80,50,420,0.34375,70,83,50,37,50,60,350,0.3360655737704918,1.0
85,56,77,50,77,78,423,0.53125,50,72,35,35,35,65,292,0.5373134328358209,1.0
60,50,70,80,80,140,480,0.8449612403100775,90,95,105,165,110,45,610,0.2890625,0.25
75,80,70,65,75,90,455,0.7578125,50,120,53,35,110,87,455,0.640625,2.0
105,150,90,150,90,95,680,0.8285714285714286,75,90,50,110,80,95,500,0.7985611510791367,1.0
65,55,115,100,40,60,435,0.3798449612403101,90,132,105,132,105,30,594,0.4246575342465753,0.5
75,100,63,80,63,116,497,0.9345794392523364,55,35,50,55,110,85,390,0.6277372262773723,2.0
40,55,30,30,30,60,245,0.43548387096774194,60,130,80,60,60,70,460,0.5153846153846153,4.0
45,20,50,60,120,50,345,0.24074074074074073,70,20,50,20,50,40,250,0.1557377049180328,0.5
90,90,85,125,90,100,580,0.768595041322314,74,48,76,83,81,104,466,0.7322834645669292,1.0
105,30,105,140,105,55,540,0.3524590163934426,40,30,30,55,30,85,270,0.4666666666666667,0.5
60,60,60,35,35,30,280,0.11194029850746269,70,60,125,115,70,55,495,0.35507246376811596,0.5
106,150,70,194,120,140,780,0.952,40,30,35,45,40,55,245,0.31496062992125984,1.0
60,85,69,60,69,77,420,0.518796992481203,30,40,55,40,55,60,280,0.3237410071942446,1.0
78,92,75,74,63,118,500,0.8842975206611571,125,120,90,170,100,95,700,0.78125,2.0
60,70,105,70,120,75,500,0.5983606557377049,60,30,30,36,56,50,262,0.32432432432432434,0.0
70,94,50,94,50,66,424,0.48148148148148145,50,72,35,35,35,65,292,0.5373134328358209,2.0
65,65,60,130,95,110,525,0.823943661971831,54,78,103,53,45,22,355,0.23255813953488372,1.0
65,80,80,59,63,58,405,0.4411764705882353,45,20,50,60,120,50,345,0.24074074074074073,0.5
100,103,75,120,75,127,600,0.940677966101695,190,33,58,33,58,33,405,0.13432835820895522,1.0
73,76,75,81,100,100,505,0.8110236220472441,45,22,60,27,30,29,213,0.07518796992481203,2.0
50,64,50,45,50,41,300,0.22727272727272727,65,55,115,100,40,60,435,0.3798449612403101,0.5
50,95,90,95,90,180,600,0.9172413793103448,75,98,63,98,63,101,498,0.889763779527559,1.0
90,92,87,75,85,76,505,0.5409836065573771,80,70,40,100,60,145,495,0.921875,0.5
60,50,40,85,75,95,405,0.7540983606557377,44,58,44,58,44,61,309,0.41964285714285715,1.0
109,66,84,81,99,32,471,0.2013888888888889,61,78,95,56,58,57,405,0.40336134453781514,0.25
60,80,50,40,40,30,300,0.15328467153284672,70,150,140,65,100,75,600,0.55,0.5
80,82,78,95,80,85,500,0.6869565217391305,54,66,70,44,55,46,335,0.4214876033057851,0.5
55,50,45,135,95,120,500,0.7714285714285715,75,125,100,70,80,45,495,0.33035714285714285,1.0
50,100,150,100,150,50,600,0.37142857142857144,55,50,40,40,40,75,300,0.5945945945945946,1.0
100,100,100,100,100,100,600,0.8758169934640523,80,120,70,110,70,80,530,0.6422764227642277,0.5
60,50,70,50,90,65,385,0.39568345323741005,85,97,66,105,66,65,484,0.47107438016528924,0.5
55,47,52,40,40,41,275,0.16806722689075632,95,117,80,65,70,92,519,0.8409090909090909,0.5
86,92,88,68,75,73,482,0.6835443037974683,75,100,95,40,70,110,490,0.8717948717948718,1.0
70,77,60,97,60,108,472,0.8394160583941606,70,65,65,55,55,70,380,0.5,1.0
75,125,230,55,95,30,610,0.3448275862068966,60,50,100,85,70,65,430,0.47580645161290325,0.0
35,55,40,50,50,90,320,0.6838235294117647,50,65,107,105,107,86,520,0.7272727272727273,1.0
36,50,50,65,60,44,305,0.16363636363636364,45,35,50,70,50,30,280,0.15753424657534246,2.0
55,50,65,175,95,150,590,0.7818181818181819,75,123,67,95,85,95,540,0.7642276422764228,1.0
75,89,85,55,65,36,405,0.29545454545454547,190,33,58,33,58,33,405,0.13432835820895522,1.0
90,75,75,90,100,70,500,0.5462184873949579,70,110,75,145,85,145,630,0.9444444444444444,0.25
57,24,86,24,86,23,300,0.12727272727272726,90,60,70,75,70,45,410,0.23880597014925373,1.0
40,45,35,65,55,70,310,0.4482758620689655,55,95,115,45,45,35,390,0.2116788321167883,4.0
85,135,130,60,80,25,515,0.40540540540540543,115,140,130,55,55,40,535,0.4519230769230769,0.5
125,170,100,120,90,95,700,0.77,106,130,90,110,154,90,680,0.719626168224299,1.0
55,75,85,25,25,15,280,0.1875,45,49,65,49,65,45,318,0.275,1.0
30,105,90,25,25,50,325,0.2773722627737226,103,60,86,60,86,50,445,0.3458646616541353,1.0
67,58,57,81,67,101,431,0.8790322580645161,60,90,55,90,80,110,485,0.8677685950413223,0.5
150,80,44,90,54,80,498,0.625,46,57,40,40,40,50,273,0.25,1.0
35,55,40,50,50,90,320,0.6838235294117647,70,60,125,115,70,55,495,0.35507246376811596,2.0
80,82,100,83,100,80,525,0.6821705426356589,30,45,59,30,39,57,260,0.2803030303030303,0.25
68,65,65,125,115,80,518,0.6461538461538462,61,72,57,55,55,65,365,0.3984375,1.0
111,83,68,92,82,39,475,0.1774193548387097,65,136,94,54,96,135,580,0.9612403100775194,1.0
50,92,108,92,108,35,485,0.2457627118644068,20,15,20,10,55,80,200,0.2682926829268293,1.0
95,110,80,70,80,50,485,0.37209302325581395,255,10,10,75,135,55,540,0.3125,1.0
73,95,62,85,65,85,465,0.6666666666666666,70,60,70,87,78,85,450,0.6228070175438597,1.0
50,72,35,35,35,65,292,0.5373134328358209,67,89,116,79,116,33,500,0.2624113475177305,4.0
91,129,90,72,90,108,580,0.8536585365853658,53,54,53,37,46,45,288,0.3090909090909091,1.0
40,70,130,60,130,25,455,0.17355371900826447,120,120,120,120,120,120,720,0.9344262295081968,0.0
70,85,140,85,70,20,470,0.272,43,70,48,50,60,38,309,0.2391304347826087,2.0
65,45,55,45,70,45,325,0.24369747899159663,45,55,39,35,39,42,255,0.18518518518518517,1.0
45,50,55,75,65,30,320,0.06293706293706294,70,90,90,135,90,125,600,0.9401709401709402,1.0
70,80,102,80,102,40,474,0.2677165354330709,60,150,50,150,50,60,520,0.5,0.125
60,50,70,50,90,65,385,0.39568345323741005,60,85,40,30,45,68,328,0.6422018348623854,0.5
72,95,67,103,71,122,530,0.9606299212598425,65,150,60,115,60,115,565,0.935251798561151,0.5
62,48,54,63,60,68,355,0.5178571428571429,90,120,120,60,60,50,500,0.35294117647058826,2.0
62,48,66,59,57,49,341,0.33884297520661155,50,80,95,10,45,10,290,0.232,1.0
60,100,85,80,85,100,510,0.7007874015748031,65,65,45,75,45,95,390,0.72,0.25
45,35,45,62,53,35,275,0.11851851851851852,85,76,64,45,55,90,415,0.6739130434782609,1.0
75,95,60,65,60,115,470,0.8778625954198473,50,85,40,85,40,35,335,0.1746031746031746,1.0
65,45,55,45,70,45,325,0.24369747899159663,123,77,72,99,92,58,521,0.4621212121212121,2.0
70,90,90,135,90,125,600,0.9401709401709402,45,67,60,35,50,63,320,0.5128205128205128,1.0
80,70,65,80,120,100,515,0.8034188034188035,65,85,70,75,70,40,405,0.203125,1.0
50,105,79,35,110,76,455,0.6214285714285714,80,185,115,40,105,75,600,0.6230769230769231,0.5
59,63,80,65,80,58,405,0.41843971631205673,70,135,105,60,105,20,495,0.5806451612903226,1.0
100,110,90,85,90,60,535,0.47794117647058826,70,110,75,145,85,145,630,0.9444444444444444,0.125
63,60,55,50,50,71,349,0.5289256198347108,100,180,160,150,90,90,770,0.7520661157024794,1.0
66,117,70,40,50,67,410,0.4573643410852713,45,75,37,70,55,83,365,0.6183206106870229,1.0
81,102,77,85,75,85,505,0.5642857142857143,65,95,75,55,55,85,430,0.6933333333333334,1.0
50,75,45,40,45,60,315,0.4380165289256198,100,120,100,150,120,90,680,0.728,0.5
50,60,45,100,80,65,400,0.45689655172413796,60,60,40,65,45,35,305,0.15833333333333333,0.5
59,45,40,35,40,31,250,0.14285714285714285,70,130,100,55,80,65,500,0.608,0.5
65,65,65,50,50,90,385,0.72,30,65,100,45,25,40,305,0.1891891891891892,0.5
60,110,70,60,60,100,460,0.8461538461538461,70,100,70,105,75,40,460,0.23214285714285715,1.0
38,36,38,32,36,57,237,0.3893805309734513,54,78,103,53,45,22,355,0.23255813953488372,0.5
84,86,88,111,101,60,530,0.4634146341463415,55,104,105,94,75,52,485,0.36363636363636365,0.25
126,131,95,131,98,99,680,0.8102189781021898,35,55,40,50,50,90,320,0.6838235294117647,0.5
50,150,50,150,50,150,600,0.9339622641509434,60,85,60,85,60,55,405,0.3673469387755102,1.0
50,85,55,65,65,90,410,0.7478260869565218,70,140,230,60,80,50,630,0.32432432432432434,2.0
65,110,130,60,65,95,525,0.8278145695364238,71,82,64,64,59,112,452,0.9327731092436975,1.0
50,48,43,46,41,60,288,0.47297297297297297,75,100,63,80,63,116,497,0.9345794392523364,2.0
95,100,85,108,70,70,528,0.5652173913043478,60,60,50,40,50,75,335,0.5882352941176471,0.5
45,50,45,115,55,95,405,0.6936936936936937,55,65,95,95,45,85,440,0.6610169491525424,1.0
74,108,133,83,65,32,495,0.32142857142857145,65,85,70,75,70,40,405,0.203125,1.0
80,115,80,65,55,93,488,0.7846153846153846,90,130,80,65,85,55,505,0.4396551724137931,2.0
50,60,60,60,60,30,320,0.11290322580645161,55,84,105,114,75,52,485,0.2890625,0.5
76,147,90,60,70,97,540,0.8267716535433071,64,115,65,83,63,65,455,0.5323741007194245,1.0
79,103,120,135,115,78,630,0.5763888888888888,50,85,85,55,55,50,380,0.3902439024390244,1.0
50,80,95,10,45,10,290,0.232,35,55,35,30,30,35,220,0.23684210526315788,1.0
54,45,47,75,98,52,371,0.39669421487603307,58,89,77,45,45,48,362,0.3177570093457944,2.0
100,103,75,120,75,127,600,0.940677966101695,70,65,60,90,75,90,450,0.6571428571428571,0.5
70,110,75,145,85,145,630,0.9444444444444444,45,75,37,70,55,83,365,0.6183206106870229,0.5
70,60,62,80,82,60,414,0.4375,30,45,55,70,55,85,340,0.5633802816901409,1.0
65,73,55,47,75,85,400,0.6846846846846847,56,61,65,48,45,38,313,0.17567567567567569,2.0
30,42,118,42,88,30,350,0.112,62,55,52,109,94,109,481,0.7833333333333333,0.5
110,65,75,125,85,30,490,0.15,45,50,35,55,75,40,300,0.21367521367521367,1.0
25,35,70,95,55,45,325,0.16783216783216784,65,60,70,85,75,40,395,0.1796875,1.0
50,53,48,53,48,64,316,0.4076923076923077,60,55,50,40,55,45,305,0.22377622377622378,0.25
100,50,50,76,96,70,442,0.5,48,72,48,72,48,48,336,0.25984251968503935,1.0
60,55,145,75,150,40,525,0.2,60,62,50,62,60,40,334,0.18181818181818182,4.0
116,55,85,107,95,29,487,0.06818181818181818,35,55,40,45,40,60,275,0.35714285714285715,1.0
160,110,65,65,110,30,540,0.35714285714285715,65,136,94,54,96,135,580,0.9612403100775194,1.0
100,150,140,100,90,90,670,0.7969924812030075,80,160,60,170,130,80,680,0.6180555555555556,1.0
85,70,80,97,80,123,535,0.9304347826086956,39,52,43,60,50,65,309,0.5041322314049587,1.0
60,85,49,60,49,60,363,0.4444444444444444,60,80,95,70,85,50,440,0.2231404958677686,1.0
70,84,70,65,70,51,410,0.2949640287769784,115,45,20,45,25,20,270,0.11538461538461539,1.0
45,80,100,35,37,28,325,0.3125,58,64,58,80,65,80,405,0.609271523178808,0.5
58,50,145,95,105,30,483,0.2459016393442623,95,145,130,120,90,120,700,0.9398496240601504,1.0
108,170,115,120,95,92,700,0.7083333333333334,101,72,72,99,89,29,462,0.1937984496124031,0.0
78,130,111,130,85,100,634,0.8561151079136691,74,48,76,83,81,104,466,0.7913043478260869,1.0
60,80,50,50,50,40,330,0.23853211009174313,109,66,84,81,99,32,471,0.2013888888888889,1.0
55,50,65,175,95,150,590,0.7818181818181819,40,40,55,40,70,55,300,0.40939597315436244,1.0
108,170,115,120,95,92,700,0.7083333333333334,70,20,50,20,50,40,250,0.1557377049180328,0.0
45,45,35,20,30,20,195,0.07246376811594203,60,115,105,65,70,80,495,0.7181818181818181,1.0
45,50,35,55,75,40,300,0.21367521367521367,55,63,90,50,80,42,380,0.21138211382113822,1.0
123,100,62,97,81,68,531,0.4806201550387597,45,20,50,60,120,50,345,0.24074074074074073,1.0
55,50,40,40,40,75,300,0.5945945945945946,76,65,45,92,42,91,411,0.7449664429530202,1.0
90,132,105,132,105,30,594,0.4246575342465753,59,110,150,45,49,35,448,0.3333333333333333,0.25
60,50,100,85,70,65,430,0.47580645161290325,41,50,37,50,37,66,281,0.5175438596491229,1.0
50,85,55,65,65,90,410,0.7478260869565218,60,85,69,60,69,77,420,0.518796992481203,1.0
42,52,67,39,56,50,306,0.2868217054263566,45,80,100,35,37,28,325,0.3125,0.5
50,85,125,85,115,20,480,0.4306569343065693,85,90,80,70,80,130,535,0.9262295081967213,1.0
89,125,90,115,80,101,600,0.8725490196078431,45,75,37,70,55,83,365,0.6183206106870229,2.0
60,50,70,80,80,140,480,0.8449612403100775,60,80,110,50,80,45,425,0.2833333333333333,0.0
68,75,53,83,113,60,452,0.45384615384615384,70,90,70,60,60,70,420,0.6390977443609023,1.0
150,80,44,90,54,80,498,0.625,55,68,64,45,55,31,318,0.11666666666666667,2.0
64,51,23,51,23,28,240,0.11363636363636363,70,50,30,95,135,105,485,0.8040540540540541,1.0
46,57,40,40,40,50,273,0.25,80,100,123,122,120,80,625,0.56,1.0
55,47,52,40,40,41,275,0.16806722689075632,65,150,60,115,60,115,565,0.935251798561151,1.0
58,64,58,80,65,80,405,0.609271523178808,90,60,70,75,70,45,410,0.23880597014925373,1.0
40,40,50,30,30,30,220,0.0873015873015873,50,65,107,105,107,86,520,0.7758620689655172,2.0
82,80,86,85,75,72,480,0.6183206106870229,65,80,140,40,70,70,465,0.5223880597014925,0.5
62,77,62,50,42,65,358,0.4838709677419355,45,85,70,40,40,60,340,0.5229357798165137,0.25
60,69,95,69,95,36,424,0.2608695652173913,55,50,65,175,95,150,590,0.7818181818181819,2.0
40,60,40,40,40,30,250,0.0948905109489051,45,75,60,40,30,50,300,0.304,1.0
65,76,84,54,96,105,480,0.9008264462809917,75,89,85,55,65,36,405,0.29545454545454547,1.0
50,25,28,45,55,15,218,0.0625,95,75,180,130,80,30,590,0.13793103448275862,1.0
30,42,118,42,88,30,350,0.112,65,125,60,95,60,105,510,0.9236641221374046,0.5
99,68,83,72,87,51,460,0.417910447761194,40,55,80,35,60,30,300,0.15037593984962405,0.25
70,115,60,115,60,55,475,0.4647887323943662,75,75,60,83,60,60,413,0.39344262295081966,2.0
50,65,90,35,35,15,290,0.14678899082568808,50,65,85,35,35,55,325,0.32575757575757575,1.0
50,75,35,70,30,40,300,0.21296296296296297,70,62,67,55,55,56,365,0.38513513513513514,0.25
77,85,51,55,51,65,384,0.5163934426229508,85,60,65,135,105,100,550,0.7518248175182481,0.5
110,130,80,70,60,80,530,0.5862068965517241,90,85,75,115,100,115,580,0.9381443298969072,2.0
50,50,120,80,80,30,410,0.07258064516129033,85,100,122,58,75,54,494,0.3939393939393939,2.0
74,108,133,83,65,32,495,0.32142857142857145,90,100,90,125,85,90,580,0.7352941176470589,8.0
70,70,115,130,90,60,535,0.5338983050847458,55,50,45,135,95,120,500,0.7714285714285715,1.0
90,90,85,125,90,100,580,0.768595041322314,45,65,34,40,34,45,263,0.2589928057553957,0.25
75,110,110,110,105,80,590,0.656934306569343,106,90,130,90,154,110,680,0.8699186991869918,1.0
80,75,150,75,150,50,580,0.30973451327433627,72,58,80,103,80,97,490,0.7171052631578947,1.0
64,165,75,93,83,75,555,0.6587301587301587,55,85,55,50,55,60,360,0.4233576642335766,1.0
70,92,65,80,55,98,460,0.8090909090909091,86,76,86,116,56,95,515,0.7982456140350878,1.0
79,115,70,125,80,111,580,0.8468468468468469,80,45,65,90,110,80,470,0.5462962962962963,1.0
55,85,122,58,75,99,494,0.8099173553719008,65,45,55,45,70,45,325,0.24369747899159663,2.0
70,100,70,105,75,40,460,0.23214285714285715,75,103,80,70,80,92,500,0.7933884297520661,1.0
70,85,65,105,85,120,530,0.9262295081967213,60,85,69,65,79,80,438,0.576,0.5
100,50,50,76,96,70,442,0.5,65,125,60,95,60,105,510,0.9236641221374046,2.0
58,64,58,80,65,80,405,0.609271523178808,55,130,115,50,50,75,475,0.5982142857142857,0.5
79,115,70,125,80,111,580,0.864,72,60,30,20,30,25,237,0.11570247933884298,2.0
55,50,65,175,95,150,590,0.7818181818181819,85,70,80,97,80,123,535,0.9304347826086956,1.0
50,20,55,25,25,30,205,0.09774436090225563,55,69,85,32,35,28,304,0.09302325581395349,1.0
105,140,55,30,55,95,480,0.8195488721804511,60,60,60,60,60,60,360,0.38095238095238093,1.0
60,50,150,50,150,60,520,0.5206611570247934,255,10,10,75,135,55,540,0.3125,0.0
100,150,90,180,160,90,770,0.7348484848484849,55,68,64,45,55,31,318,0.11666666666666667,0.5
89,124,80,55,80,55,483,0.5714285714285714,46,57,40,40,40,50,273,0.25,2.0
50,160,110,160,110,110,700,0.8854961832061069,70,80,50,35,35,35,305,0.14,1.0
65,47,55,73,75,85,400,0.65,50,50,62,40,62,65,329,0.4188034188034188,0.5
95,124,78,69,71,58,495,0.37398373983739835,55,50,40,40,40,75,300,0.5945945945945946,2.0
60,100,85,80,85,100,510,0.7007874015748031,45,30,50,65,50,45,285,0.13821138211382114,0.25
50,47,50,57,50,65,319,0.463768115942029,60,50,150,50,150,60,520,0.5206611570247934,0.25
100,150,140,100,90,90,670,0.7969924812030075,70,80,65,90,65,85,455,0.578125,1.0
50,85,55,65,65,90,410,0.7478260869565218,67,82,62,46,48,43,348,0.22033898305084745,1.0
70,90,45,15,45,50,315,0.3629032258064516,75,75,55,105,85,30,425,0.1619718309859155,2.0
58,50,145,95,105,30,483,0.2459016393442623,60,100,85,80,85,100,510,0.7007874015748031,2.0
90,50,34,60,44,70,348,0.6283185840707964,165,75,80,40,45,65,470,0.5151515151515151,1.0
75,90,90,140,90,115,600,0.9481481481481482,45,67,60,35,50,63,320,0.5128205128205128,0.5
60,62,80,63,80,60,405,0.4336283185840708,60,80,50,40,40,30,300,0.15328467153284672,1.0
40,70,40,35,40,60,285,0.392,95,135,80,110,80,100,600,0.8248175182481752,0.5
55,130,115,50,50,75,475,0.5982142857142857,65,80,80,59,63,58,405,0.4411764705882353,0.5
35,65,35,65,35,65,300,0.46621621621621623,70,80,50,35,35,35,305,0.14,1.0
130,85,80,85,95,60,535,0.43884892086330934,69,69,76,69,86,91,460,0.6554621848739496,0.25
126,131,95,131,98,99,680,0.8102189781021898,60,85,60,85,60,55,405,0.3673469387755102,1.0
68,165,95,65,115,110,618,0.8615384615384616,100,100,100,100,100,100,600,0.8778625954198473,0.25
50,65,64,44,48,43,314,0.2196969696969697,101,72,72,99,89,29,462,0.1937984496124031,1.0
95,145,130,120,90,120,700,0.9398496240601504,70,100,115,30,65,30,410,0.24390243902439024,0.5
70,43,53,43,53,40,302,0.19090909090909092,70,92,65,80,55,98,460,0.8090909090909091,1.0
65,125,100,60,70,70,490,0.6099290780141844,100,134,110,95,100,61,600,0.4057971014492754,1.0
86,68,72,109,66,106,507,0.8099173553719008,52,65,50,45,50,38,300,0.27419354838709675,0.5
70,105,105,50,40,20,390,0.33587786259541985,45,30,15,85,65,65,305,0.36220472440944884,2.0
55,45,45,25,25,15,210,0.048,59,110,150,45,49,35,448,0.3333333333333333,2.0
62,55,52,109,94,109,481,0.7833333333333333,55,50,45,135,95,120,500,0.7714285714285715,1.0
65,60,70,85,75,40,395,0.1796875,72,105,115,54,86,68,500,0.5149253731343284,0.5
50,55,50,36,30,43,264,0.2922077922077922,44,38,39,61,79,42,303,0.2251655629139073,1.0
65,60,110,130,95,65,525,0.47761194029850745,126,131,95,131,98,99,680,0.8102189781021898,2.0
51,65,65,80,75,59,395,0.4365079365079365,43,30,55,40,65,97,330,0.6030534351145038,0.5
60,67,85,77,75,116,480,0.8888888888888888,60,100,85,80,85,100,510,0.7007874015748031,2.0
50,65,64,44,48,43,314,0.2196969696969697,75,95,95,95,95,85,540,0.6470588235294118,0.25
95,75,80,100,110,30,490,0.24242424242424243,45,53,70,40,60,42,310,0.25735294117647056,0.5
45,65,34,40,34,45,263,0.2589928057553957,80,135,85,70,95,150,615,0.9844961240310077,2.0
60,60,60,85,85,85,435,0.631578947368421,80,120,79,95,79,70,523,0.5833333333333334,1.0
40,29,45,29,45,36,224,0.14634146341463414,50,40,85,40,65,25,305,0.08870967741935484,1.0
90,55,75,60,75,30,385,0.13970588235294118,50,72,35,35,35,65,292,0.5373134328358209,1.0
60,48,45,43,90,42,328,0.21897810218978103,45,53,70,40,60,42,310,0.25735294117647056,1.0
55,95,55,35,75,115,430,0.9380530973451328,85,105,85,40,50,40,405,0.211864406779661,0.5
108,100,121,81,95,95,600,0.7476635514018691,40,40,55,40,70,55,300,0.40939597315436244,1.0
70,65,65,55,55,70,380,0.5,50,65,107,105,107,86,520,0.703125,1.0
50,180,20,180,20,150,600,0.9029850746268657,55,66,44,44,56,85,350,0.6888888888888889,1.0
70,110,80,55,80,105,500,0.8794326241134752,50,55,50,36,30,43,264,0.2922077922077922,0.5
50,35,55,25,25,15,205,0.05263157894736842,60,40,60,40,60,35,295,0.18055555555555555,2.0
120,120,120,120,120,120,720,0.9344262295081968,50,47,50,57,50,65,319,0.463768115942029,1.0
85,97,66,105,66,65,484,0.47107438016528924,60,75,100,55,80,50,420,0.3088235294117647,2.0
90,92,87,75,85,76,505,0.5409836065573771,65,40,50,125,60,30,370,0.07258064516129033,1.0
55,63,90,50,80,42,380,0.21138211382113822,95,125,79,60,100,81,540,0.6165413533834586,0.5
49,49,56,49,61,66,330,0.5190839694656488,75,125,230,55,95,30,610,0.3448275862068966,2.0
50,65,64,44,48,43,314,0.2196969696969697,64,66,68,81,76,50,405,0.25190839694656486,0.5
55,104,105,94,75,52,485,0.36363636363636365,77,85,51,55,51,65,384,0.5163934426229508,1.0
45,30,35,20,20,45,195,0.14782608695652175,50,85,125,85,115,20,480,0.4306569343065693,1.0
65,83,57,95,85,105,490,0.8914728682170543,74,108,133,83,65,32,495,0.32142857142857145,2.0
70,115,60,115,60,55,475,0.4647887323943662,25,35,70,95,55,45,325,0.16783216783216784,0.5
80,92,65,65,80,68,450,0.4824561403508772,110,78,73,76,71,60,468,0.3333333333333333,1.0
60,45,70,45,90,95,405,0.7304964539007093,30,45,59,30,39,57,260,0.2803030303030303,1.0
65,125,60,95,60,105,510,0.9236641221374046,45,45,55,45,55,63,308,0.4594594594594595,1.0
30,105,90,25,25,50,325,0.2773722627737226,100,100,100,100,100,100,600,0.8758169934640523,1.0
45,30,15,85,65,65,305,0.36220472440944884,75,80,95,90,100,50,490,0.2158273381294964,2.0
90,85,75,115,100,115,580,0.9381443298969072,65,50,70,95,80,65,425,0.4262295081967213,1.0
72,105,115,54,86,68,500,0.5149253731343284,68,75,53,83,113,60,452,0.45384615384615384,0.5
110,123,65,100,65,65,528,0.5217391304347826,86,81,97,81,107,43,495,0.203125,2.0
62,44,50,44,50,55,305,0.3629032258064516,70,40,50,55,50,25,290,0.061068702290076333,0.5
55,35,50,55,110,85,390,0.6277372262773723,61,90,45,50,50,160,456,0.9230769230769231,1.0
60,67,85,77,75,116,480,0.8888888888888888,70,140,70,110,65,105,560,0.95,4.0
52,65,50,45,50,38,300,0.27419354838709675,75,103,80,70,80,92,500,0.7933884297520661,1.0
55,95,55,35,75,115,430,0.9380530973451328,60,50,70,80,80,140,480,0.8449612403100775,1.0
50,50,150,50,150,50,500,0.2571428571428571,55,65,95,95,45,85,440,0.6610169491525424,1.0
50,52,48,65,50,55,320,0.33098591549295775,55,55,50,45,65,55,325,0.37373737373737376,1.0
35,20,65,40,65,20,245,0.02459016393442623,62,48,66,59,57,49,341,0.33884297520661155,1.0
103,60,126,80,126,50,545,0.36363636363636365,95,100,85,108,70,70,528,0.5652173913043478,1.0
58,70,45,40,45,42,300,0.25925925925925924,45,30,50,55,65,45,290,0.208,1.0
75,95,60,65,60,115,470,0.8778625954198473,79,115,70,125,80,111,580,0.8468468468468469,1.0
99,68,83,72,87,51,460,0.417910447761194,50,64,50,45,50,41,300,0.22727272727272727,2.0
100,100,100,100,100,100,600,0.831858407079646,106,130,90,110,154,90,680,0.719626168224299,1.0
40,55,30,30,30,85,270,0.688,61,72,57,55,55,65,365,0.3984375,1.0
55,66,44,44,56,85,350,0.6888888888888889,78,92,75,74,63,118,500,0.8842975206611571,1.0
75,55,70,55,95,110,460,0.8444444444444444,55,50,45,135,95,120,500,0.7714285714285715,1.0
60,52,168,47,138,30,495,0.19834710743801653,67,89,116,79,116,33,500,0.2624113475177305,0.25
100,90,130,45,65,55,485,0.4253731343283582,80,115,80,65,55,93,488,0.7846153846153846,2.0
90,92,75,92,85,60,494,0.49586776859504134,78,130,111,130,85,100,634,0.8561151079136691,0.25
75,125,70,125,70,115,580,0.9037037037037037,50,95,95,35,110,70,455,0.5179856115107914,1.0
115,115,85,90,75,100,580,0.8134328358208955,55,20,35,20,45,75,250,0.37681159420289856,1.0
55,69,85,32,35,28,304,0.09302325581395349,73,95,62,85,65,85,465,0.6666666666666666,1.0
68,90,65,50,55,82,410,0.6165413533834586,45,20,50,60,120,50,345,0.24074074074074073,0.0
91,129,90,72,90,108,580,0.8536585365853658,45,100,45,45,45,10,290,0.2949640287769784,0.5
60,75,100,55,80,50,420,0.3088235294117647,95,155,109,70,130,81,640,0.6788321167883211,0.0
45,45,35,20,30,20,195,0.07246376811594203,65,75,105,35,65,85,430,0.6940298507462687,0.5
90,95,105,165,110,45,610,0.2890625,71,120,95,120,95,99,600,0.8203125,0.5
70,90,70,60,60,70,420,0.6390977443609023,108,112,118,68,72,47,525,0.2916666666666667,1.0
65,90,115,45,115,58,488,0.5041322314049587,60,52,168,47,138,30,495,0.19834710743801653,4.0
52,65,50,45,50,38,300,0.27419354838709675,70,110,180,60,60,50,530,0.4117647058823529,0.5
70,50,30,95,135,105,485,0.8040540540540541,45,55,39,35,39,42,255,0.18518518518518517,1.0
40,50,45,70,45,70,320,0.5517241379310345,79,115,70,125,80,111,580,0.8468468468468469,1.0
123,77,72,99,92,58,521,0.4621212121212121,55,81,60,50,70,97,413,0.7214285714285714,1.0
45,22,60,27,30,29,213,0.07518796992481203,84,86,88,111,101,60,530,0.4634146341463415,0.5
50,65,107,105,107,86,520,0.703125,106,90,130,90,154,110,680,0.8699186991869918,4.0
79,100,80,110,90,121,580,0.968,45,55,39,35,39,42,255,0.18518518518518517,1.0
75,125,75,30,75,85,465,0.625,65,95,75,55,55,85,430,0.6933333333333334,0.5
150,120,100,120,100,90,680,0.664179104477612,50,92,108,92,108,35,485,0.2457627118644068,1.0
75,90,140,60,60,40,465,0.3008130081300813,70,105,105,50,40,20,390,0.33587786259541985,2.0
90,70,80,70,95,70,475,0.5190839694656488,31,45,90,30,30,40,266,0.21929824561403508,4.0
50,70,50,50,50,40,310,0.16296296296296298,80,82,78,95,80,85,500,0.6869565217391305,0.5
45,30,15,85,65,65,305,0.36220472440944884,60,50,40,85,75,95,405,0.7540983606557377,1.0
100,90,130,45,65,55,485,0.4253731343283582,90,60,70,75,70,45,410,0.23880597014925373,1.0
50,50,150,50,150,50,500,0.2571428571428571,59,63,80,65,80,58,405,0.41843971631205673,1.0
30,45,135,45,90,30,375,0.09285714285714286,54,66,70,44,55,46,335,0.4214876033057851,1.0
55,85,55,50,55,60,360,0.4233576642335766,80,82,83,100,100,80,525,0.6742424242424242,2.0
65,125,100,55,70,85,500,0.6532258064516129,150,120,100,120,100,90,680,0.664179104477612,0.5
100,5,5,15,65,30,220,0.07692307692307693,80,100,70,50,60,45,405,0.25806451612903225,1.0
40,70,130,60,130,25,455,0.17355371900826447,76,65,45,92,42,91,411,0.7449664429530202,0.0
45,60,32,50,32,76,295,0.5925925925925926,110,65,75,125,85,30,490,0.15,1.0
125,120,90,170,100,95,700,0.78125,75,95,95,95,95,85,540,0.6470588235294118,2.0
90,95,95,70,90,70,510,0.5230769230769231,80,120,79,95,79,70,523,0.5833333333333334,1.0
45,90,20,65,20,65,305,0.5116279069767442,45,100,45,45,45,10,290,0.2949640287769784,2.0
60,40,60,40,60,35,295,0.18055555555555555,30,45,55,70,55,85,340,0.5633802816901409,2.0
85,97,66,105,66,65,484,0.47107438016528924,75,75,75,125,95,40,485,0.15671641791044777,1.0
105,95,80,40,80,90,490,0.753968253968254,116,55,85,107,95,29,487,0.06818181818181818,1.0
38,30,41,30,41,60,240,0.2897196261682243,120,100,85,30,85,45,465,0.22448979591836735,1.0
45,85,50,55,50,65,350,0.5076923076923077,50,65,107,105,107,86,520,0.7272727272727273,0.5
54,45,47,75,98,52,371,0.39669421487603307,130,65,60,110,95,65,525,0.5227272727272727,1.0
78,70,61,50,61,100,420,0.8145161290322581,69,69,76,69,86,91,460,0.6554621848739496,1.0
64,165,75,93,83,75,555,0.6587301587301587,50,95,90,95,90,180,600,0.9172413793103448,2.0
99,68,83,72,87,51,460,0.417910447761194,55,70,45,70,50,60,350,0.45,0.5
105,105,75,65,100,50,500,0.37593984962406013,75,90,50,110,80,95,500,0.7985611510791367,1.0
40,40,40,70,40,20,250,0.032520325203252036,50,85,55,65,65,90,410,0.7478260869565218,0.5
78,70,61,50,61,100,420,0.8145161290322581,58,64,58,80,65,80,405,0.5423728813559322,1.0
105,95,75,85,75,74,509,0.5714285714285714,78,52,60,63,65,23,341,0.06015037593984962,1.0
50,85,40,85,40,35,335,0.1746031746031746,50,120,53,35,110,87,455,0.640625,1.0
100,164,150,95,120,71,700,0.5645161290322581,55,70,55,40,55,85,360,0.7073170731707317,1.0
72,85,70,65,70,58,420,0.41304347826086957,82,80,86,85,75,72,480,0.6183206106870229,0.0
40,30,30,40,50,30,220,0.07936507936507936,45,30,35,20,20,45,195,0.14782608695652175,0.5
100,75,115,90,115,85,580,0.6446280991735537,75,69,72,114,100,104,534,0.8253968253968254,2.0
50,50,120,80,80,30,410,0.07258064516129033,62,48,66,59,57,49,341,0.33884297520661155,1.0
95,109,105,75,85,56,525,0.34513274336283184,60,100,115,70,85,90,520,0.7557251908396947,1.0
80,115,80,65,55,93,488,0.7846153846153846,82,80,86,85,75,72,480,0.6183206106870229,1.0
74,94,131,54,116,20,489,0.4485294117647059,75,125,75,30,75,85,465,0.625,1.0
65,150,60,115,60,115,565,0.935251798561151,50,20,40,20,40,20,190,0.0962962962962963,0.5
40,40,55,40,70,55,300,0.40939597315436244,1,90,45,30,30,40,236,0.33064516129032256,0.5
75,89,85,55,65,36,405,0.29545454545454547,40,80,100,30,30,20,300,0.11851851851851852,4.0
40,45,40,62,60,60,307,0.33884297520661155,75,103,80,70,80,92,500,0.7933884297520661,4.0
30,80,90,55,45,55,355,0.4295774647887324,55,40,85,80,105,40,405,0.23622047244094488,2.0
1,90,45,30,30,40,236,0.33064516129032256,60,100,89,55,69,112,485,0.9298245614035088,0.5
58,109,112,48,48,109,484,0.8805970149253731,85,135,130,60,80,25,515,0.40540540540540543,2.0
90,70,80,70,95,70,475,0.5190839694656488,75,103,80,70,80,92,500,0.7933884297520661,1.0
60,65,70,85,75,40,395,0.21705426356589147,63,120,85,90,55,55,468,0.2809917355371901,2.0
50,160,110,160,110,110,700,0.8854961832061069,65,150,40,15,80,145,495,0.9663865546218487,1.0
116,55,85,107,95,29,487,0.06818181818181818,120,70,120,75,130,85,600,0.6694915254237288,0.5
61,84,65,70,70,70,420,0.5,85,120,70,50,60,100,485,0.8308823529411765,1.0
75,80,70,65,75,90,455,0.7578125,103,93,67,71,61,84,479,0.7142857142857143,0.5
41,56,40,62,44,71,314,0.568,60,55,145,75,150,40,525,0.2,2.0
40,40,40,70,40,20,250,0.032520325203252036,35,46,34,35,45,20,215,0.072,1.0
75,98,63,98,63,101,498,0.889763779527559,60,48,45,43,90,42,328,0.21897810218978103,1.0
65,130,60,95,110,65,525,0.5303030303030303,100,150,90,180,160,90,770,0.7348484848484849,0.5
89,125,90,115,80,101,600,0.8725490196078431,50,105,79,35,110,76,455,0.6214285714285714,2.0
50,35,55,25,25,15,205,0.021739130434782608,58,64,58,80,65,80,405,0.609271523178808,0.5
80,82,78,95,80,85,500,0.6869565217391305,70,45,48,60,65,35,323,0.15748031496062992,1.0
70,110,75,145,85,145,630,0.9444444444444444,60,110,70,60,60,100,460,0.8461538461538461,0.5
50,70,50,50,50,40,310,0.16296296296296298,45,49,65,49,65,45,318,0.275,0.5
100,150,140,100,90,90,670,0.7969924812030075,60,69,95,69,95,36,424,0.2608695652173913,1.0
45,50,35,55,75,40,300,0.21367521367521367,60,48,45,43,90,42,328,0.21897810218978103,1.0
80,95,82,60,82,75,474,0.6,115,45,20,45,25,20,270,0.11538461538461539,2.0
80,82,83,100,100,80,525,0.6742424242424242,49,66,70,44,55,51,335,0.4260869565217391,0.5
106,190,100,154,100,130,780,0.9259259259259259,70,95,85,55,65,70,440,0.5,0.5
30,30,42,30,42,70,244,0.4230769230769231,90,60,60,40,40,40,330,0.29545454545454547,1.0
65,73,55,47,75,85,400,0.6846846846846847,60,48,45,43,90,42,328,0.21897810218978103,2.0
38,36,38,32,36,57,237,0.3893805309734513,65,75,90,97,123,44,494,0.1987179487179487,1.0
65,70,60,65,65,115,440,0.8583333333333333,60,25,35,70,80,60,330,0.3076923076923077,1.0
50,95,180,85,45,70,525,0.5298507462686567,70,94,50,94,50,66,424,0.48148148148148145,2.0
55,70,40,60,40,40,305,0.26956521739130435,50,105,125,55,95,50,480,0.375886524822695,0.5
76,25,45,67,55,24,292,0.0390625,60,40,50,75,85,95,405,0.6044776119402985,1.0
68,65,65,125,115,80,518,0.6461538461538462,63,60,55,50,50,71,349,0.5289256198347108,1.0
101,72,72,99,89,29,462,0.1937984496124031,60,60,40,65,45,35,305,0.15833333333333333,0.5
50,160,110,160,110,110,700,0.8854961832061069,125,130,90,130,90,95,660,0.7734375,4.0
100,103,75,120,75,127,600,0.940677966101695,80,120,70,110,70,80,530,0.6422764227642277,1.0
90,95,105,165,110,45,610,0.2890625,100,100,100,100,100,100,600,0.831858407079646,1.0
100,100,90,150,140,90,670,0.71875,60,60,60,85,85,85,435,0.631578947368421,1.0
35,55,40,45,40,60,275,0.35714285714285715,61,90,45,50,50,160,456,0.9230769230769231,2.0
100,134,110,95,100,61,600,0.4057971014492754,91,134,95,100,100,80,600,0.6304347826086957,2.0
70,90,110,60,75,95,500,0.7333333333333333,45,100,135,65,135,45,525,0.29411764705882354,1.0
95,100,85,108,70,70,528,0.5652173913043478,35,20,65,40,65,20,245,0.02459016393442623,1.0
75,87,63,87,63,98,473,0.865546218487395,77,120,90,60,90,48,485,0.2785714285714286,0.5
38,36,38,32,36,57,237,0.3893805309734513,77,85,51,55,51,65,384,0.5163934426229508,1.0
45,35,50,70,50,30,280,0.15753424657534246,60,79,105,59,85,36,424,0.17054263565891473,1.0
45,60,40,70,50,45,310,0.2846715328467153,20,10,230,10,230,5,505,0.0,1.0
75,90,50,110,80,95,500,0.7985611510791367,80,125,75,40,95,85,500,0.6911764705882353,1.0
60,50,40,85,75,95,405,0.7540983606557377,28,25,25,45,35,40,198,0.16083916083916083,1.0
55,69,85,32,35,28,304,0.09302325581395349,57,24,86,24,86,23,300,0.12727272727272726,0.5
80,92,65,65,80,68,450,0.4824561403508772,70,90,90,135,90,125,600,0.9401709401709402,1.0
60,50,150,50,150,60,520,0.5206611570247934,91,72,90,129,90,108,580,0.8925619834710744,0.5
80,82,78,95,80,85,500,0.6869565217391305,45,20,50,60,120,50,345,0.24074074074074073,0.5
60,90,55,90,80,110,485,0.8677685950413223,76,65,45,92,42,91,411,0.7449664429530202,2.0
90,60,70,75,70,45,410,0.23880597014925373,55,84,105,114,75,52,485,0.2890625,0.25
91,90,72,90,129,108,580,0.896,109,66,84,81,99,32,471,0.2013888888888889,2.0
80,100,200,50,100,50,580,0.3472222222222222,60,90,140,50,50,40,430,0.2535211267605634,0.5
50,75,45,40,45,60,315,0.4380165289256198,72,95,67,103,71,122,530,0.9606299212598425,2.0
90,95,105,165,110,45,610,0.2890625,95,80,105,40,70,100,490,0.8046875,1.0
100,5,5,15,65,30,220,0.07692307692307693,65,125,100,60,70,70,490,0.6099290780141844,0.5
30,35,30,100,35,80,310,0.4765625,80,160,80,130,80,100,630,0.8455284552845529,1.0
90,65,65,40,40,15,315,0.19672131147540983,70,140,230,60,80,50,630,0.32432432432432434,0.5
68,72,78,38,42,32,330,0.23809523809523808,65,95,75,55,55,85,430,0.6933333333333334,2.0
65,50,35,115,95,95,455,0.7333333333333333,40,35,30,120,70,105,400,0.6692307692307692,0.5
30,65,100,45,25,40,305,0.1891891891891892,91,90,129,90,72,108,580,0.9140625,1.0
105,95,75,85,75,74,509,0.5714285714285714,80,92,65,65,80,68,450,0.4824561403508772,0.5
68,65,65,125,115,80,518,0.6461538461538462,65,136,94,54,96,135,580,0.9612403100775194,2.0
50,60,45,100,80,65,400,0.45689655172413796,36,50,50,65,60,44,305,0.16363636363636364,1.0
84,71,43,71,43,48,360,0.25874125874125875,49,55,42,42,37,85,310,0.6068376068376068,1.0
65,65,60,130,95,110,525,0.823943661971831,92,105,90,125,90,98,600,0.8217054263565892,0.0
97,165,60,65,50,58,495,0.3902439024390244,70,80,70,80,70,110,480,0.6594202898550725,2.0
64,88,50,88,50,106,446,0.9111111111111111,60,62,63,80,80,60,405,0.38016528925619836,1.0
30,65,100,45,25,40,305,0.1891891891891892,40,35,30,20,20,50,195,0.23423423423423423,1.0
100,150,140,100,90,90,670,0.7969924812030075,40,45,35,40,40,90,290,0.65,1.0
55,130,115,50,50,75,475,0.5982142857142857,44,48,65,50,64,43,314,0.1623931623931624,0.5
55,66,44,44,56,85,350,0.6888888888888889,65,85,70,75,70,40,405,0.203125,1.0
91,72,90,129,90,108,580,0.8620689655172413,65,125,100,60,70,70,490,0.6099290780141844,4.0
65,125,100,60,70,70,490,0.6099290780141844,50,53,62,58,63,44,330,0.13709677419354838,0.5
106,110,90,154,90,130,680,0.926829268292683,86,81,97,81,107,43,495,0.203125,1.0
78,70,61,50,61,100,420,0.8145161290322581,95,85,85,65,65,35,430,0.2571428571428571,1.0
150,80,44,90,54,80,498,0.625,105,140,55,30,55,95,480,0.8195488721804511,1.0
75,123,67,95,85,95,540,0.7642276422764228,85,97,66,105,66,65,484,0.47107438016528924,1.0
50,20,40,20,40,20,190,0.0962962962962963,80,100,80,80,80,100,520,0.9051724137931034,2.0
60,62,50,62,60,40,334,0.18181818181818182,100,110,90,85,90,60,535,0.47794117647058826,4.0
60,90,55,90,80,110,485,0.8677685950413223,50,50,77,95,77,91,440,0.5916666666666667,0.5
110,78,73,76,71,60,468,0.3333333333333333,50,85,40,85,40,35,335,0.1746031746031746,0.25
35,55,35,30,30,35,220,0.23684210526315788,100,120,100,150,120,90,680,0.728,1.0
45,60,32,50,32,76,295,0.5925925925925926,45,55,39,35,39,42,255,0.18518518518518517,1.0
50,85,55,65,65,90,410,0.7478260869565218,65,90,50,85,45,55,390,0.371900826446281,2.0
65,130,60,95,110,65,525,0.5303030303030303,60,85,42,85,42,91,405,0.8227848101265823,1.0
44,75,35,63,33,45,295,0.2647058823529412,59,110,150,45,49,35,448,0.3333333333333333,2.0
60,62,63,80,80,60,405,0.38016528925619836,65,150,60,115,60,115,565,0.935251798561151,1.0
114,85,70,85,80,30,464,0.2066115702479339,65,75,70,95,70,95,470,0.7272727272727273,0.5
86,81,97,81,107,43,495,0.203125,55,55,45,63,45,45,308,0.25,2.0
90,95,105,165,110,45,610,0.2890625,160,110,65,65,110,30,540,0.35714285714285715,1.0
55,75,50,40,40,80,340,0.6302521008403361,95,117,184,44,46,28,514,0.2975206611570248,1.0
60,90,55,90,80,110,485,0.8677685950413223,60,80,50,40,40,30,300,0.15328467153284672,1.0
46,57,40,40,40,50,273,0.25,45,60,45,25,45,55,275,0.29,1.0
70,80,102,80,102,40,474,0.2677165354330709,75,105,75,105,75,45,480,0.3274336283185841,1.0
64,66,68,81,76,50,405,0.25190839694656486,80,80,80,55,55,90,440,0.6417910447761194,1.0
80,50,100,100,200,50,580,0.2357142857142857,50,55,50,36,30,43,264,0.2922077922077922,2.0
90,85,100,95,125,85,580,0.6834532374100719,75,69,72,114,100,104,534,0.8253968253968254,0.5
78,130,111,130,85,100,634,0.8561151079136691,85,135,130,60,80,25,515,0.40540540540540543,0.5
75,75,55,105,85,30,425,0.1619718309859155,92,105,90,125,90,98,600,0.8217054263565892,0.5
89,145,90,105,80,91,600,0.8549618320610687,71,95,85,110,95,79,535,0.664,1.0
40,45,35,40,40,90,290,0.65,75,95,122,58,75,69,494,0.5725806451612904,0.0
95,135,80,110,80,100,600,0.8248175182481752,60,100,85,80,85,100,510,0.7007874015748031,2.0
50,75,75,65,65,50,380,0.4049586776859504,71,82,64,64,59,112,452,0.9327731092436975,0.0
65,65,60,110,95,130,525,0.9253731343283582,80,80,80,55,55,90,440,0.6417910447761194,1.0
90,120,100,150,120,100,680,0.7718120805369127,60,85,60,85,60,55,405,0.3673469387755102,2.0
85,105,100,79,83,78,530,0.5869565217391305,61,78,95,56,58,57,405,0.40336134453781514,0.5
75,90,90,140,90,115,600,0.9481481481481482,50,160,110,160,110,110,700,0.8854961832061069,0.25
190,33,58,33,58,33,405,0.13432835820895522,79,103,120,135,115,78,630,0.5763888888888888,1.0
51,65,65,80,75,59,395,0.4365079365079365,80,95,82,60,82,75,474,0.6,1.0
80,52,50,90,50,89,411,0.6666666666666666,75,95,122,58,75,69,494,0.5725806451612904,2.0
76,65,45,92,42,91,411,0.7449664429530202,58,64,58,80,65,80,405,0.609271523178808,1.0
72,85,70,65,70,58,420,0.41304347826086957,45,100,45,45,45,10,290,0.2949640287769784,1.0
108,100,121,81,95,95,600,0.7476635514018691,100,180,160,150,90,90,770,0.7520661157024794,2.0
50,75,35,70,30,40,300,0.21296296296296297,95,23,48,23,48,23,260,0.046153846153846156,1.0
100,150,140,100,90,90,670,0.7969924812030075,30,45,59,30,39,57,260,0.2803030303030303,1.0
70,90,45,15,45,50,315,0.3629032258064516,83,80,75,70,70,101,479,0.8615384615384616,1.0
100,100,100,100,100,100,600,0.8345864661654135,63,120,85,90,55,55,468,0.2809917355371901,0.0
50,95,90,95,90,180,600,0.9172413793103448,80,80,80,80,80,80,480,0.6015037593984962,1.0
80,50,100,100,200,50,580,0.2357142857142857,60,65,60,130,75,110,500,0.7719298245614035,1.0
70,75,80,135,80,135,575,0.917910447761194,70,85,65,105,85,120,530,0.9262295081967213,0.5
100,103,75,120,75,127,600,0.940677966101695,65,125,100,55,70,85,500,0.6532258064516129,1.0
85,105,85,40,50,40,405,0.211864406779661,77,59,50,67,63,46,362,0.23140495867768596,4.0
125,58,58,76,76,67,460,0.515625,71,82,64,64,59,112,452,0.9327731092436975,1.0
86,81,97,81,107,43,495,0.203125,50,53,48,53,48,64,316,0.4076923076923077,0.5
125,170,100,120,90,95,700,0.77,44,50,91,24,86,10,305,0.1981981981981982,0.5
75,125,75,30,75,85,465,0.625,95,110,80,70,80,50,485,0.37209302325581395,2.0
105,140,95,55,65,45,505,0.3,54,63,52,83,56,97,405,0.7697841726618705,1.0
70,110,75,145,85,145,630,0.9444444444444444,30,65,100,45,25,40,305,0.1891891891891892,2.0
75,90,140,60,60,40,465,0.3008130081300813,40,50,45,70,45,70,320,0.5517241379310345,1.0
190,33,58,33,58,33,405,0.13432835820895522,70,85,140,85,70,20,470,0.272,1.0
60,70,105,70,120,75,500,0.5983606557377049,40,60,30,31,31,70,262,0.4492753623188406,0.0
60,85,42,85,42,91,405,0.8227848101265823,50,120,53,35,110,87,455,0.640625,1.0
55,20,35,20,45,75,250,0.37681159420289856,50,53,48,53,48,64,316,0.4076923076923077,1.0
70,65,60,90,75,90,450,0.6571428571428571,49,49,56,49,61,66,330,0.5190839694656488,1.0
62,48,66,59,57,49,341,0.33884297520661155,80,115,80,65,55,93,488,0.7846153846153846,1.0
80,100,70,60,70,95,475,0.7416666666666667,50,65,107,105,107,86,520,0.6991150442477876,0.5
59,110,150,45,49,35,448,0.3333333333333333,79,100,80,110,90,121,580,0.968,1.0
52,65,50,45,50,38,300,0.27419354838709675,60,62,80,63,80,60,405,0.4336283185840708,1.0
80,52,50,90,50,89,411,0.6666666666666666,250,5,5,35,105,50,450,0.15306122448979592,1.0
65,80,80,59,63,58,405,0.4411764705882353,75,85,200,55,65,30,510,0.16778523489932887,2.0
60,85,42,85,42,91,405,0.8227848101265823,95,80,105,40,70,100,490,0.8046875,1.0
65,65,60,110,95,130,525,0.9253731343283582,55,55,55,85,55,30,335,0.1320754716981132,1.0
40,45,65,100,120,90,460,0.5588235294117647,65,80,80,59,63,58,405,0.4411764705882353,1.0
105,30,105,140,105,55,540,0.3524590163934426,70,120,100,145,105,20,560,0.2824427480916031,1.0
75,100,63,80,63,116,497,0.9345794392523364,70,145,88,140,70,112,625,0.8888888888888888,1.0
50,35,55,25,25,15,205,0.05263157894736842,90,120,100,150,120,100,680,0.7718120805369127,1.0
44,38,33,61,43,70,289,0.5267857142857143,70,110,70,115,70,90,525,0.75,0.5
80,125,75,40,95,85,500,0.6911764705882353,55,69,85,32,35,28,304,0.09302325581395349,2.0
79,100,80,110,90,121,580,0.968,80,160,80,130,80,100,630,0.8455284552845529,2.0
20,10,55,15,20,80,200,0.17985611510791366,81,102,77,85,75,85,505,0.5642857142857143,2.0
50,48,43,46,41,60,288,0.47297297297297297,40,45,35,30,40,55,245,0.3793103448275862,0.0
75,75,55,105,85,30,425,0.1619718309859155,80,90,80,130,110,110,600,0.856,0.5
55,70,40,60,40,40,305,0.26956521739130435,65,80,80,59,63,58,405,0.4411764705882353,0.5
70,40,50,55,50,25,290,0.061068702290076333,90,95,105,165,110,45,610,0.2890625,1.0
50,95,90,95,90,180,600,0.9172413793103448,75,90,50,110,80,95,500,0.7985611510791367,0.0
30,45,59,30,39,57,260,0.2803030303030303,65,90,40,45,80,75,395,0.625,0.25
55,50,45,135,95,120,500,0.7714285714285715,70,105,105,50,40,20,390,0.33587786259541985,1.0
55,55,55,85,55,30,335,0.1320754716981132,50,160,110,160,110,110,700,0.8854961832061069,1.0
71,82,64,64,59,112,452,0.9327731092436975,75,103,80,70,80,92,500,0.7933884297520661,1.0
70,80,65,90,65,85,455,0.578125,80,105,65,60,75,130,515,0.9645390070921985,0.5
50,60,60,60,60,30,320,0.11290322580645161,65,60,70,85,75,40,395,0.1796875,1.0
50,85,85,55,55,50,380,0.3902439024390244,105,140,95,55,65,45,505,0.3,2.0
55,45,50,45,65,80,340,0.5546218487394958,35,55,40,50,50,90,320,0.6838235294117647,0.5
59,59,58,90,70,73,409,0.5826086956521739,37,25,41,25,41,25,194,0.08870967741935484,2.0
70,90,45,15,45,50,315,0.3629032258064516,130,65,60,110,95,65,525,0.5227272727272727,0.5
78,81,71,74,69,126,499,0.9090909090909091,60,62,63,80,80,60,405,0.38016528925619836,4.0
95,125,79,60,100,81,540,0.6165413533834586,100,77,77,128,128,90,600,0.6901408450704225,1.0
110,85,95,80,95,50,515,0.2713178294573643,75,100,95,40,70,110,490,0.8717948717948718,1.0
65,90,115,45,115,58,488,0.5041322314049587,72,95,67,103,71,122,530,0.9606299212598425,1.0
40,55,80,35,60,30,300,0.15037593984962405,60,62,63,80,80,60,405,0.38016528925619836,2.0
62,44,50,44,50,55,305,0.3629032258064516,78,81,71,74,69,126,499,0.9090909090909091,2.0
59,45,40,35,40,31,250,0.14285714285714285,71,73,88,120,89,59,500,0.43537414965986393,1.0
35,55,35,30,30,35,220,0.23684210526315788,70,90,90,135,90,125,600,0.9401709401709402,0.5
53,54,53,37,46,45,288,0.3090909090909091,60,48,45,43,90,42,328,0.21897810218978103,1.0
75,90,50,110,80,95,500,0.7985611510791367,150,120,100,120,100,90,680,0.664179104477612,1.0
65,65,60,110,95,130,525,0.9253731343283582,80,70,40,100,60,145,495,0.921875,1.0
105,150,90,150,90,95,680,0.8285714285714286,60,62,63,80,80,60,405,0.38016528925619836,2.0
85,76,64,45,55,90,415,0.6739130434782609,40,45,35,40,40,90,290,0.65,1.0
110,65,75,125,85,30,490,0.15,57,24,86,24,86,23,300,0.12727272727272726,0.25
60,60,60,105,105,105,495,0.848,75,125,100,70,80,45,495,0.33035714285714285,1.0
90,30,15,40,20,15,210,0.043478260869565216,40,40,35,50,100,70,335,0.5031847133757962,0.5
45,100,135,65,135,45,525,0.29411764705882354,75,105,75,105,75,45,480,0.3274336283185841,1.0
43,80,65,50,35,35,308,0.14193548387096774,60,45,70,75,85,55,390,0.3008130081300813,1.0
130,70,35,70,35,60,400,0.4017857142857143,60,45,50,90,80,70,395,0.625,1.0
60,85,69,60,69,77,420,0.518796992481203,40,80,35,35,45,70,305,0.4661016949152542,1.0
60,40,50,75,85,95,405,0.6044776119402985,64,115,65,83,63,65,455,0.5323741007194245,1.0
65,110,130,60,65,95,525,0.8278145695364238,80,80,80,80,80,80,480,0.5606060606060606,2.0
65,125,60,95,60,105,510,0.9236641221374046,76,48,48,57,62,34,325,0.11688311688311688,1.0
50,50,40,50,40,64,294,0.45588235294117646,59,74,50,35,50,35,303,0.3125,2.0
106,110,90,154,90,130,680,0.926829268292683,45,55,39,35,39,42,255,0.18518518518518517,1.0
73,115,60,60,60,90,458,0.6694915254237288,70,65,60,90,75,90,450,0.6571428571428571,1.0
81,102,77,85,75,85,505,0.5642857142857143,75,89,85,55,65,36,405,0.29545454545454547,1.0
80,135,130,95,90,70,600,0.5181818181818182,59,45,40,35,40,31,250,0.14285714285714285,1.0
55,65,35,60,30,85,330,0.6126126126126126,95,125,79,60,100,81,540,0.6165413533834586,0.5
55,112,45,74,45,70,401,0.559322033898305,105,180,100,180,100,115,780,0.9477611940298507,2.0
106,150,70,194,120,140,780,0.952,90,92,75,92,85,60,494,0.49586776859504134,1.0
50,65,107,105,107,86,520,0.703125,90,90,85,125,90,100,580,0.768595041322314,2.0
80,82,83,100,100,80,525,0.6742424242424242,65,50,70,95,80,65,425,0.4262295081967213,1.0
75,125,70,125,70,115,580,0.9037037037037037,60,40,60,40,60,35,295,0.18055555555555555,1.0
125,170,100,120,90,95,700,0.77,45,50,55,75,65,30,320,0.06293706293706294,2.0
70,130,100,55,80,65,500,0.608,90,120,120,60,60,50,500,0.35294117647058826,1.0
75,80,60,65,90,102,472,0.8625954198473282,41,50,37,50,37,66,281,0.5175438596491229,1.0
106,190,100,154,100,130,780,0.9259259259259259,70,65,60,90,75,90,450,0.6571428571428571,0.5
78,70,61,50,61,100,420,0.8145161290322581,65,60,70,85,75,40,395,0.1796875,1.0
40,65,95,60,45,35,340,0.13986013986013987,60,80,50,40,40,30,300,0.15328467153284672,2.0
65,63,45,45,45,45,308,0.2595419847328244,90,120,75,60,60,45,450,0.29411764705882354,1.0
85,135,130,60,80,25,515,0.40540540540540543,110,65,105,55,95,80,510,0.6258503401360545,2.0
75,65,55,65,55,69,384,0.43548387096774194,45,35,45,62,53,35,275,0.11851851851851852,0.25
50,95,90,95,90,180,600,0.9172413793103448,80,80,80,80,80,80,480,0.5606060606060606,1.0
40,65,40,80,40,65,330,0.5038167938931297,63,60,55,50,50,71,349,0.5289256198347108,1.0
50,85,40,85,40,35,335,0.1746031746031746,30,42,118,42,88,30,350,0.112,1.0
55,50,65,175,95,150,590,0.7818181818181819,75,95,95,95,95,85,540,0.6470588235294118,1.0
73,76,75,81,100,100,505,0.8110236220472441,65,40,50,125,60,30,370,0.07258064516129033,1.0
120,120,120,120,120,120,720,0.9344262295081968,28,25,25,45,35,40,198,0.16083916083916083,1.0
60,60,60,60,60,60,360,0.38095238095238093,75,75,55,105,85,30,425,0.1619718309859155,1.0
55,40,40,65,45,35,280,0.16428571428571428,41,64,45,50,50,50,300,0.36752136752136755,0.5
114,85,70,85,80,30,464,0.2066115702479339,65,50,35,115,95,95,455,0.7333333333333333,1.0
60,85,49,60,49,60,363,0.4444444444444444,35,35,40,35,55,50,250,0.40336134453781514,1.0
59,66,70,44,55,41,335,0.25190839694656486,85,76,64,45,55,90,415,0.6739130434782609,0.0
100,150,110,95,110,70,635,0.5923076923076923,100,50,80,60,80,50,420,0.34375,0.5
105,30,105,140,105,55,540,0.3524590163934426,71,95,85,110,95,79,535,0.664,2.0
70,50,30,95,135,105,485,0.8040540540540541,45,75,60,40,30,50,300,0.304,2.0
65,150,40,15,80,145,495,0.9663865546218487,108,130,95,80,85,102,600,0.7637795275590551,0.5
75,87,63,87,63,98,473,0.865546218487395,40,70,130,60,130,25,455,0.17355371900826447,1.0
75,100,110,45,55,65,450,0.5333333333333333,60,75,100,55,80,50,420,0.3088235294117647,2.0
60,65,70,85,75,40,395,0.21705426356589147,60,45,70,45,90,95,405,0.7304964539007093,1.0
100,70,70,65,65,45,415,0.1897810218978102,75,70,90,70,105,80,490,0.656,1.0
70,90,90,135,90,125,600,0.9401709401709402,70,90,45,15,45,50,315,0.3629032258064516,1.0
110,80,90,95,90,65,530,0.5033557046979866,90,130,80,65,85,55,505,0.4396551724137931,1.0
40,65,95,60,45,35,340,0.13986013986013987,62,48,54,63,60,68,355,0.5178571428571429,1.0
60,65,70,85,75,40,395,0.21705426356589147,110,65,75,125,85,30,490,0.15,1.0
78,92,75,74,63,118,500,0.8842975206611571,35,55,35,30,30,35,220,0.23684210526315788,2.0
73,95,62,85,65,85,465,0.6666666666666666,41,50,37,50,37,66,281,0.5175438596491229,1.0
50,35,55,25,25,15,205,0.05263157894736842,70,100,70,105,75,40,460,0.23214285714285715,0.5
43,70,48,50,60,38,309,0.2391304347826087,50,35,55,25,25,15,205,0.021739130434782608,0.5
30,65,100,45,25,40,305,0.1891891891891892,110,130,80,70,60,80,530,0.5862068965517241,2.0
50,75,75,65,65,50,380,0.4049586776859504,100,77,77,128,128,90,600,0.6901408450704225,0.0
55,104,105,94,75,52,485,0.36363636363636365,85,120,70,50,60,100,485,0.8308823529411765,1.0
78,70,61,50,61,100,420,0.8145161290322581,30,35,30,100,35,80,310,0.4765625,0.0
70,55,95,95,110,65,490,0.48872180451127817,74,48,76,83,81,104,466,0.7322834645669292,0.5
40,55,70,45,60,30,300,0.10619469026548672,61,72,57,55,55,65,365,0.3984375,1.0
60,85,60,50,50,125,430,0.9090909090909091,80,80,80,80,80,80,480,0.6015037593984962,1.0
60,62,63,80,80,60,405,0.38016528925619836,45,90,20,65,20,65,305,0.5116279069767442,2.0
85,110,90,45,90,80,500,0.6206896551724138,50,50,50,50,50,50,300,0.30708661417322836,1.0
70,150,140,65,100,75,600,0.55,55,85,55,50,55,60,360,0.4233576642335766,0.25
100,100,100,100,100,100,600,0.8758169934640523,50,85,85,55,55,50,380,0.3902439024390244,0.125
84,71,43,71,43,48,360,0.25874125874125875,55,70,55,40,55,85,360,0.7073170731707317,1.0
31,45,90,30,30,40,266,0.21929824561403508,70,120,65,45,85,125,510,0.9747899159663865,2.0
50,60,45,100,80,65,400,0.45689655172413796,60,25,35,70,80,60,330,0.3076923076923077,1.0
70,90,45,15,45,50,315,0.3629032258064516,71,95,85,110,95,79,535,0.664,2.0
40,45,65,100,120,90,460,0.5588235294117647,20,15,20,10,55,80,200,0.2682926829268293,1.0
60,60,60,60,60,60,360,0.38095238095238093,75,110,110,110,105,80,590,0.656934306569343,1.0
150,160,100,95,65,100,670,0.8866666666666667,57,80,91,80,87,75,470,0.5737704918032787,0.5
68,65,65,125,115,80,518,0.6461538461538462,105,150,90,150,90,95,680,0.8285714285714286,2.0
150,80,44,90,54,80,498,0.625,123,100,62,97,81,68,531,0.4806201550387597,2.0
75,90,140,60,60,40,465,0.3008130081300813,71,95,85,110,95,79,535,0.664,2.0
90,60,60,40,40,40,330,0.29545454545454547,75,100,95,40,70,110,490,0.8717948717948718,1.0
55,45,45,25,25,15,210,0.048,41,64,45,50,50,50,300,0.36752136752136755,0.5
65,136,94,54,96,135,580,0.9612403100775194,70,55,55,80,60,45,365,0.2222222222222222,1.0
70,65,65,55,55,70,380,0.5,60,62,80,63,80,60,405,0.4336283185840708,1.0
100,134,110,95,100,61,600,0.4057971014492754,90,50,34,60,44,70,348,0.6283185840707964,4.0
35,40,100,90,55,35,355,0.1796875,77,85,51,55,51,65,384,0.5163934426229508,2.0
45,30,40,105,50,20,290,0.031007751937984496,70,50,30,95,135,105,485,0.8040540540540541,1.0
38,30,85,55,65,30,303,0.21428571428571427,80,100,70,60,70,95,475,0.7416666666666667,0.0
78,81,71,74,69,126,499,0.9090909090909091,40,65,95,60,45,35,340,0.13986013986013987,1.0
70,75,60,105,60,105,475,0.88,115,115,85,90,75,100,580,0.8134328358208955,1.0
55,55,45,63,45,45,308,0.25,38,41,40,50,65,65,299,0.4108527131782946,2.0
80,100,80,80,80,100,520,0.9051724137931034,170,90,45,90,45,60,500,0.427536231884058,1.0
45,100,135,65,135,45,525,0.29411764705882354,60,80,95,70,85,50,440,0.2231404958677686,1.0
105,180,100,180,100,115,780,0.9477611940298507,70,135,105,60,105,20,495,0.5806451612903226,0.5
50,180,20,180,20,150,600,0.9029850746268657,70,110,75,145,85,145,630,0.9444444444444444,1.0
100,100,100,100,100,100,600,0.8805970149253731,64,165,75,93,83,75,555,0.6587301587301587,1.0
50,50,40,50,40,64,294,0.45588235294117646,53,51,53,61,56,40,314,0.14285714285714285,0.5
45,95,50,40,50,75,355,0.54,45,50,55,75,65,30,320,0.06293706293706294,1.0
35,60,44,40,54,55,288,0.366412213740458,91,72,90,129,90,108,580,0.8925619834710744,1.0
70,62,67,55,55,56,365,0.38513513513513514,100,100,100,100,100,100,600,0.8778625954198473,1.0
50,70,50,50,50,70,340,0.5645161290322581,75,95,95,95,95,85,540,0.6470588235294118,2.0
35,55,40,50,50,90,320,0.6838235294117647,65,95,100,60,50,50,420,0.34959349593495936,0.5
105,140,55,30,55,95,480,0.8195488721804511,60,59,85,79,105,36,424,0.16666666666666666,4.0
20,40,15,35,35,60,205,0.34285714285714286,65,90,122,58,75,84,494,0.71875,0.5
40,20,30,40,80,55,265,0.22764227642276422,60,50,150,50,150,60,520,0.5206611570247934,0.125
30,45,59,30,39,57,260,0.2803030303030303,39,52,43,60,50,65,309,0.49107142857142855,0.5
70,100,70,105,75,40,460,0.23214285714285715,100,100,100,100,100,100,600,0.8758169934640523,4.0
85,50,95,120,115,80,545,0.5793650793650794,95,70,73,95,90,60,483,0.3983739837398374,1.0
44,38,39,61,79,42,303,0.2251655629139073,50,52,48,65,50,55,320,0.33098591549295775,1.0
50,53,48,53,48,64,316,0.46153846153846156,45,80,100,35,37,28,325,0.3125,2.0
55,81,60,50,70,97,413,0.7214285714285714,45,63,37,65,55,95,360,0.8055555555555556,1.0
55,95,115,45,45,35,390,0.2116788321167883,40,80,100,30,30,20,300,0.11851851851851852,1.0
125,130,90,130,90,95,660,0.7734375,115,115,85,90,75,100,580,0.8134328358208955,0.5
65,50,35,115,95,95,455,0.7333333333333333,45,100,135,65,135,45,525,0.29411764705882354,1.0
50,65,85,35,35,55,325,0.32575757575757575,63,60,55,50,50,71,349,0.5289256198347108,1.0
100,90,130,45,65,55,485,0.4253731343283582,70,80,50,35,35,35,305,0.14,0.5
62,44,50,44,50,55,305,0.3629032258064516,60,80,110,50,80,45,425,0.2833333333333333,2.0
80,115,80,65,55,93,488,0.7846153846153846,90,100,70,110,150,80,600,0.6037735849056604,1.0
75,65,55,65,55,69,384,0.43548387096774194,65,136,94,54,96,135,580,0.9612403100775194,1.0
40,29,45,29,45,36,224,0.14634146341463414,65,150,60,115,60,115,565,0.935251798561151,2.0
115,140,130,55,55,40,535,0.4519230769230769,58,70,45,40,45,42,300,0.25925925925925924,0.5
55,95,115,45,45,35,390,0.2116788321167883,60,90,70,60,120,40,440,0.27419354838709675,1.0
44,50,91,24,86,10,305,0.1981981981981982,50,95,90,95,90,180,600,0.9172413793103448,1.0
50,120,53,35,110,87,455,0.640625,45,60,30,80,50,65,330,0.4603174603174603,2.0
75,90,90,140,90,115,600,0.9481481481481482,150,120,100,120,100,90,680,0.664179104477612,1.0
35,35,35,35,35,35,210,0.13385826771653545,70,120,100,145,105,20,560,0.2824427480916031,1.0
80,130,100,160,120,110,700,0.8981481481481481,80,110,60,150,130,70,600,0.5042016806722689,0.5
95,125,79,60,100,81,540,0.6165413533834586,49,55,42,42,37,85,310,0.6068376068376068,1.0
73,95,62,85,65,85,465,0.6666666666666666,55,50,40,40,40,75,300,0.5945945945945946,1.0
64,88,50,88,50,106,446,0.9111111111111111,60,85,69,60,69,77,420,0.518796992481203,1.0
50,60,45,100,80,65,400,0.45689655172413796,40,55,70,45,60,30,300,0.10619469026548672,0.0
50,65,107,105,107,86,520,0.7758620689655172,55,85,55,50,55,60,360,0.4233576642335766,2.0
65,65,60,130,95,110,525,0.823943661971831,90,95,105,165,110,45,610,0.2890625,1.0
60,45,50,90,80,70,395,0.625,60,60,40,65,45,35,305,0.15833333333333333,0.5
85,90,80,70,80,130,535,0.9262295081967213,89,125,90,115,80,101,600,0.8725490196078431,0.5
46,87,60,30,40,57,320,0.37777777777777777,66,117,70,40,50,67,410,0.4573643410852713,2.0
50,95,180,85,45,70,525,0.5298507462686567,65,136,94,54,96,135,580,0.9612403100775194,1.0
53,51,53,61,56,40,314,0.14285714285714285,95,65,65,110,130,60,525,0.4016393442622951,1.0
80,100,200,50,100,50,580,0.3472222222222222,80,92,65,65,80,68,450,0.4824561403508772,1.0
60,90,55,90,80,110,485,0.8677685950413223,75,80,70,65,75,90,455,0.7578125,2.0
85,120,70,50,60,100,485,0.8308823529411765,70,80,65,90,65,85,455,0.578125,1.0
40,50,45,70,45,70,320,0.5517241379310345,55,63,90,50,80,42,380,0.21138211382113822,4.0
95,117,80,65,70,92,519,0.8409090909090909,70,80,50,35,35,35,305,0.14,0.5
50,85,125,85,115,20,480,0.4306569343065693,52,65,55,58,62,60,352,0.4482758620689655,0.0
100,100,100,100,100,100,600,0.8758169934640523,65,75,90,97,123,44,494,0.1987179487179487,2.0
20,10,230,10,230,5,505,0.0,61,72,57,55,55,65,365,0.3984375,0.5
37,25,41,25,41,25,194,0.08870967741935484,60,60,60,85,85,85,435,0.631578947368421,0.5
60,85,60,85,60,55,405,0.3673469387755102,60,45,50,90,80,70,395,0.625,0.5
106,190,100,154,100,130,780,0.9259259259259259,95,23,48,23,48,23,260,0.046153846153846156,0.25
30,80,90,55,45,55,355,0.4295774647887324,90,60,70,75,70,45,410,0.23880597014925373,1.0
65,65,60,110,95,130,525,0.9253731343283582,80,82,83,100,100,80,525,0.6742424242424242,0.5
60,85,60,85,60,55,405,0.3673469387755102,50,75,75,65,65,50,380,0.4049586776859504,0.0
75,65,55,65,55,69,384,0.43548387096774194,95,75,110,100,80,30,490,0.15267175572519084,0.5
64,115,65,83,63,65,455,0.5323741007194245,20,25,45,70,90,60,310,0.30833333333333335,2.0
40,45,40,62,60,60,307,0.33884297520661155,84,86,88,111,101,60,530,0.4634146341463415,1.0
95,85,85,65,65,35,430,0.2571428571428571,40,70,130,60,130,25,455,0.17355371900826447,1.0
91,90,106,130,106,77,600,0.648854961832061,63,63,47,41,41,74,329,0.56,1.0
100,123,75,57,75,80,510,0.6923076923076923,80,80,50,40,50,25,325,0.176056338028169,1.0
40,45,40,62,60,60,307,0.33884297520661155,50,80,95,10,45,10,290,0.232,0.5
71,95,85,110,95,79,535,0.664,60,80,50,40,40,30,300,0.15328467153284672,1.0
45,85,50,55,50,65,350,0.5076923076923077,110,130,80,70,60,80,530,0.5862068965517241,2.0
31,45,90,30,30,40,266,0.21929824561403508,110,80,90,95,90,65,530,0.5033557046979866,1.0
65,75,105,35,65,85,430,0.6940298507462687,80,70,65,80,120,100,515,0.8034188034188035,2.0
99,68,83,72,87,51,460,0.417910447761194,86,81,97,81,107,43,495,0.203125,1.0
70,83,50,37,50,60,350,0.3360655737704918,65,75,70,95,70,95,470,0.7272727272727273,1.0
104,91,63,91,73,68,490,0.5118110236220472,85,100,122,58,75,54,494,0.3939393939393939,0.0
35,35,40,35,55,50,250,0.40336134453781514,70,80,102,80,102,40,474,0.2677165354330709,0.5
150,160,100,95,65,100,670,0.8866666666666667,80,80,80,80,80,80,480,0.5606060606060606,1.0
43,70,48,50,60,38,309,0.2391304347826087,60,100,85,80,85,100,510,0.7007874015748031,2.0
45,85,50,55,50,65,350,0.5076923076923077,65,90,122,58,75,84,494,0.71875,0.0
75,98,63,98,63,101,498,0.889763779527559,59,66,70,44,55,41,335,0.25190839694656486,2.0
60,60,60,35,35,30,280,0.11194029850746269,89,124,80,55,80,55,483,0.5714285714285714,0.0
105,95,80,40,80,90,490,0.753968253968254,74,48,76,83,81,104,466,0.7913043478260869,1.0
35,46,34,35,45,20,215,0.072,45,100,135,65,135,45,525,0.29411764705882354,0.0
62,50,58,73,54,72,369,0.4435483870967742,50,60,60,60,60,30,320,0.11290322580645161,0.5
45,45,35,20,30,20,195,0.07246376811594203,35,65,35,65,35,65,300,0.46621621621621623,1.0
38,41,40,50,65,65,299,0.4108527131782946,55,95,115,45,45,35,390,0.2116788321167883,0.5
30,42,118,42,88,30,350,0.112,45,75,37,70,55,83,365,0.6183206106870229,1.0
100,164,150,95,120,71,700,0.5645161290322581,120,70,120,75,130,85,600,0.6694915254237288,2.0
70,65,60,90,75,90,450,0.6571428571428571,60,60,50,40,50,75,335,0.5882352941176471,4.0
126,131,95,131,98,99,680,0.8102189781021898,50,65,107,105,107,86,520,0.7313432835820896,1.0
50,50,150,50,150,50,500,0.2571428571428571,95,75,110,100,80,30,490,0.15267175572519084,1.0
50,100,150,100,150,50,600,0.37142857142857144,55,50,40,40,40,75,300,0.5945945945945946,1.0
65,65,60,110,95,130,525,0.9253731343283582,103,60,86,60,86,50,445,0.3458646616541353,1.0
60,60,60,35,35,30,280,0.11194029850746269,57,24,86,24,86,23,300,0.12727272727272726,0.5
75,125,70,125,70,115,580,0.9037037037037037,60,100,85,80,85,100,510,0.7007874015748031,0.5
50,95,95,35,110,70,455,0.5179856115107914,35,35,40,35,55,50,250,0.40336134453781514,0.5
30,40,70,70,25,60,295,0.41353383458646614,45,20,50,60,120,50,345,0.24074074074074073,0.5
62,48,66,59,57,49,341,0.33884297520661155,100,100,100,100,100,100,600,0.8602941176470589,1.0
80,115,80,65,55,93,488,0.7846153846153846,100,100,100,100,100,100,600,0.8778625954198473,1.0
90,100,70,110,150,80,600,0.6037735849056604,50,50,95,40,50,35,320,0.20279720279720279,1.0
65,40,70,80,140,70,465,0.5954198473282443,55,55,45,63,45,45,308,0.25,0.5
50,65,85,35,35,55,325,0.32575757575757575,49,66,70,44,55,51,335,0.4260869565217391,1.0
104,91,63,91,73,68,490,0.5118110236220472,80,160,60,170,130,80,680,0.6180555555555556,1.0
105,30,105,140,105,55,540,0.3524590163934426,30,80,90,55,45,55,355,0.4295774647887324,0.25
65,50,35,115,95,95,455,0.7333333333333333,86,92,88,68,75,73,482,0.6835443037974683,0.0
60,70,65,125,105,90,515,0.6911764705882353,66,41,77,61,87,23,355,0.12096774193548387,1.0
75,85,200,55,65,30,510,0.16778523489932887,75,98,63,98,63,101,498,0.849624060150376,0.5
70,80,65,90,65,85,455,0.578125,91,129,90,72,90,108,580,0.8536585365853658,0.5
65,47,55,73,75,85,400,0.65,58,70,45,40,45,42,300,0.25925925925925924,1.0
60,80,50,50,50,40,330,0.23853211009174313,65,75,105,35,65,85,430,0.6940298507462687,1.0
50,50,95,40,50,35,320,0.20279720279720279,105,180,100,180,100,115,780,0.9477611940298507,0.0
55,45,45,25,25,15,210,0.048,77,85,51,55,51,65,384,0.5163934426229508,0.5
70,110,80,55,80,105,500,0.8794326241134752,66,65,48,62,57,52,350,0.36220472440944884,4.0
70,92,65,80,55,98,460,0.8090909090909091,82,121,119,69,59,71,521,0.5394736842105263,1.0
50,20,55,25,25,30,205,0.09774436090225563,75,55,70,55,95,110,460,0.8444444444444444,1.0
95,117,184,44,46,28,514,0.2975206611570248,105,95,80,40,80,90,490,0.753968253968254,1.0
30,40,70,70,25,60,295,0.41353383458646614,40,20,30,40,80,55,265,0.22764227642276422,1.0
65,50,70,95,80,65,425,0.4262295081967213,55,55,50,45,65,55,325,0.37373737373737376,1.0
100,150,140,100,90,90,670,0.7969924812030075,61,84,65,70,70,70,420,0.5,1.0
115,115,85,90,75,100,580,0.8134328358208955,110,130,80,70,60,80,530,0.5862068965517241,2.0
50,50,77,95,77,91,440,0.5916666666666667,60,40,60,40,60,35,295,0.18055555555555555,0.5
68,90,65,50,55,82,410,0.6165413533834586,50,70,100,40,40,30,330,0.2222222222222222,2.0
70,83,50,37,50,60,350,0.3360655737704918,89,145,90,105,80,91,600,0.8549618320610687,1.0
95,109,105,75,85,56,525,0.34513274336283184,75,98,63,98,63,101,498,0.849624060150376,2.0
75,89,85,55,65,36,405,0.29545454545454547,90,120,120,60,60,50,500,0.35294117647058826,2.0
76,104,71,104,71,108,534,0.912751677852349,70,43,53,43,53,40,302,0.19090909090909092,0.5
67,58,57,81,67,101,431,0.8790322580645161,50,70,50,50,50,40,310,0.16296296296296298,2.0
35,80,50,50,70,120,405,0.84375,40,80,35,35,45,70,305,0.4661016949152542,1.0
55,75,60,75,60,103,428,0.7982456140350878,89,125,90,115,80,101,600,0.8725490196078431,0.0
45,60,30,80,50,65,330,0.4603174603174603,10,55,25,35,45,95,265,0.5396825396825397,1.0
72,105,115,54,86,68,500,0.5149253731343284,44,38,39,61,79,42,303,0.2251655629139073,1.0
65,47,55,73,75,85,400,0.65,50,50,50,50,50,50,300,0.30708661417322836,1.0
60,75,100,55,80,50,420,0.3088235294117647,61,72,57,55,55,65,365,0.3984375,2.0
40,27,60,37,50,66,280,0.36220472440944884,100,103,75,120,75,127,600,0.940677966101695,0.25
60,67,85,77,75,116,480,0.8888888888888888,90,100,60,90,60,80,480,0.6422764227642277,1.0
50,95,180,85,45,70,525,0.5298507462686567,74,100,72,90,72,46,454,0.24561403508771928,1.0
90,85,75,115,100,115,580,0.9381443298969072,60,30,30,36,56,50,262,0.32432432432432434,2.0
61,72,57,55,55,65,365,0.3984375,50,20,55,25,25,30,205,0.09774436090225563,1.0
60,45,70,75,85,55,390,0.3008130081300813,65,150,60,115,60,115,565,0.935251798561151,0.0
60,60,40,65,45,35,305,0.15833333333333333,50,53,48,53,48,64,316,0.46153846153846156,1.0
58,109,112,48,48,109,484,0.8805970149253731,70,84,70,65,70,51,410,0.2949640287769784,2.0
120,70,120,75,130,85,600,0.6694915254237288,80,80,90,110,130,110,600,0.8721804511278195,0.5
105,95,80,40,80,90,490,0.753968253968254,50,65,107,105,107,86,520,0.7758620689655172,1.0
76,104,71,104,71,108,534,0.912751677852349,62,48,54,63,60,68,355,0.5178571428571429,0.5
56,61,65,48,45,38,313,0.17567567567567569,55,85,122,58,75,99,494,0.8099173553719008,0.5
60,59,85,79,105,36,424,0.16666666666666666,90,85,100,95,125,85,580,0.6834532374100719,0.25
40,60,40,40,40,30,250,0.0948905109489051,61,72,57,55,55,65,365,0.3984375,0.25
75,80,95,90,100,50,490,0.2158273381294964,70,110,70,115,70,90,525,0.75,0.5
76,65,45,92,42,91,411,0.7449664429530202,65,150,60,115,60,115,565,0.935251798561151,1.0
80,82,83,100,100,80,525,0.6742424242424242,84,86,88,111,101,60,530,0.4634146341463415,0.0
70,110,180,60,60,50,530,0.4117647058823529,80,52,50,90,50,89,411,0.6666666666666666,4.0
65,150,60,115,60,115,565,0.935251798561151,115,140,130,55,55,40,535,0.4519230769230769,1.0
64,51,23,51,23,28,240,0.11363636363636363,40,45,40,65,40,65,295,0.5661764705882353,1.0
126,131,95,131,98,99,680,0.8102189781021898,80,120,130,55,65,45,495,0.37037037037037035,0.5
65,150,60,115,60,115,565,0.935251798561151,60,79,105,59,85,36,424,0.17054263565891473,1.0
55,75,50,40,40,80,340,0.6302521008403361,85,60,65,135,105,100,550,0.7518248175182481,2.0
28,25,25,45,35,40,198,0.16083916083916083,35,55,40,45,40,60,275,0.35714285714285715,1.0
55,66,44,44,56,85,350,0.6888888888888889,71,73,88,120,89,59,500,0.43537414965986393,1.0
45,55,45,65,45,75,330,0.5692307692307692,68,72,78,38,42,32,330,0.23809523809523808,2.0
60,80,110,50,80,45,425,0.2833333333333333,62,55,52,109,94,109,481,0.7833333333333333,2.0
135,85,40,40,85,5,390,0.6864406779661016,115,115,85,90,75,100,580,0.8134328358208955,1.0
35,70,55,45,55,25,285,0.09420289855072464,55,85,55,50,55,60,360,0.4233576642335766,0.125
55,45,43,55,43,72,313,0.5853658536585366,40,30,30,40,50,30,220,0.07936507936507936,2.0
80,80,50,40,50,25,325,0.176056338028169,105,140,95,55,65,45,505,0.3,1.0
120,100,85,30,85,45,465,0.22448979591836735,60,75,85,100,85,115,520,0.8992248062015504,0.5
45,80,100,35,37,28,325,0.3125,170,90,45,90,45,60,500,0.427536231884058,0.5
70,145,88,140,70,112,625,0.8888888888888888,60,100,85,80,85,100,510,0.7007874015748031,0.5
60,60,60,85,85,85,435,0.631578947368421,70,43,53,43,53,40,302,0.19090909090909092,1.0
95,65,110,60,130,65,525,0.5275590551181102,65,85,70,75,70,40,405,0.203125,1.0
80,125,75,40,95,85,500,0.6911764705882353,60,65,60,130,75,110,500,0.7719298245614035,0.0
40,30,30,40,50,30,220,0.07936507936507936,100,77,77,128,128,90,600,0.6901408450704225,1.0
70,140,230,60,80,50,630,0.32432432432432434,95,65,65,110,130,60,525,0.4016393442622951,0.5
38,36,38,32,36,57,237,0.3893805309734513,60,80,110,50,80,45,425,0.2833333333333333,1.0
64,51,23,51,23,28,240,0.11363636363636363,70,50,30,95,135,105,485,0.8040540540540541,1.0
38,35,40,27,25,35,200,0.08208955223880597,40,60,30,31,31,70,262,0.4492753623188406,0.5
50,75,70,35,70,48,348,0.29357798165137616,58,109,112,48,48,109,484,0.8805970149253731,1.0
70,120,100,145,105,20,560,0.2824427480916031,70,65,60,90,75,90,450,0.6571428571428571,2.0
50,100,150,100,150,50,600,0.37142857142857144,92,105,90,125,90,98,600,0.8217054263565892,4.0
65,55,115,100,40,60,435,0.3798449612403101,80,95,82,60,82,75,474,0.6,0.5
74,48,76,83,81,104,466,0.7913043478260869,59,66,70,44,55,41,335,0.25190839694656486,1.0
44,48,65,50,64,43,314,0.1623931623931624,100,150,120,120,100,90,680,0.6493506493506493,0.5
60,90,70,60,120,40,440,0.27419354838709675,50,160,110,160,110,110,700,0.8854961832061069,0.5
105,105,75,65,100,50,500,0.37593984962406013,105,95,75,85,75,74,509,0.5714285714285714,0.5
85,135,130,60,80,25,515,0.40540540540540543,68,165,95,65,115,110,618,0.8615384615384616,0.5
75,75,55,105,85,30,425,0.1619718309859155,60,100,85,80,85,100,510,0.7007874015748031,1.0
25,20,15,105,55,90,310,0.32407407407407407,55,40,85,80,105,40,405,0.23622047244094488,1.0
20,25,45,70,90,60,310,0.30833333333333335,35,40,100,90,55,35,355,0.1796875,1.0
50,120,53,35,110,87,455,0.640625,55,55,50,45,65,55,325,0.37373737373737376,2.0
70,110,180,60,60,50,530,0.4117647058823529,50,50,95,40,50,35,320,0.20279720279720279,0.5
105,140,55,30,55,95,480,0.8195488721804511,54,63,52,83,56,97,405,0.7697841726618705,0.5
52,65,50,45,50,38,300,0.27419354838709675,46,57,40,40,40,50,273,0.25,1.0
65,40,50,125,60,30,370,0.07258064516129033,40,35,30,20,20,50,195,0.23423423423423423,2.0
45,30,40,105,50,20,290,0.031007751937984496,70,120,100,145,105,20,560,0.2824427480916031,2.0
101,72,72,99,89,29,462,0.1937984496124031,65,95,100,60,50,50,420,0.34959349593495936,2.0
80,85,95,30,30,25,345,0.2857142857142857,25,35,70,95,55,45,325,0.16783216783216784,2.0
20,40,15,35,35,60,205,0.34285714285714286,45,30,35,20,20,45,195,0.14782608695652175,1.0
65,90,115,45,115,58,488,0.5041322314049587,77,59,50,67,63,46,362,0.23140495867768596,4.0
70,150,140,65,100,75,600,0.55,45,100,45,45,45,10,290,0.2949640287769784,1.0
55,47,52,40,40,41,275,0.16806722689075632,80,135,85,70,95,150,615,0.9844961240310077,0.5
48,72,48,72,48,48,336,0.25984251968503935,75,95,95,95,95,85,540,0.6470588235294118,1.0
100,150,140,100,90,90,670,0.7969924812030075,74,48,76,83,81,104,466,0.7913043478260869,1.0
75,123,67,95,85,95,540,0.7642276422764228,50,50,150,50,150,50,500,0.2571428571428571,1.0
59,45,40,35,40,31,250,0.14285714285714285,100,90,130,45,65,55,485,0.4253731343283582,0.5
55,69,85,32,35,28,304,0.09302325581395349,75,125,70,125,70,115,580,0.9037037037037037,1.0
70,115,60,115,60,55,475,0.4647887323943662,65,130,60,75,60,75,465,0.689922480620155,0.5
60,45,50,90,80,70,395,0.625,75,100,110,45,55,65,450,0.5333333333333333,1.0
60,105,60,120,60,105,510,0.8849557522123894,62,77,62,50,42,65,358,0.4838709677419355,1.0
90,132,105,132,105,30,594,0.4246575342465753,74,48,76,83,81,104,466,0.7322834645669292,1.0
40,50,45,70,45,70,320,0.5517241379310345,60,62,63,80,80,60,405,0.38016528925619836,4.0
70,120,100,145,105,20,560,0.2824427480916031,100,180,160,150,90,90,770,0.7520661157024794,1.0
70,75,60,105,60,105,475,0.88,55,69,85,32,35,28,304,0.09302325581395349,1.0
41,64,45,50,50,50,300,0.36752136752136755,74,94,131,54,116,20,489,0.4485294117647059,0.5
55,75,85,25,25,15,280,0.1875,55,65,35,60,30,85,330,0.6126126126126126,1.0
60,85,60,85,60,55,405,0.3673469387755102,85,73,70,73,115,67,483,0.5126050420168067,0.5
80,70,40,100,60,145,495,0.921875,50,53,48,53,48,64,316,0.4076923076923077,2.0
70,100,115,30,65,30,410,0.24390243902439024,65,130,60,75,60,75,465,0.689922480620155,1.0
60,85,69,60,69,77,420,0.518796992481203,100,77,77,128,128,90,600,0.6901408450704225,1.0
70,90,70,60,60,70,420,0.6390977443609023,40,30,32,50,52,65,269,0.3671875,1.0
77,120,90,60,90,48,485,0.2785714285714286,60,100,115,70,85,90,520,0.7557251908396947,0.5
60,55,145,75,150,40,525,0.2,45,100,135,65,135,45,525,0.29411764705882354,1.0
83,80,75,70,70,101,479,0.8615384615384616,60,80,95,70,85,50,440,0.2231404958677686,0.25
58,64,58,80,65,80,405,0.609271523178808,70,83,50,37,50,60,350,0.3360655737704918,1.0
76,48,48,57,62,34,325,0.11688311688311688,40,45,35,65,55,70,310,0.4482758620689655,0.5
80,80,90,110,130,110,600,0.8721804511278195,75,95,125,45,75,95,510,0.8257575757575758,2.0
55,65,95,95,45,85,440,0.6610169491525424,109,66,84,81,99,32,471,0.2013888888888889,2.0
38,30,41,30,41,60,240,0.2897196261682243,60,40,50,75,85,95,405,0.6044776119402985,1.0
70,110,180,60,60,50,530,0.4117647058823529,45,30,40,105,50,20,290,0.031007751937984496,1.0
125,170,100,120,90,95,700,0.77,45,35,45,62,53,35,275,0.11851851851851852,2.0
55,85,122,58,75,99,494,0.8099173553719008,43,70,48,50,60,38,309,0.2391304347826087,1.0
90,60,70,75,70,45,410,0.23880597014925373,78,104,78,159,115,100,634,0.8444444444444444,2.0
30,30,42,30,42,70,244,0.4230769230769231,50,53,62,58,63,44,330,0.13709677419354838,1.0
45,40,60,40,75,50,310,0.2926829268292683,50,35,55,25,25,15,205,0.05263157894736842,2.0
70,50,30,95,135,105,485,0.8040540540540541,45,22,60,27,30,29,213,0.07518796992481203,1.0
75,90,50,110,80,95,500,0.7985611510791367,70,55,95,95,110,65,490,0.48872180451127817,2.0
38,30,41,30,41,60,240,0.2897196261682243,61,90,45,50,50,160,456,0.9230769230769231,1.0
75,123,67,95,85,95,540,0.7642276422764228,50,30,55,65,55,20,275,0.13675213675213677,1.0
70,90,90,135,90,125,600,0.9401709401709402,95,65,65,110,130,60,525,0.4016393442622951,0.5
60,40,60,40,60,35,295,0.18055555555555555,75,80,70,65,75,90,455,0.7578125,0.25
99,68,83,72,87,51,460,0.417910447761194,51,65,65,80,75,59,395,0.4365079365079365,1.0
59,63,80,65,80,58,405,0.41843971631205673,89,124,80,55,80,55,483,0.5714285714285714,2.0
50,35,55,25,25,15,205,0.05263157894736842,45,65,34,40,34,45,263,0.2589928057553957,1.0
45,55,39,35,39,42,255,0.18518518518518517,55,81,60,50,70,97,413,0.7214285714285714,1.0
70,140,70,110,65,105,560,0.95,55,81,60,50,70,97,413,0.7214285714285714,1.0
30,65,100,45,25,40,305,0.1891891891891892,70,77,60,97,60,108,472,0.8394160583941606,1.0
90,95,105,165,110,45,610,0.2890625,60,82,45,45,45,74,351,0.5752212389380531,0.0
50,50,120,80,80,30,410,0.07258064516129033,62,48,66,59,57,49,341,0.33884297520661155,1.0
45,35,50,70,50,30,280,0.15753424657534246,38,30,85,55,65,30,303,0.21428571428571427,1.0
60,40,60,95,60,55,370,0.4222222222222222,45,50,35,55,75,40,300,0.21367521367521367,0.5
78,92,75,74,63,118,500,0.8842975206611571,78,84,78,109,85,100,534,0.8620689655172413,1.0
35,55,35,30,30,35,220,0.23684210526315788,70,77,60,97,60,108,472,0.8394160583941606,1.0
45,75,60,40,30,50,300,0.304,50,65,45,85,65,95,405,0.7238095238095238,1.0
60,40,80,60,45,40,325,0.23529411764705882,40,70,40,35,40,60,285,0.392,1.0
35,55,40,45,40,60,275,0.35714285714285715,41,50,37,50,37,66,281,0.5175438596491229,1.0
110,80,90,95,90,65,530,0.5033557046979866,45,50,43,40,38,62,278,0.40441176470588236,2.0
76,48,48,57,62,34,325,0.11688311688311688,73,76,75,81,100,100,505,0.8110236220472441,2.0
38,35,35,65,55,50,278,0.2647058823529412,60,80,50,40,40,30,300,0.15328467153284672,1.0
50,75,45,40,45,60,315,0.4380165289256198,100,120,100,150,120,90,680,0.728,0.5
115,140,130,55,55,40,535,0.4519230769230769,75,105,75,105,75,45,480,0.3274336283185841,1.0
71,95,85,110,95,79,535,0.664,80,100,70,60,70,95,475,0.7416666666666667,2.0
60,100,115,70,85,90,520,0.7557251908396947,54,78,103,53,45,22,355,0.23255813953488372,1.0
70,60,62,80,82,60,414,0.4375,50,45,45,35,35,50,260,0.23529411764705882,1.0
91,72,90,129,90,108,580,0.8620689655172413,80,70,70,90,100,70,480,0.5609756097560976,0.25
60,85,60,85,60,55,405,0.3673469387755102,70,140,70,110,65,105,560,0.95,1.0
65,95,57,100,85,93,495,0.7441860465116279,35,46,34,35,45,20,215,0.072,1.0
110,130,80,70,60,80,530,0.5862068965517241,60,60,60,105,105,105,495,0.848,1.0
91,134,95,100,100,80,600,0.6304347826086957,44,58,44,58,44,61,309,0.41964285714285715,1.0
105,140,55,30,55,95,480,0.8195488721804511,50,55,50,36,30,43,264,0.2922077922077922,1.0
55,45,50,45,65,80,340,0.5546218487394958,40,27,60,37,50,66,280,0.36220472440944884,1.0
110,78,73,76,71,60,468,0.3333333333333333,40,40,35,50,100,70,335,0.5031847133757962,1.0
90,100,60,90,60,80,480,0.6422764227642277,66,65,48,62,57,52,350,0.36220472440944884,0.5
70,65,65,55,55,70,380,0.5,45,30,35,20,20,45,195,0.14782608695652175,1.0
50,70,160,70,160,90,600,0.7417218543046358,100,123,75,57,75,80,510,0.6923076923076923,1.0
54,45,47,75,98,52,371,0.39669421487603307,50,20,40,20,40,20,190,0.0962962962962963,1.0
65,50,35,115,95,95,455,0.7333333333333333,70,90,110,60,75,95,500,0.7333333333333333,0.0
95,124,78,69,71,58,495,0.37398373983739835,65,75,90,97,123,44,494,0.1987179487179487,0.5
80,120,80,120,80,100,580,0.8478260869565217,65,50,35,115,95,95,455,0.7333333333333333,0.5
70,55,75,45,65,60,370,0.45901639344262296,60,65,60,130,75,110,500,0.7719298245614035,2.0
58,50,145,95,105,30,483,0.2459016393442623,40,27,60,37,50,66,280,0.36220472440944884,1.0
35,40,100,90,55,35,355,0.1796875,55,50,40,40,40,75,300,0.5945945945945946,1.0
45,20,50,60,120,50,345,0.24074074074074073,75,98,63,98,63,101,498,0.889763779527559,2.0
45,30,40,105,50,20,290,0.031007751937984496,55,47,52,40,40,41,275,0.16806722689075632,2.0
75,90,140,60,60,40,465,0.3008130081300813,79,105,70,145,80,101,580,0.8608695652173913,0.25
79,85,60,55,60,71,410,0.60431654676259,60,70,105,70,120,75,500,0.5983606557377049,2.0
90,95,105,165,110,45,610,0.2890625,50,50,40,50,40,64,294,0.45588235294117646,2.0
75,110,110,110,105,80,590,0.656934306569343,70,85,65,105,85,120,530,0.9262295081967213,1.0
80,135,85,70,95,150,615,0.9844961240310077,72,60,30,20,30,25,237,0.11570247933884298,1.0
75,85,200,55,65,30,510,0.16778523489932887,60,50,150,50,150,60,520,0.5206611570247934,1.0
59,59,58,90,70,73,409,0.5826086956521739,55,69,85,32,35,28,304,0.09302325581395349,2.0
48,61,40,61,40,50,300,0.2543859649122807,75,80,55,25,35,35,305,0.18666666666666668,1.0
30,30,30,30,30,30,180,0.12612612612612611,85,110,76,65,82,56,474,0.3933333333333333,0.5
60,55,145,75,150,40,525,0.2,68,125,65,65,115,80,518,0.6277372262773723,0.5
100,120,120,150,100,90,680,0.7880794701986755,74,108,133,83,65,32,495,0.32142857142857145,1.0
70,110,80,55,80,105,500,0.8794326241134752,80,100,200,50,100,50,580,0.3472222222222222,0.5
100,50,50,76,96,70,442,0.5,123,100,62,97,81,68,531,0.4806201550387597,2.0
40,30,50,55,55,100,330,0.584070796460177,90,60,60,40,40,40,330,0.29545454545454547,0.0
104,91,63,91,73,68,490,0.5118110236220472,45,50,55,75,65,30,320,0.06293706293706294,1.0
60,55,50,40,55,45,305,0.22377622377622378,54,66,70,44,55,46,335,0.4214876033057851,1.0
81,102,77,85,75,85,505,0.5642857142857143,61,84,65,70,70,70,420,0.5,1.0
90,100,70,110,150,80,600,0.6037735849056604,72,60,30,20,30,25,237,0.11570247933884298,1.0
75,125,75,30,75,85,465,0.625,52,65,50,45,50,38,300,0.27419354838709675,2.0
75,80,85,110,90,50,490,0.3548387096774194,86,68,72,109,66,106,507,0.8099173553719008,0.5
115,140,130,55,55,40,535,0.4519230769230769,65,130,60,95,110,65,525,0.5303030303030303,4.0
75,80,55,25,35,35,305,0.18666666666666668,65,155,120,65,90,105,600,0.8677685950413223,0.25
80,130,100,160,120,110,700,0.8981481481481481,48,61,40,61,40,50,300,0.2543859649122807,2.0
90,120,75,60,60,45,450,0.29411764705882354,60,67,85,77,75,116,480,0.8888888888888888,1.0
75,125,70,125,70,115,580,0.9037037037037037,82,121,119,69,59,71,521,0.5394736842105263,1.0
100,100,80,60,60,50,450,0.3050847457627119,78,130,111,130,85,100,634,0.8561151079136691,2.0
62,48,54,63,60,68,355,0.5178571428571429,50,53,48,53,48,64,316,0.46153846153846156,1.0
10,55,25,35,45,95,265,0.5396825396825397,50,65,107,105,107,86,520,0.703125,2.0
30,40,70,70,25,60,295,0.41353383458646614,35,55,40,50,50,90,320,0.6838235294117647,1.0
50,50,77,95,77,91,440,0.5916666666666667,45,50,45,115,55,95,405,0.6936936936936937,2.0
72,60,30,20,30,25,237,0.11570247933884298,100,70,70,65,65,45,415,0.1897810218978102,2.0
60,80,50,40,40,30,300,0.15328467153284672,30,40,55,40,55,60,280,0.3237410071942446,2.0
45,50,55,75,65,30,320,0.06293706293706294,80,185,115,40,105,75,600,0.6230769230769231,0.5
80,130,100,160,120,110,700,0.8981481481481481,90,120,100,150,120,100,680,0.7718120805369127,2.0
79,103,120,135,115,78,630,0.5763888888888888,70,85,140,85,70,20,470,0.272,2.0
78,130,111,130,85,100,634,0.8561151079136691,85,120,70,50,60,100,485,0.8308823529411765,1.0
70,90,90,135,90,125,600,0.9401709401709402,90,85,75,115,100,115,580,0.9381443298969072,1.0
58,64,58,80,65,80,405,0.609271523178808,70,77,60,97,60,108,472,0.8394160583941606,2.0
65,85,70,75,70,40,405,0.203125,50,65,107,105,107,86,520,0.7313432835820896,0.25
95,155,109,70,130,81,640,0.6788321167883211,100,100,90,150,140,90,670,0.71875,0.5
66,41,77,61,87,23,355,0.12096774193548387,85,115,80,105,80,50,515,0.3063063063063063,1.0
50,50,120,80,80,30,410,0.07258064516129033,38,30,41,30,41,60,240,0.2897196261682243,1.0
59,45,40,35,40,31,250,0.14285714285714285,45,90,20,65,20,65,305,0.5116279069767442,1.0
70,90,45,15,45,50,315,0.3629032258064516,54,66,70,44,55,46,335,0.4214876033057851,2.0
60,45,70,45,90,95,405,0.7304964539007093,60,62,50,62,60,40,334,0.18181818181818182,0.5
55,68,64,45,55,31,318,0.11666666666666667,70,94,50,94,50,66,424,0.48148148148148145,0.25
110,123,65,100,65,65,528,0.5217391304347826,65,95,75,55,55,85,430,0.6933333333333334,0.25
44,48,65,50,64,43,314,0.1623931623931624,61,84,65,70,70,70,420,0.5,0.5
106,130,90,110,154,90,680,0.719626168224299,90,92,87,75,85,76,505,0.5409836065573771,1.0
49,49,56,49,61,66,330,0.5190839694656488,123,77,72,99,92,58,521,0.4621212121212121,2.0
125,120,90,170,100,95,700,0.78125,50,72,35,35,35,65,292,0.5373134328358209,2.0
75,75,55,105,85,30,425,0.1619718309859155,60,52,168,47,138,30,495,0.19834710743801653,1.0
50,50,95,40,50,35,320,0.20279720279720279,40,40,40,70,40,20,250,0.032520325203252036,2.0
62,44,50,44,50,55,305,0.3629032258064516,85,105,100,79,83,78,530,0.5869565217391305,0.5
45,53,70,40,60,42,310,0.25735294117647056,40,80,35,35,45,70,305,0.4661016949152542,0.5
75,95,95,95,95,85,540,0.6470588235294118,75,87,63,87,63,98,473,0.865546218487395,0.5
65,105,60,60,70,95,455,63.0,62,48,66,59,57,49,341,0.33884297520661155,0.5
45,22,60,27,30,29,213,0.07518796992481203,70,110,80,55,80,105,500,0.8794326241134752,0.5
70,90,90,135,90,125,600,0.9401709401709402,60,85,42,85,42,91,405,0.8227848101265823,0.5
76,65,45,92,42,91,411,0.7449664429530202,65,40,50,125,60,30,370,0.07258064516129033,1.0
70,83,50,37,50,60,350,0.3360655737704918,100,120,120,150,100,90,680,0.7880794701986755,0.25
95,75,80,100,110,30,490,0.24242424242424243,115,140,130,55,55,40,535,0.4519230769230769,8.0
45,35,50,70,50,30,280,0.15753424657534246,100,100,100,100,100,100,600,0.8345864661654135,0.5
80,160,80,130,80,100,630,0.8455284552845529,35,64,85,74,55,32,345,0.19827586206896552,0.5
55,84,105,114,75,52,485,0.2890625,60,90,55,90,80,110,485,0.8677685950413223,1.0
95,75,80,100,110,30,490,0.24242424242424243,100,103,75,120,75,127,600,0.940677966101695,0.5
70,120,65,45,85,125,510,0.9747899159663865,55,47,52,40,40,41,275,0.16806722689075632,1.0
50,80,95,10,45,10,290,0.232,30,80,90,55,45,55,355,0.4295774647887324,1.0
40,40,40,70,40,20,250,0.032520325203252036,60,115,105,65,70,80,495,0.7181818181818181,0.25
60,60,60,35,35,30,280,0.11194029850746269,60,95,80,60,80,30,405,0.19480519480519481,1.0
55,50,45,135,95,120,500,0.7714285714285715,100,123,75,57,75,80,510,0.6923076923076923,1.0
50,70,50,50,50,40,310,0.16296296296296298,86,92,88,68,75,73,482,0.6835443037974683,1.0
100,50,50,76,96,70,442,0.5,40,55,30,30,30,60,245,0.43548387096774194,1.0
67,125,40,30,30,58,350,0.3431372549019608,105,95,80,40,80,90,490,0.753968253968254,1.0
85,105,100,79,83,78,530,0.5869565217391305,95,135,80,110,80,100,600,0.8248175182481752,0.5
90,100,90,125,85,90,580,0.7352941176470589,38,30,41,30,41,60,240,0.2897196261682243,1.0
130,85,80,85,95,60,535,0.43884892086330934,73,76,75,81,100,100,505,0.8110236220472441,1.0
110,65,105,55,95,80,510,0.6258503401360545,95,60,79,100,125,81,540,0.6201550387596899,1.0
40,40,55,40,70,55,300,0.40939597315436244,70,70,70,70,70,70,420,0.5289256198347108,1.0
40,45,40,35,35,56,251,0.373015873015873,76,65,45,92,42,91,411,0.7449664429530202,1.0
45,20,50,60,120,50,345,0.24074074074074073,48,72,48,72,48,48,336,0.25984251968503935,1.0
130,70,35,70,35,60,400,0.4017857142857143,30,45,135,45,90,30,375,0.09285714285714286,2.0
59,59,58,90,70,73,409,0.5826086956521739,105,30,105,140,105,55,540,0.3524590163934426,0.5
55,70,55,40,55,85,360,0.7073170731707317,40,45,40,35,35,56,251,0.373015873015873,1.0
77,85,51,55,51,65,384,0.5163934426229508,45,40,60,40,75,50,310,0.2926829268292683,0.5
69,55,45,55,55,15,294,0.11666666666666667,72,85,70,65,70,58,420,0.41304347826086957,0.5
75,98,63,98,63,101,498,0.849624060150376,100,150,140,100,90,90,670,0.7969924812030075,2.0
85,80,90,105,95,60,515,0.49074074074074076,35,80,50,50,70,120,405,0.84375,1.0
40,40,55,40,70,55,300,0.40939597315436244,70,75,80,135,80,135,575,0.917910447761194,2.0
50,48,43,46,41,60,288,0.47297297297297297,105,150,90,150,90,95,680,0.8285714285714286,0.0
70,80,102,80,102,40,474,0.2677165354330709,40,70,130,60,130,25,455,0.17355371900826447,0.5
95,65,110,60,130,65,525,0.5275590551181102,70,65,65,55,55,70,380,0.5,1.0
65,136,94,54,96,135,580,0.9612403100775194,40,40,55,40,70,55,300,0.40939597315436244,0.5
95,100,85,108,70,70,528,0.5652173913043478,45,30,15,85,65,65,305,0.36220472440944884,1.0
55,130,115,50,50,75,475,0.5982142857142857,78,84,78,109,85,100,534,0.8646616541353384,2.0
43,80,65,50,35,35,308,0.14193548387096774,86,81,97,81,107,43,495,0.203125,1.0
55,70,45,70,50,60,350,0.45,70,140,230,60,80,50,630,0.32432432432432434,2.0
70,105,105,50,40,20,390,0.33587786259541985,60,40,60,40,60,35,295,0.18055555555555555,1.0
30,45,135,45,90,30,375,0.09285714285714286,106,150,70,194,120,140,780,0.952,1.0
30,105,90,25,25,50,325,0.2773722627737226,45,30,50,55,65,45,290,0.208,1.0
79,100,80,110,90,121,580,0.968,75,69,72,114,100,104,534,0.8253968253968254,1.0
30,45,59,30,39,57,260,0.2803030303030303,100,164,150,95,120,71,700,0.5645161290322581,1.0
120,120,120,120,120,120,720,0.9344262295081968,60,105,60,120,60,105,510,0.8849557522123894,1.0
40,55,70,45,60,30,300,0.10619469026548672,45,35,50,70,50,30,280,0.15753424657534246,1.0
80,105,105,105,105,80,580,0.5939849624060151,70,65,60,90,75,90,450,0.6571428571428571,2.0
60,130,80,60,60,70,460,0.5153846153846153,110,80,90,95,90,65,530,0.5033557046979866,4.0
95,100,85,108,70,70,528,0.5652173913043478,100,150,140,100,90,90,670,0.7969924812030075,2.0
55,55,55,85,55,30,335,0.1320754716981132,75,75,95,75,95,113,528,0.9015151515151515,1.0
51,65,65,80,75,59,395,0.4365079365079365,100,77,77,128,128,90,600,0.6901408450704225,1.0
100,150,90,180,160,90,770,0.7348484848484849,61,72,57,55,55,65,365,0.3984375,1.0
62,77,62,50,42,65,358,0.4838709677419355,90,95,95,70,90,70,510,0.5230769230769231,2.0
50,65,85,35,35,55,325,0.32575757575757575,75,125,230,55,95,30,610,0.3448275862068966,0.125
90,93,55,70,55,55,418,0.3819444444444444,100,5,5,15,65,30,220,0.07692307692307693,2.0
58,70,45,40,45,42,300,0.25925925925925924,85,80,90,105,95,60,515,0.49074074074074076,1.0
90,85,100,95,125,85,580,0.6834532374100719,68,72,78,38,42,32,330,0.23809523809523808,2.0
74,48,76,83,81,104,466,0.7913043478260869,83,106,65,86,65,85,490,0.6640625,2.0
58,64,58,80,65,80,405,0.5423728813559322,63,120,85,90,55,55,468,0.2809917355371901,0.5
72,85,70,65,70,58,420,0.41304347826086957,106,110,90,154,90,130,680,0.926829268292683,2.0
45,55,39,35,39,42,255,0.18518518518518517,65,65,60,110,95,130,525,0.9253731343283582,1.0
65,105,60,60,70,95,455,63.0,50,65,90,35,35,15,290,0.14678899082568808,0.5
80,110,120,130,90,70,600,0.6198347107438017,72,58,80,103,80,97,490,0.7171052631578947,1.0
72,60,30,20,30,25,237,0.11570247933884298,55,68,64,45,55,31,318,0.11666666666666667,1.0
50,120,53,35,110,87,455,0.640625,55,40,50,65,85,40,335,0.3181818181818182,0.0
20,25,45,70,90,60,310,0.30833333333333335,60,50,150,50,150,60,520,0.5206611570247934,0.25
72,95,67,103,71,122,530,0.9606299212598425,65,90,122,58,75,84,494,0.71875,1.0
65,40,70,80,140,70,465,0.5954198473282443,35,55,40,45,40,60,275,0.35714285714285715,0.5
44,58,44,58,44,61,309,0.41964285714285715,60,150,50,150,50,60,520,0.5,2.0
160,110,65,65,110,30,540,0.35714285714285715,60,79,105,59,85,36,424,0.17054263565891473,1.0
50,75,70,35,70,48,348,0.29357798165137616,74,48,76,83,81,104,466,0.7913043478260869,1.0
70,90,45,15,45,50,315,0.3629032258064516,79,100,80,110,90,121,580,0.968,1.0
90,90,85,125,90,100,580,0.768595041322314,55,70,45,70,50,60,350,0.45,1.0
45,55,39,35,39,42,255,0.18518518518518517,73,76,75,81,100,100,505,0.8110236220472441,1.0
89,145,90,105,80,91,600,0.8549618320610687,123,77,72,99,92,58,521,0.4621212121212121,1.0
58,89,77,45,45,48,362,0.3177570093457944,50,72,35,35,35,65,292,0.5373134328358209,0.5
40,70,40,35,40,60,285,0.392,70,60,70,87,78,85,450,0.6228070175438597,1.0
70,77,60,97,60,108,472,0.8394160583941606,55,45,43,55,43,72,313,0.5853658536585366,2.0
95,110,95,40,95,55,490,0.40336134453781514,62,73,55,56,52,84,382,0.7244094488188977,1.0
45,95,50,40,50,75,355,0.54,45,40,60,40,75,50,310,0.2926829268292683,1.0
83,80,75,70,70,101,479,0.8615384615384616,84,86,88,111,101,60,530,0.4634146341463415,0.25
82,80,86,85,75,72,480,0.6183206106870229,40,45,40,62,60,60,307,0.33884297520661155,0.5
48,72,48,72,48,48,336,0.25984251968503935,100,100,100,100,100,100,600,0.8602941176470589,1.0
91,134,95,100,100,80,600,0.6304347826086957,90,92,75,92,85,60,494,0.49586776859504134,2.0
65,50,35,115,95,95,455,0.7333333333333333,50,65,107,105,107,86,520,0.7313432835820896,2.0
44,38,33,61,43,70,289,0.5267857142857143,70,80,70,80,70,110,480,0.6594202898550725,0.0
75,55,70,55,95,110,460,0.8444444444444444,65,60,110,130,95,65,525,0.47761194029850745,1.0
50,180,20,180,20,150,600,0.9029850746268657,49,55,42,42,37,85,310,0.6068376068376068,1.0
103,60,126,80,126,50,545,0.36363636363636365,74,48,76,83,81,104,466,0.7322834645669292,1.0
100,100,100,100,100,100,600,0.8805970149253731,54,63,52,83,56,97,405,0.7697841726618705,0.5
60,82,45,45,45,74,351,0.5752212389380531,60,130,80,60,60,70,460,0.5153846153846153,0.25
35,40,100,90,55,35,355,0.1796875,75,87,63,87,63,98,473,0.865546218487395,1.0
65,65,65,50,50,90,385,0.72,70,55,65,95,85,70,440,0.5307692307692308,2.0
50,50,120,80,80,30,410,0.07258064516129033,75,98,63,98,63,101,498,0.889763779527559,1.0
50,70,100,40,40,30,330,0.2222222222222222,78,92,75,74,63,118,500,0.8842975206611571,1.0
40,20,30,40,80,55,265,0.22764227642276422,125,130,90,130,90,95,660,0.7734375,1.0
90,30,15,40,20,15,210,0.043478260869565216,61,72,57,55,55,65,365,0.3984375,0.5
105,125,100,60,100,100,590,0.8359375,51,65,65,80,75,59,395,0.4365079365079365,1.0
38,35,40,27,25,35,200,0.08208955223880597,65,63,45,45,45,45,308,0.2595419847328244,0.5
25,35,70,95,55,45,325,0.16783216783216784,45,30,50,55,65,45,290,0.208,1.0
86,76,86,116,56,95,515,0.7982456140350878,63,60,55,50,50,71,349,0.5289256198347108,0.5
70,90,90,135,90,125,600,0.9401709401709402,95,95,85,125,65,55,520,0.3894736842105263,2.0
48,72,48,72,48,48,336,0.25984251968503935,50,70,100,40,40,30,330,0.2222222222222222,0.5
85,120,70,50,60,100,485,0.8308823529411765,50,53,48,53,48,64,316,0.358974358974359,1.0
25,35,70,95,55,45,325,0.16783216783216784,80,82,78,95,80,85,500,0.6869565217391305,1.0
80,80,80,80,80,80,480,0.5606060606060606,105,30,105,140,105,55,540,0.3524590163934426,2.0
91,72,90,129,90,108,580,0.8620689655172413,55,70,55,40,55,85,360,0.7073170731707317,2.0
84,71,43,71,43,48,360,0.25874125874125875,85,70,80,97,80,123,535,0.9304347826086956,1.0
95,124,78,69,71,58,495,0.37398373983739835,55,70,40,60,40,40,305,0.26956521739130435,2.0
120,120,120,120,120,120,720,0.9344262295081968,70,135,105,60,105,20,495,0.5806451612903226,0.5
95,117,184,44,46,28,514,0.2975206611570248,60,85,69,60,69,77,420,0.518796992481203,1.0
75,80,85,110,90,50,490,0.3548387096774194,44,38,39,61,79,42,303,0.2251655629139073,2.0
95,109,105,75,85,56,525,0.34513274336283184,120,100,85,30,85,45,465,0.22448979591836735,1.0
62,55,52,109,94,109,481,0.7833333333333333,80,80,90,110,130,110,600,0.8721804511278195,0.5
60,60,60,105,105,105,495,0.848,40,40,55,40,70,55,300,0.40939597315436244,2.0
75,80,95,90,100,50,490,0.2158273381294964,40,50,45,70,45,70,320,0.5517241379310345,0.5
40,55,30,30,30,85,270,0.688,50,65,107,105,107,86,520,0.7272727272727273,0.5
55,66,44,44,56,85,350,0.6888888888888889,50,95,95,35,110,70,455,0.5179856115107914,1.0
106,90,130,90,154,110,680,0.8699186991869918,90,100,70,110,150,80,600,0.6037735849056604,1.0
35,55,35,30,30,35,220,0.23684210526315788,63,63,47,41,41,74,329,0.56,0.5
135,85,40,40,85,5,390,0.6864406779661016,55,45,45,25,25,15,210,0.048,1.0
65,60,110,130,95,65,525,0.47761194029850745,80,80,90,110,130,110,600,0.8721804511278195,2.0
65,90,50,85,45,55,390,0.371900826446281,90,65,65,40,40,15,315,0.19672131147540983,2.0
65,60,70,85,75,40,395,0.1796875,75,80,70,65,75,90,455,0.7578125,1.0
66,117,70,40,50,67,410,0.4573643410852713,65,150,60,115,60,115,565,0.935251798561151,1.0
75,38,38,56,56,67,330,0.5263157894736842,55,70,40,60,40,40,305,0.26956521739130435,1.0
110,78,73,76,71,60,468,0.3333333333333333,79,100,80,110,90,121,580,0.968,0.0
67,58,57,81,67,101,431,0.8790322580645161,65,125,100,55,70,85,500,0.6532258064516129,1.0
50,85,85,55,55,50,380,0.3902439024390244,45,90,20,65,20,65,305,0.5116279069767442,1.0
60,60,75,60,75,80,410,0.7321428571428571,75,89,85,55,65,36,405,0.29545454545454547,1.0
55,104,105,94,75,52,485,0.36363636363636365,80,80,80,80,80,80,480,0.5606060606060606,0.5
95,75,80,100,110,30,490,0.24242424242424243,89,124,80,55,80,55,483,0.5714285714285714,4.0
100,100,100,100,100,100,600,0.8345864661654135,85,56,77,50,77,78,423,0.53125,4.0
45,67,60,35,50,63,320,0.5128205128205128,60,85,60,50,50,125,430,0.9090909090909091,1.0
105,125,100,60,100,100,590,0.8359375,65,90,115,45,115,58,488,0.5041322314049587,1.0
60,40,60,95,60,55,370,0.4222222222222222,68,90,65,50,55,82,410,0.6165413533834586,0.5
75,110,110,110,105,80,590,0.656934306569343,20,40,90,30,90,25,295,0.11363636363636363,1.0
75,98,63,98,63,101,498,0.849624060150376,65,105,60,60,70,95,455,63.0,1.0
30,35,30,100,35,80,310,0.4765625,75,55,70,55,95,110,460,0.8444444444444444,2.0
55,112,45,74,45,70,401,0.559322033898305,65,95,75,55,55,85,430,0.6933333333333334,1.0
60,65,80,170,95,130,600,0.8625954198473282,58,70,45,40,45,42,300,0.25925925925925924,0.5
45,30,50,55,65,45,290,0.208,60,59,85,79,105,36,424,0.16666666666666666,1.0
65,95,57,100,85,93,495,0.7441860465116279,70,105,105,50,40,20,390,0.33587786259541985,0.5
38,35,35,65,55,50,278,0.2647058823529412,55,50,40,40,40,75,300,0.5945945945945946,1.0
82,80,86,85,75,72,480,0.6183206106870229,106,150,70,194,120,140,780,0.952,1.0
61,84,65,70,70,70,420,0.5,45,90,20,65,20,65,305,0.5116279069767442,1.0
58,64,58,80,65,80,405,0.5423728813559322,39,52,43,60,50,65,309,0.5041322314049587,0.5
170,90,45,90,45,60,500,0.427536231884058,65,65,60,130,95,110,525,0.823943661971831,1.0
80,135,85,70,95,150,615,0.9844961240310077,40,40,55,40,70,55,300,0.40939597315436244,0.5
60,60,60,60,60,60,360,0.38095238095238093,78,130,111,130,85,100,634,0.8561151079136691,1.0
72,105,115,54,86,68,500,0.5149253731343284,68,75,53,83,113,60,452,0.45384615384615384,0.5
75,105,75,105,75,45,480,0.3274336283185841,45,50,45,115,55,95,405,0.6936936936936937,1.0
86,92,88,68,75,73,482,0.6835443037974683,59,45,40,35,40,31,250,0.14285714285714285,1.0
45,49,49,65,65,45,318,0.2781954887218045,75,75,95,75,95,113,528,0.9015151515151515,1.0
30,40,70,70,25,60,295,0.41353383458646614,70,80,102,80,102,40,474,0.2677165354330709,1.0
55,50,40,40,40,75,300,0.5945945945945946,75,110,110,110,105,80,590,0.656934306569343,1.0
65,60,110,130,95,65,525,0.47761194029850745,100,100,100,100,100,100,600,0.8778625954198473,0.5
76,147,90,60,70,97,540,0.8267716535433071,50,95,180,85,45,70,525,0.5298507462686567,1.0
55,50,65,175,95,150,590,0.7818181818181819,76,48,48,57,62,34,325,0.11688311688311688,1.0
58,89,77,45,45,48,362,0.3177570093457944,58,64,58,80,65,80,405,0.609271523178808,2.0
65,83,57,95,85,105,490,0.8914728682170543,80,185,115,40,105,75,600,0.6230769230769231,1.0
65,50,35,115,95,95,455,0.7333333333333333,54,45,47,75,98,52,371,0.39669421487603307,1.0
70,95,125,65,75,45,475,0.33613445378151263,50,85,85,55,55,50,380,0.3902439024390244,0.125
85,80,90,105,95,60,515,0.49074074074074076,95,117,80,65,70,92,519,0.8409090909090909,1.0
65,125,100,55,70,85,500,0.6532258064516129,70,75,60,105,60,105,475,0.88,1.0
99,68,83,72,87,51,460,0.417910447761194,49,55,42,42,37,85,310,0.6068376068376068,1.0
35,40,100,90,55,35,355,0.1796875,70,105,105,50,40,20,390,0.33587786259541985,2.0
49,66,70,44,55,51,335,0.4260869565217391,80,145,150,105,110,110,700,0.8692307692307693,1.0
70,85,65,105,85,120,530,0.9262295081967213,60,100,115,70,85,90,520,0.7557251908396947,0.5
60,48,45,43,90,42,328,0.21897810218978103,90,50,34,60,44,70,348,0.6283185840707964,1.0
50,20,55,25,25,30,205,0.09774436090225563,91,90,106,130,106,77,600,0.648854961832061,0.25
64,51,23,51,23,28,240,0.11363636363636363,78,81,71,74,69,126,499,0.9090909090909091,1.0
43,30,55,40,65,97,330,0.6030534351145038,56,61,65,48,45,38,313,0.17567567567567569,0.5
70,100,70,105,75,40,460,0.23214285714285715,39,52,43,60,50,65,309,0.49107142857142855,1.0
65,155,120,65,90,105,600,0.8677685950413223,60,85,60,85,60,55,405,0.3673469387755102,0.5
85,120,70,50,60,100,485,0.8308823529411765,84,86,88,111,101,60,530,0.4634146341463415,0.25
20,40,90,30,90,25,295,0.11363636363636363,91,72,90,129,90,108,580,0.8620689655172413,1.0
75,75,130,75,130,95,580,0.7479674796747967,55,95,115,45,45,35,390,0.2116788321167883,2.0
55,55,50,45,65,55,325,0.37373737373737376,123,100,62,97,81,68,531,0.4806201550387597,1.0
40,30,30,55,30,85,270,0.4666666666666667,100,120,120,150,100,90,680,0.7880794701986755,0.25
80,115,80,65,55,93,488,0.7846153846153846,38,35,40,27,25,35,200,0.08208955223880597,2.0
38,41,40,50,65,65,299,0.4108527131782946,50,75,75,65,65,50,380,0.4049586776859504,1.0
30,40,55,40,55,60,280,0.3237410071942446,60,100,85,80,85,100,510,0.7007874015748031,0.25
50,65,107,105,107,86,520,0.6991150442477876,95,117,184,44,46,28,514,0.2975206611570248,2.0
85,50,95,120,115,80,545,0.5793650793650794,65,105,60,60,70,95,455,63.0,4.0
80,130,100,160,120,110,700,0.8981481481481481,75,125,230,55,95,30,610,0.3448275862068966,0.5
80,105,105,105,105,80,580,0.5939849624060151,114,85,70,85,80,30,464,0.2066115702479339,2.0
50,50,62,40,62,65,329,0.4188034188034188,105,130,120,45,45,40,485,0.4444444444444444,0.25
45,60,32,50,32,76,295,0.5925925925925926,75,90,50,110,80,95,500,0.7985611510791367,1.0
85,60,65,135,105,100,550,0.7518248175182481,65,75,105,35,65,85,430,0.6940298507462687,0.5
84,71,43,71,43,48,360,0.25874125874125875,105,140,95,55,65,45,505,0.3,1.0
80,185,115,40,105,75,600,0.6230769230769231,60,95,80,60,80,30,405,0.19480519480519481,1.0
90,100,90,125,85,90,580,0.7352941176470589,100,103,75,120,75,127,600,0.940677966101695,4.0
85,97,66,105,66,65,484,0.47107438016528924,78,84,78,109,85,100,534,0.8646616541353384,0.5
51,65,65,80,75,59,395,0.4365079365079365,60,50,50,60,70,50,340,0.28346456692913385,1.0
103,60,126,80,126,50,545,0.36363636363636365,79,115,70,125,80,111,580,0.8468468468468469,1.0
105,30,105,140,105,55,540,0.3524590163934426,60,100,115,70,85,90,520,0.7557251908396947,1.0
70,100,70,105,75,40,460,0.23214285714285715,62,48,66,59,57,49,341,0.33884297520661155,1.0
50,150,50,150,50,150,600,0.9339622641509434,60,62,50,62,60,40,334,0.18181818181818182,1.0
65,47,55,73,75,85,400,0.65,120,120,120,120,120,120,720,0.9344262295081968,1.0
60,90,140,50,50,40,430,0.2535211267605634,45,65,34,40,34,45,263,0.2589928057553957,0.5
50,47,50,57,50,65,319,0.463768115942029,75,105,75,105,75,45,480,0.3274336283185841,2.0
89,124,80,55,80,55,483,0.5714285714285714,80,135,85,70,95,150,615,0.9844961240310077,0.0
62,44,50,44,50,55,305,0.3629032258064516,58,70,45,40,45,42,300,0.25925925925925924,1.0
45,49,49,65,65,45,318,0.2781954887218045,61,84,65,70,70,70,420,0.5,0.5
67,58,57,81,67,101,431,0.8790322580645161,50,105,125,55,95,50,480,0.375886524822695,0.5
65,76,84,54,96,105,480,0.9008264462809917,40,35,30,120,70,105,400,0.6692307692307692,1.0
60,85,40,30,45,68,328,0.6422018348623854,59,63,80,65,80,58,405,0.41843971631205673,1.0
50,50,120,80,80,30,410,0.07258064516129033,65,136,94,54,96,135,580,0.9612403100775194,0.5
80,125,75,40,95,85,500,0.6911764705882353,83,80,75,70,70,101,479,0.8615384615384616,0.5
70,95,85,55,65,70,440,0.5,75,90,90,140,90,115,600,0.9481481481481482,0.0
65,45,55,45,70,45,325,0.24369747899159663,70,55,95,95,110,65,490,0.48872180451127817,1.0
20,40,90,30,90,25,295,0.11363636363636363,65,83,57,95,85,105,490,0.8914728682170543,1.0
150,160,100,95,65,100,670,0.8866666666666667,80,80,80,80,80,80,480,0.6015037593984962,1.0
70,110,70,115,70,90,525,0.75,75,55,70,55,95,110,460,0.8444444444444444,0.5
50,52,48,65,50,55,320,0.33098591549295775,45,25,50,25,25,35,205,0.13076923076923078,1.0
130,65,60,110,95,65,525,0.5227272727272727,60,55,90,145,90,80,520,0.6071428571428571,2.0
115,140,130,55,55,40,535,0.4519230769230769,95,75,180,130,80,30,590,0.13793103448275862,1.0
30,65,100,45,25,40,305,0.1891891891891892,90,50,34,60,44,70,348,0.6283185840707964,1.0
62,73,55,56,52,84,382,0.7244094488188977,50,60,45,100,80,65,400,0.45689655172413796,4.0
190,33,58,33,58,33,405,0.13432835820895522,85,76,64,45,55,90,415,0.6739130434782609,1.0
95,80,105,40,70,100,490,0.8046875,85,105,55,85,50,115,495,0.9032258064516129,1.0
40,30,30,40,50,30,220,0.07936507936507936,100,150,120,120,100,90,680,0.6493506493506493,0.25
108,170,115,120,95,92,700,0.7083333333333334,65,65,60,110,95,130,525,0.9253731343283582,2.0
80,100,70,50,60,45,405,0.25806451612903225,72,105,115,54,86,68,500,0.5149253731343284,2.0
55,75,60,75,60,103,428,0.7982456140350878,20,10,230,10,230,5,505,0.0,1.0
90,75,85,115,90,55,510,0.3445378151260504,35,46,34,35,45,20,215,0.072,1.0
60,75,85,100,85,115,520,0.8992248062015504,78,52,60,63,65,23,341,0.06015037593984962,1.0
70,115,60,115,60,55,475,0.4647887323943662,70,110,70,115,70,90,525,0.75,0.25
95,117,184,44,46,28,514,0.2975206611570248,70,60,75,110,75,90,480,0.7165354330708661,2.0
70,80,70,80,70,110,480,0.6594202898550725,75,70,90,70,105,80,490,0.656,4.0
75,95,67,125,95,83,540,0.7117117117117117,80,45,65,90,110,80,470,0.5462962962962963,1.0
67,57,55,77,55,114,425,0.8879310344827587,64,51,23,51,23,28,240,0.11363636363636363,1.0
40,45,40,35,35,56,251,0.373015873015873,90,70,80,70,95,70,475,0.5190839694656488,1.0
60,100,85,80,85,100,510,0.7007874015748031,70,20,50,20,50,40,250,0.1557377049180328,0.5
40,45,40,35,35,56,251,0.373015873015873,40,60,40,40,40,30,250,0.0948905109489051,2.0
70,90,45,15,45,50,315,0.3629032258064516,50,160,110,160,110,110,700,0.8854961832061069,0.5
60,65,60,130,75,110,500,0.7719298245614035,35,64,85,74,55,32,345,0.19827586206896552,1.0
110,65,75,125,85,30,490,0.15,55,55,55,85,55,30,335,0.1320754716981132,0.5
70,62,67,55,55,56,365,0.38513513513513514,58,64,58,80,65,80,405,0.5423728813559322,1.0
95,70,73,95,90,60,483,0.3983739837398374,105,125,100,60,100,100,590,0.8359375,1.0
52,65,55,58,62,60,352,0.4482758620689655,45,50,43,40,38,62,278,0.40441176470588236,1.0
65,136,94,54,96,135,580,0.9612403100775194,35,55,35,30,30,35,220,0.23684210526315788,2.0
70,55,65,95,85,70,440,0.5307692307692308,80,110,120,130,90,70,600,0.6198347107438017,2.0
60,50,70,50,90,65,385,0.39568345323741005,109,66,84,81,99,32,471,0.2013888888888889,0.5
100,120,120,150,100,90,680,0.7880794701986755,67,58,57,81,67,101,431,0.8790322580645161,0.0
20,25,45,70,90,60,310,0.30833333333333335,75,90,90,140,90,115,600,0.9481481481481482,0.0
30,105,90,25,25,50,325,0.2773722627737226,95,23,48,23,48,23,260,0.046153846153846156,1.0
40,35,30,120,70,105,400,0.6692307692307692,82,80,86,85,75,72,480,0.6183206106870229,1.0
120,120,120,120,120,120,720,0.9344262295081968,60,62,50,62,60,40,334,0.18181818181818182,1.0
80,100,200,50,100,50,580,0.3472222222222222,39,52,43,60,50,65,309,0.49107142857142855,2.0
65,130,60,95,110,65,525,0.5303030303030303,64,66,68,81,76,50,405,0.25190839694656486,0.5
95,75,80,100,110,30,490,0.24242424242424243,54,78,103,53,45,22,355,0.23255813953488372,1.0
92,105,90,125,90,98,600,0.8217054263565892,103,60,86,60,86,50,445,0.3458646616541353,1.0
50,50,50,50,50,50,300,0.30708661417322836,100,150,90,180,160,90,770,0.7348484848484849,0.5
44,50,91,24,86,10,305,0.1981981981981982,75,90,140,60,60,40,465,0.3008130081300813,0.125
85,105,85,40,50,40,405,0.211864406779661,99,68,83,72,87,51,460,0.417910447761194,0.5
105,180,100,180,100,115,780,0.9477611940298507,65,80,65,35,65,60,370,0.38405797101449274,1.0
59,110,150,45,49,35,448,0.3333333333333333,55,55,50,45,65,55,325,0.37373737373737376,0.0
65,150,60,115,60,115,565,0.935251798561151,78,70,61,50,61,100,420,0.8145161290322581,1.0
74,94,131,54,116,20,489,0.4485294117647059,75,140,65,112,65,110,567,0.9140625,2.0
45,60,40,70,50,45,310,0.2846715328467153,80,52,50,90,50,89,411,0.6666666666666666,2.0
60,70,65,125,105,90,515,0.6911764705882353,75,80,95,90,100,50,490,0.2158273381294964,1.0
70,60,62,80,82,60,414,0.4375,60,52,168,47,138,30,495,0.19834710743801653,0.125
67,125,40,30,30,58,350,0.3431372549019608,95,109,105,75,85,56,525,0.34513274336283184,0.5
45,75,37,70,55,83,365,0.6183206106870229,20,15,20,10,55,80,200,0.2682926829268293,0.5
78,84,78,109,85,100,534,0.8646616541353384,99,68,83,72,87,51,460,0.417910447761194,4.0
70,120,100,145,105,20,560,0.2824427480916031,80,100,200,50,100,50,580,0.3472222222222222,1.0
70,120,65,45,85,125,510,0.9747899159663865,100,5,5,15,65,30,220,0.07692307692307693,1.0
65,76,84,54,96,105,480,0.9008264462809917,55,63,90,50,80,42,380,0.21138211382113822,1.0
59,74,50,35,50,35,303,0.3125,72,105,115,54,86,68,500,0.5149253731343284,2.0
106,110,90,154,90,130,680,0.926829268292683,82,121,119,69,59,71,521,0.5394736842105263,1.0
80,135,130,95,90,70,600,0.5181818181818182,40,30,32,50,52,65,269,0.3671875,0.5
30,30,42,30,42,70,244,0.4230769230769231,90,60,60,40,40,40,330,0.29545454545454547,1.0
60,65,80,170,95,130,600,0.8625954198473282,70,45,48,60,65,35,323,0.15748031496062992,2.0
80,125,75,40,95,85,500,0.6911764705882353,80,80,80,80,80,80,480,0.5606060606060606,1.0
80,120,130,55,65,45,495,0.37037037037037035,100,134,110,95,100,61,600,0.4057971014492754,2.0
55,55,55,85,55,30,335,0.1320754716981132,100,100,125,110,50,50,535,0.384,1.0
50,35,55,25,25,15,205,0.05263157894736842,57,80,91,80,87,75,470,0.5737704918032787,0.25
72,95,67,103,71,122,530,0.9606299212598425,70,80,65,90,65,85,455,0.578125,2.0
62,55,52,109,94,109,481,0.7833333333333333,50,75,35,70,30,40,300,0.21296296296296297,0.5
65,75,105,35,65,85,430,0.6940298507462687,79,115,70,125,80,111,580,0.864,0.0
45,100,45,45,45,10,290,0.2949640287769784,105,150,90,150,90,95,680,0.8285714285714286,0.0
110,65,105,55,95,80,510,0.6258503401360545,110,80,90,95,90,65,530,0.5033557046979866,1.0
60,85,69,60,69,77,420,0.518796992481203,46,57,40,40,40,50,273,0.25,1.0
50,40,85,40,65,25,305,0.08870967741935484,59,63,80,65,80,58,405,0.41843971631205673,1.0
95,65,110,60,130,65,525,0.5275590551181102,60,40,60,40,60,35,295,0.18055555555555555,1.0
30,40,55,40,55,60,280,0.3237410071942446,20,10,230,10,230,5,505,0.0,1.0
114,85,70,85,80,30,464,0.2066115702479339,39,52,43,60,50,65,309,0.49107142857142855,0.5
50,75,35,70,30,40,300,0.21296296296296297,55,55,45,63,45,45,308,0.25,2.0
60,85,49,60,49,60,363,0.4444444444444444,55,68,64,45,55,31,318,0.11666666666666667,0.5
60,40,60,95,60,55,370,0.4222222222222222,70,85,65,105,85,120,530,0.9262295081967213,2.0
50,85,55,65,65,90,410,0.7478260869565218,60,85,69,65,79,80,438,0.576,1.0
70,90,45,15,45,50,315,0.3629032258064516,70,95,85,55,65,70,440,0.5,0.5
64,88,50,88,50,106,446,0.9111111111111111,79,105,70,145,80,101,580,0.8608695652173913,1.0
30,45,135,45,90,30,375,0.09285714285714286,70,90,70,60,60,70,420,0.6390977443609023,1.0
70,60,75,110,75,90,480,0.7165354330708661,95,110,95,40,95,55,490,0.40336134453781514,1.0
82,121,119,69,59,71,521,0.5394736842105263,75,100,63,80,63,116,497,0.9345794392523364,1.0
80,82,78,95,80,85,500,0.6869565217391305,69,69,76,69,86,91,460,0.6554621848739496,0.5
80,80,50,40,50,25,325,0.176056338028169,70,60,75,110,75,90,480,0.7165354330708661,2.0
65,65,45,75,45,95,390,0.72,75,80,95,90,100,50,490,0.2158273381294964,4.0
64,115,65,83,63,65,455,0.5323741007194245,100,164,150,95,120,71,700,0.5645161290322581,0.5
65,95,57,100,85,93,495,0.7441860465116279,95,145,130,120,90,120,700,0.9398496240601504,0.5
65,75,105,35,65,85,430,0.6940298507462687,50,75,70,35,70,48,348,0.29357798165137616,2.0
80,70,65,80,120,100,515,0.8034188034188035,60,60,75,60,75,80,410,0.7321428571428571,1.0
50,65,85,35,35,55,325,0.32575757575757575,58,64,58,80,65,80,405,0.609271523178808,1.0
100,100,90,150,140,90,670,0.71875,70,145,88,140,70,112,625,0.8888888888888888,1.0
70,60,75,110,75,90,480,0.7165354330708661,110,160,110,80,110,100,670,0.8591549295774648,1.0
70,110,180,60,60,50,530,0.4117647058823529,80,160,60,170,130,80,680,0.6180555555555556,1.0
90,30,15,40,20,15,210,0.043478260869565216,65,125,100,60,70,70,490,0.6099290780141844,0.5
50,65,85,35,35,55,325,0.32575757575757575,80,80,80,80,80,80,480,0.5606060606060606,1.0
75,98,63,98,63,101,498,0.8091603053435115,65,110,130,60,65,95,525,0.8278145695364238,0.5
43,80,65,50,35,35,308,0.14193548387096774,65,60,70,85,75,40,395,0.1796875,1.0
65,73,55,47,75,85,400,0.6846846846846847,75,65,55,65,55,69,384,0.43548387096774194,1.0
90,120,75,60,60,45,450,0.29411764705882354,76,65,45,92,42,91,411,0.7449664429530202,1.0
91,72,90,129,90,108,580,0.8925619834710744,80,80,80,55,55,90,440,0.6417910447761194,2.0
50,95,180,85,45,70,525,0.5298507462686567,65,85,70,75,70,40,405,0.203125,1.0
40,45,35,30,40,55,245,0.3793103448275862,60,40,60,95,60,55,370,0.4222222222222222,0.5
110,160,110,80,110,100,670,0.8591549295774648,55,112,45,74,45,70,401,0.559322033898305,0.5
75,80,55,25,35,35,305,0.18666666666666668,110,123,65,100,65,65,528,0.5217391304347826,1.0
70,50,30,95,135,105,485,0.8040540540540541,75,69,72,114,100,104,534,0.8253968253968254,0.5
90,130,80,65,85,55,505,0.4396551724137931,60,100,85,80,85,100,510,0.7007874015748031,0.5
55,85,122,58,75,99,494,0.8099173553719008,105,130,120,45,45,40,485,0.4444444444444444,4.0
65,100,70,80,80,105,500,0.8666666666666667,79,85,60,55,60,71,410,0.60431654676259,0.5
78,104,78,159,115,100,634,0.8444444444444444,103,60,126,80,126,50,545,0.36363636363636365,1.0
108,170,115,120,95,92,700,0.7083333333333334,110,123,65,100,65,65,528,0.5217391304347826,2.0
80,100,70,50,60,45,405,0.25806451612903225,50,75,45,40,45,60,315,0.4380165289256198,0.5
75,85,200,55,65,30,510,0.16778523489932887,75,80,70,65,75,90,455,0.7578125,0.0
61,90,45,50,50,160,456,0.9230769230769231,55,55,55,85,55,30,335,0.1320754716981132,2.0
59,110,150,45,49,35,448,0.3333333333333333,165,75,80,40,45,65,470,0.5151515151515151,0.5
105,95,80,40,80,90,490,0.753968253968254,99,68,83,72,87,51,460,0.417910447761194,1.0
95,117,184,44,46,28,514,0.2975206611570248,75,100,63,80,63,116,497,0.9345794392523364,1.0
90,75,75,90,100,70,500,0.5462184873949579,106,190,100,154,100,130,780,0.9259259259259259,1.0
45,67,60,35,50,63,320,0.5128205128205128,60,59,85,79,105,36,424,0.16666666666666666,0.5
75,87,63,87,63,98,473,0.865546218487395,70,110,75,145,85,145,630,0.9444444444444444,0.5
75,89,85,55,65,36,405,0.29545454545454547,125,130,90,130,90,95,660,0.7734375,0.5
90,130,80,65,85,55,505,0.4396551724137931,30,56,35,25,35,72,253,0.48148148148148145,2.0
65,95,100,60,50,50,420,0.34959349593495936,44,48,65,50,64,43,314,0.1623931623931624,1.0
70,55,95,95,110,65,490,0.48872180451127817,100,150,90,180,160,90,770,0.7348484848484849,1.0
115,140,130,55,55,40,535,0.4519230769230769,65,75,70,95,70,95,470,0.7272727272727273,0.0
45,80,100,35,37,28,325,0.3125,85,105,55,85,50,115,495,0.9032258064516129,0.5
91,90,106,130,106,77,600,0.648854961832061,85,50,95,120,115,80,545,0.5793650793650794,0.5
70,75,80,135,80,135,575,0.917910447761194,73,95,62,85,65,85,465,0.6666666666666666,1.0
43,80,65,50,35,35,308,0.14193548387096774,60,85,69,60,69,77,420,0.518796992481203,1.0
95,23,48,23,48,23,260,0.046153846153846156,35,85,45,35,35,75,310,0.6492537313432836,1.0
38,30,41,30,41,60,240,0.2897196261682243,75,75,95,75,95,113,528,0.9015151515151515,1.0
49,49,56,49,61,66,330,0.5190839694656488,55,66,44,44,56,85,350,0.6888888888888889,1.0
60,52,168,47,138,30,495,0.19834710743801653,60,55,50,40,55,45,305,0.22377622377622378,2.0
60,150,50,150,50,60,520,0.5,70,50,30,95,135,105,485,0.8040540540540541,2.0
37,25,41,25,41,25,194,0.08870967741935484,123,100,62,97,81,68,531,0.4806201550387597,2.0
55,50,40,40,40,75,300,0.5945945945945946,55,63,90,50,80,42,380,0.21138211382113822,1.0
50,65,107,105,107,86,520,0.7272727272727273,50,95,95,35,110,70,455,0.5179856115107914,2.0
65,60,110,130,95,65,525,0.47761194029850745,59,74,50,35,50,35,303,0.3125,2.0
45,65,34,40,34,45,263,0.2589928057553957,35,20,65,40,65,20,245,0.02459016393442623,1.0
40,60,30,31,31,70,262,0.4492753623188406,75,100,66,60,66,115,482,0.918918918918919,1.0
60,55,90,145,90,80,520,0.6071428571428571,90,120,120,60,60,50,500,0.35294117647058826,1.0
60,80,110,50,80,45,425,0.2833333333333333,123,77,72,99,92,58,521,0.4621212121212121,2.0
44,75,35,63,33,45,295,0.2647058823529412,50,100,150,100,150,50,600,0.37142857142857144,1.0
150,80,44,90,54,80,498,0.625,50,47,50,57,50,65,319,0.463768115942029,1.0
60,65,70,85,75,40,395,0.21705426356589147,100,128,90,77,77,128,600,0.959349593495935,1.0
106,190,100,154,100,130,780,0.9259259259259259,50,20,40,20,40,20,190,0.0962962962962963,1.0
55,66,44,44,56,85,350,0.6888888888888889,100,90,130,45,65,55,485,0.4253731343283582,0.5
75,70,90,70,105,80,490,0.656,75,75,75,125,95,40,485,0.15671641791044777,1.0
95,85,85,65,65,35,430,0.2571428571428571,75,90,140,60,60,40,465,0.3008130081300813,1.0
40,45,40,62,60,60,307,0.33884297520661155,53,51,53,61,56,40,314,0.14285714285714285,0.5
100,73,83,73,83,55,467,0.371900826446281,75,100,110,45,55,65,450,0.5333333333333333,0.5
60,55,145,75,150,40,525,0.2,90,50,34,60,44,70,348,0.6283185840707964,2.0
45,60,32,50,32,76,295,0.5925925925925926,1,90,45,30,30,40,236,0.33064516129032256,1.0
54,45,47,75,98,52,371,0.39669421487603307,130,85,80,85,95,60,535,0.43884892086330934,1.0
75,95,67,125,95,83,540,0.7117117117117117,85,105,55,85,50,115,495,0.9032258064516129,0.5
65,90,120,85,70,60,490,0.43410852713178294,45,95,50,40,50,75,355,0.54,0.5
75,87,63,87,63,98,473,0.865546218487395,130,85,80,85,95,60,535,0.43884892086330934,0.5
45,75,37,70,55,83,365,0.6183206106870229,85,110,76,65,82,56,474,0.3933333333333333,2.0
90,85,100,95,125,85,580,0.6834532374100719,40,40,35,50,100,70,335,0.5031847133757962,0.5
60,79,105,59,85,36,424,0.17054263565891473,91,72,90,129,90,108,580,0.8925619834710744,0.5
95,110,95,40,95,55,490,0.40336134453781514,79,85,60,55,60,71,410,0.60431654676259,1.0
72,60,30,20,30,25,237,0.11570247933884298,86,76,86,116,56,95,515,0.7982456140350878,0.25
40,55,80,35,60,30,300,0.15037593984962405,60,85,49,60,49,60,363,0.4444444444444444,0.5
38,30,85,55,65,30,303,0.21428571428571427,90,93,55,70,55,55,418,0.3819444444444444,1.0
80,80,50,40,50,25,325,0.176056338028169,75,90,140,60,60,40,465,0.3008130081300813,0.0
50,48,43,46,41,60,288,0.47297297297297297,100,150,120,120,100,90,680,0.6493506493506493,1.0
40,35,30,120,70,105,400,0.6692307692307692,125,58,58,76,76,67,460,0.515625,1.0
101,72,72,99,89,29,462,0.1937984496124031,40,29,45,29,45,36,224,0.14634146341463414,1.0
75,125,70,125,70,115,580,0.9037037037037037,40,55,99,40,79,47,360,0.26262626262626265,2.0
75,105,75,105,75,45,480,0.3274336283185841,55,112,45,74,45,70,401,0.559322033898305,2.0
91,72,90,129,90,108,580,0.8925619834710744,20,10,55,15,20,80,200,0.17985611510791366,0.5
97,165,60,65,50,58,495,0.3902439024390244,103,60,86,60,86,50,445,0.3458646616541353,1.0
80,115,80,65,55,93,488,0.7846153846153846,130,65,60,110,95,65,525,0.5227272727272727,1.0
70,120,65,45,85,125,510,0.9747899159663865,75,75,130,75,130,95,580,0.7479674796747967,2.0
60,40,50,75,85,95,405,0.6044776119402985,45,50,35,55,75,40,300,0.21367521367521367,0.5
70,80,65,90,65,85,455,0.578125,84,71,43,71,43,48,360,0.25874125874125875,1.0
79,115,70,125,80,111,580,0.8468468468468469,75,125,70,125,70,115,580,0.9037037037037037,1.0
40,45,40,35,35,56,251,0.373015873015873,38,30,85,55,65,30,303,0.21428571428571427,0.0
255,10,10,75,135,55,540,0.3125,45,49,49,65,65,45,318,0.2781954887218045,1.0
95,135,80,110,80,100,600,0.8248175182481752,90,120,120,60,60,50,500,0.35294117647058826,1.0
89,124,80,55,80,55,483,0.5714285714285714,89,125,90,115,80,101,600,0.8725490196078431,0.0
40,35,30,120,70,105,400,0.6692307692307692,75,75,60,83,60,60,413,0.39344262295081966,1.0
60,85,69,60,69,77,420,0.518796992481203,100,150,120,120,100,90,680,0.6493506493506493,1.0
95,95,85,125,65,55,520,0.3894736842105263,77,120,90,60,90,48,485,0.2785714285714286,0.5
110,123,65,100,65,65,528,0.5217391304347826,70,60,70,87,78,85,450,0.6228070175438597,2.0
40,30,30,40,50,30,220,0.07936507936507936,60,40,60,40,60,35,295,0.18055555555555555,0.25
45,45,35,20,30,20,195,0.07246376811594203,100,100,100,100,100,100,600,0.8778625954198473,1.0
60,62,80,63,80,60,405,0.4336283185840708,70,60,62,80,82,60,414,0.4375,0.25
45,100,45,45,45,10,290,0.2949640287769784,55,35,50,55,110,85,390,0.6277372262773723,0.0
70,62,67,55,55,56,365,0.38513513513513514,80,82,100,83,100,80,525,0.6821705426356589,2.0
60,55,50,40,55,45,305,0.22377622377622378,126,131,95,131,98,99,680,0.8102189781021898,1.0
126,131,95,131,98,99,680,0.8294573643410853,40,45,40,65,40,65,295,0.5661764705882353,1.0
67,58,57,81,67,101,431,0.8790322580645161,40,30,50,55,55,100,330,0.584070796460177,0.5
40,80,100,30,30,20,300,0.11851851851851852,100,150,120,120,100,90,680,0.6493506493506493,2.0
40,20,30,40,80,55,265,0.22764227642276422,80,90,80,130,110,110,600,0.856,2.0
65,70,60,65,65,115,440,0.8583333333333333,80,80,80,80,80,80,480,0.5606060606060606,1.0
80,105,105,105,105,80,580,0.5939849624060151,60,50,70,80,80,140,480,0.8449612403100775,1.0
60,30,30,36,56,50,262,0.32432432432432434,72,105,115,54,86,68,500,0.5149253731343284,0.25
95,95,85,125,65,55,520,0.3894736842105263,75,80,70,65,75,90,455,0.7578125,0.5
65,95,100,60,50,50,420,0.34959349593495936,50,48,43,46,41,60,288,0.47297297297297297,1.0
44,38,39,61,79,42,303,0.2251655629139073,105,105,75,65,100,50,500,0.37593984962406013,0.5
38,35,40,27,25,35,200,0.08208955223880597,56,61,65,48,45,38,313,0.17567567567567569,2.0
45,22,60,27,30,29,213,0.07518796992481203,78,130,111,130,85,100,634,0.8561151079136691,0.5
76,147,90,60,70,97,540,0.8267716535433071,75,103,80,70,80,92,500,0.7933884297520661,1.0
70,85,140,85,70,20,470,0.272,45,65,34,40,34,45,263,0.2589928057553957,1.0
50,180,20,180,20,150,600,0.9029850746268657,70,77,60,97,60,108,472,0.8394160583941606,1.0
35,65,35,65,35,65,300,0.46621621621621623,63,60,55,50,50,71,349,0.5289256198347108,1.0
100,100,125,110,50,50,535,0.384,66,41,77,61,87,23,355,0.12096774193548387,1.0
75,100,110,45,55,65,450,0.5333333333333333,80,85,95,30,30,25,345,0.2857142857142857,2.0
60,55,145,75,150,40,525,0.2,80,70,40,100,60,145,495,0.921875,2.0
60,110,70,60,60,100,460,0.8461538461538461,90,120,120,60,60,50,500,0.35294117647058826,1.0
80,85,95,30,30,25,345,0.2857142857142857,70,94,50,94,50,66,424,0.48148148148148145,0.0
190,33,58,33,58,33,405,0.13432835820895522,55,55,45,63,45,45,308,0.25,1.0
65,150,40,15,80,145,495,0.9663865546218487,60,65,70,85,75,40,395,0.21705426356589147,1.0
71,73,88,120,89,59,500,0.43537414965986393,70,140,70,110,65,105,560,0.95,0.5
52,65,55,58,62,60,352,0.4482758620689655,85,97,66,105,66,65,484,0.47107438016528924,1.0
105,105,75,65,100,50,500,0.37593984962406013,60,55,145,75,150,40,525,0.2,0.0
72,105,115,54,86,68,500,0.5149253731343284,72,58,80,103,80,97,490,0.7171052631578947,2.0
60,65,80,170,95,130,600,0.8625954198473282,64,88,50,88,50,106,446,0.9111111111111111,0.5
52,65,50,45,50,38,300,0.27419354838709675,76,25,45,67,55,24,292,0.0390625,2.0
55,70,45,70,50,60,350,0.45,45,30,50,65,50,45,285,0.13821138211382114,1.0
110,160,110,80,110,100,670,0.8591549295774648,50,65,107,105,107,86,520,0.7313432835820896,1.0
106,190,100,154,100,130,780,0.9259259259259259,70,120,40,95,40,95,460,0.8106060606060606,0.0
65,150,40,15,80,145,495,0.9663865546218487,45,100,45,45,45,10,290,0.2949640287769784,0.5
70,90,110,60,75,95,500,0.7333333333333333,65,73,55,47,75,85,400,0.6846846846846847,1.0
91,90,129,90,72,108,580,0.9140625,50,70,50,50,50,40,310,0.16296296296296298,0.5
60,55,50,40,55,45,305,0.22377622377622378,80,45,65,90,110,80,470,0.5462962962962963,2.0
54,45,47,75,98,52,371,0.39669421487603307,60,85,49,60,49,60,363,0.4444444444444444,1.0
70,110,180,60,60,50,530,0.4117647058823529,60,62,50,62,60,40,334,0.18181818181818182,4.0
54,63,52,83,56,97,405,0.7697841726618705,85,105,85,40,50,40,405,0.211864406779661,1.0
35,35,35,35,35,35,210,0.13385826771653545,59,59,58,90,70,73,409,0.5826086956521739,1.0
50,92,108,92,108,35,485,0.2457627118644068,65,125,100,60,70,70,490,0.6099290780141844,0.25
75,95,122,58,75,69,494,0.5725806451612904,50,105,79,35,110,76,455,0.6214285714285714,1.0
62,48,66,59,57,49,341,0.33884297520661155,100,150,140,100,90,90,670,0.7969924812030075,1.0
38,41,40,50,65,65,299,0.4108527131782946,30,30,42,30,42,70,244,0.4230769230769231,2.0
100,134,110,95,100,61,600,0.4057971014492754,55,50,40,40,40,75,300,0.5945945945945946,1.0
67,57,55,77,55,114,425,0.8879310344827587,60,62,50,62,60,40,334,0.18181818181818182,2.0
80,75,150,75,150,50,580,0.30973451327433627,54,66,70,44,55,46,335,0.4214876033057851,1.0
50,50,50,50,50,50,300,0.30708661417322836,77,85,51,55,51,65,384,0.5163934426229508,1.0
115,140,130,55,55,40,535,0.4519230769230769,95,75,80,100,110,30,490,0.24242424242424243,1.0
95,95,85,125,65,55,520,0.3894736842105263,86,68,72,109,66,106,507,0.8099173553719008,0.5
49,66,70,44,55,51,335,0.4260869565217391,68,72,78,38,42,32,330,0.23809523809523808,2.0
75,75,75,125,95,40,485,0.15671641791044777,50,20,55,25,25,30,205,0.09774436090225563,1.0
60,62,63,80,80,60,405,0.38016528925619836,79,115,70,125,80,111,580,0.864,0.5
50,50,95,40,50,35,320,0.20279720279720279,38,41,40,50,65,65,299,0.4108527131782946,2.0
80,135,85,70,95,150,615,0.9844961240310077,70,90,45,15,45,50,315,0.3629032258064516,2.0
45,45,35,20,30,20,195,0.07246376811594203,55,104,105,94,75,52,485,0.36363636363636365,1.0
90,75,85,115,90,55,510,0.3445378151260504,30,30,30,30,30,30,180,0.12612612612612611,0.5
75,98,63,98,63,101,498,0.849624060150376,54,66,70,44,55,46,335,0.4214876033057851,0.5
64,165,75,93,83,75,555,0.6587301587301587,72,60,30,20,30,25,237,0.11570247933884298,1.0
40,45,35,30,40,55,245,0.3793103448275862,70,85,70,60,70,50,405,0.28378378378378377,0.5
64,51,23,51,23,28,240,0.11363636363636363,35,64,85,74,55,32,345,0.19827586206896552,1.0
65,40,70,80,140,70,465,0.5954198473282443,50,105,79,35,110,76,455,0.6214285714285714,2.0
75,95,95,95,95,85,540,0.6470588235294118,70,65,60,90,75,90,450,0.6571428571428571,1.0
110,65,105,55,95,80,510,0.6258503401360545,45,60,45,25,45,55,275,0.29,1.0
80,80,50,40,50,25,325,0.176056338028169,61,72,57,55,55,65,365,0.3984375,0.5
50,48,43,46,41,60,288,0.47297297297297297,55,50,65,175,95,150,590,0.7818181818181819,1.0
1,90,45,30,30,40,236,0.33064516129032256,45,67,60,35,50,63,320,0.5128205128205128,1.0
50,50,50,50,50,50,300,0.30708661417322836,69,69,76,69,86,91,460,0.6554621848739496,0.5
55,45,45,25,25,15,210,0.048,60,45,50,90,80,70,395,0.625,0.0
90,50,34,60,44,70,348,0.6283185840707964,60,79,105,59,85,36,424,0.17054263565891473,2.0
64,66,68,81,76,50,405,0.25190839694656486,50,25,28,45,55,15,218,0.0625,1.0
48,61,40,61,40,50,300,0.2543859649122807,85,80,70,135,75,90,535,0.7006802721088435,2.0
38,41,40,50,65,65,299,0.4108527131782946,75,90,140,60,60,40,465,0.3008130081300813,4.0
85,73,70,73,115,67,483,0.5126050420168067,45,63,37,65,55,95,360,0.8055555555555556,1.0
38,41,40,50,65,65,299,0.4108527131782946,75,80,60,65,90,102,472,0.8625954198473282,1.0
80,100,123,122,120,80,625,0.56,90,120,100,150,120,100,680,0.7718120805369127,1.0
85,90,80,70,80,130,535,0.9262295081967213,108,112,118,68,72,47,525,0.2916666666666667,0.5
60,100,89,55,69,112,485,0.9298245614035088,60,80,110,50,80,45,425,0.2833333333333333,0.5
65,50,70,95,80,65,425,0.4262295081967213,55,50,65,175,95,150,590,0.7818181818181819,0.5
43,70,48,50,60,38,309,0.2391304347826087,65,45,55,45,70,45,325,0.24369747899159663,2.0
40,45,35,40,40,90,290,0.65,70,80,65,90,65,85,455,0.578125,1.0
60,75,85,100,85,115,520,0.8992248062015504,85,110,90,45,90,80,500,0.6206896551724138,1.0
50,95,90,95,90,180,600,0.9172413793103448,95,75,110,100,80,30,490,0.15267175572519084,0.5
111,83,68,92,82,39,475,0.1774193548387097,50,120,53,35,110,87,455,0.640625,1.0
101,72,72,99,89,29,462,0.1937984496124031,74,94,131,54,116,20,489,0.4485294117647059,0.5
31,45,90,30,30,40,266,0.21929824561403508,40,45,65,100,120,90,460,0.5588235294117647,1.0
50,60,45,100,80,65,400,0.45689655172413796,70,70,40,60,40,60,340,0.4247787610619469,1.0
75,95,95,95,95,85,540,0.6470588235294118,92,105,90,125,90,98,600,0.8217054263565892,1.0
105,140,95,55,65,45,505,0.3,40,40,55,40,70,55,300,0.40939597315436244,0.5
45,30,15,85,65,65,305,0.36220472440944884,105,125,100,60,100,100,590,0.8359375,1.0
55,69,85,32,35,28,304,0.09302325581395349,50,53,48,53,48,64,316,0.358974358974359,0.5
95,60,79,100,125,81,540,0.6201550387596899,90,90,85,125,90,100,580,0.768595041322314,1.0
50,60,45,100,80,65,400,0.45689655172413796,31,45,90,30,30,40,266,0.21929824561403508,0.5
62,77,62,50,42,65,358,0.4838709677419355,105,150,90,150,90,95,680,0.8285714285714286,1.0
68,165,95,65,115,110,618,0.8615384615384616,44,38,33,61,43,70,289,0.5267857142857143,2.0
70,92,65,80,55,98,460,0.8090909090909091,65,125,100,60,70,70,490,0.6099290780141844,1.0
57,80,91,80,87,75,470,0.5737704918032787,35,45,160,30,45,70,385,0.48148148148148145,2.0
60,59,85,79,105,36,424,0.16666666666666666,100,100,100,100,100,100,600,0.8805970149253731,2.0
83,80,80,135,80,121,579,0.9444444444444444,60,52,168,47,138,30,495,0.19834710743801653,0.0625
80,80,80,80,80,80,480,0.5606060606060606,110,130,80,70,60,80,530,0.5862068965517241,2.0
55,84,105,114,75,52,485,0.2890625,20,40,15,35,35,60,205,0.34285714285714286,1.0
55,70,45,70,50,60,350,0.45,70,92,65,80,55,98,460,0.8090909090909091,0.5
35,46,34,35,45,20,215,0.072,50,50,77,95,77,91,440,0.5916666666666667,0.0
75,38,38,56,56,67,330,0.5263157894736842,63,120,85,90,55,55,468,0.2809917355371901,1.0
50,95,180,85,45,70,525,0.5298507462686567,130,65,60,110,95,65,525,0.5227272727272727,0.25
70,75,80,135,80,135,575,0.917910447761194,60,80,50,40,40,30,300,0.15328467153284672,1.0
115,45,20,45,25,20,270,0.11538461538461539,49,66,70,44,55,51,335,0.4260869565217391,0.0
70,110,70,115,70,90,525,0.75,110,80,90,95,90,65,530,0.5033557046979866,2.0
48,61,40,61,40,50,300,0.2543859649122807,70,70,115,130,90,60,535,0.5338983050847458,0.0
70,65,60,90,75,90,450,0.6571428571428571,70,80,50,35,35,35,305,0.14,0.5
50,65,107,105,107,86,520,0.703125,50,25,28,45,55,15,218,0.0625,1.0
65,40,70,80,140,70,465,0.5954198473282443,65,80,65,35,65,60,370,0.38405797101449274,1.0
100,150,90,180,160,90,770,0.7348484848484849,85,105,100,79,83,78,530,0.5869565217391305,0.5
58,50,145,95,105,30,483,0.2459016393442623,75,98,63,98,63,101,498,0.8091603053435115,1.0
70,80,70,80,70,110,480,0.6594202898550725,66,65,48,62,57,52,350,0.36220472440944884,2.0
100,103,75,120,75,127,600,0.940677966101695,80,110,120,130,90,70,600,0.6198347107438017,1.0
75,55,70,55,95,110,460,0.8444444444444444,80,120,79,95,79,70,523,0.5833333333333334,0.5
75,98,63,98,63,101,498,0.8091603053435115,130,70,35,70,35,60,400,0.4017857142857143,2.0
70,70,70,70,70,70,420,0.5289256198347108,50,50,40,50,40,64,294,0.45588235294117646,1.0
54,66,70,44,55,46,335,0.4214876033057851,60,60,60,105,105,105,495,0.848,2.0
40,30,35,50,70,55,280,0.28205128205128205,30,105,90,25,25,50,325,0.2773722627737226,2.0
40,30,30,40,50,30,220,0.07936507936507936,60,60,40,65,45,35,305,0.15833333333333333,4.0
75,125,230,55,95,30,610,0.3448275862068966,80,80,80,55,55,90,440,0.6417910447761194,1.0
80,120,70,110,70,80,530,0.6422764227642277,40,45,40,35,35,56,251,0.373015873015873,1.0
65,75,90,97,123,44,494,0.1987179487179487,81,102,77,85,75,85,505,0.5642857142857143,0.25
55,95,115,45,45,35,390,0.2116788321167883,50,72,35,35,35,65,292,0.5373134328358209,0.5
45,50,43,40,38,62,278,0.40441176470588236,55,75,50,40,40,80,340,0.6302521008403361,1.0
50,95,180,85,45,70,525,0.5298507462686567,75,95,125,45,75,95,510,0.8257575757575758,8.0
60,40,60,40,60,35,295,0.18055555555555555,64,88,50,88,50,106,446,0.9111111111111111,1.0
67,82,62,46,48,43,348,0.22033898305084745,73,100,60,100,60,65,458,0.42657342657342656,0.5
40,45,35,65,55,70,310,0.4482758620689655,60,62,80,63,80,60,405,0.4336283185840708,0.5
71,120,95,120,95,99,600,0.8203125,50,180,20,180,20,150,600,0.9029850746268657,2.0
120,70,120,75,130,85,600,0.6694915254237288,70,85,70,60,70,50,405,0.28378378378378377,2.0
50,52,48,65,50,55,320,0.33098591549295775,110,160,110,80,110,100,670,0.8591549295774648,1.0
76,65,45,92,42,91,411,0.7449664429530202,75,125,75,30,75,85,465,0.625,2.0
65,95,57,100,85,93,495,0.7441860465116279,20,10,55,15,20,80,200,0.17985611510791366,0.5
100,50,80,60,80,50,420,0.34375,44,75,35,63,33,45,295,0.2647058823529412,1.0
80,110,60,150,130,70,600,0.5042016806722689,39,52,43,60,50,65,309,0.5041322314049587,1.0
75,98,63,98,63,101,498,0.849624060150376,35,80,50,50,70,120,405,0.84375,2.0
50,72,35,35,35,65,292,0.5373134328358209,55,65,95,95,45,85,440,0.6610169491525424,1.0
70,90,70,60,60,70,420,0.6390977443609023,65,47,55,73,75,85,400,0.65,1.0
65,47,55,73,75,85,400,0.65,170,90,45,90,45,60,500,0.427536231884058,1.0
50,65,64,44,48,43,314,0.2196969696969697,50,65,85,35,35,55,325,0.32575757575757575,2.0
60,85,49,60,49,60,363,0.4444444444444444,74,108,133,83,65,32,495,0.32142857142857145,2.0
75,95,60,65,60,115,470,0.8778625954198473,61,78,95,56,58,57,405,0.40336134453781514,1.0
45,85,70,40,40,60,340,0.5229357798165137,40,45,40,65,40,65,295,0.5661764705882353,0.5
60,70,105,70,120,75,500,0.5983606557377049,65,110,130,60,65,95,525,0.8278145695364238,0.5
45,100,45,45,45,10,290,0.2949640287769784,60,130,80,60,60,70,460,0.5153846153846153,0.5
70,120,65,45,85,125,510,0.9747899159663865,50,35,55,25,25,15,205,0.021739130434782608,1.0
150,120,100,120,100,90,680,0.664179104477612,40,45,35,40,40,90,290,0.65,0.0
60,45,70,75,85,55,390,0.3008130081300813,70,130,100,55,80,65,500,0.608,0.5
100,180,160,150,90,90,770,0.7520661157024794,78,81,71,74,69,126,499,0.9090909090909091,0.0
80,82,100,83,100,80,525,0.6821705426356589,60,85,42,85,42,91,405,0.8227848101265823,0.5
70,130,100,55,80,65,500,0.608,50,65,64,44,48,43,314,0.2196969696969697,0.5
95,75,110,100,80,30,490,0.15267175572519084,55,55,45,63,45,45,308,0.25,0.5
71,73,88,120,89,59,500,0.43537414965986393,125,170,100,120,90,95,700,0.77,0.5
64,51,23,51,23,28,240,0.11363636363636363,114,85,70,85,80,30,464,0.2066115702479339,1.0
65,95,100,60,50,50,420,0.34959349593495936,75,80,55,25,35,35,305,0.18666666666666668,1.0
40,45,40,62,60,60,307,0.33884297520661155,35,85,45,35,35,75,310,0.6492537313432836,1.0
116,55,85,107,95,29,487,0.06818181818181818,60,70,65,125,105,90,515,0.6911764705882353,2.0
50,35,55,25,25,15,205,0.05263157894736842,70,55,65,95,85,70,440,0.5307692307692308,2.0
67,89,116,79,116,33,500,0.2624113475177305,45,50,35,55,75,40,300,0.21367521367521367,1.0
100,90,130,45,65,55,485,0.4253731343283582,63,63,47,41,41,74,329,0.56,1.0
60,75,100,55,80,50,420,0.3088235294117647,55,35,50,55,110,85,390,0.6277372262773723,1.0
83,80,75,70,70,101,479,0.8615384615384616,65,40,70,80,140,70,465,0.5954198473282443,1.0
45,30,35,20,20,45,195,0.14782608695652175,101,72,72,99,89,29,462,0.1937984496124031,0.5
60,65,70,85,75,40,395,0.21705426356589147,70,80,50,35,35,35,305,0.14,1.0
55,85,55,50,55,60,360,0.4233576642335766,30,65,100,45,25,40,305,0.1891891891891892,0.5
90,55,75,60,75,30,385,0.13970588235294118,49,66,70,44,55,51,335,0.4260869565217391,0.0
80,120,130,55,65,45,495,0.37037037037037035,40,45,65,100,120,90,460,0.5588235294117647,1.0
68,85,65,165,135,100,618,0.8083333333333333,190,33,58,33,58,33,405,0.13432835820895522,0.5
35,55,35,30,30,35,220,0.23684210526315788,75,55,70,55,95,110,460,0.8444444444444444,1.0
90,60,60,40,40,40,330,0.29545454545454547,45,63,37,65,55,95,360,0.8055555555555556,2.0
30,45,59,30,39,57,260,0.2803030303030303,20,25,45,70,90,60,310,0.30833333333333335,2.0
38,36,38,32,36,57,237,0.3893805309734513,70,95,85,55,65,70,440,0.5,0.5
73,76,75,81,100,100,505,0.8110236220472441,80,120,70,110,70,80,530,0.6422764227642277,0.5
50,65,107,105,107,86,520,0.6991150442477876,74,94,131,54,116,20,489,0.4485294117647059,2.0
65,95,100,60,50,50,420,0.34959349593495936,40,55,80,35,60,30,300,0.15037593984962405,0.5
75,69,72,114,100,104,534,0.8253968253968254,90,85,100,95,125,85,580,0.6834532374100719,2.0
165,75,80,40,45,65,470,0.5151515151515151,83,80,80,135,80,121,579,0.9444444444444444,1.0
85,56,77,50,77,78,423,0.53125,50,25,28,45,55,15,218,0.0625,1.0
80,100,80,80,80,100,520,0.9051724137931034,103,93,67,71,61,84,479,0.7142857142857143,2.0
65,90,50,85,45,55,390,0.371900826446281,35,85,45,35,35,75,310,0.6492537313432836,0.5
50,75,45,40,45,60,315,0.4380165289256198,50,72,35,35,35,65,292,0.5373134328358209,2.0
70,135,105,60,105,20,495,0.5806451612903226,90,120,100,150,120,100,680,0.7718120805369127,0.5
123,77,72,99,92,58,521,0.4621212121212121,95,110,80,70,80,50,485,0.37209302325581395,1.0
95,117,184,44,46,28,514,0.2975206611570248,55,112,45,74,45,70,401,0.559322033898305,2.0
50,70,100,40,40,30,330,0.2222222222222222,55,68,64,45,55,31,318,0.11666666666666667,1.0
60,100,115,70,85,90,520,0.7557251908396947,70,70,40,60,40,60,340,0.4247787610619469,1.0
67,89,116,79,116,33,500,0.2624113475177305,38,30,85,55,65,30,303,0.21428571428571427,1.0
45,75,37,70,55,83,365,0.6183206106870229,100,180,160,150,90,90,770,0.7520661157024794,0.5
65,73,55,47,75,85,400,0.6846846846846847,45,50,35,55,75,40,300,0.21367521367521367,1.0
38,41,40,50,65,65,299,0.4108527131782946,150,120,100,120,100,90,680,0.664179104477612,0.5
50,65,107,105,107,86,520,0.7758620689655172,28,25,25,45,35,40,198,0.16083916083916083,1.0
55,50,40,40,40,75,300,0.5945945945945946,79,115,70,125,80,111,580,0.864,1.0
95,75,180,130,80,30,590,0.13793103448275862,35,35,35,35,35,35,210,0.13385826771653545,1.0
89,124,80,55,80,55,483,0.5714285714285714,50,64,50,45,50,41,300,0.22727272727272727,2.0
25,35,70,95,55,45,325,0.16783216783216784,110,135,60,50,65,88,508,0.7744360902255639,0.0
70,92,65,80,55,98,460,0.8090909090909091,68,75,53,83,113,60,452,0.45384615384615384,0.5
50,65,90,35,35,15,290,0.14678899082568808,61,72,57,55,55,65,365,0.3984375,0.5
82,121,119,69,59,71,521,0.5394736842105263,100,50,50,76,96,70,442,0.5,2.0
50,55,50,36,30,43,264,0.2922077922077922,80,110,120,130,90,70,600,0.6198347107438017,1.0
55,70,55,40,55,85,360,0.7073170731707317,70,135,105,60,105,20,495,0.5806451612903226,0.5
65,130,60,75,60,75,465,0.689922480620155,60,65,60,130,75,110,500,0.7719298245614035,2.0
125,120,90,170,100,95,700,0.78125,100,123,75,57,75,80,510,0.6923076923076923,2.0
65,125,100,55,70,85,500,0.6532258064516129,50,20,55,25,25,30,205,0.09774436090225563,1.0
65,95,100,60,50,50,420,0.34959349593495936,41,50,37,50,37,66,281,0.5175438596491229,1.0
70,75,80,135,80,135,575,0.917910447761194,65,125,60,95,60,105,510,0.9236641221374046,1.0
70,80,102,80,102,40,474,0.2677165354330709,46,57,40,40,40,50,273,0.25,0.5
40,45,35,65,55,70,310,0.4482758620689655,50,45,45,35,35,50,260,0.23529411764705882,1.0
35,65,35,65,35,65,300,0.46621621621621623,67,57,55,77,55,114,425,0.8879310344827587,1.0
50,150,50,150,50,150,600,0.9339622641509434,45,60,32,50,32,76,295,0.5925925925925926,1.0
35,65,35,65,35,65,300,0.46621621621621623,60,40,50,75,85,95,405,0.6044776119402985,1.0
65,130,60,95,110,65,525,0.5303030303030303,85,90,80,70,80,130,535,0.9262295081967213,1.0
100,103,75,120,75,127,600,0.940677966101695,35,60,44,40,54,55,288,0.366412213740458,0.5
65,55,115,100,40,60,435,0.3798449612403101,55,81,60,50,70,97,413,0.7214285714285714,1.0
45,65,34,40,34,45,263,0.2589928057553957,75,125,230,55,95,30,610,0.3448275862068966,0.0
75,80,70,65,75,90,455,0.7578125,85,90,80,70,80,130,535,0.9262295081967213,0.5
50,105,79,35,110,76,455,0.6214285714285714,65,95,75,55,55,85,430,0.6933333333333334,0.5
40,60,40,40,40,30,250,0.0948905109489051,62,48,54,63,60,68,355,0.5178571428571429,2.0
80,105,105,105,105,80,580,0.5939849624060151,64,115,65,83,63,65,455,0.5323741007194245,1.0
75,85,200,55,65,30,510,0.16778523489932887,70,92,65,80,55,98,460,0.8090909090909091,0.5
66,41,77,61,87,23,355,0.12096774193548387,90,100,90,125,85,90,580,0.7352941176470589,1.0
45,55,45,65,45,75,330,0.5692307692307692,50,50,40,50,40,64,294,0.45588235294117646,0.5
50,65,107,105,107,86,520,0.7272727272727273,55,75,85,25,25,15,280,0.1875,0.5
100,77,77,128,128,90,600,0.6901408450704225,70,50,30,95,135,105,485,0.8040540540540541,1.0
50,53,62,58,63,44,330,0.13709677419354838,68,165,95,65,115,110,618,0.8615384615384616,1.0
80,135,130,95,90,70,600,0.5181818181818182,75,80,60,65,90,102,472,0.8625954198473282,1.0
95,65,110,60,130,65,525,0.5275590551181102,65,50,35,115,95,95,455,0.7333333333333333,2.0
130,70,35,70,35,60,400,0.4017857142857143,100,164,150,95,120,71,700,0.5645161290322581,2.0
40,20,30,40,80,55,265,0.22764227642276422,53,54,53,37,46,45,288,0.3090909090909091,4.0
70,90,45,15,45,50,315,0.3629032258064516,110,135,60,50,65,88,508,0.7744360902255639,2.0
75,75,75,125,95,40,485,0.15671641791044777,50,105,79,35,110,76,455,0.6214285714285714,1.0
45,53,70,40,60,42,310,0.25735294117647056,79,115,70,125,80,111,580,0.8468468468468469,0.25
55,81,60,50,70,97,413,0.7214285714285714,41,64,45,50,50,50,300,0.36752136752136755,1.0
62,44,50,44,50,55,305,0.3629032258064516,45,55,45,65,45,75,330,0.5692307692307692,1.0
60,55,145,75,150,40,525,0.2,82,80,86,85,75,72,480,0.6183206106870229,0.5
70,90,45,15,45,50,315,0.3629032258064516,75,125,70,125,70,115,580,0.9037037037037037,1.0
106,90,130,90,154,110,680,0.8699186991869918,100,150,120,120,100,90,680,0.6493506493506493,0.5
65,73,55,47,75,85,400,0.6846846846846847,40,30,35,45,40,55,245,0.31496062992125984,0.5
80,105,65,60,75,130,515,0.9645390070921985,50,48,43,46,41,60,288,0.47297297297297297,0.5
48,72,48,72,48,48,336,0.25984251968503935,80,82,83,100,100,80,525,0.6742424242424242,2.0
76,104,71,104,71,108,534,0.912751677852349,75,75,75,125,95,40,485,0.15671641791044777,0.5
45,85,70,40,40,60,340,0.5229357798165137,40,40,40,70,40,20,250,0.032520325203252036,0.5
95,125,79,60,100,81,540,0.6165413533834586,80,82,100,83,100,80,525,0.6821705426356589,1.0
50,85,125,85,115,20,480,0.4306569343065693,70,62,67,55,55,56,365,0.38513513513513514,1.0
90,55,75,60,75,30,385,0.13970588235294118,86,68,72,109,66,106,507,0.8099173553719008,1.0
100,70,70,65,65,45,415,0.1897810218978102,70,140,70,110,65,105,560,0.95,1.0
70,40,50,55,50,25,290,0.061068702290076333,35,55,40,45,40,60,275,0.35714285714285715,1.0
100,90,130,45,65,55,485,0.4253731343283582,60,60,75,60,75,80,410,0.7321428571428571,0.5
44,38,33,61,43,70,289,0.5267857142857143,45,50,55,75,65,30,320,0.06293706293706294,0.5
50,85,40,85,40,35,335,0.1746031746031746,70,80,50,35,35,35,305,0.14,1.0
105,105,75,65,100,50,500,0.37593984962406013,58,109,112,48,48,109,484,0.8805970149253731,0.0
50,48,43,46,41,60,288,0.47297297297297297,40,27,60,37,50,66,280,0.36220472440944884,0.25
67,57,55,77,55,114,425,0.8879310344827587,72,85,70,65,70,58,420,0.41304347826086957,0.0
95,145,130,120,90,120,700,0.9398496240601504,43,70,48,50,60,38,309,0.2391304347826087,2.0
85,76,64,45,55,90,415,0.6739130434782609,70,43,53,43,53,40,302,0.19090909090909092,1.0
75,65,55,65,55,69,384,0.43548387096774194,45,30,15,85,65,65,305,0.36220472440944884,1.0
90,100,70,110,150,80,600,0.6037735849056604,55,63,90,50,80,42,380,0.21138211382113822,1.0
82,121,119,69,59,71,521,0.5394736842105263,61,72,57,55,55,65,365,0.3984375,1.0
103,60,86,60,86,50,445,0.3458646616541353,65,130,60,75,60,75,465,0.689922480620155,1.0
61,90,45,50,50,160,456,0.9230769230769231,78,52,60,63,65,23,341,0.06015037593984962,0.5
76,48,48,57,62,34,325,0.11688311688311688,65,65,60,130,95,110,525,0.823943661971831,1.0
85,76,64,45,55,90,415,0.6739130434782609,1,90,45,30,30,40,236,0.33064516129032256,0.0
30,105,90,25,25,50,325,0.2773722627737226,50,100,150,100,150,50,600,0.37142857142857144,2.0
40,45,40,62,60,60,307,0.33884297520661155,67,57,55,77,55,114,425,0.8879310344827587,1.0
50,105,125,55,95,50,480,0.375886524822695,65,63,45,45,45,45,308,0.2595419847328244,0.25
40,55,30,30,30,85,270,0.688,40,80,100,30,30,20,300,0.11851851851851852,0.25
60,85,69,65,79,80,438,0.576,65,80,80,59,63,58,405,0.4411764705882353,1.0
50,20,40,20,40,20,190,0.0962962962962963,105,125,100,60,100,100,590,0.8359375,1.0
45,45,35,20,30,20,195,0.07246376811594203,80,82,83,100,100,80,525,0.6742424242424242,1.0
95,100,85,108,70,70,528,0.5652173913043478,61,78,95,56,58,57,405,0.40336134453781514,0.5
30,40,70,70,25,60,295,0.41353383458646614,58,50,145,95,105,30,483,0.2459016393442623,1.0
50,75,70,35,70,48,348,0.29357798165137616,40,55,80,35,60,30,300,0.15037593984962405,2.0
75,98,63,98,63,101,498,0.849624060150376,65,150,40,15,80,145,495,0.9663865546218487,1.0
35,46,34,35,45,20,215,0.072,35,35,40,35,55,50,250,0.40336134453781514,1.0
70,140,230,60,80,50,630,0.32432432432432434,100,110,90,85,90,60,535,0.47794117647058826,0.5
55,55,85,65,85,35,380,0.2014388489208633,60,40,60,95,60,55,370,0.4222222222222222,4.0
50,75,75,65,65,50,380,0.4049586776859504,105,140,55,30,55,95,480,0.8195488721804511,1.0
80,160,60,170,130,80,680,0.6180555555555556,45,30,15,85,65,65,305,0.36220472440944884,1.0
95,60,79,100,125,81,540,0.6201550387596899,110,80,90,95,90,65,530,0.5033557046979866,0.5
60,60,50,40,50,75,335,0.5882352941176471,40,27,60,37,50,66,280,0.36220472440944884,0.5
42,52,67,39,56,50,306,0.2868217054263566,95,95,85,125,65,55,520,0.3894736842105263,0.5
60,62,50,62,60,40,334,0.18181818181818182,90,55,75,60,75,30,385,0.13970588235294118,1.0
54,63,52,83,56,97,405,0.7697841726618705,74,108,133,83,65,32,495,0.32142857142857145,1.0
66,65,48,62,57,52,350,0.36220472440944884,60,60,75,60,75,80,410,0.7321428571428571,1.0
60,65,60,130,75,110,500,0.7719298245614035,65,105,60,60,70,95,455,63.0,1.0
37,25,41,25,41,25,194,0.08870967741935484,55,35,50,55,110,85,390,0.6277372262773723,0.5
55,35,50,55,110,85,390,0.6277372262773723,130,70,35,70,35,60,400,0.4017857142857143,1.0
30,42,118,42,88,30,350,0.112,45,50,45,115,55,95,405,0.6936936936936937,1.0
95,75,180,130,80,30,590,0.13793103448275862,65,100,70,80,80,105,500,0.8666666666666667,2.0
66,65,48,62,57,52,350,0.36220472440944884,80,92,65,65,80,68,450,0.4824561403508772,2.0
60,45,70,75,85,55,390,0.3008130081300813,75,80,55,25,35,35,305,0.18666666666666668,1.0
59,74,50,35,50,35,303,0.3125,64,115,65,83,63,65,455,0.5323741007194245,2.0
64,51,23,51,23,28,240,0.11363636363636363,65,60,70,85,75,40,395,0.1796875,1.0
126,131,95,131,98,99,680,0.8102189781021898,50,20,40,20,40,20,190,0.0962962962962963,0.5
65,47,55,73,75,85,400,0.65,50,85,85,55,55,50,380,0.3902439024390244,0.25
100,123,75,57,75,80,510,0.6923076923076923,106,130,90,110,154,90,680,0.719626168224299,1.0
74,100,72,90,72,46,454,0.24561403508771928,70,90,90,135,90,125,600,0.9401709401709402,1.0
48,61,40,61,40,50,300,0.2543859649122807,54,78,103,53,45,22,355,0.23255813953488372,1.0
40,60,30,31,31,70,262,0.4492753623188406,75,80,95,90,100,50,490,0.2158273381294964,2.0
45,49,49,65,65,45,318,0.2781954887218045,60,30,30,36,56,50,262,0.32432432432432434,0.5
85,80,70,135,75,90,535,0.7006802721088435,70,55,65,95,85,70,440,0.5307692307692308,0.5
75,65,55,65,55,69,384,0.43548387096774194,70,90,45,15,45,50,315,0.3629032258064516,4.0
45,95,50,40,50,75,355,0.54,40,60,30,31,31,70,262,0.4492753623188406,1.0
70,45,48,60,65,35,323,0.15748031496062992,1,90,45,30,30,40,236,0.33064516129032256,1.0
60,60,40,65,45,35,305,0.15833333333333333,75,100,95,40,70,110,490,0.8717948717948718,1.0
70,140,230,60,80,50,630,0.32432432432432434,55,85,122,58,75,99,494,0.8099173553719008,1.0
85,80,70,135,75,90,535,0.7006802721088435,86,68,72,109,66,106,507,0.8099173553719008,1.0
76,104,71,104,71,108,534,0.912751677852349,75,85,200,55,65,30,510,0.16778523489932887,4.0
70,95,85,55,65,70,440,0.5,35,85,45,35,35,75,310,0.6492537313432836,2.0
65,65,65,50,50,90,385,0.72,30,45,55,70,55,85,340,0.5633802816901409,0.5
80,120,79,95,79,70,523,0.5833333333333334,170,90,45,90,45,60,500,0.427536231884058,2.0
65,65,65,50,50,90,385,0.72,45,30,40,105,50,20,290,0.031007751937984496,1.0
40,29,45,29,45,36,224,0.14634146341463414,104,91,63,91,73,68,490,0.5118110236220472,1.0
43,80,65,50,35,35,308,0.14193548387096774,60,70,65,125,105,90,515,0.6911764705882353,0.5
80,92,65,65,80,68,450,0.4824561403508772,70,43,53,43,53,40,302,0.19090909090909092,1.0
50,53,48,53,48,64,316,0.46153846153846156,55,66,44,44,56,85,350,0.6888888888888889,1.0
95,124,78,69,71,58,495,0.37398373983739835,60,40,60,40,60,35,295,0.18055555555555555,1.0
55,68,64,45,55,31,318,0.11666666666666667,95,124,78,69,71,58,495,0.37398373983739835,1.0
60,50,100,85,70,65,430,0.47580645161290325,40,30,30,40,50,30,220,0.07936507936507936,0.5
65,75,90,97,123,44,494,0.1987179487179487,85,50,95,120,115,80,545,0.5793650793650794,0.0
75,95,122,58,75,69,494,0.5725806451612904,123,100,62,97,81,68,531,0.4806201550387597,0.5
48,72,48,72,48,48,336,0.25984251968503935,58,64,58,80,65,80,405,0.609271523178808,1.0
60,80,110,50,80,45,425,0.2833333333333333,70,110,180,60,60,50,530,0.4117647058823529,4.0
65,95,57,100,85,93,495,0.7441860465116279,58,89,77,45,45,48,362,0.3177570093457944,0.25
70,60,75,110,75,90,480,0.7165354330708661,95,75,80,100,110,30,490,0.24242424242424243,2.0
80,70,65,80,120,100,515,0.8034188034188035,50,53,62,58,63,44,330,0.13709677419354838,0.5
60,90,140,50,50,40,430,0.2535211267605634,40,80,35,35,45,70,305,0.4661016949152542,0.5
70,140,230,60,80,50,630,0.32432432432432434,91,134,95,100,100,80,600,0.6304347826086957,1.0
48,72,48,72,48,48,336,0.25984251968503935,67,125,40,30,30,58,350,0.3431372549019608,1.0
75,80,55,25,35,35,305,0.18666666666666668,120,120,120,120,120,120,720,0.9344262295081968,2.0
65,83,57,95,85,105,490,0.8914728682170543,65,75,90,97,123,44,494,0.1987179487179487,0.5
85,110,76,65,82,56,474,0.3933333333333333,70,110,80,55,80,105,500,0.8794326241134752,0.25
90,60,60,40,40,40,330,0.29545454545454547,95,80,105,40,70,100,490,0.8046875,1.0
52,65,55,58,62,60,352,0.4482758620689655,110,123,65,100,65,65,528,0.5217391304347826,2.0
90,70,80,70,95,70,475,0.5190839694656488,75,85,200,55,65,30,510,0.16778523489932887,2.0
80,185,115,40,105,75,600,0.6230769230769231,20,10,230,10,230,5,505,0.0,1.0
106,130,90,110,154,90,680,0.719626168224299,45,85,70,40,40,60,340,0.5229357798165137,1.0
69,69,76,69,86,91,460,0.6554621848739496,60,40,60,40,60,35,295,0.18055555555555555,0.5
50,50,95,40,50,35,320,0.20279720279720279,60,67,85,77,75,116,480,0.8888888888888888,0.5
43,70,48,50,60,38,309,0.2391304347826087,100,50,50,76,96,70,442,0.5,0.0
70,100,115,30,65,30,410,0.24390243902439024,90,100,70,110,150,80,600,0.6037735849056604,1.0
91,90,72,90,129,108,580,0.896,126,131,95,131,98,99,680,0.8102189781021898,0.5
86,68,72,109,66,106,507,0.8099173553719008,20,40,90,30,90,25,295,0.11363636363636363,0.0
39,52,43,60,50,65,309,0.5041322314049587,55,75,50,40,40,80,340,0.6302521008403361,1.0
100,73,83,73,83,55,467,0.371900826446281,50,50,40,30,30,50,250,0.2781954887218045,0.5
123,100,62,97,81,68,531,0.4806201550387597,80,82,83,100,100,80,525,0.6742424242424242,0.25
41,64,45,50,50,50,300,0.36752136752136755,70,20,50,20,50,40,250,0.1557377049180328,0.0
75,95,67,125,95,83,540,0.7117117117117117,71,95,85,110,95,79,535,0.664,2.0
80,82,83,100,100,80,525,0.6742424242424242,38,35,40,27,25,35,200,0.08208955223880597,0.5
50,70,100,40,40,30,330,0.2222222222222222,65,45,55,45,70,45,325,0.24369747899159663,0.5
100,73,83,73,83,55,467,0.371900826446281,55,65,95,95,45,85,440,0.6610169491525424,1.0
80,90,80,130,110,110,600,0.856,45,90,20,65,20,65,305,0.5116279069767442,0.0
50,50,40,30,30,50,250,0.2781954887218045,50,48,43,46,41,60,288,0.47297297297297297,1.0
76,48,48,57,62,34,325,0.11688311688311688,54,66,70,44,55,46,335,0.4214876033057851,0.5
60,40,60,40,60,35,295,0.18055555555555555,80,82,83,100,100,80,525,0.6742424242424242,0.25
65,55,115,100,40,60,435,0.3798449612403101,106,190,100,154,100,130,780,0.9259259259259259,1.0
90,85,100,95,125,85,580,0.6834532374100719,80,80,50,40,50,25,325,0.176056338028169,1.0
100,128,90,77,77,128,600,0.959349593495935,100,100,100,100,100,100,600,0.8778625954198473,0.5
50,85,55,65,65,90,410,0.7478260869565218,85,50,95,120,115,80,545,0.5793650793650794,1.0
60,80,110,50,80,45,425,0.2833333333333333,72,85,70,65,70,58,420,0.41304347826086957,1.0
25,20,15,105,55,90,310,0.32407407407407407,100,73,83,73,83,55,467,0.371900826446281,2.0
45,100,45,45,45,10,290,0.2949640287769784,40,80,100,30,30,20,300,0.11851851851851852,2.0
68,65,65,125,115,80,518,0.6461538461538462,78,92,75,74,63,118,500,0.8842975206611571,2.0
20,10,55,15,20,80,200,0.17985611510791366,55,95,55,35,75,115,430,0.9380530973451328,1.0
80,80,80,55,55,90,440,0.6417910447761194,104,91,63,91,73,68,490,0.5118110236220472,1.0
95,60,79,100,125,81,540,0.6201550387596899,50,50,120,80,80,30,410,0.07258064516129033,4.0
50,50,150,50,150,50,500,0.2571428571428571,91,90,106,130,106,77,600,0.648854961832061,0.25
59,74,50,35,50,35,303,0.3125,45,50,55,75,65,30,320,0.06293706293706294,1.0
80,70,65,80,120,100,515,0.8034188034188035,31,45,90,30,30,40,266,0.21929824561403508,1.0
46,87,60,30,40,57,320,0.37777777777777777,90,85,75,115,100,115,580,0.9381443298969072,1.0
30,45,59,30,39,57,260,0.2803030303030303,38,41,40,50,65,65,299,0.4108527131782946,0.5
75,75,95,75,95,113,528,0.9015151515151515,70,85,140,85,70,20,470,0.272,0.5
75,90,90,140,90,115,600,0.9481481481481482,125,58,58,76,76,67,460,0.515625,0.5
65,150,40,15,80,145,495,0.9663865546218487,55,45,45,25,25,15,210,0.048,0.5
78,104,78,159,115,100,634,0.8444444444444444,40,65,40,80,40,65,330,0.5038167938931297,1.0
70,40,50,55,50,25,290,0.061068702290076333,45,75,60,40,30,50,300,0.304,1.0
70,95,125,65,75,45,475,0.33613445378151263,55,20,35,20,45,75,250,0.37681159420289856,1.0
70,80,65,90,65,85,455,0.578125,100,100,100,100,100,100,600,0.8602941176470589,1.0
70,92,65,80,55,98,460,0.8090909090909091,100,134,110,95,100,61,600,0.4057971014492754,2.0
89,124,80,55,80,55,483,0.5714285714285714,83,80,75,70,70,101,479,0.8615384615384616,0.0
75,80,95,90,100,50,490,0.2158273381294964,160,110,65,65,110,30,540,0.35714285714285715,1.0
54,45,47,75,98,52,371,0.39669421487603307,65,60,70,85,75,40,395,0.1796875,1.0
20,40,90,30,90,25,295,0.11363636363636363,65,110,130,60,65,95,525,0.8278145695364238,1.0
55,20,35,20,45,75,250,0.37681159420289856,45,49,49,65,65,45,318,0.2781954887218045,1.0
60,90,70,60,120,40,440,0.27419354838709675,50,65,45,85,65,95,405,0.7238095238095238,1.0
60,65,80,170,95,130,600,0.8625954198473282,95,117,80,65,70,92,519,0.8409090909090909,0.25
55,84,105,114,75,52,485,0.2890625,85,90,80,70,80,130,535,0.9262295081967213,1.0
65,155,120,65,90,105,600,0.8677685950413223,50,70,50,50,50,40,310,0.16296296296296298,1.0
45,40,60,40,75,50,310,0.2926829268292683,75,125,70,125,70,115,580,0.9037037037037037,1.0
40,50,90,30,55,65,330,0.44680851063829785,78,92,75,74,63,118,500,0.8842975206611571,0.25
75,87,63,87,63,98,473,0.865546218487395,40,35,30,20,20,50,195,0.23423423423423423,2.0
58,70,45,40,45,42,300,0.25925925925925924,150,100,120,100,120,90,680,0.6666666666666666,2.0
40,40,55,40,70,55,300,0.40939597315436244,60,69,95,69,95,36,424,0.2608695652173913,0.5
95,109,105,75,85,56,525,0.34513274336283184,95,135,80,110,80,100,600,0.8248175182481752,0.0
70,60,70,87,78,85,450,0.6228070175438597,126,131,95,131,98,99,680,0.8102189781021898,0.5
62,77,62,50,42,65,358,0.4838709677419355,70,90,90,135,90,125,600,0.9401709401709402,1.0
65,90,115,45,115,58,488,0.5041322314049587,56,61,65,48,45,38,313,0.17567567567567569,1.0
68,90,65,50,55,82,410,0.6165413533834586,120,100,85,30,85,45,465,0.22448979591836735,1.0
75,100,95,40,70,110,490,0.8717948717948718,67,89,116,79,116,33,500,0.2624113475177305,0.5
90,90,85,125,90,100,580,0.768595041322314,103,60,126,80,126,50,545,0.36363636363636365,1.0
83,80,75,70,70,101,479,0.8615384615384616,70,45,48,60,65,35,323,0.15748031496062992,1.0
85,135,130,60,80,25,515,0.40540540540540543,40,60,40,40,40,30,250,0.0948905109489051,2.0
95,145,130,120,90,120,700,0.9398496240601504,75,80,85,110,90,50,490,0.3548387096774194,2.0
80,120,130,55,65,45,495,0.37037037037037035,123,100,62,97,81,68,531,0.4806201550387597,0.5
40,45,35,65,55,70,310,0.4482758620689655,70,95,125,65,75,45,475,0.33613445378151263,1.0
130,85,80,85,95,60,535,0.43884892086330934,78,104,78,159,115,100,634,0.8444444444444444,2.0
66,41,77,61,87,23,355,0.12096774193548387,77,120,90,60,90,48,485,0.2785714285714286,0.5
70,110,80,55,80,105,500,0.8794326241134752,95,65,65,110,130,60,525,0.4016393442622951,0.5
10,55,25,35,45,95,265,0.5396825396825397,68,85,65,165,135,100,618,0.8083333333333333,1.0
35,20,65,40,65,20,245,0.02459016393442623,60,85,60,85,60,55,405,0.3673469387755102,1.0
25,20,15,105,55,90,310,0.32407407407407407,106,190,100,154,100,130,780,0.9259259259259259,0.5
105,30,105,140,105,55,540,0.3524590163934426,50,55,50,36,30,43,264,0.2922077922077922,1.0
65,83,57,95,85,105,490,0.8914728682170543,76,147,90,60,70,97,540,0.8267716535433071,0.5
115,45,20,45,25,20,270,0.11538461538461539,25,20,15,105,55,90,310,0.32407407407407407,1.0
74,48,76,83,81,104,466,0.7913043478260869,78,84,78,109,85,100,534,0.8646616541353384,1.0
88,107,122,74,75,64,530,0.4596774193548387,97,165,60,65,50,58,495,0.3902439024390244,4.0
114,85,70,85,80,30,464,0.2066115702479339,80,125,75,40,95,85,500,0.6911764705882353,0.5
108,100,121,81,95,95,600,0.7476635514018691,76,104,71,104,71,108,534,0.912751677852349,2.0
76,48,48,57,62,34,325,0.11688311688311688,60,67,85,77,75,116,480,0.8888888888888888,0.5
60,30,30,36,56,50,262,0.32432432432432434,39,52,43,60,50,65,309,0.5041322314049587,1.0
65,95,75,55,55,85,430,0.6933333333333334,59,110,150,45,49,35,448,0.3333333333333333,0.0
70,60,62,80,82,60,414,0.4375,45,50,43,40,38,62,278,0.40441176470588236,0.5
40,55,99,40,79,47,360,0.26262626262626265,70,50,30,95,135,105,485,0.8040540540540541,1.0
50,65,64,44,48,43,314,0.2196969696969697,95,110,80,70,80,50,485,0.37209302325581395,1.0
85,105,100,79,83,78,530,0.5869565217391305,75,65,55,65,55,69,384,0.43548387096774194,1.0
45,55,45,65,45,75,330,0.5692307692307692,95,100,85,108,70,70,528,0.5652173913043478,0.5
50,35,55,25,25,15,205,0.021739130434782608,35,55,40,50,50,90,320,0.6838235294117647,1.0
40,60,30,31,31,70,262,0.4492753623188406,100,70,70,65,65,45,415,0.1897810218978102,1.0
50,95,95,35,110,70,455,0.5179856115107914,75,85,200,55,65,30,510,0.16778523489932887,2.0
70,80,102,80,102,40,474,0.2677165354330709,80,100,80,80,80,100,520,0.9051724137931034,1.0
70,105,105,50,40,20,390,0.33587786259541985,105,180,100,180,100,115,780,0.9477611940298507,2.0
80,105,65,60,75,130,515,0.9645390070921985,68,72,78,38,42,32,330,0.23809523809523808,0.5
95,124,78,69,71,58,495,0.37398373983739835,50,65,107,105,107,86,520,0.7313432835820896,1.0
50,92,108,92,108,35,485,0.2457627118644068,65,110,130,60,65,95,525,0.8278145695364238,1.0
78,81,71,74,69,126,499,0.9090909090909091,106,190,100,154,100,130,780,0.9259259259259259,2.0
50,53,48,53,48,64,316,0.4076923076923077,50,105,79,35,110,76,455,0.6214285714285714,1.0
70,145,88,140,70,112,625,0.8888888888888888,30,80,90,55,45,55,355,0.4295774647887324,2.0
60,48,45,43,90,42,328,0.21897810218978103,50,70,50,50,50,70,340,0.5645161290322581,2.0
77,59,50,67,63,46,362,0.23140495867768596,30,105,90,25,25,50,325,0.2773722627737226,0.5
82,80,86,85,75,72,480,0.6183206106870229,90,95,105,165,110,45,610,0.2890625,2.0
90,60,70,75,70,45,410,0.23880597014925373,80,160,80,130,80,100,630,0.8455284552845529,1.0
70,55,65,95,85,70,440,0.5307692307692308,58,50,145,95,105,30,483,0.2459016393442623,1.0
40,60,30,31,31,70,262,0.4492753623188406,110,80,90,95,90,65,530,0.5033557046979866,1.0
45,30,35,20,20,45,195,0.14782608695652175,55,40,85,80,105,40,405,0.23622047244094488,0.25
79,105,70,145,80,101,580,0.8608695652173913,135,85,40,40,85,5,390,0.6864406779661016,1.0
70,94,50,94,50,66,424,0.48148148148148145,55,112,45,74,45,70,401,0.559322033898305,0.25
75,90,140,60,60,40,465,0.3008130081300813,54,66,70,44,55,46,335,0.4214876033057851,1.0
55,40,40,65,45,35,280,0.16428571428571428,75,69,72,114,100,104,534,0.8253968253968254,1.0
95,75,110,100,80,30,490,0.15267175572519084,79,100,80,110,90,121,580,0.968,1.0
95,117,80,65,70,92,519,0.8409090909090909,40,40,40,70,40,20,250,0.032520325203252036,2.0
70,80,102,80,102,40,474,0.2677165354330709,110,78,73,76,71,60,468,0.3333333333333333,1.0
250,5,5,35,105,50,450,0.15306122448979592,50,105,79,35,110,76,455,0.6214285714285714,1.0
120,100,85,30,85,45,465,0.22448979591836735,79,115,70,125,80,111,580,0.8468468468468469,0.5
40,65,95,60,45,35,340,0.13986013986013987,59,74,50,35,50,35,303,0.3125,0.25
65,150,40,15,80,145,495,0.9663865546218487,75,80,70,65,75,90,455,0.7578125,0.125
60,67,85,77,75,116,480,0.8888888888888888,55,85,55,50,55,60,360,0.4233576642335766,0.125
60,80,110,50,80,45,425,0.2833333333333333,62,73,55,56,52,84,382,0.7244094488188977,0.0
70,65,65,55,55,70,380,0.5,70,90,90,135,90,125,600,0.9401709401709402,1.0
70,90,70,60,60,70,420,0.6390977443609023,70,140,70,110,65,105,560,0.95,0.5
60,60,60,105,105,105,495,0.848,106,150,70,194,120,140,780,0.952,2.0
65,63,45,45,45,45,308,0.2595419847328244,60,79,105,59,85,36,424,0.17054263565891473,2.0
80,100,200,50,100,50,580,0.3472222222222222,75,80,95,90,100,50,490,0.2158273381294964,1.0
70,45,48,60,65,35,323,0.15748031496062992,55,35,50,55,110,85,390,0.6277372262773723,1.0
95,135,80,110,80,100,600,0.8248175182481752,35,60,44,40,54,55,288,0.366412213740458,1.0
70,55,95,95,110,65,490,0.48872180451127817,70,105,105,50,40,20,390,0.33587786259541985,1.0
68,75,53,83,113,60,452,0.45384615384615384,50,53,48,53,48,64,316,0.358974358974359,1.0
55,85,55,50,55,60,360,0.4233576642335766,92,105,90,125,90,98,600,0.8217054263565892,1.0
30,45,55,70,55,85,340,0.5633802816901409,90,120,75,60,60,45,450,0.29411764705882354,1.0
70,110,180,60,60,50,530,0.4117647058823529,73,115,60,60,60,90,458,0.6694915254237288,1.0
89,124,80,55,80,55,483,0.5714285714285714,40,55,30,30,30,85,270,0.688,0.0
50,50,40,50,40,64,294,0.45588235294117646,55,65,35,60,30,85,330,0.6126126126126126,0.5
60,85,69,65,79,80,438,0.576,73,76,75,81,100,100,505,0.8110236220472441,1.0
100,128,90,77,77,128,600,0.959349593495935,101,72,72,99,89,29,462,0.1937984496124031,0.5
28,25,25,45,35,40,198,0.16083916083916083,75,125,70,125,70,115,580,0.9037037037037037,0.5
70,55,65,95,85,70,440,0.5307692307692308,55,75,50,40,40,80,340,0.6302521008403361,2.0
45,40,60,40,75,50,310,0.2926829268292683,70,92,65,80,55,98,460,0.8090909090909091,1.0
65,90,120,85,70,60,490,0.43410852713178294,85,60,65,135,105,100,550,0.7518248175182481,1.0
70,94,50,94,50,66,424,0.48148148148148145,90,100,60,90,60,80,480,0.6422764227642277,8.0
70,105,105,50,40,20,390,0.33587786259541985,40,30,30,40,50,30,220,0.07936507936507936,1.0
30,105,90,25,25,50,325,0.2773722627737226,70,55,65,95,85,70,440,0.5307692307692308,2.0
60,105,60,120,60,105,510,0.8849557522123894,100,180,160,150,90,90,770,0.7520661157024794,1.0
60,90,140,50,50,40,430,0.2535211267605634,60,40,60,40,60,35,295,0.18055555555555555,1.0
85,100,122,58,75,54,494,0.3939393939393939,50,95,90,95,90,180,600,0.9172413793103448,2.0
40,60,40,40,40,30,250,0.0948905109489051,63,120,85,90,55,55,468,0.2809917355371901,2.0
55,45,45,25,25,15,210,0.048,50,35,55,25,25,15,205,0.021739130434782608,0.5
60,45,70,75,85,55,390,0.3008130081300813,170,90,45,90,45,60,500,0.427536231884058,1.0
59,63,80,65,80,58,405,0.41843971631205673,85,110,90,45,90,80,500,0.6206896551724138,1.0
45,30,50,55,65,45,290,0.208,65,90,120,85,70,60,490,0.43410852713178294,2.0
70,40,50,55,50,25,290,0.061068702290076333,50,100,150,100,150,50,600,0.37142857142857144,2.0
61,72,57,55,55,65,365,0.3984375,90,50,34,60,44,70,348,0.6283185840707964,0.5
40,45,40,35,35,56,251,0.373015873015873,70,55,65,95,85,70,440,0.5307692307692308,0.25
100,100,125,110,50,50,535,0.384,41,56,40,62,44,71,314,0.568,2.0
100,150,120,120,100,90,680,0.6493506493506493,75,100,66,60,66,115,482,0.918918918918919,1.0
83,106,65,86,65,85,490,0.6640625,60,90,55,90,80,110,485,0.8677685950413223,1.0
55,85,122,58,75,99,494,0.8099173553719008,65,83,57,95,85,105,490,0.8914728682170543,1.0
150,120,100,120,100,90,680,0.664179104477612,65,75,105,35,65,85,430,0.6940298507462687,1.0
110,160,110,80,110,100,670,0.8591549295774648,62,77,62,50,42,65,358,0.4838709677419355,1.0
60,59,85,79,105,36,424,0.16666666666666666,100,50,50,76,96,70,442,0.5,0.25
90,60,60,40,40,40,330,0.29545454545454547,62,44,50,44,50,55,305,0.3629032258064516,0.0
40,50,90,30,55,65,330,0.44680851063829785,40,40,55,40,70,55,300,0.40939597315436244,1.0
45,85,70,40,40,60,340,0.5229357798165137,95,65,110,60,130,65,525,0.5275590551181102,0.5
110,78,73,76,71,60,468,0.3333333333333333,20,10,55,15,20,80,200,0.17985611510791366,0.5
20,15,20,10,55,80,200,0.2682926829268293,65,150,60,115,60,115,565,0.935251798561151,1.0
65,75,90,97,123,44,494,0.1987179487179487,40,55,80,35,60,30,300,0.15037593984962405,0.0
75,85,200,55,65,30,510,0.16778523489932887,30,30,30,30,30,30,180,0.12612612612612611,0.5
105,150,90,150,90,95,680,0.8285714285714286,80,135,85,70,95,150,615,0.9844961240310077,0.5
60,65,80,170,95,130,600,0.8625954198473282,105,30,105,140,105,55,540,0.3524590163934426,2.0
78,104,78,159,115,100,634,0.8444444444444444,10,55,25,35,45,95,265,0.5396825396825397,1.0
45,85,70,40,40,60,340,0.5229357798165137,45,30,50,65,50,45,285,0.13821138211382114,2.0
100,77,77,128,128,90,600,0.6901408450704225,80,185,115,40,105,75,600,0.6230769230769231,1.0
85,135,130,60,80,25,515,0.40540540540540543,80,50,100,100,200,50,580,0.2357142857142857,2.0
65,80,80,59,63,58,405,0.4411764705882353,105,95,80,40,80,90,490,0.753968253968254,1.0
60,55,50,40,55,45,305,0.22377622377622378,35,40,100,90,55,35,355,0.1796875,0.5
65,90,50,85,45,55,390,0.371900826446281,75,100,66,60,66,115,482,0.918918918918919,1.0
75,75,95,75,95,113,528,0.9015151515151515,54,66,70,44,55,46,335,0.4214876033057851,0.5
35,40,100,90,55,35,355,0.1796875,55,95,55,35,75,115,430,0.9380530973451328,2.0
50,50,120,80,80,30,410,0.07258064516129033,70,110,70,115,70,90,525,0.75,0.5
62,73,55,56,52,84,382,0.7244094488188977,65,65,65,50,50,90,385,0.72,0.5
80,50,100,100,200,50,580,0.2357142857142857,90,30,15,40,20,15,210,0.043478260869565216,1.0
100,75,115,90,115,85,580,0.6446280991735537,70,65,60,90,75,90,450,0.6571428571428571,1.0
58,109,112,48,48,109,484,0.8805970149253731,62,55,52,109,94,109,481,0.7833333333333333,0.5
40,45,40,65,40,65,295,0.5661764705882353,45,50,43,40,38,62,278,0.40441176470588236,2.0
70,80,50,35,35,35,305,0.14,50,52,48,65,50,55,320,0.33098591549295775,1.0
75,38,38,56,56,67,330,0.5263157894736842,60,95,80,60,80,30,405,0.19480519480519481,0.25
100,77,77,128,128,90,600,0.6901408450704225,75,38,38,56,56,67,330,0.5263157894736842,1.0
70,70,70,70,70,70,420,0.5289256198347108,70,140,230,60,80,50,630,0.32432432432432434,0.5
75,75,95,75,95,113,528,0.9015151515151515,165,75,80,40,45,65,470,0.5151515151515151,2.0
70,130,100,55,80,65,500,0.608,50,53,48,53,48,64,316,0.358974358974359,0.5
80,82,78,95,80,85,500,0.6869565217391305,130,85,80,85,95,60,535,0.43884892086330934,0.5
60,85,69,60,69,77,420,0.518796992481203,65,45,55,45,70,45,325,0.24369747899159663,1.0
91,72,90,129,90,108,580,0.8620689655172413,103,60,126,80,126,50,545,0.36363636363636365,1.0
50,52,48,65,50,55,320,0.33098591549295775,50,50,62,40,62,65,329,0.4188034188034188,1.0
60,70,105,70,120,75,500,0.5983606557377049,64,78,52,78,52,81,405,0.6422764227642277,2.0
63,120,85,90,55,55,468,0.2809917355371901,90,75,85,115,90,55,510,0.3445378151260504,1.0
70,90,90,135,90,125,600,0.9401709401709402,50,50,77,95,77,91,440,0.5916666666666667,2.0
100,90,130,45,65,55,485,0.4253731343283582,80,125,75,40,95,85,500,0.6911764705882353,1.0
45,22,60,27,30,29,213,0.07518796992481203,35,65,35,65,35,65,300,0.46621621621621623,1.0
111,83,68,92,82,39,475,0.1774193548387097,90,65,65,40,40,15,315,0.19672131147540983,0.5
105,140,55,30,55,95,480,0.8195488721804511,72,95,67,103,71,122,530,0.9606299212598425,0.5
90,85,75,115,100,115,580,0.9381443298969072,75,123,67,95,85,95,540,0.7642276422764228,0.5
60,100,85,80,85,100,510,0.7007874015748031,92,105,90,125,90,98,600,0.8217054263565892,0.0
60,55,90,145,90,80,520,0.6071428571428571,90,92,75,92,85,60,494,0.49586776859504134,4.0
50,70,50,50,50,40,310,0.16296296296296298,45,50,55,75,65,30,320,0.06293706293706294,0.5
100,100,100,100,100,100,600,0.8758169934640523,75,90,50,110,80,95,500,0.7985611510791367,0.0
90,130,80,65,85,55,505,0.4396551724137931,45,75,60,40,30,50,300,0.304,1.0
65,80,80,59,63,58,405,0.4411764705882353,85,100,122,58,75,54,494,0.3939393939393939,0.5
85,70,80,97,80,123,535,0.9304347826086956,90,60,70,75,70,45,410,0.23880597014925373,1.0
65,63,45,45,45,45,308,0.2595419847328244,39,52,43,60,50,65,309,0.5041322314049587,0.5
65,95,75,55,55,85,430,0.6933333333333334,43,30,55,40,65,97,330,0.6030534351145038,0.5
70,80,70,80,70,110,480,0.6594202898550725,60,55,145,75,150,40,525,0.2,0.5
105,105,75,65,100,50,500,0.37593984962406013,91,72,90,129,90,108,580,0.8620689655172413,1.0
67,82,62,46,48,43,348,0.22033898305084745,70,70,70,70,70,70,420,0.5289256198347108,2.0
58,50,145,95,105,30,483,0.2459016393442623,80,120,79,95,79,70,523,0.5833333333333334,1.0
80,105,65,60,75,130,515,0.9645390070921985,58,109,112,48,48,109,484,0.8805970149253731,1.0
30,45,135,45,90,30,375,0.09285714285714286,70,60,75,110,75,90,480,0.7165354330708661,1.0
20,40,15,35,35,60,205,0.34285714285714286,40,40,35,50,100,70,335,0.5031847133757962,2.0
50,60,60,60,60,30,320,0.11290322580645161,45,45,35,20,30,20,195,0.07246376811594203,1.0
80,120,130,55,65,45,495,0.37037037037037035,45,85,70,40,40,60,340,0.5229357798165137,1.0
48,61,40,61,40,50,300,0.2543859649122807,45,55,39,35,39,42,255,0.18518518518518517,2.0
63,63,47,41,41,74,329,0.56,50,40,85,40,65,25,305,0.08870967741935484,1.0
44,38,33,61,43,70,289,0.5267857142857143,50,75,75,65,65,50,380,0.4049586776859504,0.0
125,170,100,120,90,95,700,0.77,90,65,65,40,40,15,315,0.19672131147540983,0.5
40,45,35,65,55,70,310,0.4482758620689655,74,48,76,83,81,104,466,0.7913043478260869,1.0
60,60,60,85,85,85,435,0.631578947368421,30,45,55,70,55,85,340,0.5633802816901409,1.0
100,50,50,76,96,70,442,0.5,65,90,65,61,61,100,442,0.8373983739837398,1.0
70,60,125,115,70,55,495,0.35507246376811596,68,75,53,83,113,60,452,0.45384615384615384,0.5
40,60,30,31,31,70,262,0.4492753623188406,60,40,60,95,60,55,370,0.4222222222222222,0.0
40,40,50,30,30,30,220,0.0873015873015873,60,50,100,85,70,65,430,0.47580645161290325,1.0
45,80,100,35,37,28,325,0.3125,50,160,110,160,110,110,700,0.8854961832061069,1.0
75,100,63,80,63,116,497,0.9345794392523364,150,100,120,100,120,90,680,0.6666666666666666,0.5
55,35,50,55,110,85,390,0.6277372262773723,65,50,35,115,95,95,455,0.7333333333333333,2.0
50,100,150,100,150,50,600,0.37142857142857144,78,52,60,63,65,23,341,0.06015037593984962,1.0
70,100,115,30,65,30,410,0.24390243902439024,40,40,40,70,40,20,250,0.032520325203252036,2.0
86,76,86,116,56,95,515,0.7982456140350878,45,22,60,27,30,29,213,0.07518796992481203,2.0
75,80,95,90,100,50,490,0.2158273381294964,59,45,40,35,40,31,250,0.14285714285714285,1.0
56,61,65,48,45,38,313,0.17567567567567569,50,53,48,53,48,64,316,0.358974358974359,2.0
90,65,65,40,40,15,315,0.19672131147540983,80,82,83,100,100,80,525,0.6742424242424242,1.0
45,30,50,55,65,45,290,0.208,54,66,70,44,55,46,335,0.4214876033057851,1.0
65,136,94,54,96,135,580,0.9612403100775194,75,110,110,110,105,80,590,0.656934306569343,0.5
48,72,48,72,48,48,336,0.25984251968503935,75,125,75,30,75,85,465,0.625,1.0
95,70,73,95,90,60,483,0.3983739837398374,79,105,70,145,80,101,580,0.8608695652173913,1.0
95,155,109,70,130,81,640,0.6788321167883211,106,110,90,154,90,130,680,0.926829268292683,2.0
76,147,90,60,70,97,540,0.8267716535433071,110,135,60,50,65,88,508,0.7744360902255639,0.5
90,120,120,60,60,50,500,0.35294117647058826,80,80,80,55,55,90,440,0.6417910447761194,1.0
70,65,60,90,75,90,450,0.6571428571428571,67,89,116,79,116,33,500,0.2624113475177305,0.0
75,123,67,95,85,95,540,0.7642276422764228,40,80,100,30,30,20,300,0.11851851851851852,0.0
116,55,85,107,95,29,487,0.06818181818181818,40,20,30,40,80,55,265,0.22764227642276422,1.0
130,65,60,110,95,65,525,0.5227272727272727,41,56,40,62,44,71,314,0.568,0.5
65,50,70,95,80,65,425,0.4262295081967213,45,75,60,40,30,50,300,0.304,1.0
91,72,90,129,90,108,580,0.8620689655172413,55,63,90,50,80,42,380,0.21138211382113822,0.25
95,75,110,100,80,30,490,0.15267175572519084,255,10,10,75,135,55,540,0.3125,1.0
170,90,45,90,45,60,500,0.427536231884058,35,64,85,74,55,32,345,0.19827586206896552,0.5
75,125,75,30,75,85,465,0.625,66,117,70,40,50,67,410,0.4573643410852713,1.0
55,65,35,60,30,85,330,0.6126126126126126,60,70,65,125,105,90,515,0.6911764705882353,0.5
70,145,88,140,70,112,625,0.8888888888888888,99,68,83,72,87,51,460,0.417910447761194,0.5
115,45,20,45,25,20,270,0.11538461538461539,50,95,95,35,110,70,455,0.5179856115107914,2.0
44,50,91,24,86,10,305,0.1981981981981982,85,105,55,85,50,115,495,0.9032258064516129,1.0
60,85,60,50,50,125,430,0.9090909090909091,60,105,60,120,60,105,510,0.8849557522123894,1.0
75,98,63,98,63,101,498,0.8091603053435115,70,77,60,97,60,108,472,0.8394160583941606,0.5
68,65,65,125,115,80,518,0.6461538461538462,35,60,44,40,54,55,288,0.366412213740458,1.0
95,124,78,69,71,58,495,0.37398373983739835,60,60,60,85,85,85,435,0.631578947368421,0.0
45,75,60,40,30,50,300,0.304,50,50,150,50,150,50,500,0.2571428571428571,0.0
45,40,60,40,75,50,310,0.2926829268292683,75,69,72,114,100,104,534,0.8253968253968254,1.0
66,41,77,61,87,23,355,0.12096774193548387,65,90,65,61,61,100,442,0.8373983739837398,1.0
86,92,88,68,75,73,482,0.6835443037974683,55,40,40,65,45,35,280,0.16428571428571428,1.0
80,105,65,60,75,130,515,0.9645390070921985,90,30,15,40,20,15,210,0.043478260869565216,1.0
40,20,30,40,80,55,265,0.22764227642276422,50,65,107,105,107,86,520,0.6991150442477876,0.25
30,45,59,30,39,57,260,0.2803030303030303,70,110,70,115,70,90,525,0.75,0.0
60,60,60,105,105,105,495,0.848,30,45,135,45,90,30,375,0.09285714285714286,1.0
65,150,60,115,60,115,565,0.935251798561151,116,55,85,107,95,29,487,0.06818181818181818,2.0
44,50,91,24,86,10,305,0.1981981981981982,55,50,65,175,95,150,590,0.7818181818181819,1.0
54,66,70,44,55,46,335,0.4214876033057851,91,72,90,129,90,108,580,0.8925619834710744,2.0
10,55,25,35,45,95,265,0.5396825396825397,72,85,70,65,70,58,420,0.41304347826086957,1.0
40,65,95,60,45,35,340,0.13986013986013987,30,40,55,40,55,60,280,0.3237410071942446,1.0
60,100,89,55,69,112,485,0.9298245614035088,110,135,60,50,65,88,508,0.7744360902255639,0.0
76,104,71,104,71,108,534,0.912751677852349,62,73,55,56,52,84,382,0.7244094488188977,0.25
75,98,63,98,63,101,498,0.8091603053435115,109,66,84,81,99,32,471,0.2013888888888889,2.0
65,90,120,85,70,60,490,0.43410852713178294,10,55,25,35,45,95,265,0.5396825396825397,0.5
135,85,40,40,85,5,390,0.6864406779661016,41,64,45,50,50,50,300,0.36752136752136755,1.0
60,67,85,77,75,116,480,0.8888888888888888,50,75,75,65,65,50,380,0.4049586776859504,2.0
75,100,66,60,66,115,482,0.918918918918919,95,65,110,60,130,65,525,0.5275590551181102,1.0
75,100,95,40,70,110,490,0.8717948717948718,50,160,110,160,110,110,700,0.8854961832061069,0.5
70,85,65,105,85,120,530,0.9262295081967213,65,155,120,65,90,105,600,0.8677685950413223,0.25
70,100,70,105,75,40,460,0.23214285714285715,50,60,60,60,60,30,320,0.11290322580645161,1.0
100,120,120,150,100,90,680,0.7880794701986755,67,89,116,79,116,33,500,0.2624113475177305,0.25
80,80,90,110,130,110,600,0.8721804511278195,74,100,72,90,72,46,454,0.24561403508771928,1.0
120,70,120,75,130,85,600,0.6694915254237288,108,100,121,81,95,95,600,0.7476635514018691,2.0
35,55,35,30,30,35,220,0.23684210526315788,85,70,80,97,80,123,535,0.9304347826086956,1.0
75,123,67,95,85,95,540,0.7642276422764228,105,150,90,150,90,95,680,0.8285714285714286,1.0
65,65,60,110,95,130,525,0.9253731343283582,90,90,85,125,90,100,580,0.768595041322314,1.0
40,65,95,60,45,35,340,0.13986013986013987,100,110,90,85,90,60,535,0.47794117647058826,0.5
95,135,80,110,80,100,600,0.8248175182481752,78,52,60,63,65,23,341,0.06015037593984962,0.0
45,45,35,20,30,20,195,0.07246376811594203,60,90,70,60,120,40,440,0.27419354838709675,1.0
80,92,65,65,80,68,450,0.4824561403508772,85,56,77,50,77,78,423,0.53125,2.0
80,105,105,105,105,80,580,0.5939849624060151,60,95,80,60,80,30,405,0.19480519480519481,1.0
90,75,75,90,100,70,500,0.5462184873949579,39,52,43,60,50,65,309,0.5041322314049587,2.0
59,74,50,35,50,35,303,0.3125,80,135,130,95,90,70,600,0.5181818181818182,4.0
116,55,85,107,95,29,487,0.06818181818181818,40,30,32,50,52,65,269,0.3671875,1.0
30,30,42,30,42,70,244,0.4230769230769231,126,131,95,131,98,99,680,0.8294573643410853,0.5
75,140,65,112,65,110,567,0.9140625,90,130,80,65,85,55,505,0.4396551724137931,1.0
75,55,70,55,95,110,460,0.8444444444444444,120,70,120,75,130,85,600,0.6694915254237288,1.0
50,50,40,30,30,50,250,0.2781954887218045,89,124,80,55,80,55,483,0.5714285714285714,2.0
60,59,85,79,105,36,424,0.16666666666666666,50,55,50,36,30,43,264,0.2922077922077922,0.25
60,65,80,170,95,130,600,0.8625954198473282,106,110,90,154,90,130,680,0.926829268292683,2.0
70,110,180,60,60,50,530,0.4117647058823529,105,95,75,85,75,74,509,0.5714285714285714,0.25
70,145,88,140,70,112,625,0.8888888888888888,40,35,30,120,70,105,400,0.6692307692307692,0.5
59,45,40,35,40,31,250,0.14285714285714285,91,134,95,100,100,80,600,0.6304347826086957,1.0
80,120,79,95,79,70,523,0.5833333333333334,60,80,50,40,40,30,300,0.15328467153284672,1.0
65,50,70,95,80,65,425,0.4262295081967213,10,55,25,35,45,95,265,0.5396825396825397,2.0
60,130,80,60,60,70,460,0.5153846153846153,65,110,130,60,65,95,525,0.8278145695364238,0.5
45,30,35,20,20,45,195,0.14782608695652175,40,80,35,35,45,70,305,0.4661016949152542,0.5
60,45,50,90,80,70,395,0.625,77,85,51,55,51,65,384,0.5163934426229508,2.0
75,80,85,110,90,50,490,0.3548387096774194,80,45,65,90,110,80,470,0.5462962962962963,1.0
20,10,230,10,230,5,505,0.0,64,78,52,78,52,81,405,0.6422764227642277,0.25
80,90,80,130,110,110,600,0.856,72,60,30,20,30,25,237,0.11570247933884298,1.0
60,85,69,60,69,77,420,0.518796992481203,62,55,52,109,94,109,481,0.7833333333333333,1.0
68,125,65,65,115,80,518,0.6277372262773723,60,50,70,80,80,140,480,0.8449612403100775,1.0
28,25,25,45,35,40,198,0.16083916083916083,55,66,44,44,56,85,350,0.6888888888888889,1.0
45,55,39,35,39,42,255,0.18518518518518517,85,80,70,135,75,90,535,0.7006802721088435,1.0
70,65,60,90,75,90,450,0.6571428571428571,90,90,85,125,90,100,580,0.768595041322314,0.5
103,60,86,60,86,50,445,0.3458646616541353,57,80,91,80,87,75,470,0.5737704918032787,0.5
150,160,100,95,65,100,670,0.8866666666666667,106,150,70,194,120,140,780,0.952,1.0
64,165,75,93,83,75,555,0.6587301587301587,106,150,70,194,120,140,780,0.952,2.0
35,64,85,74,55,32,345,0.19827586206896552,103,60,86,60,86,50,445,0.3458646616541353,1.0
65,65,60,130,95,110,525,0.823943661971831,85,135,130,60,80,25,515,0.40540540540540543,1.0
60,48,45,43,90,42,328,0.21897810218978103,75,70,90,70,105,80,490,0.656,1.0
75,123,67,95,85,95,540,0.7642276422764228,80,75,150,75,150,50,580,0.30973451327433627,1.0
50,53,48,53,48,64,316,0.4076923076923077,50,50,120,80,80,30,410,0.07258064516129033,1.0
75,87,63,87,63,98,473,0.865546218487395,40,55,70,45,60,30,300,0.10619469026548672,0.5
60,80,110,50,80,45,425,0.2833333333333333,67,125,40,30,30,58,350,0.3431372549019608,2.0
80,85,95,30,30,25,345,0.2857142857142857,73,115,60,60,60,90,458,0.6694915254237288,1.0
60,95,80,60,80,30,405,0.19480519480519481,45,55,45,65,45,75,330,0.5692307692307692,0.25
70,120,65,45,85,125,510,0.9747899159663865,95,125,79,60,100,81,540,0.6165413533834586,1.0
95,75,110,100,80,30,490,0.15267175572519084,65,70,60,65,65,115,440,0.8583333333333333,1.0
62,50,58,73,54,72,369,0.4435483870967742,50,45,45,35,35,50,260,0.23529411764705882,1.0
75,80,85,110,90,50,490,0.3548387096774194,60,45,50,90,80,70,395,0.625,0.25
90,92,75,92,85,60,494,0.49586776859504134,50,48,43,46,41,60,288,0.47297297297297297,4.0
100,123,75,57,75,80,510,0.6923076923076923,70,83,50,37,50,60,350,0.3360655737704918,1.0
80,120,130,55,65,45,495,0.37037037037037035,55,45,43,55,43,72,313,0.5853658536585366,0.0
67,89,116,79,116,33,500,0.2624113475177305,45,30,15,85,65,65,305,0.36220472440944884,1.0
49,66,70,44,55,51,335,0.4260869565217391,45,30,40,105,50,20,290,0.031007751937984496,2.0
75,125,230,55,95,30,610,0.3448275862068966,60,90,140,50,50,40,430,0.2535211267605634,4.0
59,63,80,65,80,58,405,0.41843971631205673,74,48,76,83,81,104,466,0.7913043478260869,1.0
150,160,100,95,65,100,670,0.8866666666666667,40,55,80,35,60,30,300,0.15037593984962405,0.5
95,85,85,65,65,35,430,0.2571428571428571,70,55,75,45,65,60,370,0.45901639344262296,0.0
45,100,135,65,135,45,525,0.29411764705882354,110,130,80,70,60,80,530,0.5862068965517241,1.0
70,60,70,87,78,85,450,0.6228070175438597,79,103,120,135,115,78,630,0.5763888888888888,2.0
38,30,85,55,65,30,303,0.21428571428571427,60,50,150,50,150,60,520,0.5206611570247934,2.0
85,60,65,135,105,100,550,0.7518248175182481,78,81,71,74,69,126,499,0.9090909090909091,0.125
100,77,77,128,128,90,600,0.6901408450704225,70,62,67,55,55,56,365,0.38513513513513514,2.0
38,35,40,27,25,35,200,0.08208955223880597,106,110,90,154,90,130,680,0.926829268292683,2.0
90,95,95,70,90,70,510,0.5230769230769231,80,50,100,100,200,50,580,0.2357142857142857,2.0
70,90,110,60,75,95,500,0.7333333333333333,70,120,40,95,40,95,460,0.8106060606060606,0.5
70,70,40,60,40,60,340,0.4247787610619469,65,76,84,54,96,105,480,0.9008264462809917,1.0
85,135,130,60,80,25,515,0.40540540540540543,55,85,122,58,75,99,494,0.8099173553719008,1.0
65,90,40,45,80,75,395,0.625,80,125,75,40,95,85,500,0.6911764705882353,0.5
65,60,70,85,75,40,395,0.1796875,66,65,48,62,57,52,350,0.36220472440944884,1.0
110,160,110,80,110,100,670,0.8591549295774648,90,75,85,115,90,55,510,0.3445378151260504,1.0
75,75,60,83,60,60,413,0.39344262295081966,60,50,100,85,70,65,430,0.47580645161290325,0.5
100,100,80,60,60,50,450,0.3050847457627119,50,35,55,25,25,15,205,0.021739130434782608,0.5
65,130,60,75,60,75,465,0.689922480620155,50,85,40,85,40,35,335,0.1746031746031746,1.0
62,48,66,59,57,49,341,0.33884297520661155,60,60,50,40,50,75,335,0.5882352941176471,1.0
40,65,95,60,45,35,340,0.13986013986013987,35,20,65,40,65,20,245,0.02459016393442623,2.0
50,85,40,85,40,35,335,0.1746031746031746,60,40,80,60,45,40,325,0.23529411764705882,0.5
85,60,65,135,105,100,550,0.7518248175182481,60,60,60,60,60,60,360,0.38095238095238093,1.0
60,80,95,70,85,50,440,0.2231404958677686,65,40,50,125,60,30,370,0.07258064516129033,1.0
76,25,45,67,55,24,292,0.0390625,79,103,120,135,115,78,630,0.5763888888888888,1.0
60,40,80,60,45,40,325,0.23529411764705882,45,60,30,80,50,65,330,0.4603174603174603,0.0
85,60,65,135,105,100,550,0.7518248175182481,75,80,70,65,75,90,455,0.7578125,0.25
78,130,111,130,85,100,634,0.8561151079136691,60,75,100,55,80,50,420,0.3088235294117647,1.0
73,115,60,60,60,90,458,0.6694915254237288,67,57,55,77,55,114,425,0.8879310344827587,1.0
70,140,70,110,65,105,560,0.95,45,80,100,35,37,28,325,0.3125,2.0
36,50,50,65,60,44,305,0.16363636363636364,85,90,80,70,80,130,535,0.9262295081967213,2.0
50,53,48,53,48,64,316,0.358974358974359,65,85,70,75,70,40,405,0.203125,1.0
123,100,62,97,81,68,531,0.4806201550387597,60,100,89,55,69,112,485,0.9298245614035088,0.25
80,82,83,100,100,80,525,0.6742424242424242,30,45,135,45,90,30,375,0.09285714285714286,1.0
83,80,75,70,70,101,479,0.8615384615384616,50,100,150,100,150,50,600,0.37142857142857144,0.25
88,107,122,74,75,64,530,0.4596774193548387,70,60,75,110,75,90,480,0.7165354330708661,0.5
90,93,55,70,55,55,418,0.3819444444444444,62,55,52,109,94,109,481,0.7833333333333333,2.0
65,150,40,15,80,145,495,0.9663865546218487,75,140,65,112,65,110,567,0.9140625,0.25
80,85,95,30,30,25,345,0.2857142857142857,64,115,65,83,63,65,455,0.5323741007194245,1.0
77,85,51,55,51,65,384,0.5163934426229508,49,66,70,44,55,51,335,0.4260869565217391,1.0
40,80,35,35,45,70,305,0.4661016949152542,75,75,130,75,130,95,580,0.7479674796747967,0.5
62,50,58,73,54,72,369,0.4435483870967742,91,129,90,72,90,108,580,0.8536585365853658,0.25
95,117,80,65,70,92,519,0.8409090909090909,55,75,50,40,40,80,340,0.6302521008403361,0.0
55,130,115,50,50,75,475,0.5982142857142857,103,60,126,80,126,50,545,0.36363636363636365,1.0
40,20,30,40,80,55,265,0.22764227642276422,55,35,50,55,110,85,390,0.6277372262773723,1.0
90,120,100,150,120,100,680,0.7718120805369127,65,110,130,60,65,95,525,0.8278145695364238,0.5
100,100,100,100,100,100,600,0.8602941176470589,45,22,60,27,30,29,213,0.07518796992481203,0.5
40,80,100,30,30,20,300,0.11851851851851852,100,128,90,77,77,128,600,0.959349593495935,0.5
111,83,68,92,82,39,475,0.1774193548387097,79,100,80,110,90,121,580,0.968,0.0
65,50,70,95,80,65,425,0.4262295081967213,58,109,112,48,48,109,484,0.8805970149253731,0.5
100,50,50,76,96,70,442,0.5,70,65,65,55,55,70,380,0.5,1.0
70,65,60,90,75,90,450,0.6571428571428571,49,49,56,49,61,66,330,0.5190839694656488,1.0
50,52,48,65,50,55,320,0.33098591549295775,135,85,40,40,85,5,390,0.6864406779661016,1.0
75,98,63,98,63,101,498,0.8091603053435115,54,45,47,75,98,52,371,0.39669421487603307,1.0
50,75,35,70,30,40,300,0.21296296296296297,80,120,79,95,79,70,523,0.5833333333333334,1.0
44,75,35,63,33,45,295,0.2647058823529412,60,85,60,85,60,55,405,0.3673469387755102,1.0
25,20,15,105,55,90,310,0.32407407407407407,105,125,100,60,100,100,590,0.8359375,1.0
58,50,145,95,105,30,483,0.2459016393442623,75,89,85,55,65,36,405,0.29545454545454547,1.0
55,70,45,70,50,60,350,0.45,65,130,60,95,110,65,525,0.5303030303030303,0.5
55,65,95,95,45,85,440,0.6610169491525424,58,64,58,80,65,80,405,0.609271523178808,2.0
65,55,115,100,40,60,435,0.3798449612403101,75,100,95,40,70,110,490,0.8717948717948718,1.0
100,150,140,100,90,90,670,0.7969924812030075,75,75,95,75,95,113,528,0.9015151515151515,0.5
35,64,85,74,55,32,345,0.19827586206896552,50,95,180,85,45,70,525,0.5298507462686567,0.5
80,85,95,30,30,25,345,0.2857142857142857,60,100,85,80,85,100,510,0.7007874015748031,0.5
51,65,65,80,75,59,395,0.4365079365079365,100,75,115,90,115,85,580,0.6446280991735537,0.5
50,20,55,25,25,30,205,0.09774436090225563,45,75,60,40,30,50,300,0.304,1.0
65,75,90,97,123,44,494,0.1987179487179487,86,76,86,116,56,95,515,0.7982456140350878,1.0
50,65,107,105,107,86,520,0.703125,78,104,78,159,115,100,634,0.8444444444444444,2.0
56,61,65,48,45,38,313,0.17567567567567569,66,65,48,62,57,52,350,0.36220472440944884,0.5
75,123,67,95,85,95,540,0.7642276422764228,80,105,105,105,105,80,580,0.5939849624060151,1.0
40,40,40,70,40,20,250,0.032520325203252036,108,100,121,81,95,95,600,0.7476635514018691,0.5
50,53,48,53,48,64,316,0.46153846153846156,100,150,110,95,110,70,635,0.5923076923076923,0.5
40,45,40,65,40,65,295,0.5661764705882353,45,30,50,55,65,45,290,0.208,1.0
50,20,55,25,25,30,205,0.09774436090225563,55,55,55,85,55,30,335,0.1320754716981132,2.0
59,63,80,65,80,58,405,0.41843971631205673,50,48,43,46,41,60,288,0.47297297297297297,1.0
86,81,97,81,107,43,495,0.203125,80,82,83,100,100,80,525,0.6742424242424242,0.25
95,110,95,40,95,55,490,0.40336134453781514,150,160,100,95,65,100,670,0.8866666666666667,1.0
60,50,70,50,90,65,385,0.39568345323741005,60,52,168,47,138,30,495,0.19834710743801653,0.0
70,115,60,115,60,55,475,0.4647887323943662,40,30,30,55,30,85,270,0.4666666666666667,1.0
60,70,50,100,50,65,395,0.5217391304347826,100,150,90,180,160,90,770,0.7348484848484849,1.0
75,123,67,95,85,95,540,0.7642276422764228,60,30,30,36,56,50,262,0.32432432432432434,2.0
64,165,75,93,83,75,555,0.6587301587301587,40,30,30,40,50,30,220,0.07936507936507936,1.0
65,136,94,54,96,135,580,0.9612403100775194,70,110,80,55,80,105,500,0.8794326241134752,0.25
45,67,60,35,50,63,320,0.5128205128205128,57,80,91,80,87,75,470,0.5737704918032787,1.0
67,57,55,77,55,114,425,0.8879310344827587,95,124,78,69,71,58,495,0.37398373983739835,0.0
62,48,54,63,60,68,355,0.5178571428571429,50,50,40,30,30,50,250,0.2781954887218045,2.0
75,70,90,70,105,80,490,0.656,95,145,130,120,90,120,700,0.9398496240601504,2.0
125,120,90,170,100,95,700,0.78125,101,72,72,99,89,29,462,0.1937984496124031,0.0
45,30,50,65,50,45,285,0.13821138211382114,58,64,58,80,65,80,405,0.5423728813559322,1.0
85,105,85,40,50,40,405,0.211864406779661,68,85,65,165,135,100,618,0.8083333333333333,0.25
75,100,63,80,63,116,497,0.9345794392523364,45,80,100,35,37,28,325,0.3125,1.0
50,50,95,40,50,35,320,0.20279720279720279,100,120,120,150,100,90,680,0.7880794701986755,2.0
82,80,86,85,75,72,480,0.6183206106870229,100,77,77,128,128,90,600,0.6901408450704225,1.0
42,52,67,39,56,50,306,0.2868217054263566,70,110,75,145,85,145,630,0.9444444444444444,0.25
91,72,90,129,90,108,580,0.8620689655172413,55,70,40,60,40,40,305,0.26956521739130435,2.0
91,90,106,130,106,77,600,0.648854961832061,65,130,60,75,60,75,465,0.689922480620155,1.0
50,50,150,50,150,50,500,0.2571428571428571,80,160,60,170,130,80,680,0.6180555555555556,2.0
75,75,130,75,130,95,580,0.7479674796747967,60,50,50,60,70,50,340,0.28346456692913385,1.0
60,65,70,85,75,40,395,0.21705426356589147,51,65,65,80,75,59,395,0.4365079365079365,1.0
100,120,100,150,120,90,680,0.728,100,50,50,76,96,70,442,0.5,1.0
70,70,40,60,40,60,340,0.4247787610619469,74,48,76,83,81,104,466,0.7322834645669292,2.0
77,59,50,67,63,46,362,0.23140495867768596,90,55,75,60,75,30,385,0.13970588235294118,1.0
72,60,30,20,30,25,237,0.11570247933884298,40,45,35,40,40,90,290,0.65,2.0
68,85,65,165,135,100,618,0.8083333333333333,60,85,69,60,69,77,420,0.518796992481203,1.0
55,81,60,50,70,97,413,0.7214285714285714,40,30,30,55,30,85,270,0.4666666666666667,1.0
55,55,85,65,85,35,380,0.2014388489208633,55,47,52,40,40,41,275,0.16806722689075632,1.0
70,140,230,60,80,50,630,0.32432432432432434,68,75,53,83,113,60,452,0.45384615384615384,1.0
60,80,95,70,85,50,440,0.2231404958677686,95,75,80,100,110,30,490,0.24242424242424243,0.5
50,92,108,92,108,35,485,0.2457627118644068,75,69,72,114,100,104,534,0.8253968253968254,4.0
42,52,67,39,56,50,306,0.2868217054263566,40,50,45,70,45,70,320,0.5517241379310345,2.0
55,70,40,60,40,40,305,0.26956521739130435,55,45,43,55,43,72,313,0.5853658536585366,2.0
36,50,50,65,60,44,305,0.16363636363636364,55,84,105,114,75,52,485,0.2890625,0.5
60,60,60,35,35,30,280,0.11194029850746269,70,65,65,55,55,70,380,0.5,1.0
80,80,80,55,55,90,440,0.6417910447761194,75,69,72,114,100,104,534,0.8253968253968254,1.0
65,110,130,60,65,95,525,0.8278145695364238,70,80,65,90,65,85,455,0.578125,1.0
60,80,50,40,40,30,300,0.15328467153284672,55,69,85,32,35,28,304,0.09302325581395349,1.0
60,60,60,85,85,85,435,0.631578947368421,60,50,150,50,150,60,520,0.5206611570247934,2.0
68,85,65,165,135,100,618,0.8083333333333333,65,110,130,60,65,95,525,0.8278145695364238,1.0
75,125,100,70,80,45,495,0.33035714285714285,60,85,40,30,45,68,328,0.6422018348623854,0.5
50,47,50,57,50,65,319,0.463768115942029,70,90,70,60,60,70,420,0.6390977443609023,2.0
60,85,60,50,50,125,430,0.9090909090909091,61,72,57,55,55,65,365,0.3984375,1.0
59,59,58,90,70,73,409,0.5826086956521739,78,70,61,50,61,100,420,0.8145161290322581,1.0
90,100,90,125,85,90,580,0.7352941176470589,106,110,90,154,90,130,680,0.926829268292683,1.0
85,60,65,135,105,100,550,0.7518248175182481,50,65,107,105,107,86,520,0.7758620689655172,0.5
84,71,43,71,43,48,360,0.25874125874125875,50,50,95,40,50,35,320,0.20279720279720279,1.0
105,140,95,55,65,45,505,0.3,65,65,60,110,95,130,525,0.9253731343283582,1.0
38,30,41,30,41,60,240,0.2897196261682243,75,55,70,55,95,110,460,0.8444444444444444,1.0
90,60,70,75,70,45,410,0.23880597014925373,65,47,55,73,75,85,400,0.65,1.0
65,80,80,59,63,58,405,0.4411764705882353,60,79,105,59,85,36,424,0.17054263565891473,2.0
75,95,95,95,95,85,540,0.6470588235294118,91,129,90,72,90,108,580,0.8536585365853658,2.0
45,50,35,55,75,40,300,0.21367521367521367,40,40,50,30,30,30,220,0.0873015873015873,1.0
100,150,140,100,90,90,670,0.7969924812030075,65,73,55,47,75,85,400,0.6846846846846847,0.5
58,50,145,95,105,30,483,0.2459016393442623,50,75,75,65,65,50,380,0.4049586776859504,1.0
49,66,70,44,55,51,335,0.4260869565217391,100,50,50,76,96,70,442,0.5,0.0
80,75,150,75,150,50,580,0.30973451327433627,65,110,130,60,65,95,525,0.8278145695364238,1.0
40,55,80,35,60,30,300,0.15037593984962405,62,55,52,109,94,109,481,0.7833333333333333,0.5
75,80,95,90,100,50,490,0.2158273381294964,44,38,39,61,79,42,303,0.2251655629139073,1.0
88,107,122,74,75,64,530,0.4596774193548387,60,95,80,60,80,30,405,0.19480519480519481,0.125
60,85,60,85,60,55,405,0.3673469387755102,64,66,68,81,76,50,405,0.25190839694656486,0.5
40,40,40,70,40,20,250,0.032520325203252036,73,100,60,100,60,65,458,0.42657342657342656,1.0
65,90,122,58,75,84,494,0.71875,55,70,45,70,50,60,350,0.45,0.5
55,104,105,94,75,52,485,0.36363636363636365,50,75,45,40,45,60,315,0.4380165289256198,1.0
55,55,45,63,45,45,308,0.25,75,98,63,98,63,101,498,0.8091603053435115,0.5
60,45,50,90,80,70,395,0.625,115,45,20,45,25,20,270,0.11538461538461539,0.5
60,80,50,40,40,30,300,0.15328467153284672,35,70,55,45,55,25,285,0.09420289855072464,1.0
72,105,115,54,86,68,500,0.5149253731343284,73,115,60,60,60,90,458,0.6694915254237288,1.0
70,95,125,65,75,45,475,0.33613445378151263,78,92,75,74,63,118,500,0.8842975206611571,0.25
91,134,95,100,100,80,600,0.6304347826086957,67,82,62,46,48,43,348,0.22033898305084745,2.0
85,110,76,65,82,56,474,0.3933333333333333,77,85,51,55,51,65,384,0.5163934426229508,0.5
78,92,75,74,63,118,500,0.8842975206611571,60,80,50,40,40,30,300,0.15328467153284672,0.5
110,130,80,70,60,80,530,0.5862068965517241,65,95,57,100,85,93,495,0.7441860465116279,1.0
50,35,55,25,25,15,205,0.021739130434782608,50,52,48,65,50,55,320,0.33098591549295775,1.0
110,130,80,70,60,80,530,0.5862068965517241,35,20,65,40,65,20,245,0.02459016393442623,1.0
65,80,65,35,65,60,370,0.38405797101449274,115,115,85,90,75,100,580,0.8134328358208955,1.0
70,140,230,60,80,50,630,0.32432432432432434,100,100,100,100,100,100,600,0.8758169934640523,0.5
65,100,70,80,80,105,500,0.8666666666666667,35,35,40,35,55,50,250,0.40336134453781514,2.0
69,69,76,69,86,91,460,0.6554621848739496,100,164,150,95,120,71,700,0.5645161290322581,2.0
70,80,50,35,35,35,305,0.14,45,30,15,85,65,65,305,0.36220472440944884,1.0
75,95,67,125,95,83,540,0.7117117117117117,48,61,40,61,40,50,300,0.2543859649122807,1.0
70,80,102,80,102,40,474,0.2677165354330709,50,100,150,100,150,50,600,0.37142857142857144,0.25
60,65,80,170,95,130,600,0.8625954198473282,78,92,75,74,63,118,500,0.8842975206611571,1.0
65,50,35,115,95,95,455,0.7333333333333333,80,105,105,105,105,80,580,0.5939849624060151,0.5
35,70,55,45,55,25,285,0.09420289855072464,106,190,100,154,100,130,780,0.9259259259259259,1.0
70,110,70,115,70,90,525,0.75,60,50,70,80,80,140,480,0.8449612403100775,0.5
106,190,100,154,100,130,780,0.9259259259259259,65,45,55,45,70,45,325,0.24369747899159663,1.0
95,75,80,100,110,30,490,0.24242424242424243,50,25,28,45,55,15,218,0.0625,1.0
70,20,50,20,50,40,250,0.1557377049180328,105,150,90,150,90,95,680,0.8285714285714286,1.0
60,48,45,43,90,42,328,0.21897810218978103,75,87,63,87,63,98,473,0.865546218487395,1.0
60,55,145,75,150,40,525,0.2,78,52,60,63,65,23,341,0.06015037593984962,0.5
75,140,65,112,65,110,567,0.9140625,65,75,90,97,123,44,494,0.1987179487179487,1.0
62,48,54,63,60,68,355,0.5178571428571429,108,130,95,80,85,102,600,0.7637795275590551,2.0
40,35,30,20,20,50,195,0.23423423423423423,73,95,62,85,65,85,465,0.6666666666666666,1.0
50,85,125,85,115,20,480,0.4306569343065693,62,50,58,73,54,72,369,0.4435483870967742,0.0
75,125,70,125,70,115,580,0.9037037037037037,50,75,45,40,45,60,315,0.4380165289256198,1.0
45,55,45,65,45,75,330,0.5692307692307692,85,70,80,97,80,123,535,0.9304347826086956,4.0
80,145,150,105,110,110,700,0.8692307692307693,35,55,40,50,50,90,320,0.6838235294117647,0.5
60,50,50,60,70,50,340,0.28346456692913385,125,120,90,170,100,95,700,0.78125,0.25
50,70,50,50,50,70,340,0.5645161290322581,95,60,79,100,125,81,540,0.6201550387596899,1.0
57,24,86,24,86,23,300,0.12727272727272726,40,55,99,40,79,47,360,0.26262626262626265,2.0
72,60,30,20,30,25,237,0.11570247933884298,52,65,50,45,50,38,300,0.27419354838709675,2.0
54,63,52,83,56,97,405,0.7697841726618705,67,58,57,81,67,101,431,0.8790322580645161,1.0
50,75,70,35,70,48,348,0.29357798165137616,65,65,45,75,45,95,390,0.72,0.25
45,85,70,40,40,60,340,0.5229357798165137,60,85,60,50,50,125,430,0.9090909090909091,1.0
30,45,135,45,90,30,375,0.09285714285714286,110,80,90,95,90,65,530,0.5033557046979866,2.0
60,95,80,60,80,30,405,0.19480519480519481,78,130,111,130,85,100,634,0.8561151079136691,0.125
100,100,80,60,60,50,450,0.3050847457627119,40,30,50,55,55,100,330,0.584070796460177,2.0
84,86,88,111,101,60,530,0.4634146341463415,115,45,20,45,25,20,270,0.11538461538461539,0.5
110,123,65,100,65,65,528,0.5217391304347826,105,125,100,60,100,100,590,0.8359375,2.0
75,38,38,56,56,67,330,0.5263157894736842,49,66,70,44,55,51,335,0.4260869565217391,0.25
50,180,20,180,20,150,600,0.9029850746268657,105,125,100,60,100,100,590,0.8359375,1.0
85,80,70,135,75,90,535,0.7006802721088435,75,75,130,75,130,95,580,0.7479674796747967,1.0
126,131,95,131,98,99,680,0.8102189781021898,68,85,65,165,135,100,618,0.8083333333333333,1.0
80,45,65,90,110,80,470,0.5462962962962963,50,75,45,40,45,60,315,0.4380165289256198,1.0
60,60,60,60,60,60,360,0.38095238095238093,86,81,97,81,107,43,495,0.203125,0.5
70,110,75,145,85,145,630,0.9444444444444444,50,160,110,160,110,110,700,0.8854961832061069,0.0
90,93,55,70,55,55,418,0.3819444444444444,45,45,35,20,30,20,195,0.07246376811594203,1.0
50,85,40,85,40,35,335,0.1746031746031746,80,80,50,40,50,25,325,0.176056338028169,0.5
30,30,42,30,42,70,244,0.4230769230769231,44,75,35,63,33,45,295,0.2647058823529412,0.5
70,65,60,90,75,90,450,0.6571428571428571,55,55,55,85,55,30,335,0.1320754716981132,2.0
110,130,80,70,60,80,530,0.5862068965517241,55,68,64,45,55,31,318,0.11666666666666667,1.0
59,63,80,65,80,58,405,0.41843971631205673,45,53,70,40,60,42,310,0.25735294117647056,0.5
45,75,60,40,30,50,300,0.304,30,45,59,30,39,57,260,0.2803030303030303,1.0
78,65,68,112,154,75,552,0.628099173553719,80,70,40,100,60,145,495,0.921875,1.0
75,80,85,110,90,50,490,0.3548387096774194,49,55,42,42,37,85,310,0.6068376068376068,1.0
60,40,60,95,60,55,370,0.4222222222222222,50,85,55,65,65,90,410,0.7478260869565218,0.5
90,130,80,65,85,55,505,0.4396551724137931,60,40,50,75,85,95,405,0.6044776119402985,1.0
110,85,95,80,95,50,515,0.2713178294573643,130,70,35,70,35,60,400,0.4017857142857143,1.0
105,150,90,150,90,95,680,0.8285714285714286,40,35,30,120,70,105,400,0.6692307692307692,1.0
90,92,87,75,85,76,505,0.5409836065573771,50,20,40,20,40,20,190,0.0962962962962963,2.0
50,80,95,10,45,10,290,0.232,66,65,48,62,57,52,350,0.36220472440944884,1.0
55,70,40,60,40,40,305,0.26956521739130435,40,45,65,100,120,90,460,0.5588235294117647,1.0
75,125,70,125,70,115,580,0.9037037037037037,60,45,50,90,80,70,395,0.625,1.0
50,50,120,80,80,30,410,0.07258064516129033,100,100,90,150,140,90,670,0.71875,0.5
126,131,95,131,98,99,680,0.8102189781021898,35,55,40,50,50,90,320,0.6838235294117647,0.5
55,85,55,50,55,60,360,0.4233576642335766,60,79,105,59,85,36,424,0.17054263565891473,2.0
45,85,50,55,50,65,350,0.5076923076923077,77,120,90,60,90,48,485,0.2785714285714286,1.0
110,130,80,70,60,80,530,0.5862068965517241,65,90,40,45,80,75,395,0.625,1.0
79,103,120,135,115,78,630,0.5763888888888888,75,55,70,55,95,110,460,0.8444444444444444,0.5
95,110,95,40,95,55,490,0.40336134453781514,72,105,115,54,86,68,500,0.5149253731343284,0.5
66,41,77,61,87,23,355,0.12096774193548387,75,140,65,112,65,110,567,0.9140625,2.0
85,100,122,58,75,54,494,0.3939393939393939,74,94,131,54,116,20,489,0.4485294117647059,0.25
45,65,34,40,34,45,263,0.2589928057553957,70,120,65,45,85,125,510,0.9747899159663865,1.0
66,117,70,40,50,67,410,0.4573643410852713,75,125,230,55,95,30,610,0.3448275862068966,0.5
60,100,115,70,85,90,520,0.7557251908396947,50,35,55,25,25,15,205,0.021739130434782608,1.0
77,59,50,67,63,46,362,0.23140495867768596,100,150,90,180,160,90,770,0.7348484848484849,0.5
68,75,53,83,113,60,452,0.45384615384615384,35,60,44,40,54,55,288,0.366412213740458,1.0
90,90,85,125,90,100,580,0.768595041322314,45,50,55,75,65,30,320,0.06293706293706294,1.0
31,45,90,30,30,40,266,0.21929824561403508,70,83,50,37,50,60,350,0.3360655737704918,0.0
101,72,72,99,89,29,462,0.1937984496124031,35,70,55,45,55,25,285,0.09420289855072464,1.0
49,49,56,49,61,66,330,0.5190839694656488,90,95,95,70,90,70,510,0.5230769230769231,0.5
55,69,85,32,35,28,304,0.09302325581395349,75,95,95,95,95,85,540,0.6470588235294118,1.0
55,70,45,70,50,60,350,0.45,60,85,69,65,79,80,438,0.576,1.0
125,120,90,170,100,95,700,0.78125,105,150,90,150,90,95,680,0.8285714285714286,8.0
95,75,110,100,80,30,490,0.15267175572519084,130,65,60,110,95,65,525,0.5227272727272727,0.5
90,50,34,60,44,70,348,0.6283185840707964,70,55,75,45,65,60,370,0.45901639344262296,0.5
50,70,50,50,50,40,310,0.16296296296296298,75,125,70,125,70,115,580,0.9037037037037037,1.0
116,55,85,107,95,29,487,0.06818181818181818,31,45,90,30,30,40,266,0.21929824561403508,2.0
70,80,50,35,35,35,305,0.14,40,40,40,70,40,20,250,0.032520325203252036,1.0
25,35,70,95,55,45,325,0.16783216783216784,65,50,70,95,80,65,425,0.4262295081967213,1.0
61,84,65,70,70,70,420,0.5,44,38,39,61,79,42,303,0.2251655629139073,0.0
50,80,95,10,45,10,290,0.232,40,40,55,40,70,55,300,0.40939597315436244,0.5
65,75,105,35,65,85,430,0.6940298507462687,100,150,110,95,110,70,635,0.5923076923076923,1.0
70,105,105,50,40,20,390,0.33587786259541985,80,82,78,95,80,85,500,0.6869565217391305,1.0
95,65,65,110,130,60,525,0.4016393442622951,50,20,40,20,40,20,190,0.0962962962962963,1.0
60,130,80,60,60,70,460,0.5153846153846153,78,65,68,112,154,75,552,0.628099173553719,0.5
80,115,80,65,55,93,488,0.7846153846153846,40,65,95,60,45,35,340,0.13986013986013987,1.0
80,105,65,60,75,130,515,0.9645390070921985,60,85,69,65,79,80,438,0.576,1.0
70,105,105,50,40,20,390,0.33587786259541985,54,66,70,44,55,46,335,0.4214876033057851,1.0
60,55,90,145,90,80,520,0.6071428571428571,71,120,95,120,95,99,600,0.8203125,4.0
55,50,40,40,40,75,300,0.5945945945945946,45,90,20,65,20,65,305,0.5116279069767442,1.0
70,100,70,105,75,40,460,0.23214285714285715,90,65,65,40,40,15,315,0.19672131147540983,0.5
65,110,130,60,65,95,525,0.8278145695364238,35,40,100,90,55,35,355,0.1796875,4.0
50,50,50,50,50,50,300,0.30708661417322836,85,135,130,60,80,25,515,0.40540540540540543,1.0
85,110,90,45,90,80,500,0.6206896551724138,46,87,60,30,40,57,320,0.37777777777777777,1.0
100,164,150,95,120,71,700,0.5645161290322581,75,95,95,95,95,85,540,0.6470588235294118,1.0
100,150,120,120,100,90,680,0.6493506493506493,35,80,50,50,70,120,405,0.84375,0.0
54,66,70,44,55,46,335,0.4214876033057851,70,65,60,90,75,90,450,0.6571428571428571,0.25
75,75,95,75,95,113,528,0.9015151515151515,60,95,80,60,80,30,405,0.19480519480519481,0.25
59,63,80,65,80,58,405,0.41843971631205673,80,120,70,110,70,80,530,0.6422764227642277,2.0
85,70,80,97,80,123,535,0.9304347826086956,60,85,69,65,79,80,438,0.576,1.0
40,55,70,45,60,30,300,0.10619469026548672,76,48,48,57,62,34,325,0.11688311688311688,0.5
70,80,102,80,102,40,474,0.2677165354330709,110,80,90,95,90,65,530,0.5033557046979866,1.0
57,24,86,24,86,23,300,0.12727272727272726,70,50,30,95,135,105,485,0.8040540540540541,2.0
90,85,100,95,125,85,580,0.6834532374100719,89,124,80,55,80,55,483,0.5714285714285714,2.0
40,80,100,30,30,20,300,0.11851851851851852,80,100,70,50,60,45,405,0.25806451612903225,0.5
30,45,135,45,90,30,375,0.09285714285714286,70,145,88,140,70,112,625,0.8888888888888888,0.25
50,85,125,85,115,20,480,0.4306569343065693,65,40,70,80,140,70,465,0.5954198473282443,1.0
100,103,75,120,75,127,600,0.940677966101695,110,123,65,100,65,65,528,0.5217391304347826,1.0
75,80,95,90,100,50,490,0.2158273381294964,65,83,57,95,85,105,490,0.8914728682170543,1.0
80,145,150,105,110,110,700,0.8692307692307693,72,95,67,103,71,122,530,0.9606299212598425,0.0
45,50,43,40,38,62,278,0.40441176470588236,80,82,100,83,100,80,525,0.6821705426356589,2.0
38,36,38,32,36,57,237,0.3893805309734513,79,115,70,125,80,111,580,0.864,1.0
60,75,100,55,80,50,420,0.3088235294117647,70,50,30,95,135,105,485,0.8040540540540541,2.0
86,68,72,109,66,106,507,0.8099173553719008,110,130,80,70,60,80,530,0.5862068965517241,2.0
60,85,60,85,60,55,405,0.3673469387755102,75,75,55,105,85,30,425,0.1619718309859155,2.0
50,53,62,58,63,44,330,0.13709677419354838,100,50,80,60,80,50,420,0.34375,0.5
60,85,69,60,69,77,420,0.518796992481203,60,130,80,60,60,70,460,0.5153846153846153,1.0
75,75,60,83,60,60,413,0.39344262295081966,55,50,45,135,95,120,500,0.7714285714285715,1.0
115,115,85,90,75,100,580,0.8134328358208955,75,65,55,65,55,69,384,0.43548387096774194,0.5
60,50,70,50,90,65,385,0.39568345323741005,60,60,60,85,85,85,435,0.631578947368421,0.25
58,89,77,45,45,48,362,0.3177570093457944,70,115,60,115,60,55,475,0.4647887323943662,1.0
41,56,40,62,44,71,314,0.568,70,55,55,80,60,45,365,0.2222222222222222,1.0
61,90,45,50,50,160,456,0.9230769230769231,75,95,122,58,75,69,494,0.5725806451612904,2.0
50,53,48,53,48,64,316,0.46153846153846156,150,80,44,90,54,80,498,0.625,1.0
80,80,80,80,80,80,480,0.5606060606060606,35,46,34,35,45,20,215,0.072,1.0
91,129,90,72,90,108,580,0.8536585365853658,69,55,45,55,55,15,294,0.11666666666666667,0.5
75,87,63,87,63,98,473,0.865546218487395,73,100,60,100,60,65,458,0.42657342657342656,1.0
110,160,110,80,110,100,670,0.8591549295774648,75,125,230,55,95,30,610,0.3448275862068966,0.5
75,105,75,105,75,45,480,0.3274336283185841,45,65,34,40,34,45,263,0.2589928057553957,1.0
45,30,40,105,50,20,290,0.031007751937984496,65,105,60,60,70,95,455,63.0,1.0
40,30,50,55,55,100,330,0.584070796460177,90,100,90,125,85,90,580,0.7352941176470589,2.0
70,50,30,95,135,105,485,0.8040540540540541,72,85,70,65,70,58,420,0.41304347826086957,2.0
60,50,100,85,70,65,430,0.47580645161290325,59,63,80,65,80,58,405,0.41843971631205673,0.5
60,60,75,60,75,80,410,0.7321428571428571,30,30,30,30,30,30,180,0.12612612612612611,1.0
40,30,35,45,40,55,245,0.31496062992125984,80,120,70,110,70,80,530,0.6422764227642277,2.0
95,65,110,60,130,65,525,0.5275590551181102,10,55,25,35,45,95,265,0.5396825396825397,1.0
55,55,50,45,65,55,325,0.37373737373737376,84,86,88,111,101,60,530,0.4634146341463415,0.5
57,80,91,80,87,75,470,0.5737704918032787,65,65,45,75,45,95,390,0.72,1.0
75,95,125,45,75,95,510,0.8257575757575758,70,77,60,97,60,108,472,0.8394160583941606,1.0
66,41,77,61,87,23,355,0.12096774193548387,79,100,80,110,90,121,580,0.968,1.0
70,62,67,55,55,56,365,0.38513513513513514,45,45,35,20,30,20,195,0.07246376811594203,1.0
92,105,90,125,90,98,600,0.8217054263565892,55,81,60,50,70,97,413,0.7214285714285714,1.0
55,40,50,65,85,40,335,0.3181818181818182,80,105,65,60,75,130,515,0.9645390070921985,2.0
70,75,60,105,60,105,475,0.88,67,125,40,30,30,58,350,0.3431372549019608,1.0
10,55,25,35,45,95,265,0.5396825396825397,165,75,80,40,45,65,470,0.5151515151515151,1.0
44,48,65,50,64,43,314,0.1623931623931624,65,95,75,55,55,85,430,0.6933333333333334,0.5
60,100,89,55,69,112,485,0.9298245614035088,70,60,70,87,78,85,450,0.6228070175438597,4.0
60,110,70,60,60,100,460,0.8461538461538461,50,160,110,160,110,110,700,0.8854961832061069,0.25
40,45,35,40,40,90,290,0.65,91,72,90,129,90,108,580,0.8620689655172413,1.0
60,40,60,40,60,35,295,0.18055555555555555,68,75,53,83,113,60,452,0.45384615384615384,0.5
85,120,70,50,60,100,485,0.8308823529411765,81,102,77,85,75,85,505,0.5642857142857143,1.0
75,98,63,98,63,101,498,0.8091603053435115,55,69,85,32,35,28,304,0.09302325581395349,1.0
44,50,91,24,86,10,305,0.1981981981981982,40,40,40,70,40,20,250,0.032520325203252036,0.25
30,40,55,40,55,60,280,0.3237410071942446,65,90,122,58,75,84,494,0.71875,0.0
72,105,115,54,86,68,500,0.5149253731343284,58,50,145,95,105,30,483,0.2459016393442623,1.0
45,30,40,105,50,20,290,0.031007751937984496,55,112,45,74,45,70,401,0.559322033898305,1.0
58,109,112,48,48,109,484,0.8805970149253731,75,95,95,95,95,85,540,0.6470588235294118,0.5
72,58,80,103,80,97,490,0.7171052631578947,45,55,39,35,39,42,255,0.18518518518518517,1.0
100,120,120,150,100,90,680,0.7880794701986755,45,100,45,45,45,10,290,0.2949640287769784,1.0
108,130,95,80,85,102,600,0.7637795275590551,49,49,56,49,61,66,330,0.5190839694656488,1.0
90,93,55,70,55,55,418,0.3819444444444444,85,105,55,85,50,115,495,0.9032258064516129,0.5
91,90,72,90,129,108,580,0.896,74,108,133,83,65,32,495,0.32142857142857145,8.0
48,61,40,61,40,50,300,0.2543859649122807,70,70,115,130,90,60,535,0.5338983050847458,0.0
85,56,77,50,77,78,423,0.53125,35,85,45,35,35,75,310,0.6492537313432836,0.0
64,78,52,78,52,81,405,0.6422764227642277,65,105,60,60,70,95,455,63.0,1.0
71,120,95,120,95,99,600,0.8203125,75,75,130,75,130,95,580,0.7479674796747967,2.0
50,35,55,25,25,15,205,0.021739130434782608,40,80,100,30,30,20,300,0.11851851851851852,1.0
95,145,130,120,90,120,700,0.9398496240601504,65,45,55,45,70,45,325,0.24369747899159663,1.0
56,61,65,48,45,38,313,0.17567567567567569,65,75,105,35,65,85,430,0.6940298507462687,1.0
75,125,70,125,70,115,580,0.9037037037037037,78,84,78,109,85,100,534,0.8620689655172413,1.0
65,110,130,60,65,95,525,0.8278145695364238,86,81,97,81,107,43,495,0.203125,1.0
60,85,69,65,79,80,438,0.576,65,76,84,54,96,105,480,0.9008264462809917,1.0
65,90,40,45,80,75,395,0.625,110,85,95,80,95,50,515,0.2713178294573643,1.0
65,125,100,55,70,85,500,0.6532258064516129,83,106,65,86,65,85,490,0.6640625,0.25
60,70,50,100,50,65,395,0.5217391304347826,50,70,160,70,160,90,600,0.7417218543046358,2.0
65,80,140,40,70,70,465,0.5223880597014925,60,55,145,75,150,40,525,0.2,0.25
150,100,120,100,120,90,680,0.6666666666666666,78,81,71,74,69,126,499,0.9090909090909091,1.0
60,45,70,75,85,55,390,0.3008130081300813,72,58,80,103,80,97,490,0.7171052631578947,0.5
60,62,63,80,80,60,405,0.38016528925619836,80,120,70,110,70,80,530,0.6422764227642277,0.5
60,40,80,60,45,40,325,0.23529411764705882,80,105,65,60,75,130,515,0.9645390070921985,1.0
50,105,125,55,95,50,480,0.375886524822695,60,115,105,65,70,80,495,0.7181818181818181,1.0
90,100,70,110,150,80,600,0.6037735849056604,75,95,122,58,75,69,494,0.5725806451612904,1.0
75,75,95,75,95,113,528,0.9015151515151515,79,103,120,135,115,78,630,0.5763888888888888,2.0
80,80,90,110,130,110,600,0.8721804511278195,55,65,95,95,45,85,440,0.6610169491525424,1.0
50,70,160,70,160,90,600,0.7417218543046358,80,135,85,70,95,150,615,0.9844961240310077,1.0
55,68,64,45,55,31,318,0.11666666666666667,35,40,100,90,55,35,355,0.1796875,4.0
100,70,70,65,65,45,415,0.1897810218978102,55,85,122,58,75,99,494,0.8099173553719008,0.0
100,164,150,95,120,71,700,0.5645161290322581,40,45,35,30,40,55,245,0.3793103448275862,2.0
70,100,70,105,75,40,460,0.23214285714285715,58,109,112,48,48,109,484,0.8805970149253731,4.0
40,60,30,31,31,70,262,0.4492753623188406,74,94,131,54,116,20,489,0.4485294117647059,0.5
80,70,40,100,60,145,495,0.921875,38,30,85,55,65,30,303,0.21428571428571427,0.5
50,53,62,58,63,44,330,0.13709677419354838,70,110,70,115,70,90,525,0.75,1.0
61,72,57,55,55,65,365,0.3984375,90,60,60,40,40,40,330,0.29545454545454547,0.5
126,131,95,131,98,99,680,0.8294573643410853,60,100,115,70,85,90,520,0.7557251908396947,0.5
45,60,30,80,50,65,330,0.4603174603174603,150,120,100,120,100,90,680,0.664179104477612,1.0
40,60,30,31,31,70,262,0.4492753623188406,50,20,55,25,25,30,205,0.09774436090225563,2.0
75,89,85,55,65,36,405,0.29545454545454547,50,52,48,65,50,55,320,0.33098591549295775,2.0
70,110,80,55,80,105,500,0.8794326241134752,44,38,33,61,43,70,289,0.5267857142857143,0.5
65,76,84,54,96,105,480,0.9008264462809917,40,70,40,35,40,60,285,0.392,1.0
45,35,50,70,50,30,280,0.15753424657534246,50,40,85,40,65,25,305,0.08870967741935484,0.5
20,40,15,35,35,60,205,0.34285714285714286,80,85,95,30,30,25,345,0.2857142857142857,0.0
20,40,15,35,35,60,205,0.34285714285714286,72,105,115,54,86,68,500,0.5149253731343284,2.0
90,30,15,40,20,15,210,0.043478260869565216,60,30,30,36,56,50,262,0.32432432432432434,1.0
75,100,95,40,70,110,490,0.8717948717948718,97,165,60,65,50,58,495,0.3902439024390244,0.5
90,100,90,125,85,90,580,0.7352941176470589,44,75,35,63,33,45,295,0.2647058823529412,1.0
85,80,90,105,95,60,515,0.49074074074074076,65,65,60,110,95,130,525,0.9253731343283582,1.0
43,30,55,40,65,97,330,0.6030534351145038,36,50,50,65,60,44,305,0.16363636363636364,1.0
70,80,70,80,70,110,480,0.6594202898550725,44,50,91,24,86,10,305,0.1981981981981982,1.0
45,49,49,65,65,45,318,0.2781954887218045,100,100,80,60,60,50,450,0.3050847457627119,1.0
90,85,75,115,100,115,580,0.9381443298969072,30,30,42,30,42,70,244,0.4230769230769231,2.0
20,15,20,10,55,80,200,0.2682926829268293,62,48,66,59,57,49,341,0.33884297520661155,1.0
43,80,65,50,35,35,308,0.14193548387096774,105,125,100,60,100,100,590,0.8359375,1.0
95,75,110,100,80,30,490,0.15267175572519084,65,125,100,60,70,70,490,0.6099290780141844,0.0
75,123,67,95,85,95,540,0.7642276422764228,100,134,110,95,100,61,600,0.4057971014492754,1.0
45,85,50,55,50,65,350,0.5076923076923077,45,65,34,40,34,45,263,0.2589928057553957,1.0
90,55,75,60,75,30,385,0.13970588235294118,65,75,90,97,123,44,494,0.1987179487179487,1.0
45,65,34,40,34,45,263,0.2589928057553957,80,100,70,50,60,45,405,0.25806451612903225,1.0
55,75,85,25,25,15,280,0.1875,60,62,63,80,80,60,405,0.38016528925619836,1.0
53,54,53,37,46,45,288,0.3090909090909091,50,70,50,50,50,70,340,0.5645161290322581,2.0
50,70,100,40,40,30,330,0.2222222222222222,40,30,32,50,52,65,269,0.3671875,1.0
60,80,110,50,80,45,425,0.2833333333333333,80,105,105,105,105,80,580,0.5939849624060151,1.0
70,65,65,55,55,70,380,0.5,55,95,55,35,75,115,430,0.9380530973451328,1.0
40,35,30,20,20,50,195,0.23423423423423423,82,121,119,69,59,71,521,0.5394736842105263,0.5
86,81,97,81,107,43,495,0.203125,95,70,73,95,90,60,483,0.3983739837398374,1.0
60,50,50,60,70,50,340,0.28346456692913385,82,121,119,69,59,71,521,0.5394736842105263,1.0
65,95,57,100,85,93,495,0.7441860465116279,55,130,115,50,50,75,475,0.5982142857142857,0.5
70,110,70,115,70,90,525,0.75,61,84,65,70,70,70,420,0.5,1.0
100,100,100,100,100,100,600,0.8758169934640523,42,52,67,39,56,50,306,0.2868217054263566,1.0
70,150,140,65,100,75,600,0.55,45,63,37,65,55,95,360,0.8055555555555556,0.5
50,53,48,53,48,64,316,0.358974358974359,80,70,40,100,60,145,495,0.921875,1.0
65,75,90,97,123,44,494,0.1987179487179487,45,60,30,80,50,65,330,0.4603174603174603,1.0
65,70,60,65,65,115,440,0.8583333333333333,65,65,45,75,45,95,390,0.72,1.0
85,50,95,120,115,80,545,0.5793650793650794,70,50,30,95,135,105,485,0.8040540540540541,1.0
65,155,120,65,90,105,600,0.8677685950413223,40,30,30,40,50,30,220,0.07936507936507936,4.0
100,50,80,60,80,50,420,0.34375,75,98,63,98,63,101,498,0.889763779527559,1.0
73,76,75,81,100,100,505,0.8110236220472441,110,85,95,80,95,50,515,0.2713178294573643,1.0
80,100,70,50,60,45,405,0.25806451612903225,45,50,45,115,55,95,405,0.6936936936936937,0.0
70,45,48,60,65,35,323,0.15748031496062992,80,75,150,75,150,50,580,0.30973451327433627,0.5
60,85,60,85,60,55,405,0.3673469387755102,38,35,40,27,25,35,200,0.08208955223880597,1.0
62,73,55,56,52,84,382,0.7244094488188977,70,83,50,37,50,60,350,0.3360655737704918,1.0
135,85,40,40,85,5,390,0.6864406779661016,45,65,34,40,34,45,263,0.2589928057553957,1.0
70,50,30,95,135,105,485,0.8040540540540541,60,115,105,65,70,80,495,0.7181818181818181,0.5
120,70,120,75,130,85,600,0.6694915254237288,50,95,180,85,45,70,525,0.5298507462686567,1.0
50,50,95,40,50,35,320,0.20279720279720279,60,50,100,85,70,65,430,0.47580645161290325,0.0
75,125,230,55,95,30,610,0.3448275862068966,255,10,10,75,135,55,540,0.3125,1.0
40,50,90,30,55,65,330,0.44680851063829785,105,130,120,45,45,40,485,0.4444444444444444,0.25
75,100,63,80,63,116,497,0.9345794392523364,60,100,85,80,85,100,510,0.7007874015748031,1.0
30,40,55,40,55,60,280,0.3237410071942446,65,50,35,115,95,95,455,0.7333333333333333,0.5
50,65,85,35,35,55,325,0.32575757575757575,70,140,230,60,80,50,630,0.32432432432432434,0.25
65,105,60,60,70,95,455,63.0,100,77,77,128,128,90,600,0.6901408450704225,1.0
85,110,90,45,90,80,500,0.6206896551724138,85,105,100,79,83,78,530,0.5869565217391305,1.0
90,100,90,125,85,90,580,0.7352941176470589,85,97,66,105,66,65,484,0.47107438016528924,0.5
80,80,90,110,130,110,600,0.8721804511278195,125,130,90,130,90,95,660,0.7734375,2.0
85,100,122,58,75,54,494,0.3939393939393939,70,140,230,60,80,50,630,0.32432432432432434,0.5
78,130,111,130,85,100,634,0.8561151079136691,50,20,40,20,40,20,190,0.0962962962962963,0.0
40,30,30,40,50,30,220,0.07936507936507936,75,125,100,70,80,45,495,0.33035714285714285,2.0
30,65,100,45,25,40,305,0.1891891891891892,110,78,73,76,71,60,468,0.3333333333333333,1.0
150,100,120,100,120,90,680,0.6666666666666666,110,65,105,55,95,80,510,0.6258503401360545,0.5
105,150,90,150,90,95,680,0.8285714285714286,50,85,55,65,65,90,410,0.7478260869565218,1.0
76,25,45,67,55,24,292,0.0390625,40,45,35,40,40,90,290,0.65,1.0
45,100,135,65,135,45,525,0.29411764705882354,150,100,120,100,120,90,680,0.6666666666666666,2.0
60,150,50,150,50,60,520,0.5,100,5,5,15,65,30,220,0.07692307692307693,0.0
50,85,85,55,55,50,380,0.3902439024390244,60,85,49,60,49,60,363,0.4444444444444444,0.5
110,65,75,125,85,30,490,0.15,65,90,120,85,70,60,490,0.43410852713178294,2.0
55,112,45,74,45,70,401,0.559322033898305,81,102,77,85,75,85,505,0.5642857142857143,0.5
40,60,40,40,40,30,250,0.0948905109489051,75,95,95,95,95,85,540,0.6470588235294118,1.0
60,65,80,170,95,130,600,0.8625954198473282,65,60,70,85,75,40,395,0.1796875,0.0
50,70,50,50,50,40,310,0.16296296296296298,60,59,85,79,105,36,424,0.16666666666666666,0.5
85,50,95,120,115,80,545,0.5793650793650794,65,110,130,60,65,95,525,0.8278145695364238,2.0
60,60,60,105,105,105,495,0.848,70,60,75,110,75,90,480,0.7165354330708661,1.0
100,77,77,128,128,90,600,0.6901408450704225,35,45,160,30,45,70,385,0.48148148148148145,1.0
88,107,122,74,75,64,530,0.4596774193548387,60,85,60,85,60,55,405,0.3673469387755102,0.5
74,48,76,83,81,104,466,0.7913043478260869,28,25,25,45,35,40,198,0.16083916083916083,0.5
100,150,120,120,100,90,680,0.6493506493506493,60,85,49,60,49,60,363,0.4444444444444444,0.5
71,95,85,110,95,79,535,0.664,75,98,63,98,63,101,498,0.849624060150376,0.5
60,55,90,145,90,80,520,0.6071428571428571,60,40,50,75,85,95,405,0.6044776119402985,1.0
38,30,41,30,41,60,240,0.2897196261682243,75,95,122,58,75,69,494,0.5725806451612904,0.0
60,67,85,77,75,116,480,0.8888888888888888,63,60,55,50,50,71,349,0.5289256198347108,0.5
70,110,180,60,60,50,530,0.4117647058823529,90,120,120,60,60,50,500,0.35294117647058826,0.5
40,55,80,35,60,30,300,0.15037593984962405,80,80,80,80,80,80,480,0.5606060606060606,0.5
38,35,40,27,25,35,200,0.08208955223880597,25,20,15,105,55,90,310,0.32407407407407407,2.0
38,35,40,27,25,35,200,0.08208955223880597,44,38,39,61,79,42,303,0.2251655629139073,0.5
35,55,35,30,30,35,220,0.23684210526315788,78,84,78,109,85,100,534,0.8620689655172413,1.0
50,120,53,35,110,87,455,0.640625,80,92,65,65,80,68,450,0.4824561403508772,1.0
85,70,80,97,80,123,535,0.9304347826086956,40,55,70,45,60,30,300,0.10619469026548672,0.25
70,130,100,55,80,65,500,0.608,73,100,60,100,60,65,458,0.42657342657342656,0.5
70,43,53,43,53,40,302,0.19090909090909092,75,90,90,140,90,115,600,0.9481481481481482,1.0
67,57,55,77,55,114,425,0.8879310344827587,91,90,106,130,106,77,600,0.648854961832061,0.25
35,80,50,50,70,120,405,0.84375,70,80,102,80,102,40,474,0.2677165354330709,0.0
95,65,110,60,130,65,525,0.5275590551181102,50,75,35,70,30,40,300,0.21296296296296297,1.0
90,75,85,115,90,55,510,0.3445378151260504,73,115,60,60,60,90,458,0.6694915254237288,1.0
75,100,95,40,70,110,490,0.8717948717948718,115,140,130,55,55,40,535,0.4519230769230769,0.5
50,53,48,53,48,64,316,0.46153846153846156,65,76,84,54,96,105,480,0.9008264462809917,1.0
55,84,105,114,75,52,485,0.2890625,79,103,120,135,115,78,630,0.5763888888888888,0.5
80,100,70,60,70,95,475,0.7416666666666667,35,60,44,40,54,55,288,0.366412213740458,0.5
75,80,60,65,90,102,472,0.8625954198473282,55,40,85,80,105,40,405,0.23622047244094488,1.0
70,60,75,110,75,90,480,0.7165354330708661,80,75,150,75,150,50,580,0.30973451327433627,0.5
59,74,50,35,50,35,303,0.3125,50,65,107,105,107,86,520,0.7758620689655172,2.0
66,117,70,40,50,67,410,0.4573643410852713,70,100,70,105,75,40,460,0.23214285714285715,1.0
105,150,90,150,90,95,680,0.8285714285714286,80,80,50,40,50,25,325,0.176056338028169,1.0
70,90,110,60,75,95,500,0.7333333333333333,45,95,50,40,50,75,355,0.54,0.5
80,100,80,80,80,100,520,0.9051724137931034,58,64,58,80,65,80,405,0.609271523178808,2.0
75,80,55,25,35,35,305,0.18666666666666668,116,55,85,107,95,29,487,0.06818181818181818,0.5
55,104,105,94,75,52,485,0.36363636363636365,75,90,90,140,90,115,600,0.9481481481481482,2.0
70,120,100,145,105,20,560,0.2824427480916031,40,55,80,35,60,30,300,0.15037593984962405,4.0
105,95,80,40,80,90,490,0.753968253968254,68,125,65,65,115,80,518,0.6277372262773723,1.0
70,62,67,55,55,56,365,0.38513513513513514,65,90,120,85,70,60,490,0.43410852713178294,0.5
70,105,105,50,40,20,390,0.33587786259541985,30,30,42,30,42,70,244,0.4230769230769231,4.0
91,134,95,100,100,80,600,0.6304347826086957,65,80,140,40,70,70,465,0.5223880597014925,0.25
70,60,75,110,75,90,480,0.7165354330708661,66,41,77,61,87,23,355,0.12096774193548387,1.0
85,76,64,45,55,90,415,0.6739130434782609,65,150,60,115,60,115,565,0.935251798561151,1.0
50,92,108,92,108,35,485,0.2457627118644068,70,55,75,45,65,60,370,0.45901639344262296,0.25
70,55,65,95,85,70,440,0.5307692307692308,35,85,45,35,35,75,310,0.6492537313432836,2.0
85,80,90,105,95,60,515,0.49074074074074076,59,63,80,65,80,58,405,0.41843971631205673,1.0
92,105,90,125,90,98,600,0.8217054263565892,45,50,35,55,75,40,300,0.21367521367521367,2.0
38,35,35,65,55,50,278,0.2647058823529412,40,40,55,40,70,55,300,0.40939597315436244,1.0
100,134,110,95,100,61,600,0.4057971014492754,80,100,80,80,80,100,520,0.9051724137931034,0.5
60,85,42,85,42,91,405,0.8227848101265823,20,15,20,10,55,80,200,0.2682926829268293,1.0
90,120,100,150,120,100,680,0.7718120805369127,80,100,80,80,80,100,520,0.9051724137931034,2.0
70,80,50,35,35,35,305,0.14,49,66,70,44,55,51,335,0.4260869565217391,0.0
51,65,65,80,75,59,395,0.4365079365079365,59,45,40,35,40,31,250,0.14285714285714285,1.0
60,50,70,80,80,140,480,0.8449612403100775,85,80,90,105,95,60,515,0.49074074074074076,1.0
60,95,80,60,80,30,405,0.19480519480519481,90,120,120,60,60,50,500,0.35294117647058826,2.0
72,58,80,103,80,97,490,0.7171052631578947,45,50,45,115,55,95,405,0.6936936936936937,2.0
65,47,55,73,75,85,400,0.65,75,90,140,60,60,40,465,0.3008130081300813,0.5
90,30,15,40,20,15,210,0.043478260869565216,170,90,45,90,45,60,500,0.427536231884058,1.0
190,33,58,33,58,33,405,0.13432835820895522,78,70,61,50,61,100,420,0.8145161290322581,1.0
62,73,55,56,52,84,382,0.7244094488188977,70,85,140,85,70,20,470,0.272,0.5
85,73,70,73,115,67,483,0.5126050420168067,76,65,45,92,42,91,411,0.7449664429530202,1.0
100,180,160,150,90,90,770,0.7520661157024794,55,55,45,63,45,45,308,0.25,0.5
95,124,78,69,71,58,495,0.37398373983739835,82,121,119,69,59,71,521,0.5394736842105263,2.0
70,130,100,55,80,65,500,0.608,55,112,45,74,45,70,401,0.559322033898305,1.0
74,48,76,83,81,104,466,0.7322834645669292,115,45,20,45,25,20,270,0.11538461538461539,1.0
55,50,40,40,40,75,300,0.5945945945945946,70,105,105,50,40,20,390,0.33587786259541985,0.5
70,84,70,65,70,51,410,0.2949640287769784,55,70,55,40,55,85,360,0.7073170731707317,1.0
50,48,43,46,41,60,288,0.47297297297297297,100,134,110,95,100,61,600,0.4057971014492754,4.0
100,164,150,95,120,71,700,0.5645161290322581,45,45,35,20,30,20,195,0.07246376811594203,2.0
74,100,72,90,72,46,454,0.24561403508771928,67,58,57,81,67,101,431,0.8790322580645161,1.0
80,70,70,90,100,70,480,0.5609756097560976,86,68,72,109,66,106,507,0.8099173553719008,1.0
30,42,118,42,88,30,350,0.112,80,120,80,120,80,100,580,0.8478260869565217,4.0
50,80,95,10,45,10,290,0.232,74,94,131,54,116,20,489,0.4485294117647059,0.5
75,55,70,55,95,110,460,0.8444444444444444,58,89,77,45,45,48,362,0.3177570093457944,0.5
55,35,50,55,110,85,390,0.6277372262773723,38,41,40,50,65,65,299,0.4108527131782946,0.5
91,90,106,130,106,77,600,0.648854961832061,40,45,35,30,40,55,245,0.3793103448275862,1.0
76,48,48,57,62,34,325,0.11688311688311688,67,82,62,46,48,43,348,0.22033898305084745,1.0
75,98,63,98,63,101,498,0.849624060150376,70,80,102,80,102,40,474,0.2677165354330709,1.0
50,100,150,100,150,50,600,0.37142857142857144,75,95,95,95,95,85,540,0.6470588235294118,2.0
80,100,70,60,70,95,475,0.7416666666666667,44,38,39,61,79,42,303,0.2251655629139073,1.0
35,85,45,35,35,75,310,0.6492537313432836,80,160,60,170,130,80,680,0.6180555555555556,1.0
60,75,85,100,85,115,520,0.8992248062015504,59,59,58,90,70,73,409,0.5826086956521739,2.0
40,55,30,30,30,85,270,0.688,30,35,30,100,35,80,310,0.4765625,0.0
66,117,70,40,50,67,410,0.4573643410852713,78,84,78,109,85,100,534,0.8620689655172413,1.0
75,75,95,75,95,113,528,0.9015151515151515,70,90,90,135,90,125,600,0.9401709401709402,1.0
100,100,100,100,100,100,600,0.8602941176470589,60,95,80,60,80,30,405,0.19480519480519481,0.25
68,72,78,38,42,32,330,0.23809523809523808,40,80,100,30,30,20,300,0.11851851851851852,2.0
50,95,95,35,110,70,455,0.5179856115107914,65,85,70,75,70,40,405,0.203125,1.0
80,120,130,55,65,45,495,0.37037037037037035,99,68,83,72,87,51,460,0.417910447761194,0.0
65,105,60,60,70,95,455,63.0,62,77,62,50,42,65,358,0.4838709677419355,1.0
60,50,150,50,150,60,520,0.5206611570247934,50,95,90,95,90,180,600,0.9172413793103448,2.0
70,55,95,95,110,65,490,0.48872180451127817,65,130,60,75,60,75,465,0.689922480620155,0.0
105,95,75,85,75,74,509,0.5714285714285714,40,50,45,70,45,70,320,0.5517241379310345,0.0
70,65,60,90,75,90,450,0.6571428571428571,58,50,145,95,105,30,483,0.2459016393442623,0.25
65,45,55,45,70,45,325,0.24369747899159663,55,95,115,45,45,35,390,0.2116788321167883,4.0
60,30,30,36,56,50,262,0.32432432432432434,62,77,62,50,42,65,358,0.4838709677419355,1.0
38,36,38,32,36,57,237,0.3893805309734513,62,50,58,73,54,72,369,0.4435483870967742,1.0
35,80,50,50,70,120,405,0.84375,50,85,55,65,65,90,410,0.7478260869565218,2.0
45,90,20,65,20,65,305,0.5116279069767442,40,45,35,30,40,55,245,0.3793103448275862,1.0
60,67,85,77,75,116,480,0.8888888888888888,50,65,107,105,107,86,520,0.703125,1.0
60,75,100,55,80,50,420,0.3088235294117647,65,136,94,54,96,135,580,0.9612403100775194,1.0
82,121,119,69,59,71,521,0.5394736842105263,55,95,115,45,45,35,390,0.2116788321167883,0.5
70,120,65,45,85,125,510,0.9747899159663865,65,155,120,65,90,105,600,0.8677685950413223,2.0
90,100,60,90,60,80,480,0.6422764227642277,45,95,50,40,50,75,355,0.54,1.0
100,120,120,150,100,90,680,0.7880794701986755,80,115,80,65,55,93,488,0.7846153846153846,1.0
103,60,86,60,86,50,445,0.3458646616541353,30,35,30,100,35,80,310,0.4765625,0.0
80,90,80,130,110,110,600,0.856,40,29,45,29,45,36,224,0.14634146341463414,1.0
75,125,75,30,75,85,465,0.625,70,140,70,110,65,105,560,0.95,2.0
40,45,35,65,55,70,310,0.4482758620689655,45,30,50,55,65,45,290,0.208,1.0
41,50,37,50,37,66,281,0.5175438596491229,80,100,70,50,60,45,405,0.25806451612903225,0.5
83,80,75,70,70,101,479,0.8615384615384616,75,80,55,25,35,35,305,0.18666666666666668,2.0
55,95,115,45,45,35,390,0.2116788321167883,75,80,55,25,35,35,305,0.18666666666666668,0.5
55,55,85,65,85,35,380,0.2014388489208633,114,85,70,85,80,30,464,0.2066115702479339,0.5
50,50,40,50,40,64,294,0.45588235294117646,85,105,85,40,50,40,405,0.211864406779661,1.0
55,55,50,45,65,55,325,0.37373737373737376,106,130,90,110,154,90,680,0.719626168224299,1.0
70,120,100,145,105,20,560,0.2824427480916031,86,76,86,116,56,95,515,0.7982456140350878,0.0
50,70,100,40,40,30,330,0.2222222222222222,1,90,45,30,30,40,236,0.33064516129032256,2.0
67,89,116,79,116,33,500,0.2624113475177305,85,70,80,97,80,123,535,0.9304347826086956,1.0
105,130,120,45,45,40,485,0.4444444444444444,55,40,85,80,105,40,405,0.23622047244094488,0.0
35,65,35,65,35,65,300,0.46621621621621623,70,80,102,80,102,40,474,0.2677165354330709,1.0
73,95,62,85,65,85,465,0.6666666666666666,60,50,70,50,90,65,385,0.39568345323741005,1.0
60,60,40,65,45,35,305,0.15833333333333333,90,85,100,95,125,85,580,0.6834532374100719,0.0
45,75,37,70,55,83,365,0.6183206106870229,150,120,100,120,100,90,680,0.664179104477612,0.5
90,70,80,70,95,70,475,0.5190839694656488,100,164,150,95,120,71,700,0.5645161290322581,2.0
71,82,64,64,59,112,452,0.9327731092436975,62,77,62,50,42,65,358,0.4838709677419355,1.0
60,40,50,75,85,95,405,0.6044776119402985,100,77,77,128,128,90,600,0.6901408450704225,1.0
58,64,58,80,65,80,405,0.5423728813559322,56,61,65,48,45,38,313,0.17567567567567569,2.0
30,80,90,55,45,55,355,0.4295774647887324,55,95,115,45,45,35,390,0.2116788321167883,2.0
86,68,72,109,66,106,507,0.8099173553719008,90,95,105,165,110,45,610,0.2890625,0.5
60,70,65,125,105,90,515,0.6911764705882353,65,80,80,59,63,58,405,0.4411764705882353,2.0
51,65,65,80,75,59,395,0.4365079365079365,105,140,55,30,55,95,480,0.8195488721804511,0.5
35,45,160,30,45,70,385,0.48148148148148145,45,22,60,27,30,29,213,0.07518796992481203,1.0
45,50,43,40,38,62,278,0.40441176470588236,100,110,90,85,90,60,535,0.47794117647058826,1.0
65,105,60,60,70,95,455,63.0,80,45,65,90,110,80,470,0.5462962962962963,0.5
60,45,70,75,85,55,390,0.3008130081300813,75,95,122,58,75,69,494,0.5725806451612904,1.0
103,93,67,71,61,84,479,0.7142857142857143,40,55,70,45,60,30,300,0.10619469026548672,0.0
75,85,200,55,65,30,510,0.16778523489932887,75,95,60,65,60,115,470,0.8778625954198473,1.0
91,90,72,90,129,108,580,0.896,40,30,50,55,55,100,330,0.584070796460177,1.0
45,50,35,55,75,40,300,0.21367521367521367,60,150,50,150,50,60,520,0.5,0.5
110,135,60,50,65,88,508,0.7744360902255639,40,60,30,31,31,70,262,0.4492753623188406,0.0
45,63,37,65,55,95,360,0.8055555555555556,103,60,126,80,126,50,545,0.36363636363636365,1.0
108,112,118,68,72,47,525,0.2916666666666667,125,170,100,120,90,95,700,0.77,1.0
65,50,35,115,95,95,455,0.7333333333333333,75,75,60,83,60,60,413,0.39344262295081966,0.5
54,66,70,44,55,46,335,0.4214876033057851,50,35,55,25,25,15,205,0.05263157894736842,0.5
91,90,72,90,129,108,580,0.896,91,129,90,72,90,108,580,0.8536585365853658,4.0
20,10,230,10,230,5,505,0.0,73,115,60,60,60,90,458,0.6694915254237288,1.0
105,125,100,60,100,100,590,0.8359375,70,85,140,85,70,20,470,0.272,1.0
60,65,70,85,75,40,395,0.21705426356589147,35,65,35,65,35,65,300,0.46621621621621623,2.0
120,100,85,30,85,45,465,0.22448979591836735,65,95,75,55,55,85,430,0.6933333333333334,0.5
71,120,95,120,95,99,600,0.8203125,85,105,85,40,50,40,405,0.211864406779661,0.5
45,60,40,70,50,45,310,0.2846715328467153,35,64,85,74,55,32,345,0.19827586206896552,0.5
35,64,85,74,55,32,345,0.19827586206896552,60,65,70,85,75,40,395,0.21705426356589147,0.5
91,129,90,72,90,108,580,0.8536585365853658,90,75,75,90,100,70,500,0.5462184873949579,1.0
100,100,90,150,140,90,670,0.71875,75,90,90,140,90,115,600,0.9481481481481482,2.0
76,104,71,104,71,108,534,0.912751677852349,64,165,75,93,83,75,555,0.6587301587301587,0.0
95,75,180,130,80,30,590,0.13793103448275862,72,95,67,103,71,122,530,0.9606299212598425,0.0
44,38,33,61,43,70,289,0.5267857142857143,68,65,65,125,115,80,518,0.6461538461538462,1.0
95,70,73,95,90,60,483,0.3983739837398374,70,85,65,105,85,120,530,0.9262295081967213,1.0
60,100,89,55,69,112,485,0.9298245614035088,90,132,105,132,105,30,594,0.4246575342465753,4.0
50,65,90,35,35,15,290,0.14678899082568808,50,72,35,35,35,65,292,0.5373134328358209,2.0
50,20,40,20,40,20,190,0.0962962962962963,62,44,50,44,50,55,305,0.3629032258064516,1.0
75,75,60,83,60,60,413,0.39344262295081966,80,105,65,60,75,130,515,0.9645390070921985,2.0
58,70,45,40,45,42,300,0.25925925925925924,55,85,122,58,75,99,494,0.8099173553719008,0.5
40,30,30,55,30,85,270,0.4666666666666667,45,63,37,65,55,95,360,0.8055555555555556,0.5
46,87,60,30,40,57,320,0.37777777777777777,90,100,70,110,150,80,600,0.6037735849056604,2.0
60,60,60,85,85,85,435,0.631578947368421,57,24,86,24,86,23,300,0.12727272727272726,2.0
70,120,40,95,40,95,460,0.8106060606060606,36,50,50,65,60,44,305,0.16363636363636364,1.0
105,95,80,40,80,90,490,0.753968253968254,100,90,130,45,65,55,485,0.4253731343283582,0.5
60,80,50,40,40,30,300,0.15328467153284672,80,100,70,60,70,95,475,0.7416666666666667,1.0
28,25,25,45,35,40,198,0.16083916083916083,92,105,90,125,90,98,600,0.8217054263565892,0.0
40,40,50,30,30,30,220,0.0873015873015873,70,120,40,95,40,95,460,0.8106060606060606,2.0
45,50,45,115,55,95,405,0.6936936936936937,70,140,70,110,65,105,560,0.95,0.5
78,81,71,74,69,126,499,0.9090909090909091,70,120,100,145,105,20,560,0.2824427480916031,0.5
90,30,15,40,20,15,210,0.043478260869565216,85,135,130,60,80,25,515,0.40540540540540543,0.5
125,58,58,76,76,67,460,0.515625,91,72,90,129,90,108,580,0.8925619834710744,1.0
55,45,45,25,25,15,210,0.048,80,80,80,55,55,90,440,0.6417910447761194,1.0
60,70,50,100,50,65,395,0.5217391304347826,44,38,33,61,43,70,289,0.5267857142857143,0.5
55,85,55,50,55,60,360,0.4233576642335766,60,60,60,105,105,105,495,0.848,0.5
72,95,67,103,71,122,530,0.9606299212598425,75,100,66,60,66,115,482,0.918918918918919,1.0
75,90,50,110,80,95,500,0.7985611510791367,75,98,63,98,63,101,498,0.889763779527559,0.5
55,40,85,80,105,40,405,0.23622047244094488,70,120,40,95,40,95,460,0.8106060606060606,2.0
70,80,50,35,35,35,305,0.14,80,100,200,50,100,50,580,0.3472222222222222,2.0
54,45,47,75,98,52,371,0.39669421487603307,40,80,100,30,30,20,300,0.11851851851851852,1.0
60,65,70,85,75,40,395,0.21705426356589147,65,95,100,60,50,50,420,0.34959349593495936,0.5
70,95,125,65,75,45,475,0.33613445378151263,123,77,72,99,92,58,521,0.4621212121212121,2.0
89,145,90,105,80,91,600,0.8549618320610687,40,29,45,29,45,36,224,0.14634146341463414,1.0
74,108,133,83,65,32,495,0.32142857142857145,95,100,85,108,70,70,528,0.5652173913043478,0.5
50,70,160,70,160,90,600,0.7417218543046358,60,85,40,30,45,68,328,0.6422018348623854,2.0
77,120,90,60,90,48,485,0.2785714285714286,80,80,80,80,80,80,480,0.5606060606060606,1.0
66,65,48,62,57,52,350,0.36220472440944884,40,45,35,40,40,90,290,0.65,1.0
62,55,52,109,94,109,481,0.7833333333333333,65,40,70,80,140,70,465,0.5954198473282443,4.0
50,85,40,85,40,35,335,0.1746031746031746,30,35,30,100,35,80,310,0.4765625,0.5
50,160,110,160,110,110,700,0.8854961832061069,105,150,90,150,90,95,680,0.8285714285714286,4.0
165,75,80,40,45,65,470,0.5151515151515151,65,95,100,60,50,50,420,0.34959349593495936,0.5
45,75,37,70,55,83,365,0.6183206106870229,40,35,30,120,70,105,400,0.6692307692307692,1.0
80,90,80,130,110,110,600,0.856,95,80,105,40,70,100,490,0.8046875,1.0
66,41,77,61,87,23,355,0.12096774193548387,65,75,105,35,65,85,430,0.6940298507462687,1.0
50,75,45,40,45,60,315,0.4380165289256198,75,38,38,56,56,67,330,0.5263157894736842,1.0
50,160,110,160,110,110,700,0.8854961832061069,70,70,115,130,90,60,535,0.5338983050847458,0.25
71,82,64,64,59,112,452,0.9327731092436975,66,117,70,40,50,67,410,0.4573643410852713,1.0
40,80,35,35,45,70,305,0.4661016949152542,60,60,75,60,75,80,410,0.7321428571428571,0.5
72,58,80,103,80,97,490,0.7171052631578947,76,65,45,92,42,91,411,0.7449664429530202,1.0
105,140,55,30,55,95,480,0.8195488721804511,60,60,40,65,45,35,305,0.15833333333333333,0.5
77,59,50,67,63,46,362,0.23140495867768596,100,77,77,128,128,90,600,0.6901408450704225,1.0
123,100,62,97,81,68,531,0.4806201550387597,95,125,79,60,100,81,540,0.6165413533834586,1.0
45,80,100,35,37,28,325,0.3125,38,30,85,55,65,30,303,0.21428571428571427,2.0
85,135,130,60,80,25,515,0.40540540540540543,55,55,50,45,65,55,325,0.37373737373737376,1.0
55,104,105,94,75,52,485,0.36363636363636365,70,50,30,95,135,105,485,0.8040540540540541,1.0
123,77,72,99,92,58,521,0.4621212121212121,60,50,50,60,70,50,340,0.28346456692913385,1.0
70,55,75,45,65,60,370,0.45901639344262296,100,120,120,150,100,90,680,0.7880794701986755,0.5
37,25,41,25,41,25,194,0.08870967741935484,106,90,130,90,154,110,680,0.8699186991869918,1.0
55,75,50,40,40,80,340,0.6302521008403361,43,80,65,50,35,35,308,0.14193548387096774,1.0
41,50,37,50,37,66,281,0.5175438596491229,70,90,45,15,45,50,315,0.3629032258064516,1.0
90,85,100,95,125,85,580,0.6834532374100719,67,89,116,79,116,33,500,0.2624113475177305,0.25
95,95,85,125,65,55,520,0.3894736842105263,70,120,65,45,85,125,510,0.9747899159663865,0.0
75,75,55,105,85,30,425,0.1619718309859155,45,22,60,27,30,29,213,0.07518796992481203,0.5
50,75,45,40,45,60,315,0.4380165289256198,75,98,63,98,63,101,498,0.849624060150376,1.0
85,97,66,105,66,65,484,0.47107438016528924,70,55,65,95,85,70,440,0.5307692307692308,0.5
38,30,85,55,65,30,303,0.21428571428571427,59,110,150,45,49,35,448,0.3333333333333333,2.0
90,120,100,150,120,100,680,0.7718120805369127,70,130,100,55,80,65,500,0.608,0.5
37,25,41,25,41,25,194,0.08870967741935484,85,110,90,45,90,80,500,0.6206896551724138,1.0
65,60,70,85,75,40,395,0.1796875,40,45,35,30,40,55,245,0.3793103448275862,1.0
40,80,35,35,45,70,305,0.4661016949152542,80,105,65,60,75,130,515,0.9645390070921985,1.0
40,40,55,40,70,55,300,0.40939597315436244,95,117,184,44,46,28,514,0.2975206611570248,1.0
116,55,85,107,95,29,487,0.06818181818181818,20,40,90,30,90,25,295,0.11363636363636363,1.0
63,120,85,90,55,55,468,0.2809917355371901,62,55,52,109,94,109,481,0.7833333333333333,1.0
101,72,72,99,89,29,462,0.1937984496124031,70,140,230,60,80,50,630,0.32432432432432434,0.5
65,90,65,61,61,100,442,0.8373983739837398,126,131,95,131,98,99,680,0.8294573643410853,1.0
85,110,76,65,82,56,474,0.3933333333333333,60,90,70,60,120,40,440,0.27419354838709675,0.0
70,85,65,105,85,120,530,0.9262295081967213,75,105,75,105,75,45,480,0.3274336283185841,2.0
45,100,135,65,135,45,525,0.29411764705882354,40,55,99,40,79,47,360,0.26262626262626265,1.0
80,45,65,90,110,80,470,0.5462962962962963,50,85,85,55,55,50,380,0.3902439024390244,0.5
101,72,72,99,89,29,462,0.1937984496124031,80,100,200,50,100,50,580,0.3472222222222222,1.0
70,130,100,55,80,65,500,0.608,80,80,80,55,55,90,440,0.6417910447761194,1.0
100,100,100,100,100,100,600,0.831858407079646,75,100,63,80,63,116,497,0.9345794392523364,1.0
59,110,150,45,49,35,448,0.3333333333333333,55,47,52,40,40,41,275,0.16806722689075632,1.0
100,110,90,85,90,60,535,0.47794117647058826,40,40,55,40,70,55,300,0.40939597315436244,2.0
35,55,40,50,50,90,320,0.6838235294117647,55,84,105,114,75,52,485,0.2890625,2.0
80,145,150,105,110,110,700,0.8692307692307693,60,67,85,77,75,116,480,0.8888888888888888,0.5
77,120,90,60,90,48,485,0.2785714285714286,45,100,135,65,135,45,525,0.29411764705882354,1.0
50,48,43,46,41,60,288,0.47297297297297297,50,65,107,105,107,86,520,0.703125,2.0
45,49,49,65,65,45,318,0.2781954887218045,59,74,50,35,50,35,303,0.3125,0.5
75,125,230,55,95,30,610,0.3448275862068966,38,41,40,50,65,65,299,0.4108527131782946,1.0
78,65,68,112,154,75,552,0.628099173553719,95,124,78,69,71,58,495,0.37398373983739835,4.0
75,87,63,87,63,98,473,0.865546218487395,106,90,130,90,154,110,680,0.8699186991869918,1.0
90,100,70,110,150,80,600,0.6037735849056604,85,120,70,50,60,100,485,0.8308823529411765,1.0
95,85,85,65,65,35,430,0.2571428571428571,70,100,115,30,65,30,410,0.24390243902439024,4.0
75,89,85,55,65,36,405,0.29545454545454547,90,110,80,100,80,95,555,0.7982456140350878,0.5
70,140,230,60,80,50,630,0.32432432432432434,70,70,70,70,70,70,420,0.5289256198347108,1.0
50,70,50,50,50,40,310,0.16296296296296298,115,115,85,90,75,100,580,0.8134328358208955,2.0
45,65,34,40,34,45,263,0.2589928057553957,41,50,37,50,37,66,281,0.5175438596491229,1.0
53,54,53,37,46,45,288,0.3090909090909091,95,85,85,65,65,35,430,0.2571428571428571,2.0
38,35,40,27,25,35,200,0.08208955223880597,85,105,55,85,50,115,495,0.9032258064516129,1.0
55,84,105,114,75,52,485,0.2890625,50,95,95,35,110,70,455,0.5179856115107914,1.0
100,103,75,120,75,127,600,0.940677966101695,190,33,58,33,58,33,405,0.13432835820895522,1.0
45,20,50,60,120,50,345,0.24074074074074073,90,75,85,115,90,55,510,0.3445378151260504,0.5
88,107,122,74,75,64,530,0.4596774193548387,55,84,105,114,75,52,485,0.2890625,2.0
55,50,45,135,95,120,500,0.7714285714285715,50,180,20,180,20,150,600,0.9029850746268657,0.5
60,60,75,60,75,80,410,0.7321428571428571,103,93,67,71,61,84,479,0.7142857142857143,0.0
91,90,106,130,106,77,600,0.648854961832061,40,40,50,30,30,30,220,0.0873015873015873,2.0
44,58,44,58,44,61,309,0.41964285714285715,50,35,55,25,25,15,205,0.05263157894736842,2.0
68,90,65,50,55,82,410,0.6165413533834586,54,45,47,75,98,52,371,0.39669421487603307,0.0
50,47,50,57,50,65,319,0.463768115942029,30,40,70,70,25,60,295,0.41353383458646614,2.0
40,60,30,31,31,70,262,0.4492753623188406,60,110,70,60,60,100,460,0.8461538461538461,1.0
60,50,70,50,90,65,385,0.39568345323741005,20,40,90,30,90,25,295,0.11363636363636363,0.25
95,124,78,69,71,58,495,0.37398373983739835,50,64,50,45,50,41,300,0.22727272727272727,2.0
110,160,110,80,110,100,670,0.8591549295774648,60,62,63,80,80,60,405,0.38016528925619836,1.0
55,65,95,95,45,85,440,0.6610169491525424,45,60,30,80,50,65,330,0.4603174603174603,2.0
71,120,95,120,95,99,600,0.8203125,95,110,95,40,95,55,490,0.40336134453781514,1.0
55,40,40,65,45,35,280,0.16428571428571428,95,117,184,44,46,28,514,0.2975206611570248,1.0
40,30,30,40,50,30,220,0.07936507936507936,50,70,100,40,40,30,330,0.2222222222222222,2.0
78,65,68,112,154,75,552,0.628099173553719,40,50,90,30,55,65,330,0.44680851063829785,0.5
30,30,30,30,30,30,180,0.12612612612612611,56,61,65,48,45,38,313,0.17567567567567569,0.5
50,70,160,70,160,90,600,0.7417218543046358,110,160,110,80,110,100,670,0.8591549295774648,1.0
68,75,53,83,113,60,452,0.45384615384615384,45,75,37,70,55,83,365,0.6183206106870229,1.0
60,105,60,120,60,105,510,0.8849557522123894,75,75,75,125,95,40,485,0.15671641791044777,2.0
35,80,50,50,70,120,405,0.84375,70,65,60,90,75,90,450,0.6571428571428571,1.0
55,69,85,32,35,28,304,0.09302325581395349,100,123,75,57,75,80,510,0.6923076923076923,2.0
41,64,45,50,50,50,300,0.36752136752136755,65,95,100,60,50,50,420,0.34959349593495936,2.0
58,64,58,80,65,80,405,0.609271523178808,55,75,85,25,25,15,280,0.1875,0.5
75,95,125,45,75,95,510,0.8257575757575758,70,150,140,65,100,75,600,0.55,1.0
95,117,184,44,46,28,514,0.2975206611570248,25,20,15,105,55,90,310,0.32407407407407407,1.0
35,70,55,45,55,25,285,0.09420289855072464,50,50,62,40,62,65,329,0.4188034188034188,0.25
45,60,30,80,50,65,330,0.4603174603174603,55,50,40,40,40,75,300,0.5945945945945946,1.0
68,90,65,50,55,82,410,0.6165413533834586,95,75,180,130,80,30,590,0.13793103448275862,1.0
55,55,85,65,85,35,380,0.2014388489208633,79,100,80,110,90,121,580,0.968,2.0
70,90,110,60,75,95,500,0.7333333333333333,62,48,54,63,60,68,355,0.5178571428571429,2.0
75,85,200,55,65,30,510,0.16778523489932887,95,23,48,23,48,23,260,0.046153846153846156,1.0
55,65,95,95,45,85,440,0.6610169491525424,130,65,60,110,95,65,525,0.5227272727272727,0.5
49,49,56,49,61,66,330,0.5190839694656488,50,65,64,44,48,43,314,0.2196969696969697,0.5
30,80,90,55,45,55,355,0.4295774647887324,45,60,32,50,32,76,295,0.5925925925925926,1.0
65,80,65,35,65,60,370,0.38405797101449274,80,135,85,70,95,150,615,0.9844961240310077,0.5
45,22,60,27,30,29,213,0.07518796992481203,80,105,105,105,105,80,580,0.5939849624060151,2.0
75,85,200,55,65,30,510,0.16778523489932887,45,95,50,40,50,75,355,0.54,2.0
70,75,60,105,60,105,475,0.88,105,140,55,30,55,95,480,0.8195488721804511,1.0
45,53,70,40,60,42,310,0.25735294117647056,90,95,105,165,110,45,610,0.2890625,0.5
28,25,25,45,35,40,198,0.16083916083916083,75,90,50,110,80,95,500,0.7985611510791367,0.0
67,82,62,46,48,43,348,0.22033898305084745,55,95,115,45,45,35,390,0.2116788321167883,2.0
60,100,89,55,69,112,485,0.9298245614035088,40,65,95,60,45,35,340,0.13986013986013987,0.25
41,50,37,50,37,66,281,0.5175438596491229,75,95,125,45,75,95,510,0.8257575757575758,1.0
31,45,90,30,30,40,266,0.21929824561403508,165,75,80,40,45,65,470,0.5151515151515151,1.0
80,120,130,55,65,45,495,0.37037037037037035,40,30,30,40,50,30,220,0.07936507936507936,0.5
60,55,145,75,150,40,525,0.2,95,117,80,65,70,92,519,0.8409090909090909,0.5
80,100,200,50,100,50,580,0.3472222222222222,45,40,60,40,75,50,310,0.2926829268292683,2.0
60,75,100,55,80,50,420,0.3088235294117647,76,48,48,57,62,34,325,0.11688311688311688,0.5
100,134,110,95,100,61,600,0.4057971014492754,160,110,65,65,110,30,540,0.35714285714285715,1.0
35,40,100,90,55,35,355,0.1796875,55,55,85,65,85,35,380,0.2014388489208633,1.0
90,60,70,75,70,45,410,0.23880597014925373,60,50,40,85,75,95,405,0.7540983606557377,1.0
70,120,100,145,105,20,560,0.2824427480916031,65,70,60,65,65,115,440,0.8583333333333333,1.0
44,38,39,61,79,42,303,0.2251655629139073,100,123,75,57,75,80,510,0.6923076923076923,1.0
45,22,60,27,30,29,213,0.07518796992481203,45,63,37,65,55,95,360,0.8055555555555556,1.0
123,77,72,99,92,58,521,0.4621212121212121,65,85,70,75,70,40,405,0.203125,1.0
20,40,15,35,35,60,205,0.34285714285714286,40,50,90,30,55,65,330,0.44680851063829785,1.0
50,50,50,50,50,50,300,0.30708661417322836,101,72,72,99,89,29,462,0.1937984496124031,1.0
80,125,75,40,95,85,500,0.6911764705882353,38,30,85,55,65,30,303,0.21428571428571427,0.0
70,85,70,60,70,50,405,0.28378378378378377,65,95,57,100,85,93,495,0.7441860465116279,4.0
55,70,40,60,40,40,305,0.26956521739130435,40,55,30,30,30,85,270,0.688,2.0
100,110,90,85,90,60,535,0.47794117647058826,90,75,75,90,100,70,500,0.5462184873949579,0.5
75,100,95,40,70,110,490,0.8717948717948718,55,70,40,60,40,40,305,0.26956521739130435,1.0
75,105,75,105,75,45,480,0.3274336283185841,45,20,50,60,120,50,345,0.24074074074074073,0.5
90,50,34,60,44,70,348,0.6283185840707964,25,35,70,95,55,45,325,0.16783216783216784,0.25
50,75,35,70,30,40,300,0.21296296296296297,90,60,60,40,40,40,330,0.29545454545454547,1.0
60,50,40,85,75,95,405,0.7540983606557377,80,120,79,95,79,70,523,0.5833333333333334,0.5
10,55,25,35,45,95,265,0.5396825396825397,60,65,70,85,75,40,395,0.21705426356589147,1.0
35,46,34,35,45,20,215,0.072,75,70,90,70,105,80,490,0.656,1.0
50,75,35,70,30,40,300,0.21296296296296297,60,85,42,85,42,91,405,0.8227848101265823,0.5
70,110,70,115,70,90,525,0.75,60,50,70,50,90,65,385,0.39568345323741005,0.25
50,70,50,50,50,40,310,0.16296296296296298,35,20,65,40,65,20,245,0.02459016393442623,1.0
86,81,97,81,107,43,495,0.203125,76,25,45,67,55,24,292,0.0390625,1.0
40,50,90,30,55,65,330,0.44680851063829785,50,75,75,65,65,50,380,0.4049586776859504,0.5
50,95,180,85,45,70,525,0.5298507462686567,55,75,85,25,25,15,280,0.1875,2.0
80,80,90,110,130,110,600,0.8721804511278195,50,50,50,50,50,50,300,0.30708661417322836,1.0
55,65,35,60,30,85,330,0.6126126126126126,63,120,85,90,55,55,468,0.2809917355371901,0.5
70,100,115,30,65,30,410,0.24390243902439024,50,85,125,85,115,20,480,0.4306569343065693,1.0
65,80,140,40,70,70,465,0.5223880597014925,80,105,105,105,105,80,580,0.5939849624060151,1.0
79,103,120,135,115,78,630,0.5763888888888888,20,15,20,10,55,80,200,0.2682926829268293,0.5
103,93,67,71,61,84,479,0.7142857142857143,65,90,40,45,80,75,395,0.625,0.5
80,100,80,80,80,100,520,0.9051724137931034,30,35,30,100,35,80,310,0.4765625,2.0
45,60,30,80,50,65,330,0.4603174603174603,70,120,40,95,40,95,460,0.8106060606060606,0.25
75,100,110,45,55,65,450,0.5333333333333333,45,40,60,40,75,50,310,0.2926829268292683,0.0
64,51,23,51,23,28,240,0.11363636363636363,80,100,200,50,100,50,580,0.3472222222222222,0.5
255,10,10,75,135,55,540,0.3125,55,45,45,25,25,15,210,0.048,1.0
95,70,73,95,90,60,483,0.3983739837398374,70,70,70,70,70,70,420,0.5289256198347108,1.0
46,87,60,30,40,57,320,0.37777777777777777,95,23,48,23,48,23,260,0.046153846153846156,1.0
50,25,28,45,55,15,218,0.0625,75,110,110,110,105,80,590,0.656934306569343,2.0
50,20,55,25,25,30,205,0.09774436090225563,106,110,90,154,90,130,680,0.926829268292683,2.0
116,55,85,107,95,29,487,0.06818181818181818,75,75,95,75,95,113,528,0.9015151515151515,1.0
71,95,85,110,95,79,535,0.664,90,75,85,115,90,55,510,0.3445378151260504,1.0
75,100,110,45,55,65,450,0.5333333333333333,91,129,90,72,90,108,580,0.8536585365853658,2.0
85,73,70,73,115,67,483,0.5126050420168067,100,100,100,100,100,100,600,0.8805970149253731,1.0
60,30,30,36,56,50,262,0.32432432432432434,110,130,80,70,60,80,530,0.5862068965517241,1.0
90,60,70,75,70,45,410,0.23880597014925373,95,75,180,130,80,30,590,0.13793103448275862,0.25
95,75,80,100,110,30,490,0.24242424242424243,50,75,45,40,45,60,315,0.4380165289256198,1.0
60,70,50,100,50,65,395,0.5217391304347826,70,150,140,65,100,75,600,0.55,0.5
80,110,60,150,130,70,600,0.5042016806722689,65,95,57,100,85,93,495,0.7441860465116279,1.0
35,40,100,90,55,35,355,0.1796875,30,42,118,42,88,30,350,0.112,1.0
90,95,95,70,90,70,510,0.5230769230769231,60,110,70,60,60,100,460,0.8461538461538461,1.0
100,50,50,76,96,70,442,0.5,50,65,107,105,107,86,520,0.6991150442477876,0.5
150,160,100,95,65,100,670,0.8866666666666667,61,84,65,70,70,70,420,0.5,1.0
76,147,90,60,70,97,540,0.8267716535433071,55,45,45,25,25,15,210,0.048,1.0
50,70,100,40,40,30,330,0.2222222222222222,40,29,45,29,45,36,224,0.14634146341463414,2.0
60,40,80,60,45,40,325,0.23529411764705882,100,123,75,57,75,80,510,0.6923076923076923,0.5
70,65,65,55,55,70,380,0.5,50,30,55,65,55,20,275,0.13675213675213677,0.0
75,70,90,70,105,80,490,0.656,40,40,55,40,70,55,300,0.40939597315436244,1.0
80,105,105,105,105,80,580,0.5939849624060151,60,85,42,85,42,91,405,0.8227848101265823,0.0
60,80,110,50,80,45,425,0.2833333333333333,85,120,70,50,60,100,485,0.8308823529411765,0.0
35,65,35,65,35,65,300,0.46621621621621623,90,130,80,65,85,55,505,0.4396551724137931,1.0
82,121,119,69,59,71,521,0.5394736842105263,38,41,40,50,65,65,299,0.4108527131782946,2.0
30,80,90,55,45,55,355,0.4295774647887324,70,90,45,15,45,50,315,0.3629032258064516,4.0
111,83,68,92,82,39,475,0.1774193548387097,35,35,35,35,35,35,210,0.13385826771653545,1.0
82,80,86,85,75,72,480,0.6183206106870229,52,65,50,45,50,38,300,0.27419354838709675,4.0
73,100,60,100,60,65,458,0.42657342657342656,90,120,100,150,120,100,680,0.7718120805369127,1.0
90,110,80,100,80,95,555,0.7982456140350878,65,60,110,130,95,65,525,0.47761194029850745,2.0
50,50,95,40,50,35,320,0.20279720279720279,100,150,110,95,110,70,635,0.5923076923076923,1.0
50,30,55,65,55,20,275,0.13675213675213677,71,120,95,120,95,99,600,0.8203125,4.0
91,90,72,90,129,108,580,0.896,54,78,103,53,45,22,355,0.23255813953488372,8.0
55,50,45,135,95,120,500,0.7714285714285715,45,100,135,65,135,45,525,0.29411764705882354,1.0
90,70,80,70,95,70,475,0.5190839694656488,100,120,120,150,100,90,680,0.7880794701986755,0.5
80,52,50,90,50,89,411,0.6666666666666666,74,48,76,83,81,104,466,0.7913043478260869,2.0
35,70,55,45,55,25,285,0.09420289855072464,105,105,75,65,100,50,500,0.37593984962406013,0.25
30,42,118,42,88,30,350,0.112,65,75,105,35,65,85,430,0.6940298507462687,1.0
20,10,55,15,20,80,200,0.17985611510791366,103,60,86,60,86,50,445,0.3458646616541353,1.0
125,58,58,76,76,67,460,0.515625,45,75,60,40,30,50,300,0.304,0.25
82,80,86,85,75,72,480,0.6183206106870229,78,52,60,63,65,23,341,0.06015037593984962,1.0
52,65,50,45,50,38,300,0.27419354838709675,75,80,55,25,35,35,305,0.18666666666666668,0.5
68,72,78,38,42,32,330,0.23809523809523808,90,85,75,115,100,115,580,0.9381443298969072,2.0
50,75,35,70,30,40,300,0.21296296296296297,37,25,41,25,41,25,194,0.08870967741935484,0.5
90,90,85,125,90,100,580,0.768595041322314,65,95,57,100,85,93,495,0.7441860465116279,1.0
90,50,34,60,44,70,348,0.6283185840707964,57,80,91,80,87,75,470,0.5737704918032787,0.5
50,50,62,40,62,65,329,0.4188034188034188,91,90,129,90,72,108,580,0.9140625,0.0
58,64,58,80,65,80,405,0.5423728813559322,90,120,75,60,60,45,450,0.29411764705882354,1.0
75,110,110,110,105,80,590,0.656934306569343,85,80,70,135,75,90,535,0.7006802721088435,1.0
35,80,50,50,70,120,405,0.84375,35,55,40,45,40,60,275,0.35714285714285715,2.0
45,30,40,105,50,20,290,0.031007751937984496,90,95,95,70,90,70,510,0.5230769230769231,1.0
50,85,125,85,115,20,480,0.4306569343065693,70,100,115,30,65,30,410,0.24390243902439024,1.0
80,105,105,105,105,80,580,0.5939849624060151,100,164,150,95,120,71,700,0.5645161290322581,0.0
68,75,53,83,113,60,452,0.45384615384615384,65,73,55,47,75,85,400,0.6846846846846847,1.0
45,75,37,70,55,83,365,0.6183206106870229,91,134,95,100,100,80,600,0.6304347826086957,0.5
45,67,60,35,50,63,320,0.5128205128205128,40,40,55,40,70,55,300,0.40939597315436244,2.0
67,89,116,79,116,33,500,0.2624113475177305,105,30,105,140,105,55,540,0.3524590163934426,0.25
70,20,50,20,50,40,250,0.1557377049180328,90,85,75,115,100,115,580,0.9381443298969072,1.0
84,86,88,111,101,60,530,0.4634146341463415,60,85,69,60,69,77,420,0.518796992481203,1.0
55,55,45,63,45,45,308,0.25,50,95,180,85,45,70,525,0.5298507462686567,0.5
83,80,75,70,70,101,479,0.8615384615384616,75,80,95,90,100,50,490,0.2158273381294964,2.0
70,43,53,43,53,40,302,0.19090909090909092,70,77,60,97,60,108,472,0.8394160583941606,1.0
95,23,48,23,48,23,260,0.046153846153846156,54,78,103,53,45,22,355,0.23255813953488372,1.0
45,25,50,25,25,35,205,0.13076923076923078,80,125,75,40,95,85,500,0.6911764705882353,0.5
50,100,150,100,150,50,600,0.37142857142857144,100,128,90,77,77,128,600,0.959349593495935,1.0
60,60,75,60,75,80,410,0.7321428571428571,50,50,77,95,77,91,440,0.5916666666666667,0.0
100,164,150,95,120,71,700,0.5645161290322581,95,135,80,110,80,100,600,0.8248175182481752,2.0
81,102,77,85,75,85,505,0.5642857142857143,45,60,45,25,45,55,275,0.29,1.0
55,104,105,94,75,52,485,0.36363636363636365,62,44,50,44,50,55,305,0.3629032258064516,0.5
55,85,55,50,55,60,360,0.4233576642335766,100,150,140,100,90,90,670,0.7969924812030075,1.0
30,45,59,30,39,57,260,0.2803030303030303,75,89,85,55,65,36,405,0.29545454545454547,4.0
65,90,122,58,75,84,494,0.71875,60,60,60,35,35,30,280,0.11194029850746269,0.0
55,40,50,65,85,40,335,0.3181818181818182,60,50,70,50,90,65,385,0.39568345323741005,1.0
69,55,45,55,55,15,294,0.11666666666666667,85,60,65,135,105,100,550,0.7518248175182481,0.25
50,45,45,35,35,50,260,0.23529411764705882,50,70,100,40,40,30,330,0.2222222222222222,0.25
60,75,85,100,85,115,520,0.8992248062015504,105,95,80,40,80,90,490,0.753968253968254,1.0
60,100,85,80,85,100,510,0.7007874015748031,70,80,70,80,70,110,480,0.6594202898550725,0.0
123,100,62,97,81,68,531,0.4806201550387597,59,74,50,35,50,35,303,0.3125,2.0
50,50,120,80,80,30,410,0.07258064516129033,108,130,95,80,85,102,600,0.7637795275590551,0.25
85,76,64,45,55,90,415,0.6739130434782609,126,131,95,131,98,99,680,0.8294573643410853,1.0
45,60,40,70,50,45,310,0.2846715328467153,40,30,50,55,55,100,330,0.584070796460177,1.0
77,120,90,60,90,48,485,0.2785714285714286,70,90,70,60,60,70,420,0.6390977443609023,1.0
30,45,55,70,55,85,340,0.5633802816901409,110,65,75,125,85,30,490,0.15,1.0
70,140,230,60,80,50,630,0.32432432432432434,60,85,42,85,42,91,405,0.8227848101265823,1.0
75,100,95,40,70,110,490,0.8717948717948718,40,70,40,35,40,60,285,0.392,1.0
110,78,73,76,71,60,468,0.3333333333333333,55,75,50,40,40,80,340,0.6302521008403361,0.0
65,47,55,73,75,85,400,0.65,50,65,107,105,107,86,520,0.703125,1.0
100,134,110,95,100,61,600,0.4057971014492754,66,117,70,40,50,67,410,0.4573643410852713,1.0
75,55,70,55,95,110,460,0.8444444444444444,65,55,115,100,40,60,435,0.3798449612403101,1.0
65,40,70,80,140,70,465,0.5954198473282443,62,50,58,73,54,72,369,0.4435483870967742,2.0
95,75,180,130,80,30,590,0.13793103448275862,160,110,65,65,110,30,540,0.35714285714285715,1.0
65,130,60,95,110,65,525,0.5303030303030303,59,59,58,90,70,73,409,0.5826086956521739,0.5
109,66,84,81,99,32,471,0.2013888888888889,50,48,43,46,41,60,288,0.47297297297297297,0.0
95,100,85,108,70,70,528,0.5652173913043478,35,70,55,45,55,25,285,0.09420289855072464,0.5
45,30,50,65,50,45,285,0.13821138211382114,46,57,40,40,40,50,273,0.25,2.0
79,105,70,145,80,101,580,0.8608695652173913,80,130,100,160,120,110,700,0.8981481481481481,0.5
45,50,43,40,38,62,278,0.40441176470588236,50,85,55,65,65,90,410,0.7478260869565218,1.0
70,80,65,90,65,85,455,0.578125,40,45,35,30,40,55,245,0.3793103448275862,2.0
95,85,85,65,65,35,430,0.2571428571428571,170,90,45,90,45,60,500,0.427536231884058,0.5
49,55,42,42,37,85,310,0.6068376068376068,70,60,75,110,75,90,480,0.7165354330708661,1.0
75,98,63,98,63,101,498,0.889763779527559,72,58,80,103,80,97,490,0.7171052631578947,1.0
35,55,35,30,30,35,220,0.23684210526315788,40,45,40,35,35,56,251,0.373015873015873,1.0
65,65,45,75,45,95,390,0.72,60,50,100,85,70,65,430,0.47580645161290325,0.5
70,62,67,55,55,56,365,0.38513513513513514,55,35,50,55,110,85,390,0.6277372262773723,1.0
45,100,45,45,45,10,290,0.2949640287769784,100,150,110,95,110,70,635,0.5923076923076923,1.0
67,58,57,81,67,101,431,0.8790322580645161,97,165,60,65,50,58,495,0.3902439024390244,1.0
70,65,60,90,75,90,450,0.6571428571428571,55,81,60,50,70,97,413,0.7214285714285714,1.0
54,63,52,83,56,97,405,0.7697841726618705,65,95,100,60,50,50,420,0.34959349593495936,0.5
90,92,75,92,85,60,494,0.49586776859504134,62,55,52,109,94,109,481,0.7833333333333333,1.0
38,41,40,50,65,65,299,0.4108527131782946,105,105,75,65,100,50,500,0.37593984962406013,1.0
110,65,75,125,85,30,490,0.15,35,64,85,74,55,32,345,0.19827586206896552,1.0
75,80,55,25,35,35,305,0.18666666666666668,80,120,70,110,70,80,530,0.6422764227642277,1.0
100,77,77,128,128,90,600,0.6901408450704225,80,160,60,170,130,80,680,0.6180555555555556,0.0
77,120,90,60,90,48,485,0.2785714285714286,60,75,100,55,80,50,420,0.3088235294117647,0.5
55,84,105,114,75,52,485,0.2890625,83,106,65,86,65,85,490,0.6640625,1.0
50,50,77,95,77,91,440,0.5916666666666667,91,129,90,72,90,108,580,0.8536585365853658,1.0
65,105,60,60,70,95,455,63.0,65,80,140,40,70,70,465,0.5223880597014925,1.0
70,60,75,110,75,90,480,0.7165354330708661,60,60,60,60,60,60,360,0.38095238095238093,1.0
91,134,95,100,100,80,600,0.6304347826086957,35,45,160,30,45,70,385,0.48148148148148145,0.5
50,70,160,70,160,90,600,0.7417218543046358,60,62,50,62,60,40,334,0.18181818181818182,1.0
65,130,60,95,110,65,525,0.5303030303030303,55,70,40,60,40,40,305,0.26956521739130435,2.0
70,110,180,60,60,50,530,0.4117647058823529,65,80,140,40,70,70,465,0.5223880597014925,0.5
100,100,125,110,50,50,535,0.384,70,70,40,60,40,60,340,0.4247787610619469,0.5
60,80,50,50,50,40,330,0.23853211009174313,35,70,55,45,55,25,285,0.09420289855072464,1.0
45,60,32,50,32,76,295,0.5925925925925926,64,165,75,93,83,75,555,0.6587301587301587,1.0
65,95,75,55,55,85,430,0.6933333333333334,45,30,50,55,65,45,290,0.208,1.0
160,110,65,65,110,30,540,0.35714285714285715,104,91,63,91,73,68,490,0.5118110236220472,1.0
55,112,45,74,45,70,401,0.559322033898305,100,120,100,150,120,90,680,0.728,2.0
20,10,55,15,20,80,200,0.17985611510791366,55,55,55,85,55,30,335,0.1320754716981132,1.0
62,48,54,63,60,68,355,0.5178571428571429,60,85,40,30,45,68,328,0.6422018348623854,2.0
40,65,95,60,45,35,340,0.13986013986013987,38,35,35,65,55,50,278,0.2647058823529412,2.0
65,150,40,15,80,145,495,0.9663865546218487,90,120,75,60,60,45,450,0.29411764705882354,1.0
55,50,40,40,40,75,300,0.5945945945945946,123,100,62,97,81,68,531,0.4806201550387597,1.0
104,91,63,91,73,68,490,0.5118110236220472,45,35,50,70,50,30,280,0.15753424657534246,1.0
28,25,25,45,35,40,198,0.16083916083916083,75,140,65,112,65,110,567,0.9140625,1.0
70,130,100,55,80,65,500,0.608,45,85,70,40,40,60,340,0.5229357798165137,0.5
64,66,68,81,76,50,405,0.25190839694656486,80,110,120,130,90,70,600,0.6198347107438017,1.0
115,45,20,45,25,20,270,0.11538461538461539,65,150,60,115,60,115,565,0.935251798561151,2.0
60,62,63,80,80,60,405,0.38016528925619836,75,100,110,45,55,65,450,0.5333333333333333,1.0
50,70,50,50,50,70,340,0.5645161290322581,100,110,90,85,90,60,535,0.47794117647058826,1.0
95,117,80,65,70,92,519,0.8409090909090909,100,100,125,110,50,50,535,0.384,0.5
30,45,59,30,39,57,260,0.2803030303030303,60,60,60,35,35,30,280,0.11194029850746269,1.0
40,30,35,50,70,55,280,0.28205128205128205,50,105,79,35,110,76,455,0.6214285714285714,1.0
95,124,78,69,71,58,495,0.37398373983739835,90,120,100,150,120,100,680,0.7718120805369127,1.0
95,75,180,130,80,30,590,0.13793103448275862,92,105,90,125,90,98,600,0.8217054263565892,0.0
105,140,55,30,55,95,480,0.8195488721804511,65,125,60,95,60,105,510,0.9236641221374046,1.0
40,70,130,60,130,25,455,0.17355371900826447,45,55,45,65,45,75,330,0.5692307692307692,1.0
73,95,62,85,65,85,465,0.6666666666666666,79,85,60,55,60,71,410,0.60431654676259,1.0
65,76,84,54,96,105,480,0.9008264462809917,55,45,45,25,25,15,210,0.048,1.0
40,45,40,62,60,60,307,0.33884297520661155,80,135,85,70,95,150,615,0.9844961240310077,0.5
80,100,70,60,70,95,475,0.7416666666666667,40,65,95,60,45,35,340,0.13986013986013987,0.5
65,50,35,115,95,95,455,0.7333333333333333,55,69,85,32,35,28,304,0.09302325581395349,0.5
35,55,35,30,30,35,220,0.23684210526315788,76,25,45,67,55,24,292,0.0390625,2.0
45,60,32,50,32,76,295,0.5925925925925926,60,40,60,40,60,35,295,0.18055555555555555,0.5
90,95,105,165,110,45,610,0.2890625,65,105,60,60,70,95,455,63.0,1.0
95,65,110,60,130,65,525,0.5275590551181102,85,76,64,45,55,90,415,0.6739130434782609,1.0
60,60,40,65,45,35,305,0.15833333333333333,165,75,80,40,45,65,470,0.5151515151515151,0.5
64,66,68,81,76,50,405,0.25190839694656486,70,115,60,115,60,55,475,0.4647887323943662,0.5
110,160,110,80,110,100,670,0.8591549295774648,100,134,110,95,100,61,600,0.4057971014492754,0.5
90,120,120,60,60,50,500,0.35294117647058826,80,135,130,95,90,70,600,0.5181818181818182,2.0
60,60,60,60,60,60,360,0.38095238095238093,40,40,40,70,40,20,250,0.032520325203252036,1.0
90,60,60,40,40,40,330,0.29545454545454547,40,50,90,30,55,65,330,0.44680851063829785,1.0
56,61,65,48,45,38,313,0.17567567567567569,95,110,80,70,80,50,485,0.37209302325581395,1.0
60,60,50,40,50,75,335,0.5882352941176471,74,48,76,83,81,104,466,0.7913043478260869,1.0
36,50,50,65,60,44,305,0.16363636363636364,65,60,70,85,75,40,395,0.1796875,1.0
60,115,105,65,70,80,495,0.7181818181818181,105,105,75,65,100,50,500,0.37593984962406013,1.0
35,85,45,35,35,75,310,0.6492537313432836,85,56,77,50,77,78,423,0.53125,1.0
50,85,40,85,40,35,335,0.1746031746031746,50,65,107,105,107,86,520,0.7758620689655172,2.0
68,72,78,38,42,32,330,0.23809523809523808,80,70,65,80,120,100,515,0.8034188034188035,2.0
100,75,115,90,115,85,580,0.6446280991735537,60,52,168,47,138,30,495,0.19834710743801653,2.0
110,135,60,50,65,88,508,0.7744360902255639,60,75,85,100,85,115,520,0.8992248062015504,0.5
70,55,75,45,65,60,370,0.45901639344262296,45,20,50,60,120,50,345,0.24074074074074073,1.0
86,68,72,109,66,106,507,0.8099173553719008,55,70,40,60,40,40,305,0.26956521739130435,2.0
60,100,89,55,69,112,485,0.9298245614035088,44,58,44,58,44,61,309,0.41964285714285715,0.5
68,90,65,50,55,82,410,0.6165413533834586,70,85,65,105,85,120,530,0.9262295081967213,0.5
165,75,80,40,45,65,470,0.5151515151515151,90,92,87,75,85,76,505,0.5409836065573771,2.0
45,90,20,65,20,65,305,0.5116279069767442,60,90,70,60,120,40,440,0.27419354838709675,1.0
60,55,50,40,55,45,305,0.22377622377622378,130,70,35,70,35,60,400,0.4017857142857143,1.0
110,130,80,70,60,80,530,0.5862068965517241,45,50,43,40,38,62,278,0.40441176470588236,0.0
85,60,65,135,105,100,550,0.7518248175182481,100,150,140,100,90,90,670,0.7969924812030075,1.0
59,59,58,90,70,73,409,0.5826086956521739,45,30,50,65,50,45,285,0.13821138211382114,1.0
110,160,110,80,110,100,670,0.8591549295774648,70,120,100,145,105,20,560,0.2824427480916031,1.0
56,61,65,48,45,38,313,0.17567567567567569,50,95,95,35,110,70,455,0.5179856115107914,1.0
85,120,70,50,60,100,485,0.8308823529411765,30,42,118,42,88,30,350,0.112,0.0625
60,40,80,60,45,40,325,0.23529411764705882,80,90,80,130,110,110,600,0.856,0.25
50,50,77,95,77,91,440,0.5916666666666667,40,50,90,30,55,65,330,0.44680851063829785,1.0
73,100,60,100,60,65,458,0.42657342657342656,50,20,55,25,25,30,205,0.09774436090225563,1.0
80,120,80,120,80,100,580,0.8478260869565217,50,50,77,95,77,91,440,0.5916666666666667,1.0
70,95,125,65,75,45,475,0.33613445378151263,165,75,80,40,45,65,470,0.5151515151515151,1.0
95,70,73,95,90,60,483,0.3983739837398374,75,80,95,90,100,50,490,0.2158273381294964,1.0
64,88,50,88,50,106,446,0.9111111111111111,40,35,30,20,20,50,195,0.23423423423423423,1.0
60,50,70,80,80,140,480,0.8449612403100775,59,74,50,35,50,35,303,0.3125,0.0
95,75,180,130,80,30,590,0.13793103448275862,76,147,90,60,70,97,540,0.8267716535433071,0.5
38,35,40,27,25,35,200,0.08208955223880597,52,65,50,45,50,38,300,0.27419354838709675,2.0
50,65,90,35,35,15,290,0.14678899082568808,65,95,100,60,50,50,420,0.34959349593495936,1.0
60,115,105,65,70,80,495,0.7181818181818181,110,65,75,125,85,30,490,0.15,1.0
35,85,45,35,35,75,310,0.6492537313432836,63,63,47,41,41,74,329,0.56,1.0
78,130,111,130,85,100,634,0.8561151079136691,45,60,40,70,50,45,310,0.2846715328467153,0.5
100,100,100,100,100,100,600,0.8602941176470589,90,55,75,60,75,30,385,0.13970588235294118,1.0
68,65,65,125,115,80,518,0.6461538461538462,70,75,80,135,80,135,575,0.917910447761194,1.0
85,70,80,97,80,123,535,0.9304347826086956,60,45,70,75,85,55,390,0.3008130081300813,1.0
62,48,54,63,60,68,355,0.5178571428571429,43,80,65,50,35,35,308,0.14193548387096774,1.0
75,69,72,114,100,104,534,0.8253968253968254,65,50,35,115,95,95,455,0.7333333333333333,1.0
55,47,52,40,40,41,275,0.16806722689075632,62,73,55,56,52,84,382,0.7244094488188977,1.0
90,90,85,125,90,100,580,0.768595041322314,60,40,50,75,85,95,405,0.6044776119402985,0.25
75,80,95,90,100,50,490,0.2158273381294964,70,110,180,60,60,50,530,0.4117647058823529,1.0
55,45,50,45,65,80,340,0.5546218487394958,85,105,55,85,50,115,495,0.9032258064516129,2.0
48,61,40,61,40,50,300,0.2543859649122807,105,150,90,150,90,95,680,0.8285714285714286,0.5
55,65,35,60,30,85,330,0.6126126126126126,60,45,70,75,85,55,390,0.3008130081300813,1.0
75,75,75,125,95,40,485,0.15671641791044777,78,92,75,74,63,118,500,0.8842975206611571,1.0
76,48,48,57,62,34,325,0.11688311688311688,45,75,60,40,30,50,300,0.304,0.5
44,50,91,24,86,10,305,0.1981981981981982,65,136,94,54,96,135,580,0.9612403100775194,1.0
48,72,48,72,48,48,336,0.25984251968503935,95,135,80,110,80,100,600,0.8248175182481752,1.0
65,70,60,65,65,115,440,0.8583333333333333,90,60,70,75,70,45,410,0.23880597014925373,1.0
80,130,100,160,120,110,700,0.8981481481481481,40,29,45,29,45,36,224,0.14634146341463414,1.0
105,140,55,30,55,95,480,0.8195488721804511,120,100,85,30,85,45,465,0.22448979591836735,1.0
73,95,62,85,65,85,465,0.6666666666666666,80,105,105,105,105,80,580,0.5939849624060151,1.0
79,105,70,145,80,101,580,0.8608695652173913,40,20,30,40,80,55,265,0.22764227642276422,4.0
35,70,55,45,55,25,285,0.09420289855072464,62,55,52,109,94,109,481,0.7833333333333333,1.0
1,90,45,30,30,40,236,0.33064516129032256,70,80,65,90,65,85,455,0.578125,0.0
61,78,95,56,58,57,405,0.40336134453781514,65,40,50,125,60,30,370,0.07258064516129033,1.0
20,10,230,10,230,5,505,0.0,160,110,65,65,110,30,540,0.35714285714285715,1.0
35,80,50,50,70,120,405,0.84375,80,100,70,50,60,45,405,0.25806451612903225,1.0
85,135,130,60,80,25,515,0.40540540540540543,120,100,85,30,85,45,465,0.22448979591836735,0.5
130,85,80,85,95,60,535,0.43884892086330934,78,130,111,130,85,100,634,0.8561151079136691,1.0
55,47,52,40,40,41,275,0.16806722689075632,100,120,100,150,120,90,680,0.728,1.0
100,103,75,120,75,127,600,0.940677966101695,75,80,70,65,75,90,455,0.7578125,0.25
125,130,90,130,90,95,660,0.7734375,67,57,55,77,55,114,425,0.8879310344827587,2.0
35,20,65,40,65,20,245,0.02459016393442623,48,72,48,72,48,48,336,0.25984251968503935,1.0
95,80,105,40,70,100,490,0.8046875,80,135,85,70,95,150,615,0.9844961240310077,0.5
73,100,60,100,60,65,458,0.42657342657342656,74,94,131,54,116,20,489,0.4485294117647059,0.0
76,65,45,92,42,91,411,0.7449664429530202,70,75,80,135,80,135,575,0.917910447761194,0.5
20,40,15,35,35,60,205,0.34285714285714286,50,60,45,100,80,65,400,0.45689655172413796,0.5
40,80,35,35,45,70,305,0.4661016949152542,49,66,70,44,55,51,335,0.4260869565217391,0.0
80,85,95,30,30,25,345,0.2857142857142857,76,147,90,60,70,97,540,0.8267716535433071,1.0
57,24,86,24,86,23,300,0.12727272727272726,95,117,80,65,70,92,519,0.8409090909090909,0.0
60,80,50,50,50,40,330,0.23853211009174313,70,55,65,95,85,70,440,0.5307692307692308,0.5
100,103,75,120,75,127,600,0.940677966101695,73,76,75,81,100,100,505,0.8110236220472441,0.5
62,55,52,109,94,109,481,0.7833333333333333,85,90,80,70,80,130,535,0.9262295081967213,2.0
58,64,58,80,65,80,405,0.5423728813559322,95,75,80,100,110,30,490,0.24242424242424243,0.5
60,45,50,90,80,70,395,0.625,30,45,135,45,90,30,375,0.09285714285714286,0.5
85,110,76,65,82,56,474,0.3933333333333333,70,85,140,85,70,20,470,0.272,0.5
90,30,15,40,20,15,210,0.043478260869565216,99,68,83,72,87,51,460,0.417910447761194,1.0
67,125,40,30,30,58,350,0.3431372549019608,72,95,67,103,71,122,530,0.9606299212598425,1.0
45,30,35,20,20,45,195,0.14782608695652175,55,70,55,40,55,85,360,0.7073170731707317,1.0
42,52,67,39,56,50,306,0.2868217054263566,39,52,43,60,50,65,309,0.49107142857142855,4.0
30,45,55,70,55,85,340,0.5633802816901409,60,60,60,85,85,85,435,0.631578947368421,1.0
40,40,35,50,100,70,335,0.5031847133757962,80,120,130,55,65,45,495,0.37037037037037035,1.0
90,100,60,90,60,80,480,0.6422764227642277,59,45,40,35,40,31,250,0.14285714285714285,1.0
60,85,40,30,45,68,328,0.6422018348623854,45,50,55,75,65,30,320,0.06293706293706294,1.0
60,95,80,60,80,30,405,0.19480519480519481,60,79,105,59,85,36,424,0.17054263565891473,1.0
45,60,30,80,50,65,330,0.4603174603174603,100,120,120,150,100,90,680,0.7880794701986755,1.0
90,95,105,165,110,45,610,0.2890625,75,98,63,98,63,101,498,0.8091603053435115,0.5
60,50,70,50,90,65,385,0.39568345323741005,85,110,90,45,90,80,500,0.6206896551724138,1.0
60,75,85,100,85,115,520,0.8992248062015504,114,85,70,85,80,30,464,0.2066115702479339,1.0
90,30,15,40,20,15,210,0.043478260869565216,80,70,65,80,120,100,515,0.8034188034188035,0.5
69,55,45,55,55,15,294,0.11666666666666667,73,115,60,60,60,90,458,0.6694915254237288,1.0
40,30,32,50,52,65,269,0.3671875,110,160,110,80,110,100,670,0.8591549295774648,1.0
63,60,55,50,50,71,349,0.5289256198347108,70,135,105,60,105,20,495,0.5806451612903226,0.5
100,100,100,100,100,100,600,0.8345864661654135,40,55,30,30,30,60,245,0.43548387096774194,0.5
60,60,60,105,105,105,495,0.848,40,40,35,50,100,70,335,0.5031847133757962,1.0
40,55,30,30,30,85,270,0.688,43,70,48,50,60,38,309,0.2391304347826087,0.0
30,105,90,25,25,50,325,0.2773722627737226,70,140,230,60,80,50,630,0.32432432432432434,1.0
75,98,63,98,63,101,498,0.8091603053435115,250,5,5,35,105,50,450,0.15306122448979592,1.0
61,90,45,50,50,160,456,0.9230769230769231,105,95,80,40,80,90,490,0.753968253968254,1.0
79,85,60,55,60,71,410,0.60431654676259,109,66,84,81,99,32,471,0.2013888888888889,2.0
50,92,108,92,108,35,485,0.2457627118644068,80,135,85,70,95,150,615,0.9844961240310077,1.0
65,90,115,45,115,58,488,0.5041322314049587,75,123,67,95,85,95,540,0.7642276422764228,1.0
70,150,140,65,100,75,600,0.55,73,95,62,85,65,85,465,0.6666666666666666,1.0
40,40,55,40,70,55,300,0.40939597315436244,50,65,85,35,35,55,325,0.32575757575757575,1.0
35,85,45,35,35,75,310,0.6492537313432836,70,90,110,60,75,95,500,0.7333333333333333,1.0
90,85,75,115,100,115,580,0.9381443298969072,91,90,72,90,129,108,580,0.896,0.5
50,85,40,85,40,35,335,0.1746031746031746,80,100,80,80,80,100,520,0.9051724137931034,1.0
55,63,90,50,80,42,380,0.21138211382113822,75,80,85,110,90,50,490,0.3548387096774194,0.25
45,63,37,65,55,95,360,0.8055555555555556,58,109,112,48,48,109,484,0.8805970149253731,1.0
65,136,94,54,96,135,580,0.9612403100775194,45,80,100,35,37,28,325,0.3125,0.0
70,90,110,60,75,95,500,0.7333333333333333,41,50,37,50,37,66,281,0.5175438596491229,0.5
76,25,45,67,55,24,292,0.0390625,59,110,150,45,49,35,448,0.3333333333333333,0.5
65,50,70,95,80,65,425,0.4262295081967213,50,50,62,40,62,65,329,0.4188034188034188,2.0
40,40,55,40,70,55,300,0.40939597315436244,106,110,90,154,90,130,680,0.926829268292683,0.5
40,27,60,37,50,66,280,0.36220472440944884,50,40,85,40,65,25,305,0.08870967741935484,0.5
65,90,65,61,61,100,442,0.8373983739837398,90,85,100,95,125,85,580,0.6834532374100719,1.0
60,85,42,85,42,91,405,0.8227848101265823,70,65,65,55,55,70,380,0.5,1.0
120,120,120,120,120,120,720,0.9344262295081968,70,85,65,105,85,120,530,0.9262295081967213,1.0
100,120,120,150,100,90,680,0.7880794701986755,75,85,200,55,65,30,510,0.16778523489932887,0.25
150,100,120,100,120,90,680,0.6666666666666666,100,100,90,150,140,90,670,0.71875,1.0
60,130,80,60,60,70,460,0.5153846153846153,45,63,37,65,55,95,360,0.8055555555555556,1.0
105,95,75,85,75,74,509,0.5714285714285714,75,98,63,98,63,101,498,0.889763779527559,4.0
105,150,90,150,90,95,680,0.8285714285714286,50,50,62,40,62,65,329,0.4188034188034188,1.0
70,83,50,37,50,60,350,0.3360655737704918,38,35,40,27,25,35,200,0.08208955223880597,2.0
75,98,63,98,63,101,498,0.889763779527559,55,69,85,32,35,28,304,0.09302325581395349,2.0
40,50,45,70,45,70,320,0.5517241379310345,45,80,100,35,37,28,325,0.3125,0.25
65,150,40,15,80,145,495,0.9663865546218487,126,131,95,131,98,99,680,0.8294573643410853,1.0
59,110,150,45,49,35,448,0.3333333333333333,40,50,45,70,45,70,320,0.5517241379310345,2.0
70,55,95,95,110,65,490,0.48872180451127817,50,53,48,53,48,64,316,0.4076923076923077,1.0
78,84,78,109,85,100,534,0.8646616541353384,68,65,65,125,115,80,518,0.6461538461538462,1.0
70,40,50,55,50,25,290,0.061068702290076333,70,100,70,105,75,40,460,0.23214285714285715,4.0
65,90,120,85,70,60,490,0.43410852713178294,90,60,70,75,70,45,410,0.23880597014925373,1.0
95,110,95,40,95,55,490,0.40336134453781514,70,80,65,90,65,85,455,0.578125,1.0
84,71,43,71,43,48,360,0.25874125874125875,85,100,122,58,75,54,494,0.3939393939393939,0.0
100,180,160,150,90,90,770,0.7520661157024794,40,60,40,40,40,30,250,0.0948905109489051,2.0
53,51,53,61,56,40,314,0.14285714285714285,20,40,90,30,90,25,295,0.11363636363636363,1.0
72,58,80,103,80,97,490,0.7171052631578947,50,47,50,57,50,65,319,0.463768115942029,1.0
39,52,43,60,50,65,309,0.49107142857142855,85,115,80,105,80,50,515,0.3063063063063063,1.0
70,55,55,80,60,45,365,0.2222222222222222,54,63,52,83,56,97,405,0.7697841726618705,2.0
55,85,122,58,75,99,494,0.8099173553719008,70,50,30,95,135,105,485,0.8040540540540541,1.0
70,60,62,80,82,60,414,0.4375,41,56,40,62,44,71,314,0.568,1.0
100,120,120,150,100,90,680,0.7880794701986755,50,53,48,53,48,64,316,0.46153846153846156,0.5
110,80,90,95,90,65,530,0.5033557046979866,80,135,130,95,90,70,600,0.5181818181818182,0.5
90,93,55,70,55,55,418,0.3819444444444444,60,85,69,60,69,77,420,0.518796992481203,2.0
70,60,62,80,82,60,414,0.4375,70,110,75,145,85,145,630,0.9444444444444444,4.0
78,130,111,130,85,100,634,0.8561151079136691,60,40,50,75,85,95,405,0.6044776119402985,1.0
50,45,45,35,35,50,260,0.23529411764705882,70,80,70,80,70,110,480,0.6594202898550725,0.0
60,75,85,100,85,115,520,0.8992248062015504,95,117,80,65,70,92,519,0.8409090909090909,0.0
70,110,70,115,70,90,525,0.75,100,5,5,15,65,30,220,0.07692307692307693,2.0
50,60,60,60,60,30,320,0.11290322580645161,70,55,65,95,85,70,440,0.5307692307692308,1.0
60,85,69,60,69,77,420,0.518796992481203,110,65,105,55,95,80,510,0.6258503401360545,1.0
100,110,90,85,90,60,535,0.47794117647058826,80,120,79,95,79,70,523,0.5833333333333334,2.0
45,20,50,60,120,50,345,0.24074074074074073,90,120,100,150,120,100,680,0.7718120805369127,0.25
55,40,85,80,105,40,405,0.23622047244094488,65,65,60,130,95,110,525,0.823943661971831,1.0
45,50,55,75,65,30,320,0.06293706293706294,90,120,100,150,120,100,680,0.7718120805369127,1.0
80,100,80,80,80,100,520,0.9051724137931034,60,25,35,70,80,60,330,0.3076923076923077,1.0
70,92,65,80,55,98,460,0.8090909090909091,35,40,100,90,55,35,355,0.1796875,1.0
70,90,70,60,60,70,420,0.6390977443609023,90,65,65,40,40,15,315,0.19672131147540983,2.0
78,92,75,74,63,118,500,0.8842975206611571,60,62,50,62,60,40,334,0.18181818181818182,4.0
114,85,70,85,80,30,464,0.2066115702479339,70,75,80,135,80,135,575,0.917910447761194,1.0
68,75,53,83,113,60,452,0.45384615384615384,30,40,70,70,25,60,295,0.41353383458646614,1.0
150,80,44,90,54,80,498,0.625,45,22,60,27,30,29,213,0.07518796992481203,2.0
55,75,85,25,25,15,280,0.1875,73,95,62,85,65,85,465,0.6666666666666666,1.0
38,35,40,27,25,35,200,0.08208955223880597,75,123,67,95,85,95,540,0.7642276422764228,1.0
55,55,55,85,55,30,335,0.1320754716981132,40,50,45,70,45,70,320,0.5517241379310345,0.5
60,69,95,69,95,36,424,0.2608695652173913,55,40,50,65,85,40,335,0.3181818181818182,0.25
90,65,65,40,40,15,315,0.19672131147540983,44,38,39,61,79,42,303,0.2251655629139073,1.0
78,104,78,159,115,100,634,0.8444444444444444,85,76,64,45,55,90,415,0.6739130434782609,1.0
100,100,125,110,50,50,535,0.384,60,50,100,85,70,65,430,0.47580645161290325,1.0
59,63,80,65,80,58,405,0.41843971631205673,78,65,68,112,154,75,552,0.628099173553719,1.0
40,55,80,35,60,30,300,0.15037593984962405,28,25,25,45,35,40,198,0.16083916083916083,0.25
75,98,63,98,63,101,498,0.889763779527559,50,50,62,40,62,65,329,0.4188034188034188,1.0
60,65,70,85,75,40,395,0.21705426356589147,75,85,200,55,65,30,510,0.16778523489932887,0.0
75,85,200,55,65,30,510,0.16778523489932887,75,95,67,125,95,83,540,0.7117117117117117,1.0
45,49,65,49,65,45,318,0.275,67,58,57,81,67,101,431,0.8790322580645161,1.0
65,95,57,100,85,93,495,0.7441860465116279,67,58,57,81,67,101,431,0.8790322580645161,1.0
85,105,85,40,50,40,405,0.211864406779661,55,55,50,45,65,55,325,0.37373737373737376,2.0
83,80,80,135,80,121,579,0.9444444444444444,50,70,50,50,50,40,310,0.16296296296296298,1.0
50,85,125,85,115,20,480,0.4306569343065693,35,55,35,30,30,35,220,0.23684210526315788,0.25
40,27,60,37,50,66,280,0.36220472440944884,35,35,35,35,35,35,210,0.13385826771653545,2.0
60,70,105,70,120,75,500,0.5983606557377049,66,41,77,61,87,23,355,0.12096774193548387,1.0
60,80,50,50,50,40,330,0.23853211009174313,75,100,110,45,55,65,450,0.5333333333333333,1.0
62,48,66,59,57,49,341,0.33884297520661155,95,65,110,60,130,65,525,0.5275590551181102,2.0
45,85,50,55,50,65,350,0.5076923076923077,36,50,50,65,60,44,305,0.16363636363636364,2.0
45,75,37,70,55,83,365,0.6183206106870229,70,80,70,80,70,110,480,0.6594202898550725,2.0
57,80,91,80,87,75,470,0.5737704918032787,108,112,118,68,72,47,525,0.2916666666666667,1.0
60,85,42,85,42,91,405,0.8227848101265823,97,165,60,65,50,58,495,0.3902439024390244,0.5
70,100,115,30,65,30,410,0.24390243902439024,75,75,55,105,85,30,425,0.1619718309859155,1.0
60,100,85,80,85,100,510,0.7007874015748031,85,135,130,60,80,25,515,0.40540540540540543,2.0
65,125,100,55,70,85,500,0.6532258064516129,44,38,39,61,79,42,303,0.2251655629139073,0.5
70,90,110,60,75,95,500,0.7333333333333333,50,75,35,70,30,40,300,0.21296296296296297,1.0
110,78,73,76,71,60,468,0.3333333333333333,65,65,60,130,95,110,525,0.823943661971831,1.0
35,65,35,65,35,65,300,0.46621621621621623,65,95,57,100,85,93,495,0.7441860465116279,2.0
35,64,85,74,55,32,345,0.19827586206896552,65,45,55,45,70,45,325,0.24369747899159663,0.5
70,62,67,55,55,56,365,0.38513513513513514,55,45,45,25,25,15,210,0.048,0.5
65,90,122,58,75,84,494,0.71875,105,30,105,140,105,55,540,0.3524590163934426,1.0
50,65,64,44,48,43,314,0.2196969696969697,95,23,48,23,48,23,260,0.046153846153846156,1.0
60,48,45,43,90,42,328,0.21897810218978103,120,100,85,30,85,45,465,0.22448979591836735,1.0
45,35,50,70,50,30,280,0.15753424657534246,90,100,90,125,85,90,580,0.7352941176470589,0.25
35,65,35,65,35,65,300,0.46621621621621623,95,109,105,75,85,56,525,0.34513274336283184,1.0
65,40,70,80,140,70,465,0.5954198473282443,81,102,77,85,75,85,505,0.5642857142857143,2.0
75,75,60,83,60,60,413,0.39344262295081966,95,23,48,23,48,23,260,0.046153846153846156,1.0
55,50,65,175,95,150,590,0.7818181818181819,40,55,99,40,79,47,360,0.26262626262626265,2.0
70,115,60,115,60,55,475,0.4647887323943662,44,38,33,61,43,70,289,0.5267857142857143,1.0
40,40,35,50,100,70,335,0.5031847133757962,60,60,60,60,60,60,360,0.38095238095238093,1.0
60,45,50,90,80,70,395,0.625,90,120,120,60,60,50,500,0.35294117647058826,1.0
110,160,110,80,110,100,670,0.8591549295774648,50,85,55,65,65,90,410,0.7478260869565218,1.0
50,65,107,105,107,86,520,0.703125,50,50,62,40,62,65,329,0.4188034188034188,1.0
55,112,45,74,45,70,401,0.559322033898305,65,95,75,55,55,85,430,0.6933333333333334,1.0
55,50,45,135,95,120,500,0.7714285714285715,250,5,5,35,105,50,450,0.15306122448979592,1.0
65,50,35,115,95,95,455,0.7333333333333333,55,45,45,25,25,15,210,0.048,2.0
65,75,70,95,70,95,470,0.7272727272727273,65,65,65,50,50,90,385,0.72,1.0
130,85,80,85,95,60,535,0.43884892086330934,65,95,57,100,85,93,495,0.7441860465116279,1.0
20,10,230,10,230,5,505,0.0,65,65,45,75,45,95,390,0.72,2.0
65,83,57,95,85,105,490,0.8914728682170543,83,80,80,135,80,121,579,0.9444444444444444,2.0
99,68,83,72,87,51,460,0.417910447761194,65,150,60,115,60,115,565,0.935251798561151,1.0
75,87,63,87,63,98,473,0.865546218487395,35,46,34,35,45,20,215,0.072,1.0
45,65,34,40,34,45,263,0.2589928057553957,100,100,100,100,100,100,600,0.831858407079646,1.0
80,80,80,80,80,80,480,0.6015037593984962,85,70,80,97,80,123,535,0.9304347826086956,4.0
50,80,95,10,45,10,290,0.232,44,48,65,50,64,43,314,0.1623931623931624,1.0
50,100,150,100,150,50,600,0.37142857142857144,60,55,50,40,55,45,305,0.22377622377622378,1.0
55,65,35,60,30,85,330,0.6126126126126126,65,63,45,45,45,45,308,0.2595419847328244,2.0
40,45,35,30,40,55,245,0.3793103448275862,90,70,80,70,95,70,475,0.5190839694656488,1.0
85,50,95,120,115,80,545,0.5793650793650794,60,40,60,95,60,55,370,0.4222222222222222,0.5
75,69,72,114,100,104,534,0.8253968253968254,49,49,56,49,61,66,330,0.5190839694656488,0.5
95,109,105,75,85,56,525,0.34513274336283184,74,108,133,83,65,32,495,0.32142857142857145,8.0
49,49,56,49,61,66,330,0.5190839694656488,50,53,48,53,48,64,316,0.46153846153846156,2.0
90,70,80,70,95,70,475,0.5190839694656488,45,35,45,62,53,35,275,0.11851851851851852,1.0
69,55,45,55,55,15,294,0.11666666666666667,86,68,72,109,66,106,507,0.8099173553719008,0.5
103,60,86,60,86,50,445,0.3458646616541353,60,80,50,50,50,40,330,0.23853211009174313,1.0
67,89,116,79,116,33,500,0.2624113475177305,100,100,100,100,100,100,600,0.8778625954198473,0.25
59,110,150,45,49,35,448,0.3333333333333333,75,90,90,140,90,115,600,0.9481481481481482,0.25
68,90,65,50,55,82,410,0.6165413533834586,255,10,10,75,135,55,540,0.3125,1.0
79,100,80,110,90,121,580,0.968,79,85,60,55,60,71,410,0.60431654676259,1.0
60,80,110,50,80,45,425,0.2833333333333333,40,40,55,40,70,55,300,0.40939597315436244,1.0
65,110,130,60,65,95,525,0.8278145695364238,35,45,160,30,45,70,385,0.48148148148148145,4.0
70,85,70,60,70,50,405,0.28378378378378377,80,100,70,60,70,95,475,0.7416666666666667,0.25
90,60,60,40,40,40,330,0.29545454545454547,95,109,105,75,85,56,525,0.34513274336283184,0.5
62,73,55,56,52,84,382,0.7244094488188977,65,75,90,97,123,44,494,0.1987179487179487,0.5
55,104,105,94,75,52,485,0.36363636363636365,100,100,100,100,100,100,600,0.8602941176470589,0.5
100,70,70,65,65,45,415,0.1897810218978102,100,120,100,150,120,90,680,0.728,1.0
55,112,45,74,45,70,401,0.559322033898305,70,85,140,85,70,20,470,0.272,2.0
105,140,95,55,65,45,505,0.3,80,80,80,80,80,80,480,0.5606060606060606,1.0
45,45,55,45,55,63,308,0.4594594594594595,55,65,95,95,45,85,440,0.6610169491525424,2.0
45,40,60,40,75,50,310,0.2926829268292683,70,85,140,85,70,20,470,0.272,1.0
70,130,100,55,80,65,500,0.608,74,94,131,54,116,20,489,0.4485294117647059,0.5
35,45,160,30,45,70,385,0.48148148148148145,40,65,95,60,45,35,340,0.13986013986013987,2.0
45,75,60,40,30,50,300,0.304,60,60,60,85,85,85,435,0.631578947368421,1.0
86,81,97,81,107,43,495,0.203125,78,92,75,74,63,118,500,0.8842975206611571,0.5
82,121,119,69,59,71,521,0.5394736842105263,100,50,50,76,96,70,442,0.5,2.0
38,30,85,55,65,30,303,0.21428571428571427,58,64,58,80,65,80,405,0.609271523178808,1.0
90,120,120,60,60,50,500,0.35294117647058826,55,35,50,55,110,85,390,0.6277372262773723,0.0
71,120,95,120,95,99,600,0.8203125,50,48,43,46,41,60,288,0.47297297297297297,0.5
76,104,71,104,71,108,534,0.912751677852349,62,48,54,63,60,68,355,0.5178571428571429,0.5
43,70,48,50,60,38,309,0.2391304347826087,75,70,90,70,105,80,490,0.656,0.25
70,95,85,55,65,70,440,0.5,35,45,160,30,45,70,385,0.48148148148148145,1.0
90,120,100,150,120,100,680,0.7718120805369127,70,62,67,55,55,56,365,0.38513513513513514,1.0
43,80,65,50,35,35,308,0.14193548387096774,91,134,95,100,100,80,600,0.6304347826086957,0.5
105,105,75,65,100,50,500,0.37593984962406013,40,45,35,40,40,90,290,0.65,1.0
60,85,69,60,69,77,420,0.518796992481203,116,55,85,107,95,29,487,0.06818181818181818,1.0
130,70,35,70,35,60,400,0.4017857142857143,45,90,20,65,20,65,305,0.5116279069767442,0.5
59,59,58,90,70,73,409,0.5826086956521739,55,112,45,74,45,70,401,0.559322033898305,0.5
65,105,60,60,70,95,455,63.0,70,100,70,105,75,40,460,0.23214285714285715,1.0
35,70,55,45,55,25,285,0.09420289855072464,57,24,86,24,86,23,300,0.12727272727272726,0.5
40,30,35,50,70,55,280,0.28205128205128205,95,110,80,70,80,50,485,0.37209302325581395,1.0
130,85,80,85,95,60,535,0.43884892086330934,40,27,60,37,50,66,280,0.36220472440944884,1.0
165,75,80,40,45,65,470,0.5151515151515151,70,110,180,60,60,50,530,0.4117647058823529,2.0
76,25,45,67,55,24,292,0.0390625,65,90,50,85,45,55,390,0.371900826446281,2.0
49,49,56,49,61,66,330,0.5190839694656488,90,30,15,40,20,15,210,0.043478260869565216,1.0
44,75,35,63,33,45,295,0.2647058823529412,60,50,100,85,70,65,430,0.47580645161290325,1.0
40,80,35,35,45,70,305,0.4661016949152542,100,100,90,150,140,90,670,0.71875,1.0
190,33,58,33,58,33,405,0.13432835820895522,100,100,100,100,100,100,600,0.8345864661654135,0.5
75,69,72,114,100,104,534,0.8253968253968254,60,62,63,80,80,60,405,0.38016528925619836,4.0
60,82,45,45,45,74,351,0.5752212389380531,65,90,115,45,115,58,488,0.5041322314049587,0.25
62,48,54,63,60,68,355,0.5178571428571429,60,65,70,85,75,40,395,0.21705426356589147,2.0
61,84,65,70,70,70,420,0.5,83,106,65,86,65,85,490,0.6640625,1.0
60,100,85,80,85,100,510,0.7007874015748031,20,25,45,70,90,60,310,0.30833333333333335,0.125
71,120,95,120,95,99,600,0.8203125,110,135,60,50,65,88,508,0.7744360902255639,0.25
63,63,47,41,41,74,329,0.56,58,64,58,80,65,80,405,0.5423728813559322,1.0
90,92,87,75,85,76,505,0.5409836065573771,70,80,65,90,65,85,455,0.578125,1.0
95,60,79,100,125,81,540,0.6201550387596899,75,80,60,65,90,102,472,0.8625954198473282,1.0
60,85,69,65,79,80,438,0.576,55,70,45,70,50,60,350,0.45,1.0
30,56,35,25,35,72,253,0.48148148148148145,75,98,63,98,63,101,498,0.849624060150376,1.0
40,30,35,50,70,55,280,0.28205128205128205,20,15,20,10,55,80,200,0.2682926829268293,2.0
55,75,60,75,60,103,428,0.7982456140350878,76,48,48,57,62,34,325,0.11688311688311688,2.0
100,77,77,128,128,90,600,0.6901408450704225,84,71,43,71,43,48,360,0.25874125874125875,1.0
75,80,95,90,100,50,490,0.2158273381294964,70,70,115,130,90,60,535,0.5338983050847458,0.5
38,41,40,50,65,65,299,0.4108527131782946,73,100,60,100,60,65,458,0.42657342657342656,1.0
45,85,50,55,50,65,350,0.5076923076923077,50,70,50,50,50,40,310,0.16296296296296298,1.0
89,145,90,105,80,91,600,0.8549618320610687,40,45,40,65,40,65,295,0.5661764705882353,1.0
50,95,90,95,90,180,600,0.9172413793103448,65,95,100,60,50,50,420,0.34959349593495936,1.0
60,52,168,47,138,30,495,0.19834710743801653,46,87,60,30,40,57,320,0.37777777777777777,1.0
80,145,150,105,110,110,700,0.8692307692307693,70,95,85,55,65,70,440,0.5,1.0
75,98,63,98,63,101,498,0.889763779527559,48,72,48,72,48,48,336,0.25984251968503935,1.0
50,53,62,58,63,44,330,0.13709677419354838,90,65,65,40,40,15,315,0.19672131147540983,0.5
38,35,35,65,55,50,278,0.2647058823529412,50,105,125,55,95,50,480,0.375886524822695,0.25
45,67,60,35,50,63,320,0.5128205128205128,75,75,75,125,95,40,485,0.15671641791044777,1.0
55,75,60,75,60,103,428,0.7982456140350878,75,95,67,125,95,83,540,0.7117117117117117,1.0
75,87,63,87,63,98,473,0.865546218487395,50,50,120,80,80,30,410,0.07258064516129033,2.0
50,52,48,65,50,55,320,0.33098591549295775,80,110,60,150,130,70,600,0.5042016806722689,1.0
50,92,108,92,108,35,485,0.2457627118644068,45,85,70,40,40,60,340,0.5229357798165137,0.25
37,25,41,25,41,25,194,0.08870967741935484,125,120,90,170,100,95,700,0.78125,1.0
65,65,60,130,95,110,525,0.823943661971831,55,75,50,40,40,80,340,0.6302521008403361,1.0
150,120,100,120,100,90,680,0.664179104477612,85,80,90,105,95,60,515,0.49074074074074076,0.0
80,80,50,40,50,25,325,0.176056338028169,59,45,40,35,40,31,250,0.14285714285714285,1.0
50,50,50,50,50,50,300,0.30708661417322836,75,69,72,114,100,104,534,0.8253968253968254,0.5
55,70,40,60,40,40,305,0.26956521739130435,100,100,100,100,100,100,600,0.8778625954198473,0.5
40,40,35,50,100,70,335,0.5031847133757962,60,65,80,170,95,130,600,0.8625954198473282,0.25
55,40,40,65,45,35,280,0.16428571428571428,44,38,33,61,43,70,289,0.5267857142857143,0.5
70,70,40,60,40,60,340,0.4247787610619469,50,60,60,60,60,30,320,0.11290322580645161,1.0
86,81,97,81,107,43,495,0.203125,65,150,60,115,60,115,565,0.935251798561151,1.0
101,72,72,99,89,29,462,0.1937984496124031,110,65,75,125,85,30,490,0.15,1.0
50,60,45,100,80,65,400,0.45689655172413796,70,60,75,110,75,90,480,0.7165354330708661,1.0
50,85,125,85,115,20,480,0.4306569343065693,80,110,60,150,130,70,600,0.5042016806722689,16.0
85,135,130,60,80,25,515,0.40540540540540543,70,55,65,95,85,70,440,0.5307692307692308,1.0
80,80,90,110,130,110,600,0.8721804511278195,70,45,48,60,65,35,323,0.15748031496062992,0.0
83,80,80,135,80,121,579,0.9444444444444444,80,52,50,90,50,89,411,0.6666666666666666,2.0
50,180,20,180,20,150,600,0.9029850746268657,75,80,55,25,35,35,305,0.18666666666666668,1.0
40,65,95,60,45,35,340,0.13986013986013987,60,55,145,75,150,40,525,0.2,0.0
62,73,55,56,52,84,382,0.7244094488188977,115,115,85,90,75,100,580,0.8134328358208955,0.5
65,75,70,95,70,95,470,0.7272727272727273,39,52,43,60,50,65,309,0.5041322314049587,1.0
75,80,95,90,100,50,490,0.2158273381294964,60,70,65,125,105,90,515,0.6911764705882353,0.25
110,80,90,95,90,65,530,0.5033557046979866,105,125,100,60,100,100,590,0.8359375,1.0
100,150,90,180,160,90,770,0.7348484848484849,106,190,100,154,100,130,780,0.9259259259259259,1.0
50,75,35,70,30,40,300,0.21296296296296297,35,35,35,35,35,35,210,0.13385826771653545,1.0
80,135,85,70,95,150,615,0.9844961240310077,45,60,32,50,32,76,295,0.5925925925925926,0.5
60,80,95,70,85,50,440,0.2231404958677686,38,30,85,55,65,30,303,0.21428571428571427,1.0
60,115,105,65,70,80,495,0.7181818181818181,45,53,70,40,60,42,310,0.25735294117647056,1.0
58,64,58,80,65,80,405,0.5423728813559322,90,100,60,90,60,80,480,0.6422764227642277,2.0
80,50,100,100,200,50,580,0.2357142857142857,45,55,45,65,45,75,330,0.5692307692307692,1.0
64,78,52,78,52,81,405,0.6422764227642277,65,136,94,54,96,135,580,0.9612403100775194,2.0
40,40,40,70,40,20,250,0.032520325203252036,65,75,105,35,65,85,430,0.6940298507462687,1.0
45,55,39,35,39,42,255,0.18518518518518517,65,130,60,75,60,75,465,0.689922480620155,1.0
45,60,45,25,45,55,275,0.29,90,90,85,125,90,100,580,0.768595041322314,1.0
65,100,70,80,80,105,500,0.8666666666666667,56,61,65,48,45,38,313,0.17567567567567569,2.0
74,94,131,54,116,20,489,0.4485294117647059,75,100,110,45,55,65,450,0.5333333333333333,2.0
90,120,100,150,120,100,680,0.7718120805369127,100,100,100,100,100,100,600,0.8602941176470589,0.5
65,155,120,65,90,105,600,0.8677685950413223,78,92,75,74,63,118,500,0.8842975206611571,0.5
75,125,70,125,70,115,580,0.9037037037037037,45,95,50,40,50,75,355,0.54,1.0
100,120,120,150,100,90,680,0.7880794701986755,75,69,72,114,100,104,534,0.8253968253968254,0.5
50,47,50,57,50,65,319,0.463768115942029,75,95,95,95,95,85,540,0.6470588235294118,1.0
72,95,67,103,71,122,530,0.9606299212598425,110,135,60,50,65,88,508,0.7744360902255639,2.0
70,55,55,80,60,45,365,0.2222222222222222,65,40,70,80,140,70,465,0.5954198473282443,4.0
53,51,53,61,56,40,314,0.14285714285714285,100,100,90,150,140,90,670,0.71875,0.5
64,66,68,81,76,50,405,0.25190839694656486,76,65,45,92,42,91,411,0.7449664429530202,1.0
100,164,150,95,120,71,700,0.5645161290322581,60,60,50,40,50,75,335,0.5882352941176471,1.0
60,59,85,79,105,36,424,0.16666666666666666,50,100,150,100,150,50,600,0.37142857142857144,1.0
100,73,83,73,83,55,467,0.371900826446281,40,50,45,70,45,70,320,0.5517241379310345,1.0
50,64,50,45,50,41,300,0.22727272727272727,65,60,70,85,75,40,395,0.1796875,1.0
68,90,65,50,55,82,410,0.6165413533834586,60,80,50,50,50,40,330,0.23853211009174313,1.0
70,110,75,145,85,145,630,0.9444444444444444,85,135,130,60,80,25,515,0.40540540540540543,2.0
67,82,62,46,48,43,348,0.22033898305084745,70,83,50,37,50,60,350,0.3360655737704918,1.0
59,59,58,90,70,73,409,0.5826086956521739,70,90,45,15,45,50,315,0.3629032258064516,0.5
70,85,70,60,70,50,405,0.28378378378378377,60,75,85,100,85,115,520,0.8992248062015504,0.5
75,95,125,45,75,95,510,0.8257575757575758,30,45,55,70,55,85,340,0.5633802816901409,1.0
41,50,37,50,37,66,281,0.5175438596491229,103,93,67,71,61,84,479,0.7142857142857143,0.5
40,29,45,29,45,36,224,0.14634146341463414,70,77,60,97,60,108,472,0.8394160583941606,1.0
100,110,90,85,90,60,535,0.47794117647058826,50,120,53,35,110,87,455,0.640625,1.0
65,90,65,61,61,100,442,0.8373983739837398,55,70,45,70,50,60,350,0.45,1.0
20,25,45,70,90,60,310,0.30833333333333335,95,23,48,23,48,23,260,0.046153846153846156,0.5
71,73,88,120,89,59,500,0.43537414965986393,50,105,125,55,95,50,480,0.375886524822695,1.0
58,89,77,45,45,48,362,0.3177570093457944,40,55,70,45,60,30,300,0.10619469026548672,0.25
85,90,80,70,80,130,535,0.9262295081967213,80,85,95,30,30,25,345,0.2857142857142857,0.125
75,65,55,65,55,69,384,0.43548387096774194,65,125,60,95,60,105,510,0.9236641221374046,1.0
60,70,105,70,120,75,500,0.5983606557377049,65,40,50,125,60,30,370,0.07258064516129033,0.5
40,45,35,40,40,90,290,0.65,70,105,105,50,40,20,390,0.33587786259541985,0.5
100,100,100,100,100,100,600,0.8758169934640523,50,50,77,95,77,91,440,0.5916666666666667,0.5
70,84,70,65,70,51,410,0.2949640287769784,80,70,70,90,100,70,480,0.5609756097560976,0.5
45,100,135,65,135,45,525,0.29411764705882354,65,150,60,115,60,115,565,0.935251798561151,0.5
44,58,44,58,44,61,309,0.41964285714285715,60,60,40,65,45,35,305,0.15833333333333333,0.5
45,55,45,65,45,75,330,0.5692307692307692,106,150,70,194,120,140,780,0.952,1.0
58,50,145,95,105,30,483,0.2459016393442623,85,100,122,58,75,54,494,0.3939393939393939,2.0
58,50,145,95,105,30,483,0.2459016393442623,90,120,120,60,60,50,500,0.35294117647058826,1.0
100,77,77,128,128,90,600,0.6901408450704225,85,80,70,135,75,90,535,0.7006802721088435,1.0
50,50,77,95,77,91,440,0.5916666666666667,50,75,45,40,45,60,315,0.4380165289256198,1.0
110,135,60,50,65,88,508,0.7744360902255639,60,55,145,75,150,40,525,0.2,4.0
75,95,67,125,95,83,540,0.7117117117117117,90,50,34,60,44,70,348,0.6283185840707964,1.0
85,56,77,50,77,78,423,0.53125,70,70,115,130,90,60,535,0.5338983050847458,2.0
63,120,85,90,55,55,468,0.2809917355371901,60,95,80,60,80,30,405,0.19480519480519481,0.5
64,88,50,88,50,106,446,0.9111111111111111,91,134,95,100,100,80,600,0.6304347826086957,1.0
70,140,70,110,65,105,560,0.95,106,90,130,90,154,110,680,0.8699186991869918,2.0
80,70,65,80,120,100,515,0.8034188034188035,71,82,64,64,59,112,452,0.9327731092436975,1.0
90,95,95,70,90,70,510,0.5230769230769231,54,63,52,83,56,97,405,0.7697841726618705,0.5
40,70,40,35,40,60,285,0.392,50,45,45,35,35,50,260,0.23529411764705882,2.0
55,104,105,94,75,52,485,0.36363636363636365,70,70,115,130,90,60,535,0.5338983050847458,1.0
68,90,65,50,55,82,410,0.6165413533834586,105,180,100,180,100,115,780,0.9477611940298507,0.0
50,20,40,20,40,20,190,0.0962962962962963,76,65,45,92,42,91,411,0.7449664429530202,1.0
80,185,115,40,105,75,600,0.6230769230769231,80,82,100,83,100,80,525,0.6821705426356589,2.0
90,60,60,40,40,40,330,0.29545454545454547,89,124,80,55,80,55,483,0.5714285714285714,1.0
90,85,100,95,125,85,580,0.6834532374100719,60,60,60,105,105,105,495,0.848,1.0
100,150,140,100,90,90,670,0.7969924812030075,55,40,85,80,105,40,405,0.23622047244094488,0.0
86,92,88,68,75,73,482,0.6835443037974683,28,25,25,45,35,40,198,0.16083916083916083,0.5
95,110,80,70,80,50,485,0.37209302325581395,105,95,75,85,75,74,509,0.5714285714285714,1.0
100,100,90,150,140,90,670,0.71875,65,80,140,40,70,70,465,0.5223880597014925,1.0
45,60,32,50,32,76,295,0.5925925925925926,45,100,135,65,135,45,525,0.29411764705882354,1.0
115,140,130,55,55,40,535,0.4519230769230769,85,110,90,45,90,80,500,0.6206896551724138,1.0
80,100,123,122,120,80,625,0.56,60,80,50,40,40,30,300,0.15328467153284672,2.0
55,70,55,40,55,85,360,0.7073170731707317,43,30,55,40,65,97,330,0.6030534351145038,1.0
78,52,60,63,65,23,341,0.06015037593984962,90,55,75,60,75,30,385,0.13970588235294118,1.0
80,110,120,130,90,70,600,0.6198347107438017,20,15,20,10,55,80,200,0.2682926829268293,0.25
56,61,65,48,45,38,313,0.17567567567567569,40,30,32,50,52,65,269,0.3671875,1.0
80,70,40,100,60,145,495,0.921875,65,90,65,61,61,100,442,0.8373983739837398,0.5
79,85,60,55,60,71,410,0.60431654676259,60,70,65,125,105,90,515,0.6911764705882353,0.5
65,136,94,54,96,135,580,0.9612403100775194,100,75,115,90,115,85,580,0.6446280991735537,1.0
72,60,30,20,30,25,237,0.11570247933884298,48,72,48,72,48,48,336,0.25984251968503935,0.5
120,120,120,120,120,120,720,0.9344262295081968,70,100,70,105,75,40,460,0.23214285714285715,1.0
54,78,103,53,45,22,355,0.23255813953488372,90,60,60,40,40,40,330,0.29545454545454547,1.0
106,190,100,154,100,130,780,0.9259259259259259,80,92,65,65,80,68,450,0.4824561403508772,1.0
50,60,60,60,60,30,320,0.11290322580645161,45,53,70,40,60,42,310,0.25735294117647056,1.0
55,75,60,75,60,103,428,0.7982456140350878,50,20,55,25,25,30,205,0.09774436090225563,2.0
95,124,78,69,71,58,495,0.37398373983739835,88,107,122,74,75,64,530,0.4596774193548387,0.5
50,55,50,36,30,43,264,0.2922077922077922,75,69,72,114,100,104,534,0.8253968253968254,1.0
30,42,118,42,88,30,350,0.112,80,80,80,80,80,80,480,0.5606060606060606,0.5
70,40,50,55,50,25,290,0.061068702290076333,80,70,65,80,120,100,515,0.8034188034188035,0.25
50,65,107,105,107,86,520,0.6991150442477876,90,120,120,60,60,50,500,0.35294117647058826,0.0
30,105,90,25,25,50,325,0.2773722627737226,100,5,5,15,65,30,220,0.07692307692307693,1.0
20,40,90,30,90,25,295,0.11363636363636363,75,95,67,125,95,83,540,0.7117117117117117,1.0
75,75,55,105,85,30,425,0.1619718309859155,123,77,72,99,92,58,521,0.4621212121212121,2.0
59,63,80,65,80,58,405,0.41843971631205673,75,98,63,98,63,101,498,0.889763779527559,2.0
90,85,100,95,125,85,580,0.6834532374100719,100,100,100,100,100,100,600,0.8778625954198473,0.5
70,62,67,55,55,56,365,0.38513513513513514,35,80,50,50,70,120,405,0.84375,0.5
55,69,85,32,35,28,304,0.09302325581395349,40,60,40,40,40,30,250,0.0948905109489051,1.0
60,82,45,45,45,74,351,0.5752212389380531,115,45,20,45,25,20,270,0.11538461538461539,0.5
45,63,37,65,55,95,360,0.8055555555555556,40,45,40,65,40,65,295,0.5661764705882353,0.5
75,98,63,98,63,101,498,0.8091603053435115,65,155,120,65,90,105,600,0.8677685950413223,0.25
40,45,65,100,120,90,460,0.5588235294117647,45,85,70,40,40,60,340,0.5229357798165137,0.0
74,48,76,83,81,104,466,0.7913043478260869,55,66,44,44,56,85,350,0.6888888888888889,1.0
105,95,80,40,80,90,490,0.753968253968254,50,50,77,95,77,91,440,0.5916666666666667,0.0
95,85,85,65,65,35,430,0.2571428571428571,40,80,100,30,30,20,300,0.11851851851851852,8.0
100,150,90,180,160,90,770,0.7348484848484849,30,45,135,45,90,30,375,0.09285714285714286,2.0
70,75,80,135,80,135,575,0.917910447761194,60,50,70,80,80,140,480,0.8449612403100775,0.5
50,180,20,180,20,150,600,0.9029850746268657,30,45,55,70,55,85,340,0.5633802816901409,1.0
70,120,65,45,85,125,510,0.9747899159663865,20,40,15,35,35,60,205,0.34285714285714286,1.0
90,60,70,75,70,45,410,0.23880597014925373,60,85,69,65,79,80,438,0.576,1.0
100,110,90,85,90,60,535,0.47794117647058826,60,80,50,40,40,30,300,0.15328467153284672,1.0
30,45,135,45,90,30,375,0.09285714285714286,55,45,43,55,43,72,313,0.5853658536585366,2.0
95,75,80,100,110,30,490,0.24242424242424243,35,80,50,50,70,120,405,0.84375,4.0
55,104,105,94,75,52,485,0.36363636363636365,90,55,75,60,75,30,385,0.13970588235294118,1.0
60,50,70,50,90,65,385,0.39568345323741005,100,100,80,60,60,50,450,0.3050847457627119,0.5
72,60,30,20,30,25,237,0.11570247933884298,65,70,60,65,65,115,440,0.8583333333333333,2.0
40,65,40,80,40,65,330,0.5038167938931297,84,86,88,111,101,60,530,0.4634146341463415,1.0
70,95,85,55,65,70,440,0.5,67,125,40,30,30,58,350,0.3431372549019608,1.0
95,85,85,65,65,35,430,0.2571428571428571,40,55,30,30,30,60,245,0.43548387096774194,0.0
50,65,107,105,107,86,520,0.703125,60,30,30,36,56,50,262,0.32432432432432434,4.0
95,23,48,23,48,23,260,0.046153846153846156,45,60,45,25,45,55,275,0.29,1.0
35,20,65,40,65,20,245,0.02459016393442623,91,90,72,90,129,108,580,0.896,2.0
65,90,65,61,61,100,442,0.8373983739837398,55,85,122,58,75,99,494,0.8099173553719008,0.0
85,76,64,45,55,90,415,0.6739130434782609,71,120,95,120,95,99,600,0.8203125,0.5
35,40,100,90,55,35,355,0.1796875,40,40,50,30,30,30,220,0.0873015873015873,0.5
90,60,70,75,70,45,410,0.23880597014925373,60,105,60,120,60,105,510,0.8849557522123894,1.0
89,124,80,55,80,55,483,0.5714285714285714,80,85,95,30,30,25,345,0.2857142857142857,2.0
60,55,50,40,55,45,305,0.22377622377622378,65,125,60,95,60,105,510,0.9236641221374046,0.5
68,75,53,83,113,60,452,0.45384615384615384,110,65,75,125,85,30,490,0.15,1.0
100,100,100,100,100,100,600,0.8758169934640523,70,75,60,105,60,105,475,0.88,0.5
58,70,45,40,45,42,300,0.25925925925925924,45,25,50,25,25,35,205,0.13076923076923078,1.0
75,75,55,105,85,30,425,0.1619718309859155,82,121,119,69,59,71,521,0.5394736842105263,1.0
62,73,55,56,52,84,382,0.7244094488188977,40,45,35,30,40,55,245,0.3793103448275862,1.0
85,73,70,73,115,67,483,0.5126050420168067,74,108,133,83,65,32,495,0.32142857142857145,1.0
65,76,84,54,96,105,480,0.9008264462809917,100,90,130,45,65,55,485,0.4253731343283582,0.5
65,110,130,60,65,95,525,0.8278145695364238,40,40,55,40,70,55,300,0.40939597315436244,2.0
100,134,110,95,100,61,600,0.4057971014492754,78,70,61,50,61,100,420,0.8145161290322581,1.0
64,78,52,78,52,81,405,0.6422764227642277,75,95,122,58,75,69,494,0.5725806451612904,0.0
40,55,99,40,79,47,360,0.26262626262626265,100,77,77,128,128,90,600,0.6901408450704225,2.0
110,85,95,80,95,50,515,0.2713178294573643,35,45,160,30,45,70,385,0.48148148148148145,0.5
71,95,85,110,95,79,535,0.664,95,85,85,65,65,35,430,0.2571428571428571,1.0
74,48,76,83,81,104,466,0.7322834645669292,54,78,103,53,45,22,355,0.23255813953488372,1.0
1,90,45,30,30,40,236,0.33064516129032256,70,55,65,95,85,70,440,0.5307692307692308,4.0
100,103,75,120,75,127,600,0.940677966101695,62,77,62,50,42,65,358,0.4838709677419355,0.5
60,90,55,90,80,110,485,0.8677685950413223,111,83,68,92,82,39,475,0.1774193548387097,0.0
60,60,50,40,50,75,335,0.5882352941176471,55,95,55,35,75,115,430,0.9380530973451328,1.0
70,70,40,60,40,60,340,0.4247787610619469,80,80,80,80,80,80,480,0.5606060606060606,2.0
116,55,85,107,95,29,487,0.06818181818181818,64,115,65,83,63,65,455,0.5323741007194245,1.0
70,85,65,105,85,120,530,0.9262295081967213,65,55,115,100,40,60,435,0.3798449612403101,0.5
77,120,90,60,90,48,485,0.2785714285714286,95,135,80,110,80,100,600,0.8248175182481752,2.0
80,90,80,130,110,110,600,0.856,60,100,89,55,69,112,485,0.9298245614035088,2.0
100,5,5,15,65,30,220,0.07692307692307693,55,63,90,50,80,42,380,0.21138211382113822,1.0
70,75,80,135,80,135,575,0.917910447761194,65,95,100,60,50,50,420,0.34959349593495936,0.5
60,85,69,65,79,80,438,0.576,65,155,120,65,90,105,600,0.8677685950413223,1.0
50,80,95,10,45,10,290,0.232,80,70,65,80,120,100,515,0.8034188034188035,1.0
41,56,40,62,44,71,314,0.568,52,65,55,58,62,60,352,0.4482758620689655,1.0
60,70,65,125,105,90,515,0.6911764705882353,95,60,79,100,125,81,540,0.6201550387596899,2.0
70,85,65,105,85,120,530,0.9262295081967213,60,60,60,35,35,30,280,0.11194029850746269,1.0
75,75,60,83,60,60,413,0.39344262295081966,65,125,100,60,70,70,490,0.6099290780141844,1.0
52,65,50,45,50,38,300,0.27419354838709675,65,76,84,54,96,105,480,0.9008264462809917,1.0
54,78,103,53,45,22,355,0.23255813953488372,45,50,55,75,65,30,320,0.06293706293706294,0.5
40,40,50,30,30,30,220,0.0873015873015873,43,80,65,50,35,35,308,0.14193548387096774,2.0
50,65,85,35,35,55,325,0.32575757575757575,90,75,75,90,100,70,500,0.5462184873949579,1.0
150,160,100,95,65,100,670,0.8866666666666667,100,128,90,77,77,128,600,0.959349593495935,1.0
35,60,44,40,54,55,288,0.366412213740458,65,95,100,60,50,50,420,0.34959349593495936,1.0
92,105,90,125,90,98,600,0.8217054263565892,100,100,90,150,140,90,670,0.71875,1.0
35,80,50,50,70,120,405,0.84375,85,90,80,70,80,130,535,0.9262295081967213,0.0
62,48,66,59,57,49,341,0.33884297520661155,65,125,60,95,60,105,510,0.9236641221374046,2.0
30,45,59,30,39,57,260,0.2803030303030303,67,57,55,77,55,114,425,0.8879310344827587,1.0
60,85,69,60,69,77,420,0.518796992481203,55,70,55,40,55,85,360,0.7073170731707317,1.0
70,50,30,95,135,105,485,0.8040540540540541,65,83,57,95,85,105,490,0.8914728682170543,1.0
70,100,70,105,75,40,460,0.23214285714285715,41,64,45,50,50,50,300,0.36752136752136755,0.5
55,47,52,40,40,41,275,0.16806722689075632,80,82,78,95,80,85,500,0.6869565217391305,1.0
74,48,76,83,81,104,466,0.7322834645669292,61,84,65,70,70,70,420,0.5,1.0
77,120,90,60,90,48,485,0.2785714285714286,95,75,180,130,80,30,590,0.13793103448275862,1.0
65,155,120,65,90,105,600,0.8677685950413223,79,115,70,125,80,111,580,0.8468468468468469,0.5
70,115,60,115,60,55,475,0.4647887323943662,60,80,110,50,80,45,425,0.2833333333333333,2.0
70,130,100,55,80,65,500,0.608,105,30,105,140,105,55,540,0.3524590163934426,0.5
90,55,75,60,75,30,385,0.13970588235294118,90,100,90,125,85,90,580,0.7352941176470589,1.0
50,50,62,40,62,65,329,0.4188034188034188,55,130,115,50,50,75,475,0.5982142857142857,1.0
45,45,35,20,30,20,195,0.07246376811594203,106,90,130,90,154,110,680,0.8699186991869918,1.0
95,155,109,70,130,81,640,0.6788321167883211,84,86,88,111,101,60,530,0.4634146341463415,0.5
75,125,100,70,80,45,495,0.33035714285714285,40,55,80,35,60,30,300,0.15037593984962405,0.5
45,40,60,40,75,50,310,0.2926829268292683,103,60,126,80,126,50,545,0.36363636363636365,1.0
65,45,55,45,70,45,325,0.24369747899159663,74,94,131,54,116,20,489,0.4485294117647059,0.5
76,48,48,57,62,34,325,0.11688311688311688,53,51,53,61,56,40,314,0.14285714285714285,0.5
97,165,60,65,50,58,495,0.3902439024390244,95,110,95,40,95,55,490,0.40336134453781514,1.0
95,124,78,69,71,58,495,0.37398373983739835,85,80,70,135,75,90,535,0.7006802721088435,2.0
60,85,42,85,42,91,405,0.8227848101265823,60,50,50,60,70,50,340,0.28346456692913385,2.0
90,60,60,40,40,40,330,0.29545454545454547,68,125,65,65,115,80,518,0.6277372262773723,1.0
100,134,110,95,100,61,600,0.4057971014492754,90,100,70,110,150,80,600,0.6037735849056604,1.0
59,45,40,35,40,31,250,0.14285714285714285,55,45,45,25,25,15,210,0.048,1.0
38,35,40,27,25,35,200,0.08208955223880597,53,51,53,61,56,40,314,0.14285714285714285,1.0
70,75,80,135,80,135,575,0.917910447761194,55,69,85,32,35,28,304,0.09302325581395349,1.0
110,135,60,50,65,88,508,0.7744360902255639,52,65,55,58,62,60,352,0.4482758620689655,0.0
65,75,70,95,70,95,470,0.7272727272727273,40,55,70,45,60,30,300,0.10619469026548672,0.25
80,80,80,80,80,80,480,0.5606060606060606,49,55,42,42,37,85,310,0.6068376068376068,1.0
79,85,60,55,60,71,410,0.60431654676259,80,105,65,60,75,130,515,0.9645390070921985,1.0
40,50,90,30,55,65,330,0.44680851063829785,100,123,75,57,75,80,510,0.6923076923076923,0.5
57,80,91,80,87,75,470,0.5737704918032787,60,62,63,80,80,60,405,0.38016528925619836,0.5
40,70,130,60,130,25,455,0.17355371900826447,70,95,85,55,65,70,440,0.5,2.0
65,75,90,97,123,44,494,0.1987179487179487,50,160,110,160,110,110,700,0.8854961832061069,0.0
91,90,72,90,129,108,580,0.896,90,70,80,70,95,70,475,0.5190839694656488,4.0
70,60,125,115,70,55,495,0.35507246376811596,65,50,35,115,95,95,455,0.7333333333333333,2.0
50,50,150,50,150,50,500,0.2571428571428571,70,55,95,95,110,65,490,0.48872180451127817,1.0
65,75,90,97,123,44,494,0.1987179487179487,65,65,60,130,95,110,525,0.823943661971831,1.0
60,70,105,70,120,75,500,0.5983606557377049,40,50,90,30,55,65,330,0.44680851063829785,2.0
64,66,68,81,76,50,405,0.25190839694656486,50,85,125,85,115,20,480,0.4306569343065693,1.0
70,55,95,95,110,65,490,0.48872180451127817,49,49,56,49,61,66,330,0.5190839694656488,1.0
70,55,95,95,110,65,490,0.48872180451127817,83,106,65,86,65,85,490,0.6640625,2.0
80,82,100,83,100,80,525,0.6821705426356589,38,30,85,55,65,30,303,0.21428571428571427,1.0
50,95,95,35,110,70,455,0.5179856115107914,55,85,55,50,55,60,360,0.4233576642335766,0.5
55,63,90,50,80,42,380,0.21138211382113822,95,65,65,110,130,60,525,0.4016393442622951,0.5
55,45,50,45,65,80,340,0.5546218487394958,45,60,32,50,32,76,295,0.5925925925925926,0.5
50,80,95,10,45,10,290,0.232,73,100,60,100,60,65,458,0.42657342657342656,1.0
95,80,105,40,70,100,490,0.8046875,75,110,110,110,105,80,590,0.656934306569343,1.0
65,80,80,59,63,58,405,0.4411764705882353,120,100,85,30,85,45,465,0.22448979591836735,1.0
65,80,80,59,63,58,405,0.4411764705882353,62,77,62,50,42,65,358,0.4838709677419355,1.0
60,75,100,55,80,50,420,0.3088235294117647,90,93,55,70,55,55,418,0.3819444444444444,0.5
55,66,44,44,56,85,350,0.6888888888888889,65,125,100,60,70,70,490,0.6099290780141844,0.5
65,105,60,60,70,95,455,63.0,85,60,65,135,105,100,550,0.7518248175182481,0.5
60,30,30,36,56,50,262,0.32432432432432434,45,75,37,70,55,83,365,0.6183206106870229,1.0
95,65,110,60,130,65,525,0.5275590551181102,70,115,60,115,60,55,475,0.4647887323943662,0.5
75,110,110,110,105,80,590,0.656934306569343,91,72,90,129,90,108,580,0.8620689655172413,2.0
55,75,60,75,60,103,428,0.7982456140350878,60,85,40,30,45,68,328,0.6422018348623854,0.0
70,55,65,95,85,70,440,0.5307692307692308,40,27,60,37,50,66,280,0.36220472440944884,1.0
44,38,39,61,79,42,303,0.2251655629139073,60,50,40,85,75,95,405,0.7540983606557377,1.0
75,95,67,125,95,83,540,0.7117117117117117,90,132,105,132,105,30,594,0.4246575342465753,4.0
58,64,58,80,65,80,405,0.5423728813559322,57,80,91,80,87,75,470,0.5737704918032787,2.0
95,124,78,69,71,58,495,0.37398373983739835,62,73,55,56,52,84,382,0.7244094488188977,0.5
66,41,77,61,87,23,355,0.12096774193548387,50,65,107,105,107,86,520,0.7313432835820896,0.5
100,103,75,120,75,127,600,0.940677966101695,75,80,95,90,100,50,490,0.2158273381294964,1.0
80,130,100,160,120,110,700,0.8981481481481481,50,72,35,35,35,65,292,0.5373134328358209,0.0
50,70,50,50,50,70,340,0.5645161290322581,46,57,40,40,40,50,273,0.25,2.0
44,38,39,61,79,42,303,0.2251655629139073,43,30,55,40,65,97,330,0.6030534351145038,1.0
71,73,88,120,89,59,500,0.43537414965986393,45,30,35,20,20,45,195,0.14782608695652175,1.0
80,70,65,80,120,100,515,0.8034188034188035,77,59,50,67,63,46,362,0.23140495867768596,1.0
74,108,133,83,65,32,495,0.32142857142857145,80,160,60,170,130,80,680,0.6180555555555556,1.0
50,48,43,46,41,60,288,0.47297297297297297,100,100,125,110,50,50,535,0.384,0.25
50,60,60,60,60,30,320,0.11290322580645161,80,70,65,80,120,100,515,0.8034188034188035,0.25
70,120,100,145,105,20,560,0.2824427480916031,85,105,85,40,50,40,405,0.211864406779661,1.0
50,50,120,80,80,30,410,0.07258064516129033,70,80,65,90,65,85,455,0.578125,1.0
50,105,79,35,110,76,455,0.6214285714285714,30,45,59,30,39,57,260,0.2803030303030303,0.25
60,60,40,65,45,35,305,0.15833333333333333,95,75,80,100,110,30,490,0.24242424242424243,0.5
60,50,150,50,150,60,520,0.5206611570247934,100,100,80,60,60,50,450,0.3050847457627119,2.0
38,35,35,65,55,50,278,0.2647058823529412,39,52,43,60,50,65,309,0.5041322314049587,0.5
50,50,40,50,40,64,294,0.45588235294117646,73,76,75,81,100,100,505,0.8110236220472441,2.0
108,170,115,120,95,92,700,0.7083333333333334,82,121,119,69,59,71,521,0.5394736842105263,4.0
58,70,45,40,45,42,300,0.25925925925925924,150,160,100,95,65,100,670,0.8866666666666667,1.0
59,63,80,65,80,58,405,0.41843971631205673,95,65,65,110,130,60,525,0.4016393442622951,1.0
38,41,40,50,65,65,299,0.4108527131782946,65,95,100,60,50,50,420,0.34959349593495936,0.5
95,75,80,100,110,30,490,0.24242424242424243,64,88,50,88,50,106,446,0.9111111111111111,0.0
90,70,80,70,95,70,475,0.5190839694656488,65,130,60,95,110,65,525,0.5303030303030303,1.0
80,80,50,40,50,25,325,0.176056338028169,110,160,110,80,110,100,670,0.8591549295774648,1.0
250,5,5,35,105,50,450,0.15306122448979592,45,49,65,49,65,45,318,0.275,1.0
80,95,82,60,82,75,474,0.6,67,58,57,81,67,101,431,0.8790322580645161,2.0
50,40,85,40,65,25,305,0.08870967741935484,50,48,43,46,41,60,288,0.47297297297297297,1.0
41,50,37,50,37,66,281,0.5175438596491229,45,35,50,70,50,30,280,0.15753424657534246,1.0
61,90,45,50,50,160,456,0.9230769230769231,40,60,40,40,40,30,250,0.0948905109489051,1.0
38,41,40,50,65,65,299,0.4108527131782946,90,65,65,40,40,15,315,0.19672131147540983,0.5
95,110,80,70,80,50,485,0.37209302325581395,55,65,95,95,45,85,440,0.6610169491525424,0.5
80,135,130,95,90,70,600,0.5181818181818182,45,20,50,60,120,50,345,0.24074074074074073,0.5
95,60,79,100,125,81,540,0.6201550387596899,95,124,78,69,71,58,495,0.37398373983739835,1.0
65,90,115,45,115,58,488,0.5041322314049587,60,50,100,85,70,65,430,0.47580645161290325,0.5
68,85,65,165,135,100,618,0.8083333333333333,99,68,83,72,87,51,460,0.417910447761194,1.0
55,130,115,50,50,75,475,0.5982142857142857,45,90,20,65,20,65,305,0.5116279069767442,0.5
45,95,50,40,50,75,355,0.54,100,100,100,100,100,100,600,0.8778625954198473,2.0
60,62,80,63,80,60,405,0.4336283185840708,58,64,58,80,65,80,405,0.609271523178808,0.5
50,95,95,35,110,70,455,0.5179856115107914,31,45,90,30,30,40,266,0.21929824561403508,0.5
70,150,140,65,100,75,600,0.55,45,50,55,75,65,30,320,0.06293706293706294,1.0
60,50,70,50,90,65,385,0.39568345323741005,45,50,55,75,65,30,320,0.06293706293706294,1.0
64,165,75,93,83,75,555,0.6587301587301587,74,94,131,54,116,20,489,0.4485294117647059,1.0
30,35,30,100,35,80,310,0.4765625,59,45,40,35,40,31,250,0.14285714285714285,0.0
50,70,160,70,160,90,600,0.7417218543046358,40,35,30,120,70,105,400,0.6692307692307692,0.5
65,80,65,35,65,60,370,0.38405797101449274,65,75,70,95,70,95,470,0.7272727272727273,1.0
55,40,50,65,85,40,335,0.3181818181818182,60,30,30,36,56,50,262,0.32432432432432434,0.0
50,95,95,35,110,70,455,0.5179856115107914,65,125,60,95,60,105,510,0.9236641221374046,1.0
80,145,150,105,110,110,700,0.8692307692307693,90,85,100,95,125,85,580,0.6834532374100719,2.0
100,134,110,95,100,61,600,0.4057971014492754,65,136,94,54,96,135,580,0.9612403100775194,0.25
80,120,80,120,80,100,580,0.8478260869565217,25,35,70,95,55,45,325,0.16783216783216784,0.5
20,10,55,15,20,80,200,0.17985611510791366,40,60,30,31,31,70,262,0.4492753623188406,1.0
44,48,65,50,64,43,314,0.1623931623931624,42,52,67,39,56,50,306,0.2868217054263566,1.0
65,125,100,55,70,85,500,0.6532258064516129,75,55,70,55,95,110,460,0.8444444444444444,1.0
125,58,58,76,76,67,460,0.515625,100,103,75,120,75,127,600,0.940677966101695,0.5
40,35,30,120,70,105,400,0.6692307692307692,80,50,100,100,200,50,580,0.2357142857142857,1.0
70,95,85,55,65,70,440,0.5,80,90,80,130,110,110,600,0.856,0.5
40,35,30,20,20,50,195,0.23423423423423423,75,98,63,98,63,101,498,0.8091603053435115,4.0
60,50,40,85,75,95,405,0.7540983606557377,90,60,70,75,70,45,410,0.23880597014925373,2.0
75,75,55,105,85,30,425,0.1619718309859155,65,60,110,130,95,65,525,0.47761194029850745,1.0
55,40,40,65,45,35,280,0.16428571428571428,90,55,75,60,75,30,385,0.13970588235294118,1.0
90,75,85,115,90,55,510,0.3445378151260504,65,45,55,45,70,45,325,0.24369747899159663,2.0
71,95,85,110,95,79,535,0.664,80,82,78,95,80,85,500,0.6869565217391305,0.5
65,50,35,115,95,95,455,0.7333333333333333,75,95,60,65,60,115,470,0.8778625954198473,1.0
35,35,35,35,35,35,210,0.13385826771653545,60,65,80,170,95,130,600,0.8625954198473282,0.0
60,60,60,105,105,105,495,0.848,100,150,120,120,100,90,680,0.6493506493506493,1.0
60,62,80,63,80,60,405,0.4336283185840708,92,105,90,125,90,98,600,0.8217054263565892,0.5
65,90,40,45,80,75,395,0.625,75,103,80,70,80,92,500,0.7933884297520661,4.0
35,55,40,45,40,60,275,0.35714285714285715,50,150,50,150,50,150,600,0.9339622641509434,1.0
45,60,32,50,32,76,295,0.5925925925925926,82,80,86,85,75,72,480,0.6183206106870229,1.0
71,73,88,120,89,59,500,0.43537414965986393,65,90,120,85,70,60,490,0.43410852713178294,1.0
95,70,73,95,90,60,483,0.3983739837398374,63,63,47,41,41,74,329,0.56,1.0
41,64,45,50,50,50,300,0.36752136752136755,70,85,65,105,85,120,530,0.9262295081967213,1.0
60,110,70,60,60,100,460,0.8461538461538461,74,108,133,83,65,32,495,0.32142857142857145,0.25
85,105,55,85,50,115,495,0.9032258064516129,100,90,130,45,65,55,485,0.4253731343283582,1.0
85,50,95,120,115,80,545,0.5793650793650794,50,85,125,85,115,20,480,0.4306569343065693,2.0
100,75,115,90,115,85,580,0.6446280991735537,43,70,48,50,60,38,309,0.2391304347826087,0.5
66,117,70,40,50,67,410,0.4573643410852713,60,82,45,45,45,74,351,0.5752212389380531,1.0
45,35,45,62,53,35,275,0.11851851851851852,80,125,75,40,95,85,500,0.6911764705882353,0.5
95,23,48,23,48,23,260,0.046153846153846156,65,50,70,95,80,65,425,0.4262295081967213,0.5
30,65,100,45,25,40,305,0.1891891891891892,80,115,80,65,55,93,488,0.7846153846153846,1.0
10,55,25,35,45,95,265,0.5396825396825397,50,53,48,53,48,64,316,0.358974358974359,1.0
75,100,66,60,66,115,482,0.918918918918919,75,125,70,125,70,115,580,0.9037037037037037,1.0
109,66,84,81,99,32,471,0.2013888888888889,88,107,122,74,75,64,530,0.4596774193548387,0.25
60,70,65,125,105,90,515,0.6911764705882353,50,60,45,100,80,65,400,0.45689655172413796,0.25
90,100,60,90,60,80,480,0.6422764227642277,75,95,60,65,60,115,470,0.8778625954198473,1.0
35,55,40,50,50,90,320,0.6838235294117647,50,60,60,60,60,30,320,0.11290322580645161,2.0
100,100,100,100,100,100,600,0.8778625954198473,78,81,71,74,69,126,499,0.9090909090909091,0.5
110,160,110,80,110,100,670,0.8591549295774648,80,125,75,40,95,85,500,0.6911764705882353,1.0
70,50,30,95,135,105,485,0.8040540540540541,95,65,110,60,130,65,525,0.5275590551181102,1.0
35,55,40,45,40,60,275,0.35714285714285715,50,75,75,65,65,50,380,0.4049586776859504,1.0
45,55,39,35,39,42,255,0.18518518518518517,75,38,38,56,56,67,330,0.5263157894736842,1.0
20,15,20,10,55,80,200,0.2682926829268293,75,75,55,105,85,30,425,0.1619718309859155,0.5
85,135,130,60,80,25,515,0.40540540540540543,50,85,40,85,40,35,335,0.1746031746031746,1.0
70,120,65,45,85,125,510,0.9747899159663865,60,105,60,120,60,105,510,0.8849557522123894,0.5
80,110,120,130,90,70,600,0.6198347107438017,52,65,55,58,62,60,352,0.4482758620689655,1.0
85,100,122,58,75,54,494,0.3939393939393939,70,90,70,60,60,70,420,0.6390977443609023,0.5
100,50,80,60,80,50,420,0.34375,44,58,44,58,44,61,309,0.41964285714285715,1.0
65,47,55,73,75,85,400,0.65,64,165,75,93,83,75,555,0.6587301587301587,0.5
65,40,70,80,140,70,465,0.5954198473282443,108,130,95,80,85,102,600,0.7637795275590551,1.0
50,65,107,105,107,86,520,0.7313432835820896,67,82,62,46,48,43,348,0.22033898305084745,1.0
50,72,35,35,35,65,292,0.5373134328358209,106,150,70,194,120,140,780,0.952,2.0
40,30,35,45,40,55,245,0.31496062992125984,59,59,58,90,70,73,409,0.5826086956521739,1.0
80,115,80,65,55,93,488,0.7846153846153846,80,70,65,80,120,100,515,0.8034188034188035,1.0
40,50,90,30,55,65,330,0.44680851063829785,75,98,63,98,63,101,498,0.889763779527559,0.5
40,20,30,40,80,55,265,0.22764227642276422,50,92,108,92,108,35,485,0.2457627118644068,1.0
68,90,65,50,55,82,410,0.6165413533834586,74,48,76,83,81,104,466,0.7913043478260869,1.0
105,125,100,60,100,100,590,0.8359375,75,65,55,65,55,69,384,0.43548387096774194,1.0
59,63,80,65,80,58,405,0.41843971631205673,61,90,45,50,50,160,456,0.9230769230769231,1.0
60,25,35,70,80,60,330,0.3076923076923077,45,49,49,65,65,45,318,0.2781954887218045,2.0
100,128,90,77,77,128,600,0.959349593495935,125,120,90,170,100,95,700,0.78125,2.0
70,75,80,135,80,135,575,0.917910447761194,65,63,45,45,45,45,308,0.2595419847328244,1.0
30,42,118,42,88,30,350,0.112,78,52,60,63,65,23,341,0.06015037593984962,0.5
78,92,75,74,63,118,500,0.8842975206611571,40,30,50,55,55,100,330,0.584070796460177,0.5
40,55,30,30,30,60,245,0.43548387096774194,45,60,45,25,45,55,275,0.29,1.0
70,55,75,45,65,60,370,0.45901639344262296,76,104,71,104,71,108,534,0.912751677852349,1.0
125,170,100,120,90,95,700,0.77,50,95,90,95,90,180,600,0.9172413793103448,1.0
38,36,38,32,36,57,237,0.3893805309734513,43,30,55,40,65,97,330,0.6030534351145038,1.0
50,50,120,80,80,30,410,0.07258064516129033,95,135,80,110,80,100,600,0.8248175182481752,1.0
62,50,58,73,54,72,369,0.4435483870967742,50,160,110,160,110,110,700,0.8854961832061069,0.25
61,78,95,56,58,57,405,0.40336134453781514,70,115,60,115,60,55,475,0.4647887323943662,0.5
20,10,55,15,20,80,200,0.17985611510791366,65,130,60,95,110,65,525,0.5303030303030303,2.0
89,145,90,105,80,91,600,0.8549618320610687,75,89,85,55,65,36,405,0.29545454545454547,1.0
41,64,45,50,50,50,300,0.36752136752136755,90,55,75,60,75,30,385,0.13970588235294118,1.0
70,145,88,140,70,112,625,0.8888888888888888,84,86,88,111,101,60,530,0.4634146341463415,0.5
80,120,80,120,80,100,580,0.8478260869565217,115,140,130,55,55,40,535,0.4519230769230769,2.0
70,20,50,20,50,40,250,0.1557377049180328,80,120,80,120,80,100,580,0.8478260869565217,1.0
70,70,115,130,90,60,535,0.5338983050847458,70,55,95,95,110,65,490,0.48872180451127817,1.0
66,41,77,61,87,23,355,0.12096774193548387,61,84,65,70,70,70,420,0.5,0.5
38,41,40,50,65,65,299,0.4108527131782946,80,80,50,40,50,25,325,0.176056338028169,1.0
45,60,32,50,32,76,295,0.5925925925925926,64,51,23,51,23,28,240,0.11363636363636363,1.0
114,85,70,85,80,30,464,0.2066115702479339,88,107,122,74,75,64,530,0.4596774193548387,1.0
40,40,50,30,30,30,220,0.0873015873015873,70,140,230,60,80,50,630,0.32432432432432434,0.5
60,90,70,60,120,40,440,0.27419354838709675,58,70,45,40,45,42,300,0.25925925925925924,1.0
60,50,70,50,90,65,385,0.39568345323741005,67,58,57,81,67,101,431,0.8790322580645161,1.0
59,66,70,44,55,41,335,0.25190839694656486,105,30,105,140,105,55,540,0.3524590163934426,1.0
55,40,50,65,85,40,335,0.3181818181818182,50,65,90,35,35,15,290,0.14678899082568808,1.0
28,25,25,45,35,40,198,0.16083916083916083,86,76,86,116,56,95,515,0.7982456140350878,1.0
90,75,85,115,90,55,510,0.3445378151260504,45,100,45,45,45,10,290,0.2949640287769784,0.0
79,105,70,145,80,101,580,0.8608695652173913,125,120,90,170,100,95,700,0.78125,0.5
35,64,85,74,55,32,345,0.19827586206896552,68,90,65,50,55,82,410,0.6165413533834586,1.0
38,36,38,32,36,57,237,0.3893805309734513,55,40,40,65,45,35,280,0.16428571428571428,1.0
40,30,32,50,52,65,269,0.3671875,104,91,63,91,73,68,490,0.5118110236220472,1.0
60,100,89,55,69,112,485,0.9298245614035088,70,55,95,95,110,65,490,0.48872180451127817,2.0
69,69,76,69,86,91,460,0.6554621848739496,190,33,58,33,58,33,405,0.13432835820895522,1.0
55,40,85,80,105,40,405,0.23622047244094488,42,52,67,39,56,50,306,0.2868217054263566,0.5
55,75,85,25,25,15,280,0.1875,80,120,70,110,70,80,530,0.6422764227642277,1.0
44,48,65,50,64,43,314,0.1623931623931624,75,55,70,55,95,110,460,0.8444444444444444,0.5
75,90,90,140,90,115,600,0.9481481481481482,70,100,70,105,75,40,460,0.23214285714285715,0.5
95,65,110,60,130,65,525,0.5275590551181102,80,92,65,65,80,68,450,0.4824561403508772,1.0
50,70,50,50,50,40,310,0.16296296296296298,62,73,55,56,52,84,382,0.7244094488188977,2.0
100,73,83,73,83,55,467,0.371900826446281,70,70,40,60,40,60,340,0.4247787610619469,2.0
45,45,55,45,55,63,308,0.4594594594594595,71,120,95,120,95,99,600,0.8203125,0.25
60,100,115,70,85,90,520,0.7557251908396947,75,75,75,125,95,40,485,0.15671641791044777,1.0
60,60,60,85,85,85,435,0.631578947368421,50,75,75,65,65,50,380,0.4049586776859504,1.0
60,60,40,65,45,35,305,0.15833333333333333,90,55,75,60,75,30,385,0.13970588235294118,1.0
95,125,79,60,100,81,540,0.6165413533834586,75,95,60,65,60,115,470,0.8778625954198473,1.0
60,82,45,45,45,74,351,0.5752212389380531,71,120,95,120,95,99,600,0.8203125,1.0
39,52,43,60,50,65,309,0.49107142857142855,45,50,55,75,65,30,320,0.06293706293706294,2.0
105,30,105,140,105,55,540,0.3524590163934426,60,100,85,80,85,100,510,0.7007874015748031,0.5
90,75,85,115,90,55,510,0.3445378151260504,75,100,110,45,55,65,450,0.5333333333333333,0.0
50,120,53,35,110,87,455,0.640625,75,69,72,114,100,104,534,0.8253968253968254,0.5
58,64,58,80,65,80,405,0.5423728813559322,55,112,45,74,45,70,401,0.559322033898305,0.5
45,50,43,40,38,62,278,0.40441176470588236,55,55,55,85,55,30,335,0.1320754716981132,1.0
20,40,15,35,35,60,205,0.34285714285714286,35,85,45,35,35,75,310,0.6492537313432836,2.0
10,55,25,35,45,95,265,0.5396825396825397,80,80,80,80,80,80,480,0.6015037593984962,1.0
92,105,90,125,90,98,600,0.8217054263565892,40,30,35,50,70,55,280,0.28205128205128205,1.0
75,103,80,70,80,92,500,0.7933884297520661,60,85,40,30,45,68,328,0.6422018348623854,2.0
45,50,43,40,38,62,278,0.40441176470588236,65,47,55,73,75,85,400,0.65,2.0
45,90,20,65,20,65,305,0.5116279069767442,55,45,50,45,65,80,340,0.5546218487394958,0.5
45,25,50,25,25,35,205,0.13076923076923078,65,60,70,85,75,40,395,0.1796875,1.0
70,55,55,80,60,45,365,0.2222222222222222,100,100,100,100,100,100,600,0.8602941176470589,0.5
60,80,50,50,50,40,330,0.23853211009174313,55,69,85,32,35,28,304,0.09302325581395349,1.0
108,170,115,120,95,92,700,0.7083333333333334,80,105,65,60,75,130,515,0.9645390070921985,0.0
45,55,39,35,39,42,255,0.18518518518518517,59,74,50,35,50,35,303,0.3125,0.0
40,30,35,45,40,55,245,0.31496062992125984,91,72,90,129,90,108,580,0.8620689655172413,2.0
100,100,100,100,100,100,600,0.8345864661654135,70,120,100,145,105,20,560,0.2824427480916031,2.0
70,150,140,65,100,75,600,0.55,70,55,65,95,85,70,440,0.5307692307692308,4.0
65,90,65,61,61,100,442,0.8373983739837398,65,130,60,95,110,65,525,0.5303030303030303,1.0
95,23,48,23,48,23,260,0.046153846153846156,38,41,40,50,65,65,299,0.4108527131782946,1.0
50,53,48,53,48,64,316,0.46153846153846156,60,40,60,40,60,35,295,0.18055555555555555,2.0
130,85,80,85,95,60,535,0.43884892086330934,68,165,95,65,115,110,618,0.8615384615384616,1.0
60,90,140,50,50,40,430,0.2535211267605634,30,45,55,70,55,85,340,0.5633802816901409,0.5
65,90,65,61,61,100,442,0.8373983739837398,66,41,77,61,87,23,355,0.12096774193548387,0.5
58,89,77,45,45,48,362,0.3177570093457944,75,98,63,98,63,101,498,0.889763779527559,2.0
88,107,122,74,75,64,530,0.4596774193548387,95,95,85,125,65,55,520,0.3894736842105263,0.25
65,55,115,100,40,60,435,0.3798449612403101,60,60,75,60,75,80,410,0.7321428571428571,1.0
60,85,60,50,50,125,430,0.9090909090909091,39,52,43,60,50,65,309,0.49107142857142855,1.0
95,75,180,130,80,30,590,0.13793103448275862,45,75,37,70,55,83,365,0.6183206106870229,2.0
150,120,100,120,100,90,680,0.664179104477612,68,72,78,38,42,32,330,0.23809523809523808,1.0
105,130,120,45,45,40,485,0.4444444444444444,55,85,55,50,55,60,360,0.4233576642335766,4.0
58,109,112,48,48,109,484,0.8805970149253731,100,50,50,76,96,70,442,0.5,0.5
65,130,60,95,110,65,525,0.5303030303030303,95,70,73,95,90,60,483,0.3983739837398374,1.0
40,50,45,70,45,70,320,0.5517241379310345,120,70,120,75,130,85,600,0.6694915254237288,0.5
75,55,70,55,95,110,460,0.8444444444444444,190,33,58,33,58,33,405,0.13432835820895522,1.0
41,50,37,50,37,66,281,0.5175438596491229,65,80,65,35,65,60,370,0.38405797101449274,1.0
85,97,66,105,66,65,484,0.47107438016528924,65,47,55,73,75,85,400,0.65,2.0
120,100,85,30,85,45,465,0.22448979591836735,76,104,71,104,71,108,534,0.912751677852349,1.0
50,160,110,160,110,110,700,0.8854961832061069,90,120,75,60,60,45,450,0.29411764705882354,1.0
110,85,95,80,95,50,515,0.2713178294573643,150,120,100,120,100,90,680,0.664179104477612,0.0
73,76,75,81,100,100,505,0.8110236220472441,78,70,61,50,61,100,420,0.8145161290322581,1.0
70,100,115,30,65,30,410,0.24390243902439024,60,115,105,65,70,80,495,0.7181818181818181,1.0
90,30,15,40,20,15,210,0.043478260869565216,45,45,35,20,30,20,195,0.07246376811594203,1.0
40,55,80,35,60,30,300,0.15037593984962405,95,117,184,44,46,28,514,0.2975206611570248,2.0
35,46,34,35,45,20,215,0.072,40,40,55,40,70,55,300,0.40939597315436244,1.0
60,85,42,85,42,91,405,0.8227848101265823,105,95,80,40,80,90,490,0.753968253968254,1.0
105,125,100,60,100,100,590,0.8359375,80,75,150,75,150,50,580,0.30973451327433627,0.5
66,117,70,40,50,67,410,0.4573643410852713,60,45,70,75,85,55,390,0.3008130081300813,1.0
82,80,86,85,75,72,480,0.6183206106870229,86,92,88,68,75,73,482,0.6835443037974683,2.0
110,78,73,76,71,60,468,0.3333333333333333,50,105,79,35,110,76,455,0.6214285714285714,1.0
65,65,65,50,50,90,385,0.72,100,100,100,100,100,100,600,0.8345864661654135,0.5
95,109,105,75,85,56,525,0.34513274336283184,106,150,70,194,120,140,780,0.952,1.0
65,45,55,45,70,45,325,0.24369747899159663,75,87,63,87,63,98,473,0.865546218487395,0.5
100,100,100,100,100,100,600,0.8345864661654135,55,40,50,65,85,40,335,0.3181818181818182,2.0
85,97,66,105,66,65,484,0.47107438016528924,80,82,83,100,100,80,525,0.6742424242424242,2.0
70,85,70,60,70,50,405,0.28378378378378377,75,123,67,95,85,95,540,0.7642276422764228,2.0
88,107,122,74,75,64,530,0.4596774193548387,45,53,70,40,60,42,310,0.25735294117647056,0.125
75,87,63,87,63,98,473,0.865546218487395,50,65,90,35,35,15,290,0.14678899082568808,2.0
35,65,35,65,35,65,300,0.46621621621621623,55,75,85,25,25,15,280,0.1875,2.0
95,100,85,108,70,70,528,0.5652173913043478,60,67,85,77,75,116,480,0.8888888888888888,0.5
90,50,34,60,44,70,348,0.6283185840707964,60,100,89,55,69,112,485,0.9298245614035088,2.0
75,95,125,45,75,95,510,0.8257575757575758,50,53,48,53,48,64,316,0.4076923076923077,1.0
65,75,105,35,65,85,430,0.6940298507462687,60,95,80,60,80,30,405,0.19480519480519481,1.0
65,130,60,95,110,65,525,0.5303030303030303,30,105,90,25,25,50,325,0.2773722627737226,0.5
95,135,80,110,80,100,600,0.8248175182481752,62,77,62,50,42,65,358,0.4838709677419355,1.0
50,70,50,50,50,70,340,0.5645161290322581,50,35,55,25,25,15,205,0.05263157894736842,0.5
80,80,50,40,50,25,325,0.176056338028169,80,85,95,30,30,25,345,0.2857142857142857,0.25
80,80,80,80,80,80,480,0.6015037593984962,95,70,73,95,90,60,483,0.3983739837398374,1.0
60,85,60,85,60,55,405,0.3673469387755102,85,73,70,73,115,67,483,0.5126050420168067,0.5
115,140,130,55,55,40,535,0.4519230769230769,53,51,53,61,56,40,314,0.14285714285714285,1.0
80,100,123,122,120,80,625,0.56,65,125,60,95,60,105,510,0.9236641221374046,1.0
50,64,50,45,50,41,300,0.22727272727272727,60,85,60,50,50,125,430,0.9090909090909091,0.0
58,64,58,80,65,80,405,0.5423728813559322,73,95,62,85,65,85,465,0.6666666666666666,1.0
65,150,40,15,80,145,495,0.9663865546218487,62,44,50,44,50,55,305,0.3629032258064516,0.5
80,82,83,100,100,80,525,0.6742424242424242,75,123,67,95,85,95,540,0.7642276422764228,1.0
130,65,60,110,95,65,525,0.5227272727272727,65,50,35,115,95,95,455,0.7333333333333333,1.0
65,90,40,45,80,75,395,0.625,100,5,5,15,65,30,220,0.07692307692307693,1.0
105,130,120,45,45,40,485,0.4444444444444444,65,47,55,73,75,85,400,0.65,1.0
83,80,75,70,70,101,479,0.8615384615384616,75,80,70,65,75,90,455,0.7578125,1.0
90,70,80,70,95,70,475,0.5190839694656488,68,85,65,165,135,100,618,0.8083333333333333,1.0
50,70,160,70,160,90,600,0.7417218543046358,101,72,72,99,89,29,462,0.1937984496124031,1.0
90,100,60,90,60,80,480,0.6422764227642277,71,73,88,120,89,59,500,0.43537414965986393,2.0
100,100,80,60,60,50,450,0.3050847457627119,100,120,120,150,100,90,680,0.7880794701986755,2.0
50,60,60,60,60,30,320,0.11290322580645161,55,20,35,20,45,75,250,0.37681159420289856,1.0
55,69,85,32,35,28,304,0.09302325581395349,60,60,60,60,60,60,360,0.38095238095238093,1.0
106,190,100,154,100,130,780,0.9259259259259259,80,70,65,80,120,100,515,0.8034188034188035,1.0
60,60,40,65,45,35,305,0.15833333333333333,85,90,80,70,80,130,535,0.9262295081967213,0.0
60,50,50,60,70,50,340,0.28346456692913385,65,90,115,45,115,58,488,0.5041322314049587,1.0
100,100,100,100,100,100,600,0.8345864661654135,57,24,86,24,86,23,300,0.12727272727272726,0.125
57,24,86,24,86,23,300,0.12727272727272726,70,75,80,135,80,135,575,0.917910447761194,0.5
150,80,44,90,54,80,498,0.625,60,55,90,145,90,80,520,0.6071428571428571,2.0
80,105,105,105,105,80,580,0.5939849624060151,49,66,70,44,55,51,335,0.4260869565217391,1.0
70,55,65,95,85,70,440,0.5307692307692308,80,130,100,160,120,110,700,0.8981481481481481,0.5
85,80,70,135,75,90,535,0.7006802721088435,38,36,38,32,36,57,237,0.3893805309734513,1.0
109,66,84,81,99,32,471,0.2013888888888889,70,62,67,55,55,56,365,0.38513513513513514,2.0
106,110,90,154,90,130,680,0.926829268292683,80,85,95,30,30,25,345,0.2857142857142857,2.0
59,63,80,65,80,58,405,0.41843971631205673,45,53,70,40,60,42,310,0.25735294117647056,0.5
75,95,67,125,95,83,540,0.7117117117117117,60,45,70,45,90,95,405,0.7304964539007093,1.0
64,165,75,93,83,75,555,0.6587301587301587,100,70,70,65,65,45,415,0.1897810218978102,0.0
106,150,70,194,120,140,780,0.952,40,70,40,35,40,60,285,0.392,1.0
70,95,85,55,65,70,440,0.5,65,105,60,60,70,95,455,63.0,0.5
41,50,37,50,37,66,281,0.5175438596491229,90,75,85,115,90,55,510,0.3445378151260504,1.0
95,155,109,70,130,81,640,0.6788321167883211,70,75,80,135,80,135,575,0.917910447761194,1.0
65,136,94,54,96,135,580,0.9612403100775194,50,65,85,35,35,55,325,0.32575757575757575,0.5
58,70,45,40,45,42,300,0.25925925925925924,55,45,43,55,43,72,313,0.5853658536585366,0.0
80,80,80,80,80,80,480,0.6015037593984962,70,80,70,80,70,110,480,0.6594202898550725,0.5
110,78,73,76,71,60,468,0.3333333333333333,45,30,50,65,50,45,285,0.13821138211382114,1.0
81,102,77,85,75,85,505,0.5642857142857143,75,100,110,45,55,65,450,0.5333333333333333,0.5
59,59,58,90,70,73,409,0.5826086956521739,55,85,122,58,75,99,494,0.8099173553719008,2.0
50,53,48,53,48,64,316,0.358974358974359,65,75,90,97,123,44,494,0.1987179487179487,0.5
150,120,100,120,100,90,680,0.664179104477612,80,70,40,100,60,145,495,0.921875,1.0
52,65,55,58,62,60,352,0.4482758620689655,50,160,110,160,110,110,700,0.8854961832061069,0.25
80,160,60,170,130,80,680,0.6180555555555556,65,90,120,85,70,60,490,0.43410852713178294,2.0
80,105,65,60,75,130,515,0.9645390070921985,50,53,48,53,48,64,316,0.358974358974359,1.0
20,40,15,35,35,60,205,0.34285714285714286,62,44,50,44,50,55,305,0.3629032258064516,4.0
65,50,35,115,95,95,455,0.7333333333333333,35,85,45,35,35,75,310,0.6492537313432836,2.0
50,50,40,30,30,50,250,0.2781954887218045,80,95,82,60,82,75,474,0.6,2.0
95,109,105,75,85,56,525,0.34513274336283184,70,90,90,135,90,125,600,0.9401709401709402,1.0
45,50,35,55,75,40,300,0.21367521367521367,30,80,90,55,45,55,355,0.4295774647887324,1.0
64,51,23,51,23,28,240,0.11363636363636363,35,40,100,90,55,35,355,0.1796875,0.5
111,83,68,92,82,39,475,0.1774193548387097,30,56,35,25,35,72,253,0.48148148148148145,1.0
100,120,100,150,120,90,680,0.728,50,53,48,53,48,64,316,0.4076923076923077,2.0
25,20,15,105,55,90,310,0.32407407407407407,165,75,80,40,45,65,470,0.5151515151515151,1.0
75,65,55,65,55,69,384,0.43548387096774194,50,50,40,30,30,50,250,0.2781954887218045,2.0
60,62,50,62,60,40,334,0.18181818181818182,100,120,120,150,100,90,680,0.7880794701986755,0.25
75,38,38,56,56,67,330,0.5263157894736842,44,38,33,61,43,70,289,0.5267857142857143,0.5
75,125,100,70,80,45,495,0.33035714285714285,45,50,35,55,75,40,300,0.21367521367521367,1.0
75,80,55,25,35,35,305,0.18666666666666668,65,110,130,60,65,95,525,0.8278145695364238,1.0
108,170,115,120,95,92,700,0.7083333333333334,55,40,85,80,105,40,405,0.23622047244094488,0.0
105,95,75,85,75,74,509,0.5714285714285714,82,80,86,85,75,72,480,0.6183206106870229,1.0
89,124,80,55,80,55,483,0.5714285714285714,95,80,105,40,70,100,490,0.8046875,0.0
60,67,85,77,75,116,480,0.8888888888888888,80,70,65,80,120,100,515,0.8034188034188035,0.5
75,110,110,110,105,80,590,0.656934306569343,63,120,85,90,55,55,468,0.2809917355371901,2.0
60,90,140,50,50,40,430,0.2535211267605634,70,95,125,65,75,45,475,0.33613445378151263,4.0
85,73,70,73,115,67,483,0.5126050420168067,86,76,86,116,56,95,515,0.7982456140350878,1.0
46,57,40,40,40,50,273,0.25,120,120,120,120,120,120,720,0.9344262295081968,1.0
65,125,60,95,60,105,510,0.9236641221374046,95,155,109,70,130,81,640,0.6788321167883211,2.0
110,160,110,80,110,100,670,0.8591549295774648,100,100,100,100,100,100,600,0.8345864661654135,1.0
95,124,78,69,71,58,495,0.37398373983739835,40,30,35,50,70,55,280,0.28205128205128205,0.5
74,108,133,83,65,32,495,0.32142857142857145,90,70,80,70,95,70,475,0.5190839694656488,1.0
78,70,61,50,61,100,420,0.8145161290322581,60,40,60,95,60,55,370,0.4222222222222222,0.0
65,45,55,45,70,45,325,0.24369747899159663,40,45,65,100,120,90,460,0.5588235294117647,1.0
70,110,70,115,70,90,525,0.75,50,72,35,35,35,65,292,0.5373134328358209,2.0
50,65,90,35,35,15,290,0.14678899082568808,55,55,45,63,45,45,308,0.25,1.0
70,90,45,15,45,50,315,0.3629032258064516,80,95,82,60,82,75,474,0.6,1.0
60,80,50,50,50,40,330,0.23853211009174313,60,100,85,80,85,100,510,0.7007874015748031,1.0
76,65,45,92,42,91,411,0.7449664429530202,100,100,80,60,60,50,450,0.3050847457627119,1.0
80,70,40,100,60,145,495,0.921875,39,52,43,60,50,65,309,0.49107142857142855,0.5
45,53,70,40,60,42,310,0.25735294117647056,72,95,67,103,71,122,530,0.9606299212598425,4.0
60,90,140,50,50,40,430,0.2535211267605634,66,65,48,62,57,52,350,0.36220472440944884,1.0
70,94,50,94,50,66,424,0.48148148148148145,50,85,55,65,65,90,410,0.7478260869565218,0.5
95,124,78,69,71,58,495,0.37398373983739835,80,95,82,60,82,75,474,0.6,0.5
45,49,49,65,65,45,318,0.2781954887218045,58,64,58,80,65,80,405,0.5423728813559322,0.5
55,45,45,25,25,15,210,0.048,58,64,58,80,65,80,405,0.609271523178808,4.0
59,45,40,35,40,31,250,0.14285714285714285,75,125,100,70,80,45,495,0.33035714285714285,0.5
50,85,125,85,115,20,480,0.4306569343065693,73,95,62,85,65,85,465,0.6666666666666666,0.0
55,65,35,60,30,85,330,0.6126126126126126,70,65,65,55,55,70,380,0.5,1.0
150,160,100,95,65,100,670,0.8866666666666667,125,58,58,76,76,67,460,0.515625,1.0
90,120,120,60,60,50,500,0.35294117647058826,50,45,45,35,35,50,260,0.23529411764705882,1.0
65,90,40,45,80,75,395,0.625,52,65,50,45,50,38,300,0.27419354838709675,2.0
80,70,70,90,100,70,480,0.5609756097560976,80,160,60,170,130,80,680,0.6180555555555556,1.0
40,45,35,40,40,90,290,0.65,78,104,78,159,115,100,634,0.8444444444444444,1.0
35,55,40,50,50,90,320,0.6838235294117647,95,110,95,40,95,55,490,0.40336134453781514,1.0
65,110,130,60,65,95,525,0.8278145695364238,55,65,35,60,30,85,330,0.6126126126126126,2.0
78,84,78,109,85,100,534,0.8620689655172413,45,30,15,85,65,65,305,0.36220472440944884,2.0
61,84,65,70,70,70,420,0.5,86,92,88,68,75,73,482,0.6835443037974683,1.0
90,92,75,92,85,60,494,0.49586776859504134,60,40,60,40,60,35,295,0.18055555555555555,1.0
50,50,150,50,150,50,500,0.2571428571428571,60,50,70,80,80,140,480,0.8449612403100775,1.0
95,85,85,65,65,35,430,0.2571428571428571,39,52,43,60,50,65,309,0.5041322314049587,4.0
65,76,84,54,96,105,480,0.9008264462809917,105,180,100,180,100,115,780,0.9477611940298507,1.0
70,65,65,55,55,70,380,0.5,95,110,80,70,80,50,485,0.37209302325581395,1.0
64,165,75,93,83,75,555,0.6587301587301587,100,123,75,57,75,80,510,0.6923076923076923,0.0
100,164,150,95,120,71,700,0.5645161290322581,70,140,230,60,80,50,630,0.32432432432432434,0.5
100,100,100,100,100,100,600,0.8758169934640523,65,40,50,125,60,30,370,0.07258064516129033,0.5
100,128,90,77,77,128,600,0.959349593495935,25,35,70,95,55,45,325,0.16783216783216784,1.0
60,52,168,47,138,30,495,0.19834710743801653,60,50,40,85,75,95,405,0.7540983606557377,0.5
35,80,50,50,70,120,405,0.84375,55,55,55,85,55,30,335,0.1320754716981132,1.0
65,80,80,59,63,58,405,0.4411764705882353,50,25,28,45,55,15,218,0.0625,1.0
58,89,77,45,45,48,362,0.3177570093457944,80,80,90,110,130,110,600,0.8721804511278195,2.0
85,50,95,120,115,80,545,0.5793650793650794,80,92,65,65,80,68,450,0.4824561403508772,1.0
58,50,145,95,105,30,483,0.2459016393442623,75,140,65,112,65,110,567,0.9140625,1.0
70,55,55,80,60,45,365,0.2222222222222222,65,95,57,100,85,93,495,0.7441860465116279,1.0
55,85,55,50,55,60,360,0.4233576642335766,80,105,105,105,105,80,580,0.5939849624060151,2.0
65,90,122,58,75,84,494,0.71875,89,124,80,55,80,55,483,0.5714285714285714,4.0
70,80,70,80,70,110,480,0.6594202898550725,20,10,230,10,230,5,505,0.0,1.0
60,40,80,60,45,40,325,0.23529411764705882,55,63,90,50,80,42,380,0.21138211382113822,0.25
55,55,85,65,85,35,380,0.2014388489208633,95,75,80,100,110,30,490,0.24242424242424243,0.5
80,100,123,122,120,80,625,0.56,58,89,77,45,45,48,362,0.3177570093457944,0.5
50,55,50,36,30,43,264,0.2922077922077922,60,62,80,63,80,60,405,0.4336283185840708,2.0
108,100,121,81,95,95,600,0.7476635514018691,45,50,35,55,75,40,300,0.21367521367521367,2.0
60,69,95,69,95,36,424,0.2608695652173913,67,89,116,79,116,33,500,0.2624113475177305,0.5
38,35,35,65,55,50,278,0.2647058823529412,110,78,73,76,71,60,468,0.3333333333333333,2.0
91,90,72,90,129,108,580,0.896,90,120,75,60,60,45,450,0.29411764705882354,0.5
60,40,60,95,60,55,370,0.4222222222222222,92,105,90,125,90,98,600,0.8217054263565892,0.25
65,60,110,130,95,65,525,0.47761194029850745,70,60,62,80,82,60,414,0.4375,2.0
40,45,40,35,35,56,251,0.373015873015873,80,100,70,50,60,45,405,0.25806451612903225,2.0
55,75,60,75,60,103,428,0.7982456140350878,45,85,70,40,40,60,340,0.5229357798165137,0.5
90,55,75,60,75,30,385,0.13970588235294118,100,150,140,100,90,90,670,0.7969924812030075,1.0
45,30,15,85,65,65,305,0.36220472440944884,50,95,90,95,90,180,600,0.9172413793103448,0.5
60,40,50,75,85,95,405,0.6044776119402985,50,72,35,35,35,65,292,0.5373134328358209,0.0
95,110,95,40,95,55,490,0.40336134453781514,45,100,45,45,45,10,290,0.2949640287769784,1.0
80,70,40,100,60,145,495,0.921875,40,40,50,30,30,30,220,0.0873015873015873,2.0
75,85,200,55,65,30,510,0.16778523489932887,45,30,35,20,20,45,195,0.14782608695652175,0.5
95,110,80,70,80,50,485,0.37209302325581395,60,85,40,30,45,68,328,0.6422018348623854,2.0
35,65,35,65,35,65,300,0.46621621621621623,45,40,60,40,75,50,310,0.2926829268292683,1.0
60,55,90,145,90,80,520,0.6071428571428571,55,40,50,65,85,40,335,0.3181818181818182,1.0
52,65,50,45,50,38,300,0.27419354838709675,71,73,88,120,89,59,500,0.43537414965986393,1.0
105,95,75,85,75,74,509,0.5714285714285714,64,165,75,93,83,75,555,0.6587301587301587,1.0
70,150,140,65,100,75,600,0.55,40,20,30,40,80,55,265,0.22764227642276422,0.5
75,100,110,45,55,65,450,0.5333333333333333,110,123,65,100,65,65,528,0.5217391304347826,2.0
50,52,48,65,50,55,320,0.33098591549295775,43,30,55,40,65,97,330,0.6030534351145038,0.5
95,75,110,100,80,30,490,0.15267175572519084,37,25,41,25,41,25,194,0.08870967741935484,1.0
50,30,55,65,55,20,275,0.13675213675213677,40,55,80,35,60,30,300,0.15037593984962405,4.0
60,60,40,65,45,35,305,0.15833333333333333,85,90,80,70,80,130,535,0.9262295081967213,0.0
50,85,85,55,55,50,380,0.3902439024390244,65,40,70,80,140,70,465,0.5954198473282443,0.5
50,48,43,46,41,60,288,0.47297297297297297,50,55,50,36,30,43,264,0.2922077922077922,0.0
80,80,80,80,80,80,480,0.6015037593984962,95,85,85,65,65,35,430,0.2571428571428571,1.0
50,95,90,95,90,180,600,0.9172413793103448,50,52,48,65,50,55,320,0.33098591549295775,1.0
95,125,79,60,100,81,540,0.6165413533834586,80,100,70,50,60,45,405,0.25806451612903225,2.0
66,65,48,62,57,52,350,0.36220472440944884,45,45,35,20,30,20,195,0.07246376811594203,0.5
40,55,99,40,79,47,360,0.26262626262626265,60,59,85,79,105,36,424,0.16666666666666666,4.0
65,130,60,95,110,65,525,0.5303030303030303,65,73,55,47,75,85,400,0.6846846846846847,2.0
85,73,70,73,115,67,483,0.5126050420168067,60,115,105,65,70,80,495,0.7181818181818181,1.0
50,65,107,105,107,86,520,0.7758620689655172,81,102,77,85,75,85,505,0.5642857142857143,0.0
40,40,40,70,40,20,250,0.032520325203252036,95,100,85,108,70,70,528,0.5652173913043478,0.5
41,56,40,62,44,71,314,0.568,116,55,85,107,95,29,487,0.06818181818181818,1.0
55,69,85,32,35,28,304,0.09302325581395349,28,25,25,45,35,40,198,0.16083916083916083,1.0
1,90,45,30,30,40,236,0.33064516129032256,30,56,35,25,35,72,253,0.48148148148148145,0.0
95,65,110,60,130,65,525,0.5275590551181102,90,75,75,90,100,70,500,0.5462184873949579,1.0
86,92,88,68,75,73,482,0.6835443037974683,109,66,84,81,99,32,471,0.2013888888888889,2.0
66,65,48,62,57,52,350,0.36220472440944884,90,93,55,70,55,55,418,0.3819444444444444,0.5
64,51,23,51,23,28,240,0.11363636363636363,91,90,129,90,72,108,580,0.9140625,0.5
65,95,100,60,50,50,420,0.34959349593495936,70,110,75,145,85,145,630,0.9444444444444444,2.0
1,90,45,30,30,40,236,0.33064516129032256,20,10,55,15,20,80,200,0.17985611510791366,1.0
64,51,23,51,23,28,240,0.11363636363636363,55,40,40,65,45,35,280,0.16428571428571428,1.0
40,20,30,40,80,55,265,0.22764227642276422,38,30,41,30,41,60,240,0.2897196261682243,1.0
70,80,70,80,70,110,480,0.6594202898550725,97,165,60,65,50,58,495,0.3902439024390244,1.0
105,125,100,60,100,100,590,0.8359375,65,130,60,75,60,75,465,0.689922480620155,1.0
70,55,55,80,60,45,365,0.2222222222222222,69,69,76,69,86,91,460,0.6554621848739496,2.0
95,60,79,100,125,81,540,0.6201550387596899,65,47,55,73,75,85,400,0.65,1.0
50,85,40,85,40,35,335,0.1746031746031746,80,185,115,40,105,75,600,0.6230769230769231,0.5
35,60,44,40,54,55,288,0.366412213740458,60,80,50,40,40,30,300,0.15328467153284672,2.0
31,45,90,30,30,40,266,0.21929824561403508,105,95,80,40,80,90,490,0.753968253968254,1.0
62,48,66,59,57,49,341,0.33884297520661155,55,55,85,65,85,35,380,0.2014388489208633,1.0
40,45,35,30,40,55,245,0.3793103448275862,45,60,40,70,50,45,310,0.2846715328467153,1.0
55,50,40,40,40,75,300,0.5945945945945946,60,48,45,43,90,42,328,0.21897810218978103,1.0
70,140,230,60,80,50,630,0.32432432432432434,40,55,99,40,79,47,360,0.26262626262626265,1.0
95,110,95,40,95,55,490,0.40336134453781514,78,130,111,130,85,100,634,0.8561151079136691,1.0
67,58,57,81,67,101,431,0.8790322580645161,70,20,50,20,50,40,250,0.1557377049180328,2.0
72,95,67,103,71,122,530,0.9606299212598425,75,75,60,83,60,60,413,0.39344262295081966,0.5
55,81,60,50,70,97,413,0.7214285714285714,67,58,57,81,67,101,431,0.8790322580645161,1.0
90,120,100,150,120,100,680,0.7718120805369127,108,170,115,120,95,92,700,0.7083333333333334,2.0
80,125,75,40,95,85,500,0.6911764705882353,41,56,40,62,44,71,314,0.568,1.0
30,40,70,70,25,60,295,0.41353383458646614,40,80,100,30,30,20,300,0.11851851851851852,4.0
75,98,63,98,63,101,498,0.849624060150376,41,56,40,62,44,71,314,0.568,0.5
105,95,80,40,80,90,490,0.753968253968254,40,30,35,45,40,55,245,0.31496062992125984,1.0
50,95,90,95,90,180,600,0.9172413793103448,95,75,180,130,80,30,590,0.13793103448275862,0.5
36,50,50,65,60,44,305,0.16363636363636364,90,50,34,60,44,70,348,0.6283185840707964,2.0
123,77,72,99,92,58,521,0.4621212121212121,75,69,72,114,100,104,534,0.8253968253968254,1.0
45,60,40,70,50,45,310,0.2846715328467153,100,100,100,100,100,100,600,0.8805970149253731,0.5
65,95,75,55,55,85,430,0.6933333333333334,70,115,60,115,60,55,475,0.4647887323943662,1.0
80,82,83,100,100,80,525,0.6742424242424242,36,50,50,65,60,44,305,0.16363636363636364,1.0
75,110,110,110,105,80,590,0.656934306569343,126,131,95,131,98,99,680,0.8102189781021898,2.0
55,68,64,45,55,31,318,0.11666666666666667,100,100,100,100,100,100,600,0.8758169934640523,0.5
75,80,95,90,100,50,490,0.2158273381294964,75,95,125,45,75,95,510,0.8257575757575758,1.0
110,135,60,50,65,88,508,0.7744360902255639,65,80,65,35,65,60,370,0.38405797101449274,1.0
78,104,78,159,115,100,634,0.8444444444444444,90,92,87,75,85,76,505,0.5409836065573771,1.0
40,55,80,35,60,30,300,0.15037593984962405,65,125,100,60,70,70,490,0.6099290780141844,0.0
70,110,70,115,70,90,525,0.75,65,50,35,115,95,95,455,0.7333333333333333,2.0
65,90,115,45,115,58,488,0.5041322314049587,60,60,60,60,60,60,360,0.38095238095238093,2.0
75,70,90,70,105,80,490,0.656,80,120,130,55,65,45,495,0.37037037037037035,0.5
45,25,50,25,25,35,205,0.13076923076923078,90,100,70,110,150,80,600,0.6037735849056604,1.0
80,105,65,60,75,130,515,0.9645390070921985,90,70,80,70,95,70,475,0.5190839694656488,2.0
45,30,35,20,20,45,195,0.14782608695652175,103,60,126,80,126,50,545,0.36363636363636365,0.5
70,60,75,110,75,90,480,0.7165354330708661,64,88,50,88,50,106,446,0.9111111111111111,1.0
100,70,70,65,65,45,415,0.1897810218978102,106,90,130,90,154,110,680,0.8699186991869918,1.0
51,65,65,80,75,59,395,0.4365079365079365,90,100,90,125,85,90,580,0.7352941176470589,1.0
70,20,50,20,50,40,250,0.1557377049180328,90,130,80,65,85,55,505,0.4396551724137931,2.0
55,66,44,44,56,85,350,0.6888888888888889,45,65,34,40,34,45,263,0.2589928057553957,1.0
100,150,110,95,110,70,635,0.5923076923076923,60,80,95,70,85,50,440,0.2231404958677686,2.0
30,56,35,25,35,72,253,0.48148148148148145,61,90,45,50,50,160,456,0.9230769230769231,1.0
40,40,55,40,70,55,300,0.40939597315436244,43,70,48,50,60,38,309,0.2391304347826087,0.5
97,165,60,65,50,58,495,0.3902439024390244,45,30,15,85,65,65,305,0.36220472440944884,2.0
50,85,55,65,65,90,410,0.7478260869565218,65,90,50,85,45,55,390,0.371900826446281,2.0
55,130,115,50,50,75,475,0.5982142857142857,125,170,100,120,90,95,700,0.77,0.5
60,40,60,40,60,35,295,0.18055555555555555,80,120,130,55,65,45,495,0.37037037037037035,4.0
150,120,100,120,100,90,680,0.664179104477612,66,41,77,61,87,23,355,0.12096774193548387,1.0
50,50,40,50,40,64,294,0.45588235294117646,60,60,60,60,60,60,360,0.38095238095238093,1.0
65,65,65,50,50,90,385,0.72,65,65,60,110,95,130,525,0.9253731343283582,1.0
35,55,40,50,50,90,320,0.6838235294117647,73,115,60,60,60,90,458,0.6694915254237288,1.0
58,70,45,40,45,42,300,0.25925925925925924,45,30,40,105,50,20,290,0.031007751937984496,1.0
70,130,100,55,80,65,500,0.608,103,60,86,60,86,50,445,0.3458646616541353,1.0
41,56,40,62,44,71,314,0.568,70,60,62,80,82,60,414,0.4375,1.0
60,69,95,69,95,36,424,0.2608695652173913,55,69,85,32,35,28,304,0.09302325581395349,2.0
60,60,60,60,60,60,360,0.38095238095238093,100,128,90,77,77,128,600,0.959349593495935,1.0
50,65,107,105,107,86,520,0.7272727272727273,60,55,50,40,55,45,305,0.22377622377622378,2.0
75,100,66,60,66,115,482,0.918918918918919,75,98,63,98,63,101,498,0.889763779527559,1.0
85,76,64,45,55,90,415,0.6739130434782609,95,110,80,70,80,50,485,0.37209302325581395,1.0
75,75,130,75,130,95,580,0.7479674796747967,66,65,48,62,57,52,350,0.36220472440944884,1.0
100,150,110,95,110,70,635,0.5923076923076923,40,55,30,30,30,85,270,0.688,0.0
44,38,39,61,79,42,303,0.2251655629139073,70,60,62,80,82,60,414,0.4375,1.0
80,105,105,105,105,80,580,0.5939849624060151,80,115,80,65,55,93,488,0.7846153846153846,1.0
45,30,40,105,50,20,290,0.031007751937984496,40,40,50,30,30,30,220,0.0873015873015873,1.0
70,65,65,55,55,70,380,0.5,65,125,100,55,70,85,500,0.6532258064516129,1.0
50,50,150,50,150,50,500,0.2571428571428571,95,110,80,70,80,50,485,0.37209302325581395,2.0
55,63,90,50,80,42,380,0.21138211382113822,100,70,70,65,65,45,415,0.1897810218978102,1.0
30,80,90,55,45,55,355,0.4295774647887324,95,75,110,100,80,30,490,0.15267175572519084,0.5
90,85,75,115,100,115,580,0.9381443298969072,79,115,70,125,80,111,580,0.864,1.0
40,45,35,40,40,90,290,0.65,60,55,50,40,55,45,305,0.22377622377622378,1.0
60,60,40,65,45,35,305,0.15833333333333333,95,65,110,60,130,65,525,0.5275590551181102,1.0
105,125,100,60,100,100,590,0.8359375,60,50,100,85,70,65,430,0.47580645161290325,1.0
44,75,35,63,33,45,295,0.2647058823529412,99,68,83,72,87,51,460,0.417910447761194,1.0
95,155,109,70,130,81,640,0.6788321167883211,40,40,40,70,40,20,250,0.032520325203252036,2.0
85,105,55,85,50,115,495,0.9032258064516129,50,95,90,95,90,180,600,0.9172413793103448,1.0
60,100,89,55,69,112,485,0.9298245614035088,95,125,79,60,100,81,540,0.6165413533834586,0.5
70,85,70,60,70,50,405,0.28378378378378377,58,64,58,80,65,80,405,0.5423728813559322,4.0
100,134,110,95,100,61,600,0.4057971014492754,55,40,85,80,105,40,405,0.23622047244094488,1.0
105,30,105,140,105,55,540,0.3524590163934426,44,75,35,63,33,45,295,0.2647058823529412,1.0
73,100,60,100,60,65,458,0.42657342657342656,80,92,65,65,80,68,450,0.4824561403508772,1.0
105,180,100,180,100,115,780,0.9477611940298507,80,80,80,80,80,80,480,0.5606060606060606,1.0
75,95,60,65,60,115,470,0.8778625954198473,55,70,55,40,55,85,360,0.7073170731707317,1.0
90,50,34,60,44,70,348,0.6283185840707964,75,125,70,125,70,115,580,0.9037037037037037,2.0
70,95,85,55,65,70,440,0.5,50,45,45,35,35,50,260,0.23529411764705882,1.0
80,120,130,55,65,45,495,0.37037037037037035,75,69,72,114,100,104,534,0.8253968253968254,4.0
76,147,90,60,70,97,540,0.8267716535433071,95,110,80,70,80,50,485,0.37209302325581395,1.0
40,50,45,70,45,70,320,0.5517241379310345,55,65,35,60,30,85,330,0.6126126126126126,1.0
90,75,85,115,90,55,510,0.3445378151260504,45,30,35,20,20,45,195,0.14782608695652175,1.0
46,57,40,40,40,50,273,0.25,75,80,70,65,75,90,455,0.7578125,0.5
45,90,20,65,20,65,305,0.5116279069767442,89,145,90,105,80,91,600,0.8549618320610687,2.0
37,25,41,25,41,25,194,0.08870967741935484,65,95,100,60,50,50,420,0.34959349593495936,1.0
30,40,70,70,25,60,295,0.41353383458646614,45,40,60,40,75,50,310,0.2926829268292683,1.0
86,68,72,109,66,106,507,0.8099173553719008,60,62,80,63,80,60,405,0.4336283185840708,2.0
106,190,100,154,100,130,780,0.9259259259259259,70,110,180,60,60,50,530,0.4117647058823529,2.0
30,105,90,25,25,50,325,0.2773722627737226,100,100,100,100,100,100,600,0.831858407079646,1.0
35,46,34,35,45,20,215,0.072,40,30,50,55,55,100,330,0.584070796460177,1.0
30,80,90,55,45,55,355,0.4295774647887324,65,76,84,54,96,105,480,0.9008264462809917,1.0
83,80,75,70,70,101,479,0.8615384615384616,50,50,62,40,62,65,329,0.4188034188034188,1.0
50,50,40,30,30,50,250,0.2781954887218045,40,70,40,35,40,60,285,0.392,1.0
65,90,120,85,70,60,490,0.43410852713178294,40,40,55,40,70,55,300,0.40939597315436244,0.5
70,150,140,65,100,75,600,0.55,68,90,65,50,55,82,410,0.6165413533834586,1.0
65,150,40,15,80,145,495,0.9663865546218487,50,25,28,45,55,15,218,0.0625,1.0
85,105,55,85,50,115,495,0.9032258064516129,30,30,30,30,30,30,180,0.12612612612612611,0.5
70,65,60,90,75,90,450,0.6571428571428571,74,94,131,54,116,20,489,0.4485294117647059,0.0
108,112,118,68,72,47,525,0.2916666666666667,78,81,71,74,69,126,499,0.9090909090909091,0.0
50,80,95,10,45,10,290,0.232,40,30,35,50,70,55,280,0.28205128205128205,1.0
60,85,40,30,45,68,328,0.6422018348623854,95,70,73,95,90,60,483,0.3983739837398374,1.0
80,100,123,122,120,80,625,0.56,56,61,65,48,45,38,313,0.17567567567567569,1.0
43,70,48,50,60,38,309,0.2391304347826087,110,160,110,80,110,100,670,0.8591549295774648,0.0
100,70,70,65,65,45,415,0.1897810218978102,70,60,125,115,70,55,495,0.35507246376811596,0.5
110,80,90,95,90,65,530,0.5033557046979866,45,25,50,25,25,35,205,0.13076923076923078,1.0
75,75,95,75,95,113,528,0.9015151515151515,86,92,88,68,75,73,482,0.6835443037974683,1.0
105,140,95,55,65,45,505,0.3,50,48,43,46,41,60,288,0.47297297297297297,1.0
70,85,70,60,70,50,405,0.28378378378378377,105,95,80,40,80,90,490,0.753968253968254,1.0
55,66,44,44,56,85,350,0.6888888888888889,45,50,55,75,65,30,320,0.06293706293706294,1.0
120,120,120,120,120,120,720,0.9344262295081968,45,35,45,62,53,35,275,0.11851851851851852,1.0
79,100,80,110,90,121,580,0.968,78,92,75,74,63,118,500,0.8842975206611571,2.0
45,45,55,45,55,63,308,0.4594594594594595,75,38,38,56,56,67,330,0.5263157894736842,2.0
30,45,55,70,55,85,340,0.5633802816901409,65,136,94,54,96,135,580,0.9612403100775194,1.0
85,73,70,73,115,67,483,0.5126050420168067,35,55,40,50,50,90,320,0.6838235294117647,1.0
60,85,49,60,49,60,363,0.4444444444444444,35,55,40,50,50,90,320,0.6838235294117647,0.5
84,86,88,111,101,60,530,0.4634146341463415,73,95,62,85,65,85,465,0.6666666666666666,1.0
40,60,30,31,31,70,262,0.4492753623188406,95,75,180,130,80,30,590,0.13793103448275862,1.0
55,66,44,44,56,85,350,0.6888888888888889,55,40,40,65,45,35,280,0.16428571428571428,1.0
49,49,56,49,61,66,330,0.5190839694656488,90,30,15,40,20,15,210,0.043478260869565216,1.0
40,29,45,29,45,36,224,0.14634146341463414,79,105,70,145,80,101,580,0.8608695652173913,0.5
40,65,40,80,40,65,330,0.5038167938931297,28,25,25,45,35,40,198,0.16083916083916083,1.0
95,65,110,60,130,65,525,0.5275590551181102,67,89,116,79,116,33,500,0.2624113475177305,2.0
45,50,55,75,65,30,320,0.06293706293706294,95,145,130,120,90,120,700,0.9398496240601504,0.25
50,45,45,35,35,50,260,0.23529411764705882,90,75,75,90,100,70,500,0.5462184873949579,1.0
50,92,108,92,108,35,485,0.2457627118644068,85,100,122,58,75,54,494,0.3939393939393939,4.0
90,55,75,60,75,30,385,0.13970588235294118,50,65,107,105,107,86,520,0.703125,1.0
60,65,70,85,75,40,395,0.21705426356589147,55,70,55,40,55,85,360,0.7073170731707317,1.0
70,94,50,94,50,66,424,0.48148148148148145,45,80,100,35,37,28,325,0.3125,0.125
95,75,110,100,80,30,490,0.15267175572519084,45,95,50,40,50,75,355,0.54,2.0
80,82,83,100,100,80,525,0.6742424242424242,91,90,106,130,106,77,600,0.648854961832061,0.0
75,80,95,90,100,50,490,0.2158273381294964,20,10,230,10,230,5,505,0.0,1.0
60,65,70,85,75,40,395,0.21705426356589147,55,40,40,65,45,35,280,0.16428571428571428,1.0
35,55,40,50,50,90,320,0.6838235294117647,40,40,35,50,100,70,335,0.5031847133757962,2.0
110,65,75,125,85,30,490,0.15,44,38,39,61,79,42,303,0.2251655629139073,1.0
85,110,90,45,90,80,500,0.6206896551724138,80,50,100,100,200,50,580,0.2357142857142857,1.0
50,95,90,95,90,180,600,0.9172413793103448,123,100,62,97,81,68,531,0.4806201550387597,1.0
125,170,100,120,90,95,700,0.77,55,55,85,65,85,35,380,0.2014388489208633,0.5
75,110,110,110,105,80,590,0.656934306569343,76,147,90,60,70,97,540,0.8267716535433071,4.0
45,60,32,50,32,76,295,0.5925925925925926,45,30,50,55,65,45,290,0.208,1.0
80,95,82,60,82,75,474,0.6,74,48,76,83,81,104,466,0.7913043478260869,1.0
43,80,65,50,35,35,308,0.14193548387096774,75,80,55,25,35,35,305,0.18666666666666668,1.0
75,89,85,55,65,36,405,0.29545454545454547,54,78,103,53,45,22,355,0.23255813953488372,4.0
40,45,40,65,40,65,295,0.5661764705882353,76,25,45,67,55,24,292,0.0390625,1.0
89,124,80,55,80,55,483,0.5714285714285714,50,70,160,70,160,90,600,0.7417218543046358,2.0
110,80,90,95,90,65,530,0.5033557046979866,50,53,48,53,48,64,316,0.358974358974359,0.25
67,57,55,77,55,114,425,0.8879310344827587,100,134,110,95,100,61,600,0.4057971014492754,0.0
100,150,140,100,90,90,670,0.7969924812030075,68,72,78,38,42,32,330,0.23809523809523808,1.0
95,80,105,40,70,100,490,0.8046875,80,82,78,95,80,85,500,0.6869565217391305,1.0
80,100,70,50,60,45,405,0.25806451612903225,80,80,50,40,50,25,325,0.176056338028169,0.5
65,125,100,60,70,70,490,0.6099290780141844,55,66,44,44,56,85,350,0.6888888888888889,1.0
100,100,100,100,100,100,600,0.8345864661654135,85,120,70,50,60,100,485,0.8308823529411765,0.5
45,30,50,65,50,45,285,0.13821138211382114,40,55,30,30,30,85,270,0.688,1.0
76,25,45,67,55,24,292,0.0390625,72,95,67,103,71,122,530,0.9606299212598425,0.0
78,84,78,109,85,100,534,0.8646616541353384,45,60,45,25,45,55,275,0.29,1.0
50,50,95,40,50,35,320,0.20279720279720279,71,73,88,120,89,59,500,0.43537414965986393,1.0
70,150,140,65,100,75,600,0.55,67,58,57,81,67,101,431,0.8790322580645161,0.125
79,100,80,110,90,121,580,0.968,80,70,65,80,120,100,515,0.8034188034188035,1.0
60,100,85,80,85,100,510,0.7007874015748031,100,100,100,100,100,100,600,0.8758169934640523,0.25
65,65,65,50,50,90,385,0.72,85,120,70,50,60,100,485,0.8308823529411765,1.0
50,45,45,35,35,50,260,0.23529411764705882,150,100,120,100,120,90,680,0.6666666666666666,0.0
60,70,50,100,50,65,395,0.5217391304347826,76,65,45,92,42,91,411,0.7449664429530202,0.5
70,94,50,94,50,66,424,0.48148148148148145,64,78,52,78,52,81,405,0.6422764227642277,0.5
20,40,90,30,90,25,295,0.11363636363636363,55,70,55,40,55,85,360,0.7073170731707317,0.0
62,44,50,44,50,55,305,0.3629032258064516,80,80,90,110,130,110,600,0.8721804511278195,0.5
125,170,100,120,90,95,700,0.77,76,147,90,60,70,97,540,0.8267716535433071,4.0
82,80,86,85,75,72,480,0.6183206106870229,108,100,121,81,95,95,600,0.7476635514018691,2.0
75,110,110,110,105,80,590,0.656934306569343,62,48,54,63,60,68,355,0.5178571428571429,1.0
100,100,100,100,100,100,600,0.8805970149253731,80,145,150,105,110,110,700,0.8692307692307693,1.0
55,20,35,20,45,75,250,0.37681159420289856,70,43,53,43,53,40,302,0.19090909090909092,1.0
30,30,42,30,42,70,244,0.4230769230769231,105,95,75,85,75,74,509,0.5714285714285714,1.0
70,84,70,65,70,51,410,0.2949640287769784,45,30,40,105,50,20,290,0.031007751937984496,1.0
60,50,70,80,80,140,480,0.8449612403100775,68,85,65,165,135,100,618,0.8083333333333333,1.0
120,120,120,120,120,120,720,0.9344262295081968,55,65,35,60,30,85,330,0.6126126126126126,1.0
30,42,118,42,88,30,350,0.112,65,75,105,35,65,85,430,0.6940298507462687,1.0
69,69,76,69,86,91,460,0.6554621848739496,67,82,62,46,48,43,348,0.22033898305084745,1.0
50,65,64,44,48,43,314,0.2196969696969697,50,50,150,50,150,50,500,0.2571428571428571,2.0
78,52,60,63,65,23,341,0.06015037593984962,40,30,35,50,70,55,280,0.28205128205128205,0.5
61,78,95,56,58,57,405,0.40336134453781514,78,92,75,74,63,118,500,0.8842975206611571,0.5
35,35,35,35,35,35,210,0.13385826771653545,78,92,75,74,63,118,500,0.8842975206611571,0.5
73,76,75,81,100,100,505,0.8110236220472441,79,115,70,125,80,111,580,0.8468468468468469,1.0
65,73,55,47,75,85,400,0.6846846846846847,65,75,70,95,70,95,470,0.7272727272727273,1.0
65,83,57,95,85,105,490,0.8914728682170543,60,90,140,50,50,40,430,0.2535211267605634,1.0
160,110,65,65,110,30,540,0.35714285714285715,55,66,44,44,56,85,350,0.6888888888888889,1.0
95,80,105,40,70,100,490,0.8046875,40,55,30,30,30,85,270,0.688,1.0
49,49,56,49,61,66,330,0.5190839694656488,50,92,108,92,108,35,485,0.2457627118644068,1.0
75,125,75,30,75,85,465,0.625,60,80,95,70,85,50,440,0.2231404958677686,2.0
50,64,50,45,50,41,300,0.22727272727272727,80,135,85,70,95,150,615,0.9844961240310077,0.0
80,160,80,130,80,100,630,0.8455284552845529,108,130,95,80,85,102,600,0.7637795275590551,0.5
85,105,55,85,50,115,495,0.9032258064516129,40,35,30,120,70,105,400,0.6692307692307692,1.0
60,75,100,55,80,50,420,0.3088235294117647,50,85,125,85,115,20,480,0.4306569343065693,0.0
95,75,180,130,80,30,590,0.13793103448275862,67,89,116,79,116,33,500,0.2624113475177305,0.25
60,65,60,130,75,110,500,0.7719298245614035,67,89,116,79,116,33,500,0.2624113475177305,0.0
90,93,55,70,55,55,418,0.3819444444444444,60,60,60,60,60,60,360,0.38095238095238093,2.0
75,80,60,65,90,102,472,0.8625954198473282,45,49,65,49,65,45,318,0.275,1.0
56,61,65,48,45,38,313,0.17567567567567569,75,125,230,55,95,30,610,0.3448275862068966,1.0
48,72,48,72,48,48,336,0.25984251968503935,55,112,45,74,45,70,401,0.559322033898305,1.0
55,45,45,25,25,15,210,0.048,45,30,40,105,50,20,290,0.031007751937984496,1.0
35,70,55,45,55,25,285,0.09420289855072464,45,30,50,65,50,45,285,0.13821138211382114,2.0
70,120,40,95,40,95,460,0.8106060606060606,76,65,45,92,42,91,411,0.7449664429530202,1.0
65,65,60,110,95,130,525,0.9253731343283582,95,110,95,40,95,55,490,0.40336134453781514,1.0
99,68,83,72,87,51,460,0.417910447761194,91,72,90,129,90,108,580,0.8925619834710744,4.0
45,100,135,65,135,45,525,0.29411764705882354,55,20,35,20,45,75,250,0.37681159420289856,0.0
70,110,70,115,70,90,525,0.75,73,115,60,60,60,90,458,0.6694915254237288,2.0
40,65,40,80,40,65,330,0.5038167938931297,20,15,20,10,55,80,200,0.2682926829268293,1.0
84,71,43,71,43,48,360,0.25874125874125875,60,60,50,40,50,75,335,0.5882352941176471,1.0
91,129,90,72,90,108,580,0.8536585365853658,62,55,52,109,94,109,481,0.7833333333333333,2.0
50,100,150,100,150,50,600,0.37142857142857144,70,105,105,50,40,20,390,0.33587786259541985,1.0
75,80,70,65,75,90,455,0.7578125,61,78,95,56,58,57,405,0.40336134453781514,4.0
130,85,80,85,95,60,535,0.43884892086330934,62,73,55,56,52,84,382,0.7244094488188977,2.0
106,190,100,154,100,130,780,0.9259259259259259,100,134,110,95,100,61,600,0.4057971014492754,0.0
58,70,45,40,45,42,300,0.25925925925925924,38,35,35,65,55,50,278,0.2647058823529412,0.0
100,50,50,76,96,70,442,0.5,85,70,80,97,80,123,535,0.9304347826086956,1.0
85,80,90,105,95,60,515,0.49074074074074076,50,48,43,46,41,60,288,0.47297297297297297,1.0
58,50,145,95,105,30,483,0.2459016393442623,65,65,65,50,50,90,385,0.72,1.0
90,55,75,60,75,30,385,0.13970588235294118,100,120,100,150,120,90,680,0.728,1.0
45,100,135,65,135,45,525,0.29411764705882354,60,50,70,80,80,140,480,0.8449612403100775,1.0
68,85,65,165,135,100,618,0.8083333333333333,65,136,94,54,96,135,580,0.9612403100775194,2.0
50,100,150,100,150,50,600,0.37142857142857144,125,120,90,170,100,95,700,0.78125,4.0
50,85,125,85,115,20,480,0.4306569343065693,40,20,30,40,80,55,265,0.22764227642276422,1.0
40,45,65,100,120,90,460,0.5588235294117647,50,150,50,150,50,150,600,0.9339622641509434,0.5
101,72,72,99,89,29,462,0.1937984496124031,55,95,115,45,45,35,390,0.2116788321167883,1.0
50,50,120,80,80,30,410,0.07258064516129033,75,103,80,70,80,92,500,0.7933884297520661,8.0
50,85,125,85,115,20,480,0.4306569343065693,65,136,94,54,96,135,580,0.9612403100775194,0.0
75,87,63,87,63,98,473,0.865546218487395,46,87,60,30,40,57,320,0.37777777777777777,0.5
70,150,140,65,100,75,600,0.55,100,5,5,15,65,30,220,0.07692307692307693,1.0
100,110,90,85,90,60,535,0.47794117647058826,65,125,100,55,70,85,500,0.6532258064516129,0.5
70,135,105,60,105,20,495,0.5806451612903226,70,65,65,55,55,70,380,0.5,1.0
50,48,43,46,41,60,288,0.47297297297297297,103,60,126,80,126,50,545,0.36363636363636365,1.0
40,65,40,80,40,65,330,0.5038167938931297,67,125,40,30,30,58,350,0.3431372549019608,1.0
80,92,65,65,80,68,450,0.4824561403508772,75,80,70,65,75,90,455,0.7578125,1.0
75,80,60,65,90,102,472,0.8625954198473282,55,35,50,55,110,85,390,0.6277372262773723,1.0
45,30,35,20,20,45,195,0.14782608695652175,125,130,90,130,90,95,660,0.7734375,1.0
45,30,50,65,50,45,285,0.13821138211382114,50,47,50,57,50,65,319,0.463768115942029,1.0
50,52,48,65,50,55,320,0.33098591549295775,60,60,50,40,50,75,335,0.5882352941176471,0.5
70,85,140,85,70,20,470,0.272,60,85,42,85,42,91,405,0.8227848101265823,1.0
75,100,95,40,70,110,490,0.8717948717948718,35,55,35,30,30,35,220,0.23684210526315788,1.0
60,85,42,85,42,91,405,0.8227848101265823,44,58,44,58,44,61,309,0.41964285714285715,1.0
35,64,85,74,55,32,345,0.19827586206896552,95,75,80,100,110,30,490,0.24242424242424243,0.5
100,120,120,150,100,90,680,0.7880794701986755,53,51,53,61,56,40,314,0.14285714285714285,0.5
60,62,63,80,80,60,405,0.38016528925619836,38,35,40,27,25,35,200,0.08208955223880597,0.5
50,52,48,65,50,55,320,0.33098591549295775,76,104,71,104,71,108,534,0.912751677852349,2.0
67,89,116,79,116,33,500,0.2624113475177305,68,90,65,50,55,82,410,0.6165413533834586,2.0
50,65,107,105,107,86,520,0.7313432835820896,80,80,90,110,130,110,600,0.8721804511278195,0.25
90,92,75,92,85,60,494,0.49586776859504134,40,45,40,65,40,65,295,0.5661764705882353,1.0
100,150,90,180,160,90,770,0.7348484848484849,80,95,82,60,82,75,474,0.6,1.0
40,29,45,29,45,36,224,0.14634146341463414,61,78,95,56,58,57,405,0.40336134453781514,2.0
68,90,65,50,55,82,410,0.6165413533834586,55,130,115,50,50,75,475,0.5982142857142857,1.0
75,70,90,70,105,80,490,0.656,70,105,105,50,40,20,390,0.33587786259541985,0.5
55,47,52,40,40,41,275,0.16806722689075632,90,92,75,92,85,60,494,0.49586776859504134,2.0
54,78,103,53,45,22,355,0.23255813953488372,110,65,75,125,85,30,490,0.15,1.0
62,44,50,44,50,55,305,0.3629032258064516,75,70,90,70,105,80,490,0.656,0.5
95,65,110,60,130,65,525,0.5275590551181102,100,128,90,77,77,128,600,0.959349593495935,0.5
100,100,90,150,140,90,670,0.71875,125,130,90,130,90,95,660,0.7734375,0.5
60,82,45,45,45,74,351,0.5752212389380531,82,80,86,85,75,72,480,0.6183206106870229,0.5
60,80,50,50,50,40,330,0.23853211009174313,78,84,78,109,85,100,534,0.8646616541353384,1.0
90,120,120,60,60,50,500,0.35294117647058826,70,90,110,60,75,95,500,0.7333333333333333,2.0
45,53,70,40,60,42,310,0.25735294117647056,65,130,60,75,60,75,465,0.689922480620155,2.0
48,61,40,61,40,50,300,0.2543859649122807,40,55,99,40,79,47,360,0.26262626262626265,0.125
75,140,65,112,65,110,567,0.9140625,60,62,50,62,60,40,334,0.18181818181818182,4.0
79,100,80,110,90,121,580,0.968,80,70,65,80,120,100,515,0.8034188034188035,1.0
85,80,70,135,75,90,535,0.7006802721088435,30,40,70,70,25,60,295,0.41353383458646614,1.0
75,90,90,140,90,115,600,0.9481481481481482,80,82,83,100,100,80,525,0.6742424242424242,2.0
65,76,84,54,96,105,480,0.9008264462809917,100,134,110,95,100,61,600,0.4057971014492754,0.5
85,97,66,105,66,65,484,0.47107438016528924,70,110,180,60,60,50,530,0.4117647058823529,1.0
64,66,68,81,76,50,405,0.25190839694656486,111,83,68,92,82,39,475,0.1774193548387097,1.0
55,130,115,50,50,75,475,0.5982142857142857,60,55,50,40,55,45,305,0.22377622377622378,1.0
68,65,65,125,115,80,518,0.6461538461538462,50,45,45,35,35,50,260,0.23529411764705882,1.0
120,120,120,120,120,120,720,0.9344262295081968,71,120,95,120,95,99,600,0.8203125,0.5
95,70,73,95,90,60,483,0.3983739837398374,100,100,100,100,100,100,600,0.831858407079646,1.0
55,69,85,32,35,28,304,0.09302325581395349,35,70,55,45,55,25,285,0.09420289855072464,2.0
60,115,105,65,70,80,495,0.7181818181818181,90,95,105,165,110,45,610,0.2890625,0.5
50,35,55,25,25,15,205,0.021739130434782608,50,20,40,20,40,20,190,0.0962962962962963,0.5
80,120,130,55,65,45,495,0.37037037037037035,80,100,70,50,60,45,405,0.25806451612903225,0.5
40,35,30,20,20,50,195,0.23423423423423423,55,112,45,74,45,70,401,0.559322033898305,0.25
120,120,120,120,120,120,720,0.9344262295081968,75,38,38,56,56,67,330,0.5263157894736842,1.0
40,70,130,60,130,25,455,0.17355371900826447,60,60,60,105,105,105,495,0.848,2.0
50,65,107,105,107,86,520,0.703125,123,77,72,99,92,58,521,0.4621212121212121,0.5
75,95,125,45,75,95,510,0.8257575757575758,50,65,85,35,35,55,325,0.32575757575757575,1.0
82,121,119,69,59,71,521,0.5394736842105263,90,65,65,40,40,15,315,0.19672131147540983,1.0
80,125,75,40,95,85,500,0.6911764705882353,74,48,76,83,81,104,466,0.7913043478260869,1.0
44,50,91,24,86,10,305,0.1981981981981982,95,65,65,110,130,60,525,0.4016393442622951,0.5
85,105,55,85,50,115,495,0.9032258064516129,75,98,63,98,63,101,498,0.889763779527559,2.0
125,170,100,120,90,95,700,0.77,50,53,48,53,48,64,316,0.4076923076923077,2.0
70,75,60,105,60,105,475,0.88,60,85,69,60,69,77,420,0.518796992481203,1.0
60,95,80,60,80,30,405,0.19480519480519481,63,60,55,50,50,71,349,0.5289256198347108,0.25
55,70,40,60,40,40,305,0.26956521739130435,60,75,100,55,80,50,420,0.3088235294117647,0.5
95,125,79,60,100,81,540,0.6165413533834586,63,63,47,41,41,74,329,0.56,1.0
106,150,70,194,120,140,780,0.952,75,100,95,40,70,110,490,0.8717948717948718,1.0
65,45,55,45,70,45,325,0.24369747899159663,60,40,50,75,85,95,405,0.6044776119402985,1.0
80,105,105,105,105,80,580,0.5939849624060151,50,20,55,25,25,30,205,0.09774436090225563,1.0
71,82,64,64,59,112,452,0.9327731092436975,40,45,40,62,60,60,307,0.33884297520661155,1.0
100,110,90,85,90,60,535,0.47794117647058826,53,54,53,37,46,45,288,0.3090909090909091,1.0
90,100,70,110,150,80,600,0.6037735849056604,35,55,40,45,40,60,275,0.35714285714285715,1.0
80,135,85,70,95,150,615,0.9844961240310077,75,98,63,98,63,101,498,0.889763779527559,2.0
65,125,100,55,70,85,500,0.6532258064516129,60,55,90,145,90,80,520,0.6071428571428571,0.25
53,51,53,61,56,40,314,0.14285714285714285,80,80,80,80,80,80,480,0.6015037593984962,1.0
60,100,89,55,69,112,485,0.9298245614035088,50,75,35,70,30,40,300,0.21296296296296297,1.0
20,10,55,15,20,80,200,0.17985611510791366,55,63,90,50,80,42,380,0.21138211382113822,0.5
40,40,40,70,40,20,250,0.032520325203252036,60,110,70,60,60,100,460,0.8461538461538461,1.0
106,90,130,90,154,110,680,0.8699186991869918,20,40,90,30,90,25,295,0.11363636363636363,1.0
68,72,78,38,42,32,330,0.23809523809523808,75,123,67,95,85,95,540,0.7642276422764228,2.0
85,110,76,65,82,56,474,0.3933333333333333,60,40,60,40,60,35,295,0.18055555555555555,0.5
40,45,35,40,40,90,290,0.65,110,130,80,70,60,80,530,0.5862068965517241,1.0
77,120,90,60,90,48,485,0.2785714285714286,75,98,63,98,63,101,498,0.8091603053435115,1.0
60,60,60,60,60,60,360,0.38095238095238093,106,150,70,194,120,140,780,0.952,1.0
60,150,50,150,50,60,520,0.5,70,140,70,110,65,105,560,0.95,0.25
90,92,87,75,85,76,505,0.5409836065573771,80,110,60,150,130,70,600,0.5042016806722689,0.5
90,132,105,132,105,30,594,0.4246575342465753,100,150,120,120,100,90,680,0.6493506493506493,1.0
91,90,106,130,106,77,600,0.648854961832061,70,92,65,80,55,98,460,0.8090909090909091,0.25
50,120,53,35,110,87,455,0.640625,75,98,63,98,63,101,498,0.8091603053435115,1.0
65,50,35,115,95,95,455,0.7333333333333333,78,130,111,130,85,100,634,0.8561151079136691,1.0
60,65,70,85,75,40,395,0.21705426356589147,90,132,105,132,105,30,594,0.4246575342465753,1.0
90,120,100,150,120,100,680,0.7718120805369127,50,40,85,40,65,25,305,0.08870967741935484,1.0
60,105,60,120,60,105,510,0.8849557522123894,35,20,65,40,65,20,245,0.02459016393442623,0.5
38,30,85,55,65,30,303,0.21428571428571427,70,60,75,110,75,90,480,0.7165354330708661,1.0
50,75,45,40,45,60,315,0.4380165289256198,81,102,77,85,75,85,505,0.5642857142857143,0.5
75,80,95,90,100,50,490,0.2158273381294964,60,75,100,55,80,50,420,0.3088235294117647,0.5
70,110,80,55,80,105,500,0.8794326241134752,97,165,60,65,50,58,495,0.3902439024390244,0.5
55,50,65,175,95,150,590,0.7818181818181819,80,100,70,50,60,45,405,0.25806451612903225,1.0
40,55,30,30,30,85,270,0.688,50,30,55,65,55,20,275,0.13675213675213677,0.0
75,110,110,110,105,80,590,0.656934306569343,73,100,60,100,60,65,458,0.42657342657342656,0.5
72,95,67,103,71,122,530,0.9606299212598425,80,100,123,122,120,80,625,0.56,0.5
68,75,53,83,113,60,452,0.45384615384615384,60,70,65,125,105,90,515,0.6911764705882353,1.0
100,150,120,120,100,90,680,0.6493506493506493,45,53,70,40,60,42,310,0.25735294117647056,0.5
50,50,120,80,80,30,410,0.07258064516129033,44,75,35,63,33,45,295,0.2647058823529412,1.0
66,117,70,40,50,67,410,0.4573643410852713,70,55,95,95,110,65,490,0.48872180451127817,1.0
65,105,60,60,70,95,455,63.0,40,45,35,30,40,55,245,0.3793103448275862,0.25
80,50,100,100,200,50,580,0.2357142857142857,110,85,95,80,95,50,515,0.2713178294573643,1.0
30,65,100,45,25,40,305,0.1891891891891892,114,85,70,85,80,30,464,0.2066115702479339,0.5
65,65,45,75,45,95,390,0.72,60,45,70,45,90,95,405,0.7304964539007093,0.5
50,85,40,85,40,35,335,0.1746031746031746,39,52,43,60,50,65,309,0.49107142857142855,0.5
65,90,120,85,70,60,490,0.43410852713178294,50,53,62,58,63,44,330,0.13709677419354838,1.0
70,80,70,80,70,110,480,0.6594202898550725,105,125,100,60,100,100,590,0.8359375,0.0
59,110,150,45,49,35,448,0.3333333333333333,95,124,78,69,71,58,495,0.37398373983739835,0.5
60,65,80,170,95,130,600,0.8625954198473282,44,75,35,63,33,45,295,0.2647058823529412,1.0
50,53,48,53,48,64,316,0.358974358974359,65,55,115,100,40,60,435,0.3798449612403101,0.5
100,77,77,128,128,90,600,0.6901408450704225,50,75,75,65,65,50,380,0.4049586776859504,0.0
30,65,100,45,25,40,305,0.1891891891891892,255,10,10,75,135,55,540,0.3125,1.0
58,50,145,95,105,30,483,0.2459016393442623,71,82,64,64,59,112,452,0.9327731092436975,0.0
50,20,55,25,25,30,205,0.09774436090225563,60,90,140,50,50,40,430,0.2535211267605634,0.5
56,61,65,48,45,38,313,0.17567567567567569,90,92,75,92,85,60,494,0.49586776859504134,0.5
50,20,40,20,40,20,190,0.0962962962962963,85,135,130,60,80,25,515,0.40540540540540543,0.5
106,150,70,194,120,140,780,0.952,90,55,75,60,75,30,385,0.13970588235294118,1.0
90,65,65,40,40,15,315,0.19672131147540983,55,70,55,40,55,85,360,0.7073170731707317,1.0
75,70,90,70,105,80,490,0.656,86,92,88,68,75,73,482,0.6835443037974683,1.0
63,63,47,41,41,74,329,0.56,170,90,45,90,45,60,500,0.427536231884058,1.0
125,120,90,170,100,95,700,0.78125,75,89,85,55,65,36,405,0.29545454545454547,2.0
39,52,43,60,50,65,309,0.49107142857142855,150,120,100,120,100,90,680,0.664179104477612,0.5
45,35,50,70,50,30,280,0.15753424657534246,45,30,50,65,50,45,285,0.13821138211382114,1.0
70,110,70,115,70,90,525,0.75,65,40,70,80,140,70,465,0.5954198473282443,0.25
90,85,75,115,100,115,580,0.9381443298969072,95,135,80,110,80,100,600,0.8248175182481752,1.0
60,70,50,100,50,65,395,0.5217391304347826,165,75,80,40,45,65,470,0.5151515151515151,1.0
55,45,50,45,65,80,340,0.5546218487394958,91,72,90,129,90,108,580,0.8620689655172413,4.0
100,120,100,150,120,90,680,0.728,60,60,50,40,50,75,335,0.5882352941176471,2.0
55,40,40,65,45,35,280,0.16428571428571428,81,102,77,85,75,85,505,0.5642857142857143,0.0
95,95,85,125,65,55,520,0.3894736842105263,35,55,35,30,30,35,220,0.23684210526315788,0.0
35,55,40,50,50,90,320,0.6838235294117647,70,115,60,115,60,55,475,0.4647887323943662,0.5
72,95,67,103,71,122,530,0.9606299212598425,75,103,80,70,80,92,500,0.7933884297520661,0.5
53,54,53,37,46,45,288,0.3090909090909091,40,40,55,40,70,55,300,0.40939597315436244,2.0
99,68,83,72,87,51,460,0.417910447761194,60,80,50,40,40,30,300,0.15328467153284672,1.0
60,70,50,100,50,65,395,0.5217391304347826,76,48,48,57,62,34,325,0.11688311688311688,1.0
70,60,70,87,78,85,450,0.6228070175438597,70,45,48,60,65,35,323,0.15748031496062992,1.0
30,56,35,25,35,72,253,0.48148148148148145,35,55,40,45,40,60,275,0.35714285714285715,1.0
100,110,90,85,90,60,535,0.47794117647058826,125,120,90,170,100,95,700,0.78125,0.5
100,73,83,73,83,55,467,0.371900826446281,90,120,75,60,60,45,450,0.29411764705882354,2.0
80,80,90,110,130,110,600,0.8721804511278195,58,89,77,45,45,48,362,0.3177570093457944,2.0
65,80,80,59,63,58,405,0.4411764705882353,78,52,60,63,65,23,341,0.06015037593984962,1.0
70,77,60,97,60,108,472,0.8394160583941606,40,45,35,65,55,70,310,0.4482758620689655,1.0
55,84,105,114,75,52,485,0.2890625,115,140,130,55,55,40,535,0.4519230769230769,4.0
40,40,35,50,100,70,335,0.5031847133757962,80,70,40,100,60,145,495,0.921875,1.0
75,105,75,105,75,45,480,0.3274336283185841,45,50,43,40,38,62,278,0.40441176470588236,1.0
125,58,58,76,76,67,460,0.515625,45,100,45,45,45,10,290,0.2949640287769784,0.0
74,100,72,90,72,46,454,0.24561403508771928,62,50,58,73,54,72,369,0.4435483870967742,0.5
48,61,40,61,40,50,300,0.2543859649122807,85,80,90,105,95,60,515,0.49074074074074076,2.0
75,125,75,30,75,85,465,0.625,100,128,90,77,77,128,600,0.959349593495935,2.0
28,25,25,45,35,40,198,0.16083916083916083,75,100,63,80,63,116,497,0.9345794392523364,1.0
50,105,79,35,110,76,455,0.6214285714285714,50,65,107,105,107,86,520,0.6991150442477876,1.0
65,85,70,75,70,40,405,0.203125,61,72,57,55,55,65,365,0.3984375,1.0
105,140,95,55,65,45,505,0.3,60,80,110,50,80,45,425,0.2833333333333333,1.0
72,105,115,54,86,68,500,0.5149253731343284,71,73,88,120,89,59,500,0.43537414965986393,0.5
49,49,56,49,61,66,330,0.5190839694656488,77,59,50,67,63,46,362,0.23140495867768596,2.0
40,20,30,40,80,55,265,0.22764227642276422,60,60,75,60,75,80,410,0.7321428571428571,2.0
60,85,60,85,60,55,405,0.3673469387755102,50,85,40,85,40,35,335,0.1746031746031746,2.0
70,60,62,80,82,60,414,0.4375,45,53,70,40,60,42,310,0.25735294117647056,8.0
106,190,100,154,100,130,780,0.9259259259259259,50,40,85,40,65,25,305,0.08870967741935484,0.5
104,91,63,91,73,68,490,0.5118110236220472,105,125,100,60,100,100,590,0.8359375,1.0
60,55,145,75,150,40,525,0.2,70,55,75,45,65,60,370,0.45901639344262296,2.0
100,150,90,180,160,90,770,0.7348484848484849,71,73,88,120,89,59,500,0.43537414965986393,0.5
61,84,65,70,70,70,420,0.5,80,120,130,55,65,45,495,0.37037037037037035,1.0
50,75,45,40,45,60,315,0.4380165289256198,80,82,100,83,100,80,525,0.6821705426356589,2.0
80,100,200,50,100,50,580,0.3472222222222222,59,110,150,45,49,35,448,0.3333333333333333,0.5
78,70,61,50,61,100,420,0.8145161290322581,50,65,90,35,35,15,290,0.14678899082568808,1.0
75,95,95,95,95,85,540,0.6470588235294118,95,75,180,130,80,30,590,0.13793103448275862,0.5
60,80,50,50,50,40,330,0.23853211009174313,61,72,57,55,55,65,365,0.3984375,1.0
50,160,110,160,110,110,700,0.8854961832061069,97,165,60,65,50,58,495,0.3902439024390244,1.0
90,85,75,115,100,115,580,0.9381443298969072,50,65,107,105,107,86,520,0.7272727272727273,1.0
75,95,125,45,75,95,510,0.8257575757575758,100,110,90,85,90,60,535,0.47794117647058826,1.0
35,55,40,45,40,60,275,0.35714285714285715,73,95,62,85,65,85,465,0.6666666666666666,1.0
60,95,80,60,80,30,405,0.19480519480519481,123,100,62,97,81,68,531,0.4806201550387597,1.0
100,77,77,128,128,90,600,0.6901408450704225,65,80,80,59,63,58,405,0.4411764705882353,1.0
50,75,75,65,65,50,380,0.4049586776859504,100,150,90,180,160,90,770,0.7348484848484849,1.0
80,145,150,105,110,110,700,0.8692307692307693,67,58,57,81,67,101,431,0.8790322580645161,0.25
69,55,45,55,55,15,294,0.11666666666666667,30,80,90,55,45,55,355,0.4295774647887324,2.0
50,75,70,35,70,48,348,0.29357798165137616,95,135,80,110,80,100,600,0.8248175182481752,0.5
60,95,80,60,80,30,405,0.19480519480519481,105,95,75,85,75,74,509,0.5714285714285714,4.0
71,73,88,120,89,59,500,0.43537414965986393,70,84,70,65,70,51,410,0.2949640287769784,4.0
50,95,180,85,45,70,525,0.5298507462686567,50,95,95,35,110,70,455,0.5179856115107914,1.0
75,95,125,45,75,95,510,0.8257575757575758,72,60,30,20,30,25,237,0.11570247933884298,2.0
60,52,168,47,138,30,495,0.19834710743801653,80,100,80,80,80,100,520,0.9051724137931034,0.5
30,30,42,30,42,70,244,0.4230769230769231,70,100,70,105,75,40,460,0.23214285714285715,0.5
61,78,95,56,58,57,405,0.40336134453781514,86,68,72,109,66,106,507,0.8099173553719008,0.5
63,120,85,90,55,55,468,0.2809917355371901,35,20,65,40,65,20,245,0.02459016393442623,0.5
65,90,122,58,75,84,494,0.71875,60,45,70,45,90,95,405,0.7304964539007093,1.0
60,82,45,45,45,74,351,0.5752212389380531,90,85,100,95,125,85,580,0.6834532374100719,0.0
40,40,40,70,40,20,250,0.032520325203252036,68,90,65,50,55,82,410,0.6165413533834586,0.5
89,145,90,105,80,91,600,0.8549618320610687,91,129,90,72,90,108,580,0.8536585365853658,2.0
50,95,90,95,90,180,600,0.9172413793103448,60,85,42,85,42,91,405,0.8227848101265823,0.0
77,85,51,55,51,65,384,0.5163934426229508,60,65,70,85,75,40,395,0.21705426356589147,1.0
50,80,95,10,45,10,290,0.232,55,55,55,85,55,30,335,0.1320754716981132,1.0
66,65,48,62,57,52,350,0.36220472440944884,60,130,80,60,60,70,460,0.5153846153846153,0.5
106,190,100,154,100,130,780,0.9259259259259259,60,80,50,40,40,30,300,0.15328467153284672,0.5
90,132,105,132,105,30,594,0.4246575342465753,106,110,90,154,90,130,680,0.926829268292683,1.0
70,85,70,60,70,50,405,0.28378378378378377,75,69,72,114,100,104,534,0.8253968253968254,4.0
60,55,145,75,150,40,525,0.2,72,85,70,65,70,58,420,0.41304347826086957,1.0
35,35,40,35,55,50,250,0.40336134453781514,85,56,77,50,77,78,423,0.53125,2.0
63,60,55,50,50,71,349,0.5289256198347108,85,97,66,105,66,65,484,0.47107438016528924,1.0
110,135,60,50,65,88,508,0.7744360902255639,75,105,75,105,75,45,480,0.3274336283185841,0.5
50,60,45,100,80,65,400,0.45689655172413796,49,66,70,44,55,51,335,0.4260869565217391,0.5
62,55,52,109,94,109,481,0.7833333333333333,75,100,110,45,55,65,450,0.5333333333333333,0.0
70,90,90,135,90,125,600,0.9401709401709402,45,30,50,65,50,45,285,0.13821138211382114,2.0
50,85,55,65,65,90,410,0.7478260869565218,35,65,35,65,35,65,300,0.46621621621621623,0.5
75,98,63,98,63,101,498,0.849624060150376,20,10,230,10,230,5,505,0.0,2.0
40,50,45,70,45,70,320,0.5517241379310345,90,120,120,60,60,50,500,0.35294117647058826,2.0
55,75,85,25,25,15,280,0.1875,80,50,100,100,200,50,580,0.2357142857142857,2.0
126,131,95,131,98,99,680,0.8294573643410853,45,65,34,40,34,45,263,0.2589928057553957,1.0
50,120,53,35,110,87,455,0.640625,40,30,50,55,55,100,330,0.584070796460177,1.0
84,86,88,111,101,60,530,0.4634146341463415,90,95,95,70,90,70,510,0.5230769230769231,0.25
45,50,55,75,65,30,320,0.06293706293706294,86,68,72,109,66,106,507,0.8099173553719008,0.5
90,60,60,40,40,40,330,0.29545454545454547,86,76,86,116,56,95,515,0.7982456140350878,0.0
55,40,85,80,105,40,405,0.23622047244094488,50,55,50,36,30,43,264,0.2922077922077922,1.0
75,75,55,105,85,30,425,0.1619718309859155,89,124,80,55,80,55,483,0.5714285714285714,2.0
69,55,45,55,55,15,294,0.11666666666666667,75,80,60,65,90,102,472,0.8625954198473282,1.0
60,45,70,45,90,95,405,0.7304964539007093,76,147,90,60,70,97,540,0.8267716535433071,0.5
100,123,75,57,75,80,510,0.6923076923076923,72,105,115,54,86,68,500,0.5149253731343284,0.25
70,80,102,80,102,40,474,0.2677165354330709,45,22,60,27,30,29,213,0.07518796992481203,2.0
45,49,49,65,65,45,318,0.2781954887218045,80,100,200,50,100,50,580,0.3472222222222222,1.0
30,45,55,70,55,85,340,0.5633802816901409,85,80,70,135,75,90,535,0.7006802721088435,1.0
45,50,55,75,65,30,320,0.06293706293706294,68,85,65,165,135,100,618,0.8083333333333333,2.0
90,60,70,75,70,45,410,0.23880597014925373,100,75,115,90,115,85,580,0.6446280991735537,0.25
50,75,70,35,70,48,348,0.29357798165137616,40,45,35,40,40,90,290,0.65,2.0
79,85,60,55,60,71,410,0.60431654676259,110,160,110,80,110,100,670,0.8591549295774648,1.0
45,63,37,65,55,95,360,0.8055555555555556,45,75,37,70,55,83,365,0.6183206106870229,1.0
20,25,45,70,90,60,310,0.30833333333333335,95,125,79,60,100,81,540,0.6165413533834586,1.0
41,50,37,50,37,66,281,0.5175438596491229,50,50,95,40,50,35,320,0.20279720279720279,1.0
80,120,70,110,70,80,530,0.6422764227642277,50,65,45,85,65,95,405,0.7238095238095238,2.0
65,65,60,130,95,110,525,0.823943661971831,80,80,90,110,130,110,600,0.8721804511278195,0.5
75,75,95,75,95,113,528,0.9015151515151515,44,38,39,61,79,42,303,0.2251655629139073,1.0
50,85,40,85,40,35,335,0.1746031746031746,44,48,65,50,64,43,314,0.1623931623931624,2.0
80,90,80,130,110,110,600,0.856,55,104,105,94,75,52,485,0.36363636363636365,1.0
70,140,230,60,80,50,630,0.32432432432432434,65,83,57,95,85,105,490,0.8914728682170543,0.5
90,95,105,165,110,45,610,0.2890625,60,85,60,85,60,55,405,0.3673469387755102,1.0
50,50,95,40,50,35,320,0.20279720279720279,60,85,40,30,45,68,328,0.6422018348623854,1.0
85,80,70,135,75,90,535,0.7006802721088435,38,30,85,55,65,30,303,0.21428571428571427,0.0
160,110,65,65,110,30,540,0.35714285714285715,70,120,65,45,85,125,510,0.9747899159663865,1.0
70,140,70,110,65,105,560,0.95,70,65,65,55,55,70,380,0.5,1.0
60,65,70,85,75,40,395,0.21705426356589147,80,120,79,95,79,70,523,0.5833333333333334,1.0
60,40,80,60,45,40,325,0.23529411764705882,65,75,70,95,70,95,470,0.7272727272727273,0.25
40,45,40,35,35,56,251,0.373015873015873,79,115,70,125,80,111,580,0.864,0.5
57,80,91,80,87,75,470,0.5737704918032787,70,90,70,60,60,70,420,0.6390977443609023,2.0
45,75,37,70,55,83,365,0.6183206106870229,65,40,50,125,60,30,370,0.07258064516129033,1.0
73,115,60,60,60,90,458,0.6694915254237288,60,100,115,70,85,90,520,0.7557251908396947,0.5
30,30,30,30,30,30,180,0.12612612612612611,100,150,140,100,90,90,670,0.7969924812030075,2.0
76,65,45,92,42,91,411,0.7449664429530202,108,112,118,68,72,47,525,0.2916666666666667,1.0
60,85,60,85,60,55,405,0.3673469387755102,70,110,70,115,70,90,525,0.75,4.0
80,120,80,120,80,100,580,0.8478260869565217,85,90,80,70,80,130,535,0.9262295081967213,2.0
91,90,106,130,106,77,600,0.648854961832061,65,110,130,60,65,95,525,0.8278145695364238,2.0
38,36,38,32,36,57,237,0.3893805309734513,60,55,50,40,55,45,305,0.22377622377622378,1.0
120,70,120,75,130,85,600,0.6694915254237288,92,105,90,125,90,98,600,0.8217054263565892,0.0
60,79,105,59,85,36,424,0.17054263565891473,60,75,100,55,80,50,420,0.3088235294117647,2.0
55,55,55,85,55,30,335,0.1320754716981132,50,85,55,65,65,90,410,0.7478260869565218,1.0
55,75,60,75,60,103,428,0.7982456140350878,45,49,49,65,65,45,318,0.2781954887218045,1.0
45,55,45,65,45,75,330,0.5692307692307692,79,100,80,110,90,121,580,0.968,2.0
28,25,25,45,35,40,198,0.16083916083916083,76,25,45,67,55,24,292,0.0390625,0.5
55,75,85,25,25,15,280,0.1875,45,49,65,49,65,45,318,0.275,1.0
60,45,70,45,90,95,405,0.7304964539007093,72,105,115,54,86,68,500,0.5149253731343284,2.0
67,82,62,46,48,43,348,0.22033898305084745,44,48,65,50,64,43,314,0.1623931623931624,1.0
78,92,75,74,63,118,500,0.8842975206611571,65,75,105,35,65,85,430,0.6940298507462687,0.5
78,81,71,74,69,126,499,0.9090909090909091,108,170,115,120,95,92,700,0.7083333333333334,0.5
60,50,50,60,70,50,340,0.28346456692913385,65,90,115,45,115,58,488,0.5041322314049587,1.0
105,140,95,55,65,45,505,0.3,60,115,105,65,70,80,495,0.7181818181818181,2.0
111,83,68,92,82,39,475,0.1774193548387097,110,135,60,50,65,88,508,0.7744360902255639,4.0
50,100,150,100,150,50,600,0.37142857142857144,74,48,76,83,81,104,466,0.7913043478260869,1.0
64,165,75,93,83,75,555,0.6587301587301587,60,40,60,95,60,55,370,0.4222222222222222,2.0
65,63,45,45,45,45,308,0.2595419847328244,50,70,160,70,160,90,600,0.7417218543046358,1.0
38,41,40,50,65,65,299,0.4108527131782946,60,110,70,60,60,100,460,0.8461538461538461,1.0
45,35,45,62,53,35,275,0.11851851851851852,45,60,40,70,50,45,310,0.2846715328467153,0.5
95,75,110,100,80,30,490,0.15267175572519084,50,160,110,160,110,110,700,0.8854961832061069,2.0
45,95,50,40,50,75,355,0.54,73,115,60,60,60,90,458,0.6694915254237288,1.0
85,135,130,60,80,25,515,0.40540540540540543,100,150,110,95,110,70,635,0.5923076923076923,0.5
60,110,70,60,60,100,460,0.8461538461538461,45,65,34,40,34,45,263,0.2589928057553957,0.5
55,112,45,74,45,70,401,0.559322033898305,70,90,45,15,45,50,315,0.3629032258064516,2.0
85,120,70,50,60,100,485,0.8308823529411765,73,115,60,60,60,90,458,0.6694915254237288,1.0
50,180,20,180,20,150,600,0.9029850746268657,60,60,60,35,35,30,280,0.11194029850746269,1.0
70,45,48,60,65,35,323,0.15748031496062992,59,63,80,65,80,58,405,0.41843971631205673,1.0
105,140,95,55,65,45,505,0.3,65,60,110,130,95,65,525,0.47761194029850745,2.0
44,48,65,50,64,43,314,0.1623931623931624,50,100,150,100,150,50,600,0.37142857142857144,2.0
85,115,80,105,80,50,515,0.3063063063063063,58,50,145,95,105,30,483,0.2459016393442623,1.0
80,82,100,83,100,80,525,0.6821705426356589,50,60,60,60,60,30,320,0.11290322580645161,1.0
80,70,70,90,100,70,480,0.5609756097560976,50,48,43,46,41,60,288,0.47297297297297297,4.0
45,50,35,55,75,40,300,0.21367521367521367,110,78,73,76,71,60,468,0.3333333333333333,1.0
76,65,45,92,42,91,411,0.7449664429530202,75,80,55,25,35,35,305,0.18666666666666668,2.0
70,105,105,50,40,20,390,0.33587786259541985,80,95,82,60,82,75,474,0.6,1.0
135,85,40,40,85,5,390,0.6864406779661016,60,75,100,55,80,50,420,0.3088235294117647,0.5
65,65,60,130,95,110,525,0.823943661971831,80,82,100,83,100,80,525,0.6821705426356589,1.0
60,60,60,35,35,30,280,0.11194029850746269,95,65,110,60,130,65,525,0.5275590551181102,1.0
75,85,200,55,65,30,510,0.16778523489932887,50,65,64,44,48,43,314,0.2196969696969697,0.5
255,10,10,75,135,55,540,0.3125,40,30,35,45,40,55,245,0.31496062992125984,1.0
65,90,65,61,61,100,442,0.8373983739837398,80,80,80,80,80,80,480,0.5606060606060606,1.0
60,48,45,43,90,42,328,0.21897810218978103,100,50,50,76,96,70,442,0.5,1.0
165,75,80,40,45,65,470,0.5151515151515151,60,40,80,60,45,40,325,0.23529411764705882,0.5
90,65,65,40,40,15,315,0.19672131147540983,85,56,77,50,77,78,423,0.53125,4.0
65,70,60,65,65,115,440,0.8583333333333333,65,80,80,59,63,58,405,0.4411764705882353,1.0
38,30,41,30,41,60,240,0.2897196261682243,60,60,60,85,85,85,435,0.631578947368421,0.0
65,47,55,73,75,85,400,0.65,75,80,70,65,75,90,455,0.7578125,0.25
55,65,35,60,30,85,330,0.6126126126126126,89,124,80,55,80,55,483,0.5714285714285714,2.0
60,40,80,60,45,40,325,0.23529411764705882,50,180,20,180,20,150,600,0.9029850746268657,0.5
115,45,20,45,25,20,270,0.11538461538461539,65,75,90,97,123,44,494,0.1987179487179487,1.0
105,180,100,180,100,115,780,0.9477611940298507,80,100,200,50,100,50,580,0.3472222222222222,0.5
50,92,108,92,108,35,485,0.2457627118644068,110,65,105,55,95,80,510,0.6258503401360545,0.25
77,59,50,67,63,46,362,0.23140495867768596,70,130,100,55,80,65,500,0.608,0.5
135,85,40,40,85,5,390,0.6864406779661016,50,75,45,40,45,60,315,0.4380165289256198,1.0
70,50,30,95,135,105,485,0.8040540540540541,65,95,57,100,85,93,495,0.7441860465116279,0.5
75,98,63,98,63,101,498,0.849624060150376,40,50,90,30,55,65,330,0.44680851063829785,1.0
60,90,70,60,120,40,440,0.27419354838709675,78,81,71,74,69,126,499,0.9090909090909091,1.0
59,74,50,35,50,35,303,0.3125,70,94,50,94,50,66,424,0.48148148148148145,0.0
41,64,45,50,50,50,300,0.36752136752136755,60,75,85,100,85,115,520,0.8992248062015504,1.0
70,77,60,97,60,108,472,0.8394160583941606,60,100,85,80,85,100,510,0.7007874015748031,1.0
80,135,130,95,90,70,600,0.5181818181818182,60,62,63,80,80,60,405,0.38016528925619836,2.0
80,120,79,95,79,70,523,0.5833333333333334,70,55,95,95,110,65,490,0.48872180451127817,1.0
60,62,80,63,80,60,405,0.4336283185840708,40,45,35,30,40,55,245,0.3793103448275862,0.25
75,125,70,125,70,115,580,0.9037037037037037,50,53,48,53,48,64,316,0.358974358974359,1.0
88,107,122,74,75,64,530,0.4596774193548387,85,56,77,50,77,78,423,0.53125,4.0
150,160,100,95,65,100,670,0.8866666666666667,90,70,80,70,95,70,475,0.5190839694656488,1.0
40,20,30,40,80,55,265,0.22764227642276422,40,40,35,50,100,70,335,0.5031847133757962,0.5
60,75,85,100,85,115,520,0.8992248062015504,81,102,77,85,75,85,505,0.5642857142857143,8.0
160,110,65,65,110,30,540,0.35714285714285715,80,82,100,83,100,80,525,0.6821705426356589,1.0
67,58,57,81,67,101,431,0.8790322580645161,70,150,140,65,100,75,600,0.55,0.5
68,75,53,83,113,60,452,0.45384615384615384,75,100,66,60,66,115,482,0.918918918918919,1.0
66,41,77,61,87,23,355,0.12096774193548387,55,55,85,65,85,35,380,0.2014388489208633,4.0
88,107,122,74,75,64,530,0.4596774193548387,65,63,45,45,45,45,308,0.2595419847328244,0.5
100,100,100,100,100,100,600,0.8758169934640523,20,10,230,10,230,5,505,0.0,2.0
75,95,95,95,95,85,540,0.6470588235294118,95,75,180,130,80,30,590,0.13793103448275862,0.5
75,140,65,112,65,110,567,0.9140625,70,135,105,60,105,20,495,0.5806451612903226,1.0
79,105,70,145,80,101,580,0.8608695652173913,70,110,180,60,60,50,530,0.4117647058823529,0.25
50,65,45,85,65,95,405,0.7238095238095238,75,110,110,110,105,80,590,0.656934306569343,0.5
90,95,95,70,90,70,510,0.5230769230769231,79,103,120,135,115,78,630,0.5763888888888888,0.5
75,125,100,70,80,45,495,0.33035714285714285,55,65,95,95,45,85,440,0.6610169491525424,1.0
55,40,85,80,105,40,405,0.23622047244094488,105,105,75,65,100,50,500,0.37593984962406013,0.5
35,55,40,45,40,60,275,0.35714285714285715,68,165,95,65,115,110,618,0.8615384615384616,1.0
60,90,140,50,50,40,430,0.2535211267605634,79,85,60,55,60,71,410,0.60431654676259,0.5
50,75,35,70,30,40,300,0.21296296296296297,70,50,30,95,135,105,485,0.8040540540540541,1.0
35,65,35,65,35,65,300,0.46621621621621623,65,95,100,60,50,50,420,0.34959349593495936,0.5
39,52,43,60,50,65,309,0.49107142857142855,50,35,55,25,25,15,205,0.05263157894736842,2.0
190,33,58,33,58,33,405,0.13432835820895522,45,25,50,25,25,35,205,0.13076923076923078,2.0
95,75,110,100,80,30,490,0.15267175572519084,135,85,40,40,85,5,390,0.6864406779661016,1.0
74,100,72,90,72,46,454,0.24561403508771928,40,45,40,65,40,65,295,0.5661764705882353,1.0
67,89,116,79,116,33,500,0.2624113475177305,57,24,86,24,86,23,300,0.12727272727272726,0.125
59,110,150,45,49,35,448,0.3333333333333333,62,77,62,50,42,65,358,0.4838709677419355,0.0
85,76,64,45,55,90,415,0.6739130434782609,40,60,30,31,31,70,262,0.4492753623188406,1.0
61,72,57,55,55,65,365,0.3984375,50,105,79,35,110,76,455,0.6214285714285714,1.0
130,85,80,85,95,60,535,0.43884892086330934,38,35,40,27,25,35,200,0.08208955223880597,1.0
30,56,35,25,35,72,253,0.48148148148148145,54,63,52,83,56,97,405,0.7697841726618705,1.0
80,95,82,60,82,75,474,0.6,70,85,70,60,70,50,405,0.28378378378378377,0.5
65,60,110,130,95,65,525,0.47761194029850745,45,35,50,70,50,30,280,0.15753424657534246,2.0
100,73,83,73,83,55,467,0.371900826446281,40,80,100,30,30,20,300,0.11851851851851852,0.25
65,110,130,60,65,95,525,0.8278145695364238,85,76,64,45,55,90,415,0.6739130434782609,1.0
103,60,126,80,126,50,545,0.36363636363636365,85,135,130,60,80,25,515,0.40540540540540543,0.5
60,50,150,50,150,60,520,0.5206611570247934,75,80,95,90,100,50,490,0.2158273381294964,1.0
100,103,75,120,75,127,600,0.940677966101695,56,61,65,48,45,38,313,0.17567567567567569,1.0
67,82,62,46,48,43,348,0.22033898305084745,125,120,90,170,100,95,700,0.78125,2.0
100,100,100,100,100,100,600,0.8602941176470589,55,84,105,114,75,52,485,0.2890625,2.0
62,50,58,73,54,72,369,0.4435483870967742,100,100,100,100,100,100,600,0.8602941176470589,2.0
250,5,5,35,105,50,450,0.15306122448979592,74,48,76,83,81,104,466,0.7913043478260869,1.0
74,94,131,54,116,20,489,0.4485294117647059,58,64,58,80,65,80,405,0.609271523178808,0.25
75,75,60,83,60,60,413,0.39344262295081966,85,110,76,65,82,56,474,0.3933333333333333,0.5
40,30,35,45,40,55,245,0.31496062992125984,70,40,50,55,50,25,290,0.061068702290076333,1.0
80,160,60,170,130,80,680,0.6180555555555556,65,63,45,45,45,45,308,0.2595419847328244,1.0
106,110,90,154,90,130,680,0.926829268292683,80,135,130,95,90,70,600,0.5181818181818182,0.25
60,50,100,85,70,65,430,0.47580645161290325,70,80,102,80,102,40,474,0.2677165354330709,2.0
45,60,32,50,32,76,295,0.5925925925925926,90,60,60,40,40,40,330,0.29545454545454547,0.0
125,130,90,130,90,95,660,0.7734375,100,100,80,60,60,50,450,0.3050847457627119,1.0
40,40,35,50,100,70,335,0.5031847133757962,60,85,60,85,60,55,405,0.3673469387755102,2.0
65,150,40,15,80,145,495,0.9663865546218487,70,120,65,45,85,125,510,0.9747899159663865,2.0
45,35,45,62,53,35,275,0.11851851851851852,100,77,77,128,128,90,600,0.6901408450704225,1.0
65,155,120,65,90,105,600,0.8677685950413223,50,180,20,180,20,150,600,0.9029850746268657,2.0
55,70,45,70,50,60,350,0.45,72,85,70,65,70,58,420,0.41304347826086957,0.5
150,160,100,95,65,100,670,0.8866666666666667,85,80,70,135,75,90,535,0.7006802721088435,1.0
62,44,50,44,50,55,305,0.3629032258064516,82,80,86,85,75,72,480,0.6183206106870229,1.0
75,100,110,45,55,65,450,0.5333333333333333,49,49,56,49,61,66,330,0.5190839694656488,1.0
60,82,45,45,45,74,351,0.5752212389380531,50,60,60,60,60,30,320,0.11290322580645161,2.0
20,40,90,30,90,25,295,0.11363636363636363,91,90,72,90,129,108,580,0.896,1.0
35,60,44,40,54,55,288,0.366412213740458,74,94,131,54,116,20,489,0.4485294117647059,0.0
45,30,50,55,65,45,290,0.208,70,80,102,80,102,40,474,0.2677165354330709,1.0
65,125,100,60,70,70,490,0.6099290780141844,40,55,30,30,30,85,270,0.688,1.0
70,50,30,95,135,105,485,0.8040540540540541,45,65,34,40,34,45,263,0.2589928057553957,1.0
60,90,140,50,50,40,430,0.2535211267605634,60,85,60,50,50,125,430,0.9090909090909091,2.0
55,130,115,50,50,75,475,0.5982142857142857,64,88,50,88,50,106,446,0.9111111111111111,1.0
120,120,120,120,120,120,720,0.9344262295081968,1,90,45,30,30,40,236,0.33064516129032256,0.0
69,55,45,55,55,15,294,0.11666666666666667,60,100,115,70,85,90,520,0.7557251908396947,0.0
80,50,100,100,200,50,580,0.2357142857142857,43,30,55,40,65,97,330,0.6030534351145038,0.5
100,150,140,100,90,90,670,0.7969924812030075,62,50,58,73,54,72,369,0.4435483870967742,2.0
105,125,100,60,100,100,590,0.8359375,38,30,85,55,65,30,303,0.21428571428571427,0.0
85,90,80,70,80,130,535,0.9262295081967213,40,70,130,60,130,25,455,0.17355371900826447,0.5
78,65,68,112,154,75,552,0.628099173553719,50,72,35,35,35,65,292,0.5373134328358209,2.0
65,150,40,15,80,145,495,0.9663865546218487,86,81,97,81,107,43,495,0.203125,2.0
70,85,65,105,85,120,530,0.9262295081967213,50,65,107,105,107,86,520,0.6991150442477876,0.5
70,70,115,130,90,60,535,0.5338983050847458,46,87,60,30,40,57,320,0.37777777777777777,0.5
100,123,75,57,75,80,510,0.6923076923076923,40,29,45,29,45,36,224,0.14634146341463414,2.0
95,75,110,100,80,30,490,0.15267175572519084,70,80,102,80,102,40,474,0.2677165354330709,1.0
55,45,45,25,25,15,210,0.048,65,47,55,73,75,85,400,0.65,0.5
50,75,70,35,70,48,348,0.29357798165137616,55,50,45,135,95,120,500,0.7714285714285715,1.0
40,45,65,100,120,90,460,0.5588235294117647,40,30,30,40,50,30,220,0.07936507936507936,1.0
85,105,100,79,83,78,530,0.5869565217391305,38,35,35,65,55,50,278,0.2647058823529412,1.0
105,30,105,140,105,55,540,0.3524590163934426,55,63,90,50,80,42,380,0.21138211382113822,4.0
40,60,40,40,40,30,250,0.0948905109489051,55,55,85,65,85,35,380,0.2014388489208633,0.5
75,80,95,90,100,50,490,0.2158273381294964,103,93,67,71,61,84,479,0.7142857142857143,0.5
50,85,55,65,65,90,410,0.7478260869565218,50,65,107,105,107,86,520,0.703125,2.0
100,50,80,60,80,50,420,0.34375,120,100,85,30,85,45,465,0.22448979591836735,2.0
50,160,110,160,110,110,700,0.8854961832061069,49,66,70,44,55,51,335,0.4260869565217391,1.0
70,140,70,110,65,105,560,0.95,75,110,110,110,105,80,590,0.656934306569343,0.25
100,100,100,100,100,100,600,0.8345864661654135,90,132,105,132,105,30,594,0.4246575342465753,0.5
84,71,43,71,43,48,360,0.25874125874125875,64,78,52,78,52,81,405,0.6422764227642277,1.0
80,80,80,80,80,80,480,0.6015037593984962,76,65,45,92,42,91,411,0.7449664429530202,2.0
106,110,90,154,90,130,680,0.926829268292683,68,125,65,65,115,80,518,0.6277372262773723,0.5
65,90,115,45,115,58,488,0.5041322314049587,55,95,115,45,45,35,390,0.2116788321167883,2.0
59,110,150,45,49,35,448,0.3333333333333333,55,104,105,94,75,52,485,0.36363636363636365,0.5
80,135,130,95,90,70,600,0.5181818181818182,30,65,100,45,25,40,305,0.1891891891891892,0.5
50,105,125,55,95,50,480,0.375886524822695,70,110,70,115,70,90,525,0.75,0.5
190,33,58,33,58,33,405,0.13432835820895522,50,95,180,85,45,70,525,0.5298507462686567,1.0
100,50,80,60,80,50,420,0.34375,38,30,85,55,65,30,303,0.21428571428571427,1.0
75,38,38,56,56,67,330,0.5263157894736842,30,40,70,70,25,60,295,0.41353383458646614,1.0
100,150,140,100,90,90,670,0.7969924812030075,70,60,125,115,70,55,495,0.35507246376811596,2.0
75,69,72,114,100,104,534,0.8253968253968254,105,30,105,140,105,55,540,0.3524590163934426,0.25
95,117,80,65,70,92,519,0.8409090909090909,70,50,30,95,135,105,485,0.8040540540540541,1.0
45,22,60,27,30,29,213,0.07518796992481203,85,80,90,105,95,60,515,0.49074074074074076,1.0
95,75,110,100,80,30,490,0.15267175572519084,150,160,100,95,65,100,670,0.8866666666666667,1.0
66,65,48,62,57,52,350,0.36220472440944884,45,60,40,70,50,45,310,0.2846715328467153,0.5
60,60,60,85,85,85,435,0.631578947368421,30,40,55,40,55,60,280,0.3237410071942446,2.0
61,72,57,55,55,65,365,0.3984375,75,55,70,55,95,110,460,0.8444444444444444,2.0
100,100,125,110,50,50,535,0.384,95,75,180,130,80,30,590,0.13793103448275862,2.0
60,60,60,105,105,105,495,0.848,60,60,60,35,35,30,280,0.11194029850746269,0.0
60,62,80,63,80,60,405,0.4336283185840708,50,52,48,65,50,55,320,0.33098591549295775,2.0
70,80,50,35,35,35,305,0.14,80,145,150,105,110,110,700,0.8692307692307693,1.0
44,38,39,61,79,42,303,0.2251655629139073,70,75,80,135,80,135,575,0.917910447761194,1.0
60,50,70,50,90,65,385,0.39568345323741005,110,65,75,125,85,30,490,0.15,2.0
50,53,62,58,63,44,330,0.13709677419354838,79,103,120,135,115,78,630,0.5763888888888888,0.5
72,85,70,65,70,58,420,0.41304347826086957,100,77,77,128,128,90,600,0.6901408450704225,2.0
77,59,50,67,63,46,362,0.23140495867768596,40,40,35,50,100,70,335,0.5031847133757962,0.5
125,58,58,76,76,67,460,0.515625,60,45,50,90,80,70,395,0.625,2.0
80,100,70,60,70,95,475,0.7416666666666667,100,100,90,150,140,90,670,0.71875,2.0
75,70,90,70,105,80,490,0.656,70,80,70,80,70,110,480,0.6594202898550725,1.0
105,125,100,60,100,100,590,0.8359375,50,180,20,180,20,150,600,0.9029850746268657,1.0
95,95,85,125,65,55,520,0.3894736842105263,68,72,78,38,42,32,330,0.23809523809523808,4.0
80,160,60,170,130,80,680,0.6180555555555556,55,50,40,40,40,75,300,0.5945945945945946,1.0
78,84,78,109,85,100,534,0.8646616541353384,20,10,55,15,20,80,200,0.17985611510791366,0.5
108,170,115,120,95,92,700,0.7083333333333334,60,65,80,170,95,130,600,0.8625954198473282,2.0
30,105,90,25,25,50,325,0.2773722627737226,90,130,80,65,85,55,505,0.4396551724137931,1.0
190,33,58,33,58,33,405,0.13432835820895522,75,90,140,60,60,40,465,0.3008130081300813,0.5
75,90,90,140,90,115,600,0.9481481481481482,35,55,40,50,50,90,320,0.6838235294117647,1.0
40,40,55,40,70,55,300,0.40939597315436244,80,160,80,130,80,100,630,0.8455284552845529,2.0
48,72,48,72,48,48,336,0.25984251968503935,95,109,105,75,85,56,525,0.34513274336283184,2.0
60,85,49,60,49,60,363,0.4444444444444444,10,55,25,35,45,95,265,0.5396825396825397,0.0
50,65,45,85,65,95,405,0.7238095238095238,60,70,50,100,50,65,395,0.5217391304347826,0.25
50,75,45,40,45,60,315,0.4380165289256198,100,150,90,180,160,90,770,0.7348484848484849,1.0
45,35,45,62,53,35,275,0.11851851851851852,70,60,62,80,82,60,414,0.4375,0.25
75,80,60,65,90,102,472,0.8625954198473282,85,90,80,70,80,130,535,0.9262295081967213,1.0
120,120,120,120,120,120,720,0.9344262295081968,55,50,65,175,95,150,590,0.7818181818181819,1.0
85,80,90,105,95,60,515,0.49074074074074076,108,112,118,68,72,47,525,0.2916666666666667,1.0
45,80,100,35,37,28,325,0.3125,70,70,115,130,90,60,535,0.5338983050847458,0.25
60,85,69,60,69,77,420,0.518796992481203,64,51,23,51,23,28,240,0.11363636363636363,1.0
80,160,60,170,130,80,680,0.6180555555555556,70,55,75,45,65,60,370,0.45901639344262296,0.0
55,70,45,70,50,60,350,0.45,109,66,84,81,99,32,471,0.2013888888888889,1.0
75,103,80,70,80,92,500,0.7933884297520661,70,40,50,55,50,25,290,0.061068702290076333,2.0
100,75,115,90,115,85,580,0.6446280991735537,73,95,62,85,65,85,465,0.6666666666666666,1.0
70,85,70,60,70,50,405,0.28378378378378377,70,62,67,55,55,56,365,0.38513513513513514,2.0
60,40,60,40,60,35,295,0.18055555555555555,65,75,105,35,65,85,430,0.6940298507462687,1.0
80,135,85,70,95,150,615,0.9844961240310077,65,155,120,65,90,105,600,0.8677685950413223,8.0
50,75,75,65,65,50,380,0.4049586776859504,82,121,119,69,59,71,521,0.5394736842105263,1.0
45,55,45,65,45,75,330,0.5692307692307692,85,76,64,45,55,90,415,0.6739130434782609,1.0
75,125,100,70,80,45,495,0.33035714285714285,80,100,70,60,70,95,475,0.7416666666666667,2.0
40,20,30,40,80,55,265,0.22764227642276422,41,50,37,50,37,66,281,0.5175438596491229,2.0
78,52,60,63,65,23,341,0.06015037593984962,60,40,80,60,45,40,325,0.23529411764705882,1.0
61,90,45,50,50,160,456,0.9230769230769231,50,50,95,40,50,35,320,0.20279720279720279,1.0
61,78,95,56,58,57,405,0.40336134453781514,100,100,100,100,100,100,600,0.8805970149253731,2.0
50,47,50,57,50,65,319,0.463768115942029,55,75,60,75,60,103,428,0.7982456140350878,0.5
70,110,180,60,60,50,530,0.4117647058823529,80,45,65,90,110,80,470,0.5462962962962963,1.0
99,68,83,72,87,51,460,0.417910447761194,50,50,120,80,80,30,410,0.07258064516129033,0.5
50,100,150,100,150,50,600,0.37142857142857144,65,105,60,60,70,95,455,63.0,1.0
63,60,55,50,50,71,349,0.5289256198347108,41,64,45,50,50,50,300,0.36752136752136755,1.0
80,120,79,95,79,70,523,0.5833333333333334,82,80,86,85,75,72,480,0.6183206106870229,1.0
60,60,60,35,35,30,280,0.11194029850746269,60,79,105,59,85,36,424,0.17054263565891473,1.0
90,60,60,40,40,40,330,0.29545454545454547,50,50,40,50,40,64,294,0.45588235294117646,1.0
69,69,76,69,86,91,460,0.6554621848739496,60,25,35,70,80,60,330,0.3076923076923077,1.0
83,80,75,70,70,101,479,0.8615384615384616,40,40,35,50,100,70,335,0.5031847133757962,1.0
80,105,65,60,75,130,515,0.9645390070921985,60,50,70,50,90,65,385,0.39568345323741005,4.0
70,120,65,45,85,125,510,0.9747899159663865,30,80,90,55,45,55,355,0.4295774647887324,0.5
40,29,45,29,45,36,224,0.14634146341463414,60,150,50,150,50,60,520,0.5,0.25
65,150,40,15,80,145,495,0.9663865546218487,86,92,88,68,75,73,482,0.6835443037974683,4.0
50,65,107,105,107,86,520,0.703125,55,45,50,45,65,80,340,0.5546218487394958,4.0
80,80,80,80,80,80,480,0.6015037593984962,250,5,5,35,105,50,450,0.15306122448979592,1.0
55,85,55,50,55,60,360,0.4233576642335766,55,112,45,74,45,70,401,0.559322033898305,0.25
70,135,105,60,105,20,495,0.5806451612903226,25,20,15,105,55,90,310,0.32407407407407407,2.0
60,95,80,60,80,30,405,0.19480519480519481,100,77,77,128,128,90,600,0.6901408450704225,2.0
70,77,60,97,60,108,472,0.8394160583941606,30,45,135,45,90,30,375,0.09285714285714286,1.0
60,85,60,85,60,55,405,0.3673469387755102,70,40,50,55,50,25,290,0.061068702290076333,2.0
90,100,90,125,85,90,580,0.7352941176470589,70,100,115,30,65,30,410,0.24390243902439024,0.25
70,130,100,55,80,65,500,0.608,35,35,35,35,35,35,210,0.13385826771653545,0.5
88,107,122,74,75,64,530,0.4596774193548387,65,90,115,45,115,58,488,0.5041322314049587,2.0
40,65,95,60,45,35,340,0.13986013986013987,60,85,60,85,60,55,405,0.3673469387755102,1.0
80,50,100,100,200,50,580,0.2357142857142857,68,165,95,65,115,110,618,0.8615384615384616,1.0
55,45,45,25,25,15,210,0.048,65,85,70,75,70,40,405,0.203125,2.0
75,100,110,45,55,65,450,0.5333333333333333,80,75,150,75,150,50,580,0.30973451327433627,2.0
80,52,50,90,50,89,411,0.6666666666666666,55,85,122,58,75,99,494,0.8099173553719008,2.0
110,65,105,55,95,80,510,0.6258503401360545,30,30,42,30,42,70,244,0.4230769230769231,2.0
50,65,107,105,107,86,520,0.7313432835820896,90,70,80,70,95,70,475,0.5190839694656488,4.0
100,120,100,150,120,90,680,0.728,60,100,85,80,85,100,510,0.7007874015748031,1.0
65,125,100,55,70,85,500,0.6532258064516129,59,45,40,35,40,31,250,0.14285714285714285,1.0
60,45,70,75,85,55,390,0.3008130081300813,67,57,55,77,55,114,425,0.8879310344827587,0.5
55,63,90,50,80,42,380,0.21138211382113822,75,140,65,112,65,110,567,0.9140625,0.5
60,70,105,70,120,75,500,0.5983606557377049,100,100,100,100,100,100,600,0.8758169934640523,0.5
45,60,30,80,50,65,330,0.4603174603174603,85,105,55,85,50,115,495,0.9032258064516129,0.5
85,135,130,60,80,25,515,0.40540540540540543,65,95,100,60,50,50,420,0.34959349593495936,1.0
68,90,65,50,55,82,410,0.6165413533834586,95,100,85,108,70,70,528,0.5652173913043478,1.0
70,70,40,60,40,60,340,0.4247787610619469,50,50,95,40,50,35,320,0.20279720279720279,2.0
30,35,30,100,35,80,310,0.4765625,70,94,50,94,50,66,424,0.48148148148148145,1.0
86,76,86,116,56,95,515,0.7982456140350878,40,35,30,120,70,105,400,0.6692307692307692,2.0
50,64,50,45,50,41,300,0.22727272727272727,170,90,45,90,45,60,500,0.427536231884058,1.0
65,75,105,35,65,85,430,0.6940298507462687,115,45,20,45,25,20,270,0.11538461538461539,1.0
25,35,70,95,55,45,325,0.16783216783216784,72,58,80,103,80,97,490,0.7171052631578947,2.0
62,48,66,59,57,49,341,0.33884297520661155,50,75,35,70,30,40,300,0.21296296296296297,0.5
45,40,60,40,75,50,310,0.2926829268292683,99,68,83,72,87,51,460,0.417910447761194,2.0
50,25,28,45,55,15,218,0.0625,50,20,40,20,40,20,190,0.0962962962962963,1.0
75,110,110,110,105,80,590,0.656934306569343,70,65,65,55,55,70,380,0.5,1.0
55,55,50,45,65,55,325,0.37373737373737376,75,98,63,98,63,101,498,0.889763779527559,1.0
40,55,80,35,60,30,300,0.15037593984962405,60,55,145,75,150,40,525,0.2,0.5
70,85,70,60,70,50,405,0.28378378378378377,60,60,60,85,85,85,435,0.631578947368421,1.0
104,91,63,91,73,68,490,0.5118110236220472,28,25,25,45,35,40,198,0.16083916083916083,1.0
65,125,60,95,60,105,510,0.9236641221374046,110,130,80,70,60,80,530,0.5862068965517241,2.0
74,48,76,83,81,104,466,0.7913043478260869,25,35,70,95,55,45,325,0.16783216783216784,0.5
165,75,80,40,45,65,470,0.5151515151515151,85,100,122,58,75,54,494,0.3939393939393939,0.5
10,55,25,35,45,95,265,0.5396825396825397,71,82,64,64,59,112,452,0.9327731092436975,1.0
20,25,45,70,90,60,310,0.30833333333333335,84,86,88,111,101,60,530,0.4634146341463415,0.25
78,84,78,109,85,100,534,0.8646616541353384,65,80,140,40,70,70,465,0.5223880597014925,1.0
20,15,20,10,55,80,200,0.2682926829268293,64,115,65,83,63,65,455,0.5323741007194245,1.0
95,95,85,125,65,55,520,0.3894736842105263,80,110,60,150,130,70,600,0.5042016806722689,0.5
65,80,140,40,70,70,465,0.5223880597014925,84,86,88,111,101,60,530,0.4634146341463415,0.125
70,65,65,55,55,70,380,0.5,80,160,80,130,80,100,630,0.8455284552845529,1.0
100,103,75,120,75,127,600,0.940677966101695,80,105,65,60,75,130,515,0.9645390070921985,0.5
65,50,35,115,95,95,455,0.7333333333333333,60,65,60,130,75,110,500,0.7719298245614035,2.0
54,66,70,44,55,46,335,0.4214876033057851,50,50,50,50,50,50,300,0.30708661417322836,1.0
75,100,110,45,55,65,450,0.5333333333333333,115,45,20,45,25,20,270,0.11538461538461539,1.0
85,50,95,120,115,80,545,0.5793650793650794,40,45,35,30,40,55,245,0.3793103448275862,0.5
66,65,48,62,57,52,350,0.36220472440944884,90,55,75,60,75,30,385,0.13970588235294118,1.0
70,95,125,65,75,45,475,0.33613445378151263,91,72,90,129,90,108,580,0.8620689655172413,0.25
80,45,65,90,110,80,470,0.5462962962962963,126,131,95,131,98,99,680,0.8294573643410853,1.0
105,130,120,45,45,40,485,0.4444444444444444,55,75,85,25,25,15,280,0.1875,2.0
70,120,65,45,85,125,510,0.9747899159663865,54,66,70,44,55,46,335,0.4214876033057851,4.0
67,58,57,81,67,101,431,0.8790322580645161,75,80,70,65,75,90,455,0.7578125,1.0
50,65,107,105,107,86,520,0.703125,91,90,106,130,106,77,600,0.648854961832061,0.25
90,92,75,92,85,60,494,0.49586776859504134,90,95,95,70,90,70,510,0.5230769230769231,1.0
55,65,35,60,30,85,330,0.6126126126126126,85,60,65,135,105,100,550,0.7518248175182481,2.0
83,106,65,86,65,85,490,0.6640625,45,85,70,40,40,60,340,0.5229357798165137,0.0
45,75,37,70,55,83,365,0.6183206106870229,55,20,35,20,45,75,250,0.37681159420289856,1.0
65,95,100,60,50,50,420,0.34959349593495936,85,80,90,105,95,60,515,0.49074074074074076,1.0
70,55,75,45,65,60,370,0.45901639344262296,58,64,58,80,65,80,405,0.5423728813559322,1.0
51,65,65,80,75,59,395,0.4365079365079365,76,104,71,104,71,108,534,0.912751677852349,0.5
44,48,65,50,64,43,314,0.1623931623931624,110,130,80,70,60,80,530,0.5862068965517241,2.0
35,55,35,30,30,35,220,0.23684210526315788,90,110,80,100,80,95,555,0.7982456140350878,1.0
90,100,60,90,60,80,480,0.6422764227642277,65,73,55,47,75,85,400,0.6846846846846847,0.5
50,85,55,65,65,90,410,0.7478260869565218,75,70,90,70,105,80,490,0.656,0.5
55,45,50,45,65,80,340,0.5546218487394958,35,70,55,45,55,25,285,0.09420289855072464,1.0
85,90,80,70,80,130,535,0.9262295081967213,63,120,85,90,55,55,468,0.2809917355371901,1.0
58,50,145,95,105,30,483,0.2459016393442623,65,90,50,85,45,55,390,0.371900826446281,1.0
100,5,5,15,65,30,220,0.07692307692307693,65,90,120,85,70,60,490,0.43410852713178294,1.0
60,115,105,65,70,80,495,0.7181818181818181,90,85,100,95,125,85,580,0.6834532374100719,4.0
78,65,68,112,154,75,552,0.628099173553719,40,80,100,30,30,20,300,0.11851851851851852,1.0
75,90,90,140,90,115,600,0.9481481481481482,30,45,135,45,90,30,375,0.09285714285714286,0.5
35,35,40,35,55,50,250,0.40336134453781514,40,40,50,30,30,30,220,0.0873015873015873,1.0
75,75,95,75,95,113,528,0.9015151515151515,106,110,90,154,90,130,680,0.926829268292683,1.0
100,75,115,90,115,85,580,0.6446280991735537,116,55,85,107,95,29,487,0.06818181818181818,1.0
55,70,45,70,50,60,350,0.45,40,20,30,40,80,55,265,0.22764227642276422,2.0
50,65,64,44,48,43,314,0.2196969696969697,45,90,20,65,20,65,305,0.5116279069767442,0.5
70,80,70,80,70,110,480,0.6594202898550725,95,23,48,23,48,23,260,0.046153846153846156,2.0
105,180,100,180,100,115,780,0.9477611940298507,60,62,50,62,60,40,334,0.18181818181818182,2.0
40,40,40,70,40,20,250,0.032520325203252036,60,85,42,85,42,91,405,0.8227848101265823,1.0
68,72,78,38,42,32,330,0.23809523809523808,65,65,60,110,95,130,525,0.9253731343283582,2.0
75,100,95,40,70,110,490,0.8717948717948718,75,55,70,55,95,110,460,0.8444444444444444,1.0
35,55,40,45,40,60,275,0.35714285714285715,70,70,115,130,90,60,535,0.5338983050847458,0.5
35,85,45,35,35,75,310,0.6492537313432836,50,92,108,92,108,35,485,0.2457627118644068,0.0
50,25,28,45,55,15,218,0.0625,60,70,105,70,120,75,500,0.5983606557377049,1.0
90,50,34,60,44,70,348,0.6283185840707964,75,98,63,98,63,101,498,0.849624060150376,1.0
50,105,125,55,95,50,480,0.375886524822695,90,92,75,92,85,60,494,0.49586776859504134,2.0
65,83,57,95,85,105,490,0.8914728682170543,65,55,115,100,40,60,435,0.3798449612403101,0.5
50,95,90,95,90,180,600,0.9172413793103448,80,80,90,110,130,110,600,0.8721804511278195,0.5
35,64,85,74,55,32,345,0.19827586206896552,72,95,67,103,71,122,530,0.9606299212598425,0.5
76,147,90,60,70,97,540,0.8267716535433071,68,65,65,125,115,80,518,0.6461538461538462,0.0
110,160,110,80,110,100,670,0.8591549295774648,65,40,50,125,60,30,370,0.07258064516129033,1.0
55,75,85,25,25,15,280,0.1875,105,180,100,180,100,115,780,0.9477611940298507,2.0
75,89,85,55,65,36,405,0.29545454545454547,91,90,72,90,129,108,580,0.896,0.5
67,82,62,46,48,43,348,0.22033898305084745,50,85,85,55,55,50,380,0.3902439024390244,1.0
70,135,105,60,105,20,495,0.5806451612903226,105,30,105,140,105,55,540,0.3524590163934426,0.5
100,110,90,85,90,60,535,0.47794117647058826,50,40,85,40,65,25,305,0.08870967741935484,0.5
100,150,110,95,110,70,635,0.5923076923076923,45,80,100,35,37,28,325,0.3125,2.0
73,76,75,81,100,100,505,0.8110236220472441,90,95,95,70,90,70,510,0.5230769230769231,0.5
43,30,55,40,65,97,330,0.6030534351145038,78,65,68,112,154,75,552,0.628099173553719,1.0
40,80,100,30,30,20,300,0.11851851851851852,65,155,120,65,90,105,600,0.8677685950413223,0.0
39,52,43,60,50,65,309,0.5041322314049587,65,50,35,115,95,95,455,0.7333333333333333,2.0
60,150,50,150,50,60,520,0.5,20,40,90,30,90,25,295,0.11363636363636363,2.0
59,45,40,35,40,31,250,0.14285714285714285,30,45,59,30,39,57,260,0.2803030303030303,1.0
45,30,40,105,50,20,290,0.031007751937984496,45,100,135,65,135,45,525,0.29411764705882354,1.0
60,85,42,85,42,91,405,0.8227848101265823,130,85,80,85,95,60,535,0.43884892086330934,1.0
65,110,130,60,65,95,525,0.8278145695364238,72,105,115,54,86,68,500,0.5149253731343284,4.0
55,95,115,45,45,35,390,0.2116788321167883,50,25,28,45,55,15,218,0.0625,1.0
115,140,130,55,55,40,535,0.4519230769230769,150,160,100,95,65,100,670,0.8866666666666667,1.0
170,90,45,90,45,60,500,0.427536231884058,63,120,85,90,55,55,468,0.2809917355371901,0.5
50,95,90,95,90,180,600,0.9172413793103448,35,40,100,90,55,35,355,0.1796875,1.0
84,71,43,71,43,48,360,0.25874125874125875,78,81,71,74,69,126,499,0.9090909090909091,1.0
91,129,90,72,90,108,580,0.8536585365853658,95,117,80,65,70,92,519,0.8409090909090909,1.0
40,40,50,30,30,30,220,0.0873015873015873,60,50,70,50,90,65,385,0.39568345323741005,0.25
50,60,45,100,80,65,400,0.45689655172413796,41,56,40,62,44,71,314,0.568,2.0
80,110,120,130,90,70,600,0.6198347107438017,59,63,80,65,80,58,405,0.41843971631205673,0.25
72,95,67,103,71,122,530,0.9606299212598425,40,55,70,45,60,30,300,0.10619469026548672,1.0
58,109,112,48,48,109,484,0.8805970149253731,45,60,40,70,50,45,310,0.2846715328467153,0.25
115,45,20,45,25,20,270,0.11538461538461539,54,45,47,75,98,52,371,0.39669421487603307,1.0
44,38,39,61,79,42,303,0.2251655629139073,70,110,70,115,70,90,525,0.75,1.0
60,62,80,63,80,60,405,0.4336283185840708,80,95,82,60,82,75,474,0.6,0.5
38,35,40,27,25,35,200,0.08208955223880597,75,103,80,70,80,92,500,0.7933884297520661,2.0
75,70,90,70,105,80,490,0.656,75,95,122,58,75,69,494,0.5725806451612904,2.0
100,150,110,95,110,70,635,0.5923076923076923,40,30,35,45,40,55,245,0.31496062992125984,0.0
20,25,45,70,90,60,310,0.30833333333333335,80,70,70,90,100,70,480,0.5609756097560976,1.0
54,66,70,44,55,46,335,0.4214876033057851,50,85,85,55,55,50,380,0.3902439024390244,0.5
55,95,115,45,45,35,390,0.2116788321167883,59,66,70,44,55,41,335,0.25190839694656486,0.5
55,104,105,94,75,52,485,0.36363636363636365,70,45,48,60,65,35,323,0.15748031496062992,1.0
70,55,65,95,85,70,440,0.5307692307692308,65,95,75,55,55,85,430,0.6933333333333334,2.0
80,130,100,160,120,110,700,0.8981481481481481,75,95,60,65,60,115,470,0.8778625954198473,1.0
40,45,35,65,55,70,310,0.4482758620689655,55,69,85,32,35,28,304,0.09302325581395349,1.0
70,90,70,60,60,70,420,0.6390977443609023,68,85,65,165,135,100,618,0.8083333333333333,1.0
44,50,91,24,86,10,305,0.1981981981981982,67,82,62,46,48,43,348,0.22033898305084745,1.0
65,47,55,73,75,85,400,0.65,50,20,40,20,40,20,190,0.0962962962962963,0.5
50,53,62,58,63,44,330,0.13709677419354838,91,72,90,129,90,108,580,0.8620689655172413,0.5
50,75,75,65,65,50,380,0.4049586776859504,60,100,115,70,85,90,520,0.7557251908396947,1.0
55,45,45,25,25,15,210,0.048,95,124,78,69,71,58,495,0.37398373983739835,1.0
80,135,130,95,90,70,600,0.5181818181818182,75,103,80,70,80,92,500,0.7933884297520661,1.0
45,30,15,85,65,65,305,0.36220472440944884,91,72,90,129,90,108,580,0.8925619834710744,0.5
170,90,45,90,45,60,500,0.427536231884058,75,75,55,105,85,30,425,0.1619718309859155,0.5
1,90,45,30,30,40,236,0.33064516129032256,40,30,30,40,50,30,220,0.07936507936507936,2.0
85,100,122,58,75,54,494,0.3939393939393939,111,83,68,92,82,39,475,0.1774193548387097,4.0
54,63,52,83,56,97,405,0.7697841726618705,30,30,42,30,42,70,244,0.4230769230769231,1.0
60,60,60,60,60,60,360,0.38095238095238093,71,120,95,120,95,99,600,0.8203125,0.5
80,80,50,40,50,25,325,0.176056338028169,30,45,59,30,39,57,260,0.2803030303030303,0.5
100,120,100,150,120,90,680,0.728,40,29,45,29,45,36,224,0.14634146341463414,2.0
50,53,48,53,48,64,316,0.4076923076923077,125,130,90,130,90,95,660,0.7734375,0.5
55,55,85,65,85,35,380,0.2014388489208633,255,10,10,75,135,55,540,0.3125,1.0
150,80,44,90,54,80,498,0.625,100,100,100,100,100,100,600,0.831858407079646,2.0
75,103,80,70,80,92,500,0.7933884297520661,125,58,58,76,76,67,460,0.515625,2.0
55,40,50,65,85,40,335,0.3181818181818182,75,100,63,80,63,116,497,0.9345794392523364,1.0
68,72,78,38,42,32,330,0.23809523809523808,65,150,40,15,80,145,495,0.9663865546218487,1.0
90,92,75,92,85,60,494,0.49586776859504134,58,50,145,95,105,30,483,0.2459016393442623,1.0
55,63,90,50,80,42,380,0.21138211382113822,72,60,30,20,30,25,237,0.11570247933884298,0.5
75,80,95,90,100,50,490,0.2158273381294964,80,100,80,80,80,100,520,0.9051724137931034,1.0
76,65,45,92,42,91,411,0.7449664429530202,90,120,75,60,60,45,450,0.29411764705882354,1.0
55,50,45,135,95,120,500,0.7714285714285715,95,124,78,69,71,58,495,0.37398373983739835,0.0
30,56,35,25,35,72,253,0.48148148148148145,100,150,120,120,100,90,680,0.6493506493506493,1.0
65,40,70,80,140,70,465,0.5954198473282443,71,82,64,64,59,112,452,0.9327731092436975,1.0
50,80,95,10,45,10,290,0.232,65,90,120,85,70,60,490,0.43410852713178294,1.0
70,70,115,130,90,60,535,0.5338983050847458,91,134,95,100,100,80,600,0.6304347826086957,1.0
44,38,39,61,79,42,303,0.2251655629139073,50,55,50,36,30,43,264,0.2922077922077922,1.0
50,70,100,40,40,30,330,0.2222222222222222,49,55,42,42,37,85,310,0.6068376068376068,1.0
30,30,42,30,42,70,244,0.4230769230769231,60,80,95,70,85,50,440,0.2231404958677686,0.25
70,145,88,140,70,112,625,0.8888888888888888,35,64,85,74,55,32,345,0.19827586206896552,0.5
65,65,65,50,50,90,385,0.72,92,105,90,125,90,98,600,0.8217054263565892,0.5
105,130,120,45,45,40,485,0.4444444444444444,75,95,122,58,75,69,494,0.5725806451612904,0.5
75,100,110,45,55,65,450,0.5333333333333333,45,75,37,70,55,83,365,0.6183206106870229,2.0
90,92,75,92,85,60,494,0.49586776859504134,100,50,50,76,96,70,442,0.5,1.0
40,65,95,60,45,35,340,0.13986013986013987,70,90,45,15,45,50,315,0.3629032258064516,1.0
60,90,70,60,120,40,440,0.27419354838709675,50,55,50,36,30,43,264,0.2922077922077922,1.0
40,70,130,60,130,25,455,0.17355371900826447,60,45,70,45,90,95,405,0.7304964539007093,1.0
58,109,112,48,48,109,484,0.8805970149253731,84,71,43,71,43,48,360,0.25874125874125875,1.0
70,20,50,20,50,40,250,0.1557377049180328,74,108,133,83,65,32,495,0.32142857142857145,1.0
50,95,90,95,90,180,600,0.9172413793103448,50,60,60,60,60,30,320,0.11290322580645161,2.0
70,60,75,110,75,90,480,0.7165354330708661,68,165,95,65,115,110,618,0.8615384615384616,1.0
70,135,105,60,105,20,495,0.5806451612903226,50,100,150,100,150,50,600,0.37142857142857144,0.5
40,55,99,40,79,47,360,0.26262626262626265,95,95,85,125,65,55,520,0.3894736842105263,8.0
70,110,70,115,70,90,525,0.75,95,60,79,100,125,81,540,0.6201550387596899,0.5
60,90,140,50,50,40,430,0.2535211267605634,106,110,90,154,90,130,680,0.926829268292683,1.0
85,56,77,50,77,78,423,0.53125,60,85,40,30,45,68,328,0.6422018348623854,1.0
60,50,100,85,70,65,430,0.47580645161290325,106,190,100,154,100,130,780,0.9259259259259259,2.0
65,45,55,45,70,45,325,0.24369747899159663,135,85,40,40,85,5,390,0.6864406779661016,1.0
91,72,90,129,90,108,580,0.8925619834710744,64,51,23,51,23,28,240,0.11363636363636363,2.0
65,90,65,61,61,100,442,0.8373983739837398,60,100,115,70,85,90,520,0.7557251908396947,0.25
64,88,50,88,50,106,446,0.9111111111111111,50,65,85,35,35,55,325,0.32575757575757575,1.0
60,90,140,50,50,40,430,0.2535211267605634,67,125,40,30,30,58,350,0.3431372549019608,2.0
110,135,60,50,65,88,508,0.7744360902255639,60,60,60,85,85,85,435,0.631578947368421,1.0
45,85,50,55,50,65,350,0.5076923076923077,110,123,65,100,65,65,528,0.5217391304347826,1.0
43,70,48,50,60,38,309,0.2391304347826087,111,83,68,92,82,39,475,0.1774193548387097,4.0
70,100,115,30,65,30,410,0.24390243902439024,73,76,75,81,100,100,505,0.8110236220472441,2.0
78,70,61,50,61,100,420,0.8145161290322581,45,50,35,55,75,40,300,0.21367521367521367,1.0
66,65,48,62,57,52,350,0.36220472440944884,100,100,100,100,100,100,600,0.8758169934640523,0.5
50,75,75,65,65,50,380,0.4049586776859504,50,180,20,180,20,150,600,0.9029850746268657,4.0
65,75,90,97,123,44,494,0.1987179487179487,62,44,50,44,50,55,305,0.3629032258064516,1.0
74,108,133,83,65,32,495,0.32142857142857145,65,80,140,40,70,70,465,0.5223880597014925,1.0
55,68,64,45,55,31,318,0.11666666666666667,67,89,116,79,116,33,500,0.2624113475177305,0.5
52,65,50,45,50,38,300,0.27419354838709675,60,45,70,45,90,95,405,0.7304964539007093,1.0
106,90,130,90,154,110,680,0.8699186991869918,73,115,60,60,60,90,458,0.6694915254237288,1.0
45,50,45,115,55,95,405,0.6936936936936937,100,128,90,77,77,128,600,0.959349593495935,0.0
80,80,80,80,80,80,480,0.6015037593984962,60,130,80,60,60,70,460,0.5153846153846153,2.0
50,64,50,45,50,41,300,0.22727272727272727,100,150,110,95,110,70,635,0.5923076923076923,0.5
55,66,44,44,56,85,350,0.6888888888888889,75,125,75,30,75,85,465,0.625,1.0
90,55,75,60,75,30,385,0.13970588235294118,75,75,130,75,130,95,580,0.7479674796747967,1.0
85,105,55,85,50,115,495,0.9032258064516129,68,125,65,65,115,80,518,0.6277372262773723,1.0
71,73,88,120,89,59,500,0.43537414965986393,40,45,40,65,40,65,295,0.5661764705882353,1.0
40,45,35,65,55,70,310,0.4482758620689655,76,65,45,92,42,91,411,0.7449664429530202,0.5
50,20,55,25,25,30,205,0.09774436090225563,40,60,40,40,40,30,250,0.0948905109489051,0.5
75,55,70,55,95,110,460,0.8444444444444444,95,95,85,125,65,55,520,0.3894736842105263,1.0
95,65,110,60,130,65,525,0.5275590551181102,65,76,84,54,96,105,480,0.9008264462809917,1.0
70,94,50,94,50,66,424,0.48148148148148145,60,80,50,40,40,30,300,0.15328467153284672,0.5
125,120,90,170,100,95,700,0.78125,40,30,50,55,55,100,330,0.584070796460177,1.0
103,93,67,71,61,84,479,0.7142857142857143,59,45,40,35,40,31,250,0.14285714285714285,1.0
65,80,140,40,70,70,465,0.5223880597014925,100,100,100,100,100,100,600,0.8758169934640523,0.25
80,82,100,83,100,80,525,0.6821705426356589,89,145,90,105,80,91,600,0.8549618320610687,1.0
50,52,48,65,50,55,320,0.33098591549295775,54,63,52,83,56,97,405,0.7697841726618705,0.5
50,50,50,50,50,50,300,0.30708661417322836,60,100,89,55,69,112,485,0.9298245614035088,1.0
48,72,48,72,48,48,336,0.25984251968503935,20,25,45,70,90,60,310,0.30833333333333335,0.5
50,53,48,53,48,64,316,0.358974358974359,39,52,43,60,50,65,309,0.5041322314049587,2.0
50,52,48,65,50,55,320,0.33098591549295775,82,121,119,69,59,71,521,0.5394736842105263,1.0
71,95,85,110,95,79,535,0.664,100,150,120,120,100,90,680,0.6493506493506493,2.0
45,53,70,40,60,42,310,0.25735294117647056,80,85,95,30,30,25,345,0.2857142857142857,4.0
40,40,55,40,70,55,300,0.40939597315436244,115,45,20,45,25,20,270,0.11538461538461539,1.0
35,55,35,30,30,35,220,0.23684210526315788,70,20,50,20,50,40,250,0.1557377049180328,0.5
60,59,85,79,105,36,424,0.16666666666666666,76,25,45,67,55,24,292,0.0390625,2.0
82,80,86,85,75,72,480,0.6183206106870229,50,70,50,50,50,40,310,0.16296296296296298,1.0
65,60,110,130,95,65,525,0.47761194029850745,35,40,100,90,55,35,355,0.1796875,0.5
60,62,80,63,80,60,405,0.4336283185840708,45,90,20,65,20,65,305,0.5116279069767442,2.0
90,110,80,100,80,95,555,0.7982456140350878,40,30,50,55,55,100,330,0.584070796460177,1.0
79,105,70,145,80,101,580,0.8608695652173913,75,89,85,55,65,36,405,0.29545454545454547,1.0
80,82,100,83,100,80,525,0.6821705426356589,68,72,78,38,42,32,330,0.23809523809523808,2.0
90,120,100,150,120,100,680,0.7718120805369127,68,90,65,50,55,82,410,0.6165413533834586,2.0
90,60,60,40,40,40,330,0.29545454545454547,65,95,57,100,85,93,495,0.7441860465116279,2.0
70,62,67,55,55,56,365,0.38513513513513514,55,50,65,175,95,150,590,0.7818181818181819,1.0
45,80,100,35,37,28,325,0.3125,80,120,70,110,70,80,530,0.6422764227642277,0.5
63,120,85,90,55,55,468,0.2809917355371901,45,63,37,65,55,95,360,0.8055555555555556,1.0
25,20,15,105,55,90,310,0.32407407407407407,100,180,160,150,90,90,770,0.7520661157024794,2.0
70,80,102,80,102,40,474,0.2677165354330709,38,35,40,27,25,35,200,0.08208955223880597,2.0
75,100,63,80,63,116,497,0.9345794392523364,63,63,47,41,41,74,329,0.56,1.0
50,70,50,50,50,70,340,0.5645161290322581,65,76,84,54,96,105,480,0.9008264462809917,1.0
65,75,70,95,70,95,470,0.7272727272727273,91,72,90,129,90,108,580,0.8620689655172413,2.0
50,105,125,55,95,50,480,0.375886524822695,80,52,50,90,50,89,411,0.6666666666666666,1.0
45,45,55,45,55,63,308,0.4594594594594595,61,78,95,56,58,57,405,0.40336134453781514,0.5
40,55,99,40,79,47,360,0.26262626262626265,45,75,37,70,55,83,365,0.6183206106870229,0.5
43,80,65,50,35,35,308,0.14193548387096774,45,63,37,65,55,95,360,0.8055555555555556,1.0
80,135,130,95,90,70,600,0.5181818181818182,190,33,58,33,58,33,405,0.13432835820895522,0.5
50,60,60,60,60,30,320,0.11290322580645161,105,130,120,45,45,40,485,0.4444444444444444,1.0
54,66,70,44,55,46,335,0.4214876033057851,45,55,39,35,39,42,255,0.18518518518518517,0.0
79,115,70,125,80,111,580,0.864,70,110,180,60,60,50,530,0.4117647058823529,0.25
60,40,60,95,60,55,370,0.4222222222222222,90,75,75,90,100,70,500,0.5462184873949579,0.5
70,62,67,55,55,56,365,0.38513513513513514,59,45,40,35,40,31,250,0.14285714285714285,1.0
30,42,118,42,88,30,350,0.112,50,25,28,45,55,15,218,0.0625,0.5
35,65,35,65,35,65,300,0.46621621621621623,38,35,40,27,25,35,200,0.08208955223880597,1.0
70,94,50,94,50,66,424,0.48148148148148145,70,95,125,65,75,45,475,0.33613445378151263,1.0
64,78,52,78,52,81,405,0.6422764227642277,60,60,60,85,85,85,435,0.631578947368421,0.0
108,112,118,68,72,47,525,0.2916666666666667,43,70,48,50,60,38,309,0.2391304347826087,0.5
50,85,40,85,40,35,335,0.1746031746031746,70,90,70,60,60,70,420,0.6390977443609023,1.0
75,90,50,110,80,95,500,0.7985611510791367,120,120,120,120,120,120,720,0.9344262295081968,1.0
90,120,75,60,60,45,450,0.29411764705882354,74,48,76,83,81,104,466,0.7322834645669292,1.0
75,90,90,140,90,115,600,0.9481481481481482,80,160,60,170,130,80,680,0.6180555555555556,1.0
110,78,73,76,71,60,468,0.3333333333333333,95,117,184,44,46,28,514,0.2975206611570248,1.0
55,40,50,65,85,40,335,0.3181818181818182,65,50,35,115,95,95,455,0.7333333333333333,2.0
60,40,60,95,60,55,370,0.4222222222222222,59,66,70,44,55,41,335,0.25190839694656486,4.0
78,65,68,112,154,75,552,0.628099173553719,50,50,77,95,77,91,440,0.5916666666666667,1.0
20,15,20,10,55,80,200,0.2682926829268293,75,103,80,70,80,92,500,0.7933884297520661,0.5
75,95,122,58,75,69,494,0.5725806451612904,90,92,87,75,85,76,505,0.5409836065573771,1.0
91,134,95,100,100,80,600,0.6304347826086957,50,50,95,40,50,35,320,0.20279720279720279,1.0
52,65,50,45,50,38,300,0.27419354838709675,50,50,95,40,50,35,320,0.20279720279720279,1.0
45,30,50,65,50,45,285,0.13821138211382114,110,123,65,100,65,65,528,0.5217391304347826,1.0
55,55,85,65,85,35,380,0.2014388489208633,95,65,65,110,130,60,525,0.4016393442622951,1.0
106,130,90,110,154,90,680,0.719626168224299,76,48,48,57,62,34,325,0.11688311688311688,0.5
65,65,60,130,95,110,525,0.823943661971831,50,30,55,65,55,20,275,0.13675213675213677,1.0
60,90,55,90,80,110,485,0.8677685950413223,105,30,105,140,105,55,540,0.3524590163934426,1.0
90,93,55,70,55,55,418,0.3819444444444444,85,135,130,60,80,25,515,0.40540540540540543,1.0
65,80,80,59,63,58,405,0.4411764705882353,58,70,45,40,45,42,300,0.25925925925925924,1.0
255,10,10,75,135,55,540,0.3125,61,72,57,55,55,65,365,0.3984375,1.0
120,120,120,120,120,120,720,0.9344262295081968,75,95,95,95,95,85,540,0.6470588235294118,1.0
40,35,30,120,70,105,400,0.6692307692307692,45,60,45,25,45,55,275,0.29,1.0
75,87,63,87,63,98,473,0.865546218487395,40,45,40,62,60,60,307,0.33884297520661155,2.0
90,95,105,165,110,45,610,0.2890625,45,75,37,70,55,83,365,0.6183206106870229,1.0
80,105,65,60,75,130,515,0.9645390070921985,65,95,100,60,50,50,420,0.34959349593495936,1.0
50,95,95,35,110,70,455,0.5179856115107914,85,80,90,105,95,60,515,0.49074074074074076,2.0
70,80,102,80,102,40,474,0.2677165354330709,83,106,65,86,65,85,490,0.6640625,0.5
75,125,70,125,70,115,580,0.9037037037037037,50,53,48,53,48,64,316,0.46153846153846156,1.0
30,65,100,45,25,40,305,0.1891891891891892,44,38,39,61,79,42,303,0.2251655629139073,1.0
70,84,70,65,70,51,410,0.2949640287769784,85,56,77,50,77,78,423,0.53125,0.5
50,45,45,35,35,50,260,0.23529411764705882,60,55,145,75,150,40,525,0.2,0.25
64,78,52,78,52,81,405,0.6422764227642277,54,66,70,44,55,46,335,0.4214876033057851,0.0
85,110,76,65,82,56,474,0.3933333333333333,90,55,75,60,75,30,385,0.13970588235294118,0.0
20,15,20,10,55,80,200,0.2682926829268293,65,80,140,40,70,70,465,0.5223880597014925,1.0
110,80,90,95,90,65,530,0.5033557046979866,30,105,90,25,25,50,325,0.2773722627737226,0.25
65,90,50,85,45,55,390,0.371900826446281,62,77,62,50,42,65,358,0.4838709677419355,0.5
40,45,65,100,120,90,460,0.5588235294117647,48,61,40,61,40,50,300,0.2543859649122807,2.0
30,45,135,45,90,30,375,0.09285714285714286,70,110,75,145,85,145,630,0.9444444444444444,1.0
75,90,140,60,60,40,465,0.3008130081300813,115,45,20,45,25,20,270,0.11538461538461539,0.25
55,45,50,45,65,80,340,0.5546218487394958,45,30,50,65,50,45,285,0.13821138211382114,1.0
41,56,40,62,44,71,314,0.568,95,155,109,70,130,81,640,0.6788321167883211,0.5
35,65,35,65,35,65,300,0.46621621621621623,105,125,100,60,100,100,590,0.8359375,1.0
55,130,115,50,50,75,475,0.5982142857142857,100,123,75,57,75,80,510,0.6923076923076923,1.0
40,40,50,30,30,30,220,0.0873015873015873,65,150,60,115,60,115,565,0.935251798561151,1.0
80,85,95,30,30,25,345,0.2857142857142857,70,20,50,20,50,40,250,0.1557377049180328,1.0
125,170,100,120,90,95,700,0.77,60,110,70,60,60,100,460,0.8461538461538461,2.0
65,110,130,60,65,95,525,0.8278145695364238,60,85,60,50,50,125,430,0.9090909090909091,0.5
50,53,48,53,48,64,316,0.358974358974359,70,115,60,115,60,55,475,0.4647887323943662,0.5
55,85,122,58,75,99,494,0.8099173553719008,75,95,67,125,95,83,540,0.7117117117117117,0.5
80,135,85,70,95,150,615,0.9844961240310077,80,80,80,80,80,80,480,0.5606060606060606,1.0
65,90,122,58,75,84,494,0.71875,85,110,76,65,82,56,474,0.3933333333333333,1.0
50,92,108,92,108,35,485,0.2457627118644068,65,125,100,55,70,85,500,0.6532258064516129,1.0
80,80,80,80,80,80,480,0.6015037593984962,80,52,50,90,50,89,411,0.6666666666666666,2.0
75,95,67,125,95,83,540,0.7117117117117117,44,38,39,61,79,42,303,0.2251655629139073,1.0
73,76,75,81,100,100,505,0.8110236220472441,75,95,60,65,60,115,470,0.8778625954198473,1.0
40,65,40,80,40,65,330,0.5038167938931297,70,90,45,15,45,50,315,0.3629032258064516,1.0
38,41,40,50,65,65,299,0.4108527131782946,80,130,100,160,120,110,700,0.8981481481481481,0.5
45,50,43,40,38,62,278,0.40441176470588236,80,105,105,105,105,80,580,0.5939849624060151,1.0
75,80,60,65,90,102,472,0.8625954198473282,38,41,40,50,65,65,299,0.4108527131782946,1.0
78,81,71,74,69,126,499,0.9090909090909091,95,75,180,130,80,30,590,0.13793103448275862,0.5
58,89,77,45,45,48,362,0.3177570093457944,130,85,80,85,95,60,535,0.43884892086330934,2.0
70,92,65,80,55,98,460,0.8090909090909091,165,75,80,40,45,65,470,0.5151515151515151,0.5
67,89,116,79,116,33,500,0.2624113475177305,50,55,50,36,30,43,264,0.2922077922077922,1.0
91,90,72,90,129,108,580,0.896,55,63,90,50,80,42,380,0.21138211382113822,0.125
45,45,55,45,55,63,308,0.4594594594594595,100,100,100,100,100,100,600,0.8602941176470589,0.5
65,125,100,55,70,85,500,0.6532258064516129,50,70,160,70,160,90,600,0.7417218543046358,2.0
30,42,118,42,88,30,350,0.112,70,50,30,95,135,105,485,0.8040540540540541,4.0
78,130,111,130,85,100,634,0.8561151079136691,72,58,80,103,80,97,490,0.7171052631578947,1.0
105,95,75,85,75,74,509,0.5714285714285714,50,47,50,57,50,65,319,0.463768115942029,1.0
250,5,5,35,105,50,450,0.15306122448979592,50,70,50,50,50,70,340,0.5645161290322581,1.0
90,30,15,40,20,15,210,0.043478260869565216,55,85,122,58,75,99,494,0.8099173553719008,0.0
90,120,75,60,60,45,450,0.29411764705882354,50,85,55,65,65,90,410,0.7478260869565218,0.5
95,145,130,120,90,120,700,0.9398496240601504,28,25,25,45,35,40,198,0.16083916083916083,0.0
62,44,50,44,50,55,305,0.3629032258064516,60,40,60,95,60,55,370,0.4222222222222222,2.0
100,134,110,95,100,61,600,0.4057971014492754,59,59,58,90,70,73,409,0.5826086956521739,2.0
79,115,70,125,80,111,580,0.864,30,56,35,25,35,72,253,0.48148148148148145,1.0
80,82,100,83,100,80,525,0.6821705426356589,40,45,40,65,40,65,295,0.5661764705882353,1.0
55,45,50,45,65,80,340,0.5546218487394958,60,59,85,79,105,36,424,0.16666666666666666,1.0
45,60,40,70,50,45,310,0.2846715328467153,40,40,35,50,100,70,335,0.5031847133757962,0.5
80,95,82,60,82,75,474,0.6,75,110,110,110,105,80,590,0.656934306569343,2.0
65,75,90,97,123,44,494,0.1987179487179487,69,55,45,55,55,15,294,0.11666666666666667,1.0
60,50,70,80,80,140,480,0.8449612403100775,80,110,120,130,90,70,600,0.6198347107438017,2.0
59,45,40,35,40,31,250,0.14285714285714285,101,72,72,99,89,29,462,0.1937984496124031,1.0
70,90,90,135,90,125,600,0.9401709401709402,95,70,73,95,90,60,483,0.3983739837398374,0.5
44,38,39,61,79,42,303,0.2251655629139073,75,125,230,55,95,30,610,0.3448275862068966,0.5
50,52,48,65,50,55,320,0.33098591549295775,70,105,105,50,40,20,390,0.33587786259541985,2.0
95,65,110,60,130,65,525,0.5275590551181102,80,115,80,65,55,93,488,0.7846153846153846,1.0
68,125,65,65,115,80,518,0.6277372262773723,40,30,30,40,50,30,220,0.07936507936507936,1.0
75,95,67,125,95,83,540,0.7117117117117117,126,131,95,131,98,99,680,0.8102189781021898,1.0
70,85,70,60,70,50,405,0.28378378378378377,90,100,60,90,60,80,480,0.6422764227642277,0.25
88,107,122,74,75,64,530,0.4596774193548387,50,65,107,105,107,86,520,0.7313432835820896,0.5
50,65,64,44,48,43,314,0.2196969696969697,95,110,80,70,80,50,485,0.37209302325581395,1.0
60,130,80,60,60,70,460,0.5153846153846153,50,48,43,46,41,60,288,0.47297297297297297,4.0
80,82,83,100,100,80,525,0.6742424242424242,75,55,70,55,95,110,460,0.8444444444444444,0.5
70,110,80,55,80,105,500,0.8794326241134752,80,100,70,60,70,95,475,0.7416666666666667,4.0
60,85,49,60,49,60,363,0.4444444444444444,95,70,73,95,90,60,483,0.3983739837398374,1.0
45,50,45,115,55,95,405,0.6936936936936937,95,135,80,110,80,100,600,0.8248175182481752,1.0
55,40,40,65,45,35,280,0.16428571428571428,90,50,34,60,44,70,348,0.6283185840707964,2.0
45,60,30,80,50,65,330,0.4603174603174603,55,95,55,35,75,115,430,0.9380530973451328,1.0
95,65,110,60,130,65,525,0.5275590551181102,80,120,130,55,65,45,495,0.37037037037037035,1.0
55,65,95,95,45,85,440,0.6610169491525424,38,30,41,30,41,60,240,0.2897196261682243,1.0
75,95,67,125,95,83,540,0.7117117117117117,55,104,105,94,75,52,485,0.36363636363636365,0.5
91,134,95,100,100,80,600,0.6304347826086957,20,10,230,10,230,5,505,0.0,1.0
55,55,85,65,85,35,380,0.2014388489208633,75,125,75,30,75,85,465,0.625,0.5
72,105,115,54,86,68,500,0.5149253731343284,91,90,129,90,72,108,580,0.9140625,0.25
55,65,35,60,30,85,330,0.6126126126126126,70,83,50,37,50,60,350,0.3360655737704918,1.0
79,100,80,110,90,121,580,0.968,65,125,60,95,60,105,510,0.9236641221374046,2.0
55,66,44,44,56,85,350,0.6888888888888889,79,100,80,110,90,121,580,0.968,1.0
160,110,65,65,110,30,540,0.35714285714285715,75,95,95,95,95,85,540,0.6470588235294118,1.0
75,80,55,25,35,35,305,0.18666666666666668,75,100,110,45,55,65,450,0.5333333333333333,1.0
1,90,45,30,30,40,236,0.33064516129032256,91,90,72,90,129,108,580,0.896,1.0
35,80,50,50,70,120,405,0.84375,70,110,70,115,70,90,525,0.75,2.0
95,75,110,100,80,30,490,0.15267175572519084,90,92,87,75,85,76,505,0.5409836065573771,8.0
91,90,72,90,129,108,580,0.896,75,69,72,114,100,104,534,0.8253968253968254,0.25
76,48,48,57,62,34,325,0.11688311688311688,80,75,150,75,150,50,580,0.30973451327433627,1.0
50,50,120,80,80,30,410,0.07258064516129033,40,55,30,30,30,60,245,0.43548387096774194,2.0
50,53,48,53,48,64,316,0.46153846153846156,65,95,75,55,55,85,430,0.6933333333333334,0.5
60,80,50,40,40,30,300,0.15328467153284672,105,140,55,30,55,95,480,0.8195488721804511,0.5
79,115,70,125,80,111,580,0.864,70,94,50,94,50,66,424,0.48148148148148145,4.0
79,115,70,125,80,111,580,0.864,60,60,50,40,50,75,335,0.5882352941176471,1.0
55,63,90,50,80,42,380,0.21138211382113822,65,75,105,35,65,85,430,0.6940298507462687,0.5
106,150,70,194,120,140,780,0.952,35,70,55,45,55,25,285,0.09420289855072464,1.0
89,125,90,115,80,101,600,0.8725490196078431,51,65,65,80,75,59,395,0.4365079365079365,1.0
85,80,90,105,95,60,515,0.49074074074074076,80,82,83,100,100,80,525,0.6742424242424242,1.0
40,50,90,30,55,65,330,0.44680851063829785,50,72,35,35,35,65,292,0.5373134328358209,1.0
50,50,40,30,30,50,250,0.2781954887218045,95,155,109,70,130,81,640,0.6788321167883211,0.5
45,49,65,49,65,45,318,0.275,68,85,65,165,135,100,618,0.8083333333333333,1.0
105,180,100,180,100,115,780,0.9477611940298507,40,30,30,55,30,85,270,0.4666666666666667,1.0
65,60,110,130,95,65,525,0.47761194029850745,30,45,135,45,90,30,375,0.09285714285714286,1.0
65,60,110,130,95,65,525,0.47761194029850745,62,73,55,56,52,84,382,0.7244094488188977,1.0
40,55,70,45,60,30,300,0.10619469026548672,91,90,129,90,72,108,580,0.9140625,0.5
85,60,65,135,105,100,550,0.7518248175182481,70,80,50,35,35,35,305,0.14,0.5
65,70,60,65,65,115,440,0.8583333333333333,70,110,180,60,60,50,530,0.4117647058823529,0.25
70,110,70,115,70,90,525,0.75,70,75,60,105,60,105,475,0.88,0.5
85,97,66,105,66,65,484,0.47107438016528924,63,120,85,90,55,55,468,0.2809917355371901,0.5
38,35,40,27,25,35,200,0.08208955223880597,55,55,45,63,45,45,308,0.25,1.0
105,95,80,40,80,90,490,0.753968253968254,60,50,70,50,90,65,385,0.39568345323741005,1.0
45,30,35,20,20,45,195,0.14782608695652175,60,100,85,80,85,100,510,0.7007874015748031,1.0
150,160,100,95,65,100,670,0.8866666666666667,65,100,70,80,80,105,500,0.8666666666666667,1.0
68,125,65,65,115,80,518,0.6277372262773723,90,100,60,90,60,80,480,0.6422764227642277,0.0
95,110,95,40,95,55,490,0.40336134453781514,65,90,50,85,45,55,390,0.371900826446281,1.0
74,100,72,90,72,46,454,0.24561403508771928,60,85,60,50,50,125,430,0.9090909090909091,0.5
28,25,25,45,35,40,198,0.16083916083916083,72,60,30,20,30,25,237,0.11570247933884298,2.0
90,100,70,110,150,80,600,0.6037735849056604,50,52,48,65,50,55,320,0.33098591549295775,1.0
35,45,160,30,45,70,385,0.48148148148148145,59,59,58,90,70,73,409,0.5826086956521739,4.0
90,100,90,125,85,90,580,0.7352941176470589,43,80,65,50,35,35,308,0.14193548387096774,0.5
70,43,53,43,53,40,302,0.19090909090909092,70,145,88,140,70,112,625,0.8888888888888888,0.0
123,77,72,99,92,58,521,0.4621212121212121,120,100,85,30,85,45,465,0.22448979591836735,0.5
55,104,105,94,75,52,485,0.36363636363636365,44,75,35,63,33,45,295,0.2647058823529412,1.0
55,20,35,20,45,75,250,0.37681159420289856,100,123,75,57,75,80,510,0.6923076923076923,1.0
65,105,60,60,70,95,455,63.0,50,50,40,30,30,50,250,0.2781954887218045,2.0
100,120,100,150,120,90,680,0.728,28,25,25,45,35,40,198,0.16083916083916083,0.0
60,50,70,80,80,140,480,0.8449612403100775,55,55,45,63,45,45,308,0.25,2.0
65,95,100,60,50,50,420,0.34959349593495936,60,79,105,59,85,36,424,0.17054263565891473,1.0
40,70,40,35,40,60,285,0.392,70,120,100,145,105,20,560,0.2824427480916031,1.0
50,65,45,85,65,95,405,0.7238095238095238,50,120,53,35,110,87,455,0.640625,1.0
40,30,50,55,55,100,330,0.584070796460177,45,60,30,80,50,65,330,0.4603174603174603,1.0
126,131,95,131,98,99,680,0.8294573643410853,100,180,160,150,90,90,770,0.7520661157024794,0.5
95,124,78,69,71,58,495,0.37398373983739835,65,95,75,55,55,85,430,0.6933333333333334,0.5
55,35,50,55,110,85,390,0.6277372262773723,45,40,60,40,75,50,310,0.2926829268292683,0.5
40,40,50,30,30,30,220,0.0873015873015873,150,80,44,90,54,80,498,0.625,0.5
60,85,60,50,50,125,430,0.9090909090909091,100,73,83,73,83,55,467,0.371900826446281,1.0
60,85,40,30,45,68,328,0.6422018348623854,43,80,65,50,35,35,308,0.14193548387096774,1.0
55,45,50,45,65,80,340,0.5546218487394958,90,93,55,70,55,55,418,0.3819444444444444,1.0
63,120,85,90,55,55,468,0.2809917355371901,100,100,100,100,100,100,600,0.8805970149253731,0.5
50,85,40,85,40,35,335,0.1746031746031746,50,50,95,40,50,35,320,0.20279720279720279,2.0
79,105,70,145,80,101,580,0.8608695652173913,130,65,60,110,95,65,525,0.5227272727272727,2.0
60,75,100,55,80,50,420,0.3088235294117647,110,78,73,76,71,60,468,0.3333333333333333,1.0
50,92,108,92,108,35,485,0.2457627118644068,111,83,68,92,82,39,475,0.1774193548387097,1.0
55,40,40,65,45,35,280,0.16428571428571428,78,70,61,50,61,100,420,0.8145161290322581,1.0
62,44,50,44,50,55,305,0.3629032258064516,85,80,90,105,95,60,515,0.49074074074074076,1.0
41,64,45,50,50,50,300,0.36752136752136755,38,30,85,55,65,30,303,0.21428571428571427,1.0
51,65,65,80,75,59,395,0.4365079365079365,45,35,50,70,50,30,280,0.15753424657534246,2.0
62,48,54,63,60,68,355,0.5178571428571429,65,83,57,95,85,105,490,0.8914728682170543,1.0
65,90,122,58,75,84,494,0.71875,60,62,63,80,80,60,405,0.38016528925619836,0.25
55,66,44,44,56,85,350,0.6888888888888889,60,85,69,65,79,80,438,0.576,1.0
80,100,70,50,60,45,405,0.25806451612903225,85,76,64,45,55,90,415,0.6739130434782609,2.0
90,120,120,60,60,50,500,0.35294117647058826,110,78,73,76,71,60,468,0.3333333333333333,1.0
75,98,63,98,63,101,498,0.849624060150376,75,38,38,56,56,67,330,0.5263157894736842,0.5
55,55,85,65,85,35,380,0.2014388489208633,30,45,55,70,55,85,340,0.5633802816901409,0.5
85,120,70,50,60,100,485,0.8308823529411765,160,110,65,65,110,30,540,0.35714285714285715,1.0
79,103,120,135,115,78,630,0.5763888888888888,120,70,120,75,130,85,600,0.6694915254237288,1.0
45,95,50,40,50,75,355,0.54,78,65,68,112,154,75,552,0.628099173553719,0.5
44,58,44,58,44,61,309,0.41964285714285715,90,95,105,165,110,45,610,0.2890625,0.5
30,35,30,100,35,80,310,0.4765625,35,85,45,35,35,75,310,0.6492537313432836,0.0
58,70,45,40,45,42,300,0.25925925925925924,76,104,71,104,71,108,534,0.912751677852349,2.0
90,120,120,60,60,50,500,0.35294117647058826,79,100,80,110,90,121,580,0.968,0.0
105,140,55,30,55,95,480,0.8195488721804511,85,115,80,105,80,50,515,0.3063063063063063,1.0
50,50,40,50,40,64,294,0.45588235294117646,110,85,95,80,95,50,515,0.2713178294573643,1.0
60,130,80,60,60,70,460,0.5153846153846153,90,120,75,60,60,45,450,0.29411764705882354,0.5
150,100,120,100,120,90,680,0.6666666666666666,55,47,52,40,40,41,275,0.16806722689075632,1.0
1,90,45,30,30,40,236,0.33064516129032256,80,100,200,50,100,50,580,0.3472222222222222,1.0
106,110,90,154,90,130,680,0.926829268292683,100,100,100,100,100,100,600,0.8345864661654135,0.5
105,180,100,180,100,115,780,0.9477611940298507,90,90,85,125,90,100,580,0.768595041322314,0.5
90,130,80,65,85,55,505,0.4396551724137931,80,120,70,110,70,80,530,0.6422764227642277,1.0
76,104,71,104,71,108,534,0.912751677852349,20,25,45,70,90,60,310,0.30833333333333335,0.25
106,150,70,194,120,140,780,0.952,250,5,5,35,105,50,450,0.15306122448979592,1.0
95,100,85,108,70,70,528,0.5652173913043478,100,100,100,100,100,100,600,0.8805970149253731,0.5
45,53,70,40,60,42,310,0.25735294117647056,80,100,123,122,120,80,625,0.56,0.25
80,90,80,130,110,110,600,0.856,91,90,129,90,72,108,580,0.9140625,0.25
75,140,65,112,65,110,567,0.9140625,45,67,60,35,50,63,320,0.5128205128205128,1.0
60,60,40,65,45,35,305,0.15833333333333333,39,52,43,60,50,65,309,0.5041322314049587,1.0
65,76,84,54,96,105,480,0.9008264462809917,35,45,160,30,45,70,385,0.48148148148148145,0.5
40,30,35,50,70,55,280,0.28205128205128205,67,57,55,77,55,114,425,0.8879310344827587,0.5
95,80,105,40,70,100,490,0.8046875,77,59,50,67,63,46,362,0.23140495867768596,0.5
100,75,115,90,115,85,580,0.6446280991735537,40,80,100,30,30,20,300,0.11851851851851852,4.0
49,55,42,42,37,85,310,0.6068376068376068,50,70,50,50,50,70,340,0.5645161290322581,1.0
90,100,60,90,60,80,480,0.6422764227642277,70,75,60,105,60,105,475,0.88,1.0
60,85,60,50,50,125,430,0.9090909090909091,60,45,70,45,90,95,405,0.7304964539007093,0.5
45,65,34,40,34,45,263,0.2589928057553957,95,124,78,69,71,58,495,0.37398373983739835,1.0
65,55,115,100,40,60,435,0.3798449612403101,40,20,30,40,80,55,265,0.22764227642276422,0.25
75,95,125,45,75,95,510,0.8257575757575758,20,25,45,70,90,60,310,0.30833333333333335,1.0
68,90,65,50,55,82,410,0.6165413533834586,35,35,40,35,55,50,250,0.40336134453781514,0.0
35,65,35,65,35,65,300,0.46621621621621623,55,95,115,45,45,35,390,0.2116788321167883,4.0
75,65,55,65,55,69,384,0.43548387096774194,74,108,133,83,65,32,495,0.32142857142857145,2.0
85,97,66,105,66,65,484,0.47107438016528924,60,69,95,69,95,36,424,0.2608695652173913,4.0
70,60,75,110,75,90,480,0.7165354330708661,64,66,68,81,76,50,405,0.25190839694656486,2.0
60,55,90,145,90,80,520,0.6071428571428571,75,125,230,55,95,30,610,0.3448275862068966,2.0
49,66,70,44,55,51,335,0.4260869565217391,70,140,230,60,80,50,630,0.32432432432432434,0.5
67,57,55,77,55,114,425,0.8879310344827587,79,115,70,125,80,111,580,0.8468468468468469,1.0
61,72,57,55,55,65,365,0.3984375,84,86,88,111,101,60,530,0.4634146341463415,0.0
75,98,63,98,63,101,498,0.849624060150376,108,130,95,80,85,102,600,0.7637795275590551,1.0
59,74,50,35,50,35,303,0.3125,40,55,70,45,60,30,300,0.10619469026548672,2.0
100,100,100,100,100,100,600,0.8602941176470589,56,61,65,48,45,38,313,0.17567567567567569,0.5
79,100,80,110,90,121,580,0.968,50,85,40,85,40,35,335,0.1746031746031746,2.0
125,170,100,120,90,95,700,0.77,61,72,57,55,55,65,365,0.3984375,1.0
103,60,86,60,86,50,445,0.3458646616541353,55,50,65,175,95,150,590,0.7818181818181819,1.0
90,120,120,60,60,50,500,0.35294117647058826,64,115,65,83,63,65,455,0.5323741007194245,1.0
95,65,65,110,130,60,525,0.4016393442622951,100,128,90,77,77,128,600,0.959349593495935,2.0
70,55,55,80,60,45,365,0.2222222222222222,100,77,77,128,128,90,600,0.6901408450704225,1.0
50,105,79,35,110,76,455,0.6214285714285714,104,91,63,91,73,68,490,0.5118110236220472,2.0
60,59,85,79,105,36,424,0.16666666666666666,95,100,85,108,70,70,528,0.5652173913043478,2.0
75,85,200,55,65,30,510,0.16778523489932887,79,103,120,135,115,78,630,0.5763888888888888,0.5
85,115,80,105,80,50,515,0.3063063063063063,90,95,95,70,90,70,510,0.5230769230769231,2.0
75,95,125,45,75,95,510,0.8257575757575758,55,70,40,60,40,40,305,0.26956521739130435,1.0
105,125,100,60,100,100,590,0.8359375,65,90,65,61,61,100,442,0.8373983739837398,1.0
91,134,95,100,100,80,600,0.6304347826086957,58,50,145,95,105,30,483,0.2459016393442623,1.0
84,86,88,111,101,60,530,0.4634146341463415,60,60,75,60,75,80,410,0.7321428571428571,1.0
40,30,32,50,52,65,269,0.3671875,83,80,75,70,70,101,479,0.8615384615384616,0.5
40,55,80,35,60,30,300,0.15037593984962405,72,105,115,54,86,68,500,0.5149253731343284,1.0
45,49,65,49,65,45,318,0.275,90,55,75,60,75,30,385,0.13970588235294118,1.0
55,75,60,75,60,103,428,0.7982456140350878,125,58,58,76,76,67,460,0.515625,0.5
62,48,54,63,60,68,355,0.5178571428571429,60,100,85,80,85,100,510,0.7007874015748031,0.5
50,65,107,105,107,86,520,0.6991150442477876,50,85,85,55,55,50,380,0.3902439024390244,2.0
55,66,44,44,56,85,350,0.6888888888888889,91,90,72,90,129,108,580,0.896,1.0
39,52,43,60,50,65,309,0.5041322314049587,85,110,76,65,82,56,474,0.3933333333333333,2.0
55,84,105,114,75,52,485,0.2890625,40,27,60,37,50,66,280,0.36220472440944884,0.5
255,10,10,75,135,55,540,0.3125,35,65,35,65,35,65,300,0.46621621621621623,1.0
80,100,70,50,60,45,405,0.25806451612903225,58,50,145,95,105,30,483,0.2459016393442623,0.0
63,120,85,90,55,55,468,0.2809917355371901,65,90,50,85,45,55,390,0.371900826446281,0.5
90,95,95,70,90,70,510,0.5230769230769231,84,86,88,111,101,60,530,0.4634146341463415,1.0
60,85,60,85,60,55,405,0.3673469387755102,45,100,135,65,135,45,525,0.29411764705882354,0.0
53,51,53,61,56,40,314,0.14285714285714285,48,72,48,72,48,48,336,0.25984251968503935,1.0
100,5,5,15,65,30,220,0.07692307692307693,115,115,85,90,75,100,580,0.8134328358208955,1.0
68,85,65,165,135,100,618,0.8083333333333333,60,40,50,75,85,95,405,0.6044776119402985,1.0
110,123,65,100,65,65,528,0.5217391304347826,104,91,63,91,73,68,490,0.5118110236220472,2.0
45,53,70,40,60,42,310,0.25735294117647056,69,55,45,55,55,15,294,0.11666666666666667,0.25
115,45,20,45,25,20,270,0.11538461538461539,150,80,44,90,54,80,498,0.625,0.0
90,92,75,92,85,60,494,0.49586776859504134,60,65,70,85,75,40,395,0.21705426356589147,0.5
60,30,30,36,56,50,262,0.32432432432432434,65,110,130,60,65,95,525,0.8278145695364238,2.0
59,66,70,44,55,41,335,0.25190839694656486,70,62,67,55,55,56,365,0.38513513513513514,0.5
54,63,52,83,56,97,405,0.7697841726618705,75,125,230,55,95,30,610,0.3448275862068966,2.0
90,130,80,65,85,55,505,0.4396551724137931,35,46,34,35,45,20,215,0.072,2.0
58,89,77,45,45,48,362,0.3177570093457944,40,40,55,40,70,55,300,0.40939597315436244,0.5
55,112,45,74,45,70,401,0.559322033898305,86,92,88,68,75,73,482,0.6835443037974683,1.0
100,110,90,85,90,60,535,0.47794117647058826,46,87,60,30,40,57,320,0.37777777777777777,0.5
20,10,230,10,230,5,505,0.0,70,85,65,105,85,120,530,0.9262295081967213,2.0
50,20,55,25,25,30,205,0.09774436090225563,60,130,80,60,60,70,460,0.5153846153846153,1.0
60,100,115,70,85,90,520,0.7557251908396947,105,130,120,45,45,40,485,0.4444444444444444,2.0
85,110,90,45,90,80,500,0.6206896551724138,100,100,100,100,100,100,600,0.8758169934640523,0.5
80,82,78,95,80,85,500,0.6869565217391305,59,45,40,35,40,31,250,0.14285714285714285,1.0
50,53,48,53,48,64,316,0.46153846153846156,30,80,90,55,45,55,355,0.4295774647887324,0.25
30,45,55,70,55,85,340,0.5633802816901409,150,100,120,100,120,90,680,0.6666666666666666,0.5
65,150,40,15,80,145,495,0.9663865546218487,80,82,78,95,80,85,500,0.6869565217391305,1.0
60,95,80,60,80,30,405,0.19480519480519481,40,50,45,70,45,70,320,0.5517241379310345,0.5
30,80,90,55,45,55,355,0.4295774647887324,91,134,95,100,100,80,600,0.6304347826086957,1.0
60,65,80,170,95,130,600,0.8625954198473282,78,84,78,109,85,100,534,0.8646616541353384,1.0
76,147,90,60,70,97,540,0.8267716535433071,75,95,95,95,95,85,540,0.6470588235294118,2.0
45,100,135,65,135,45,525,0.29411764705882354,110,65,75,125,85,30,490,0.15,2.0
60,50,40,85,75,95,405,0.7540983606557377,100,123,75,57,75,80,510,0.6923076923076923,2.0
59,45,40,35,40,31,250,0.14285714285714285,60,60,75,60,75,80,410,0.7321428571428571,1.0
40,45,40,65,40,65,295,0.5661764705882353,50,85,55,65,65,90,410,0.7478260869565218,1.0
44,38,33,61,43,70,289,0.5267857142857143,30,30,42,30,42,70,244,0.4230769230769231,2.0
108,100,121,81,95,95,600,0.7476635514018691,60,130,80,60,60,70,460,0.5153846153846153,0.5
68,75,53,83,113,60,452,0.45384615384615384,50,65,107,105,107,86,520,0.7758620689655172,1.0
75,80,60,65,90,102,472,0.8625954198473282,61,72,57,55,55,65,365,0.3984375,1.0
105,95,80,40,80,90,490,0.753968253968254,80,82,83,100,100,80,525,0.6742424242424242,1.0
60,40,60,95,60,55,370,0.4222222222222222,75,80,60,65,90,102,472,0.8625954198473282,0.0
28,25,25,45,35,40,198,0.16083916083916083,50,70,100,40,40,30,330,0.2222222222222222,0.25
105,95,75,85,75,74,509,0.5714285714285714,79,85,60,55,60,71,410,0.60431654676259,0.5
78,52,60,63,65,23,341,0.06015037593984962,110,80,90,95,90,65,530,0.5033557046979866,1.0
77,120,90,60,90,48,485,0.2785714285714286,105,95,80,40,80,90,490,0.753968253968254,1.0
55,69,85,32,35,28,304,0.09302325581395349,160,110,65,65,110,30,540,0.35714285714285715,1.0
71,82,64,64,59,112,452,0.9327731092436975,60,79,105,59,85,36,424,0.17054263565891473,1.0
150,80,44,90,54,80,498,0.625,108,100,121,81,95,95,600,0.7476635514018691,1.0
50,95,90,95,90,180,600,0.9172413793103448,60,85,42,85,42,91,405,0.8227848101265823,0.0
51,65,65,80,75,59,395,0.4365079365079365,35,70,55,45,55,25,285,0.09420289855072464,2.0
45,80,100,35,37,28,325,0.3125,38,30,41,30,41,60,240,0.2897196261682243,0.0
92,105,90,125,90,98,600,0.8217054263565892,105,95,80,40,80,90,490,0.753968253968254,1.0
65,75,90,97,123,44,494,0.1987179487179487,35,35,35,35,35,35,210,0.13385826771653545,1.0
45,100,135,65,135,45,525,0.29411764705882354,75,95,122,58,75,69,494,0.5725806451612904,2.0
65,40,50,125,60,30,370,0.07258064516129033,90,120,75,60,60,45,450,0.29411764705882354,1.0
43,70,48,50,60,38,309,0.2391304347826087,35,40,100,90,55,35,355,0.1796875,4.0
60,100,115,70,85,90,520,0.7557251908396947,70,140,70,110,65,105,560,0.95,0.5
70,94,50,94,50,66,424,0.48148148148148145,44,75,35,63,33,45,295,0.2647058823529412,0.5
69,69,76,69,86,91,460,0.6554621848739496,95,117,184,44,46,28,514,0.2975206611570248,1.0
50,92,108,92,108,35,485,0.2457627118644068,62,44,50,44,50,55,305,0.3629032258064516,1.0
75,98,63,98,63,101,498,0.889763779527559,60,85,69,60,69,77,420,0.518796992481203,1.0
68,90,65,50,55,82,410,0.6165413533834586,43,80,65,50,35,35,308,0.14193548387096774,1.0
76,104,71,104,71,108,534,0.912751677852349,60,80,110,50,80,45,425,0.2833333333333333,1.0
40,40,40,70,40,20,250,0.032520325203252036,70,90,45,15,45,50,315,0.3629032258064516,0.5
50,180,20,180,20,150,600,0.9029850746268657,50,85,55,65,65,90,410,0.7478260869565218,1.0
66,41,77,61,87,23,355,0.12096774193548387,85,97,66,105,66,65,484,0.47107438016528924,1.0
105,140,95,55,65,45,505,0.3,91,72,90,129,90,108,580,0.8925619834710744,1.0
95,135,80,110,80,100,600,0.8248175182481752,60,85,60,50,50,125,430,0.9090909090909091,1.0
58,64,58,80,65,80,405,0.609271523178808,65,125,100,60,70,70,490,0.6099290780141844,2.0
59,74,50,35,50,35,303,0.3125,65,40,70,80,140,70,465,0.5954198473282443,0.0
125,58,58,76,76,67,460,0.515625,37,25,41,25,41,25,194,0.08870967741935484,1.0
55,47,52,40,40,41,275,0.16806722689075632,86,81,97,81,107,43,495,0.203125,1.0
88,107,122,74,75,64,530,0.4596774193548387,65,90,50,85,45,55,390,0.371900826446281,0.125
40,80,35,35,45,70,305,0.4661016949152542,85,115,80,105,80,50,515,0.3063063063063063,1.0
50,180,20,180,20,150,600,0.9029850746268657,60,90,55,90,80,110,485,0.8677685950413223,1.0
49,49,56,49,61,66,330,0.5190839694656488,60,130,80,60,60,70,460,0.5153846153846153,0.5
50,20,40,20,40,20,190,0.0962962962962963,60,40,80,60,45,40,325,0.23529411764705882,1.0
100,100,100,100,100,100,600,0.8758169934640523,45,53,70,40,60,42,310,0.25735294117647056,1.0
55,50,40,40,40,75,300,0.5945945945945946,95,85,85,65,65,35,430,0.2571428571428571,1.0
90,60,70,75,70,45,410,0.23880597014925373,55,75,85,25,25,15,280,0.1875,2.0
106,150,70,194,120,140,780,0.952,89,125,90,115,80,101,600,0.8725490196078431,2.0
85,60,65,135,105,100,550,0.7518248175182481,70,85,70,60,70,50,405,0.28378378378378377,0.5
110,65,75,125,85,30,490,0.15,45,50,43,40,38,62,278,0.40441176470588236,1.0
75,85,200,55,65,30,510,0.16778523489932887,60,90,55,90,80,110,485,0.8677685950413223,1.0
45,49,49,65,65,45,318,0.2781954887218045,35,20,65,40,65,20,245,0.02459016393442623,2.0
100,150,140,100,90,90,670,0.7969924812030075,50,80,95,10,45,10,290,0.232,2.0
20,25,45,70,90,60,310,0.30833333333333335,45,85,70,40,40,60,340,0.5229357798165137,0.0
80,160,60,170,130,80,680,0.6180555555555556,89,125,90,115,80,101,600,0.8725490196078431,2.0
80,95,82,60,82,75,474,0.6,65,50,35,115,95,95,455,0.7333333333333333,1.0
45,50,35,55,75,40,300,0.21367521367521367,88,107,122,74,75,64,530,0.4596774193548387,1.0
70,90,90,135,90,125,600,0.9401709401709402,77,59,50,67,63,46,362,0.23140495867768596,1.0
40,45,65,100,120,90,460,0.5588235294117647,70,140,70,110,65,105,560,0.95,0.0
123,77,72,99,92,58,521,0.4621212121212121,40,29,45,29,45,36,224,0.14634146341463414,2.0
50,65,45,85,65,95,405,0.7238095238095238,110,80,90,95,90,65,530,0.5033557046979866,2.0
62,77,62,50,42,65,358,0.4838709677419355,38,35,35,65,55,50,278,0.2647058823529412,1.0
65,130,60,95,110,65,525,0.5303030303030303,70,90,70,60,60,70,420,0.6390977443609023,1.0
70,95,125,65,75,45,475,0.33613445378151263,80,120,79,95,79,70,523,0.5833333333333334,1.0
70,55,95,95,110,65,490,0.48872180451127817,95,155,109,70,130,81,640,0.6788321167883211,0.0
75,75,130,75,130,95,580,0.7479674796747967,39,52,43,60,50,65,309,0.49107142857142855,1.0
74,48,76,83,81,104,466,0.7322834645669292,59,74,50,35,50,35,303,0.3125,2.0
68,165,95,65,115,110,618,0.8615384615384616,70,70,70,70,70,70,420,0.5289256198347108,2.0
80,110,60,150,130,70,600,0.5042016806722689,66,41,77,61,87,23,355,0.12096774193548387,1.0
65,150,40,15,80,145,495,0.9663865546218487,150,120,100,120,100,90,680,0.664179104477612,0.25
40,40,55,40,70,55,300,0.40939597315436244,65,125,60,95,60,105,510,0.9236641221374046,1.0
114,85,70,85,80,30,464,0.2066115702479339,65,90,40,45,80,75,395,0.625,0.125
90,120,100,150,120,100,680,0.7718120805369127,78,104,78,159,115,100,634,0.8444444444444444,2.0
50,65,107,105,107,86,520,0.7272727272727273,55,95,115,45,45,35,390,0.2116788321167883,0.0
80,90,80,130,110,110,600,0.856,42,52,67,39,56,50,306,0.2868217054263566,1.0
105,140,55,30,55,95,480,0.8195488721804511,85,60,65,135,105,100,550,0.7518248175182481,1.0
75,100,110,45,55,65,450,0.5333333333333333,106,150,70,194,120,140,780,0.952,1.0
85,105,55,85,50,115,495,0.9032258064516129,50,95,90,95,90,180,600,0.9172413793103448,1.0
45,45,55,45,55,63,308,0.4594594594594595,1,90,45,30,30,40,236,0.33064516129032256,0.5
95,95,85,125,65,55,520,0.3894736842105263,55,47,52,40,40,41,275,0.16806722689075632,1.0
64,78,52,78,52,81,405,0.6422764227642277,50,75,35,70,30,40,300,0.21296296296296297,1.0
44,48,65,50,64,43,314,0.1623931623931624,40,80,100,30,30,20,300,0.11851851851851852,4.0
60,80,50,40,40,30,300,0.15328467153284672,45,50,45,115,55,95,405,0.6936936936936937,0.5
35,45,160,30,45,70,385,0.48148148148148145,65,125,60,95,60,105,510,0.9236641221374046,0.5
65,50,35,115,95,95,455,0.7333333333333333,95,110,95,40,95,55,490,0.40336134453781514,1.0
60,40,80,60,45,40,325,0.23529411764705882,95,95,85,125,65,55,520,0.3894736842105263,0.25
40,55,80,35,60,30,300,0.15037593984962405,10,55,25,35,45,95,265,0.5396825396825397,2.0
38,41,40,50,65,65,299,0.4108527131782946,160,110,65,65,110,30,540,0.35714285714285715,1.0
79,115,70,125,80,111,580,0.8468468468468469,60,69,95,69,95,36,424,0.2608695652173913,1.0
60,45,70,75,85,55,390,0.3008130081300813,65,85,70,75,70,40,405,0.203125,1.0
45,60,32,50,32,76,295,0.5925925925925926,80,80,50,40,50,25,325,0.176056338028169,1.0
70,115,60,115,60,55,475,0.4647887323943662,95,75,80,100,110,30,490,0.24242424242424243,4.0
108,170,115,120,95,92,700,0.7083333333333334,60,100,115,70,85,90,520,0.7557251908396947,1.0
41,56,40,62,44,71,314,0.568,45,49,65,49,65,45,318,0.275,0.5
60,62,63,80,80,60,405,0.38016528925619836,75,65,55,65,55,69,384,0.43548387096774194,2.0
55,85,55,50,55,60,360,0.4233576642335766,45,60,45,25,45,55,275,0.29,1.0
80,92,65,65,80,68,450,0.4824561403508772,40,45,40,62,60,60,307,0.33884297520661155,2.0
55,68,64,45,55,31,318,0.11666666666666667,40,60,30,31,31,70,262,0.4492753623188406,0.5
80,70,65,80,120,100,515,0.8034188034188035,85,105,85,40,50,40,405,0.211864406779661,1.0
90,85,100,95,125,85,580,0.6834532374100719,50,75,70,35,70,48,348,0.29357798165137616,2.0
106,130,90,110,154,90,680,0.719626168224299,30,45,135,45,90,30,375,0.09285714285714286,0.25
80,135,130,95,90,70,600,0.5181818181818182,105,140,55,30,55,95,480,0.8195488721804511,0.5
150,160,100,95,65,100,670,0.8866666666666667,60,62,63,80,80,60,405,0.38016528925619836,1.0
89,125,90,115,80,101,600,0.8725490196078431,73,95,62,85,65,85,465,0.6666666666666666,1.0
76,147,90,60,70,97,540,0.8267716535433071,70,105,105,50,40,20,390,0.33587786259541985,1.0
95,100,85,108,70,70,528,0.5652173913043478,130,70,35,70,35,60,400,0.4017857142857143,0.5
45,100,45,45,45,10,290,0.2949640287769784,70,60,62,80,82,60,414,0.4375,0.0
53,54,53,37,46,45,288,0.3090909090909091,65,45,55,45,70,45,325,0.24369747899159663,1.0
60,80,95,70,85,50,440,0.2231404958677686,97,165,60,65,50,58,495,0.3902439024390244,2.0
40,65,95,60,45,35,340,0.13986013986013987,86,68,72,109,66,106,507,0.8099173553719008,1.0
65,40,50,125,60,30,370,0.07258064516129033,123,100,62,97,81,68,531,0.4806201550387597,1.0
123,77,72,99,92,58,521,0.4621212121212121,60,50,70,50,90,65,385,0.39568345323741005,2.0
90,92,75,92,85,60,494,0.49586776859504134,84,71,43,71,43,48,360,0.25874125874125875,1.0
45,100,45,45,45,10,290,0.2949640287769784,74,48,76,83,81,104,466,0.7913043478260869,1.0
105,105,75,65,100,50,500,0.37593984962406013,45,49,65,49,65,45,318,0.275,2.0
85,105,55,85,50,115,495,0.9032258064516129,72,95,67,103,71,122,530,0.9606299212598425,0.5
90,100,70,110,150,80,600,0.6037735849056604,95,75,110,100,80,30,490,0.15267175572519084,1.0
90,60,70,75,70,45,410,0.23880597014925373,45,45,35,20,30,20,195,0.07246376811594203,1.0
77,85,51,55,51,65,384,0.5163934426229508,65,110,130,60,65,95,525,0.8278145695364238,2.0
70,55,55,80,60,45,365,0.2222222222222222,38,30,85,55,65,30,303,0.21428571428571427,1.0
65,85,70,75,70,40,405,0.203125,50,60,60,60,60,30,320,0.11290322580645161,2.0
125,120,90,170,100,95,700,0.78125,65,55,115,100,40,60,435,0.3798449612403101,2.0
40,35,30,20,20,50,195,0.23423423423423423,106,190,100,154,100,130,780,0.9259259259259259,1.0
78,92,75,74,63,118,500,0.8842975206611571,75,140,65,112,65,110,567,0.9140625,0.5
45,50,43,40,38,62,278,0.40441176470588236,60,110,70,60,60,100,460,0.8461538461538461,1.0
90,100,70,110,150,80,600,0.6037735849056604,55,50,65,175,95,150,590,0.7818181818181819,1.0
78,81,71,74,69,126,499,0.9090909090909091,90,65,65,40,40,15,315,0.19672131147540983,0.5
90,120,75,60,60,45,450,0.29411764705882354,85,56,77,50,77,78,423,0.53125,1.0
80,80,80,80,80,80,480,0.5606060606060606,60,45,70,45,90,95,405,0.7304964539007093,1.0
70,85,140,85,70,20,470,0.272,75,38,38,56,56,67,330,0.5263157894736842,0.5
59,74,50,35,50,35,303,0.3125,60,60,50,40,50,75,335,0.5882352941176471,0.0
100,150,110,95,110,70,635,0.5923076923076923,45,35,50,70,50,30,280,0.15753424657534246,0.25
77,120,90,60,90,48,485,0.2785714285714286,110,78,73,76,71,60,468,0.3333333333333333,1.0
105,140,55,30,55,95,480,0.8195488721804511,90,75,85,115,90,55,510,0.3445378151260504,1.0
75,105,75,105,75,45,480,0.3274336283185841,60,52,168,47,138,30,495,0.19834710743801653,2.0
90,93,55,70,55,55,418,0.3819444444444444,60,85,42,85,42,91,405,0.8227848101265823,1.0
59,59,58,90,70,73,409,0.5826086956521739,54,63,52,83,56,97,405,0.7697841726618705,0.5
60,40,50,75,85,95,405,0.6044776119402985,44,38,33,61,43,70,289,0.5267857142857143,0.5
110,65,105,55,95,80,510,0.6258503401360545,45,100,135,65,135,45,525,0.29411764705882354,2.0
70,90,45,15,45,50,315,0.3629032258064516,65,60,70,85,75,40,395,0.1796875,1.0
65,65,60,110,95,130,525,0.9253731343283582,70,83,50,37,50,60,350,0.3360655737704918,2.0
65,110,130,60,65,95,525,0.8278145695364238,70,55,55,80,60,45,365,0.2222222222222222,1.0
100,50,80,60,80,50,420,0.34375,70,43,53,43,53,40,302,0.19090909090909092,0.5
120,120,120,120,120,120,720,0.9344262295081968,65,130,60,75,60,75,465,0.689922480620155,1.0
50,70,160,70,160,90,600,0.7417218543046358,64,78,52,78,52,81,405,0.6422764227642277,1.0
65,70,60,65,65,115,440,0.8583333333333333,65,155,120,65,90,105,600,0.8677685950413223,1.0
90,95,105,165,110,45,610,0.2890625,50,65,107,105,107,86,520,0.7313432835820896,0.25
110,123,65,100,65,65,528,0.5217391304347826,39,52,43,60,50,65,309,0.5041322314049587,0.5
78,52,60,63,65,23,341,0.06015037593984962,66,65,48,62,57,52,350,0.36220472440944884,1.0
64,66,68,81,76,50,405,0.25190839694656486,110,130,80,70,60,80,530,0.5862068965517241,2.0
70,70,40,60,40,60,340,0.4247787610619469,105,95,80,40,80,90,490,0.753968253968254,1.0
40,50,45,70,45,70,320,0.5517241379310345,45,30,50,65,50,45,285,0.13821138211382114,0.5
55,70,40,60,40,40,305,0.26956521739130435,40,55,30,30,30,85,270,0.688,2.0
80,70,70,90,100,70,480,0.5609756097560976,45,45,35,20,30,20,195,0.07246376811594203,0.5
70,110,80,55,80,105,500,0.8794326241134752,89,125,90,115,80,101,600,0.8725490196078431,0.5
46,87,60,30,40,57,320,0.37777777777777777,45,40,60,40,75,50,310,0.2926829268292683,1.0
64,51,23,51,23,28,240,0.11363636363636363,40,45,40,62,60,60,307,0.33884297520661155,1.0
63,63,47,41,41,74,329,0.56,91,90,72,90,129,108,580,0.896,1.0
76,48,48,57,62,34,325,0.11688311688311688,75,75,55,105,85,30,425,0.1619718309859155,0.5
75,98,63,98,63,101,498,0.8091603053435115,115,45,20,45,25,20,270,0.11538461538461539,1.0
50,65,45,85,65,95,405,0.7238095238095238,44,75,35,63,33,45,295,0.2647058823529412,1.0
79,100,80,110,90,121,580,0.968,106,190,100,154,100,130,780,0.9259259259259259,2.0
75,125,230,55,95,30,610,0.3448275862068966,60,80,110,50,80,45,425,0.2833333333333333,1.0
65,75,70,95,70,95,470,0.7272727272727273,100,100,100,100,100,100,600,0.831858407079646,0.5
50,85,55,65,65,90,410,0.7478260869565218,60,25,35,70,80,60,330,0.3076923076923077,1.0
50,50,50,50,50,50,300,0.30708661417322836,44,48,65,50,64,43,314,0.1623931623931624,0.5
62,50,58,73,54,72,369,0.4435483870967742,95,75,80,100,110,30,490,0.24242424242424243,0.5
60,55,50,40,55,45,305,0.22377622377622378,75,85,200,55,65,30,510,0.16778523489932887,0.0
64,88,50,88,50,106,446,0.9111111111111111,30,56,35,25,35,72,253,0.48148148148148145,1.0
72,105,115,54,86,68,500,0.5149253731343284,55,70,40,60,40,40,305,0.26956521739130435,2.0
70,110,80,55,80,105,500,0.8794326241134752,65,155,120,65,90,105,600,0.8677685950413223,1.0
45,60,32,50,32,76,295,0.5925925925925926,35,35,35,35,35,35,210,0.13385826771653545,1.0
60,65,80,170,95,130,600,0.8625954198473282,79,100,80,110,90,121,580,0.968,1.0
63,120,85,90,55,55,468,0.2809917355371901,55,45,43,55,43,72,313,0.5853658536585366,2.0
70,115,60,115,60,55,475,0.4647887323943662,45,49,49,65,65,45,318,0.2781954887218045,0.25
65,110,130,60,65,95,525,0.8278145695364238,60,48,45,43,90,42,328,0.21897810218978103,1.0
95,117,80,65,70,92,519,0.8409090909090909,20,40,15,35,35,60,205,0.34285714285714286,2.0
50,53,48,53,48,64,316,0.358974358974359,72,105,115,54,86,68,500,0.5149253731343284,1.0
60,60,60,35,35,30,280,0.11194029850746269,83,106,65,86,65,85,490,0.6640625,1.0
50,65,107,105,107,86,520,0.7313432835820896,40,80,100,30,30,20,300,0.11851851851851852,0.0
55,112,45,74,45,70,401,0.559322033898305,50,70,50,50,50,40,310,0.16296296296296298,1.0
105,140,95,55,65,45,505,0.3,104,91,63,91,73,68,490,0.5118110236220472,2.0
55,40,50,65,85,40,335,0.3181818181818182,60,60,50,40,50,75,335,0.5882352941176471,0.0
70,85,70,60,70,50,405,0.28378378378378377,77,85,51,55,51,65,384,0.5163934426229508,0.5
55,63,90,50,80,42,380,0.21138211382113822,63,60,55,50,50,71,349,0.5289256198347108,0.25
55,85,55,50,55,60,360,0.4233576642335766,85,50,95,120,115,80,545,0.5793650793650794,0.25
65,90,120,85,70,60,490,0.43410852713178294,39,52,43,60,50,65,309,0.49107142857142855,1.0
70,75,80,135,80,135,575,0.917910447761194,60,65,60,130,75,110,500,0.7719298245614035,1.0
91,72,90,129,90,108,580,0.8925619834710744,70,80,65,90,65,85,455,0.578125,1.0
45,45,55,45,55,63,308,0.4594594594594595,70,40,50,55,50,25,290,0.061068702290076333,2.0
70,62,67,55,55,56,365,0.38513513513513514,85,73,70,73,115,67,483,0.5126050420168067,1.0
65,150,60,115,60,115,565,0.935251798561151,80,45,65,90,110,80,470,0.5462962962962963,2.0
80,125,75,40,95,85,500,0.6911764705882353,45,45,55,45,55,63,308,0.4594594594594595,2.0
67,57,55,77,55,114,425,0.8879310344827587,50,95,90,95,90,180,600,0.9172413793103448,0.5
50,65,107,105,107,86,520,0.703125,70,90,90,135,90,125,600,0.9401709401709402,1.0
76,104,71,104,71,108,534,0.912751677852349,165,75,80,40,45,65,470,0.5151515151515151,0.5
78,92,75,74,63,118,500,0.8842975206611571,70,84,70,65,70,51,410,0.2949640287769784,1.0
65,90,122,58,75,84,494,0.71875,150,80,44,90,54,80,498,0.625,1.0
44,48,65,50,64,43,314,0.1623931623931624,62,55,52,109,94,109,481,0.7833333333333333,1.0
40,45,35,30,40,55,245,0.3793103448275862,80,100,200,50,100,50,580,0.3472222222222222,0.25
95,95,85,125,65,55,520,0.3894736842105263,55,104,105,94,75,52,485,0.36363636363636365,2.0
75,100,66,60,66,115,482,0.918918918918919,35,46,34,35,45,20,215,0.072,1.0
60,40,80,60,45,40,325,0.23529411764705882,75,95,67,125,95,83,540,0.7117117117117117,0.5
90,120,100,150,120,100,680,0.7718120805369127,70,140,230,60,80,50,630,0.32432432432432434,0.5
71,82,64,64,59,112,452,0.9327731092436975,65,125,100,60,70,70,490,0.6099290780141844,0.5
45,50,45,115,55,95,405,0.6936936936936937,60,55,145,75,150,40,525,0.2,0.0
45,45,55,45,55,63,308,0.4594594594594595,20,40,15,35,35,60,205,0.34285714285714286,1.0
50,48,43,46,41,60,288,0.47297297297297297,65,40,50,125,60,30,370,0.07258064516129033,1.0
70,85,65,105,85,120,530,0.9262295081967213,50,92,108,92,108,35,485,0.2457627118644068,1.0
40,45,35,40,40,90,290,0.65,75,110,110,110,105,80,590,0.656934306569343,1.0
50,70,50,50,50,40,310,0.16296296296296298,65,95,100,60,50,50,420,0.34959349593495936,0.5
110,123,65,100,65,65,528,0.5217391304347826,30,45,135,45,90,30,375,0.09285714285714286,1.0
50,50,120,80,80,30,410,0.07258064516129033,60,45,70,45,90,95,405,0.7304964539007093,1.0
70,20,50,20,50,40,250,0.1557377049180328,100,5,5,15,65,30,220,0.07692307692307693,1.0
50,65,107,105,107,86,520,0.7272727272727273,60,85,69,60,69,77,420,0.518796992481203,1.0
30,30,42,30,42,70,244,0.4230769230769231,106,90,130,90,154,110,680,0.8699186991869918,1.0
80,100,200,50,100,50,580,0.3472222222222222,100,5,5,15,65,30,220,0.07692307692307693,1.0
80,105,65,60,75,130,515,0.9645390070921985,50,75,45,40,45,60,315,0.4380165289256198,4.0
31,45,90,30,30,40,266,0.21929824561403508,90,85,75,115,100,115,580,0.9381443298969072,2.0
65,65,60,110,95,130,525,0.9253731343283582,60,90,140,50,50,40,430,0.2535211267605634,1.0
75,98,63,98,63,101,498,0.849624060150376,50,50,40,30,30,50,250,0.2781954887218045,2.0
100,100,125,110,50,50,535,0.384,78,130,111,130,85,100,634,0.8561151079136691,0.25
45,75,60,40,30,50,300,0.304,61,72,57,55,55,65,365,0.3984375,1.0
91,134,95,100,100,80,600,0.6304347826086957,60,60,75,60,75,80,410,0.7321428571428571,2.0
45,30,40,105,50,20,290,0.031007751937984496,100,150,110,95,110,70,635,0.5923076923076923,2.0
85,76,64,45,55,90,415,0.6739130434782609,65,95,75,55,55,85,430,0.6933333333333334,1.0
90,70,80,70,95,70,475,0.5190839694656488,80,85,95,30,30,25,345,0.2857142857142857,8.0
80,100,200,50,100,50,580,0.3472222222222222,86,76,86,116,56,95,515,0.7982456140350878,4.0
70,60,75,110,75,90,480,0.7165354330708661,75,125,70,125,70,115,580,0.9037037037037037,1.0
70,85,65,105,85,120,530,0.9262295081967213,80,135,85,70,95,150,615,0.9844961240310077,1.0
73,76,75,81,100,100,505,0.8110236220472441,80,105,105,105,105,80,580,0.5939849624060151,1.0
50,35,55,25,25,15,205,0.05263157894736842,30,40,55,40,55,60,280,0.3237410071942446,1.0
55,50,45,135,95,120,500,0.7714285714285715,75,75,55,105,85,30,425,0.1619718309859155,1.0
60,45,70,45,90,95,405,0.7304964539007093,95,109,105,75,85,56,525,0.34513274336283184,0.0
95,60,79,100,125,81,540,0.6201550387596899,40,35,30,120,70,105,400,0.6692307692307692,1.0
40,27,60,37,50,66,280,0.36220472440944884,76,25,45,67,55,24,292,0.0390625,1.0
45,50,45,115,55,95,405,0.6936936936936937,80,185,115,40,105,75,600,0.6230769230769231,1.0
60,62,63,80,80,60,405,0.38016528925619836,130,85,80,85,95,60,535,0.43884892086330934,2.0
95,80,105,40,70,100,490,0.8046875,59,63,80,65,80,58,405,0.41843971631205673,1.0
35,80,50,50,70,120,405,0.84375,65,50,70,95,80,65,425,0.4262295081967213,1.0
65,60,110,130,95,65,525,0.47761194029850745,70,140,230,60,80,50,630,0.32432432432432434,0.5
80,90,80,130,110,110,600,0.856,50,120,53,35,110,87,455,0.640625,1.0
80,105,105,105,105,80,580,0.5939849624060151,190,33,58,33,58,33,405,0.13432835820895522,0.5
75,90,90,140,90,115,600,0.9481481481481482,90,70,80,70,95,70,475,0.5190839694656488,1.0
65,83,57,95,85,105,490,0.8914728682170543,75,75,60,83,60,60,413,0.39344262295081966,2.0
40,45,40,65,40,65,295,0.5661764705882353,45,50,43,40,38,62,278,0.40441176470588236,2.0
65,50,70,95,80,65,425,0.4262295081967213,53,54,53,37,46,45,288,0.3090909090909091,0.0
80,80,90,110,130,110,600,0.8721804511278195,50,55,50,36,30,43,264,0.2922077922077922,1.0
80,80,80,55,55,90,440,0.6417910447761194,78,92,75,74,63,118,500,0.8842975206611571,1.0
71,95,85,110,95,79,535,0.664,40,55,30,30,30,60,245,0.43548387096774194,2.0
50,65,64,44,48,43,314,0.2196969696969697,50,75,35,70,30,40,300,0.21296296296296297,0.5
73,100,60,100,60,65,458,0.42657342657342656,68,125,65,65,115,80,518,0.6277372262773723,1.0
40,30,35,45,40,55,245,0.31496062992125984,35,45,160,30,45,70,385,0.48148148148148145,0.5
80,52,50,90,50,89,411,0.6666666666666666,45,60,32,50,32,76,295,0.5925925925925926,0.5
75,75,95,75,95,113,528,0.9015151515151515,43,80,65,50,35,35,308,0.14193548387096774,2.0
80,82,100,83,100,80,525,0.6821705426356589,74,108,133,83,65,32,495,0.32142857142857145,4.0
61,90,45,50,50,160,456,0.9230769230769231,85,105,85,40,50,40,405,0.211864406779661,1.0
60,40,60,40,60,35,295,0.18055555555555555,45,50,45,115,55,95,405,0.6936936936936937,0.5
70,145,88,140,70,112,625,0.8888888888888888,49,55,42,42,37,85,310,0.6068376068376068,2.0
108,170,115,120,95,92,700,0.7083333333333334,30,45,59,30,39,57,260,0.2803030303030303,1.0
100,75,115,90,115,85,580,0.6446280991735537,90,60,60,40,40,40,330,0.29545454545454547,2.0
79,85,60,55,60,71,410,0.60431654676259,39,52,43,60,50,65,309,0.49107142857142855,2.0
70,110,80,55,80,105,500,0.8794326241134752,82,121,119,69,59,71,521,0.5394736842105263,0.5
40,45,40,35,35,56,251,0.373015873015873,70,115,60,115,60,55,475,0.4647887323943662,2.0
80,145,150,105,110,110,700,0.8692307692307693,54,78,103,53,45,22,355,0.23255813953488372,1.0
45,30,35,20,20,45,195,0.14782608695652175,40,40,50,30,30,30,220,0.0873015873015873,2.0
50,160,110,160,110,110,700,0.8854961832061069,90,75,85,115,90,55,510,0.3445378151260504,1.0
35,70,55,45,55,25,285,0.09420289855072464,35,20,65,40,65,20,245,0.02459016393442623,0.5
39,52,43,60,50,65,309,0.5041322314049587,70,120,40,95,40,95,460,0.8106060606060606,0.5
65,65,65,50,50,90,385,0.72,70,55,55,80,60,45,365,0.2222222222222222,1.0
70,130,100,55,80,65,500,0.608,50,52,48,65,50,55,320,0.33098591549295775,0.5
70,85,70,60,70,50,405,0.28378378378378377,103,60,126,80,126,50,545,0.36363636363636365,1.0
70,60,62,80,82,60,414,0.4375,70,62,67,55,55,56,365,0.38513513513513514,0.5
30,42,118,42,88,30,350,0.112,80,52,50,90,50,89,411,0.6666666666666666,4.0
50,70,50,50,50,70,340,0.5645161290322581,77,85,51,55,51,65,384,0.5163934426229508,0.5
40,35,30,20,20,50,195,0.23423423423423423,80,100,70,60,70,95,475,0.7416666666666667,4.0
130,65,60,110,95,65,525,0.5227272727272727,100,70,70,65,65,45,415,0.1897810218978102,1.0
55,55,45,63,45,45,308,0.25,85,120,70,50,60,100,485,0.8308823529411765,1.0
91,90,129,90,72,108,580,0.9140625,91,90,106,130,106,77,600,0.648854961832061,0.5
65,65,45,75,45,95,390,0.72,90,120,100,150,120,100,680,0.7718120805369127,1.0
74,48,76,83,81,104,466,0.7322834645669292,80,82,83,100,100,80,525,0.6742424242424242,2.0
105,130,120,45,45,40,485,0.4444444444444444,50,55,50,36,30,43,264,0.2922077922077922,0.0
70,65,65,55,55,70,380,0.5,70,80,70,80,70,110,480,0.6594202898550725,0.0
75,95,125,45,75,95,510,0.8257575757575758,78,130,111,130,85,100,634,0.8561151079136691,2.0
90,55,75,60,75,30,385,0.13970588235294118,75,105,75,105,75,45,480,0.3274336283185841,1.0
48,61,40,61,40,50,300,0.2543859649122807,55,85,122,58,75,99,494,0.8099173553719008,0.0
68,165,95,65,115,110,618,0.8615384615384616,85,105,100,79,83,78,530,0.5869565217391305,1.0
60,45,70,75,85,55,390,0.3008130081300813,100,150,140,100,90,90,670,0.7969924812030075,2.0
110,135,60,50,65,88,508,0.7744360902255639,70,20,50,20,50,40,250,0.1557377049180328,0.25
85,80,70,135,75,90,535,0.7006802721088435,45,45,35,20,30,20,195,0.07246376811594203,1.0
70,105,105,50,40,20,390,0.33587786259541985,65,90,115,45,115,58,488,0.5041322314049587,0.5
59,74,50,35,50,35,303,0.3125,60,45,50,90,80,70,395,0.625,0.0
100,100,100,100,100,100,600,0.8758169934640523,40,55,30,30,30,60,245,0.43548387096774194,1.0
100,103,75,120,75,127,600,0.940677966101695,35,45,160,30,45,70,385,0.48148148148148145,2.0
100,100,125,110,50,50,535,0.384,88,107,122,74,75,64,530,0.4596774193548387,0.5
97,165,60,65,50,58,495,0.3902439024390244,85,105,55,85,50,115,495,0.9032258064516129,1.0
60,62,50,62,60,40,334,0.18181818181818182,85,56,77,50,77,78,423,0.53125,4.0
120,120,120,120,120,120,720,0.9344262295081968,50,45,45,35,35,50,260,0.23529411764705882,1.0
70,75,80,135,80,135,575,0.917910447761194,85,90,80,70,80,130,535,0.9262295081967213,2.0
100,150,140,100,90,90,670,0.7969924812030075,35,46,34,35,45,20,215,0.072,1.0
115,115,85,90,75,100,580,0.8134328358208955,85,120,70,50,60,100,485,0.8308823529411765,1.0
30,40,70,70,25,60,295,0.41353383458646614,85,100,122,58,75,54,494,0.3939393939393939,0.5
68,65,65,125,115,80,518,0.6461538461538462,85,56,77,50,77,78,423,0.53125,2.0
64,78,52,78,52,81,405,0.6422764227642277,40,27,60,37,50,66,280,0.36220472440944884,1.0
100,70,70,65,65,45,415,0.1897810218978102,65,130,60,95,110,65,525,0.5303030303030303,1.0
60,65,70,85,75,40,395,0.21705426356589147,65,80,140,40,70,70,465,0.5223880597014925,0.0
50,55,50,36,30,43,264,0.2922077922077922,80,70,40,100,60,145,495,0.921875,2.0
65,90,122,58,75,84,494,0.71875,65,63,45,45,45,45,308,0.2595419847328244,0.5
35,46,34,35,45,20,215,0.072,45,50,55,75,65,30,320,0.06293706293706294,1.0
45,30,50,55,65,45,290,0.208,65,136,94,54,96,135,580,0.9612403100775194,1.0
69,69,76,69,86,91,460,0.6554621848739496,55,40,40,65,45,35,280,0.16428571428571428,1.0
86,92,88,68,75,73,482,0.6835443037974683,62,48,66,59,57,49,341,0.33884297520661155,0.5
75,125,70,125,70,115,580,0.9037037037037037,44,38,39,61,79,42,303,0.2251655629139073,1.0
75,80,55,25,35,35,305,0.18666666666666668,38,36,38,32,36,57,237,0.3893805309734513,2.0
75,95,60,65,60,115,470,0.8778625954198473,100,73,83,73,83,55,467,0.371900826446281,1.0
45,22,60,27,30,29,213,0.07518796992481203,45,49,65,49,65,45,318,0.275,2.0
75,100,95,40,70,110,490,0.8717948717948718,70,95,85,55,65,70,440,0.5,0.5
90,75,85,115,90,55,510,0.3445378151260504,40,40,55,40,70,55,300,0.40939597315436244,0.0
50,180,20,180,20,150,600,0.9029850746268657,85,105,55,85,50,115,495,0.9032258064516129,1.0
62,77,62,50,42,65,358,0.4838709677419355,65,80,65,35,65,60,370,0.38405797101449274,1.0
40,29,45,29,45,36,224,0.14634146341463414,54,66,70,44,55,46,335,0.4214876033057851,1.0
70,62,67,55,55,56,365,0.38513513513513514,50,50,50,50,50,50,300,0.30708661417322836,1.0
76,65,45,92,42,91,411,0.7449664429530202,83,80,80,135,80,121,579,0.9444444444444444,1.0
69,69,76,69,86,91,460,0.6554621848739496,100,50,80,60,80,50,420,0.34375,0.5
59,110,150,45,49,35,448,0.3333333333333333,90,92,87,75,85,76,505,0.5409836065573771,1.0
70,90,70,60,60,70,420,0.6390977443609023,50,95,180,85,45,70,525,0.5298507462686567,1.0
59,66,70,44,55,41,335,0.25190839694656486,50,65,107,105,107,86,520,0.7313432835820896,0.5
74,48,76,83,81,104,466,0.7913043478260869,95,110,95,40,95,55,490,0.40336134453781514,1.0
45,49,65,49,65,45,318,0.275,80,80,80,80,80,80,480,0.5606060606060606,2.0
60,45,70,45,90,95,405,0.7304964539007093,60,110,70,60,60,100,460,0.8461538461538461,2.0
72,85,70,65,70,58,420,0.41304347826086957,90,120,120,60,60,50,500,0.35294117647058826,1.0
85,76,64,45,55,90,415,0.6739130434782609,95,124,78,69,71,58,495,0.37398373983739835,1.0
85,120,70,50,60,100,485,0.8308823529411765,40,80,35,35,45,70,305,0.4661016949152542,2.0
30,45,59,30,39,57,260,0.2803030303030303,74,48,76,83,81,104,466,0.7322834645669292,2.0
85,105,85,40,50,40,405,0.211864406779661,55,130,115,50,50,75,475,0.5982142857142857,1.0
40,35,30,20,20,50,195,0.23423423423423423,60,60,75,60,75,80,410,0.7321428571428571,1.0
62,44,50,44,50,55,305,0.3629032258064516,74,48,76,83,81,104,466,0.7913043478260869,1.0
55,75,60,75,60,103,428,0.7982456140350878,77,59,50,67,63,46,362,0.23140495867768596,0.5
70,85,65,105,85,120,530,0.9262295081967213,92,105,90,125,90,98,600,0.8217054263565892,0.5
35,55,35,30,30,35,220,0.23684210526315788,75,75,95,75,95,113,528,0.9015151515151515,1.0
60,60,60,85,85,85,435,0.631578947368421,30,45,59,30,39,57,260,0.2803030303030303,1.0
110,65,105,55,95,80,510,0.6258503401360545,62,50,58,73,54,72,369,0.4435483870967742,1.0
65,75,90,97,123,44,494,0.1987179487179487,45,85,70,40,40,60,340,0.5229357798165137,0.0
78,65,68,112,154,75,552,0.628099173553719,50,85,85,55,55,50,380,0.3902439024390244,0.5
103,60,126,80,126,50,545,0.36363636363636365,60,80,50,40,40,30,300,0.15328467153284672,1.0
105,125,100,60,100,100,590,0.8359375,53,54,53,37,46,45,288,0.3090909090909091,1.0
75,95,95,95,95,85,540,0.6470588235294118,55,66,44,44,56,85,350,0.6888888888888889,1.0
85,100,122,58,75,54,494,0.3939393939393939,100,150,140,100,90,90,670,0.7969924812030075,2.0
50,65,107,105,107,86,520,0.7758620689655172,40,55,99,40,79,47,360,0.26262626262626265,1.0
59,66,70,44,55,41,335,0.25190839694656486,78,84,78,109,85,100,534,0.8646616541353384,0.25
50,45,45,35,35,50,260,0.23529411764705882,75,90,90,140,90,115,600,0.9481481481481482,1.0
65,70,60,65,65,115,440,0.8583333333333333,60,75,85,100,85,115,520,0.8992248062015504,1.0
110,130,80,70,60,80,530,0.5862068965517241,65,55,115,100,40,60,435,0.3798449612403101,1.0
108,130,95,80,85,102,600,0.7637795275590551,85,97,66,105,66,65,484,0.47107438016528924,2.0
80,80,80,55,55,90,440,0.6417910447761194,100,150,90,180,160,90,770,0.7348484848484849,1.0
45,75,60,40,30,50,300,0.304,62,44,50,44,50,55,305,0.3629032258064516,1.0
40,55,99,40,79,47,360,0.26262626262626265,78,52,60,63,65,23,341,0.06015037593984962,1.0
70,90,70,60,60,70,420,0.6390977443609023,35,85,45,35,35,75,310,0.6492537313432836,1.0
65,83,57,95,85,105,490,0.8914728682170543,57,80,91,80,87,75,470,0.5737704918032787,1.0
45,60,30,80,50,65,330,0.4603174603174603,110,85,95,80,95,50,515,0.2713178294573643,1.0
50,65,107,105,107,86,520,0.703125,110,123,65,100,65,65,528,0.5217391304347826,0.5
50,53,62,58,63,44,330,0.13709677419354838,76,65,45,92,42,91,411,0.7449664429530202,1.0
90,92,87,75,85,76,505,0.5409836065573771,40,40,50,30,30,30,220,0.0873015873015873,1.0
60,95,80,60,80,30,405,0.19480519480519481,70,100,115,30,65,30,410,0.24390243902439024,2.0
75,100,95,40,70,110,490,0.8717948717948718,110,135,60,50,65,88,508,0.7744360902255639,0.5
95,117,184,44,46,28,514,0.2975206611570248,75,103,80,70,80,92,500,0.7933884297520661,2.0
65,45,55,45,70,45,325,0.24369747899159663,70,65,65,55,55,70,380,0.5,1.0
43,80,65,50,35,35,308,0.14193548387096774,130,85,80,85,95,60,535,0.43884892086330934,0.5
60,70,65,125,105,90,515,0.6911764705882353,90,100,70,110,150,80,600,0.6037735849056604,0.5
95,145,130,120,90,120,700,0.9398496240601504,75,125,75,30,75,85,465,0.625,2.0
70,110,80,55,80,105,500,0.8794326241134752,50,75,45,40,45,60,315,0.4380165289256198,2.0
65,136,94,54,96,135,580,0.9612403100775194,78,130,111,130,85,100,634,0.8561151079136691,1.0
59,110,150,45,49,35,448,0.3333333333333333,53,54,53,37,46,45,288,0.3090909090909091,1.0
50,60,60,60,60,30,320,0.11290322580645161,49,49,56,49,61,66,330,0.5190839694656488,0.5
35,46,34,35,45,20,215,0.072,20,40,90,30,90,25,295,0.11363636363636363,0.0
40,70,40,35,40,60,285,0.392,60,60,75,60,75,80,410,0.7321428571428571,0.5
123,100,62,97,81,68,531,0.4806201550387597,40,60,40,40,40,30,250,0.0948905109489051,0.25
45,55,45,65,45,75,330,0.5692307692307692,37,25,41,25,41,25,194,0.08870967741935484,2.0
42,52,67,39,56,50,306,0.2868217054263566,65,100,70,80,80,105,500,0.8666666666666667,4.0
35,55,40,50,50,90,320,0.6838235294117647,70,85,65,105,85,120,530,0.9262295081967213,0.5
80,130,100,160,120,110,700,0.8981481481481481,60,79,105,59,85,36,424,0.17054263565891473,2.0
45,75,60,40,30,50,300,0.304,60,95,80,60,80,30,405,0.19480519480519481,1.0
70,120,65,45,85,125,510,0.9747899159663865,45,60,45,25,45,55,275,0.29,1.0
70,75,60,105,60,105,475,0.88,70,77,60,97,60,108,472,0.8394160583941606,0.5
54,45,47,75,98,52,371,0.39669421487603307,60,90,70,60,120,40,440,0.27419354838709675,1.0
70,120,40,95,40,95,460,0.8106060606060606,45,65,34,40,34,45,263,0.2589928057553957,1.0
30,45,59,30,39,57,260,0.2803030303030303,95,75,110,100,80,30,490,0.15267175572519084,2.0
43,70,48,50,60,38,309,0.2391304347826087,116,55,85,107,95,29,487,0.06818181818181818,2.0
65,90,122,58,75,84,494,0.71875,67,125,40,30,30,58,350,0.3431372549019608,2.0
45,50,45,115,55,95,405,0.6936936936936937,40,45,40,35,35,56,251,0.373015873015873,0.0
90,95,105,165,110,45,610,0.2890625,36,50,50,65,60,44,305,0.16363636363636364,1.0
70,85,65,105,85,120,530,0.9262295081967213,25,20,15,105,55,90,310,0.32407407407407407,1.0
20,10,230,10,230,5,505,0.0,44,75,35,63,33,45,295,0.2647058823529412,0.5
70,80,70,80,70,110,480,0.6594202898550725,65,65,65,50,50,90,385,0.72,0.5
86,68,72,109,66,106,507,0.8099173553719008,45,50,43,40,38,62,278,0.40441176470588236,1.0
111,83,68,92,82,39,475,0.1774193548387097,95,110,80,70,80,50,485,0.37209302325581395,1.0
95,110,95,40,95,55,490,0.40336134453781514,45,53,70,40,60,42,310,0.25735294117647056,1.0
110,130,80,70,60,80,530,0.5862068965517241,46,57,40,40,40,50,273,0.25,2.0
40,65,95,60,45,35,340,0.13986013986013987,35,55,35,30,30,35,220,0.23684210526315788,1.0
65,90,40,45,80,75,395,0.625,170,90,45,90,45,60,500,0.427536231884058,1.0
80,80,80,80,80,80,480,0.5606060606060606,95,109,105,75,85,56,525,0.34513274336283184,1.0
90,55,75,60,75,30,385,0.13970588235294118,115,115,85,90,75,100,580,0.8134328358208955,1.0
69,69,76,69,86,91,460,0.6554621848739496,150,160,100,95,65,100,670,0.8866666666666667,1.0
130,65,60,110,95,65,525,0.5227272727272727,60,60,60,35,35,30,280,0.11194029850746269,1.0
100,70,70,65,65,45,415,0.1897810218978102,50,65,107,105,107,86,520,0.703125,1.0
70,120,65,45,85,125,510,0.9747899159663865,75,90,140,60,60,40,465,0.3008130081300813,0.5
75,95,122,58,75,69,494,0.5725806451612904,90,75,75,90,100,70,500,0.5462184873949579,2.0
70,20,50,20,50,40,250,0.1557377049180328,100,120,120,150,100,90,680,0.7880794701986755,0.5
68,125,65,65,115,80,518,0.6277372262773723,135,85,40,40,85,5,390,0.6864406779661016,2.0
90,85,100,95,125,85,580,0.6834532374100719,70,70,40,60,40,60,340,0.4247787610619469,4.0
54,78,103,53,45,22,355,0.23255813953488372,75,75,95,75,95,113,528,0.9015151515151515,0.5
75,65,55,65,55,69,384,0.43548387096774194,60,55,145,75,150,40,525,0.2,8.0
20,25,45,70,90,60,310,0.30833333333333335,79,115,70,125,80,111,580,0.864,1.0
100,134,110,95,100,61,600,0.4057971014492754,55,40,85,80,105,40,405,0.23622047244094488,1.0
40,55,30,30,30,60,245,0.43548387096774194,72,85,70,65,70,58,420,0.41304347826086957,1.0
105,95,75,85,75,74,509,0.5714285714285714,100,150,140,100,90,90,670,0.7969924812030075,2.0
75,75,130,75,130,95,580,0.7479674796747967,71,120,95,120,95,99,600,0.8203125,0.5
70,65,65,55,55,70,380,0.5,105,30,105,140,105,55,540,0.3524590163934426,1.0
35,35,40,35,55,50,250,0.40336134453781514,100,100,100,100,100,100,600,0.8805970149253731,2.0
65,80,65,35,65,60,370,0.38405797101449274,45,100,45,45,45,10,290,0.2949640287769784,1.0
74,94,131,54,116,20,489,0.4485294117647059,70,50,30,95,135,105,485,0.8040540540540541,2.0
60,80,50,40,40,30,300,0.15328467153284672,78,65,68,112,154,75,552,0.628099173553719,1.0
65,90,50,85,45,55,390,0.371900826446281,108,170,115,120,95,92,700,0.7083333333333334,0.5
72,60,30,20,30,25,237,0.11570247933884298,105,95,75,85,75,74,509,0.5714285714285714,1.0
35,35,35,35,35,35,210,0.13385826771653545,35,70,55,45,55,25,285,0.09420289855072464,0.5
130,65,60,110,95,65,525,0.5227272727272727,90,75,85,115,90,55,510,0.3445378151260504,1.0
100,77,77,128,128,90,600,0.6901408450704225,45,80,100,35,37,28,325,0.3125,0.0
65,40,70,80,140,70,465,0.5954198473282443,50,48,43,46,41,60,288,0.47297297297297297,1.0
95,100,85,108,70,70,528,0.5652173913043478,28,25,25,45,35,40,198,0.16083916083916083,1.0
71,82,64,64,59,112,452,0.9327731092436975,70,83,50,37,50,60,350,0.3360655737704918,1.0
65,125,60,95,60,105,510,0.9236641221374046,71,95,85,110,95,79,535,0.664,2.0
40,55,70,45,60,30,300,0.10619469026548672,55,70,45,70,50,60,350,0.45,0.5
60,62,63,80,80,60,405,0.38016528925619836,38,35,40,27,25,35,200,0.08208955223880597,0.5
40,45,40,62,60,60,307,0.33884297520661155,45,50,35,55,75,40,300,0.21367521367521367,0.5
59,45,40,35,40,31,250,0.14285714285714285,55,63,90,50,80,42,380,0.21138211382113822,1.0
80,80,80,80,80,80,480,0.6015037593984962,50,85,125,85,115,20,480,0.4306569343065693,1.0
86,92,88,68,75,73,482,0.6835443037974683,68,75,53,83,113,60,452,0.45384615384615384,1.0
55,130,115,50,50,75,475,0.5982142857142857,95,60,79,100,125,81,540,0.6201550387596899,0.5
100,150,120,120,100,90,680,0.6493506493506493,95,135,80,110,80,100,600,0.8248175182481752,2.0
110,65,75,125,85,30,490,0.15,31,45,90,30,30,40,266,0.21929824561403508,2.0
60,130,80,60,60,70,460,0.5153846153846153,89,125,90,115,80,101,600,0.8725490196078431,0.5
45,75,60,40,30,50,300,0.304,40,60,40,40,40,30,250,0.0948905109489051,1.0
65,70,60,65,65,115,440,0.8583333333333333,70,85,65,105,85,120,530,0.9262295081967213,1.0
105,150,90,150,90,95,680,0.8285714285714286,125,170,100,120,90,95,700,0.77,2.0
126,131,95,131,98,99,680,0.8102189781021898,86,81,97,81,107,43,495,0.203125,1.0
45,49,49,65,65,45,318,0.2781954887218045,65,125,100,60,70,70,490,0.6099290780141844,0.0
70,62,67,55,55,56,365,0.38513513513513514,80,120,130,55,65,45,495,0.37037037037037035,0.25
40,55,70,45,60,30,300,0.10619469026548672,99,68,83,72,87,51,460,0.417910447761194,1.0
60,110,70,60,60,100,460,0.8461538461538461,70,45,48,60,65,35,323,0.15748031496062992,1.0
50,45,45,35,35,50,260,0.23529411764705882,105,140,55,30,55,95,480,0.8195488721804511,1.0
77,85,51,55,51,65,384,0.5163934426229508,64,51,23,51,23,28,240,0.11363636363636363,1.0
110,78,73,76,71,60,468,0.3333333333333333,61,72,57,55,55,65,365,0.3984375,2.0
40,35,30,120,70,105,400,0.6692307692307692,75,125,100,70,80,45,495,0.33035714285714285,1.0
80,105,65,60,75,130,515,0.9645390070921985,75,90,50,110,80,95,500,0.7985611510791367,2.0
70,90,110,60,75,95,500,0.7333333333333333,65,90,65,61,61,100,442,0.8373983739837398,1.0
85,135,130,60,80,25,515,0.40540540540540543,60,69,95,69,95,36,424,0.2608695652173913,1.0
150,100,120,100,120,90,680,0.6666666666666666,100,120,120,150,100,90,680,0.7880794701986755,1.0
55,45,50,45,65,80,340,0.5546218487394958,70,85,65,105,85,120,530,0.9262295081967213,1.0
45,75,60,40,30,50,300,0.304,35,40,100,90,55,35,355,0.1796875,1.0
74,94,131,54,116,20,489,0.4485294117647059,68,72,78,38,42,32,330,0.23809523809523808,2.0
45,60,40,70,50,45,310,0.2846715328467153,50,50,40,50,40,64,294,0.45588235294117646,0.5
78,92,75,74,63,118,500,0.8842975206611571,130,70,35,70,35,60,400,0.4017857142857143,1.0
106,150,70,194,120,140,780,0.952,50,50,40,30,30,50,250,0.2781954887218045,2.0
70,55,95,95,110,65,490,0.48872180451127817,60,79,105,59,85,36,424,0.17054263565891473,2.0
65,65,45,75,45,95,390,0.72,79,115,70,125,80,111,580,0.8468468468468469,0.5
68,65,65,125,115,80,518,0.6461538461538462,40,80,100,30,30,20,300,0.11851851851851852,2.0
55,81,60,50,70,97,413,0.7214285714285714,75,65,55,65,55,69,384,0.43548387096774194,1.0
95,75,80,100,110,30,490,0.24242424242424243,105,95,75,85,75,74,509,0.5714285714285714,2.0
86,76,86,116,56,95,515,0.7982456140350878,64,78,52,78,52,81,405,0.6422764227642277,0.5
79,115,70,125,80,111,580,0.8468468468468469,105,150,90,150,90,95,680,0.8285714285714286,1.0
130,70,35,70,35,60,400,0.4017857142857143,55,70,45,70,50,60,350,0.45,2.0
105,105,75,65,100,50,500,0.37593984962406013,75,98,63,98,63,101,498,0.849624060150376,1.0
77,59,50,67,63,46,362,0.23140495867768596,80,80,80,80,80,80,480,0.6015037593984962,1.0
40,55,70,45,60,30,300,0.10619469026548672,70,70,70,70,70,70,420,0.5289256198347108,1.0
75,89,85,55,65,36,405,0.29545454545454547,150,160,100,95,65,100,670,0.8866666666666667,1.0
80,120,130,55,65,45,495,0.37037037037037035,68,125,65,65,115,80,518,0.6277372262773723,0.5
65,70,60,65,65,115,440,0.8583333333333333,91,134,95,100,100,80,600,0.6304347826086957,1.0
62,50,58,73,54,72,369,0.4435483870967742,59,59,58,90,70,73,409,0.5826086956521739,0.5
45,60,30,80,50,65,330,0.4603174603174603,74,108,133,83,65,32,495,0.32142857142857145,0.25
62,73,55,56,52,84,382,0.7244094488188977,50,53,62,58,63,44,330,0.13709677419354838,0.5
20,40,90,30,90,25,295,0.11363636363636363,75,125,230,55,95,30,610,0.3448275862068966,1.0
95,65,65,110,130,60,525,0.4016393442622951,75,90,50,110,80,95,500,0.7985611510791367,1.0
30,45,135,45,90,30,375,0.09285714285714286,90,60,70,75,70,45,410,0.23880597014925373,2.0
55,45,50,45,65,80,340,0.5546218487394958,60,50,50,60,70,50,340,0.28346456692913385,2.0
20,40,15,35,35,60,205,0.34285714285714286,95,145,130,120,90,120,700,0.9398496240601504,1.0
45,30,50,55,65,45,290,0.208,68,85,65,165,135,100,618,0.8083333333333333,0.5
40,60,40,40,40,30,250,0.0948905109489051,125,58,58,76,76,67,460,0.515625,1.0
78,65,68,112,154,75,552,0.628099173553719,91,90,129,90,72,108,580,0.9140625,1.0
78,81,71,74,69,126,499,0.9090909090909091,1,90,45,30,30,40,236,0.33064516129032256,4.0
60,65,70,85,75,40,395,0.21705426356589147,65,50,35,115,95,95,455,0.7333333333333333,1.0
49,66,70,44,55,51,335,0.4260869565217391,111,83,68,92,82,39,475,0.1774193548387097,4.0
90,100,90,125,85,90,580,0.7352941176470589,40,55,30,30,30,60,245,0.43548387096774194,1.0
65,45,55,45,70,45,325,0.24369747899159663,70,95,125,65,75,45,475,0.33613445378151263,2.0
80,80,80,55,55,90,440,0.6417910447761194,60,65,80,170,95,130,600,0.8625954198473282,0.0
95,85,85,65,65,35,430,0.2571428571428571,44,50,91,24,86,10,305,0.1981981981981982,0.5
35,55,40,45,40,60,275,0.35714285714285715,35,35,35,35,35,35,210,0.13385826771653545,1.0
126,131,95,131,98,99,680,0.8294573643410853,44,58,44,58,44,61,309,0.41964285714285715,0.5
70,120,40,95,40,95,460,0.8106060606060606,90,60,60,40,40,40,330,0.29545454545454547,2.0
100,100,125,110,50,50,535,0.384,60,60,75,60,75,80,410,0.7321428571428571,1.0
101,72,72,99,89,29,462,0.1937984496124031,125,58,58,76,76,67,460,0.515625,1.0
40,27,60,37,50,66,280,0.36220472440944884,38,30,85,55,65,30,303,0.21428571428571427,1.0
75,80,70,65,75,90,455,0.7578125,105,105,75,65,100,50,500,0.37593984962406013,0.5
50,20,40,20,40,20,190,0.0962962962962963,50,35,55,25,25,15,205,0.021739130434782608,1.0
75,110,110,110,105,80,590,0.656934306569343,40,35,30,20,20,50,195,0.23423423423423423,0.5
90,55,75,60,75,30,385,0.13970588235294118,105,150,90,150,90,95,680,0.8285714285714286,1.0
65,65,65,50,50,90,385,0.72,55,130,115,50,50,75,475,0.5982142857142857,0.5
58,109,112,48,48,109,484,0.8805970149253731,106,150,70,194,120,140,780,0.952,2.0
70,140,70,110,65,105,560,0.95,50,50,120,80,80,30,410,0.07258064516129033,4.0
72,85,70,65,70,58,420,0.41304347826086957,80,50,100,100,200,50,580,0.2357142857142857,1.0
40,55,80,35,60,30,300,0.15037593984962405,75,90,90,140,90,115,600,0.9481481481481482,0.0
45,30,50,65,50,45,285,0.13821138211382114,64,78,52,78,52,81,405,0.6422764227642277,1.0
70,65,65,55,55,70,380,0.5,150,160,100,95,65,100,670,0.8866666666666667,1.0
65,40,70,80,140,70,465,0.5954198473282443,75,75,95,75,95,113,528,0.9015151515151515,1.0
70,115,60,115,60,55,475,0.4647887323943662,50,160,110,160,110,110,700,0.8854961832061069,1.0
50,75,70,35,70,48,348,0.29357798165137616,60,55,90,145,90,80,520,0.6071428571428571,0.0
70,80,50,35,35,35,305,0.14,60,55,90,145,90,80,520,0.6071428571428571,0.0
40,70,40,35,40,60,285,0.392,45,75,37,70,55,83,365,0.6183206106870229,1.0
80,95,82,60,82,75,474,0.6,108,130,95,80,85,102,600,0.7637795275590551,0.5
60,40,60,40,60,35,295,0.18055555555555555,80,82,83,100,100,80,525,0.6742424242424242,0.25
70,110,75,145,85,145,630,0.9444444444444444,65,60,70,85,75,40,395,0.1796875,1.0
70,120,100,145,105,20,560,0.2824427480916031,66,117,70,40,50,67,410,0.4573643410852713,0.5
65,65,65,50,50,90,385,0.72,50,50,77,95,77,91,440,0.5916666666666667,1.0
80,95,82,60,82,75,474,0.6,85,100,122,58,75,54,494,0.3939393939393939,1.0
55,66,44,44,56,85,350,0.6888888888888889,90,100,70,110,150,80,600,0.6037735849056604,1.0
60,70,105,70,120,75,500,0.5983606557377049,79,100,80,110,90,121,580,0.968,0.0
123,100,62,97,81,68,531,0.4806201550387597,55,47,52,40,40,41,275,0.16806722689075632,0.5
100,100,100,100,100,100,600,0.8805970149253731,55,35,50,55,110,85,390,0.6277372262773723,1.0
70,110,70,115,70,90,525,0.75,68,85,65,165,135,100,618,0.8083333333333333,0.125
80,70,40,100,60,145,495,0.921875,108,130,95,80,85,102,600,0.7637795275590551,1.0
46,57,40,40,40,50,273,0.25,64,115,65,83,63,65,455,0.5323741007194245,0.5
50,65,107,105,107,86,520,0.6991150442477876,60,60,60,35,35,30,280,0.11194029850746269,1.0
65,110,130,60,65,95,525,0.8278145695364238,80,160,80,130,80,100,630,0.8455284552845529,0.5
65,150,40,15,80,145,495,0.9663865546218487,49,49,56,49,61,66,330,0.5190839694656488,1.0
95,75,180,130,80,30,590,0.13793103448275862,55,70,40,60,40,40,305,0.26956521739130435,1.0
80,85,95,30,30,25,345,0.2857142857142857,60,40,50,75,85,95,405,0.6044776119402985,2.0
72,105,115,54,86,68,500,0.5149253731343284,68,85,65,165,135,100,618,0.8083333333333333,1.0
68,125,65,65,115,80,518,0.6277372262773723,70,65,65,55,55,70,380,0.5,2.0
89,145,90,105,80,91,600,0.8549618320610687,50,75,70,35,70,48,348,0.29357798165137616,2.0
20,15,20,10,55,80,200,0.2682926829268293,76,65,45,92,42,91,411,0.7449664429530202,1.0
75,80,55,25,35,35,305,0.18666666666666668,50,70,100,40,40,30,330,0.2222222222222222,4.0
95,145,130,120,90,120,700,0.9398496240601504,60,50,50,60,70,50,340,0.28346456692913385,2.0
90,75,75,90,100,70,500,0.5462184873949579,70,85,140,85,70,20,470,0.272,2.0
50,100,150,100,150,50,600,0.37142857142857144,55,95,55,35,75,115,430,0.9380530973451328,4.0
100,100,100,100,100,100,600,0.8345864661654135,80,52,50,90,50,89,411,0.6666666666666666,0.25
100,123,75,57,75,80,510,0.6923076923076923,80,92,65,65,80,68,450,0.4824561403508772,1.0
55,84,105,114,75,52,485,0.2890625,41,56,40,62,44,71,314,0.568,0.5
76,147,90,60,70,97,540,0.8267716535433071,48,61,40,61,40,50,300,0.2543859649122807,1.0
35,20,65,40,65,20,245,0.02459016393442623,65,90,50,85,45,55,390,0.371900826446281,0.5
111,83,68,92,82,39,475,0.1774193548387097,55,95,115,45,45,35,390,0.2116788321167883,8.0
55,95,55,35,75,115,430,0.9380530973451328,40,30,50,55,55,100,330,0.584070796460177,1.0
78,70,61,50,61,100,420,0.8145161290322581,50,50,50,50,50,50,300,0.30708661417322836,1.0
68,125,65,65,115,80,518,0.6277372262773723,60,25,35,70,80,60,330,0.3076923076923077,0.25
30,105,90,25,25,50,325,0.2773722627737226,66,65,48,62,57,52,350,0.36220472440944884,0.5
79,100,80,110,90,121,580,0.968,45,100,45,45,45,10,290,0.2949640287769784,1.0
40,45,65,100,120,90,460,0.5588235294117647,65,80,140,40,70,70,465,0.5223880597014925,0.25
44,38,39,61,79,42,303,0.2251655629139073,85,80,70,135,75,90,535,0.7006802721088435,1.0
62,73,55,56,52,84,382,0.7244094488188977,85,76,64,45,55,90,415,0.6739130434782609,1.0
60,45,70,75,85,55,390,0.3008130081300813,69,55,45,55,55,15,294,0.11666666666666667,2.0
50,105,125,55,95,50,480,0.375886524822695,60,50,100,85,70,65,430,0.47580645161290325,0.5
70,92,65,80,55,98,460,0.8090909090909091,89,124,80,55,80,55,483,0.5714285714285714,2.0
55,50,45,135,95,120,500,0.7714285714285715,78,84,78,109,85,100,534,0.8620689655172413,1.0
70,110,180,60,60,50,530,0.4117647058823529,65,90,40,45,80,75,395,0.625,2.0
50,95,180,85,45,70,525,0.5298507462686567,95,135,80,110,80,100,600,0.8248175182481752,2.0
115,45,20,45,25,20,270,0.11538461538461539,86,92,88,68,75,73,482,0.6835443037974683,2.0
80,75,150,75,150,50,580,0.30973451327433627,78,81,71,74,69,126,499,0.9090909090909091,0.5
50,95,180,85,45,70,525,0.5298507462686567,67,89,116,79,116,33,500,0.2624113475177305,0.5
40,30,32,50,52,65,269,0.3671875,70,45,48,60,65,35,323,0.15748031496062992,0.5
70,110,75,145,85,145,630,0.9444444444444444,90,75,85,115,90,55,510,0.3445378151260504,1.0
62,48,66,59,57,49,341,0.33884297520661155,55,40,85,80,105,40,405,0.23622047244094488,1.0
68,72,78,38,42,32,330,0.23809523809523808,60,90,70,60,120,40,440,0.27419354838709675,1.0
60,60,60,105,105,105,495,0.848,75,95,125,45,75,95,510,0.8257575757575758,1.0
80,120,79,95,79,70,523,0.5833333333333334,40,50,90,30,55,65,330,0.44680851063829785,1.0
105,150,90,150,90,95,680,0.8285714285714286,40,65,95,60,45,35,340,0.13986013986013987,1.0
65,55,115,100,40,60,435,0.3798449612403101,60,79,105,59,85,36,424,0.17054263565891473,1.0
95,75,180,130,80,30,590,0.13793103448275862,65,85,70,75,70,40,405,0.203125,1.0
45,35,45,62,53,35,275,0.11851851851851852,75,140,65,112,65,110,567,0.9140625,1.0
54,45,47,75,98,52,371,0.39669421487603307,45,30,50,65,50,45,285,0.13821138211382114,1.0
91,90,72,90,129,108,580,0.896,116,55,85,107,95,29,487,0.06818181818181818,0.5
55,81,60,50,70,97,413,0.7214285714285714,44,38,33,61,43,70,289,0.5267857142857143,1.0
41,50,37,50,37,66,281,0.5175438596491229,59,66,70,44,55,41,335,0.25190839694656486,2.0
75,65,55,65,55,69,384,0.43548387096774194,60,85,69,65,79,80,438,0.576,2.0
70,45,48,60,65,35,323,0.15748031496062992,65,90,65,61,61,100,442,0.8373983739837398,1.0
90,30,15,40,20,15,210,0.043478260869565216,55,65,35,60,30,85,330,0.6126126126126126,1.0
65,83,57,95,85,105,490,0.8914728682170543,61,90,45,50,50,160,456,0.9230769230769231,2.0
45,55,39,35,39,42,255,0.18518518518518517,49,55,42,42,37,85,310,0.6068376068376068,1.0
135,85,40,40,85,5,390,0.6864406779661016,65,40,70,80,140,70,465,0.5954198473282443,1.0
90,30,15,40,20,15,210,0.043478260869565216,35,70,55,45,55,25,285,0.09420289855072464,1.0
85,73,70,73,115,67,483,0.5126050420168067,60,62,50,62,60,40,334,0.18181818181818182,1.0
65,125,60,95,60,105,510,0.9236641221374046,30,45,55,70,55,85,340,0.5633802816901409,1.0
91,90,72,90,129,108,580,0.896,150,100,120,100,120,90,680,0.6666666666666666,0.0
50,20,40,20,40,20,190,0.0962962962962963,65,136,94,54,96,135,580,0.9612403100775194,2.0
50,150,50,150,50,150,600,0.9339622641509434,75,98,63,98,63,101,498,0.849624060150376,1.0
52,65,55,58,62,60,352,0.4482758620689655,30,42,118,42,88,30,350,0.112,0.0625
45,25,50,25,25,35,205,0.13076923076923078,75,80,55,25,35,35,305,0.18666666666666668,0.5
60,85,60,85,60,55,405,0.3673469387755102,71,82,64,64,59,112,452,0.9327731092436975,2.0
80,110,60,150,130,70,600,0.5042016806722689,39,52,43,60,50,65,309,0.49107142857142855,1.0
42,52,67,39,56,50,306,0.2868217054263566,80,115,80,65,55,93,488,0.7846153846153846,2.0
50,85,40,85,40,35,335,0.1746031746031746,70,110,180,60,60,50,530,0.4117647058823529,1.0
50,65,90,35,35,15,290,0.14678899082568808,75,98,63,98,63,101,498,0.889763779527559,0.5
20,10,55,15,20,80,200,0.17985611510791366,70,83,50,37,50,60,350,0.3360655737704918,1.0
78,84,78,109,85,100,534,0.8646616541353384,10,55,25,35,45,95,265,0.5396825396825397,1.0
70,40,50,55,50,25,290,0.061068702290076333,60,85,42,85,42,91,405,0.8227848101265823,2.0
90,90,85,125,90,100,580,0.768595041322314,50,120,53,35,110,87,455,0.640625,2.0
40,80,35,35,45,70,305,0.4661016949152542,100,50,50,76,96,70,442,0.5,1.0
65,90,50,85,45,55,390,0.371900826446281,50,35,55,25,25,15,205,0.021739130434782608,0.5
35,60,44,40,54,55,288,0.366412213740458,75,87,63,87,63,98,473,0.865546218487395,1.0
75,95,60,65,60,115,470,0.8778625954198473,55,95,55,35,75,115,430,0.9380530973451328,1.0
135,85,40,40,85,5,390,0.6864406779661016,59,110,150,45,49,35,448,0.3333333333333333,0.0
70,60,125,115,70,55,495,0.35507246376811596,50,65,45,85,65,95,405,0.7238095238095238,0.5
35,55,40,45,40,60,275,0.35714285714285715,100,150,140,100,90,90,670,0.7969924812030075,0.0
45,20,50,60,120,50,345,0.24074074074074073,80,110,60,150,130,70,600,0.5042016806722689,1.0
90,75,75,90,100,70,500,0.5462184873949579,50,180,20,180,20,150,600,0.9029850746268657,1.0
45,90,20,65,20,65,305,0.5116279069767442,71,82,64,64,59,112,452,0.9327731092436975,1.0
43,70,48,50,60,38,309,0.2391304347826087,49,49,56,49,61,66,330,0.5190839694656488,2.0
100,100,100,100,100,100,600,0.8758169934640523,35,35,40,35,55,50,250,0.40336134453781514,1.0
85,120,70,50,60,100,485,0.8308823529411765,40,35,30,20,20,50,195,0.23423423423423423,2.0
70,60,125,115,70,55,495,0.35507246376811596,55,81,60,50,70,97,413,0.7214285714285714,1.0
95,65,110,60,130,65,525,0.5275590551181102,60,79,105,59,85,36,424,0.17054263565891473,1.0
65,75,105,35,65,85,430,0.6940298507462687,100,180,160,150,90,90,770,0.7520661157024794,2.0
70,80,50,35,35,35,305,0.14,115,115,85,90,75,100,580,0.8134328358208955,1.0
80,100,80,80,80,100,520,0.9051724137931034,50,75,45,40,45,60,315,0.4380165289256198,0.5
60,45,50,90,80,70,395,0.625,30,45,135,45,90,30,375,0.09285714285714286,0.5
65,65,60,130,95,110,525,0.823943661971831,67,125,40,30,30,58,350,0.3431372549019608,1.0
65,60,110,130,95,65,525,0.47761194029850745,62,73,55,56,52,84,382,0.7244094488188977,1.0
20,25,45,70,90,60,310,0.30833333333333335,60,45,50,90,80,70,395,0.625,1.0
70,115,60,115,60,55,475,0.4647887323943662,63,120,85,90,55,55,468,0.2809917355371901,1.0
79,115,70,125,80,111,580,0.864,80,80,50,40,50,25,325,0.176056338028169,1.0
35,65,35,65,35,65,300,0.46621621621621623,80,70,70,90,100,70,480,0.5609756097560976,0.25
80,70,65,80,120,100,515,0.8034188034188035,60,50,50,60,70,50,340,0.28346456692913385,0.5
55,104,105,94,75,52,485,0.36363636363636365,80,82,83,100,100,80,525,0.6742424242424242,0.5
46,87,60,30,40,57,320,0.37777777777777777,45,45,35,20,30,20,195,0.07246376811594203,1.0
85,110,90,45,90,80,500,0.6206896551724138,255,10,10,75,135,55,540,0.3125,1.0
41,56,40,62,44,71,314,0.568,64,66,68,81,76,50,405,0.25190839694656486,0.5
65,90,120,85,70,60,490,0.43410852713178294,40,45,65,100,120,90,460,0.5588235294117647,2.0
43,80,65,50,35,35,308,0.14193548387096774,85,60,65,135,105,100,550,0.7518248175182481,2.0
64,88,50,88,50,106,446,0.9111111111111111,90,120,120,60,60,50,500,0.35294117647058826,1.0
40,29,45,29,45,36,224,0.14634146341463414,55,45,45,25,25,15,210,0.048,1.0
86,81,97,81,107,43,495,0.203125,55,65,95,95,45,85,440,0.6610169491525424,2.0
44,50,91,24,86,10,305,0.1981981981981982,45,95,50,40,50,75,355,0.54,2.0
70,95,125,65,75,45,475,0.33613445378151263,50,85,40,85,40,35,335,0.1746031746031746,2.0
85,135,130,60,80,25,515,0.40540540540540543,40,55,80,35,60,30,300,0.15037593984962405,0.5
50,70,160,70,160,90,600,0.7417218543046358,45,50,35,55,75,40,300,0.21367521367521367,1.0
50,70,160,70,160,90,600,0.7417218543046358,65,50,35,115,95,95,455,0.7333333333333333,0.5
95,65,110,60,130,65,525,0.5275590551181102,110,160,110,80,110,100,670,0.8591549295774648,1.0
120,100,85,30,85,45,465,0.22448979591836735,41,64,45,50,50,50,300,0.36752136752136755,1.0
79,115,70,125,80,111,580,0.864,45,35,50,70,50,30,280,0.15753424657534246,1.0
77,120,90,60,90,48,485,0.2785714285714286,60,59,85,79,105,36,424,0.16666666666666666,1.0
86,68,72,109,66,106,507,0.8099173553719008,91,72,90,129,90,108,580,0.8925619834710744,0.5
40,60,30,31,31,70,262,0.4492753623188406,89,145,90,105,80,91,600,0.8549618320610687,1.0
89,145,90,105,80,91,600,0.8549618320610687,39,52,43,60,50,65,309,0.49107142857142855,2.0
65,90,40,45,80,75,395,0.625,55,75,85,25,25,15,280,0.1875,0.5
105,130,120,45,45,40,485,0.4444444444444444,54,45,47,75,98,52,371,0.39669421487603307,1.0
116,55,85,107,95,29,487,0.06818181818181818,60,95,80,60,80,30,405,0.19480519480519481,1.0
50,50,120,80,80,30,410,0.07258064516129033,75,75,60,83,60,60,413,0.39344262295081966,0.5
85,97,66,105,66,65,484,0.47107438016528924,40,55,30,30,30,85,270,0.688,1.0
130,65,60,110,95,65,525,0.5227272727272727,58,64,58,80,65,80,405,0.609271523178808,2.0
57,80,91,80,87,75,470,0.5737704918032787,55,47,52,40,40,41,275,0.16806722689075632,0.5
50,80,95,10,45,10,290,0.232,70,84,70,65,70,51,410,0.2949640287769784,0.5
80,135,130,95,90,70,600,0.5181818181818182,61,78,95,56,58,57,405,0.40336134453781514,1.0
44,50,91,24,86,10,305,0.1981981981981982,65,155,120,65,90,105,600,0.8677685950413223,0.25
72,85,70,65,70,58,420,0.41304347826086957,255,10,10,75,135,55,540,0.3125,1.0
75,100,66,60,66,115,482,0.918918918918919,80,105,65,60,75,130,515,0.9645390070921985,0.5
60,30,30,36,56,50,262,0.32432432432432434,79,115,70,125,80,111,580,0.864,0.5
90,95,105,165,110,45,610,0.2890625,60,40,60,40,60,35,295,0.18055555555555555,0.5
90,85,75,115,100,115,580,0.9381443298969072,90,70,80,70,95,70,475,0.5190839694656488,2.0
80,185,115,40,105,75,600,0.6230769230769231,90,100,70,110,150,80,600,0.6037735849056604,1.0
75,80,55,25,35,35,305,0.18666666666666668,78,65,68,112,154,75,552,0.628099173553719,0.5
170,90,45,90,45,60,500,0.427536231884058,65,80,65,35,65,60,370,0.38405797101449274,1.0
78,84,78,109,85,100,534,0.8646616541353384,64,66,68,81,76,50,405,0.25190839694656486,0.5
100,150,110,95,110,70,635,0.5923076923076923,40,55,70,45,60,30,300,0.10619469026548672,2.0
55,75,85,25,25,15,280,0.1875,60,65,60,130,75,110,500,0.7719298245614035,1.0
130,85,80,85,95,60,535,0.43884892086330934,30,40,55,40,55,60,280,0.3237410071942446,1.0
20,15,20,10,55,80,200,0.2682926829268293,40,55,80,35,60,30,300,0.15037593984962405,1.0
60,75,85,100,85,115,520,0.8992248062015504,60,85,42,85,42,91,405,0.8227848101265823,0.0
100,100,80,60,60,50,450,0.3050847457627119,95,95,85,125,65,55,520,0.3894736842105263,1.0
90,120,120,60,60,50,500,0.35294117647058826,64,88,50,88,50,106,446,0.9111111111111111,1.0
70,120,40,95,40,95,460,0.8106060606060606,70,85,70,60,70,50,405,0.28378378378378377,1.0
68,75,53,83,113,60,452,0.45384615384615384,60,100,89,55,69,112,485,0.9298245614035088,1.0
125,58,58,76,76,67,460,0.515625,86,76,86,116,56,95,515,0.7982456140350878,2.0
75,80,55,25,35,35,305,0.18666666666666668,67,89,116,79,116,33,500,0.2624113475177305,1.0
40,35,30,20,20,50,195,0.23423423423423423,65,55,115,100,40,60,435,0.3798449612403101,4.0
85,97,66,105,66,65,484,0.47107438016528924,85,80,70,135,75,90,535,0.7006802721088435,1.0
55,40,85,80,105,40,405,0.23622047244094488,85,73,70,73,115,67,483,0.5126050420168067,1.0
95,117,80,65,70,92,519,0.8409090909090909,60,45,70,75,85,55,390,0.3008130081300813,2.0
85,80,70,135,75,90,535,0.7006802721088435,60,65,80,170,95,130,600,0.8625954198473282,0.0
126,131,95,131,98,99,680,0.8294573643410853,91,72,90,129,90,108,580,0.8620689655172413,2.0
65,105,60,60,70,95,455,63.0,65,155,120,65,90,105,600,0.8677685950413223,0.25
105,180,100,180,100,115,780,0.9477611940298507,100,134,110,95,100,61,600,0.4057971014492754,0.5
65,95,75,55,55,85,430,0.6933333333333334,95,60,79,100,125,81,540,0.6201550387596899,0.5
110,123,65,100,65,65,528,0.5217391304347826,50,25,28,45,55,15,218,0.0625,0.5
40,30,35,50,70,55,280,0.28205128205128205,60,48,45,43,90,42,328,0.21897810218978103,1.0
65,130,60,95,110,65,525,0.5303030303030303,78,70,61,50,61,100,420,0.8145161290322581,1.0
100,77,77,128,128,90,600,0.6901408450704225,55,65,95,95,45,85,440,0.6610169491525424,1.0
60,115,105,65,70,80,495,0.7181818181818181,85,105,100,79,83,78,530,0.5869565217391305,0.5
50,35,55,25,25,15,205,0.05263157894736842,65,150,60,115,60,115,565,0.935251798561151,2.0
105,130,120,45,45,40,485,0.4444444444444444,110,130,80,70,60,80,530,0.5862068965517241,1.0
35,55,40,50,50,90,320,0.6838235294117647,45,60,32,50,32,76,295,0.5925925925925926,0.5
105,105,75,65,100,50,500,0.37593984962406013,50,50,120,80,80,30,410,0.07258064516129033,0.5
105,140,95,55,65,45,505,0.3,35,45,160,30,45,70,385,0.48148148148148145,2.0
55,45,50,45,65,80,340,0.5546218487394958,71,73,88,120,89,59,500,0.43537414965986393,2.0
100,100,90,150,140,90,670,0.71875,55,95,115,45,45,35,390,0.2116788321167883,4.0
80,125,75,40,95,85,500,0.6911764705882353,54,66,70,44,55,46,335,0.4214876033057851,0.0
100,123,75,57,75,80,510,0.6923076923076923,95,75,180,130,80,30,590,0.13793103448275862,1.0
60,62,50,62,60,40,334,0.18181818181818182,67,82,62,46,48,43,348,0.22033898305084745,1.0
120,100,85,30,85,45,465,0.22448979591836735,64,115,65,83,63,65,455,0.5323741007194245,0.0
85,97,66,105,66,65,484,0.47107438016528924,71,73,88,120,89,59,500,0.43537414965986393,0.5
45,100,45,45,45,10,290,0.2949640287769784,55,55,50,45,65,55,325,0.37373737373737376,1.0
90,93,55,70,55,55,418,0.3819444444444444,50,95,180,85,45,70,525,0.5298507462686567,2.0
60,85,60,50,50,125,430,0.9090909090909091,40,60,30,31,31,70,262,0.4492753623188406,1.0
60,110,70,60,60,100,460,0.8461538461538461,55,40,50,65,85,40,335,0.3181818181818182,0.0
20,25,45,70,90,60,310,0.30833333333333335,40,45,35,30,40,55,245,0.3793103448275862,1.0
50,52,48,65,50,55,320,0.33098591549295775,40,20,30,40,80,55,265,0.22764227642276422,1.0
50,50,50,50,50,50,300,0.30708661417322836,90,93,55,70,55,55,418,0.3819444444444444,0.5
70,40,50,55,50,25,290,0.061068702290076333,90,30,15,40,20,15,210,0.043478260869565216,1.0
75,125,75,30,75,85,465,0.625,60,70,65,125,105,90,515,0.6911764705882353,0.5
75,95,122,58,75,69,494,0.5725806451612904,73,100,60,100,60,65,458,0.42657342657342656,0.5
85,100,122,58,75,54,494,0.3939393939393939,123,100,62,97,81,68,531,0.4806201550387597,0.5
45,95,50,40,50,75,355,0.54,45,60,32,50,32,76,295,0.5925925925925926,1.0
70,80,65,90,65,85,455,0.578125,70,84,70,65,70,51,410,0.2949640287769784,1.0
43,70,48,50,60,38,309,0.2391304347826087,64,66,68,81,76,50,405,0.25190839694656486,2.0
80,160,80,130,80,100,630,0.8455284552845529,75,125,230,55,95,30,610,0.3448275862068966,4.0
75,100,63,80,63,116,497,0.9345794392523364,100,150,110,95,110,70,635,0.5923076923076923,0.0
71,73,88,120,89,59,500,0.43537414965986393,69,55,45,55,55,15,294,0.11666666666666667,0.5
70,70,115,130,90,60,535,0.5338983050847458,50,53,62,58,63,44,330,0.13709677419354838,1.0
60,85,49,60,49,60,363,0.4444444444444444,110,65,75,125,85,30,490,0.15,1.0
100,100,100,100,100,100,600,0.8758169934640523,60,90,70,60,120,40,440,0.27419354838709675,1.0
50,60,60,60,60,30,320,0.11290322580645161,31,45,90,30,30,40,266,0.21929824561403508,1.0
60,85,60,50,50,125,430,0.9090909090909091,55,70,45,70,50,60,350,0.45,1.0
10,55,25,35,45,95,265,0.5396825396825397,80,70,70,90,100,70,480,0.5609756097560976,0.5
72,85,70,65,70,58,420,0.41304347826086957,75,80,60,65,90,102,472,0.8625954198473282,1.0
60,75,85,100,85,115,520,0.8992248062015504,75,100,110,45,55,65,450,0.5333333333333333,4.0
30,65,100,45,25,40,305,0.1891891891891892,70,120,100,145,105,20,560,0.2824427480916031,4.0
104,91,63,91,73,68,490,0.5118110236220472,35,55,35,30,30,35,220,0.23684210526315788,1.0
50,50,40,50,40,64,294,0.45588235294117646,79,100,80,110,90,121,580,0.968,1.0
60,50,70,50,90,65,385,0.39568345323741005,123,77,72,99,92,58,521,0.4621212121212121,0.5
60,40,50,75,85,95,405,0.6044776119402985,80,105,65,60,75,130,515,0.9645390070921985,2.0
80,70,70,90,100,70,480,0.5609756097560976,40,45,40,62,60,60,307,0.33884297520661155,1.0
91,90,129,90,72,108,580,0.9140625,79,100,80,110,90,121,580,0.968,0.5
50,35,55,25,25,15,205,0.021739130434782608,80,85,95,30,30,25,345,0.2857142857142857,1.0
70,110,70,115,70,90,525,0.75,50,45,45,35,35,50,260,0.23529411764705882,2.0
40,45,35,40,40,90,290,0.65,40,45,35,30,40,55,245,0.3793103448275862,1.0
35,20,65,40,65,20,245,0.02459016393442623,70,95,85,55,65,70,440,0.5,1.0
80,70,70,90,100,70,480,0.5609756097560976,70,55,75,45,65,60,370,0.45901639344262296,0.5
45,35,50,70,50,30,280,0.15753424657534246,90,75,75,90,100,70,500,0.5462184873949579,2.0
80,135,130,95,90,70,600,0.5181818181818182,50,70,100,40,40,30,330,0.2222222222222222,0.5
50,70,50,50,50,40,310,0.16296296296296298,74,100,72,90,72,46,454,0.24561403508771928,0.5
105,95,75,85,75,74,509,0.5714285714285714,108,100,121,81,95,95,600,0.7476635514018691,1.0
50,150,50,150,50,150,600,0.9339622641509434,85,110,90,45,90,80,500,0.6206896551724138,1.0
100,180,160,150,90,90,770,0.7520661157024794,105,130,120,45,45,40,485,0.4444444444444444,1.0
103,60,86,60,86,50,445,0.3458646616541353,30,30,30,30,30,30,180,0.12612612612612611,1.0
100,90,130,45,65,55,485,0.4253731343283582,61,84,65,70,70,70,420,0.5,0.5
60,60,50,40,50,75,335,0.5882352941176471,170,90,45,90,45,60,500,0.427536231884058,2.0
38,41,40,50,65,65,299,0.4108527131782946,55,50,40,40,40,75,300,0.5945945945945946,1.0
115,140,130,55,55,40,535,0.4519230769230769,62,50,58,73,54,72,369,0.4435483870967742,4.0
50,53,48,53,48,64,316,0.358974358974359,70,135,105,60,105,20,495,0.5806451612903226,1.0
61,72,57,55,55,65,365,0.3984375,78,52,60,63,65,23,341,0.06015037593984962,2.0
70,85,70,60,70,50,405,0.28378378378378377,30,45,55,70,55,85,340,0.5633802816901409,0.5
70,140,230,60,80,50,630,0.32432432432432434,80,160,60,170,130,80,680,0.6180555555555556,1.0
79,85,60,55,60,71,410,0.60431654676259,45,35,50,70,50,30,280,0.15753424657534246,0.5
45,63,37,65,55,95,360,0.8055555555555556,70,70,70,70,70,70,420,0.5289256198347108,1.0
80,82,100,83,100,80,525,0.6821705426356589,70,45,48,60,65,35,323,0.15748031496062992,1.0
82,121,119,69,59,71,521,0.5394736842105263,60,60,60,60,60,60,360,0.38095238095238093,1.0
70,80,65,90,65,85,455,0.578125,45,50,55,75,65,30,320,0.06293706293706294,2.0
65,110,130,60,65,95,525,0.8278145695364238,60,55,90,145,90,80,520,0.6071428571428571,0.5
75,90,50,110,80,95,500,0.7985611510791367,130,65,60,110,95,65,525,0.5227272727272727,0.5
68,65,65,125,115,80,518,0.6461538461538462,41,56,40,62,44,71,314,0.568,1.0
60,70,65,125,105,90,515,0.6911764705882353,79,105,70,145,80,101,580,0.8608695652173913,0.5
70,80,70,80,70,110,480,0.6594202898550725,170,90,45,90,45,60,500,0.427536231884058,0.5
64,165,75,93,83,75,555,0.6587301587301587,70,43,53,43,53,40,302,0.19090909090909092,1.0
80,95,82,60,82,75,474,0.6,55,70,55,40,55,85,360,0.7073170731707317,1.0
65,90,115,45,115,58,488,0.5041322314049587,80,185,115,40,105,75,600,0.6230769230769231,0.25
10,55,25,35,45,95,265,0.5396825396825397,75,55,70,55,95,110,460,0.8444444444444444,0.0
85,56,77,50,77,78,423,0.53125,100,100,100,100,100,100,600,0.8758169934640523,1.0
130,85,80,85,95,60,535,0.43884892086330934,60,115,105,65,70,80,495,0.7181818181818181,0.5
85,105,100,79,83,78,530,0.5869565217391305,70,70,115,130,90,60,535,0.5338983050847458,1.0
125,58,58,76,76,67,460,0.515625,70,100,70,105,75,40,460,0.23214285714285715,0.0
82,121,119,69,59,71,521,0.5394736842105263,110,65,105,55,95,80,510,0.6258503401360545,2.0
49,55,42,42,37,85,310,0.6068376068376068,51,65,65,80,75,59,395,0.4365079365079365,1.0
40,20,30,40,80,55,265,0.22764227642276422,74,108,133,83,65,32,495,0.32142857142857145,0.5
86,76,86,116,56,95,515,0.7982456140350878,100,134,110,95,100,61,600,0.4057971014492754,1.0
80,105,65,60,75,130,515,0.9645390070921985,68,85,65,165,135,100,618,0.8083333333333333,1.0
45,75,60,40,30,50,300,0.304,65,136,94,54,96,135,580,0.9612403100775194,1.0
70,94,50,94,50,66,424,0.48148148148148145,80,82,100,83,100,80,525,0.6821705426356589,4.0
30,80,90,55,45,55,355,0.4295774647887324,60,50,100,85,70,65,430,0.47580645161290325,1.0
79,105,70,145,80,101,580,0.8608695652173913,100,164,150,95,120,71,700,0.5645161290322581,0.5
79,115,70,125,80,111,580,0.864,55,70,45,70,50,60,350,0.45,1.0
50,75,45,40,45,60,315,0.4380165289256198,45,63,37,65,55,95,360,0.8055555555555556,1.0
30,45,135,45,90,30,375,0.09285714285714286,86,81,97,81,107,43,495,0.203125,1.0
1,90,45,30,30,40,236,0.33064516129032256,60,60,60,85,85,85,435,0.631578947368421,1.0
40,65,40,80,40,65,330,0.5038167938931297,80,45,65,90,110,80,470,0.5462962962962963,2.0
70,110,75,145,85,145,630,0.9444444444444444,60,60,60,105,105,105,495,0.848,1.0
100,110,90,85,90,60,535,0.47794117647058826,75,100,63,80,63,116,497,0.9345794392523364,2.0
45,95,50,40,50,75,355,0.54,58,70,45,40,45,42,300,0.25925925925925924,0.5
75,80,60,65,90,102,472,0.8625954198473282,60,85,49,60,49,60,363,0.4444444444444444,1.0
80,82,83,100,100,80,525,0.6742424242424242,60,90,55,90,80,110,485,0.8677685950413223,1.0
40,45,40,35,35,56,251,0.373015873015873,55,81,60,50,70,97,413,0.7214285714285714,1.0
91,134,95,100,100,80,600,0.6304347826086957,68,75,53,83,113,60,452,0.45384615384615384,2.0
65,75,105,35,65,85,430,0.6940298507462687,35,55,35,30,30,35,220,0.23684210526315788,1.0
85,50,95,120,115,80,545,0.5793650793650794,77,120,90,60,90,48,485,0.2785714285714286,2.0
45,50,43,40,38,62,278,0.40441176470588236,60,70,50,100,50,65,395,0.5217391304347826,2.0
30,40,70,70,25,60,295,0.41353383458646614,53,54,53,37,46,45,288,0.3090909090909091,1.0
50,50,77,95,77,91,440,0.5916666666666667,65,125,100,55,70,85,500,0.6532258064516129,1.0
73,115,60,60,60,90,458,0.6694915254237288,95,75,180,130,80,30,590,0.13793103448275862,1.0
65,90,65,61,61,100,442,0.8373983739837398,70,100,115,30,65,30,410,0.24390243902439024,0.25
60,62,63,80,80,60,405,0.38016528925619836,60,60,50,40,50,75,335,0.5882352941176471,1.0
90,120,100,150,120,100,680,0.7718120805369127,54,78,103,53,45,22,355,0.23255813953488372,1.0
65,65,65,50,50,90,385,0.72,50,85,125,85,115,20,480,0.4306569343065693,1.0
40,45,40,62,60,60,307,0.33884297520661155,110,135,60,50,65,88,508,0.7744360902255639,2.0
95,75,110,100,80,30,490,0.15267175572519084,60,105,60,120,60,105,510,0.8849557522123894,0.0
90,65,65,40,40,15,315,0.19672131147540983,80,105,105,105,105,80,580,0.5939849624060151,0.5
65,136,94,54,96,135,580,0.9612403100775194,35,45,160,30,45,70,385,0.48148148148148145,1.0
85,80,70,135,75,90,535,0.7006802721088435,39,52,43,60,50,65,309,0.5041322314049587,1.0
50,85,125,85,115,20,480,0.4306569343065693,100,164,150,95,120,71,700,0.5645161290322581,0.25
50,180,20,180,20,150,600,0.9029850746268657,72,95,67,103,71,122,530,0.9606299212598425,0.0
100,100,90,150,140,90,670,0.71875,84,86,88,111,101,60,530,0.4634146341463415,0.5
135,85,40,40,85,5,390,0.6864406779661016,84,71,43,71,43,48,360,0.25874125874125875,1.0
42,52,67,39,56,50,306,0.2868217054263566,50,35,55,25,25,15,205,0.05263157894736842,2.0
80,100,80,80,80,100,520,0.9051724137931034,70,80,102,80,102,40,474,0.2677165354330709,0.0
40,45,40,62,60,60,307,0.33884297520661155,62,48,54,63,60,68,355,0.5178571428571429,1.0
90,60,70,75,70,45,410,0.23880597014925373,67,58,57,81,67,101,431,0.8790322580645161,1.0
65,83,57,95,85,105,490,0.8914728682170543,101,72,72,99,89,29,462,0.1937984496124031,1.0
50,25,28,45,55,15,218,0.0625,70,45,48,60,65,35,323,0.15748031496062992,1.0
60,45,70,45,90,95,405,0.7304964539007093,105,180,100,180,100,115,780,0.9477611940298507,1.0
100,164,150,95,120,71,700,0.5645161290322581,90,132,105,132,105,30,594,0.4246575342465753,2.0
80,120,130,55,65,45,495,0.37037037037037035,60,50,70,50,90,65,385,0.39568345323741005,2.0
86,92,88,68,75,73,482,0.6835443037974683,90,132,105,132,105,30,594,0.4246575342465753,1.0
75,90,90,140,90,115,600,0.9481481481481482,60,110,70,60,60,100,460,0.8461538461538461,1.0
60,55,50,40,55,45,305,0.22377622377622378,46,87,60,30,40,57,320,0.37777777777777777,1.0
80,120,130,55,65,45,495,0.37037037037037035,70,90,45,15,45,50,315,0.3629032258064516,4.0
75,98,63,98,63,101,498,0.8091603053435115,255,10,10,75,135,55,540,0.3125,1.0
65,60,110,130,95,65,525,0.47761194029850745,45,100,45,45,45,10,290,0.2949640287769784,2.0
40,70,40,35,40,60,285,0.392,95,85,85,65,65,35,430,0.2571428571428571,1.0
52,65,50,45,50,38,300,0.27419354838709675,45,50,43,40,38,62,278,0.40441176470588236,1.0
60,50,100,85,70,65,430,0.47580645161290325,76,65,45,92,42,91,411,0.7449664429530202,1.0
30,56,35,25,35,72,253,0.48148148148148145,40,50,90,30,55,65,330,0.44680851063829785,1.0
45,35,50,70,50,30,280,0.15753424657534246,10,55,25,35,45,95,265,0.5396825396825397,2.0
40,30,30,55,30,85,270,0.4666666666666667,40,45,35,30,40,55,245,0.3793103448275862,1.0
65,75,70,95,70,95,470,0.7272727272727273,85,110,90,45,90,80,500,0.6206896551724138,1.0
70,120,65,45,85,125,510,0.9747899159663865,100,123,75,57,75,80,510,0.6923076923076923,2.0
80,145,150,105,110,110,700,0.8692307692307693,80,160,80,130,80,100,630,0.8455284552845529,0.5
60,50,70,80,80,140,480,0.8449612403100775,54,66,70,44,55,46,335,0.4214876033057851,0.5
60,69,95,69,95,36,424,0.2608695652173913,95,100,85,108,70,70,528,0.5652173913043478,0.5
55,45,43,55,43,72,313,0.5853658536585366,65,45,55,45,70,45,325,0.24369747899159663,1.0
55,50,45,135,95,120,500,0.7714285714285715,100,77,77,128,128,90,600,0.6901408450704225,0.5
100,100,100,100,100,100,600,0.8602941176470589,65,125,60,95,60,105,510,0.9236641221374046,1.0
100,73,83,73,83,55,467,0.371900826446281,35,40,100,90,55,35,355,0.1796875,0.5
80,135,85,70,95,150,615,0.9844961240310077,72,58,80,103,80,97,490,0.7171052631578947,2.0
40,55,80,35,60,30,300,0.15037593984962405,55,55,85,65,85,35,380,0.2014388489208633,1.0
100,150,140,100,90,90,670,0.7969924812030075,74,48,76,83,81,104,466,0.7322834645669292,1.0
80,80,80,80,80,80,480,0.5606060606060606,80,80,80,55,55,90,440,0.6417910447761194,1.0
30,35,30,100,35,80,310,0.4765625,70,60,125,115,70,55,495,0.35507246376811596,0.5
70,110,75,145,85,145,630,0.9444444444444444,45,30,35,20,20,45,195,0.14782608695652175,0.5
60,90,70,60,120,40,440,0.27419354838709675,78,92,75,74,63,118,500,0.8842975206611571,1.0
50,85,85,55,55,50,380,0.3902439024390244,41,64,45,50,50,50,300,0.36752136752136755,2.0
35,70,55,45,55,25,285,0.09420289855072464,100,100,100,100,100,100,600,0.8778625954198473,0.5
60,62,63,80,80,60,405,0.38016528925619836,91,90,72,90,129,108,580,0.896,1.0
108,170,115,120,95,92,700,0.7083333333333334,41,50,37,50,37,66,281,0.5175438596491229,1.0
100,164,150,95,120,71,700,0.5645161290322581,68,65,65,125,115,80,518,0.6461538461538462,1.0
55,112,45,74,45,70,401,0.559322033898305,45,50,35,55,75,40,300,0.21367521367521367,1.0
70,85,65,105,85,120,530,0.9262295081967213,90,30,15,40,20,15,210,0.043478260869565216,1.0
35,60,44,40,54,55,288,0.366412213740458,82,80,86,85,75,72,480,0.6183206106870229,2.0
78,92,75,74,63,118,500,0.8842975206611571,100,100,100,100,100,100,600,0.8778625954198473,0.5
75,95,60,65,60,115,470,0.8778625954198473,92,105,90,125,90,98,600,0.8217054263565892,1.0
110,135,60,50,65,88,508,0.7744360902255639,55,75,50,40,40,80,340,0.6302521008403361,0.0
90,75,85,115,90,55,510,0.3445378151260504,72,58,80,103,80,97,490,0.7171052631578947,2.0
59,45,40,35,40,31,250,0.14285714285714285,50,53,48,53,48,64,316,0.46153846153846156,1.0
65,50,70,95,80,65,425,0.4262295081967213,38,36,38,32,36,57,237,0.3893805309734513,1.0
45,55,39,35,39,42,255,0.18518518518518517,35,65,35,65,35,65,300,0.46621621621621623,1.0
92,105,90,125,90,98,600,0.8217054263565892,50,70,160,70,160,90,600,0.7417218543046358,2.0
123,100,62,97,81,68,531,0.4806201550387597,65,60,110,130,95,65,525,0.47761194029850745,1.0
75,85,200,55,65,30,510,0.16778523489932887,72,95,67,103,71,122,530,0.9606299212598425,0.5
80,105,105,105,105,80,580,0.5939849624060151,40,30,50,55,55,100,330,0.584070796460177,1.0
55,65,95,95,45,85,440,0.6610169491525424,65,95,57,100,85,93,495,0.7441860465116279,2.0
116,55,85,107,95,29,487,0.06818181818181818,50,50,50,50,50,50,300,0.30708661417322836,1.0
50,35,55,25,25,15,205,0.021739130434782608,64,165,75,93,83,75,555,0.6587301587301587,0.5
70,62,67,55,55,56,365,0.38513513513513514,75,140,65,112,65,110,567,0.9140625,0.5
100,128,90,77,77,128,600,0.959349593495935,60,45,50,90,80,70,395,0.625,0.25
55,68,64,45,55,31,318,0.11666666666666667,75,87,63,87,63,98,473,0.865546218487395,1.0
50,85,40,85,40,35,335,0.1746031746031746,49,66,70,44,55,51,335,0.4260869565217391,0.5
60,80,50,50,50,40,330,0.23853211009174313,40,30,32,50,52,65,269,0.3671875,1.0
44,58,44,58,44,61,309,0.41964285714285715,75,100,95,40,70,110,490,0.8717948717948718,1.0
70,55,75,45,65,60,370,0.45901639344262296,70,90,90,135,90,125,600,0.9401709401709402,0.5
35,55,40,45,40,60,275,0.35714285714285715,80,125,75,40,95,85,500,0.6911764705882353,1.0
78,104,78,159,115,100,634,0.8444444444444444,70,80,50,35,35,35,305,0.14,2.0
40,45,35,65,55,70,310,0.4482758620689655,40,20,30,40,80,55,265,0.22764227642276422,0.25
55,68,64,45,55,31,318,0.11666666666666667,55,70,40,60,40,40,305,0.26956521739130435,1.0
45,30,15,85,65,65,305,0.36220472440944884,50,47,50,57,50,65,319,0.463768115942029,1.0
50,65,90,35,35,15,290,0.14678899082568808,126,131,95,131,98,99,680,0.8102189781021898,1.0
60,90,140,50,50,40,430,0.2535211267605634,50,30,55,65,55,20,275,0.13675213675213677,1.0
90,130,80,65,85,55,505,0.4396551724137931,67,82,62,46,48,43,348,0.22033898305084745,1.0
60,110,70,60,60,100,460,0.8461538461538461,45,45,35,20,30,20,195,0.07246376811594203,2.0
126,131,95,131,98,99,680,0.8294573643410853,64,66,68,81,76,50,405,0.25190839694656486,1.0
50,50,40,30,30,50,250,0.2781954887218045,50,40,85,40,65,25,305,0.08870967741935484,0.5
65,73,55,47,75,85,400,0.6846846846846847,65,90,115,45,115,58,488,0.5041322314049587,1.0
80,115,80,65,55,93,488,0.7846153846153846,95,95,85,125,65,55,520,0.3894736842105263,2.0
90,85,100,95,125,85,580,0.6834532374100719,74,108,133,83,65,32,495,0.32142857142857145,0.25
60,69,95,69,95,36,424,0.2608695652173913,86,76,86,116,56,95,515,0.7982456140350878,0.5
80,135,130,95,90,70,600,0.5181818181818182,40,40,35,50,100,70,335,0.5031847133757962,1.0
50,52,48,65,50,55,320,0.33098591549295775,69,55,45,55,55,15,294,0.11666666666666667,0.5
40,30,32,50,52,65,269,0.3671875,65,130,60,75,60,75,465,0.689922480620155,2.0
55,40,40,65,45,35,280,0.16428571428571428,85,105,85,40,50,40,405,0.211864406779661,1.0
85,110,76,65,82,56,474,0.3933333333333333,40,29,45,29,45,36,224,0.14634146341463414,0.5
55,40,50,65,85,40,335,0.3181818181818182,55,84,105,114,75,52,485,0.2890625,0.5
66,41,77,61,87,23,355,0.12096774193548387,30,80,90,55,45,55,355,0.4295774647887324,4.0
40,55,30,30,30,60,245,0.43548387096774194,76,48,48,57,62,34,325,0.11688311688311688,1.0
77,120,90,60,90,48,485,0.2785714285714286,40,50,90,30,55,65,330,0.44680851063829785,1.0
50,35,55,25,25,15,205,0.021739130434782608,60,150,50,150,50,60,520,0.5,0.25
80,50,100,100,200,50,580,0.2357142857142857,78,81,71,74,69,126,499,0.9090909090909091,1.0
20,10,55,15,20,80,200,0.17985611510791366,70,110,75,145,85,145,630,0.9444444444444444,0.25
60,80,50,50,50,40,330,0.23853211009174313,62,48,54,63,60,68,355,0.5178571428571429,1.0
120,120,120,120,120,120,720,0.9344262295081968,41,64,45,50,50,50,300,0.36752136752136755,1.0
95,155,109,70,130,81,640,0.6788321167883211,100,100,80,60,60,50,450,0.3050847457627119,2.0
99,68,83,72,87,51,460,0.417910447761194,65,125,100,60,70,70,490,0.6099290780141844,0.25
85,97,66,105,66,65,484,0.47107438016528924,100,73,83,73,83,55,467,0.371900826446281,1.0
80,105,105,105,105,80,580,0.5939849624060151,40,29,45,29,45,36,224,0.14634146341463414,1.0
95,80,105,40,70,100,490,0.8046875,80,80,80,55,55,90,440,0.6417910447761194,1.0
50,70,50,50,50,40,310,0.16296296296296298,70,140,70,110,65,105,560,0.95,0.5
55,47,52,40,40,41,275,0.16806722689075632,77,59,50,67,63,46,362,0.23140495867768596,0.5
50,48,43,46,41,60,288,0.47297297297297297,35,80,50,50,70,120,405,0.84375,2.0
70,150,140,65,100,75,600,0.55,60,75,100,55,80,50,420,0.3088235294117647,0.5
45,30,50,65,50,45,285,0.13821138211382114,62,73,55,56,52,84,382,0.7244094488188977,1.0
75,95,67,125,95,83,540,0.7117117117117117,85,50,95,120,115,80,545,0.5793650793650794,1.0
30,56,35,25,35,72,253,0.48148148148148145,55,75,85,25,25,15,280,0.1875,0.5
110,85,95,80,95,50,515,0.2713178294573643,45,95,50,40,50,75,355,0.54,0.5
255,10,10,75,135,55,540,0.3125,70,84,70,65,70,51,410,0.2949640287769784,0.5
70,100,70,105,75,40,460,0.23214285714285715,45,30,40,105,50,20,290,0.031007751937984496,1.0
38,35,35,65,55,50,278,0.2647058823529412,95,75,110,100,80,30,490,0.15267175572519084,0.5
80,70,70,90,100,70,480,0.5609756097560976,100,100,100,100,100,100,600,0.8602941176470589,0.25
103,60,86,60,86,50,445,0.3458646616541353,50,105,125,55,95,50,480,0.375886524822695,0.5
160,110,65,65,110,30,540,0.35714285714285715,51,65,65,80,75,59,395,0.4365079365079365,1.0
110,130,80,70,60,80,530,0.5862068965517241,60,45,50,90,80,70,395,0.625,0.0
55,35,50,55,110,85,390,0.6277372262773723,65,125,100,55,70,85,500,0.6532258064516129,2.0
78,81,71,74,69,126,499,0.9090909090909091,75,87,63,87,63,98,473,0.865546218487395,0.5
100,75,115,90,115,85,580,0.6446280991735537,75,70,90,70,105,80,490,0.656,0.5
80,95,82,60,82,75,474,0.6,38,30,41,30,41,60,240,0.2897196261682243,1.0
60,50,50,60,70,50,340,0.28346456692913385,65,90,115,45,115,58,488,0.5041322314049587,1.0
55,81,60,50,70,97,413,0.7214285714285714,90,60,60,40,40,40,330,0.29545454545454547,1.0
85,80,70,135,75,90,535,0.7006802721088435,54,66,70,44,55,46,335,0.4214876033057851,0.0
58,64,58,80,65,80,405,0.609271523178808,65,80,80,59,63,58,405,0.4411764705882353,0.5
35,55,35,30,30,35,220,0.23684210526315788,55,50,45,135,95,120,500,0.7714285714285715,2.0
80,120,80,120,80,100,580,0.8478260869565217,52,65,55,58,62,60,352,0.4482758620689655,2.0
55,40,50,65,85,40,335,0.3181818181818182,95,60,79,100,125,81,540,0.6201550387596899,0.5
75,80,95,90,100,50,490,0.2158273381294964,75,100,95,40,70,110,490,0.8717948717948718,1.0
70,80,50,35,35,35,305,0.14,70,70,40,60,40,60,340,0.4247787610619469,2.0
60,80,95,70,85,50,440,0.2231404958677686,35,70,55,45,55,25,285,0.09420289855072464,1.0
95,23,48,23,48,23,260,0.046153846153846156,90,50,34,60,44,70,348,0.6283185840707964,1.0
45,100,45,45,45,10,290,0.2949640287769784,40,30,30,40,50,30,220,0.07936507936507936,0.5
40,50,90,30,55,65,330,0.44680851063829785,115,140,130,55,55,40,535,0.4519230769230769,0.25
45,49,49,65,65,45,318,0.2781954887218045,55,81,60,50,70,97,413,0.7214285714285714,1.0
75,38,38,56,56,67,330,0.5263157894736842,61,90,45,50,50,160,456,0.9230769230769231,2.0
50,50,95,40,50,35,320,0.20279720279720279,100,100,100,100,100,100,600,0.831858407079646,1.0
250,5,5,35,105,50,450,0.15306122448979592,40,80,35,35,45,70,305,0.4661016949152542,1.0
80,75,150,75,150,50,580,0.30973451327433627,70,90,70,60,60,70,420,0.6390977443609023,1.0
70,65,60,90,75,90,450,0.6571428571428571,48,61,40,61,40,50,300,0.2543859649122807,0.125
95,125,79,60,100,81,540,0.6165413533834586,60,80,50,50,50,40,330,0.23853211009174313,1.0
91,72,90,129,90,108,580,0.8620689655172413,45,100,45,45,45,10,290,0.2949640287769784,2.0
55,130,115,50,50,75,475,0.5982142857142857,90,70,80,70,95,70,475,0.5190839694656488,0.5
70,120,40,95,40,95,460,0.8106060606060606,35,35,40,35,55,50,250,0.40336134453781514,0.5
108,170,115,120,95,92,700,0.7083333333333334,90,130,80,65,85,55,505,0.4396551724137931,1.0
49,66,70,44,55,51,335,0.4260869565217391,70,92,65,80,55,98,460,0.8090909090909091,2.0
60,60,60,35,35,30,280,0.11194029850746269,80,95,82,60,82,75,474,0.6,1.0
95,70,73,95,90,60,483,0.3983739837398374,50,105,125,55,95,50,480,0.375886524822695,0.5
100,150,140,100,90,90,670,0.7969924812030075,105,130,120,45,45,40,485,0.4444444444444444,2.0
75,75,75,125,95,40,485,0.15671641791044777,65,65,60,110,95,130,525,0.9253731343283582,1.0
103,60,126,80,126,50,545,0.36363636363636365,61,78,95,56,58,57,405,0.40336134453781514,1.0
46,57,40,40,40,50,273,0.25,45,60,32,50,32,76,295,0.5925925925925926,1.0
65,130,60,95,110,65,525,0.5303030303030303,77,59,50,67,63,46,362,0.23140495867768596,1.0
100,70,70,65,65,45,415,0.1897810218978102,50,75,45,40,45,60,315,0.4380165289256198,1.0
100,120,120,150,100,90,680,0.7880794701986755,70,120,40,95,40,95,460,0.8106060606060606,0.5
108,112,118,68,72,47,525,0.2916666666666667,50,48,43,46,41,60,288,0.47297297297297297,1.0
85,105,55,85,50,115,495,0.9032258064516129,75,98,63,98,63,101,498,0.8091603053435115,0.5
105,30,105,140,105,55,540,0.3524590163934426,45,50,45,115,55,95,405,0.6936936936936937,2.0
60,55,90,145,90,80,520,0.6071428571428571,70,95,85,55,65,70,440,0.5,1.0
95,117,80,65,70,92,519,0.8409090909090909,80,80,80,80,80,80,480,0.5606060606060606,1.0
68,125,65,65,115,80,518,0.6277372262773723,60,69,95,69,95,36,424,0.2608695652173913,0.5
90,85,100,95,125,85,580,0.6834532374100719,70,120,100,145,105,20,560,0.2824427480916031,1.0
95,110,80,70,80,50,485,0.37209302325581395,44,38,39,61,79,42,303,0.2251655629139073,1.0
100,100,100,100,100,100,600,0.8778625954198473,100,134,110,95,100,61,600,0.4057971014492754,0.0
61,72,57,55,55,65,365,0.3984375,45,30,15,85,65,65,305,0.36220472440944884,1.0
55,95,55,35,75,115,430,0.9380530973451328,72,85,70,65,70,58,420,0.41304347826086957,1.0
45,45,35,20,30,20,195,0.07246376811594203,108,100,121,81,95,95,600,0.7476635514018691,1.0
66,41,77,61,87,23,355,0.12096774193548387,50,105,79,35,110,76,455,0.6214285714285714,0.5
70,135,105,60,105,20,495,0.5806451612903226,80,80,80,55,55,90,440,0.6417910447761194,1.0
65,90,50,85,45,55,390,0.371900826446281,65,73,55,47,75,85,400,0.6846846846846847,0.5
90,75,75,90,100,70,500,0.5462184873949579,55,95,55,35,75,115,430,0.9380530973451328,1.0
80,82,78,95,80,85,500,0.6869565217391305,45,53,70,40,60,42,310,0.25735294117647056,0.5
20,15,20,10,55,80,200,0.2682926829268293,100,150,110,95,110,70,635,0.5923076923076923,1.0
30,30,42,30,42,70,244,0.4230769230769231,100,90,130,45,65,55,485,0.4253731343283582,0.5
30,30,30,30,30,30,180,0.12612612612612611,50,25,28,45,55,15,218,0.0625,1.0
110,135,60,50,65,88,508,0.7744360902255639,75,75,95,75,95,113,528,0.9015151515151515,0.5
150,120,100,120,100,90,680,0.664179104477612,55,35,50,55,110,85,390,0.6277372262773723,1.0
100,90,130,45,65,55,485,0.4253731343283582,65,155,120,65,90,105,600,0.8677685950413223,4.0
60,85,42,85,42,91,405,0.8227848101265823,70,95,125,65,75,45,475,0.33613445378151263,1.0
40,40,35,50,100,70,335,0.5031847133757962,55,55,85,65,85,35,380,0.2014388489208633,0.5
90,100,60,90,60,80,480,0.6422764227642277,80,70,65,80,120,100,515,0.8034188034188035,1.0
55,40,40,65,45,35,280,0.16428571428571428,130,85,80,85,95,60,535,0.43884892086330934,2.0
50,65,107,105,107,86,520,0.6991150442477876,100,100,125,110,50,50,535,0.384,1.0
80,70,40,100,60,145,495,0.921875,70,110,180,60,60,50,530,0.4117647058823529,0.5
65,73,55,47,75,85,400,0.6846846846846847,90,100,90,125,85,90,580,0.7352941176470589,0.25
52,65,50,45,50,38,300,0.27419354838709675,42,52,67,39,56,50,306,0.2868217054263566,1.0
40,40,50,30,30,30,220,0.0873015873015873,35,60,44,40,54,55,288,0.366412213740458,0.5
40,30,35,50,70,55,280,0.28205128205128205,90,60,60,40,40,40,330,0.29545454545454547,1.0
105,140,95,55,65,45,505,0.3,55,95,115,45,45,35,390,0.2116788321167883,2.0
76,48,48,57,62,34,325,0.11688311688311688,130,70,35,70,35,60,400,0.4017857142857143,0.5
65,55,115,100,40,60,435,0.3798449612403101,100,100,100,100,100,100,600,0.8345864661654135,0.5
80,110,60,150,130,70,600,0.5042016806722689,90,93,55,70,55,55,418,0.3819444444444444,1.0
108,130,95,80,85,102,600,0.7637795275590551,45,40,60,40,75,50,310,0.2926829268292683,0.0
70,110,70,115,70,90,525,0.75,59,110,150,45,49,35,448,0.3333333333333333,0.0
90,90,85,125,90,100,580,0.768595041322314,31,45,90,30,30,40,266,0.21929824561403508,0.0
45,25,50,25,25,35,205,0.13076923076923078,103,93,67,71,61,84,479,0.7142857142857143,0.5
95,65,110,60,130,65,525,0.5275590551181102,100,100,80,60,60,50,450,0.3050847457627119,1.0
55,63,90,50,80,42,380,0.21138211382113822,60,52,168,47,138,30,495,0.19834710743801653,0.5
40,45,35,40,40,90,290,0.65,110,78,73,76,71,60,468,0.3333333333333333,1.0
45,85,50,55,50,65,350,0.5076923076923077,70,150,140,65,100,75,600,0.55,1.0
80,145,150,105,110,110,700,0.8692307692307693,75,80,55,25,35,35,305,0.18666666666666668,1.0
109,66,84,81,99,32,471,0.2013888888888889,60,65,60,130,75,110,500,0.7719298245614035,2.0
106,150,70,194,120,140,780,0.952,65,125,60,95,60,105,510,0.9236641221374046,1.0
55,55,45,63,45,45,308,0.25,50,65,85,35,35,55,325,0.32575757575757575,2.0
38,35,40,27,25,35,200,0.08208955223880597,50,95,90,95,90,180,600,0.9172413793103448,2.0
83,80,80,135,80,121,579,0.9444444444444444,110,160,110,80,110,100,670,0.8591549295774648,1.0
55,20,35,20,45,75,250,0.37681159420289856,89,125,90,115,80,101,600,0.8725490196078431,1.0
70,45,48,60,65,35,323,0.15748031496062992,65,65,60,130,95,110,525,0.823943661971831,1.0
60,130,80,60,60,70,460,0.5153846153846153,40,45,40,62,60,60,307,0.33884297520661155,0.5
170,90,45,90,45,60,500,0.427536231884058,95,23,48,23,48,23,260,0.046153846153846156,1.0
123,77,72,99,92,58,521,0.4621212121212121,100,100,100,100,100,100,600,0.8778625954198473,1.0
115,115,85,90,75,100,580,0.8134328358208955,50,50,40,50,40,64,294,0.45588235294117646,0.5
100,5,5,15,65,30,220,0.07692307692307693,50,50,40,30,30,50,250,0.2781954887218045,1.0
55,65,35,60,30,85,330,0.6126126126126126,100,110,90,85,90,60,535,0.47794117647058826,1.0
60,60,60,60,60,60,360,0.38095238095238093,90,132,105,132,105,30,594,0.4246575342465753,1.0
106,90,130,90,154,110,680,0.8699186991869918,80,120,79,95,79,70,523,0.5833333333333334,0.5
80,115,80,65,55,93,488,0.7846153846153846,90,92,87,75,85,76,505,0.5409836065573771,1.0
80,82,83,100,100,80,525,0.6742424242424242,50,50,40,30,30,50,250,0.2781954887218045,1.0
95,85,85,65,65,35,430,0.2571428571428571,28,25,25,45,35,40,198,0.16083916083916083,1.0
70,45,48,60,65,35,323,0.15748031496062992,106,130,90,110,154,90,680,0.719626168224299,0.5
100,150,90,180,160,90,770,0.7348484848484849,100,100,100,100,100,100,600,0.8805970149253731,0.5
105,125,100,60,100,100,590,0.8359375,55,84,105,114,75,52,485,0.2890625,1.0
60,50,70,80,80,140,480,0.8449612403100775,60,69,95,69,95,36,424,0.2608695652173913,1.0
85,60,65,135,105,100,550,0.7518248175182481,58,50,145,95,105,30,483,0.2459016393442623,0.5
105,180,100,180,100,115,780,0.9477611940298507,59,66,70,44,55,41,335,0.25190839694656486,2.0
73,95,62,85,65,85,465,0.6666666666666666,95,155,109,70,130,81,640,0.6788321167883211,1.0
61,90,45,50,50,160,456,0.9230769230769231,70,85,70,60,70,50,405,0.28378378378378377,1.0
40,45,40,35,35,56,251,0.373015873015873,80,45,65,90,110,80,470,0.5462962962962963,1.0
50,50,150,50,150,50,500,0.2571428571428571,40,50,45,70,45,70,320,0.5517241379310345,2.0
100,70,70,65,65,45,415,0.1897810218978102,100,100,90,150,140,90,670,0.71875,1.0
25,35,70,95,55,45,325,0.16783216783216784,75,123,67,95,85,95,540,0.7642276422764228,0.25
85,110,90,45,90,80,500,0.6206896551724138,62,50,58,73,54,72,369,0.4435483870967742,1.0
55,45,50,45,65,80,340,0.5546218487394958,78,52,60,63,65,23,341,0.06015037593984962,1.0
60,90,140,50,50,40,430,0.2535211267605634,106,130,90,110,154,90,680,0.719626168224299,2.0
75,80,55,25,35,35,305,0.18666666666666668,95,75,180,130,80,30,590,0.13793103448275862,0.5
88,107,122,74,75,64,530,0.4596774193548387,80,95,82,60,82,75,474,0.6,0.25
41,56,40,62,44,71,314,0.568,65,80,65,35,65,60,370,0.38405797101449274,1.0
105,180,100,180,100,115,780,0.9477611940298507,70,84,70,65,70,51,410,0.2949640287769784,0.5
75,90,140,60,60,40,465,0.3008130081300813,41,50,37,50,37,66,281,0.5175438596491229,2.0
90,100,60,90,60,80,480,0.6422764227642277,95,145,130,120,90,120,700,0.9398496240601504,0.25
82,80,86,85,75,72,480,0.6183206106870229,60,60,50,40,50,75,335,0.5882352941176471,1.0
60,50,150,50,150,60,520,0.5206611570247934,40,70,130,60,130,25,455,0.17355371900826447,2.0
50,150,50,150,50,150,600,0.9339622641509434,65,83,57,95,85,105,490,0.8914728682170543,1.0
65,60,110,130,95,65,525,0.47761194029850745,55,66,44,44,56,85,350,0.6888888888888889,1.0
62,50,58,73,54,72,369,0.4435483870967742,70,80,65,90,65,85,455,0.578125,1.0
68,90,65,50,55,82,410,0.6165413533834586,85,70,80,97,80,123,535,0.9304347826086956,0.0
135,85,40,40,85,5,390,0.6864406779661016,60,25,35,70,80,60,330,0.3076923076923077,1.0
65,80,65,35,65,60,370,0.38405797101449274,95,23,48,23,48,23,260,0.046153846153846156,1.0
90,92,87,75,85,76,505,0.5409836065573771,100,50,50,76,96,70,442,0.5,0.0
53,54,53,37,46,45,288,0.3090909090909091,65,90,65,61,61,100,442,0.8373983739837398,1.0
61,78,95,56,58,57,405,0.40336134453781514,60,50,100,85,70,65,430,0.47580645161290325,1.0
90,95,95,70,90,70,510,0.5230769230769231,80,120,79,95,79,70,523,0.5833333333333334,1.0
50,48,43,46,41,60,288,0.47297297297297297,106,110,90,154,90,130,680,0.926829268292683,1.0
78,70,61,50,61,100,420,0.8145161290322581,75,90,50,110,80,95,500,0.7985611510791367,1.0
70,55,55,80,60,45,365,0.2222222222222222,75,87,63,87,63,98,473,0.865546218487395,4.0
50,75,70,35,70,48,348,0.29357798165137616,55,95,55,35,75,115,430,0.9380530973451328,2.0
30,40,55,40,55,60,280,0.3237410071942446,75,80,95,90,100,50,490,0.2158273381294964,1.0
55,55,55,85,55,30,335,0.1320754716981132,48,72,48,72,48,48,336,0.25984251968503935,0.5
20,40,90,30,90,25,295,0.11363636363636363,60,100,85,80,85,100,510,0.7007874015748031,2.0
70,110,80,55,80,105,500,0.8794326241134752,20,40,15,35,35,60,205,0.34285714285714286,0.5
126,131,95,131,98,99,680,0.8102189781021898,45,55,39,35,39,42,255,0.18518518518518517,1.0
85,135,130,60,80,25,515,0.40540540540540543,50,52,48,65,50,55,320,0.33098591549295775,1.0
100,90,130,45,65,55,485,0.4253731343283582,90,110,80,100,80,95,555,0.7982456140350878,4.0
80,135,85,70,95,150,615,0.9844961240310077,53,51,53,61,56,40,314,0.14285714285714285,1.0
90,30,15,40,20,15,210,0.043478260869565216,80,82,78,95,80,85,500,0.6869565217391305,1.0
53,54,53,37,46,45,288,0.3090909090909091,65,155,120,65,90,105,600,0.8677685950413223,1.0
59,45,40,35,40,31,250,0.14285714285714285,39,52,43,60,50,65,309,0.49107142857142855,1.0
105,95,80,40,80,90,490,0.753968253968254,65,95,57,100,85,93,495,0.7441860465116279,1.0
100,70,70,65,65,45,415,0.1897810218978102,165,75,80,40,45,65,470,0.5151515151515151,1.0
80,70,65,80,120,100,515,0.8034188034188035,60,60,60,60,60,60,360,0.38095238095238093,1.0
35,35,35,35,35,35,210,0.13385826771653545,45,60,32,50,32,76,295,0.5925925925925926,1.0
50,35,55,25,25,15,205,0.021739130434782608,100,120,100,150,120,90,680,0.728,0.5
25,35,70,95,55,45,325,0.16783216783216784,100,110,90,85,90,60,535,0.47794117647058826,0.0
30,56,35,25,35,72,253,0.48148148148148145,45,100,135,65,135,45,525,0.29411764705882354,0.0
90,120,120,60,60,50,500,0.35294117647058826,55,75,60,75,60,103,428,0.7982456140350878,0.0
67,89,116,79,116,33,500,0.2624113475177305,62,77,62,50,42,65,358,0.4838709677419355,1.0
104,91,63,91,73,68,490,0.5118110236220472,100,70,70,65,65,45,415,0.1897810218978102,1.0
50,53,48,53,48,64,316,0.46153846153846156,55,55,45,63,45,45,308,0.25,0.5
68,65,65,125,115,80,518,0.6461538461538462,40,30,35,50,70,55,280,0.28205128205128205,1.0
44,38,39,61,79,42,303,0.2251655629139073,55,70,55,40,55,85,360,0.7073170731707317,1.0
60,67,85,77,75,116,480,0.8888888888888888,30,65,100,45,25,40,305,0.1891891891891892,2.0
45,40,60,40,75,50,310,0.2926829268292683,40,45,40,62,60,60,307,0.33884297520661155,1.0
75,75,75,125,95,40,485,0.15671641791044777,105,140,55,30,55,95,480,0.8195488721804511,1.0
65,65,65,50,50,90,385,0.72,115,140,130,55,55,40,535,0.4519230769230769,4.0
67,89,116,79,116,33,500,0.2624113475177305,50,65,90,35,35,15,290,0.14678899082568808,1.0
75,70,90,70,105,80,490,0.656,115,115,85,90,75,100,580,0.8134328358208955,1.0
70,94,50,94,50,66,424,0.48148148148148145,50,60,45,100,80,65,400,0.45689655172413796,2.0
80,110,60,150,130,70,600,0.5042016806722689,95,155,109,70,130,81,640,0.6788321167883211,0.0
80,145,150,105,110,110,700,0.8692307692307693,65,90,120,85,70,60,490,0.43410852713178294,2.0
50,65,64,44,48,43,314,0.2196969696969697,60,85,42,85,42,91,405,0.8227848101265823,1.0
55,47,52,40,40,41,275,0.16806722689075632,75,38,38,56,56,67,330,0.5263157894736842,1.0
38,30,41,30,41,60,240,0.2897196261682243,40,60,40,40,40,30,250,0.0948905109489051,1.0
85,80,70,135,75,90,535,0.7006802721088435,95,60,79,100,125,81,540,0.6201550387596899,1.0
61,84,65,70,70,70,420,0.5,90,75,85,115,90,55,510,0.3445378151260504,1.0
70,75,60,105,60,105,475,0.88,48,72,48,72,48,48,336,0.25984251968503935,1.0
43,30,55,40,65,97,330,0.6030534351145038,108,170,115,120,95,92,700,0.7083333333333334,1.0
50,85,85,55,55,50,380,0.3902439024390244,60,65,80,170,95,130,600,0.8625954198473282,0.5
71,120,95,120,95,99,600,0.8203125,60,100,115,70,85,90,520,0.7557251908396947,0.25
65,76,84,54,96,105,480,0.9008264462809917,110,65,75,125,85,30,490,0.15,1.0
40,55,30,30,30,60,245,0.43548387096774194,50,65,107,105,107,86,520,0.6991150442477876,0.5
70,85,65,105,85,120,530,0.9262295081967213,35,60,44,40,54,55,288,0.366412213740458,0.5
60,60,60,35,35,30,280,0.11194029850746269,70,45,48,60,65,35,323,0.15748031496062992,1.0
60,70,50,100,50,65,395,0.5217391304347826,45,63,37,65,55,95,360,0.8055555555555556,0.5
30,40,70,70,25,60,295,0.41353383458646614,75,110,110,110,105,80,590,0.656934306569343,0.5
100,70,70,65,65,45,415,0.1897810218978102,50,65,107,105,107,86,520,0.6991150442477876,1.0
100,100,80,60,60,50,450,0.3050847457627119,45,100,45,45,45,10,290,0.2949640287769784,2.0
80,100,200,50,100,50,580,0.3472222222222222,62,73,55,56,52,84,382,0.7244094488188977,4.0
50,35,55,25,25,15,205,0.05263157894736842,80,95,82,60,82,75,474,0.6,0.5
58,70,45,40,45,42,300,0.25925925925925924,60,40,60,40,60,35,295,0.18055555555555555,0.5
45,22,60,27,30,29,213,0.07518796992481203,85,105,100,79,83,78,530,0.5869565217391305,1.0
80,85,95,30,30,25,345,0.2857142857142857,150,120,100,120,100,90,680,0.664179104477612,1.0
100,103,75,120,75,127,600,0.940677966101695,45,63,37,65,55,95,360,0.8055555555555556,0.5
40,29,45,29,45,36,224,0.14634146341463414,38,35,40,27,25,35,200,0.08208955223880597,1.0
80,90,80,130,110,110,600,0.856,65,136,94,54,96,135,580,0.9612403100775194,1.0
90,92,87,75,85,76,505,0.5409836065573771,85,100,122,58,75,54,494,0.3939393939393939,0.5
95,100,85,108,70,70,528,0.5652173913043478,59,63,80,65,80,58,405,0.41843971631205673,0.5
110,135,60,50,65,88,508,0.7744360902255639,125,130,90,130,90,95,660,0.7734375,2.0
50,95,95,35,110,70,455,0.5179856115107914,55,50,40,40,40,75,300,0.5945945945945946,2.0
70,75,80,135,80,135,575,0.917910447761194,45,30,40,105,50,20,290,0.031007751937984496,1.0
30,45,55,70,55,85,340,0.5633802816901409,60,65,60,130,75,110,500,0.7719298245614035,1.0
60,65,60,130,75,110,500,0.7719298245614035,95,23,48,23,48,23,260,0.046153846153846156,2.0
55,85,122,58,75,99,494,0.8099173553719008,65,90,65,61,61,100,442,0.8373983739837398,0.0
65,83,57,95,85,105,490,0.8914728682170543,61,84,65,70,70,70,420,0.5,0.5
60,48,45,43,90,42,328,0.21897810218978103,70,90,110,60,75,95,500,0.7333333333333333,0.0
55,55,55,85,55,30,335,0.1320754716981132,20,25,45,70,90,60,310,0.30833333333333335,0.5
50,35,55,25,25,15,205,0.021739130434782608,80,80,80,55,55,90,440,0.6417910447761194,1.0
100,70,70,65,65,45,415,0.1897810218978102,104,91,63,91,73,68,490,0.5118110236220472,1.0
62,50,58,73,54,72,369,0.4435483870967742,60,60,60,35,35,30,280,0.11194029850746269,1.0
79,100,80,110,90,121,580,0.968,60,45,70,45,90,95,405,0.7304964539007093,0.5
44,38,39,61,79,42,303,0.2251655629139073,40,45,40,62,60,60,307,0.33884297520661155,0.5
45,50,35,55,75,40,300,0.21367521367521367,50,50,95,40,50,35,320,0.20279720279720279,1.0
45,49,49,65,65,45,318,0.2781954887218045,60,55,50,40,55,45,305,0.22377622377622378,0.125
75,75,55,105,85,30,425,0.1619718309859155,60,62,80,63,80,60,405,0.4336283185840708,0.5
100,120,120,150,100,90,680,0.7880794701986755,50,95,90,95,90,180,600,0.9172413793103448,1.0
80,80,50,40,50,25,325,0.176056338028169,76,104,71,104,71,108,534,0.912751677852349,1.0
60,90,70,60,120,40,440,0.27419354838709675,60,60,60,60,60,60,360,0.38095238095238093,1.0
80,52,50,90,50,89,411,0.6666666666666666,106,150,70,194,120,140,780,0.952,2.0
80,100,200,50,100,50,580,0.3472222222222222,60,85,49,60,49,60,363,0.4444444444444444,1.0
83,80,75,70,70,101,479,0.8615384615384616,50,50,77,95,77,91,440,0.5916666666666667,0.0
60,50,100,85,70,65,430,0.47580645161290325,70,80,65,90,65,85,455,0.578125,1.0
20,10,230,10,230,5,505,0.0,20,25,45,70,90,60,310,0.30833333333333335,1.0
66,117,70,40,50,67,410,0.4573643410852713,90,50,34,60,44,70,348,0.6283185840707964,1.0
64,88,50,88,50,106,446,0.9111111111111111,60,40,80,60,45,40,325,0.23529411764705882,2.0
75,80,70,65,75,90,455,0.7578125,60,65,60,130,75,110,500,0.7719298245614035,0.25
55,55,50,45,65,55,325,0.37373737373737376,95,117,80,65,70,92,519,0.8409090909090909,1.0
65,90,115,45,115,58,488,0.5041322314049587,126,131,95,131,98,99,680,0.8102189781021898,0.5
90,60,70,75,70,45,410,0.23880597014925373,55,85,55,50,55,60,360,0.4233576642335766,1.0
81,102,77,85,75,85,505,0.5642857142857143,35,80,50,50,70,120,405,0.84375,0.5
91,90,106,130,106,77,600,0.648854961832061,65,125,60,95,60,105,510,0.9236641221374046,1.0
65,75,105,35,65,85,430,0.6940298507462687,125,130,90,130,90,95,660,0.7734375,1.0
35,55,40,45,40,60,275,0.35714285714285715,108,170,115,120,95,92,700,0.7083333333333334,0.0
75,80,95,90,100,50,490,0.2158273381294964,68,125,65,65,115,80,518,0.6277372262773723,1.0
91,90,106,130,106,77,600,0.648854961832061,70,80,70,80,70,110,480,0.6594202898550725,4.0
50,180,20,180,20,150,600,0.9029850746268657,55,50,45,135,95,120,500,0.7714285714285715,0.5
65,90,120,85,70,60,490,0.43410852713178294,35,35,35,35,35,35,210,0.13385826771653545,1.0
116,55,85,107,95,29,487,0.06818181818181818,65,50,35,115,95,95,455,0.7333333333333333,0.5
50,72,35,35,35,65,292,0.5373134328358209,60,50,50,60,70,50,340,0.28346456692913385,0.5
70,75,60,105,60,105,475,0.88,50,75,75,65,65,50,380,0.4049586776859504,1.0
20,10,230,10,230,5,505,0.0,78,84,78,109,85,100,534,0.8646616541353384,1.0
80,115,80,65,55,93,488,0.7846153846153846,69,69,76,69,86,91,460,0.6554621848739496,1.0
70,140,230,60,80,50,630,0.32432432432432434,70,55,65,95,85,70,440,0.5307692307692308,2.0
40,27,60,37,50,66,280,0.36220472440944884,55,50,65,175,95,150,590,0.7818181818181819,1.0
100,164,150,95,120,71,700,0.5645161290322581,120,100,85,30,85,45,465,0.22448979591836735,0.25
50,75,45,40,45,60,315,0.4380165289256198,90,75,75,90,100,70,500,0.5462184873949579,1.0
55,40,40,65,45,35,280,0.16428571428571428,35,70,55,45,55,25,285,0.09420289855072464,0.5
85,80,90,105,95,60,515,0.49074074074074076,40,30,35,45,40,55,245,0.31496062992125984,1.0
65,65,65,50,50,90,385,0.72,1,90,45,30,30,40,236,0.33064516129032256,1.0
80,70,40,100,60,145,495,0.921875,108,112,118,68,72,47,525,0.2916666666666667,1.0
75,140,65,112,65,110,567,0.9140625,70,80,102,80,102,40,474,0.2677165354330709,8.0
50,75,45,40,45,60,315,0.4380165289256198,60,70,65,125,105,90,515,0.6911764705882353,1.0
55,85,122,58,75,99,494,0.8099173553719008,90,100,90,125,85,90,580,0.7352941176470589,0.25
20,10,55,15,20,80,200,0.17985611510791366,50,64,50,45,50,41,300,0.22727272727272727,4.0
43,70,48,50,60,38,309,0.2391304347826087,40,30,32,50,52,65,269,0.3671875,1.0
55,55,55,85,55,30,335,0.1320754716981132,54,63,52,83,56,97,405,0.7697841726618705,1.0
60,80,50,40,40,30,300,0.15328467153284672,70,65,65,55,55,70,380,0.5,1.0
70,62,67,55,55,56,365,0.38513513513513514,40,65,95,60,45,35,340,0.13986013986013987,0.5
65,110,130,60,65,95,525,0.8278145695364238,60,55,145,75,150,40,525,0.2,1.0
55,85,55,50,55,60,360,0.4233576642335766,111,83,68,92,82,39,475,0.1774193548387097,0.5
31,45,90,30,30,40,266,0.21929824561403508,110,65,105,55,95,80,510,0.6258503401360545,0.0
65,65,65,50,50,90,385,0.72,68,85,65,165,135,100,618,0.8083333333333333,1.0
60,55,145,75,150,40,525,0.2,80,120,130,55,65,45,495,0.37037037037037035,1.0
75,125,100,70,80,45,495,0.33035714285714285,90,120,120,60,60,50,500,0.35294117647058826,0.5
74,108,133,83,65,32,495,0.32142857142857145,76,48,48,57,62,34,325,0.11688311688311688,0.5
55,50,40,40,40,75,300,0.5945945945945946,103,93,67,71,61,84,479,0.7142857142857143,1.0
1,90,45,30,30,40,236,0.33064516129032256,60,110,70,60,60,100,460,0.8461538461538461,0.0
49,49,56,49,61,66,330,0.5190839694656488,40,29,45,29,45,36,224,0.14634146341463414,1.0
65,63,45,45,45,45,308,0.2595419847328244,80,125,75,40,95,85,500,0.6911764705882353,2.0
40,45,40,65,40,65,295,0.5661764705882353,55,20,35,20,45,75,250,0.37681159420289856,1.0
91,129,90,72,90,108,580,0.8536585365853658,55,112,45,74,45,70,401,0.559322033898305,2.0
75,75,60,83,60,60,413,0.39344262295081966,100,100,100,100,100,100,600,0.8758169934640523,1.0
110,85,95,80,95,50,515,0.2713178294573643,28,25,25,45,35,40,198,0.16083916083916083,1.0
150,100,120,100,120,90,680,0.6666666666666666,70,140,70,110,65,105,560,0.95,0.5
43,70,48,50,60,38,309,0.2391304347826087,44,38,33,61,43,70,289,0.5267857142857143,0.0
44,48,65,50,64,43,314,0.1623931623931624,90,85,100,95,125,85,580,0.6834532374100719,1.0
80,80,90,110,130,110,600,0.8721804511278195,95,135,80,110,80,100,600,0.8248175182481752,2.0
75,70,90,70,105,80,490,0.656,63,63,47,41,41,74,329,0.56,1.0
50,95,180,85,45,70,525,0.5298507462686567,70,65,65,55,55,70,380,0.5,1.0
80,82,100,83,100,80,525,0.6821705426356589,79,85,60,55,60,71,410,0.60431654676259,2.0
75,100,95,40,70,110,490,0.8717948717948718,150,160,100,95,65,100,670,0.8866666666666667,1.0
95,125,79,60,100,81,540,0.6165413533834586,50,55,50,36,30,43,264,0.2922077922077922,1.0
44,75,35,63,33,45,295,0.2647058823529412,65,80,65,35,65,60,370,0.38405797101449274,0.0
75,69,72,114,100,104,534,0.8253968253968254,55,55,50,45,65,55,325,0.37373737373737376,1.0
100,150,120,120,100,90,680,0.6493506493506493,75,95,95,95,95,85,540,0.6470588235294118,2.0
100,100,125,110,50,50,535,0.384,45,60,40,70,50,45,310,0.2846715328467153,0.5
86,81,97,81,107,43,495,0.203125,58,109,112,48,48,109,484,0.8805970149253731,0.25
80,110,120,130,90,70,600,0.6198347107438017,90,75,85,115,90,55,510,0.3445378151260504,1.0
65,76,84,54,96,105,480,0.9008264462809917,75,80,60,65,90,102,472,0.8625954198473282,1.0
100,180,160,150,90,90,770,0.7520661157024794,30,40,70,70,25,60,295,0.41353383458646614,0.5
78,65,68,112,154,75,552,0.628099173553719,160,110,65,65,110,30,540,0.35714285714285715,1.0
80,115,80,65,55,93,488,0.7846153846153846,55,45,43,55,43,72,313,0.5853658536585366,1.0
55,112,45,74,45,70,401,0.559322033898305,100,75,115,90,115,85,580,0.6446280991735537,1.0
44,75,35,63,33,45,295,0.2647058823529412,40,45,40,35,35,56,251,0.373015873015873,0.0
85,135,130,60,80,25,515,0.40540540540540543,45,50,55,75,65,30,320,0.06293706293706294,1.0
85,73,70,73,115,67,483,0.5126050420168067,50,53,62,58,63,44,330,0.13709677419354838,1.0
70,90,70,60,60,70,420,0.6390977443609023,123,100,62,97,81,68,531,0.4806201550387597,1.0
40,27,60,37,50,66,280,0.36220472440944884,160,110,65,65,110,30,540,0.35714285714285715,1.0
35,70,55,45,55,25,285,0.09420289855072464,58,64,58,80,65,80,405,0.5423728813559322,0.25
85,97,66,105,66,65,484,0.47107438016528924,90,95,95,70,90,70,510,0.5230769230769231,0.5
90,120,75,60,60,45,450,0.29411764705882354,90,100,70,110,150,80,600,0.6037735849056604,2.0
77,85,51,55,51,65,384,0.5163934426229508,85,76,64,45,55,90,415,0.6739130434782609,1.0
78,65,68,112,154,75,552,0.628099173553719,104,91,63,91,73,68,490,0.5118110236220472,1.0
50,92,108,92,108,35,485,0.2457627118644068,67,82,62,46,48,43,348,0.22033898305084745,0.5
70,45,48,60,65,35,323,0.15748031496062992,45,75,37,70,55,83,365,0.6183206106870229,0.5
75,70,90,70,105,80,490,0.656,45,100,135,65,135,45,525,0.29411764705882354,1.0
50,85,85,55,55,50,380,0.3902439024390244,90,95,105,165,110,45,610,0.2890625,1.0
100,70,70,65,65,45,415,0.1897810218978102,50,52,48,65,50,55,320,0.33098591549295775,1.0
50,70,50,50,50,70,340,0.5645161290322581,80,100,80,80,80,100,520,0.9051724137931034,2.0
104,91,63,91,73,68,490,0.5118110236220472,80,52,50,90,50,89,411,0.6666666666666666,1.0
85,105,100,79,83,78,530,0.5869565217391305,65,50,35,115,95,95,455,0.7333333333333333,1.0
70,150,140,65,100,75,600,0.55,100,120,120,150,100,90,680,0.7880794701986755,0.25
70,95,125,65,75,45,475,0.33613445378151263,85,90,80,70,80,130,535,0.9262295081967213,0.5
50,60,60,60,60,30,320,0.11290322580645161,43,80,65,50,35,35,308,0.14193548387096774,0.5
80,145,150,105,110,110,700,0.8692307692307693,95,70,73,95,90,60,483,0.3983739837398374,0.5
68,165,95,65,115,110,618,0.8615384615384616,105,105,75,65,100,50,500,0.37593984962406013,1.0
10,55,25,35,45,95,265,0.5396825396825397,45,85,50,55,50,65,350,0.5076923076923077,1.0
40,45,35,30,40,55,245,0.3793103448275862,95,109,105,75,85,56,525,0.34513274336283184,2.0
40,40,55,40,70,55,300,0.40939597315436244,95,145,130,120,90,120,700,0.9398496240601504,0.0
115,115,85,90,75,100,580,0.8134328358208955,30,35,30,100,35,80,310,0.4765625,1.0
80,105,105,105,105,80,580,0.5939849624060151,60,50,50,60,70,50,340,0.28346456692913385,1.0
60,79,105,59,85,36,424,0.17054263565891473,90,92,75,92,85,60,494,0.49586776859504134,1.0
84,86,88,111,101,60,530,0.4634146341463415,80,92,65,65,80,68,450,0.4824561403508772,0.25
80,92,65,65,80,68,450,0.4824561403508772,75,100,95,40,70,110,490,0.8717948717948718,1.0
50,50,40,30,30,50,250,0.2781954887218045,75,140,65,112,65,110,567,0.9140625,0.0
74,100,72,90,72,46,454,0.24561403508771928,20,10,230,10,230,5,505,0.0,1.0
50,65,107,105,107,86,520,0.6991150442477876,55,66,44,44,56,85,350,0.6888888888888889,1.0
95,65,65,110,130,60,525,0.4016393442622951,71,82,64,64,59,112,452,0.9327731092436975,1.0
50,95,90,95,90,180,600,0.9172413793103448,77,59,50,67,63,46,362,0.23140495867768596,1.0
50,50,95,40,50,35,320,0.20279720279720279,45,25,50,25,25,35,205,0.13076923076923078,1.0
35,64,85,74,55,32,345,0.19827586206896552,86,81,97,81,107,43,495,0.203125,1.0
40,55,80,35,60,30,300,0.15037593984962405,55,65,95,95,45,85,440,0.6610169491525424,0.5
105,95,80,40,80,90,490,0.753968253968254,79,115,70,125,80,111,580,0.864,1.0
62,55,52,109,94,109,481,0.7833333333333333,85,115,80,105,80,50,515,0.3063063063063063,0.5
45,50,45,115,55,95,405,0.6936936936936937,110,85,95,80,95,50,515,0.2713178294573643,0.0
65,125,60,95,60,105,510,0.9236641221374046,125,170,100,120,90,95,700,0.77,2.0
75,95,60,65,60,115,470,0.8778625954198473,80,185,115,40,105,75,600,0.6230769230769231,1.0
41,64,45,50,50,50,300,0.36752136752136755,70,55,65,95,85,70,440,0.5307692307692308,1.0
62,55,52,109,94,109,481,0.7833333333333333,74,48,76,83,81,104,466,0.7913043478260869,1.0
56,61,65,48,45,38,313,0.17567567567567569,39,52,43,60,50,65,309,0.5041322314049587,0.5
65,105,60,60,70,95,455,63.0,90,120,100,150,120,100,680,0.7718120805369127,1.0
120,100,85,30,85,45,465,0.22448979591836735,86,68,72,109,66,106,507,0.8099173553719008,2.0
80,100,70,50,60,45,405,0.25806451612903225,60,40,80,60,45,40,325,0.23529411764705882,0.5
58,50,145,95,105,30,483,0.2459016393442623,43,70,48,50,60,38,309,0.2391304347826087,2.0
80,125,75,40,95,85,500,0.6911764705882353,65,65,60,110,95,130,525,0.9253731343283582,1.0
95,23,48,23,48,23,260,0.046153846153846156,61,72,57,55,55,65,365,0.3984375,2.0
45,40,60,40,75,50,310,0.2926829268292683,80,185,115,40,105,75,600,0.6230769230769231,4.0
73,95,62,85,65,85,465,0.6666666666666666,45,60,30,80,50,65,330,0.4603174603174603,1.0
70,100,70,105,75,40,460,0.23214285714285715,35,45,160,30,45,70,385,0.48148148148148145,1.0
50,85,40,85,40,35,335,0.1746031746031746,50,50,150,50,150,50,500,0.2571428571428571,2.0
50,50,40,50,40,64,294,0.45588235294117646,30,80,90,55,45,55,355,0.4295774647887324,1.0
78,70,61,50,61,100,420,0.8145161290322581,70,130,100,55,80,65,500,0.608,0.5
40,65,95,60,45,35,340,0.13986013986013987,105,30,105,140,105,55,540,0.3524590163934426,1.0
75,123,67,95,85,95,540,0.7642276422764228,60,25,35,70,80,60,330,0.3076923076923077,1.0
70,20,50,20,50,40,250,0.1557377049180328,70,80,70,80,70,110,480,0.6594202898550725,1.0
60,50,100,85,70,65,430,0.47580645161290325,91,90,72,90,129,108,580,0.896,2.0
36,50,50,65,60,44,305,0.16363636363636364,190,33,58,33,58,33,405,0.13432835820895522,1.0
105,95,75,85,75,74,509,0.5714285714285714,123,100,62,97,81,68,531,0.4806201550387597,0.25
120,100,85,30,85,45,465,0.22448979591836735,75,125,100,70,80,45,495,0.33035714285714285,1.0
97,165,60,65,50,58,495,0.3902439024390244,110,123,65,100,65,65,528,0.5217391304347826,1.0
130,85,80,85,95,60,535,0.43884892086330934,85,105,85,40,50,40,405,0.211864406779661,1.0
60,60,60,60,60,60,360,0.38095238095238093,90,130,80,65,85,55,505,0.4396551724137931,1.0
44,75,35,63,33,45,295,0.2647058823529412,78,104,78,159,115,100,634,0.8444444444444444,1.0
45,67,60,35,50,63,320,0.5128205128205128,65,55,115,100,40,60,435,0.3798449612403101,0.5
60,45,50,90,80,70,395,0.625,50,53,48,53,48,64,316,0.4076923076923077,4.0
70,65,60,90,75,90,450,0.6571428571428571,70,150,140,65,100,75,600,0.55,0.0
38,30,85,55,65,30,303,0.21428571428571427,90,120,75,60,60,45,450,0.29411764705882354,1.0
50,95,90,95,90,180,600,0.9172413793103448,130,85,80,85,95,60,535,0.43884892086330934,1.0
55,50,45,135,95,120,500,0.7714285714285715,73,100,60,100,60,65,458,0.42657342657342656,2.0
79,103,120,135,115,78,630,0.5763888888888888,65,75,90,97,123,44,494,0.1987179487179487,0.5
80,82,100,83,100,80,525,0.6821705426356589,50,35,55,25,25,15,205,0.021739130434782608,0.5
76,104,71,104,71,108,534,0.912751677852349,86,68,72,109,66,106,507,0.8099173553719008,1.0
20,25,45,70,90,60,310,0.30833333333333335,75,80,95,90,100,50,490,0.2158273381294964,1.0
60,40,80,60,45,40,325,0.23529411764705882,55,35,50,55,110,85,390,0.6277372262773723,0.25
40,60,30,31,31,70,262,0.4492753623188406,35,64,85,74,55,32,345,0.19827586206896552,1.0
150,80,44,90,54,80,498,0.625,45,75,60,40,30,50,300,0.304,1.0
50,95,90,95,90,180,600,0.9172413793103448,80,110,60,150,130,70,600,0.5042016806722689,0.5
75,80,85,110,90,50,490,0.3548387096774194,78,65,68,112,154,75,552,0.628099173553719,2.0
84,71,43,71,43,48,360,0.25874125874125875,106,110,90,154,90,130,680,0.926829268292683,1.0
60,55,50,40,55,45,305,0.22377622377622378,75,80,60,65,90,102,472,0.8625954198473282,1.0
70,75,60,105,60,105,475,0.88,80,100,123,122,120,80,625,0.56,0.5
65,73,55,47,75,85,400,0.6846846846846847,58,64,58,80,65,80,405,0.609271523178808,0.5
103,60,126,80,126,50,545,0.36363636363636365,75,90,50,110,80,95,500,0.7985611510791367,1.0
30,65,100,45,25,40,305,0.1891891891891892,76,104,71,104,71,108,534,0.912751677852349,2.0
100,134,110,95,100,61,600,0.4057971014492754,50,85,55,65,65,90,410,0.7478260869565218,2.0
75,100,110,45,55,65,450,0.5333333333333333,55,70,45,70,50,60,350,0.45,2.0
70,50,30,95,135,105,485,0.8040540540540541,88,107,122,74,75,64,530,0.4596774193548387,2.0
80,52,50,90,50,89,411,0.6666666666666666,70,55,95,95,110,65,490,0.48872180451127817,2.0
100,123,75,57,75,80,510,0.6923076923076923,43,70,48,50,60,38,309,0.2391304347826087,0.0
55,45,50,45,65,80,340,0.5546218487394958,60,45,50,90,80,70,395,0.625,0.5
40,30,30,55,30,85,270,0.4666666666666667,35,80,50,50,70,120,405,0.84375,2.0
45,55,45,65,45,75,330,0.5692307692307692,55,69,85,32,35,28,304,0.09302325581395349,0.5
65,65,45,75,45,95,390,0.72,62,73,55,56,52,84,382,0.7244094488188977,0.25
75,123,67,95,85,95,540,0.7642276422764228,55,45,45,25,25,15,210,0.048,0.0
100,110,90,85,90,60,535,0.47794117647058826,35,40,100,90,55,35,355,0.1796875,2.0
70,85,140,85,70,20,470,0.272,80,185,115,40,105,75,600,0.6230769230769231,2.0
55,70,55,40,55,85,360,0.7073170731707317,80,105,65,60,75,130,515,0.9645390070921985,0.5
20,40,90,30,90,25,295,0.11363636363636363,40,29,45,29,45,36,224,0.14634146341463414,1.0
76,147,90,60,70,97,540,0.8267716535433071,58,70,45,40,45,42,300,0.25925925925925924,2.0
92,105,90,125,90,98,600,0.8217054263565892,75,75,55,105,85,30,425,0.1619718309859155,1.0
105,105,75,65,100,50,500,0.37593984962406013,61,90,45,50,50,160,456,0.9230769230769231,1.0
60,70,65,125,105,90,515,0.6911764705882353,59,66,70,44,55,41,335,0.25190839694656486,0.5
130,65,60,110,95,65,525,0.5227272727272727,70,60,75,110,75,90,480,0.7165354330708661,0.5
65,90,122,58,75,84,494,0.71875,76,104,71,104,71,108,534,0.912751677852349,0.5
115,45,20,45,25,20,270,0.11538461538461539,75,95,125,45,75,95,510,0.8257575757575758,1.0
100,100,100,100,100,100,600,0.8778625954198473,65,150,60,115,60,115,565,0.935251798561151,0.0
54,63,52,83,56,97,405,0.7697841726618705,35,20,65,40,65,20,245,0.02459016393442623,1.0
50,53,62,58,63,44,330,0.13709677419354838,70,70,115,130,90,60,535,0.5338983050847458,1.0
50,47,50,57,50,65,319,0.463768115942029,100,164,150,95,120,71,700,0.5645161290322581,2.0
103,60,86,60,86,50,445,0.3458646616541353,40,30,30,55,30,85,270,0.4666666666666667,1.0
46,57,40,40,40,50,273,0.25,64,165,75,93,83,75,555,0.6587301587301587,0.5
55,40,50,65,85,40,335,0.3181818181818182,106,190,100,154,100,130,780,0.9259259259259259,2.0
70,70,40,60,40,60,340,0.4247787610619469,40,45,35,40,40,90,290,0.65,1.0
58,109,112,48,48,109,484,0.8805970149253731,110,65,75,125,85,30,490,0.15,2.0
40,45,35,65,55,70,310,0.4482758620689655,108,112,118,68,72,47,525,0.2916666666666667,2.0
76,104,71,104,71,108,534,0.912751677852349,40,50,90,30,55,65,330,0.44680851063829785,0.5
75,70,90,70,105,80,490,0.656,30,45,135,45,90,30,375,0.09285714285714286,0.5
35,55,40,45,40,60,275,0.35714285714285715,75,90,140,60,60,40,465,0.3008130081300813,1.0
65,75,70,95,70,95,470,0.7272727272727273,38,36,38,32,36,57,237,0.3893805309734513,1.0
41,50,37,50,37,66,281,0.5175438596491229,100,100,100,100,100,100,600,0.8345864661654135,2.0
90,120,100,150,120,100,680,0.7718120805369127,45,60,32,50,32,76,295,0.5925925925925926,1.0
46,87,60,30,40,57,320,0.37777777777777777,76,48,48,57,62,34,325,0.11688311688311688,1.0
60,85,49,60,49,60,363,0.4444444444444444,75,95,67,125,95,83,540,0.7117117117117117,1.0
50,50,50,50,50,50,300,0.30708661417322836,80,52,50,90,50,89,411,0.6666666666666666,2.0
100,150,90,180,160,90,770,0.7348484848484849,58,64,58,80,65,80,405,0.609271523178808,2.0
28,25,25,45,35,40,198,0.16083916083916083,80,135,85,70,95,150,615,0.9844961240310077,1.0
75,98,63,98,63,101,498,0.849624060150376,53,51,53,61,56,40,314,0.14285714285714285,0.5
111,83,68,92,82,39,475,0.1774193548387097,39,52,43,60,50,65,309,0.5041322314049587,4.0
61,72,57,55,55,65,365,0.3984375,80,50,100,100,200,50,580,0.2357142857142857,1.0
75,140,65,112,65,110,567,0.9140625,65,50,70,95,80,65,425,0.4262295081967213,1.0
70,115,60,115,60,55,475,0.4647887323943662,100,73,83,73,83,55,467,0.371900826446281,0.5
42,52,67,39,56,50,306,0.2868217054263566,90,120,120,60,60,50,500,0.35294117647058826,1.0
88,107,122,74,75,64,530,0.4596774193548387,60,67,85,77,75,116,480,0.8888888888888888,0.25
50,53,48,53,48,64,316,0.4076923076923077,50,60,60,60,60,30,320,0.11290322580645161,1.0
60,150,50,150,50,60,520,0.5,86,92,88,68,75,73,482,0.6835443037974683,1.0
51,65,65,80,75,59,395,0.4365079365079365,75,80,95,90,100,50,490,0.2158273381294964,2.0
45,55,45,65,45,75,330,0.5692307692307692,45,100,135,65,135,45,525,0.29411764705882354,1.0
36,50,50,65,60,44,305,0.16363636363636364,49,49,56,49,61,66,330,0.5190839694656488,0.5
45,95,50,40,50,75,355,0.54,40,50,90,30,55,65,330,0.44680851063829785,1.0
80,120,70,110,70,80,530,0.6422764227642277,66,41,77,61,87,23,355,0.12096774193548387,2.0
100,103,75,120,75,127,600,0.940677966101695,65,90,122,58,75,84,494,0.71875,1.0
60,62,80,63,80,60,405,0.4336283185840708,86,76,86,116,56,95,515,0.7982456140350878,0.25
45,40,60,40,75,50,310,0.2926829268292683,54,45,47,75,98,52,371,0.39669421487603307,1.0
50,65,107,105,107,86,520,0.6991150442477876,50,65,107,105,107,86,520,0.7272727272727273,1.0
55,85,55,50,55,60,360,0.4233576642335766,55,45,45,25,25,15,210,0.048,0.5
80,80,80,80,80,80,480,0.6015037593984962,85,60,65,135,105,100,550,0.7518248175182481,0.5
100,90,130,45,65,55,485,0.4253731343283582,80,92,65,65,80,68,450,0.4824561403508772,0.5
65,130,60,95,110,65,525,0.5303030303030303,55,40,40,65,45,35,280,0.16428571428571428,1.0
55,55,55,85,55,30,335,0.1320754716981132,40,65,95,60,45,35,340,0.13986013986013987,2.0
60,25,35,70,80,60,330,0.3076923076923077,95,65,65,110,130,60,525,0.4016393442622951,1.0
90,120,120,60,60,50,500,0.35294117647058826,125,130,90,130,90,95,660,0.7734375,1.0
40,65,95,60,45,35,340,0.13986013986013987,85,90,80,70,80,130,535,0.9262295081967213,0.5
45,50,55,75,65,30,320,0.06293706293706294,60,75,85,100,85,115,520,0.8992248062015504,2.0
65,90,40,45,80,75,395,0.625,45,100,45,45,45,10,290,0.2949640287769784,0.5
190,33,58,33,58,33,405,0.13432835820895522,70,55,55,80,60,45,365,0.2222222222222222,1.0
50,30,55,65,55,20,275,0.13675213675213677,70,100,115,30,65,30,410,0.24390243902439024,0.5
76,48,48,57,62,34,325,0.11688311688311688,59,63,80,65,80,58,405,0.41843971631205673,0.5
69,69,76,69,86,91,460,0.6554621848739496,40,70,40,35,40,60,285,0.392,1.0
70,60,75,110,75,90,480,0.7165354330708661,70,150,140,65,100,75,600,0.55,0.25
110,65,75,125,85,30,490,0.15,50,50,120,80,80,30,410,0.07258064516129033,1.0
75,95,67,125,95,83,540,0.7117117117117117,38,30,85,55,65,30,303,0.21428571428571427,1.0
65,70,60,65,65,115,440,0.8583333333333333,90,120,120,60,60,50,500,0.35294117647058826,1.0
30,35,30,100,35,80,310,0.4765625,100,150,140,100,90,90,670,0.7969924812030075,0.5
91,134,95,100,100,80,600,0.6304347826086957,105,140,95,55,65,45,505,0.3,2.0
95,80,105,40,70,100,490,0.8046875,50,35,55,25,25,15,205,0.021739130434782608,1.0
90,100,90,125,85,90,580,0.7352941176470589,65,90,65,61,61,100,442,0.8373983739837398,1.0
120,70,120,75,130,85,600,0.6694915254237288,125,130,90,130,90,95,660,0.7734375,1.0
68,65,65,125,115,80,518,0.6461538461538462,61,72,57,55,55,65,365,0.3984375,1.0
60,50,150,50,150,60,520,0.5206611570247934,75,90,90,140,90,115,600,0.9481481481481482,0.25
50,75,75,65,65,50,380,0.4049586776859504,125,170,100,120,90,95,700,0.77,1.0
80,80,50,40,50,25,325,0.176056338028169,75,80,95,90,100,50,490,0.2158273381294964,2.0
40,35,30,120,70,105,400,0.6692307692307692,70,60,62,80,82,60,414,0.4375,1.0
60,50,100,85,70,65,430,0.47580645161290325,55,55,55,85,55,30,335,0.1320754716981132,1.0
50,70,160,70,160,90,600,0.7417218543046358,70,145,88,140,70,112,625,0.8888888888888888,0.5
45,65,34,40,34,45,263,0.2589928057553957,100,180,160,150,90,90,770,0.7520661157024794,0.0
65,40,50,125,60,30,370,0.07258064516129033,95,124,78,69,71,58,495,0.37398373983739835,0.0
80,105,105,105,105,80,580,0.5939849624060151,75,95,125,45,75,95,510,0.8257575757575758,2.0
50,160,110,160,110,110,700,0.8854961832061069,170,90,45,90,45,60,500,0.427536231884058,1.0
135,85,40,40,85,5,390,0.6864406779661016,100,100,100,100,100,100,600,0.8805970149253731,1.0
86,81,97,81,107,43,495,0.203125,50,45,45,35,35,50,260,0.23529411764705882,1.0
50,50,150,50,150,50,500,0.2571428571428571,76,65,45,92,42,91,411,0.7449664429530202,2.0
65,65,65,50,50,90,385,0.72,60,69,95,69,95,36,424,0.2608695652173913,1.0
35,80,50,50,70,120,405,0.84375,45,30,50,65,50,45,285,0.13821138211382114,1.0
57,80,91,80,87,75,470,0.5737704918032787,125,58,58,76,76,67,460,0.515625,0.25
59,59,58,90,70,73,409,0.5826086956521739,70,115,60,115,60,55,475,0.4647887323943662,2.0
80,120,70,110,70,80,530,0.6422764227642277,39,52,43,60,50,65,309,0.5041322314049587,0.5
42,52,67,39,56,50,306,0.2868217054263566,28,25,25,45,35,40,198,0.16083916083916083,1.0
30,40,70,70,25,60,295,0.41353383458646614,65,65,45,75,45,95,390,0.72,1.0
55,112,45,74,45,70,401,0.559322033898305,50,65,107,105,107,86,520,0.6991150442477876,1.0
59,66,70,44,55,41,335,0.25190839694656486,75,89,85,55,65,36,405,0.29545454545454547,0.5
95,145,130,120,90,120,700,0.9398496240601504,80,105,105,105,105,80,580,0.5939849624060151,1.0
55,45,43,55,43,72,313,0.5853658536585366,64,66,68,81,76,50,405,0.25190839694656486,1.0
20,40,90,30,90,25,295,0.11363636363636363,90,75,75,90,100,70,500,0.5462184873949579,1.0
115,45,20,45,25,20,270,0.11538461538461539,106,90,130,90,154,110,680,0.8699186991869918,1.0
60,60,60,35,35,30,280,0.11194029850746269,60,60,60,85,85,85,435,0.631578947368421,0.0
58,50,145,95,105,30,483,0.2459016393442623,40,40,55,40,70,55,300,0.40939597315436244,2.0
65,100,70,80,80,105,500,0.8666666666666667,60,90,55,90,80,110,485,0.8677685950413223,1.0
70,120,100,145,105,20,560,0.2824427480916031,61,90,45,50,50,160,456,0.9230769230769231,0.0
75,140,65,112,65,110,567,0.9140625,55,75,50,40,40,80,340,0.6302521008403361,2.0
95,65,110,60,130,65,525,0.5275590551181102,90,60,60,40,40,40,330,0.29545454545454547,1.0
65,136,94,54,96,135,580,0.9612403100775194,75,125,75,30,75,85,465,0.625,1.0
85,105,55,85,50,115,495,0.9032258064516129,61,84,65,70,70,70,420,0.5,0.5
30,30,30,30,30,30,180,0.12612612612612611,53,54,53,37,46,45,288,0.3090909090909091,1.0
30,65,100,45,25,40,305,0.1891891891891892,150,100,120,100,120,90,680,0.6666666666666666,0.5
55,55,55,85,55,30,335,0.1320754716981132,60,55,90,145,90,80,520,0.6071428571428571,1.0
60,85,60,85,60,55,405,0.3673469387755102,100,5,5,15,65,30,220,0.07692307692307693,2.0
95,110,95,40,95,55,490,0.40336134453781514,60,25,35,70,80,60,330,0.3076923076923077,1.0
55,75,50,40,40,80,340,0.6302521008403361,60,50,100,85,70,65,430,0.47580645161290325,1.0
60,90,70,60,120,40,440,0.27419354838709675,35,64,85,74,55,32,345,0.19827586206896552,1.0
80,100,70,60,70,95,475,0.7416666666666667,80,100,80,80,80,100,520,0.9051724137931034,1.0
120,70,120,75,130,85,600,0.6694915254237288,80,45,65,90,110,80,470,0.5462962962962963,0.5
72,60,30,20,30,25,237,0.11570247933884298,50,180,20,180,20,150,600,0.9029850746268657,0.5
69,55,45,55,55,15,294,0.11666666666666667,64,115,65,83,63,65,455,0.5323741007194245,0.5
110,85,95,80,95,50,515,0.2713178294573643,65,90,115,45,115,58,488,0.5041322314049587,1.0
105,30,105,140,105,55,540,0.3524590163934426,70,145,88,140,70,112,625,0.8888888888888888,1.0
110,65,75,125,85,30,490,0.15,78,70,61,50,61,100,420,0.8145161290322581,1.0
35,65,35,65,35,65,300,0.46621621621621623,95,65,110,60,130,65,525,0.5275590551181102,1.0
108,100,121,81,95,95,600,0.7476635514018691,65,110,130,60,65,95,525,0.8278145695364238,0.5
65,80,65,35,65,60,370,0.38405797101449274,44,48,65,50,64,43,314,0.1623931623931624,1.0
58,109,112,48,48,109,484,0.8805970149253731,100,100,90,150,140,90,670,0.71875,0.5
68,125,65,65,115,80,518,0.6277372262773723,70,75,80,135,80,135,575,0.917910447761194,1.0
77,59,50,67,63,46,362,0.23140495867768596,30,40,70,70,25,60,295,0.41353383458646614,0.5
70,70,115,130,90,60,535,0.5338983050847458,60,60,60,35,35,30,280,0.11194029850746269,1.0
60,50,150,50,150,60,520,0.5206611570247934,79,100,80,110,90,121,580,0.968,1.0
75,95,60,65,60,115,470,0.8778625954198473,85,60,65,135,105,100,550,0.7518248175182481,1.0
65,100,70,80,80,105,500,0.8666666666666667,70,75,60,105,60,105,475,0.88,1.0
50,85,85,55,55,50,380,0.3902439024390244,65,85,70,75,70,40,405,0.203125,0.5
41,56,40,62,44,71,314,0.568,49,49,56,49,61,66,330,0.5190839694656488,0.5
60,40,50,75,85,95,405,0.6044776119402985,50,47,50,57,50,65,319,0.463768115942029,0.5
70,55,75,45,65,60,370,0.45901639344262296,123,100,62,97,81,68,531,0.4806201550387597,2.0
60,45,70,75,85,55,390,0.3008130081300813,45,30,50,55,65,45,290,0.208,0.5
20,40,15,35,35,60,205,0.34285714285714286,70,80,70,80,70,110,480,0.6594202898550725,1.0
79,103,120,135,115,78,630,0.5763888888888888,40,29,45,29,45,36,224,0.14634146341463414,1.0
30,30,42,30,42,70,244,0.4230769230769231,65,40,50,125,60,30,370,0.07258064516129033,2.0
60,65,60,130,75,110,500,0.7719298245614035,35,55,35,30,30,35,220,0.23684210526315788,0.5
59,110,150,45,49,35,448,0.3333333333333333,115,115,85,90,75,100,580,0.8134328358208955,0.5
40,55,30,30,30,85,270,0.688,70,135,105,60,105,20,495,0.5806451612903226,0.5
95,80,105,40,70,100,490,0.8046875,35,20,65,40,65,20,245,0.02459016393442623,1.0
72,60,30,20,30,25,237,0.11570247933884298,45,30,50,65,50,45,285,0.13821138211382114,0.5
70,60,75,110,75,90,480,0.7165354330708661,30,30,30,30,30,30,180,0.12612612612612611,0.5
50,92,108,92,108,35,485,0.2457627118644068,50,65,107,105,107,86,520,0.7272727272727273,1.0
80,80,80,80,80,80,480,0.6015037593984962,20,15,20,10,55,80,200,0.2682926829268293,0.5
75,95,60,65,60,115,470,0.8778625954198473,110,65,105,55,95,80,510,0.6258503401360545,1.0
105,95,75,85,75,74,509,0.5714285714285714,35,35,35,35,35,35,210,0.13385826771653545,1.0
70,150,140,65,100,75,600,0.55,35,64,85,74,55,32,345,0.19827586206896552,0.5
70,90,45,15,45,50,315,0.3629032258064516,70,130,100,55,80,65,500,0.608,4.0
110,85,95,80,95,50,515,0.2713178294573643,70,60,125,115,70,55,495,0.35507246376811596,0.5
100,5,5,15,65,30,220,0.07692307692307693,40,70,40,35,40,60,285,0.392,1.0
38,35,40,27,25,35,200,0.08208955223880597,70,60,70,87,78,85,450,0.6228070175438597,2.0
55,104,105,94,75,52,485,0.36363636363636365,60,75,100,55,80,50,420,0.3088235294117647,1.0
60,95,80,60,80,30,405,0.19480519480519481,40,70,130,60,130,25,455,0.17355371900826447,0.5
60,50,50,60,70,50,340,0.28346456692913385,75,87,63,87,63,98,473,0.865546218487395,0.5
68,75,53,83,113,60,452,0.45384615384615384,55,55,45,63,45,45,308,0.25,1.0
62,50,58,73,54,72,369,0.4435483870967742,89,124,80,55,80,55,483,0.5714285714285714,0.0
65,155,120,65,90,105,600,0.8677685950413223,44,58,44,58,44,61,309,0.41964285714285715,0.5
59,45,40,35,40,31,250,0.14285714285714285,95,75,110,100,80,30,490,0.15267175572519084,1.0
80,115,80,65,55,93,488,0.7846153846153846,75,80,60,65,90,102,472,0.8625954198473282,1.0
45,35,50,70,50,30,280,0.15753424657534246,80,185,115,40,105,75,600,0.6230769230769231,0.5
41,56,40,62,44,71,314,0.568,57,24,86,24,86,23,300,0.12727272727272726,1.0
30,65,100,45,25,40,305,0.1891891891891892,60,110,70,60,60,100,460,0.8461538461538461,1.0
55,104,105,94,75,52,485,0.36363636363636365,30,40,55,40,55,60,280,0.3237410071942446,1.0
90,120,120,60,60,50,500,0.35294117647058826,89,125,90,115,80,101,600,0.8725490196078431,0.0
45,65,34,40,34,45,263,0.2589928057553957,35,65,35,65,35,65,300,0.46621621621621623,2.0
80,95,82,60,82,75,474,0.6,75,100,95,40,70,110,490,0.8717948717948718,1.0
38,30,85,55,65,30,303,0.21428571428571427,55,75,50,40,40,80,340,0.6302521008403361,0.0
78,84,78,109,85,100,534,0.8620689655172413,75,80,60,65,90,102,472,0.8625954198473282,1.0
70,90,110,60,75,95,500,0.7333333333333333,76,147,90,60,70,97,540,0.8267716535433071,1.0
75,95,125,45,75,95,510,0.8257575757575758,45,22,60,27,30,29,213,0.07518796992481203,1.0
78,92,75,74,63,118,500,0.8842975206611571,85,90,80,70,80,130,535,0.9262295081967213,0.25
59,45,40,35,40,31,250,0.14285714285714285,30,40,70,70,25,60,295,0.41353383458646614,1.0
55,112,45,74,45,70,401,0.559322033898305,75,98,63,98,63,101,498,0.849624060150376,1.0
80,160,80,130,80,100,630,0.8455284552845529,20,40,90,30,90,25,295,0.11363636363636363,0.0
45,75,37,70,55,83,365,0.6183206106870229,65,136,94,54,96,135,580,0.9612403100775194,1.0
58,109,112,48,48,109,484,0.8805970149253731,68,165,95,65,115,110,618,0.8615384615384616,1.0
75,87,63,87,63,98,473,0.865546218487395,105,140,95,55,65,45,505,0.3,2.0
55,45,50,45,65,80,340,0.5546218487394958,50,50,40,50,40,64,294,0.45588235294117646,2.0
61,90,45,50,50,160,456,0.9230769230769231,45,35,50,70,50,30,280,0.15753424657534246,4.0
71,82,64,64,59,112,452,0.9327731092436975,91,90,106,130,106,77,600,0.648854961832061,0.5
53,51,53,61,56,40,314,0.14285714285714285,40,55,30,30,30,85,270,0.688,1.0
60,80,110,50,80,45,425,0.2833333333333333,80,115,80,65,55,93,488,0.7846153846153846,0.0
35,45,160,30,45,70,385,0.48148148148148145,1,90,45,30,30,40,236,0.33064516129032256,1.0
60,90,70,60,120,40,440,0.27419354838709675,68,90,65,50,55,82,410,0.6165413533834586,1.0
60,40,80,60,45,40,325,0.23529411764705882,25,20,15,105,55,90,310,0.32407407407407407,0.5
68,90,65,50,55,82,410,0.6165413533834586,60,130,80,60,60,70,460,0.5153846153846153,0.5
50,160,110,160,110,110,700,0.8854961832061069,25,35,70,95,55,45,325,0.16783216783216784,0.25
30,105,90,25,25,50,325,0.2773722627737226,60,40,80,60,45,40,325,0.23529411764705882,0.5
50,65,107,105,107,86,520,0.6991150442477876,45,25,50,25,25,35,205,0.13076923076923078,2.0
80,105,105,105,105,80,580,0.5939849624060151,68,65,65,125,115,80,518,0.6461538461538462,0.5
20,10,55,15,20,80,200,0.17985611510791366,70,90,70,60,60,70,420,0.6390977443609023,1.0
65,73,55,47,75,85,400,0.6846846846846847,50,85,40,85,40,35,335,0.1746031746031746,2.0
60,50,100,85,70,65,430,0.47580645161290325,50,64,50,45,50,41,300,0.22727272727272727,2.0
60,75,100,55,80,50,420,0.3088235294117647,60,45,70,75,85,55,390,0.3008130081300813,0.5
45,63,37,65,55,95,360,0.8055555555555556,40,55,99,40,79,47,360,0.26262626262626265,1.0
83,106,65,86,65,85,490,0.6640625,77,85,51,55,51,65,384,0.5163934426229508,0.5
70,45,48,60,65,35,323,0.15748031496062992,170,90,45,90,45,60,500,0.427536231884058,1.0
60,95,80,60,80,30,405,0.19480519480519481,70,80,70,80,70,110,480,0.6594202898550725,0.5
40,40,35,50,100,70,335,0.5031847133757962,50,70,50,50,50,40,310,0.16296296296296298,0.5
55,69,85,32,35,28,304,0.09302325581395349,125,58,58,76,76,67,460,0.515625,0.5
50,50,40,30,30,50,250,0.2781954887218045,103,60,86,60,86,50,445,0.3458646616541353,1.0
135,85,40,40,85,5,390,0.6864406779661016,65,75,90,97,123,44,494,0.1987179487179487,1.0
45,100,135,65,135,45,525,0.29411764705882354,90,50,34,60,44,70,348,0.6283185840707964,2.0
67,58,57,81,67,101,431,0.8790322580645161,80,100,80,80,80,100,520,0.9051724137931034,0.0
110,123,65,100,65,65,528,0.5217391304347826,65,47,55,73,75,85,400,0.65,1.0
65,65,60,130,95,110,525,0.823943661971831,100,100,100,100,100,100,600,0.8345864661654135,0.5
48,61,40,61,40,50,300,0.2543859649122807,126,131,95,131,98,99,680,0.8102189781021898,1.0
60,60,40,65,45,35,305,0.15833333333333333,79,105,70,145,80,101,580,0.8608695652173913,0.0
100,73,83,73,83,55,467,0.371900826446281,75,125,75,30,75,85,465,0.625,1.0
55,55,45,63,45,45,308,0.25,60,110,70,60,60,100,460,0.8461538461538461,1.0
40,29,45,29,45,36,224,0.14634146341463414,65,73,55,47,75,85,400,0.6846846846846847,1.0
115,115,85,90,75,100,580,0.8134328358208955,70,80,70,80,70,110,480,0.6594202898550725,2.0
50,65,45,85,65,95,405,0.7238095238095238,75,65,55,65,55,69,384,0.43548387096774194,4.0
85,73,70,73,115,67,483,0.5126050420168067,74,94,131,54,116,20,489,0.4485294117647059,0.5
61,84,65,70,70,70,420,0.5,75,95,60,65,60,115,470,0.8778625954198473,1.0
70,105,105,50,40,20,390,0.33587786259541985,70,60,125,115,70,55,495,0.35507246376811596,1.0
55,50,40,40,40,75,300,0.5945945945945946,60,90,70,60,120,40,440,0.27419354838709675,1.0
80,52,50,90,50,89,411,0.6666666666666666,40,45,65,100,120,90,460,0.5588235294117647,1.0
90,30,15,40,20,15,210,0.043478260869565216,55,50,40,40,40,75,300,0.5945945945945946,1.0
60,65,60,130,75,110,500,0.7719298245614035,40,50,45,70,45,70,320,0.5517241379310345,2.0
70,140,230,60,80,50,630,0.32432432432432434,50,65,85,35,35,55,325,0.32575757575757575,2.0
40,45,40,65,40,65,295,0.5661764705882353,38,35,35,65,55,50,278,0.2647058823529412,1.0
55,20,35,20,45,75,250,0.37681159420289856,65,155,120,65,90,105,600,0.8677685950413223,1.0
60,45,50,90,80,70,395,0.625,50,75,70,35,70,48,348,0.29357798165137616,2.0
91,129,90,72,90,108,580,0.8536585365853658,40,27,60,37,50,66,280,0.36220472440944884,0.5
50,95,95,35,110,70,455,0.5179856115107914,45,65,34,40,34,45,263,0.2589928057553957,1.0
70,75,60,105,60,105,475,0.88,63,120,85,90,55,55,468,0.2809917355371901,2.0
60,40,60,95,60,55,370,0.4222222222222222,30,45,55,70,55,85,340,0.5633802816901409,0.5
71,120,95,120,95,99,600,0.8203125,60,65,60,130,75,110,500,0.7719298245614035,0.25
63,120,85,90,55,55,468,0.2809917355371901,65,110,130,60,65,95,525,0.8278145695364238,0.5
78,84,78,109,85,100,534,0.8646616541353384,82,80,86,85,75,72,480,0.6183206106870229,1.0
120,100,85,30,85,45,465,0.22448979591836735,80,115,80,65,55,93,488,0.7846153846153846,1.0
89,124,80,55,80,55,483,0.5714285714285714,50,72,35,35,35,65,292,0.5373134328358209,0.5
89,125,90,115,80,101,600,0.8725490196078431,66,65,48,62,57,52,350,0.36220472440944884,1.0
60,80,50,40,40,30,300,0.15328467153284672,40,29,45,29,45,36,224,0.14634146341463414,1.0
110,85,95,80,95,50,515,0.2713178294573643,55,70,55,40,55,85,360,0.7073170731707317,1.0
46,87,60,30,40,57,320,0.37777777777777777,83,106,65,86,65,85,490,0.6640625,1.0
45,55,45,65,45,75,330,0.5692307692307692,100,90,130,45,65,55,485,0.4253731343283582,0.25
100,50,80,60,80,50,420,0.34375,90,60,60,40,40,40,330,0.29545454545454547,2.0
60,90,70,60,120,40,440,0.27419354838709675,60,45,70,75,85,55,390,0.3008130081300813,1.0
35,70,55,45,55,25,285,0.09420289855072464,85,110,76,65,82,56,474,0.3933333333333333,0.5
91,90,72,90,129,108,580,0.896,55,84,105,114,75,52,485,0.2890625,2.0
55,85,55,50,55,60,360,0.4233576642335766,40,65,95,60,45,35,340,0.13986013986013987,0.5
72,60,30,20,30,25,237,0.11570247933884298,40,35,30,120,70,105,400,0.6692307692307692,0.5
80,100,80,80,80,100,520,0.9051724137931034,60,25,35,70,80,60,330,0.3076923076923077,1.0
100,180,160,150,90,90,770,0.7520661157024794,55,75,50,40,40,80,340,0.6302521008403361,0.0
70,75,80,135,80,135,575,0.917910447761194,50,65,45,85,65,95,405,0.7238095238095238,0.5
70,75,80,135,80,135,575,0.917910447761194,85,100,122,58,75,54,494,0.3939393939393939,0.5
60,100,89,55,69,112,485,0.9298245614035088,103,60,126,80,126,50,545,0.36363636363636365,1.0
86,92,88,68,75,73,482,0.6835443037974683,70,140,230,60,80,50,630,0.32432432432432434,0.5
90,75,75,90,100,70,500,0.5462184873949579,65,100,70,80,80,105,500,0.8666666666666667,2.0
150,80,44,90,54,80,498,0.625,70,90,70,60,60,70,420,0.6390977443609023,0.5
50,50,150,50,150,50,500,0.2571428571428571,60,45,70,75,85,55,390,0.3008130081300813,1.0
45,22,60,27,30,29,213,0.07518796992481203,110,135,60,50,65,88,508,0.7744360902255639,0.5
55,40,50,65,85,40,335,0.3181818181818182,40,55,80,35,60,30,300,0.15037593984962405,2.0
45,50,45,115,55,95,405,0.6936936936936937,60,80,50,50,50,40,330,0.23853211009174313,0.0
79,85,60,55,60,71,410,0.60431654676259,75,125,100,70,80,45,495,0.33035714285714285,1.0
45,60,30,80,50,65,330,0.4603174603174603,75,80,85,110,90,50,490,0.3548387096774194,2.0
71,95,85,110,95,79,535,0.664,35,70,55,45,55,25,285,0.09420289855072464,2.0
80,100,70,60,70,95,475,0.7416666666666667,95,109,105,75,85,56,525,0.34513274336283184,1.0
50,95,180,85,45,70,525,0.5298507462686567,73,95,62,85,65,85,465,0.6666666666666666,1.0
60,65,70,85,75,40,395,0.21705426356589147,60,85,40,30,45,68,328,0.6422018348623854,1.0
75,125,100,70,80,45,495,0.33035714285714285,80,120,130,55,65,45,495,0.37037037037037035,0.5
70,120,65,45,85,125,510,0.9747899159663865,86,81,97,81,107,43,495,0.203125,2.0
95,75,110,100,80,30,490,0.15267175572519084,105,150,90,150,90,95,680,0.8285714285714286,0.5
61,78,95,56,58,57,405,0.40336134453781514,70,75,80,135,80,135,575,0.917910447761194,1.0
65,100,70,80,80,105,500,0.8666666666666667,80,115,80,65,55,93,488,0.7846153846153846,1.0
100,150,90,180,160,90,770,0.7348484848484849,100,100,100,100,100,100,600,0.8345864661654135,0.5
76,65,45,92,42,91,411,0.7449664429530202,90,90,85,125,90,100,580,0.768595041322314,0.5
120,120,120,120,120,120,720,0.9344262295081968,91,72,90,129,90,108,580,0.8620689655172413,1.0
60,85,42,85,42,91,405,0.8227848101265823,65,85,70,75,70,40,405,0.203125,0.5
40,30,30,40,50,30,220,0.07936507936507936,38,35,35,65,55,50,278,0.2647058823529412,1.0
100,100,80,60,60,50,450,0.3050847457627119,60,75,100,55,80,50,420,0.3088235294117647,1.0
90,30,15,40,20,15,210,0.043478260869565216,75,70,90,70,105,80,490,0.656,2.0
65,95,75,55,55,85,430,0.6933333333333334,65,85,70,75,70,40,405,0.203125,1.0
60,80,95,70,85,50,440,0.2231404958677686,35,85,45,35,35,75,310,0.6492537313432836,1.0
50,47,50,57,50,65,319,0.463768115942029,60,70,105,70,120,75,500,0.5983606557377049,0.0
75,100,63,80,63,116,497,0.9345794392523364,60,105,60,120,60,105,510,0.8849557522123894,1.0
115,45,20,45,25,20,270,0.11538461538461539,85,100,122,58,75,54,494,0.3939393939393939,0.0
75,75,95,75,95,113,528,0.9015151515151515,59,63,80,65,80,58,405,0.41843971631205673,2.0
60,30,30,36,56,50,262,0.32432432432432434,76,48,48,57,62,34,325,0.11688311688311688,1.0
65,136,94,54,96,135,580,0.9612403100775194,67,82,62,46,48,43,348,0.22033898305084745,1.0
100,100,100,100,100,100,600,0.8778625954198473,70,60,70,87,78,85,450,0.6228070175438597,2.0
60,70,105,70,120,75,500,0.5983606557377049,100,123,75,57,75,80,510,0.6923076923076923,0.0
97,165,60,65,50,58,495,0.3902439024390244,55,65,95,95,45,85,440,0.6610169491525424,1.0
80,70,40,100,60,145,495,0.921875,120,70,120,75,130,85,600,0.6694915254237288,2.0
84,86,88,111,101,60,530,0.4634146341463415,55,40,40,65,45,35,280,0.16428571428571428,0.5
65,90,65,61,61,100,442,0.8373983739837398,73,76,75,81,100,100,505,0.8110236220472441,1.0
40,80,35,35,45,70,305,0.4661016949152542,20,10,55,15,20,80,200,0.17985611510791366,1.0
108,170,115,120,95,92,700,0.7083333333333334,76,147,90,60,70,97,540,0.8267716535433071,2.0
80,125,75,40,95,85,500,0.6911764705882353,60,105,60,120,60,105,510,0.8849557522123894,4.0
74,100,72,90,72,46,454,0.24561403508771928,40,45,40,65,40,65,295,0.5661764705882353,1.0
95,135,80,110,80,100,600,0.8248175182481752,50,95,180,85,45,70,525,0.5298507462686567,1.0
60,70,65,125,105,90,515,0.6911764705882353,62,50,58,73,54,72,369,0.4435483870967742,0.5
65,83,57,95,85,105,490,0.8914728682170543,75,80,95,90,100,50,490,0.2158273381294964,0.5
58,109,112,48,48,109,484,0.8805970149253731,90,132,105,132,105,30,594,0.4246575342465753,4.0
75,90,140,60,60,40,465,0.3008130081300813,100,75,115,90,115,85,580,0.6446280991735537,0.5
61,90,45,50,50,160,456,0.9230769230769231,70,20,50,20,50,40,250,0.1557377049180328,0.5
90,93,55,70,55,55,418,0.3819444444444444,30,65,100,45,25,40,305,0.1891891891891892,0.5
50,20,55,25,25,30,205,0.09774436090225563,76,104,71,104,71,108,534,0.912751677852349,0.25
55,70,40,60,40,40,305,0.26956521739130435,45,75,60,40,30,50,300,0.304,2.0
65,47,55,73,75,85,400,0.65,30,105,90,25,25,50,325,0.2773722627737226,1.0
60,110,70,60,60,100,460,0.8461538461538461,95,75,180,130,80,30,590,0.13793103448275862,1.0
90,55,75,60,75,30,385,0.13970588235294118,60,50,70,80,80,140,480,0.8449612403100775,1.0
50,85,85,55,55,50,380,0.3902439024390244,100,100,90,150,140,90,670,0.71875,0.5
75,105,75,105,75,45,480,0.3274336283185841,70,84,70,65,70,51,410,0.2949640287769784,4.0
55,85,122,58,75,99,494,0.8099173553719008,41,50,37,50,37,66,281,0.5175438596491229,0.5
60,85,49,60,49,60,363,0.4444444444444444,80,100,70,60,70,95,475,0.7416666666666667,0.5
79,105,70,145,80,101,580,0.8608695652173913,100,164,150,95,120,71,700,0.5645161290322581,0.5
66,41,77,61,87,23,355,0.12096774193548387,90,30,15,40,20,15,210,0.043478260869565216,1.0
40,20,30,40,80,55,265,0.22764227642276422,85,105,100,79,83,78,530,0.5869565217391305,1.0
45,30,50,55,65,45,290,0.208,65,95,75,55,55,85,430,0.6933333333333334,2.0
60,62,50,62,60,40,334,0.18181818181818182,65,95,57,100,85,93,495,0.7441860465116279,0.25
70,92,65,80,55,98,460,0.8090909090909091,38,35,35,65,55,50,278,0.2647058823529412,1.0
44,58,44,58,44,61,309,0.41964285714285715,60,55,50,40,55,45,305,0.22377622377622378,2.0
60,85,49,60,49,60,363,0.4444444444444444,50,60,45,100,80,65,400,0.45689655172413796,0.5
114,85,70,85,80,30,464,0.2066115702479339,70,95,85,55,65,70,440,0.5,1.0
95,117,80,65,70,92,519,0.8409090909090909,97,165,60,65,50,58,495,0.3902439024390244,2.0
85,97,66,105,66,65,484,0.47107438016528924,83,80,80,135,80,121,579,0.9444444444444444,1.0
40,65,40,80,40,65,330,0.5038167938931297,70,60,75,110,75,90,480,0.7165354330708661,1.0
70,55,65,95,85,70,440,0.5307692307692308,80,160,80,130,80,100,630,0.8455284552845529,1.0
50,65,107,105,107,86,520,0.7313432835820896,40,45,40,65,40,65,295,0.5661764705882353,0.5
68,125,65,65,115,80,518,0.6277372262773723,35,60,44,40,54,55,288,0.366412213740458,1.0
90,50,34,60,44,70,348,0.6283185840707964,70,90,70,60,60,70,420,0.6390977443609023,0.5
85,115,80,105,80,50,515,0.3063063063063063,40,70,130,60,130,25,455,0.17355371900826447,1.0
75,75,75,125,95,40,485,0.15671641791044777,43,80,65,50,35,35,308,0.14193548387096774,1.0
40,30,50,55,55,100,330,0.584070796460177,55,63,90,50,80,42,380,0.21138211382113822,0.5
40,20,30,40,80,55,265,0.22764227642276422,82,121,119,69,59,71,521,0.5394736842105263,0.5
89,145,90,105,80,91,600,0.8549618320610687,30,30,30,30,30,30,180,0.12612612612612611,1.0
110,65,105,55,95,80,510,0.6258503401360545,125,130,90,130,90,95,660,0.7734375,1.0
77,120,90,60,90,48,485,0.2785714285714286,30,56,35,25,35,72,253,0.48148148148148145,1.0
51,65,65,80,75,59,395,0.4365079365079365,65,90,65,61,61,100,442,0.8373983739837398,2.0
50,95,95,35,110,70,455,0.5179856115107914,76,147,90,60,70,97,540,0.8267716535433071,1.0
74,48,76,83,81,104,466,0.7322834645669292,65,55,115,100,40,60,435,0.3798449612403101,1.0
75,80,85,110,90,50,490,0.3548387096774194,55,50,45,135,95,120,500,0.7714285714285715,1.0
80,70,65,80,120,100,515,0.8034188034188035,49,55,42,42,37,85,310,0.6068376068376068,1.0
85,90,80,70,80,130,535,0.9262295081967213,70,45,48,60,65,35,323,0.15748031496062992,2.0
45,45,55,45,55,63,308,0.4594594594594595,65,65,60,130,95,110,525,0.823943661971831,1.0
72,58,80,103,80,97,490,0.7171052631578947,70,120,65,45,85,125,510,0.9747899159663865,0.0
78,130,111,130,85,100,634,0.8561151079136691,75,105,75,105,75,45,480,0.3274336283185841,0.5
65,130,60,75,60,75,465,0.689922480620155,45,100,135,65,135,45,525,0.29411764705882354,2.0
80,70,40,100,60,145,495,0.921875,1,90,45,30,30,40,236,0.33064516129032256,0.5
95,110,80,70,80,50,485,0.37209302325581395,65,85,70,75,70,40,405,0.203125,1.0
80,135,130,95,90,70,600,0.5181818181818182,90,50,34,60,44,70,348,0.6283185840707964,1.0
60,85,69,65,79,80,438,0.576,65,90,120,85,70,60,490,0.43410852713178294,0.5
70,80,70,80,70,110,480,0.6594202898550725,30,35,30,100,35,80,310,0.4765625,2.0
89,145,90,105,80,91,600,0.8549618320610687,70,55,65,95,85,70,440,0.5307692307692308,1.0
100,134,110,95,100,61,600,0.4057971014492754,72,85,70,65,70,58,420,0.41304347826086957,0.5
70,70,70,70,70,70,420,0.5289256198347108,64,51,23,51,23,28,240,0.11363636363636363,1.0
60,85,42,85,42,91,405,0.8227848101265823,79,100,80,110,90,121,580,0.968,1.0
60,150,50,150,50,60,520,0.5,50,100,150,100,150,50,600,0.37142857142857144,1.0
50,60,60,60,60,30,320,0.11290322580645161,31,45,90,30,30,40,266,0.21929824561403508,1.0
60,100,85,80,85,100,510,0.7007874015748031,130,70,35,70,35,60,400,0.4017857142857143,1.0
50,50,150,50,150,50,500,0.2571428571428571,65,95,75,55,55,85,430,0.6933333333333334,0.5
90,75,85,115,90,55,510,0.3445378151260504,51,65,65,80,75,59,395,0.4365079365079365,1.0
123,77,72,99,92,58,521,0.4621212121212121,80,160,80,130,80,100,630,0.8455284552845529,0.5
80,100,80,80,80,100,520,0.9051724137931034,60,55,145,75,150,40,525,0.2,2.0
50,25,28,45,55,15,218,0.0625,75,80,60,65,90,102,472,0.8625954198473282,1.0
80,80,80,55,55,90,440,0.6417910447761194,76,104,71,104,71,108,534,0.912751677852349,1.0
59,45,40,35,40,31,250,0.14285714285714285,50,53,48,53,48,64,316,0.46153846153846156,1.0
51,65,65,80,75,59,395,0.4365079365079365,50,95,95,35,110,70,455,0.5179856115107914,1.0
60,80,110,50,80,45,425,0.2833333333333333,80,120,70,110,70,80,530,0.6422764227642277,2.0
90,50,34,60,44,70,348,0.6283185840707964,75,80,55,25,35,35,305,0.18666666666666668,2.0
40,30,35,50,70,55,280,0.28205128205128205,55,20,35,20,45,75,250,0.37681159420289856,1.0
85,135,130,60,80,25,515,0.40540540540540543,60,40,80,60,45,40,325,0.23529411764705882,1.0
85,73,70,73,115,67,483,0.5126050420168067,75,103,80,70,80,92,500,0.7933884297520661,1.0
55,50,65,175,95,150,590,0.7818181818181819,80,105,65,60,75,130,515,0.9645390070921985,1.0
86,92,88,68,75,73,482,0.6835443037974683,41,64,45,50,50,50,300,0.36752136752136755,1.0
95,75,80,100,110,30,490,0.24242424242424243,150,80,44,90,54,80,498,0.625,1.0
95,65,110,60,130,65,525,0.5275590551181102,40,55,30,30,30,60,245,0.43548387096774194,1.0
80,80,80,55,55,90,440,0.6417910447761194,75,140,65,112,65,110,567,0.9140625,0.5
35,35,40,35,55,50,250,0.40336134453781514,55,95,115,45,45,35,390,0.2116788321167883,2.0
55,63,90,50,80,42,380,0.21138211382113822,50,85,85,55,55,50,380,0.3902439024390244,0.125
90,30,15,40,20,15,210,0.043478260869565216,90,110,80,100,80,95,555,0.7982456140350878,0.5
70,110,80,55,80,105,500,0.8794326241134752,65,75,90,97,123,44,494,0.1987179487179487,0.5
45,75,37,70,55,83,365,0.6183206106870229,85,90,80,70,80,130,535,0.9262295081967213,1.0
70,140,70,110,65,105,560,0.95,75,100,110,45,55,65,450,0.5333333333333333,2.0
80,100,80,80,80,100,520,0.9051724137931034,35,85,45,35,35,75,310,0.6492537313432836,0.0
40,55,99,40,79,47,360,0.26262626262626265,40,20,30,40,80,55,265,0.22764227642276422,0.5
50,50,77,95,77,91,440,0.5916666666666667,69,55,45,55,55,15,294,0.11666666666666667,0.5
55,95,55,35,75,115,430,0.9380530973451328,44,50,91,24,86,10,305,0.1981981981981982,1.0
60,50,50,60,70,50,340,0.28346456692913385,40,40,40,70,40,20,250,0.032520325203252036,1.0
65,45,55,45,70,45,325,0.24369747899159663,80,105,105,105,105,80,580,0.5939849624060151,1.0
88,107,122,74,75,64,530,0.4596774193548387,75,85,200,55,65,30,510,0.16778523489932887,2.0
89,125,90,115,80,101,600,0.8725490196078431,103,60,126,80,126,50,545,0.36363636363636365,1.0
123,100,62,97,81,68,531,0.4806201550387597,50,75,45,40,45,60,315,0.4380165289256198,0.5
70,120,100,145,105,20,560,0.2824427480916031,54,78,103,53,45,22,355,0.23255813953488372,0.5
100,100,100,100,100,100,600,0.8602941176470589,57,80,91,80,87,75,470,0.5737704918032787,0.5
60,90,70,60,120,40,440,0.27419354838709675,123,100,62,97,81,68,531,0.4806201550387597,1.0
95,75,110,100,80,30,490,0.15267175572519084,80,80,80,80,80,80,480,0.6015037593984962,1.0
90,95,105,165,110,45,610,0.2890625,61,78,95,56,58,57,405,0.40336134453781514,0.5
30,30,30,30,30,30,180,0.12612612612612611,65,125,60,95,60,105,510,0.9236641221374046,1.0
41,56,40,62,44,71,314,0.568,70,70,40,60,40,60,340,0.4247787610619469,0.5
50,180,20,180,20,150,600,0.9029850746268657,59,74,50,35,50,35,303,0.3125,2.0
100,77,77,128,128,90,600,0.6901408450704225,70,20,50,20,50,40,250,0.1557377049180328,1.0
35,35,35,35,35,35,210,0.13385826771653545,60,40,60,40,60,35,295,0.18055555555555555,1.0
100,75,115,90,115,85,580,0.6446280991735537,100,100,100,100,100,100,600,0.831858407079646,1.0
59,74,50,35,50,35,303,0.3125,105,125,100,60,100,100,590,0.8359375,0.0
50,72,35,35,35,65,292,0.5373134328358209,60,40,60,95,60,55,370,0.4222222222222222,4.0
54,63,52,83,56,97,405,0.7697841726618705,70,43,53,43,53,40,302,0.19090909090909092,1.0
49,49,56,49,61,66,330,0.5190839694656488,75,110,110,110,105,80,590,0.656934306569343,0.5
71,73,88,120,89,59,500,0.43537414965986393,70,20,50,20,50,40,250,0.1557377049180328,0.5
35,65,35,65,35,65,300,0.46621621621621623,65,55,115,100,40,60,435,0.3798449612403101,0.5
114,85,70,85,80,30,464,0.2066115702479339,50,35,55,25,25,15,205,0.021739130434782608,0.5
86,68,72,109,66,106,507,0.8099173553719008,95,80,105,40,70,100,490,0.8046875,1.0
45,53,70,40,60,42,310,0.25735294117647056,60,79,105,59,85,36,424,0.17054263565891473,1.0
75,90,140,60,60,40,465,0.3008130081300813,62,50,58,73,54,72,369,0.4435483870967742,0.25
125,170,100,120,90,95,700,0.77,60,100,115,70,85,90,520,0.7557251908396947,0.25
35,64,85,74,55,32,345,0.19827586206896552,75,95,67,125,95,83,540,0.7117117117117117,2.0
50,65,64,44,48,43,314,0.2196969696969697,100,100,125,110,50,50,535,0.384,0.5
80,125,75,40,95,85,500,0.6911764705882353,75,89,85,55,65,36,405,0.29545454545454547,2.0
55,40,85,80,105,40,405,0.23622047244094488,65,90,40,45,80,75,395,0.625,1.0
109,66,84,81,99,32,471,0.2013888888888889,45,45,55,45,55,63,308,0.4594594594594595,0.25
75,89,85,55,65,36,405,0.29545454545454547,126,131,95,131,98,99,680,0.8294573643410853,1.0
41,64,45,50,50,50,300,0.36752136752136755,70,80,70,80,70,110,480,0.6594202898550725,1.0
30,35,30,100,35,80,310,0.4765625,65,80,65,35,65,60,370,0.38405797101449274,0.0
50,48,43,46,41,60,288,0.47297297297297297,38,36,38,32,36,57,237,0.3893805309734513,1.0
55,130,115,50,50,75,475,0.5982142857142857,60,45,70,75,85,55,390,0.3008130081300813,1.0
80,85,95,30,30,25,345,0.2857142857142857,49,66,70,44,55,51,335,0.4260869565217391,0.5
75,140,65,112,65,110,567,0.9140625,80,100,70,50,60,45,405,0.25806451612903225,1.0
38,36,38,32,36,57,237,0.3893805309734513,38,35,35,65,55,50,278,0.2647058823529412,1.0
80,120,79,95,79,70,523,0.5833333333333334,44,48,65,50,64,43,314,0.1623931623931624,2.0
85,100,122,58,75,54,494,0.3939393939393939,60,82,45,45,45,74,351,0.5752212389380531,1.0
45,75,37,70,55,83,365,0.6183206106870229,70,55,65,95,85,70,440,0.5307692307692308,0.5
60,80,110,50,80,45,425,0.2833333333333333,150,160,100,95,65,100,670,0.8866666666666667,1.0
75,123,67,95,85,95,540,0.7642276422764228,55,70,40,60,40,40,305,0.26956521739130435,1.0
60,65,60,130,75,110,500,0.7719298245614035,80,100,70,60,70,95,475,0.7416666666666667,0.0
100,180,160,150,90,90,770,0.7520661157024794,70,110,75,145,85,145,630,0.9444444444444444,0.5
50,70,50,50,50,40,310,0.16296296296296298,90,95,105,165,110,45,610,0.2890625,0.5
55,50,45,135,95,120,500,0.7714285714285715,78,104,78,159,115,100,634,0.8444444444444444,1.0
73,100,60,100,60,65,458,0.42657342657342656,125,130,90,130,90,95,660,0.7734375,1.0
75,95,122,58,75,69,494,0.5725806451612904,110,85,95,80,95,50,515,0.2713178294573643,0.0
38,30,41,30,41,60,240,0.2897196261682243,60,40,50,75,85,95,405,0.6044776119402985,1.0
41,56,40,62,44,71,314,0.568,55,55,45,63,45,45,308,0.25,0.5
45,49,49,65,65,45,318,0.2781954887218045,20,25,45,70,90,60,310,0.30833333333333335,2.0
190,33,58,33,58,33,405,0.13432835820895522,60,60,60,105,105,105,495,0.848,1.0
68,165,95,65,115,110,618,0.8615384615384616,90,90,85,125,90,100,580,0.768595041322314,0.5
72,60,30,20,30,25,237,0.11570247933884298,115,115,85,90,75,100,580,0.8134328358208955,1.0
130,70,35,70,35,60,400,0.4017857142857143,50,20,55,25,25,30,205,0.09774436090225563,1.0
90,95,105,165,110,45,610,0.2890625,75,75,130,75,130,95,580,0.7479674796747967,1.0
120,120,120,120,120,120,720,0.9344262295081968,71,120,95,120,95,99,600,0.8203125,0.5
30,45,55,70,55,85,340,0.5633802816901409,65,40,70,80,140,70,465,0.5954198473282443,0.5
60,100,89,55,69,112,485,0.9298245614035088,52,65,55,58,62,60,352,0.4482758620689655,0.5
55,95,115,45,45,35,390,0.2116788321167883,50,80,95,10,45,10,290,0.232,2.0
65,95,100,60,50,50,420,0.34959349593495936,70,80,65,90,65,85,455,0.578125,1.0
90,110,80,100,80,95,555,0.7982456140350878,38,36,38,32,36,57,237,0.3893805309734513,1.0
60,85,42,85,42,91,405,0.8227848101265823,90,130,80,65,85,55,505,0.4396551724137931,1.0
40,70,130,60,130,25,455,0.17355371900826447,95,117,80,65,70,92,519,0.8409090909090909,0.5
44,50,91,24,86,10,305,0.1981981981981982,65,150,60,115,60,115,565,0.935251798561151,1.0
75,95,122,58,75,69,494,0.5725806451612904,75,100,110,45,55,65,450,0.5333333333333333,2.0
45,30,50,55,65,45,290,0.208,90,120,100,150,120,100,680,0.7718120805369127,1.0
100,100,125,110,50,50,535,0.384,70,55,55,80,60,45,365,0.2222222222222222,1.0
80,120,130,55,65,45,495,0.37037037037037035,85,80,70,135,75,90,535,0.7006802721088435,1.0
60,30,30,36,56,50,262,0.32432432432432434,125,170,100,120,90,95,700,0.77,1.0
55,45,43,55,43,72,313,0.5853658536585366,100,100,100,100,100,100,600,0.8758169934640523,0.125
50,65,107,105,107,86,520,0.7313432835820896,40,50,45,70,45,70,320,0.5517241379310345,1.0
38,36,38,32,36,57,237,0.3893805309734513,70,85,65,105,85,120,530,0.9262295081967213,1.0
35,80,50,50,70,120,405,0.84375,45,80,100,35,37,28,325,0.3125,2.0
65,55,115,100,40,60,435,0.3798449612403101,74,100,72,90,72,46,454,0.24561403508771928,0.5
45,30,35,20,20,45,195,0.14782608695652175,71,73,88,120,89,59,500,0.43537414965986393,1.0
90,85,100,95,125,85,580,0.6834532374100719,55,85,122,58,75,99,494,0.8099173553719008,4.0
90,93,55,70,55,55,418,0.3819444444444444,55,40,85,80,105,40,405,0.23622047244094488,0.25
75,80,55,25,35,35,305,0.18666666666666668,60,90,140,50,50,40,430,0.2535211267605634,4.0
60,70,65,125,105,90,515,0.6911764705882353,55,95,55,35,75,115,430,0.9380530973451328,1.0
71,73,88,120,89,59,500,0.43537414965986393,80,110,60,150,130,70,600,0.5042016806722689,1.0
50,85,40,85,40,35,335,0.1746031746031746,40,35,30,120,70,105,400,0.6692307692307692,1.0
75,100,66,60,66,115,482,0.918918918918919,65,65,60,110,95,130,525,0.9253731343283582,1.0
38,35,35,65,55,50,278,0.2647058823529412,100,180,160,150,90,90,770,0.7520661157024794,1.0
64,78,52,78,52,81,405,0.6422764227642277,45,63,37,65,55,95,360,0.8055555555555556,1.0
70,90,110,60,75,95,500,0.7333333333333333,40,45,40,65,40,65,295,0.5661764705882353,1.0
71,120,95,120,95,99,600,0.8203125,106,130,90,110,154,90,680,0.719626168224299,0.125
53,51,53,61,56,40,314,0.14285714285714285,65,65,45,75,45,95,390,0.72,1.0
55,75,60,75,60,103,428,0.7982456140350878,170,90,45,90,45,60,500,0.427536231884058,2.0
90,132,105,132,105,30,594,0.4246575342465753,50,65,64,44,48,43,314,0.2196969696969697,1.0
80,100,80,80,80,100,520,0.9051724137931034,60,90,55,90,80,110,485,0.8677685950413223,2.0
82,80,86,85,75,72,480,0.6183206106870229,45,30,35,20,20,45,195,0.14782608695652175,1.0
35,46,34,35,45,20,215,0.072,50,95,180,85,45,70,525,0.5298507462686567,1.0
75,90,90,140,90,115,600,0.9481481481481482,68,125,65,65,115,80,518,0.6277372262773723,1.0
80,82,83,100,100,80,525,0.6742424242424242,80,120,80,120,80,100,580,0.8478260869565217,1.0
40,20,30,40,80,55,265,0.22764227642276422,90,75,85,115,90,55,510,0.3445378151260504,0.5
45,60,32,50,32,76,295,0.5925925925925926,60,90,140,50,50,40,430,0.2535211267605634,1.0
48,61,40,61,40,50,300,0.2543859649122807,35,55,40,45,40,60,275,0.35714285714285715,1.0
37,25,41,25,41,25,194,0.08870967741935484,65,130,60,95,110,65,525,0.5303030303030303,0.5
108,112,118,68,72,47,525,0.2916666666666667,65,65,65,50,50,90,385,0.72,1.0
71,73,88,120,89,59,500,0.43537414965986393,50,50,50,50,50,50,300,0.30708661417322836,1.0
50,47,50,57,50,65,319,0.463768115942029,25,20,15,105,55,90,310,0.32407407407407407,2.0
75,75,95,75,95,113,528,0.9015151515151515,90,75,85,115,90,55,510,0.3445378151260504,1.0
64,88,50,88,50,106,446,0.9111111111111111,100,70,70,65,65,45,415,0.1897810218978102,1.0
150,160,100,95,65,100,670,0.8866666666666667,50,72,35,35,35,65,292,0.5373134328358209,1.0
40,30,35,50,70,55,280,0.28205128205128205,111,83,68,92,82,39,475,0.1774193548387097,2.0
100,134,110,95,100,61,600,0.4057971014492754,30,80,90,55,45,55,355,0.4295774647887324,1.0
55,40,50,65,85,40,335,0.3181818181818182,105,30,105,140,105,55,540,0.3524590163934426,4.0
60,50,150,50,150,60,520,0.5206611570247934,100,120,120,150,100,90,680,0.7880794701986755,0.5
89,124,80,55,80,55,483,0.5714285714285714,80,110,60,150,130,70,600,0.5042016806722689,4.0
70,65,65,55,55,70,380,0.5,79,85,60,55,60,71,410,0.60431654676259,1.0
91,90,106,130,106,77,600,0.648854961832061,50,50,95,40,50,35,320,0.20279720279720279,1.0
100,50,50,76,96,70,442,0.5,30,80,90,55,45,55,355,0.4295774647887324,0.25
90,132,105,132,105,30,594,0.4246575342465753,75,125,75,30,75,85,465,0.625,1.0
72,105,115,54,86,68,500,0.5149253731343284,55,95,115,45,45,35,390,0.2116788321167883,2.0
65,90,40,45,80,75,395,0.625,60,70,105,70,120,75,500,0.5983606557377049,1.0
45,30,40,105,50,20,290,0.031007751937984496,58,50,145,95,105,30,483,0.2459016393442623,1.0
45,60,32,50,32,76,295,0.5925925925925926,60,85,69,65,79,80,438,0.576,1.0
57,24,86,24,86,23,300,0.12727272727272726,60,110,70,60,60,100,460,0.8461538461538461,1.0
30,105,90,25,25,50,325,0.2773722627737226,80,80,90,110,130,110,600,0.8721804511278195,0.5
46,87,60,30,40,57,320,0.37777777777777777,85,76,64,45,55,90,415,0.6739130434782609,1.0
55,81,60,50,70,97,413,0.7214285714285714,75,90,90,140,90,115,600,0.9481481481481482,1.0
85,115,80,105,80,50,515,0.3063063063063063,90,132,105,132,105,30,594,0.4246575342465753,0.5
60,82,45,45,45,74,351,0.5752212389380531,39,52,43,60,50,65,309,0.49107142857142855,2.0
75,75,75,125,95,40,485,0.15671641791044777,60,85,69,65,79,80,438,0.576,2.0
70,85,70,60,70,50,405,0.28378378378378377,78,70,61,50,61,100,420,0.8145161290322581,1.0
75,80,85,110,90,50,490,0.3548387096774194,100,150,90,180,160,90,770,0.7348484848484849,2.0
90,90,85,125,90,100,580,0.768595041322314,45,45,35,20,30,20,195,0.07246376811594203,2.0
65,110,130,60,65,95,525,0.8278145695364238,150,160,100,95,65,100,670,0.8866666666666667,1.0
80,85,95,30,30,25,345,0.2857142857142857,55,104,105,94,75,52,485,0.36363636363636365,1.0
68,75,53,83,113,60,452,0.45384615384615384,55,55,55,85,55,30,335,0.1320754716981132,1.0
104,91,63,91,73,68,490,0.5118110236220472,40,55,70,45,60,30,300,0.10619469026548672,0.5
76,48,48,57,62,34,325,0.11688311688311688,103,60,86,60,86,50,445,0.3458646616541353,1.0
75,75,130,75,130,95,580,0.7479674796747967,45,30,50,55,65,45,290,0.208,0.5
65,80,140,40,70,70,465,0.5223880597014925,60,60,40,65,45,35,305,0.15833333333333333,0.5
65,40,50,125,60,30,370,0.07258064516129033,70,120,100,145,105,20,560,0.2824427480916031,2.0
71,120,95,120,95,99,600,0.8203125,62,50,58,73,54,72,369,0.4435483870967742,0.25
60,65,70,85,75,40,395,0.21705426356589147,50,64,50,45,50,41,300,0.22727272727272727,1.0
60,60,50,40,50,75,335,0.5882352941176471,75,65,55,65,55,69,384,0.43548387096774194,4.0
40,45,40,65,40,65,295,0.5661764705882353,70,140,230,60,80,50,630,0.32432432432432434,1.0
76,147,90,60,70,97,540,0.8267716535433071,49,49,56,49,61,66,330,0.5190839694656488,1.0
50,35,55,25,25,15,205,0.05263157894736842,80,160,80,130,80,100,630,0.8455284552845529,0.25
38,30,85,55,65,30,303,0.21428571428571427,90,65,65,40,40,15,315,0.19672131147540983,2.0
70,77,60,97,60,108,472,0.8394160583941606,80,92,65,65,80,68,450,0.4824561403508772,2.0
40,30,35,45,40,55,245,0.31496062992125984,70,50,30,95,135,105,485,0.8040540540540541,1.0
50,100,150,100,150,50,600,0.37142857142857144,75,123,67,95,85,95,540,0.7642276422764228,1.0
75,125,75,30,75,85,465,0.625,70,150,140,65,100,75,600,0.55,1.0
30,45,135,45,90,30,375,0.09285714285714286,65,95,100,60,50,50,420,0.34959349593495936,1.0
45,50,45,115,55,95,405,0.6936936936936937,40,65,40,80,40,65,330,0.5038167938931297,0.5
74,100,72,90,72,46,454,0.24561403508771928,65,136,94,54,96,135,580,0.9612403100775194,1.0
95,155,109,70,130,81,640,0.6788321167883211,80,80,80,55,55,90,440,0.6417910447761194,1.0
55,68,64,45,55,31,318,0.11666666666666667,85,110,76,65,82,56,474,0.3933333333333333,0.5
50,20,40,20,40,20,190,0.0962962962962963,50,85,125,85,115,20,480,0.4306569343065693,0.0
50,53,62,58,63,44,330,0.13709677419354838,40,45,35,40,40,90,290,0.65,1.0
60,82,45,45,45,74,351,0.5752212389380531,45,67,60,35,50,63,320,0.5128205128205128,1.0
65,75,105,35,65,85,430,0.6940298507462687,95,85,85,65,65,35,430,0.2571428571428571,1.0
70,85,70,60,70,50,405,0.28378378378378377,44,50,91,24,86,10,305,0.1981981981981982,0.5
45,100,135,65,135,45,525,0.29411764705882354,80,85,95,30,30,25,345,0.2857142857142857,1.0
80,100,200,50,100,50,580,0.3472222222222222,70,70,115,130,90,60,535,0.5338983050847458,0.5
60,70,50,100,50,65,395,0.5217391304347826,80,130,100,160,120,110,700,0.8981481481481481,2.0
123,77,72,99,92,58,521,0.4621212121212121,84,71,43,71,43,48,360,0.25874125874125875,1.0
46,87,60,30,40,57,320,0.37777777777777777,105,105,75,65,100,50,500,0.37593984962406013,1.0
40,35,30,20,20,50,195,0.23423423423423423,85,105,55,85,50,115,495,0.9032258064516129,1.0
70,60,70,87,78,85,450,0.6228070175438597,80,100,200,50,100,50,580,0.3472222222222222,2.0
80,70,65,80,120,100,515,0.8034188034188035,75,140,65,112,65,110,567,0.9140625,1.0
70,105,105,50,40,20,390,0.33587786259541985,78,92,75,74,63,118,500,0.8842975206611571,1.0
80,70,70,90,100,70,480,0.5609756097560976,80,100,70,50,60,45,405,0.25806451612903225,1.0
35,35,40,35,55,50,250,0.40336134453781514,49,55,42,42,37,85,310,0.6068376068376068,1.0
78,84,78,109,85,100,534,0.8620689655172413,50,25,28,45,55,15,218,0.0625,1.0
30,45,55,70,55,85,340,0.5633802816901409,70,110,70,115,70,90,525,0.75,1.0
45,50,55,75,65,30,320,0.06293706293706294,55,69,85,32,35,28,304,0.09302325581395349,1.0
55,40,50,65,85,40,335,0.3181818181818182,65,45,55,45,70,45,325,0.24369747899159663,0.5
61,90,45,50,50,160,456,0.9230769230769231,60,52,168,47,138,30,495,0.19834710743801653,0.125
110,85,95,80,95,50,515,0.2713178294573643,72,95,67,103,71,122,530,0.9606299212598425,1.0
80,100,123,122,120,80,625,0.56,71,82,64,64,59,112,452,0.9327731092436975,1.0
80,80,80,80,80,80,480,0.6015037593984962,60,45,50,90,80,70,395,0.625,2.0
41,64,45,50,50,50,300,0.36752136752136755,95,75,110,100,80,30,490,0.15267175572519084,1.0
70,145,88,140,70,112,625,0.8888888888888888,110,65,75,125,85,30,490,0.15,0.5
45,50,43,40,38,62,278,0.40441176470588236,76,25,45,67,55,24,292,0.0390625,1.0
60,50,70,50,90,65,385,0.39568345323741005,70,80,50,35,35,35,305,0.14,0.5
90,100,60,90,60,80,480,0.6422764227642277,66,117,70,40,50,67,410,0.4573643410852713,0.5
60,40,60,40,60,35,295,0.18055555555555555,65,90,122,58,75,84,494,0.71875,0.5
55,69,85,32,35,28,304,0.09302325581395349,100,100,100,100,100,100,600,0.8345864661654135,2.0
60,95,80,60,80,30,405,0.19480519480519481,55,85,122,58,75,99,494,0.8099173553719008,0.5
40,27,60,37,50,66,280,0.36220472440944884,45,60,40,70,50,45,310,0.2846715328467153,0.25
92,105,90,125,90,98,600,0.8217054263565892,44,75,35,63,33,45,295,0.2647058823529412,2.0
60,60,40,65,45,35,305,0.15833333333333333,71,95,85,110,95,79,535,0.664,2.0
55,130,115,50,50,75,475,0.5982142857142857,80,135,85,70,95,150,615,0.9844961240310077,2.0
72,85,70,65,70,58,420,0.41304347826086957,50,45,45,35,35,50,260,0.23529411764705882,1.0
80,130,100,160,120,110,700,0.8981481481481481,70,150,140,65,100,75,600,0.55,0.25
70,83,50,37,50,60,350,0.3360655737704918,65,100,70,80,80,105,500,0.8666666666666667,1.0
30,40,55,40,55,60,280,0.3237410071942446,100,70,70,65,65,45,415,0.1897810218978102,2.0
65,50,35,115,95,95,455,0.7333333333333333,80,110,120,130,90,70,600,0.6198347107438017,0.25
55,40,50,65,85,40,335,0.3181818181818182,35,65,35,65,35,65,300,0.46621621621621623,0.5
63,120,85,90,55,55,468,0.2809917355371901,78,130,111,130,85,100,634,0.8561151079136691,1.0
65,130,60,95,110,65,525,0.5303030303030303,255,10,10,75,135,55,540,0.3125,1.0
75,65,55,65,55,69,384,0.43548387096774194,71,73,88,120,89,59,500,0.43537414965986393,0.5
55,40,40,65,45,35,280,0.16428571428571428,50,70,160,70,160,90,600,0.7417218543046358,1.0
45,55,39,35,39,42,255,0.18518518518518517,45,80,100,35,37,28,325,0.3125,0.0
75,125,100,70,80,45,495,0.33035714285714285,35,80,50,50,70,120,405,0.84375,0.5
65,90,120,85,70,60,490,0.43410852713178294,83,106,65,86,65,85,490,0.6640625,0.5
70,140,70,110,65,105,560,0.95,40,55,30,30,30,85,270,0.688,1.0
50,100,150,100,150,50,600,0.37142857142857144,50,65,107,105,107,86,520,0.7272727272727273,2.0
45,22,60,27,30,29,213,0.07518796992481203,60,95,80,60,80,30,405,0.19480519480519481,2.0
80,160,60,170,130,80,680,0.6180555555555556,65,90,120,85,70,60,490,0.43410852713178294,2.0
75,98,63,98,63,101,498,0.889763779527559,70,40,50,55,50,25,290,0.061068702290076333,1.0
10,55,25,35,45,95,265,0.5396825396825397,55,75,60,75,60,103,428,0.7982456140350878,0.0
40,65,40,80,40,65,330,0.5038167938931297,73,76,75,81,100,100,505,0.8110236220472441,1.0
68,125,65,65,115,80,518,0.6277372262773723,106,110,90,154,90,130,680,0.926829268292683,0.25
55,70,45,70,50,60,350,0.45,86,76,86,116,56,95,515,0.7982456140350878,2.0
95,85,85,65,65,35,430,0.2571428571428571,60,65,80,170,95,130,600,0.8625954198473282,2.0
60,60,60,60,60,60,360,0.38095238095238093,60,110,70,60,60,100,460,0.8461538461538461,1.0
60,75,100,55,80,50,420,0.3088235294117647,60,95,80,60,80,30,405,0.19480519480519481,1.0
80,90,80,130,110,110,600,0.856,65,95,75,55,55,85,430,0.6933333333333334,2.0
110,135,60,50,65,88,508,0.7744360902255639,85,105,55,85,50,115,495,0.9032258064516129,0.5
91,90,72,90,129,108,580,0.896,45,53,70,40,60,42,310,0.25735294117647056,0.125
62,73,55,56,52,84,382,0.7244094488188977,60,90,140,50,50,40,430,0.2535211267605634,0.25
60,79,105,59,85,36,424,0.17054263565891473,40,35,30,120,70,105,400,0.6692307692307692,2.0
46,57,40,40,40,50,273,0.25,62,48,54,63,60,68,355,0.5178571428571429,1.0
60,62,50,62,60,40,334,0.18181818181818182,70,90,45,15,45,50,315,0.3629032258064516,0.25
75,123,67,95,85,95,540,0.7642276422764228,81,102,77,85,75,85,505,0.5642857142857143,0.0
62,55,52,109,94,109,481,0.7833333333333333,62,50,58,73,54,72,369,0.4435483870967742,1.0
150,100,120,100,120,90,680,0.6666666666666666,50,64,50,45,50,41,300,0.22727272727272727,1.0
100,75,115,90,115,85,580,0.6446280991735537,80,82,83,100,100,80,525,0.6742424242424242,0.5
90,90,85,125,90,100,580,0.768595041322314,50,53,48,53,48,64,316,0.358974358974359,2.0
55,50,45,135,95,120,500,0.7714285714285715,170,90,45,90,45,60,500,0.427536231884058,1.0
75,95,125,45,75,95,510,0.8257575757575758,90,120,120,60,60,50,500,0.35294117647058826,1.0
50,70,50,50,50,40,310,0.16296296296296298,30,105,90,25,25,50,325,0.2773722627737226,0.5
75,80,70,65,75,90,455,0.7578125,55,45,43,55,43,72,313,0.5853658536585366,1.0
115,115,85,90,75,100,580,0.8134328358208955,35,60,44,40,54,55,288,0.366412213740458,1.0
61,90,45,50,50,160,456,0.9230769230769231,65,125,100,60,70,70,490,0.6099290780141844,0.5
65,83,57,95,85,105,490,0.8914728682170543,91,134,95,100,100,80,600,0.6304347826086957,1.0
75,80,60,65,90,102,472,0.8625954198473282,45,60,32,50,32,76,295,0.5925925925925926,1.0
75,100,66,60,66,115,482,0.918918918918919,82,80,86,85,75,72,480,0.6183206106870229,1.0
75,89,85,55,65,36,405,0.29545454545454547,45,25,50,25,25,35,205,0.13076923076923078,0.25
35,45,160,30,45,70,385,0.48148148148148145,90,120,75,60,60,45,450,0.29411764705882354,1.0
36,50,50,65,60,44,305,0.16363636363636364,83,80,75,70,70,101,479,0.8615384615384616,2.0
58,64,58,80,65,80,405,0.609271523178808,80,160,60,170,130,80,680,0.6180555555555556,1.0
95,70,73,95,90,60,483,0.3983739837398374,50,53,48,53,48,64,316,0.46153846153846156,0.5
100,128,90,77,77,128,600,0.959349593495935,55,84,105,114,75,52,485,0.2890625,1.0
70,43,53,43,53,40,302,0.19090909090909092,55,45,45,25,25,15,210,0.048,0.5
20,25,45,70,90,60,310,0.30833333333333335,80,120,130,55,65,45,495,0.37037037037037035,2.0
95,70,73,95,90,60,483,0.3983739837398374,58,109,112,48,48,109,484,0.8805970149253731,0.5
70,140,230,60,80,50,630,0.32432432432432434,64,88,50,88,50,106,446,0.9111111111111111,1.0
90,60,60,40,40,40,330,0.29545454545454547,39,52,43,60,50,65,309,0.5041322314049587,2.0
65,63,45,45,45,45,308,0.2595419847328244,77,85,51,55,51,65,384,0.5163934426229508,2.0
80,70,65,80,120,100,515,0.8034188034188035,40,27,60,37,50,66,280,0.36220472440944884,2.0
89,124,80,55,80,55,483,0.5714285714285714,85,110,90,45,90,80,500,0.6206896551724138,0.0
80,120,80,120,80,100,580,0.8478260869565217,75,75,55,105,85,30,425,0.1619718309859155,2.0
60,90,70,60,120,40,440,0.27419354838709675,103,93,67,71,61,84,479,0.7142857142857143,1.0
38,35,40,27,25,35,200,0.08208955223880597,125,58,58,76,76,67,460,0.515625,1.0
76,104,71,104,71,108,534,0.912751677852349,108,100,121,81,95,95,600,0.7476635514018691,0.5
79,103,120,135,115,78,630,0.5763888888888888,40,30,35,45,40,55,245,0.31496062992125984,0.5
80,120,70,110,70,80,530,0.6422764227642277,74,48,76,83,81,104,466,0.7913043478260869,0.5
70,65,65,55,55,70,380,0.5,40,50,45,70,45,70,320,0.5517241379310345,1.0
60,75,100,55,80,50,420,0.3088235294117647,79,105,70,145,80,101,580,0.8608695652173913,0.5
50,95,180,85,45,70,525,0.5298507462686567,109,66,84,81,99,32,471,0.2013888888888889,4.0
75,80,95,90,100,50,490,0.2158273381294964,55,75,85,25,25,15,280,0.1875,2.0
50,95,95,35,110,70,455,0.5179856115107914,75,90,140,60,60,40,465,0.3008130081300813,1.0
72,95,67,103,71,122,530,0.9606299212598425,70,40,50,55,50,25,290,0.061068702290076333,0.5
73,76,75,81,100,100,505,0.8110236220472441,70,70,70,70,70,70,420,0.5289256198347108,1.0
120,100,85,30,85,45,465,0.22448979591836735,85,105,100,79,83,78,530,0.5869565217391305,1.0
100,77,77,128,128,90,600,0.6901408450704225,90,95,105,165,110,45,610,0.2890625,1.0
60,82,45,45,45,74,351,0.5752212389380531,90,30,15,40,20,15,210,0.043478260869565216,0.5
40,45,65,100,120,90,460,0.5588235294117647,65,95,100,60,50,50,420,0.34959349593495936,2.0
86,68,72,109,66,106,507,0.8099173553719008,50,85,85,55,55,50,380,0.3902439024390244,1.0
45,30,40,105,50,20,290,0.031007751937984496,64,66,68,81,76,50,405,0.25190839694656486,1.0
54,78,103,53,45,22,355,0.23255813953488372,35,40,100,90,55,35,355,0.1796875,1.0
60,45,70,45,90,95,405,0.7304964539007093,55,45,50,45,65,80,340,0.5546218487394958,1.0
38,35,40,27,25,35,200,0.08208955223880597,90,95,95,70,90,70,510,0.5230769230769231,0.5
45,85,70,40,40,60,340,0.5229357798165137,76,104,71,104,71,108,534,0.912751677852349,0.25
90,70,80,70,95,70,475,0.5190839694656488,65,75,105,35,65,85,430,0.6940298507462687,8.0
100,128,90,77,77,128,600,0.959349593495935,69,69,76,69,86,91,460,0.6554621848739496,1.0
95,65,110,60,130,65,525,0.5275590551181102,150,120,100,120,100,90,680,0.664179104477612,2.0
65,90,120,85,70,60,490,0.43410852713178294,130,65,60,110,95,65,525,0.5227272727272727,1.0
75,80,55,25,35,35,305,0.18666666666666668,58,89,77,45,45,48,362,0.3177570093457944,2.0
60,60,60,85,85,85,435,0.631578947368421,79,103,120,135,115,78,630,0.5763888888888888,1.0
95,117,80,65,70,92,519,0.8409090909090909,40,55,80,35,60,30,300,0.15037593984962405,4.0
70,145,88,140,70,112,625,0.8888888888888888,100,50,80,60,80,50,420,0.34375,0.125
95,85,85,65,65,35,430,0.2571428571428571,43,70,48,50,60,38,309,0.2391304347826087,0.25
80,105,105,105,105,80,580,0.5939849624060151,110,130,80,70,60,80,530,0.5862068965517241,2.0
85,105,100,79,83,78,530,0.5869565217391305,60,50,70,50,90,65,385,0.39568345323741005,1.0
71,82,64,64,59,112,452,0.9327731092436975,80,120,80,120,80,100,580,0.8478260869565217,1.0
49,55,42,42,37,85,310,0.6068376068376068,45,65,34,40,34,45,263,0.2589928057553957,1.0
65,75,70,95,70,95,470,0.7272727272727273,75,100,66,60,66,115,482,0.918918918918919,1.0
65,76,84,54,96,105,480,0.9008264462809917,50,25,28,45,55,15,218,0.0625,1.0
80,120,130,55,65,45,495,0.37037037037037035,77,120,90,60,90,48,485,0.2785714285714286,1.0
64,115,65,83,63,65,455,0.5323741007194245,75,85,200,55,65,30,510,0.16778523489932887,1.0
44,38,39,61,79,42,303,0.2251655629139073,100,150,120,120,100,90,680,0.6493506493506493,2.0
95,110,80,70,80,50,485,0.37209302325581395,49,49,56,49,61,66,330,0.5190839694656488,0.5
77,59,50,67,63,46,362,0.23140495867768596,45,30,35,20,20,45,195,0.14782608695652175,2.0
60,80,50,40,40,30,300,0.15328467153284672,80,120,130,55,65,45,495,0.37037037037037035,1.0
100,100,100,100,100,100,600,0.831858407079646,20,15,20,10,55,80,200,0.2682926829268293,1.0
58,50,145,95,105,30,483,0.2459016393442623,35,55,40,50,50,90,320,0.6838235294117647,1.0
35,35,40,35,55,50,250,0.40336134453781514,65,40,50,125,60,30,370,0.07258064516129033,1.0
40,40,35,50,100,70,335,0.5031847133757962,70,120,100,145,105,20,560,0.2824427480916031,2.0
50,65,45,85,65,95,405,0.7238095238095238,80,120,130,55,65,45,495,0.37037037037037035,4.0
70,120,100,145,105,20,560,0.2824427480916031,65,90,120,85,70,60,490,0.43410852713178294,2.0
75,125,70,125,70,115,580,0.9037037037037037,70,90,70,60,60,70,420,0.6390977443609023,0.0
55,45,43,55,43,72,313,0.5853658536585366,126,131,95,131,98,99,680,0.8294573643410853,1.0
65,95,57,100,85,93,495,0.7441860465116279,50,70,50,50,50,40,310,0.16296296296296298,0.5
54,63,52,83,56,97,405,0.7697841726618705,95,145,130,120,90,120,700,0.9398496240601504,0.5
45,50,35,55,75,40,300,0.21367521367521367,28,25,25,45,35,40,198,0.16083916083916083,0.0
75,80,55,25,35,35,305,0.18666666666666668,60,48,45,43,90,42,328,0.21897810218978103,0.5
70,80,70,80,70,110,480,0.6594202898550725,80,135,85,70,95,150,615,0.9844961240310077,2.0
80,80,80,80,80,80,480,0.6015037593984962,100,100,100,100,100,100,600,0.8602941176470589,2.0
75,80,55,25,35,35,305,0.18666666666666668,43,80,65,50,35,35,308,0.14193548387096774,1.0
50,35,55,25,25,15,205,0.05263157894736842,50,65,107,105,107,86,520,0.7758620689655172,1.0
75,95,95,95,95,85,540,0.6470588235294118,70,65,60,90,75,90,450,0.6571428571428571,1.0
110,85,95,80,95,50,515,0.2713178294573643,116,55,85,107,95,29,487,0.06818181818181818,1.0
58,109,112,48,48,109,484,0.8805970149253731,85,120,70,50,60,100,485,0.8308823529411765,0.5
81,102,77,85,75,85,505,0.5642857142857143,30,45,59,30,39,57,260,0.2803030303030303,0.5
68,85,65,165,135,100,618,0.8083333333333333,61,90,45,50,50,160,456,0.9230769230769231,1.0
65,95,75,55,55,85,430,0.6933333333333334,42,52,67,39,56,50,306,0.2868217054263566,0.5
55,50,40,40,40,75,300,0.5945945945945946,70,100,70,105,75,40,460,0.23214285714285715,1.0
45,60,40,70,50,45,310,0.2846715328467153,60,85,49,60,49,60,363,0.4444444444444444,1.0
58,50,145,95,105,30,483,0.2459016393442623,70,80,102,80,102,40,474,0.2677165354330709,1.0
108,100,121,81,95,95,600,0.7476635514018691,95,125,79,60,100,81,540,0.6165413533834586,0.0
85,50,95,120,115,80,545,0.5793650793650794,65,90,120,85,70,60,490,0.43410852713178294,0.5
60,80,50,50,50,40,330,0.23853211009174313,60,85,69,65,79,80,438,0.576,1.0
65,125,100,60,70,70,490,0.6099290780141844,60,90,55,90,80,110,485,0.8677685950413223,0.5
95,60,79,100,125,81,540,0.6201550387596899,106,190,100,154,100,130,780,0.9259259259259259,1.0
75,98,63,98,63,101,498,0.849624060150376,40,50,90,30,55,65,330,0.44680851063829785,1.0
100,134,110,95,100,61,600,0.4057971014492754,89,125,90,115,80,101,600,0.8725490196078431,1.0
40,45,40,65,40,65,295,0.5661764705882353,40,29,45,29,45,36,224,0.14634146341463414,1.0
60,45,50,90,80,70,395,0.625,40,60,30,31,31,70,262,0.4492753623188406,0.5
75,69,72,114,100,104,534,0.8253968253968254,54,63,52,83,56,97,405,0.7697841726618705,0.5
45,95,50,40,50,75,355,0.54,65,83,57,95,85,105,490,0.8914728682170543,1.0
80,110,60,150,130,70,600,0.5042016806722689,40,45,40,62,60,60,307,0.33884297520661155,1.0
50,20,55,25,25,30,205,0.09774436090225563,45,20,50,60,120,50,345,0.24074074074074073,0.5
73,100,60,100,60,65,458,0.42657342657342656,110,160,110,80,110,100,670,0.8591549295774648,1.0
100,150,120,120,100,90,680,0.6493506493506493,30,42,118,42,88,30,350,0.112,0.5
65,47,55,73,75,85,400,0.65,20,10,55,15,20,80,200,0.17985611510791366,1.0
65,55,115,100,40,60,435,0.3798449612403101,45,50,55,75,65,30,320,0.06293706293706294,0.25
65,85,70,75,70,40,405,0.203125,65,125,100,60,70,70,490,0.6099290780141844,1.0
35,35,35,35,35,35,210,0.13385826771653545,60,59,85,79,105,36,424,0.16666666666666666,0.5
100,70,70,65,65,45,415,0.1897810218978102,65,150,60,115,60,115,565,0.935251798561151,1.0
60,80,95,70,85,50,440,0.2231404958677686,40,30,35,45,40,55,245,0.31496062992125984,1.0
103,60,86,60,86,50,445,0.3458646616541353,40,40,40,70,40,20,250,0.032520325203252036,1.0
70,150,140,65,100,75,600,0.55,80,82,78,95,80,85,500,0.6869565217391305,0.5
40,80,35,35,45,70,305,0.4661016949152542,65,125,60,95,60,105,510,0.9236641221374046,1.0
60,115,105,65,70,80,495,0.7181818181818181,115,140,130,55,55,40,535,0.4519230769230769,2.0
103,60,126,80,126,50,545,0.36363636363636365,80,100,70,50,60,45,405,0.25806451612903225,2.0
45,55,45,65,45,75,330,0.5692307692307692,44,38,33,61,43,70,289,0.5267857142857143,0.5
130,65,60,110,95,65,525,0.5227272727272727,35,55,40,45,40,60,275,0.35714285714285715,1.0
50,40,85,40,65,25,305,0.08870967741935484,85,135,130,60,80,25,515,0.40540540540540543,1.0
150,100,120,100,120,90,680,0.6666666666666666,55,47,52,40,40,41,275,0.16806722689075632,1.0
60,45,70,75,85,55,390,0.3008130081300813,60,50,100,85,70,65,430,0.47580645161290325,1.0
45,50,55,75,65,30,320,0.06293706293706294,55,55,85,65,85,35,380,0.2014388489208633,2.0
110,85,95,80,95,50,515,0.2713178294573643,65,125,100,60,70,70,490,0.6099290780141844,0.5
90,95,105,165,110,45,610,0.2890625,70,130,100,55,80,65,500,0.608,0.5
78,70,61,50,61,100,420,0.8145161290322581,75,75,60,83,60,60,413,0.39344262295081966,1.0
65,75,90,97,123,44,494,0.1987179487179487,35,45,160,30,45,70,385,0.48148148148148145,0.25
45,30,40,105,50,20,290,0.031007751937984496,68,65,65,125,115,80,518,0.6461538461538462,0.5
50,35,55,25,25,15,205,0.05263157894736842,80,82,83,100,100,80,525,0.6742424242424242,1.0
50,65,45,85,65,95,405,0.7238095238095238,50,60,60,60,60,30,320,0.11290322580645161,1.0
60,100,85,80,85,100,510,0.7007874015748031,73,115,60,60,60,90,458,0.6694915254237288,2.0
40,45,65,100,120,90,460,0.5588235294117647,65,47,55,73,75,85,400,0.65,1.0
60,60,60,35,35,30,280,0.11194029850746269,67,89,116,79,116,33,500,0.2624113475177305,0.5
95,110,95,40,95,55,490,0.40336134453781514,59,63,80,65,80,58,405,0.41843971631205673,1.0
72,95,67,103,71,122,530,0.9606299212598425,44,50,91,24,86,10,305,0.1981981981981982,0.5
70,85,70,60,70,50,405,0.28378378378378377,126,131,95,131,98,99,680,0.8294573643410853,1.0
64,115,65,83,63,65,455,0.5323741007194245,50,75,45,40,45,60,315,0.4380165289256198,1.0
45,100,45,45,45,10,290,0.2949640287769784,60,85,60,50,50,125,430,0.9090909090909091,0.0
65,63,45,45,45,45,308,0.2595419847328244,70,150,140,65,100,75,600,0.55,4.0
45,95,50,40,50,75,355,0.54,62,48,54,63,60,68,355,0.5178571428571429,2.0
75,125,70,125,70,115,580,0.9037037037037037,65,90,115,45,115,58,488,0.5041322314049587,0.0
70,60,62,80,82,60,414,0.4375,40,70,40,35,40,60,285,0.392,1.0
70,85,70,60,70,50,405,0.28378378378378377,150,80,44,90,54,80,498,0.625,0.0
90,100,70,110,150,80,600,0.6037735849056604,65,80,80,59,63,58,405,0.4411764705882353,1.0
60,80,95,70,85,50,440,0.2231404958677686,60,50,100,85,70,65,430,0.47580645161290325,0.5
50,180,20,180,20,150,600,0.9029850746268657,80,100,70,50,60,45,405,0.25806451612903225,1.0
90,132,105,132,105,30,594,0.4246575342465753,65,76,84,54,96,105,480,0.9008264462809917,1.0
60,75,100,55,80,50,420,0.3088235294117647,65,155,120,65,90,105,600,0.8677685950413223,1.0
108,112,118,68,72,47,525,0.2916666666666667,80,100,70,60,70,95,475,0.7416666666666667,0.5
74,48,76,83,81,104,466,0.7322834645669292,95,110,80,70,80,50,485,0.37209302325581395,1.0
70,80,70,80,70,110,480,0.6594202898550725,95,110,80,70,80,50,485,0.37209302325581395,0.5
44,48,65,50,64,43,314,0.1623931623931624,72,60,30,20,30,25,237,0.11570247933884298,1.0
49,49,56,49,61,66,330,0.5190839694656488,20,25,45,70,90,60,310,0.30833333333333335,1.0
60,55,90,145,90,80,520,0.6071428571428571,50,85,85,55,55,50,380,0.3902439024390244,2.0
50,65,64,44,48,43,314,0.2196969696969697,65,125,100,60,70,70,490,0.6099290780141844,1.0
77,85,51,55,51,65,384,0.5163934426229508,100,50,80,60,80,50,420,0.34375,0.5
50,85,85,55,55,50,380,0.3902439024390244,35,60,44,40,54,55,288,0.366412213740458,0.5
60,90,70,60,120,40,440,0.27419354838709675,50,85,85,55,55,50,380,0.3902439024390244,0.5
40,20,30,40,80,55,265,0.22764227642276422,90,55,75,60,75,30,385,0.13970588235294118,1.0
70,85,70,60,70,50,405,0.28378378378378377,30,65,100,45,25,40,305,0.1891891891891892,0.5
70,92,65,80,55,98,460,0.8090909090909091,77,59,50,67,63,46,362,0.23140495867768596,2.0
85,105,100,79,83,78,530,0.5869565217391305,75,100,95,40,70,110,490,0.8717948717948718,1.0
35,40,100,90,55,35,355,0.1796875,100,75,115,90,115,85,580,0.6446280991735537,0.5
85,105,100,79,83,78,530,0.5869565217391305,95,100,85,108,70,70,528,0.5652173913043478,0.5
70,43,53,43,53,40,302,0.19090909090909092,70,110,80,55,80,105,500,0.8794326241134752,1.0
60,75,100,55,80,50,420,0.3088235294117647,100,123,75,57,75,80,510,0.6923076923076923,1.0
55,50,65,175,95,150,590,0.7818181818181819,70,60,70,87,78,85,450,0.6228070175438597,1.0
100,100,100,100,100,100,600,0.831858407079646,40,30,50,55,55,100,330,0.584070796460177,1.0
75,98,63,98,63,101,498,0.889763779527559,50,95,180,85,45,70,525,0.5298507462686567,1.0
62,48,54,63,60,68,355,0.5178571428571429,40,30,30,55,30,85,270,0.4666666666666667,1.0
80,80,80,80,80,80,480,0.6015037593984962,90,65,65,40,40,15,315,0.19672131147540983,0.5
45,35,50,70,50,30,280,0.15753424657534246,95,60,79,100,125,81,540,0.6201550387596899,2.0
100,100,90,150,140,90,670,0.71875,75,105,75,105,75,45,480,0.3274336283185841,0.5
103,93,67,71,61,84,479,0.7142857142857143,78,104,78,159,115,100,634,0.8444444444444444,1.0
100,110,90,85,90,60,535,0.47794117647058826,70,62,67,55,55,56,365,0.38513513513513514,2.0
100,150,90,180,160,90,770,0.7348484848484849,55,50,65,175,95,150,590,0.7818181818181819,1.0
45,60,30,80,50,65,330,0.4603174603174603,40,65,40,80,40,65,330,0.5038167938931297,0.5
135,85,40,40,85,5,390,0.6864406779661016,57,24,86,24,86,23,300,0.12727272727272726,0.5
60,85,69,60,69,77,420,0.518796992481203,40,55,30,30,30,85,270,0.688,1.0
70,80,102,80,102,40,474,0.2677165354330709,40,55,30,30,30,85,270,0.688,0.5
55,75,50,40,40,80,340,0.6302521008403361,70,140,230,60,80,50,630,0.32432432432432434,0.25
103,60,86,60,86,50,445,0.3458646616541353,45,80,100,35,37,28,325,0.3125,0.0
111,83,68,92,82,39,475,0.1774193548387097,95,117,184,44,46,28,514,0.2975206611570248,1.0
45,50,35,55,75,40,300,0.21367521367521367,85,56,77,50,77,78,423,0.53125,1.0
60,48,45,43,90,42,328,0.21897810218978103,72,95,67,103,71,122,530,0.9606299212598425,0.0
80,100,70,50,60,45,405,0.25806451612903225,55,130,115,50,50,75,475,0.5982142857142857,1.0
40,45,40,65,40,65,295,0.5661764705882353,55,50,40,40,40,75,300,0.5945945945945946,1.0
60,80,50,40,40,30,300,0.15328467153284672,35,55,40,50,50,90,320,0.6838235294117647,1.0
45,53,70,40,60,42,310,0.25735294117647056,40,45,40,35,35,56,251,0.373015873015873,0.25
80,100,70,50,60,45,405,0.25806451612903225,55,50,40,40,40,75,300,0.5945945945945946,2.0
50,20,40,20,40,20,190,0.0962962962962963,99,68,83,72,87,51,460,0.417910447761194,1.0
91,90,72,90,129,108,580,0.896,105,30,105,140,105,55,540,0.3524590163934426,0.25
46,87,60,30,40,57,320,0.37777777777777777,45,100,45,45,45,10,290,0.2949640287769784,1.0
115,45,20,45,25,20,270,0.11538461538461539,44,38,39,61,79,42,303,0.2251655629139073,1.0
74,100,72,90,72,46,454,0.24561403508771928,44,50,91,24,86,10,305,0.1981981981981982,0.25
53,54,53,37,46,45,288,0.3090909090909091,38,35,35,65,55,50,278,0.2647058823529412,0.5
105,150,90,150,90,95,680,0.8285714285714286,85,90,80,70,80,130,535,0.9262295081967213,1.0
80,80,50,40,50,25,325,0.176056338028169,75,100,63,80,63,116,497,0.9345794392523364,1.0
80,110,60,150,130,70,600,0.5042016806722689,80,80,80,80,80,80,480,0.6015037593984962,1.0
35,46,34,35,45,20,215,0.072,58,89,77,45,45,48,362,0.3177570093457944,0.5
90,95,105,165,110,45,610,0.2890625,105,125,100,60,100,100,590,0.8359375,1.0
49,55,42,42,37,85,310,0.6068376068376068,45,95,50,40,50,75,355,0.54,0.5
75,75,60,83,60,60,413,0.39344262295081966,59,63,80,65,80,58,405,0.41843971631205673,0.5
40,55,30,30,30,60,245,0.43548387096774194,60,55,50,40,55,45,305,0.22377622377622378,2.0
60,85,42,85,42,91,405,0.8227848101265823,70,70,115,130,90,60,535,0.5338983050847458,0.25
90,100,90,125,85,90,580,0.7352941176470589,100,73,83,73,83,55,467,0.371900826446281,1.0
50,20,55,25,25,30,205,0.09774436090225563,80,110,120,130,90,70,600,0.6198347107438017,0.5
30,42,118,42,88,30,350,0.112,75,75,95,75,95,113,528,0.9015151515151515,1.0
50,72,35,35,35,65,292,0.5373134328358209,44,48,65,50,64,43,314,0.1623931623931624,1.0
95,100,85,108,70,70,528,0.5652173913043478,55,85,122,58,75,99,494,0.8099173553719008,0.5
50,20,40,20,40,20,190,0.0962962962962963,90,132,105,132,105,30,594,0.4246575342465753,1.0
55,70,45,70,50,60,350,0.45,38,35,40,27,25,35,200,0.08208955223880597,2.0
75,140,65,112,65,110,567,0.9140625,70,100,70,105,75,40,460,0.23214285714285715,1.0
50,53,48,53,48,64,316,0.46153846153846156,80,82,78,95,80,85,500,0.6869565217391305,0.5
50,160,110,160,110,110,700,0.8854961832061069,120,70,120,75,130,85,600,0.6694915254237288,1.0
77,85,51,55,51,65,384,0.5163934426229508,85,80,70,135,75,90,535,0.7006802721088435,1.0
190,33,58,33,58,33,405,0.13432835820895522,86,92,88,68,75,73,482,0.6835443037974683,0.0
50,50,150,50,150,50,500,0.2571428571428571,80,105,105,105,105,80,580,0.5939849624060151,1.0
70,55,95,95,110,65,490,0.48872180451127817,65,65,60,110,95,130,525,0.9253731343283582,1.0
75,69,72,114,100,104,534,0.8253968253968254,59,45,40,35,40,31,250,0.14285714285714285,1.0
60,130,80,60,60,70,460,0.5153846153846153,45,30,35,20,20,45,195,0.14782608695652175,0.25
50,50,40,30,30,50,250,0.2781954887218045,76,48,48,57,62,34,325,0.11688311688311688,0.5
44,50,91,24,86,10,305,0.1981981981981982,70,135,105,60,105,20,495,0.5806451612903226,0.125
65,63,45,45,45,45,308,0.2595419847328244,50,53,48,53,48,64,316,0.46153846153846156,0.5
40,55,99,40,79,47,360,0.26262626262626265,160,110,65,65,110,30,540,0.35714285714285715,1.0
60,30,30,36,56,50,262,0.32432432432432434,43,30,55,40,65,97,330,0.6030534351145038,1.0
89,145,90,105,80,91,600,0.8549618320610687,68,72,78,38,42,32,330,0.23809523809523808,1.0
65,90,50,85,45,55,390,0.371900826446281,68,165,95,65,115,110,618,0.8615384615384616,1.0
60,52,168,47,138,30,495,0.19834710743801653,100,150,90,180,160,90,770,0.7348484848484849,0.5
50,160,110,160,110,110,700,0.8854961832061069,49,55,42,42,37,85,310,0.6068376068376068,1.0
100,50,50,76,96,70,442,0.5,76,25,45,67,55,24,292,0.0390625,1.0
60,100,85,80,85,100,510,0.7007874015748031,20,25,45,70,90,60,310,0.30833333333333335,0.125
40,45,40,62,60,60,307,0.33884297520661155,41,56,40,62,44,71,314,0.568,0.5
95,65,110,60,130,65,525,0.5275590551181102,55,85,55,50,55,60,360,0.4233576642335766,1.0
30,35,30,100,35,80,310,0.4765625,65,65,60,110,95,130,525,0.9253731343283582,1.0
75,125,75,30,75,85,465,0.625,80,92,65,65,80,68,450,0.4824561403508772,1.0
70,55,55,80,60,45,365,0.2222222222222222,45,49,65,49,65,45,318,0.275,0.5
70,55,75,45,65,60,370,0.45901639344262296,28,25,25,45,35,40,198,0.16083916083916083,1.0
54,63,52,83,56,97,405,0.7697841726618705,70,62,67,55,55,56,365,0.38513513513513514,1.0
90,95,95,70,90,70,510,0.5230769230769231,44,48,65,50,64,43,314,0.1623931623931624,0.5
70,80,50,35,35,35,305,0.14,60,60,75,60,75,80,410,0.7321428571428571,0.5
91,72,90,129,90,108,580,0.8925619834710744,70,60,75,110,75,90,480,0.7165354330708661,0.5
20,40,90,30,90,25,295,0.11363636363636363,40,30,35,45,40,55,245,0.31496062992125984,1.0
50,50,150,50,150,50,500,0.2571428571428571,55,63,90,50,80,42,380,0.21138211382113822,2.0
55,35,50,55,110,85,390,0.6277372262773723,80,90,80,130,110,110,600,0.856,2.0
60,80,110,50,80,45,425,0.2833333333333333,75,38,38,56,56,67,330,0.5263157894736842,2.0
85,76,64,45,55,90,415,0.6739130434782609,25,20,15,105,55,90,310,0.32407407407407407,1.0
60,85,69,65,79,80,438,0.576,80,115,80,65,55,93,488,0.7846153846153846,1.0
65,50,35,115,95,95,455,0.7333333333333333,40,30,30,55,30,85,270,0.4666666666666667,1.0
68,72,78,38,42,32,330,0.23809523809523808,80,70,70,90,100,70,480,0.5609756097560976,0.5
80,115,80,65,55,93,488,0.7846153846153846,75,80,70,65,75,90,455,0.7578125,1.0
53,51,53,61,56,40,314,0.14285714285714285,95,135,80,110,80,100,600,0.8248175182481752,0.5
75,80,95,90,100,50,490,0.2158273381294964,91,90,129,90,72,108,580,0.9140625,0.5
255,10,10,75,135,55,540,0.3125,60,60,60,35,35,30,280,0.11194029850746269,1.0
60,45,70,45,90,95,405,0.7304964539007093,45,60,30,80,50,65,330,0.4603174603174603,1.0
51,65,65,80,75,59,395,0.4365079365079365,66,41,77,61,87,23,355,0.12096774193548387,2.0
49,49,56,49,61,66,330,0.5190839694656488,45,75,37,70,55,83,365,0.6183206106870229,2.0
75,80,55,25,35,35,305,0.18666666666666668,80,120,79,95,79,70,523,0.5833333333333334,1.0
100,100,100,100,100,100,600,0.8778625954198473,70,43,53,43,53,40,302,0.19090909090909092,2.0
68,90,65,50,55,82,410,0.6165413533834586,120,100,85,30,85,45,465,0.22448979591836735,1.0
50,180,20,180,20,150,600,0.9029850746268657,100,120,120,150,100,90,680,0.7880794701986755,0.5
67,58,57,81,67,101,431,0.8790322580645161,67,125,40,30,30,58,350,0.3431372549019608,1.0
70,70,115,130,90,60,535,0.5338983050847458,55,81,60,50,70,97,413,0.7214285714285714,1.0
150,160,100,95,65,100,670,0.8866666666666667,60,85,69,60,69,77,420,0.518796992481203,1.0
75,75,95,75,95,113,528,0.9015151515151515,55,95,55,35,75,115,430,0.9380530973451328,1.0
70,70,70,70,70,70,420,0.5289256198347108,255,10,10,75,135,55,540,0.3125,1.0
30,42,118,42,88,30,350,0.112,108,130,95,80,85,102,600,0.7637795275590551,0.5
60,75,85,100,85,115,520,0.8992248062015504,110,135,60,50,65,88,508,0.7744360902255639,2.0
85,105,100,79,83,78,530,0.5869565217391305,35,70,55,45,55,25,285,0.09420289855072464,0.5
55,104,105,94,75,52,485,0.36363636363636365,70,60,125,115,70,55,495,0.35507246376811596,1.0
65,130,60,75,60,75,465,0.689922480620155,72,58,80,103,80,97,490,0.7171052631578947,2.0
250,5,5,35,105,50,450,0.15306122448979592,80,120,70,110,70,80,530,0.6422764227642277,1.0
130,65,60,110,95,65,525,0.5227272727272727,110,123,65,100,65,65,528,0.5217391304347826,2.0
45,45,35,20,30,20,195,0.07246376811594203,40,65,40,80,40,65,330,0.5038167938931297,2.0
65,65,60,110,95,130,525,0.9253731343283582,55,50,40,40,40,75,300,0.5945945945945946,1.0
75,69,72,114,100,104,534,0.8253968253968254,45,30,15,85,65,65,305,0.36220472440944884,1.0
80,120,130,55,65,45,495,0.37037037037037035,70,110,70,115,70,90,525,0.75,0.5
55,50,40,40,40,75,300,0.5945945945945946,60,55,50,40,55,45,305,0.22377622377622378,1.0
49,49,56,49,61,66,330,0.5190839694656488,60,79,105,59,85,36,424,0.17054263565891473,2.0
35,20,65,40,65,20,245,0.02459016393442623,255,10,10,75,135,55,540,0.3125,1.0
60,40,60,40,60,35,295,0.18055555555555555,95,75,110,100,80,30,490,0.15267175572519084,2.0
40,27,60,37,50,66,280,0.36220472440944884,60,50,50,60,70,50,340,0.28346456692913385,1.0
80,115,80,65,55,93,488,0.7846153846153846,85,90,80,70,80,130,535,0.9262295081967213,1.0
125,58,58,76,76,67,460,0.515625,66,117,70,40,50,67,410,0.4573643410852713,0.25
70,55,65,95,85,70,440,0.5307692307692308,61,78,95,56,58,57,405,0.40336134453781514,1.0
55,40,85,80,105,40,405,0.23622047244094488,50,95,180,85,45,70,525,0.5298507462686567,1.0
65,125,60,95,60,105,510,0.9236641221374046,65,125,100,55,70,85,500,0.6532258064516129,0.5
60,85,69,60,69,77,420,0.518796992481203,70,83,50,37,50,60,350,0.3360655737704918,1.0
85,110,90,45,90,80,500,0.6206896551724138,75,75,130,75,130,95,580,0.7479674796747967,1.0
20,10,55,15,20,80,200,0.17985611510791366,45,30,15,85,65,65,305,0.36220472440944884,1.0
60,100,89,55,69,112,485,0.9298245614035088,50,65,45,85,65,95,405,0.7238095238095238,4.0
86,68,72,109,66,106,507,0.8099173553719008,65,70,60,65,65,115,440,0.8583333333333333,1.0
100,150,140,100,90,90,670,0.7969924812030075,45,55,39,35,39,42,255,0.18518518518518517,1.0
74,100,72,90,72,46,454,0.24561403508771928,65,95,75,55,55,85,430,0.6933333333333334,1.0
55,40,85,80,105,40,405,0.23622047244094488,70,90,110,60,75,95,500,0.7333333333333333,1.0
35,55,35,30,30,35,220,0.23684210526315788,52,65,50,45,50,38,300,0.27419354838709675,0.5
80,95,82,60,82,75,474,0.6,50,20,55,25,25,30,205,0.09774436090225563,1.0
40,45,40,65,40,65,295,0.5661764705882353,40,30,35,50,70,55,280,0.28205128205128205,0.5
68,75,53,83,113,60,452,0.45384615384615384,100,90,130,45,65,55,485,0.4253731343283582,1.0
90,60,60,40,40,40,330,0.29545454545454547,55,45,43,55,43,72,313,0.5853658536585366,0.0
100,100,125,110,50,50,535,0.384,65,95,57,100,85,93,495,0.7441860465116279,0.5
65,130,60,95,110,65,525,0.5303030303030303,95,155,109,70,130,81,640,0.6788321167883211,0.5
60,85,60,50,50,125,430,0.9090909090909091,72,105,115,54,86,68,500,0.5149253731343284,0.25
20,10,230,10,230,5,505,0.0,130,65,60,110,95,65,525,0.5227272727272727,1.0
69,55,45,55,55,15,294,0.11666666666666667,65,65,60,110,95,130,525,0.9253731343283582,1.0
65,40,50,125,60,30,370,0.07258064516129033,62,55,52,109,94,109,481,0.7833333333333333,1.0
45,55,45,65,45,75,330,0.5692307692307692,130,65,60,110,95,65,525,0.5227272727272727,0.5
45,35,50,70,50,30,280,0.15753424657534246,130,65,60,110,95,65,525,0.5227272727272727,2.0
64,165,75,93,83,75,555,0.6587301587301587,61,72,57,55,55,65,365,0.3984375,1.0
85,110,90,45,90,80,500,0.6206896551724138,100,150,120,120,100,90,680,0.6493506493506493,1.0
72,105,115,54,86,68,500,0.5149253731343284,110,80,90,95,90,65,530,0.5033557046979866,1.0
70,70,40,60,40,60,340,0.4247787610619469,70,55,75,45,65,60,370,0.45901639344262296,0.25
45,67,60,35,50,63,320,0.5128205128205128,110,78,73,76,71,60,468,0.3333333333333333,1.0
108,130,95,80,85,102,600,0.7637795275590551,65,90,120,85,70,60,490,0.43410852713178294,2.0
86,68,72,109,66,106,507,0.8099173553719008,55,45,50,45,65,80,340,0.5546218487394958,2.0
60,105,60,120,60,105,510,0.8849557522123894,75,100,110,45,55,65,450,0.5333333333333333,1.0
35,35,40,35,55,50,250,0.40336134453781514,68,72,78,38,42,32,330,0.23809523809523808,2.0
60,70,65,125,105,90,515,0.6911764705882353,46,87,60,30,40,57,320,0.37777777777777777,0.5
60,30,30,36,56,50,262,0.32432432432432434,60,105,60,120,60,105,510,0.8849557522123894,1.0
70,60,125,115,70,55,495,0.35507246376811596,40,70,40,35,40,60,285,0.392,0.5
78,92,75,74,63,118,500,0.8842975206611571,55,35,50,55,110,85,390,0.6277372262773723,0.5
65,73,55,47,75,85,400,0.6846846846846847,120,70,120,75,130,85,600,0.6694915254237288,2.0
79,115,70,125,80,111,580,0.864,60,60,60,60,60,60,360,0.38095238095238093,1.0
80,100,200,50,100,50,580,0.3472222222222222,45,49,65,49,65,45,318,0.275,1.0
45,35,50,70,50,30,280,0.15753424657534246,55,65,95,95,45,85,440,0.6610169491525424,2.0
48,72,48,72,48,48,336,0.25984251968503935,40,55,80,35,60,30,300,0.15037593984962405,0.25
65,90,65,61,61,100,442,0.8373983739837398,70,95,85,55,65,70,440,0.5,0.25
100,100,100,100,100,100,600,0.8602941176470589,44,58,44,58,44,61,309,0.41964285714285715,0.5
65,60,70,85,75,40,395,0.1796875,75,80,85,110,90,50,490,0.3548387096774194,1.0
75,55,70,55,95,110,460,0.8444444444444444,68,75,53,83,113,60,452,0.45384615384615384,0.5
43,30,55,40,65,97,330,0.6030534351145038,49,55,42,42,37,85,310,0.6068376068376068,1.0
50,65,107,105,107,86,520,0.7758620689655172,82,80,86,85,75,72,480,0.6183206106870229,1.0
55,66,44,44,56,85,350,0.6888888888888889,44,48,65,50,64,43,314,0.1623931623931624,1.0
70,150,140,65,100,75,600,0.55,38,36,38,32,36,57,237,0.3893805309734513,1.0
60,75,85,100,85,115,520,0.8992248062015504,80,80,90,110,130,110,600,0.8721804511278195,0.25
55,45,43,55,43,72,313,0.5853658536585366,100,90,130,45,65,55,485,0.4253731343283582,0.5
90,95,105,165,110,45,610,0.2890625,75,100,110,45,55,65,450,0.5333333333333333,0.0
55,45,43,55,43,72,313,0.5853658536585366,46,87,60,30,40,57,320,0.37777777777777777,1.0
45,22,60,27,30,29,213,0.07518796992481203,49,49,56,49,61,66,330,0.5190839694656488,1.0
100,180,160,150,90,90,770,0.7520661157024794,60,60,50,40,50,75,335,0.5882352941176471,1.0
115,45,20,45,25,20,270,0.11538461538461539,50,65,107,105,107,86,520,0.7758620689655172,1.0
53,54,53,37,46,45,288,0.3090909090909091,63,60,55,50,50,71,349,0.5289256198347108,1.0
75,125,75,30,75,85,465,0.625,71,82,64,64,59,112,452,0.9327731092436975,2.0
50,50,40,30,30,50,250,0.2781954887218045,40,30,35,45,40,55,245,0.31496062992125984,0.0
50,50,77,95,77,91,440,0.5916666666666667,70,90,70,60,60,70,420,0.6390977443609023,0.5
73,95,62,85,65,85,465,0.6666666666666666,75,69,72,114,100,104,534,0.8253968253968254,1.0
90,55,75,60,75,30,385,0.13970588235294118,95,124,78,69,71,58,495,0.37398373983739835,1.0
95,100,85,108,70,70,528,0.5652173913043478,40,65,40,80,40,65,330,0.5038167938931297,1.0
70,55,75,45,65,60,370,0.45901639344262296,50,50,50,50,50,50,300,0.30708661417322836,1.0
55,45,43,55,43,72,313,0.5853658536585366,65,75,90,97,123,44,494,0.1987179487179487,2.0
58,109,112,48,48,109,484,0.8805970149253731,67,89,116,79,116,33,500,0.2624113475177305,0.5
95,95,85,125,65,55,520,0.3894736842105263,65,110,130,60,65,95,525,0.8278145695364238,0.5
95,125,79,60,100,81,540,0.6165413533834586,90,70,80,70,95,70,475,0.5190839694656488,0.5
73,100,60,100,60,65,458,0.42657342657342656,70,130,100,55,80,65,500,0.608,0.0
80,100,80,80,80,100,520,0.9051724137931034,50,105,79,35,110,76,455,0.6214285714285714,1.0
65,125,60,95,60,105,510,0.9236641221374046,46,87,60,30,40,57,320,0.37777777777777777,1.0
90,93,55,70,55,55,418,0.3819444444444444,40,50,45,70,45,70,320,0.5517241379310345,0.25
55,63,90,50,80,42,380,0.21138211382113822,120,70,120,75,130,85,600,0.6694915254237288,2.0
78,70,61,50,61,100,420,0.8145161290322581,100,75,115,90,115,85,580,0.6446280991735537,1.0
55,50,45,135,95,120,500,0.7714285714285715,106,190,100,154,100,130,780,0.9259259259259259,0.5
104,91,63,91,73,68,490,0.5118110236220472,55,85,55,50,55,60,360,0.4233576642335766,1.0
100,150,140,100,90,90,670,0.7969924812030075,61,90,45,50,50,160,456,0.9230769230769231,0.0
91,72,90,129,90,108,580,0.8925619834710744,65,65,65,50,50,90,385,0.72,0.5
105,105,75,65,100,50,500,0.37593984962406013,100,110,90,85,90,60,535,0.47794117647058826,0.5
60,100,89,55,69,112,485,0.9298245614035088,80,160,80,130,80,100,630,0.8455284552845529,0.25
80,135,130,95,90,70,600,0.5181818181818182,65,75,70,95,70,95,470,0.7272727272727273,0.5
75,80,55,25,35,35,305,0.18666666666666668,95,155,109,70,130,81,640,0.6788321167883211,2.0
76,104,71,104,71,108,534,0.912751677852349,55,65,95,95,45,85,440,0.6610169491525424,0.5
60,95,80,60,80,30,405,0.19480519480519481,45,60,45,25,45,55,275,0.29,1.0
100,100,125,110,50,50,535,0.384,50,75,75,65,65,50,380,0.4049586776859504,1.0
100,103,75,120,75,127,600,0.940677966101695,70,80,70,80,70,110,480,0.6594202898550725,1.0
75,125,70,125,70,115,580,0.9037037037037037,70,92,65,80,55,98,460,0.8090909090909091,1.0
85,135,130,60,80,25,515,0.40540540540540543,64,78,52,78,52,81,405,0.6422764227642277,1.0
60,80,50,50,50,40,330,0.23853211009174313,45,50,55,75,65,30,320,0.06293706293706294,1.0
85,56,77,50,77,78,423,0.53125,84,86,88,111,101,60,530,0.4634146341463415,1.0
62,48,66,59,57,49,341,0.33884297520661155,75,100,95,40,70,110,490,0.8717948717948718,1.0
100,128,90,77,77,128,600,0.959349593495935,50,60,60,60,60,30,320,0.11290322580645161,0.5
20,40,90,30,90,25,295,0.11363636363636363,60,75,85,100,85,115,520,0.8992248062015504,2.0
70,140,230,60,80,50,630,0.32432432432432434,105,140,55,30,55,95,480,0.8195488721804511,0.5
60,55,90,145,90,80,520,0.6071428571428571,54,66,70,44,55,46,335,0.4214876033057851,4.0
90,65,65,40,40,15,315,0.19672131147540983,85,105,100,79,83,78,530,0.5869565217391305,0.5
60,25,35,70,80,60,330,0.3076923076923077,95,145,130,120,90,120,700,0.9398496240601504,1.0
50,64,50,45,50,41,300,0.22727272727272727,58,70,45,40,45,42,300,0.25925925925925924,0.5
41,56,40,62,44,71,314,0.568,59,63,80,65,80,58,405,0.41843971631205673,0.5
100,150,120,120,100,90,680,0.6493506493506493,45,65,34,40,34,45,263,0.2589928057553957,0.5
55,20,35,20,45,75,250,0.37681159420289856,41,64,45,50,50,50,300,0.36752136752136755,1.0
70,100,115,30,65,30,410,0.24390243902439024,79,85,60,55,60,71,410,0.60431654676259,1.0
108,130,95,80,85,102,600,0.7637795275590551,82,80,86,85,75,72,480,0.6183206106870229,0.0
70,120,40,95,40,95,460,0.8106060606060606,106,150,70,194,120,140,780,0.952,2.0
44,48,65,50,64,43,314,0.1623931623931624,50,50,40,50,40,64,294,0.45588235294117646,0.5
110,123,65,100,65,65,528,0.5217391304347826,75,75,95,75,95,113,528,0.9015151515151515,2.0
65,130,60,75,60,75,465,0.689922480620155,74,48,76,83,81,104,466,0.7913043478260869,2.0
65,85,70,75,70,40,405,0.203125,60,60,40,65,45,35,305,0.15833333333333333,0.0
65,155,120,65,90,105,600,0.8677685950413223,30,65,100,45,25,40,305,0.1891891891891892,1.0
70,130,100,55,80,65,500,0.608,66,41,77,61,87,23,355,0.12096774193548387,4.0
43,30,55,40,65,97,330,0.6030534351145038,35,80,50,50,70,120,405,0.84375,2.0
70,140,70,110,65,105,560,0.95,55,81,60,50,70,97,413,0.7214285714285714,1.0
70,135,105,60,105,20,495,0.5806451612903226,55,35,50,55,110,85,390,0.6277372262773723,0.5
71,73,88,120,89,59,500,0.43537414965986393,74,100,72,90,72,46,454,0.24561403508771928,0.5
95,125,79,60,100,81,540,0.6165413533834586,60,79,105,59,85,36,424,0.17054263565891473,4.0
80,105,65,60,75,130,515,0.9645390070921985,55,50,45,135,95,120,500,0.7714285714285715,1.0
103,60,86,60,86,50,445,0.3458646616541353,55,70,40,60,40,40,305,0.26956521739130435,1.0
70,60,125,115,70,55,495,0.35507246376811596,100,120,120,150,100,90,680,0.7880794701986755,0.25
67,89,116,79,116,33,500,0.2624113475177305,78,52,60,63,65,23,341,0.06015037593984962,0.5
89,145,90,105,80,91,600,0.8549618320610687,65,90,50,85,45,55,390,0.371900826446281,2.0
25,35,70,95,55,45,325,0.16783216783216784,62,48,66,59,57,49,341,0.33884297520661155,0.5
95,117,80,65,70,92,519,0.8409090909090909,70,55,95,95,110,65,490,0.48872180451127817,2.0
91,90,72,90,129,108,580,0.896,75,100,110,45,55,65,450,0.5333333333333333,2.0
85,80,90,105,95,60,515,0.49074074074074076,50,40,85,40,65,25,305,0.08870967741935484,1.0
45,65,34,40,34,45,263,0.2589928057553957,80,70,65,80,120,100,515,0.8034188034188035,2.0
60,100,85,80,85,100,510,0.7007874015748031,70,105,105,50,40,20,390,0.33587786259541985,2.0
45,22,60,27,30,29,213,0.07518796992481203,46,57,40,40,40,50,273,0.25,0.5
50,120,53,35,110,87,455,0.640625,50,35,55,25,25,15,205,0.05263157894736842,0.5
75,69,72,114,100,104,534,0.8253968253968254,50,75,75,65,65,50,380,0.4049586776859504,0.0
50,65,45,85,65,95,405,0.7238095238095238,35,60,44,40,54,55,288,0.366412213740458,0.5
80,125,75,40,95,85,500,0.6911764705882353,65,125,100,60,70,70,490,0.6099290780141844,4.0
50,120,53,35,110,87,455,0.640625,80,80,90,110,130,110,600,0.8721804511278195,0.5
68,90,65,50,55,82,410,0.6165413533834586,72,58,80,103,80,97,490,0.7171052631578947,0.0
55,66,44,44,56,85,350,0.6888888888888889,75,105,75,105,75,45,480,0.3274336283185841,1.0
60,50,70,80,80,140,480,0.8449612403100775,85,56,77,50,77,78,423,0.53125,0.0
100,150,140,100,90,90,670,0.7969924812030075,35,85,45,35,35,75,310,0.6492537313432836,0.0
50,53,62,58,63,44,330,0.13709677419354838,40,30,30,55,30,85,270,0.4666666666666667,0.5
60,85,69,60,69,77,420,0.518796992481203,60,115,105,65,70,80,495,0.7181818181818181,0.5
62,48,54,63,60,68,355,0.5178571428571429,85,110,76,65,82,56,474,0.3933333333333333,1.0
70,90,110,60,75,95,500,0.7333333333333333,100,100,100,100,100,100,600,0.8758169934640523,0.0
60,45,70,75,85,55,390,0.3008130081300813,20,25,45,70,90,60,310,0.30833333333333335,0.5
77,85,51,55,51,65,384,0.5163934426229508,150,160,100,95,65,100,670,0.8866666666666667,1.0
60,110,70,60,60,100,460,0.8461538461538461,58,109,112,48,48,109,484,0.8805970149253731,0.5
55,85,122,58,75,99,494,0.8099173553719008,40,40,55,40,70,55,300,0.40939597315436244,4.0
80,50,100,100,200,50,580,0.2357142857142857,40,65,40,80,40,65,330,0.5038167938931297,1.0
40,29,45,29,45,36,224,0.14634146341463414,70,140,70,110,65,105,560,0.95,2.0
40,70,40,35,40,60,285,0.392,75,75,60,83,60,60,413,0.39344262295081966,1.0
110,135,60,50,65,88,508,0.7744360902255639,45,30,40,105,50,20,290,0.031007751937984496,1.0
60,65,70,85,75,40,395,0.21705426356589147,61,78,95,56,58,57,405,0.40336134453781514,1.0
59,63,80,65,80,58,405,0.41843971631205673,40,30,50,55,55,100,330,0.584070796460177,1.0
75,95,122,58,75,69,494,0.5725806451612904,65,75,90,97,123,44,494,0.1987179487179487,0.25
115,115,85,90,75,100,580,0.8134328358208955,45,60,30,80,50,65,330,0.4603174603174603,0.5
60,50,70,80,80,140,480,0.8449612403100775,75,80,55,25,35,35,305,0.18666666666666668,1.0
75,75,75,125,95,40,485,0.15671641791044777,150,120,100,120,100,90,680,0.664179104477612,1.0
60,45,70,45,90,95,405,0.7304964539007093,80,120,70,110,70,80,530,0.6422764227642277,1.0
110,130,80,70,60,80,530,0.5862068965517241,90,132,105,132,105,30,594,0.4246575342465753,0.5
50,70,50,50,50,40,310,0.16296296296296298,100,150,140,100,90,90,670,0.7969924812030075,2.0
91,72,90,129,90,108,580,0.8925619834710744,50,53,48,53,48,64,316,0.358974358974359,0.5
40,80,35,35,45,70,305,0.4661016949152542,49,49,56,49,61,66,330,0.5190839694656488,1.0
70,90,70,60,60,70,420,0.6390977443609023,60,75,85,100,85,115,520,0.8992248062015504,2.0
45,55,39,35,39,42,255,0.18518518518518517,58,109,112,48,48,109,484,0.8805970149253731,0.5
65,50,35,115,95,95,455,0.7333333333333333,59,59,58,90,70,73,409,0.5826086956521739,0.5
76,65,45,92,42,91,411,0.7449664429530202,90,75,85,115,90,55,510,0.3445378151260504,0.5
50,35,55,25,25,15,205,0.05263157894736842,90,95,95,70,90,70,510,0.5230769230769231,0.5
85,56,77,50,77,78,423,0.53125,90,95,95,70,90,70,510,0.5230769230769231,1.0
106,190,100,154,100,130,780,0.9259259259259259,70,120,100,145,105,20,560,0.2824427480916031,2.0
80,50,100,100,200,50,580,0.2357142857142857,85,120,70,50,60,100,485,0.8308823529411765,2.0
65,50,35,115,95,95,455,0.7333333333333333,65,40,50,125,60,30,370,0.07258064516129033,0.5
90,70,80,70,95,70,475,0.5190839694656488,90,120,120,60,60,50,500,0.35294117647058826,4.0
49,55,42,42,37,85,310,0.6068376068376068,67,82,62,46,48,43,348,0.22033898305084745,1.0
160,110,65,65,110,30,540,0.35714285714285715,60,60,40,65,45,35,305,0.15833333333333333,1.0
55,70,45,70,50,60,350,0.45,60,62,50,62,60,40,334,0.18181818181818182,4.0
60,50,150,50,150,60,520,0.5206611570247934,74,48,76,83,81,104,466,0.7322834645669292,2.0
75,125,75,30,75,85,465,0.625,35,20,65,40,65,20,245,0.02459016393442623,0.5
55,66,44,44,56,85,350,0.6888888888888889,66,117,70,40,50,67,410,0.4573643410852713,1.0
46,87,60,30,40,57,320,0.37777777777777777,55,55,55,85,55,30,335,0.1320754716981132,1.0
45,60,30,80,50,65,330,0.4603174603174603,60,90,70,60,120,40,440,0.27419354838709675,1.0
66,117,70,40,50,67,410,0.4573643410852713,35,46,34,35,45,20,215,0.072,1.0
75,80,95,90,100,50,490,0.2158273381294964,65,50,35,115,95,95,455,0.7333333333333333,1.0
45,60,30,80,50,65,330,0.4603174603174603,114,85,70,85,80,30,464,0.2066115702479339,2.0
70,100,115,30,65,30,410,0.24390243902439024,60,45,70,75,85,55,390,0.3008130081300813,1.0
50,65,107,105,107,86,520,0.7758620689655172,65,76,84,54,96,105,480,0.9008264462809917,1.0
45,75,37,70,55,83,365,0.6183206106870229,60,85,60,85,60,55,405,0.3673469387755102,0.5
80,80,80,80,80,80,480,0.5606060606060606,55,47,52,40,40,41,275,0.16806722689075632,1.0
75,98,63,98,63,101,498,0.849624060150376,45,53,70,40,60,42,310,0.25735294117647056,0.5
75,110,110,110,105,80,590,0.656934306569343,70,55,75,45,65,60,370,0.45901639344262296,2.0
70,85,70,60,70,50,405,0.28378378378378377,50,65,64,44,48,43,314,0.2196969696969697,0.5
60,40,50,75,85,95,405,0.6044776119402985,60,90,55,90,80,110,485,0.8677685950413223,0.5
109,66,84,81,99,32,471,0.2013888888888889,150,100,120,100,120,90,680,0.6666666666666666,0.5
38,30,85,55,65,30,303,0.21428571428571427,80,160,60,170,130,80,680,0.6180555555555556,1.0
59,110,150,45,49,35,448,0.3333333333333333,79,85,60,55,60,71,410,0.60431654676259,0.0
70,83,50,37,50,60,350,0.3360655737704918,60,45,70,45,90,95,405,0.7304964539007093,0.5
40,50,90,30,55,65,330,0.44680851063829785,40,55,99,40,79,47,360,0.26262626262626265,0.25
78,52,60,63,65,23,341,0.06015037593984962,67,57,55,77,55,114,425,0.8879310344827587,1.0
70,80,102,80,102,40,474,0.2677165354330709,60,100,115,70,85,90,520,0.7557251908396947,0.25
40,45,40,65,40,65,295,0.5661764705882353,65,75,105,35,65,85,430,0.6940298507462687,0.0
80,135,85,70,95,150,615,0.9844961240310077,65,65,60,130,95,110,525,0.823943661971831,1.0
110,85,95,80,95,50,515,0.2713178294573643,55,47,52,40,40,41,275,0.16806722689075632,1.0
50,160,110,160,110,110,700,0.8854961832061069,65,55,115,100,40,60,435,0.3798449612403101,1.0
55,55,85,65,85,35,380,0.2014388489208633,73,100,60,100,60,65,458,0.42657342657342656,1.0
70,120,40,95,40,95,460,0.8106060606060606,48,61,40,61,40,50,300,0.2543859649122807,0.5
60,48,45,43,90,42,328,0.21897810218978103,80,80,80,80,80,80,480,0.6015037593984962,1.0
80,130,100,160,120,110,700,0.8981481481481481,65,110,130,60,65,95,525,0.8278145695364238,1.0
35,46,34,35,45,20,215,0.072,105,130,120,45,45,40,485,0.4444444444444444,0.5
52,65,50,45,50,38,300,0.27419354838709675,50,160,110,160,110,110,700,0.8854961832061069,0.0
70,150,140,65,100,75,600,0.55,55,55,55,85,55,30,335,0.1320754716981132,2.0
70,115,60,115,60,55,475,0.4647887323943662,65,85,70,75,70,40,405,0.203125,1.0
60,50,70,80,80,140,480,0.8449612403100775,110,80,90,95,90,65,530,0.5033557046979866,2.0
60,50,40,85,75,95,405,0.7540983606557377,44,75,35,63,33,45,295,0.2647058823529412,1.0
85,80,90,105,95,60,515,0.49074074074074076,75,105,75,105,75,45,480,0.3274336283185841,1.0
79,100,80,110,90,121,580,0.968,61,78,95,56,58,57,405,0.40336134453781514,2.0
73,76,75,81,100,100,505,0.8110236220472441,50,55,50,36,30,43,264,0.2922077922077922,1.0
45,85,50,55,50,65,350,0.5076923076923077,71,95,85,110,95,79,535,0.664,2.0
65,95,57,100,85,93,495,0.7441860465116279,108,130,95,80,85,102,600,0.7637795275590551,0.5
55,50,45,135,95,120,500,0.7714285714285715,50,65,85,35,35,55,325,0.32575757575757575,1.0
83,80,75,70,70,101,479,0.8615384615384616,80,82,100,83,100,80,525,0.6821705426356589,2.0
60,70,65,125,105,90,515,0.6911764705882353,55,55,45,63,45,45,308,0.25,2.0
88,107,122,74,75,64,530,0.4596774193548387,55,68,64,45,55,31,318,0.11666666666666667,0.5
40,30,32,50,52,65,269,0.3671875,70,55,75,45,65,60,370,0.45901639344262296,1.0
82,121,119,69,59,71,521,0.5394736842105263,44,38,39,61,79,42,303,0.2251655629139073,0.0
60,40,80,60,45,40,325,0.23529411764705882,28,25,25,45,35,40,198,0.16083916083916083,0.5
50,105,79,35,110,76,455,0.6214285714285714,70,110,80,55,80,105,500,0.8794326241134752,0.25
40,55,80,35,60,30,300,0.15037593984962405,50,85,85,55,55,50,380,0.3902439024390244,0.125
55,50,40,40,40,75,300,0.5945945945945946,50,47,50,57,50,65,319,0.463768115942029,1.0
55,81,60,50,70,97,413,0.7214285714285714,57,80,91,80,87,75,470,0.5737704918032787,0.5
74,48,76,83,81,104,466,0.7913043478260869,60,70,50,100,50,65,395,0.5217391304347826,1.0
55,75,85,25,25,15,280,0.1875,85,105,100,79,83,78,530,0.5869565217391305,1.0
89,125,90,115,80,101,600,0.8725490196078431,100,123,75,57,75,80,510,0.6923076923076923,0.0
74,108,133,83,65,32,495,0.32142857142857145,58,50,145,95,105,30,483,0.2459016393442623,1.0
60,50,70,80,80,140,480,0.8449612403100775,40,55,30,30,30,85,270,0.688,2.0
35,46,34,35,45,20,215,0.072,95,65,110,60,130,65,525,0.5275590551181102,1.0
60,50,70,50,90,65,385,0.39568345323741005,95,125,79,60,100,81,540,0.6165413533834586,0.5
105,140,55,30,55,95,480,0.8195488721804511,95,125,79,60,100,81,540,0.6165413533834586,0.5
100,100,100,100,100,100,600,0.8805970149253731,83,80,80,135,80,121,579,0.9444444444444444,1.0
60,60,60,85,85,85,435,0.631578947368421,77,85,51,55,51,65,384,0.5163934426229508,1.0
78,65,68,112,154,75,552,0.628099173553719,74,100,72,90,72,46,454,0.24561403508771928,1.0
100,180,160,150,90,90,770,0.7520661157024794,53,54,53,37,46,45,288,0.3090909090909091,1.0
66,65,48,62,57,52,350,0.36220472440944884,50,45,45,35,35,50,260,0.23529411764705882,1.0
65,110,130,60,65,95,525,0.8278145695364238,85,110,76,65,82,56,474,0.3933333333333333,0.5
45,30,40,105,50,20,290,0.031007751937984496,100,150,110,95,110,70,635,0.5923076923076923,2.0
78,84,78,109,85,100,534,0.8646616541353384,89,125,90,115,80,101,600,0.8725490196078431,1.0
74,48,76,83,81,104,466,0.7322834645669292,70,90,70,60,60,70,420,0.6390977443609023,0.0
90,50,34,60,44,70,348,0.6283185840707964,95,125,79,60,100,81,540,0.6165413533834586,1.0
50,85,85,55,55,50,380,0.3902439024390244,60,50,70,80,80,140,480,0.8449612403100775,0.5
90,120,100,150,120,100,680,0.7718120805369127,126,131,95,131,98,99,680,0.8294573643410853,0.0
85,60,65,135,105,100,550,0.7518248175182481,79,115,70,125,80,111,580,0.864,0.5
100,123,75,57,75,80,510,0.6923076923076923,90,92,87,75,85,76,505,0.5409836065573771,1.0
60,25,35,70,80,60,330,0.3076923076923077,45,65,34,40,34,45,263,0.2589928057553957,1.0
30,40,55,40,55,60,280,0.3237410071942446,40,55,30,30,30,85,270,0.688,1.0
70,70,40,60,40,60,340,0.4247787610619469,64,66,68,81,76,50,405,0.25190839694656486,2.0
70,70,115,130,90,60,535,0.5338983050847458,92,105,90,125,90,98,600,0.8217054263565892,0.5
60,150,50,150,50,60,520,0.5,72,85,70,65,70,58,420,0.41304347826086957,0.5
86,76,86,116,56,95,515,0.7982456140350878,40,40,40,70,40,20,250,0.032520325203252036,0.5
55,85,122,58,75,99,494,0.8099173553719008,60,85,40,30,45,68,328,0.6422018348623854,2.0
49,66,70,44,55,51,335,0.4260869565217391,75,85,200,55,65,30,510,0.16778523489932887,1.0
70,110,180,60,60,50,530,0.4117647058823529,60,65,80,170,95,130,600,0.8625954198473282,1.0
100,134,110,95,100,61,600,0.4057971014492754,85,90,80,70,80,130,535,0.9262295081967213,2.0
55,55,85,65,85,35,380,0.2014388489208633,90,120,120,60,60,50,500,0.35294117647058826,1.0
115,115,85,90,75,100,580,0.8134328358208955,39,52,43,60,50,65,309,0.49107142857142855,0.5
58,64,58,80,65,80,405,0.609271523178808,103,60,126,80,126,50,545,0.36363636363636365,1.0
76,104,71,104,71,108,534,0.912751677852349,85,120,70,50,60,100,485,0.8308823529411765,1.0
35,65,35,65,35,65,300,0.46621621621621623,75,89,85,55,65,36,405,0.29545454545454547,0.5
78,52,60,63,65,23,341,0.06015037593984962,90,100,70,110,150,80,600,0.6037735849056604,2.0
74,94,131,54,116,20,489,0.4485294117647059,55,70,45,70,50,60,350,0.45,0.25
62,73,55,56,52,84,382,0.7244094488188977,85,110,76,65,82,56,474,0.3933333333333333,4.0
75,140,65,112,65,110,567,0.9140625,55,68,64,45,55,31,318,0.11666666666666667,2.0
150,100,120,100,120,90,680,0.6666666666666666,45,40,60,40,75,50,310,0.2926829268292683,0.0
110,160,110,80,110,100,670,0.8591549295774648,55,112,45,74,45,70,401,0.559322033898305,0.5
50,53,48,53,48,64,316,0.4076923076923077,120,70,120,75,130,85,600,0.6694915254237288,1.0
70,43,53,43,53,40,302,0.19090909090909092,70,60,75,110,75,90,480,0.7165354330708661,2.0
95,60,79,100,125,81,540,0.6201550387596899,50,85,125,85,115,20,480,0.4306569343065693,1.0
50,50,50,50,50,50,300,0.30708661417322836,35,46,34,35,45,20,215,0.072,1.0
76,65,45,92,42,91,411,0.7449664429530202,255,10,10,75,135,55,540,0.3125,1.0
42,52,67,39,56,50,306,0.2868217054263566,90,90,85,125,90,100,580,0.768595041322314,2.0
53,51,53,61,56,40,314,0.14285714285714285,105,140,95,55,65,45,505,0.3,1.0
85,56,77,50,77,78,423,0.53125,30,30,42,30,42,70,244,0.4230769230769231,0.0
110,85,95,80,95,50,515,0.2713178294573643,70,70,40,60,40,60,340,0.4247787610619469,1.0
70,55,65,95,85,70,440,0.5307692307692308,50,105,125,55,95,50,480,0.375886524822695,0.25
50,40,85,40,65,25,305,0.08870967741935484,85,110,90,45,90,80,500,0.6206896551724138,1.0
75,75,75,125,95,40,485,0.15671641791044777,70,90,70,60,60,70,420,0.6390977443609023,0.0
71,82,64,64,59,112,452,0.9327731092436975,75,110,110,110,105,80,590,0.656934306569343,1.0
65,130,60,75,60,75,465,0.689922480620155,70,75,80,135,80,135,575,0.917910447761194,1.0
75,75,75,125,95,40,485,0.15671641791044777,70,90,45,15,45,50,315,0.3629032258064516,1.0
80,75,150,75,150,50,580,0.30973451327433627,50,50,50,50,50,50,300,0.30708661417322836,2.0
70,110,180,60,60,50,530,0.4117647058823529,80,135,130,95,90,70,600,0.5181818181818182,0.25
108,112,118,68,72,47,525,0.2916666666666667,60,62,80,63,80,60,405,0.4336283185840708,0.5
55,75,60,75,60,103,428,0.7982456140350878,68,165,95,65,115,110,618,0.8615384615384616,2.0
75,70,90,70,105,80,490,0.656,53,51,53,61,56,40,314,0.14285714285714285,1.0
50,65,107,105,107,86,520,0.703125,75,55,70,55,95,110,460,0.8444444444444444,4.0
40,55,99,40,79,47,360,0.26262626262626265,85,110,90,45,90,80,500,0.6206896551724138,1.0
54,45,47,75,98,52,371,0.39669421487603307,50,75,70,35,70,48,348,0.29357798165137616,4.0
35,70,55,45,55,25,285,0.09420289855072464,116,55,85,107,95,29,487,0.06818181818181818,2.0
75,80,85,110,90,50,490,0.3548387096774194,70,150,140,65,100,75,600,0.55,0.0
65,40,50,125,60,30,370,0.07258064516129033,45,55,45,65,45,75,330,0.5692307692307692,1.0
70,92,65,80,55,98,460,0.8090909090909091,70,115,60,115,60,55,475,0.4647887323943662,0.5
50,70,50,50,50,40,310,0.16296296296296298,39,52,43,60,50,65,309,0.5041322314049587,2.0
40,30,32,50,52,65,269,0.3671875,70,145,88,140,70,112,625,0.8888888888888888,0.25
41,64,45,50,50,50,300,0.36752136752136755,110,65,75,125,85,30,490,0.15,1.0
60,90,140,50,50,40,430,0.2535211267605634,75,100,95,40,70,110,490,0.8717948717948718,1.0
85,100,122,58,75,54,494,0.3939393939393939,60,60,75,60,75,80,410,0.7321428571428571,2.0
38,35,40,27,25,35,200,0.08208955223880597,100,77,77,128,128,90,600,0.6901408450704225,2.0
67,89,116,79,116,33,500,0.2624113475177305,20,10,55,15,20,80,200,0.17985611510791366,0.5
100,70,70,65,65,45,415,0.1897810218978102,70,50,30,95,135,105,485,0.8040540540540541,1.0
60,80,110,50,80,45,425,0.2833333333333333,55,40,50,65,85,40,335,0.3181818181818182,1.0
100,120,100,150,120,90,680,0.728,65,80,65,35,65,60,370,0.38405797101449274,1.0
65,105,60,60,70,95,455,63.0,55,85,122,58,75,99,494,0.8099173553719008,0.0
50,25,28,45,55,15,218,0.0625,70,100,115,30,65,30,410,0.24390243902439024,1.0
80,80,80,80,80,80,480,0.5606060606060606,104,91,63,91,73,68,490,0.5118110236220472,1.0
75,100,110,45,55,65,450,0.5333333333333333,80,185,115,40,105,75,600,0.6230769230769231,0.5
40,80,100,30,30,20,300,0.11851851851851852,90,120,120,60,60,50,500,0.35294117647058826,0.5
50,47,50,57,50,65,319,0.463768115942029,70,75,60,105,60,105,475,0.88,0.5
70,94,50,94,50,66,424,0.48148148148148145,54,63,52,83,56,97,405,0.7697841726618705,1.0
55,40,85,80,105,40,405,0.23622047244094488,63,60,55,50,50,71,349,0.5289256198347108,1.0
68,125,65,65,115,80,518,0.6277372262773723,80,92,65,65,80,68,450,0.4824561403508772,1.0
75,85,200,55,65,30,510,0.16778523489932887,95,117,80,65,70,92,519,0.8409090909090909,1.0
65,80,65,35,65,60,370,0.38405797101449274,50,75,70,35,70,48,348,0.29357798165137616,1.0
74,100,72,90,72,46,454,0.24561403508771928,80,70,65,80,120,100,515,0.8034188034188035,1.0
77,120,90,60,90,48,485,0.2785714285714286,105,125,100,60,100,100,590,0.8359375,1.0
105,125,100,60,100,100,590,0.8359375,66,65,48,62,57,52,350,0.36220472440944884,1.0
60,70,105,70,120,75,500,0.5983606557377049,80,82,78,95,80,85,500,0.6869565217391305,1.0
43,70,48,50,60,38,309,0.2391304347826087,48,72,48,72,48,48,336,0.25984251968503935,2.0
75,65,55,65,55,69,384,0.43548387096774194,95,75,80,100,110,30,490,0.24242424242424243,0.5
79,115,70,125,80,111,580,0.864,60,60,75,60,75,80,410,0.7321428571428571,2.0
79,103,120,135,115,78,630,0.5763888888888888,75,80,95,90,100,50,490,0.2158273381294964,0.5
40,45,35,40,40,90,290,0.65,64,115,65,83,63,65,455,0.5323741007194245,0.0
50,47,50,57,50,65,319,0.463768115942029,63,120,85,90,55,55,468,0.2809917355371901,4.0
70,85,65,105,85,120,530,0.9262295081967213,65,80,80,59,63,58,405,0.4411764705882353,2.0
75,55,70,55,95,110,460,0.8444444444444444,70,60,62,80,82,60,414,0.4375,0.5
45,25,50,25,25,35,205,0.13076923076923078,54,78,103,53,45,22,355,0.23255813953488372,0.5
70,75,60,105,60,105,475,0.88,60,90,140,50,50,40,430,0.2535211267605634,1.0
70,120,100,145,105,20,560,0.2824427480916031,79,103,120,135,115,78,630,0.5763888888888888,0.5
70,90,110,60,75,95,500,0.7333333333333333,45,55,45,65,45,75,330,0.5692307692307692,1.0
70,110,70,115,70,90,525,0.75,80,135,85,70,95,150,615,0.9844961240310077,2.0
90,85,100,95,125,85,580,0.6834532374100719,50,50,40,30,30,50,250,0.2781954887218045,1.0
90,70,80,70,95,70,475,0.5190839694656488,95,135,80,110,80,100,600,0.8248175182481752,2.0
40,30,50,55,55,100,330,0.584070796460177,60,55,50,40,55,45,305,0.22377622377622378,1.0
57,24,86,24,86,23,300,0.12727272727272726,40,60,40,40,40,30,250,0.0948905109489051,2.0
60,85,42,85,42,91,405,0.8227848101265823,105,140,55,30,55,95,480,0.8195488721804511,1.0
70,94,50,94,50,66,424,0.48148148148148145,55,40,40,65,45,35,280,0.16428571428571428,0.5
100,77,77,128,128,90,600,0.6901408450704225,50,95,95,35,110,70,455,0.5179856115107914,1.0
80,125,75,40,95,85,500,0.6911764705882353,101,72,72,99,89,29,462,0.1937984496124031,0.25
80,105,65,60,75,130,515,0.9645390070921985,60,69,95,69,95,36,424,0.2608695652173913,1.0
50,55,50,36,30,43,264,0.2922077922077922,40,30,35,45,40,55,245,0.31496062992125984,1.0
45,63,37,65,55,95,360,0.8055555555555556,68,125,65,65,115,80,518,0.6277372262773723,1.0
80,135,130,95,90,70,600,0.5181818181818182,55,20,35,20,45,75,250,0.37681159420289856,1.0
57,80,91,80,87,75,470,0.5737704918032787,72,105,115,54,86,68,500,0.5149253731343284,1.0
50,47,50,57,50,65,319,0.463768115942029,100,100,100,100,100,100,600,0.8778625954198473,1.0
71,120,95,120,95,99,600,0.8203125,40,45,35,40,40,90,290,0.65,1.0
60,65,80,170,95,130,600,0.8625954198473282,70,95,125,65,75,45,475,0.33613445378151263,0.5
60,65,60,130,75,110,500,0.7719298245614035,50,30,55,65,55,20,275,0.13675213675213677,1.0
53,51,53,61,56,40,314,0.14285714285714285,35,64,85,74,55,32,345,0.19827586206896552,0.5
40,45,35,40,40,90,290,0.65,45,95,50,40,50,75,355,0.54,0.5
65,130,60,95,110,65,525,0.5303030303030303,45,45,55,45,55,63,308,0.4594594594594595,2.0
75,80,95,90,100,50,490,0.2158273381294964,43,70,48,50,60,38,309,0.2391304347826087,0.5
60,25,35,70,80,60,330,0.3076923076923077,50,50,50,50,50,50,300,0.30708661417322836,1.0
90,92,87,75,85,76,505,0.5409836065573771,75,100,63,80,63,116,497,0.9345794392523364,2.0
72,58,80,103,80,97,490,0.7171052631578947,75,125,230,55,95,30,610,0.3448275862068966,0.5
78,130,111,130,85,100,634,0.8561151079136691,75,87,63,87,63,98,473,0.865546218487395,0.5
105,140,95,55,65,45,505,0.3,35,35,35,35,35,35,210,0.13385826771653545,1.0
80,70,65,80,120,100,515,0.8034188034188035,90,75,75,90,100,70,500,0.5462184873949579,0.5
76,104,71,104,71,108,534,0.912751677852349,97,165,60,65,50,58,495,0.3902439024390244,1.0
55,75,85,25,25,15,280,0.1875,65,50,35,115,95,95,455,0.7333333333333333,2.0
40,55,70,45,60,30,300,0.10619469026548672,75,95,60,65,60,115,470,0.8778625954198473,1.0
80,135,130,95,90,70,600,0.5181818181818182,35,80,50,50,70,120,405,0.84375,2.0
100,100,125,110,50,50,535,0.384,72,105,115,54,86,68,500,0.5149253731343284,4.0
45,63,37,65,55,95,360,0.8055555555555556,110,135,60,50,65,88,508,0.7744360902255639,0.0
50,70,50,50,50,40,310,0.16296296296296298,80,80,80,80,80,80,480,0.6015037593984962,1.0
60,65,80,170,95,130,600,0.8625954198473282,73,100,60,100,60,65,458,0.42657342657342656,0.5
60,55,145,75,150,40,525,0.2,48,72,48,72,48,48,336,0.25984251968503935,1.0
58,64,58,80,65,80,405,0.5423728813559322,100,150,120,120,100,90,680,0.6493506493506493,0.5
60,40,60,95,60,55,370,0.4222222222222222,65,47,55,73,75,85,400,0.65,2.0
70,77,60,97,60,108,472,0.8394160583941606,100,100,100,100,100,100,600,0.8805970149253731,2.0
90,132,105,132,105,30,594,0.4246575342465753,75,75,95,75,95,113,528,0.9015151515151515,1.0
1,90,45,30,30,40,236,0.33064516129032256,40,45,35,30,40,55,245,0.3793103448275862,0.25
115,45,20,45,25,20,270,0.11538461538461539,60,85,49,60,49,60,363,0.4444444444444444,1.0
90,65,65,40,40,15,315,0.19672131147540983,67,125,40,30,30,58,350,0.3431372549019608,2.0
74,108,133,83,65,32,495,0.32142857142857145,45,35,50,70,50,30,280,0.15753424657534246,0.5
95,124,78,69,71,58,495,0.37398373983739835,76,48,48,57,62,34,325,0.11688311688311688,1.0
65,47,55,73,75,85,400,0.65,66,65,48,62,57,52,350,0.36220472440944884,2.0
100,100,100,100,100,100,600,0.831858407079646,40,40,50,30,30,30,220,0.0873015873015873,1.0
100,100,100,100,100,100,600,0.831858407079646,55,130,115,50,50,75,475,0.5982142857142857,1.0
45,90,20,65,20,65,305,0.5116279069767442,80,80,80,80,80,80,480,0.6015037593984962,1.0
65,75,105,35,65,85,430,0.6940298507462687,92,105,90,125,90,98,600,0.8217054263565892,1.0
100,77,77,128,128,90,600,0.6901408450704225,100,90,130,45,65,55,485,0.4253731343283582,0.5
61,84,65,70,70,70,420,0.5,50,70,160,70,160,90,600,0.7417218543046358,1.0
55,75,50,40,40,80,340,0.6302521008403361,55,45,45,25,25,15,210,0.048,1.0
70,135,105,60,105,20,495,0.5806451612903226,97,165,60,65,50,58,495,0.3902439024390244,2.0
50,65,64,44,48,43,314,0.2196969696969697,40,29,45,29,45,36,224,0.14634146341463414,1.0
75,100,66,60,66,115,482,0.918918918918919,55,75,85,25,25,15,280,0.1875,0.5
62,77,62,50,42,65,358,0.4838709677419355,55,45,50,45,65,80,340,0.5546218487394958,2.0
67,82,62,46,48,43,348,0.22033898305084745,70,94,50,94,50,66,424,0.48148148148148145,0.25
105,140,55,30,55,95,480,0.8195488721804511,51,65,65,80,75,59,395,0.4365079365079365,2.0
77,120,90,60,90,48,485,0.2785714285714286,40,30,50,55,55,100,330,0.584070796460177,1.0
50,25,28,45,55,15,218,0.0625,100,100,90,150,140,90,670,0.71875,1.0
108,170,115,120,95,92,700,0.7083333333333334,95,100,85,108,70,70,528,0.5652173913043478,1.0
60,85,60,85,60,55,405,0.3673469387755102,55,50,40,40,40,75,300,0.5945945945945946,2.0
90,100,60,90,60,80,480,0.6422764227642277,75,87,63,87,63,98,473,0.865546218487395,1.0
70,60,75,110,75,90,480,0.7165354330708661,60,75,100,55,80,50,420,0.3088235294117647,0.5
70,85,70,60,70,50,405,0.28378378378378377,80,92,65,65,80,68,450,0.4824561403508772,0.5
60,45,70,45,90,95,405,0.7304964539007093,70,150,140,65,100,75,600,0.55,1.0
37,25,41,25,41,25,194,0.08870967741935484,75,90,140,60,60,40,465,0.3008130081300813,0.5
40,50,45,70,45,70,320,0.5517241379310345,90,95,105,165,110,45,610,0.2890625,0.5
71,73,88,120,89,59,500,0.43537414965986393,100,164,150,95,120,71,700,0.5645161290322581,2.0
54,63,52,83,56,97,405,0.7697841726618705,72,105,115,54,86,68,500,0.5149253731343284,1.0
40,50,45,70,45,70,320,0.5517241379310345,88,107,122,74,75,64,530,0.4596774193548387,4.0
90,120,75,60,60,45,450,0.29411764705882354,70,115,60,115,60,55,475,0.4647887323943662,2.0
50,72,35,35,35,65,292,0.5373134328358209,20,40,90,30,90,25,295,0.11363636363636363,2.0
60,40,60,40,60,35,295,0.18055555555555555,73,100,60,100,60,65,458,0.42657342657342656,0.5
95,65,65,110,130,60,525,0.4016393442622951,35,35,40,35,55,50,250,0.40336134453781514,1.0
110,123,65,100,65,65,528,0.5217391304347826,43,30,55,40,65,97,330,0.6030534351145038,0.5
80,85,95,30,30,25,345,0.2857142857142857,30,30,42,30,42,70,244,0.4230769230769231,0.0
95,75,80,100,110,30,490,0.24242424242424243,50,30,55,65,55,20,275,0.13675213675213677,2.0
70,120,100,145,105,20,560,0.2824427480916031,75,75,75,125,95,40,485,0.15671641791044777,1.0
106,90,130,90,154,110,680,0.8699186991869918,55,75,50,40,40,80,340,0.6302521008403361,1.0
60,50,50,60,70,50,340,0.28346456692913385,75,103,80,70,80,92,500,0.7933884297520661,0.125
45,30,50,65,50,45,285,0.13821138211382114,90,132,105,132,105,30,594,0.4246575342465753,1.0
116,55,85,107,95,29,487,0.06818181818181818,100,110,90,85,90,60,535,0.47794117647058826,2.0
70,40,50,55,50,25,290,0.061068702290076333,59,66,70,44,55,41,335,0.25190839694656486,1.0
64,88,50,88,50,106,446,0.9111111111111111,74,100,72,90,72,46,454,0.24561403508771928,1.0
55,20,35,20,45,75,250,0.37681159420289856,65,80,65,35,65,60,370,0.38405797101449274,1.0
103,60,86,60,86,50,445,0.3458646616541353,80,105,65,60,75,130,515,0.9645390070921985,0.5
105,130,120,45,45,40,485,0.4444444444444444,78,70,61,50,61,100,420,0.8145161290322581,1.0
70,150,140,65,100,75,600,0.55,82,80,86,85,75,72,480,0.6183206106870229,0.25
60,60,60,85,85,85,435,0.631578947368421,70,55,55,80,60,45,365,0.2222222222222222,1.0
40,35,30,20,20,50,195,0.23423423423423423,44,75,35,63,33,45,295,0.2647058823529412,0.25
65,125,100,55,70,85,500,0.6532258064516129,80,82,83,100,100,80,525,0.6742424242424242,1.0
106,150,70,194,120,140,780,0.952,75,80,95,90,100,50,490,0.2158273381294964,1.0
75,85,200,55,65,30,510,0.16778523489932887,60,75,100,55,80,50,420,0.3088235294117647,1.0
55,65,35,60,30,85,330,0.6126126126126126,35,55,40,50,50,90,320,0.6838235294117647,1.0
65,130,60,95,110,65,525,0.5303030303030303,70,110,180,60,60,50,530,0.4117647058823529,1.0
35,65,35,65,35,65,300,0.46621621621621623,50,48,43,46,41,60,288,0.47297297297297297,1.0
75,75,95,75,95,113,528,0.9015151515151515,62,77,62,50,42,65,358,0.4838709677419355,0.5
65,90,115,45,115,58,488,0.5041322314049587,81,102,77,85,75,85,505,0.5642857142857143,0.5
60,95,80,60,80,30,405,0.19480519480519481,95,75,80,100,110,30,490,0.24242424242424243,4.0
75,123,67,95,85,95,540,0.7642276422764228,90,120,100,150,120,100,680,0.7718120805369127,1.0
40,80,35,35,45,70,305,0.4661016949152542,70,70,115,130,90,60,535,0.5338983050847458,2.0
70,95,85,55,65,70,440,0.5,95,117,80,65,70,92,519,0.8409090909090909,0.0
35,64,85,74,55,32,345,0.19827586206896552,40,55,80,35,60,30,300,0.15037593984962405,1.0
52,65,55,58,62,60,352,0.4482758620689655,50,75,35,70,30,40,300,0.21296296296296297,2.0
100,100,100,100,100,100,600,0.8345864661654135,100,120,100,150,120,90,680,0.728,0.25
91,134,95,100,100,80,600,0.6304347826086957,40,70,40,35,40,60,285,0.392,2.0
50,40,85,40,65,25,305,0.08870967741935484,61,84,65,70,70,70,420,0.5,1.0
55,70,40,60,40,40,305,0.26956521739130435,35,35,40,35,55,50,250,0.40336134453781514,4.0
60,60,75,60,75,80,410,0.7321428571428571,65,85,70,75,70,40,405,0.203125,1.0
70,85,65,105,85,120,530,0.9262295081967213,65,95,75,55,55,85,430,0.6933333333333334,1.0
70,77,60,97,60,108,472,0.8394160583941606,86,92,88,68,75,73,482,0.6835443037974683,4.0
80,82,78,95,80,85,500,0.6869565217391305,65,40,70,80,140,70,465,0.5954198473282443,0.5
45,35,50,70,50,30,280,0.15753424657534246,105,125,100,60,100,100,590,0.8359375,1.0
50,65,107,105,107,86,520,0.7272727272727273,50,53,48,53,48,64,316,0.4076923076923077,1.0
65,80,65,35,65,60,370,0.38405797101449274,35,45,160,30,45,70,385,0.48148148148148145,0.5
90,75,85,115,90,55,510,0.3445378151260504,60,69,95,69,95,36,424,0.2608695652173913,1.0
110,85,95,80,95,50,515,0.2713178294573643,38,30,85,55,65,30,303,0.21428571428571427,0.0
60,55,50,40,55,45,305,0.22377622377622378,70,43,53,43,53,40,302,0.19090909090909092,0.25
255,10,10,75,135,55,540,0.3125,65,65,60,130,95,110,525,0.823943661971831,1.0
65,95,57,100,85,93,495,0.7441860465116279,105,95,75,85,75,74,509,0.5714285714285714,0.5
60,85,42,85,42,91,405,0.8227848101265823,60,95,80,60,80,30,405,0.19480519480519481,4.0
30,65,100,45,25,40,305,0.1891891891891892,50,60,45,100,80,65,400,0.45689655172413796,0.5
80,160,80,130,80,100,630,0.8455284552845529,68,125,65,65,115,80,518,0.6277372262773723,0.5
50,70,160,70,160,90,600,0.7417218543046358,70,84,70,65,70,51,410,0.2949640287769784,2.0
50,65,64,44,48,43,314,0.2196969696969697,45,40,60,40,75,50,310,0.2926829268292683,1.0
40,45,35,40,40,90,290,0.65,60,90,140,50,50,40,430,0.2535211267605634,0.25
30,80,90,55,45,55,355,0.4295774647887324,60,60,60,35,35,30,280,0.11194029850746269,1.0
114,85,70,85,80,30,464,0.2066115702479339,100,5,5,15,65,30,220,0.07692307692307693,1.0
10,55,25,35,45,95,265,0.5396825396825397,55,70,40,60,40,40,305,0.26956521739130435,1.0
91,72,90,129,90,108,580,0.8925619834710744,74,48,76,83,81,104,466,0.7322834645669292,0.5
90,95,95,70,90,70,510,0.5230769230769231,50,95,95,35,110,70,455,0.5179856115107914,1.0
50,65,107,105,107,86,520,0.7272727272727273,45,55,45,65,45,75,330,0.5692307692307692,2.0
65,47,55,73,75,85,400,0.65,55,35,50,55,110,85,390,0.6277372262773723,0.5
80,100,123,122,120,80,625,0.56,65,90,115,45,115,58,488,0.5041322314049587,1.0
65,90,40,45,80,75,395,0.625,70,120,40,95,40,95,460,0.8106060606060606,2.0
70,145,88,140,70,112,625,0.8888888888888888,79,100,80,110,90,121,580,0.968,0.5
75,85,200,55,65,30,510,0.16778523489932887,53,54,53,37,46,45,288,0.3090909090909091,1.0
40,80,100,30,30,20,300,0.11851851851851852,80,120,70,110,70,80,530,0.6422764227642277,2.0
60,75,85,100,85,115,520,0.8992248062015504,74,48,76,83,81,104,466,0.7913043478260869,0.5
90,75,85,115,90,55,510,0.3445378151260504,80,120,130,55,65,45,495,0.37037037037037035,0.0
45,30,15,85,65,65,305,0.36220472440944884,65,45,55,45,70,45,325,0.24369747899159663,0.5
73,100,60,100,60,65,458,0.42657342657342656,130,70,35,70,35,60,400,0.4017857142857143,1.0
85,80,90,105,95,60,515,0.49074074074074076,50,50,77,95,77,91,440,0.5916666666666667,0.0
67,89,116,79,116,33,500,0.2624113475177305,58,70,45,40,45,42,300,0.25925925925925924,2.0
85,105,100,79,83,78,530,0.5869565217391305,65,65,45,75,45,95,390,0.72,1.0
28,25,25,45,35,40,198,0.16083916083916083,75,80,55,25,35,35,305,0.18666666666666668,2.0
55,63,90,50,80,42,380,0.21138211382113822,45,45,55,45,55,63,308,0.4594594594594595,1.0
100,164,150,95,120,71,700,0.5645161290322581,100,77,77,128,128,90,600,0.6901408450704225,2.0
50,85,125,85,115,20,480,0.4306569343065693,70,45,48,60,65,35,323,0.15748031496062992,0.5
85,56,77,50,77,78,423,0.53125,70,100,70,105,75,40,460,0.23214285714285715,2.0
73,76,75,81,100,100,505,0.8110236220472441,70,100,115,30,65,30,410,0.24390243902439024,0.5
100,180,160,150,90,90,770,0.7520661157024794,70,115,60,115,60,55,475,0.4647887323943662,1.0
68,72,78,38,42,32,330,0.23809523809523808,72,105,115,54,86,68,500,0.5149253731343284,2.0
35,65,35,65,35,65,300,0.46621621621621623,60,75,85,100,85,115,520,0.8992248062015504,0.5
45,100,135,65,135,45,525,0.29411764705882354,40,65,40,80,40,65,330,0.5038167938931297,0.5
80,110,120,130,90,70,600,0.6198347107438017,115,140,130,55,55,40,535,0.4519230769230769,2.0
60,85,42,85,42,91,405,0.8227848101265823,44,38,39,61,79,42,303,0.2251655629139073,0.5
255,10,10,75,135,55,540,0.3125,45,35,45,62,53,35,275,0.11851851851851852,1.0
45,35,50,70,50,30,280,0.15753424657534246,45,45,35,20,30,20,195,0.07246376811594203,0.5
65,85,70,75,70,40,405,0.203125,50,160,110,160,110,110,700,0.8854961832061069,1.0
125,120,90,170,100,95,700,0.78125,100,70,70,65,65,45,415,0.1897810218978102,1.0
65,90,40,45,80,75,395,0.625,60,45,50,90,80,70,395,0.625,0.5
60,40,80,60,45,40,325,0.23529411764705882,61,78,95,56,58,57,405,0.40336134453781514,0.5
100,110,90,85,90,60,535,0.47794117647058826,80,145,150,105,110,110,700,0.8692307692307693,2.0
85,105,100,79,83,78,530,0.5869565217391305,100,100,80,60,60,50,450,0.3050847457627119,2.0
95,75,180,130,80,30,590,0.13793103448275862,58,109,112,48,48,109,484,0.8805970149253731,0.5
30,45,55,70,55,85,340,0.5633802816901409,105,125,100,60,100,100,590,0.8359375,1.0
80,110,60,150,130,70,600,0.5042016806722689,54,63,52,83,56,97,405,0.7697841726618705,1.0
70,75,80,135,80,135,575,0.917910447761194,65,55,115,100,40,60,435,0.3798449612403101,0.5
85,115,80,105,80,50,515,0.3063063063063063,50,45,45,35,35,50,260,0.23529411764705882,1.0
67,58,57,81,67,101,431,0.8790322580645161,85,80,70,135,75,90,535,0.7006802721088435,1.0
45,67,60,35,50,63,320,0.5128205128205128,106,90,130,90,154,110,680,0.8699186991869918,1.0
30,40,55,40,55,60,280,0.3237410071942446,43,30,55,40,65,97,330,0.6030534351145038,1.0
70,95,125,65,75,45,475,0.33613445378151263,85,120,70,50,60,100,485,0.8308823529411765,1.0
70,84,70,65,70,51,410,0.2949640287769784,80,80,80,80,80,80,480,0.6015037593984962,2.0
60,52,168,47,138,30,495,0.19834710743801653,64,115,65,83,63,65,455,0.5323741007194245,1.0
50,72,35,35,35,65,292,0.5373134328358209,45,53,70,40,60,42,310,0.25735294117647056,0.25
62,44,50,44,50,55,305,0.3629032258064516,30,45,59,30,39,57,260,0.2803030303030303,2.0
79,105,70,145,80,101,580,0.8608695652173913,80,80,90,110,130,110,600,0.8721804511278195,0.5
75,80,95,90,100,50,490,0.2158273381294964,55,95,55,35,75,115,430,0.9380530973451328,1.0
49,66,70,44,55,51,335,0.4260869565217391,110,78,73,76,71,60,468,0.3333333333333333,4.0
30,65,100,45,25,40,305,0.1891891891891892,100,150,120,120,100,90,680,0.6493506493506493,0.5
85,50,95,120,115,80,545,0.5793650793650794,90,100,70,110,150,80,600,0.6037735849056604,2.0
49,55,42,42,37,85,310,0.6068376068376068,106,190,100,154,100,130,780,0.9259259259259259,1.0
50,85,55,65,65,90,410,0.7478260869565218,55,40,40,65,45,35,280,0.16428571428571428,1.0
65,130,60,95,110,65,525,0.5303030303030303,70,140,70,110,65,105,560,0.95,0.5
35,40,100,90,55,35,355,0.1796875,100,120,100,150,120,90,680,0.728,2.0
50,53,48,53,48,64,316,0.4076923076923077,80,115,80,65,55,93,488,0.7846153846153846,0.5
123,77,72,99,92,58,521,0.4621212121212121,125,120,90,170,100,95,700,0.78125,2.0
65,65,65,50,50,90,385,0.72,65,130,60,95,110,65,525,0.5303030303030303,2.0
60,50,70,80,80,140,480,0.8449612403100775,45,95,50,40,50,75,355,0.54,1.0
100,100,125,110,50,50,535,0.384,79,115,70,125,80,111,580,0.864,0.5
30,42,118,42,88,30,350,0.112,70,80,50,35,35,35,305,0.14,0.5
40,40,40,70,40,20,250,0.032520325203252036,60,52,168,47,138,30,495,0.19834710743801653,1.0
108,100,121,81,95,95,600,0.7476635514018691,80,90,80,130,110,110,600,0.856,2.0
55,65,35,60,30,85,330,0.6126126126126126,20,40,15,35,35,60,205,0.34285714285714286,1.0
45,35,50,70,50,30,280,0.15753424657534246,50,65,85,35,35,55,325,0.32575757575757575,1.0
100,180,160,150,90,90,770,0.7520661157024794,75,80,85,110,90,50,490,0.3548387096774194,2.0
100,73,83,73,83,55,467,0.371900826446281,75,95,95,95,95,85,540,0.6470588235294118,1.0
40,80,35,35,45,70,305,0.4661016949152542,64,78,52,78,52,81,405,0.6422764227642277,1.0
58,50,145,95,105,30,483,0.2459016393442623,78,52,60,63,65,23,341,0.06015037593984962,1.0
95,85,85,65,65,35,430,0.2571428571428571,106,90,130,90,154,110,680,0.8699186991869918,0.0
70,110,70,115,70,90,525,0.75,45,80,100,35,37,28,325,0.3125,0.0
95,65,110,60,130,65,525,0.5275590551181102,40,40,50,30,30,30,220,0.0873015873015873,1.0
60,85,60,50,50,125,430,0.9090909090909091,65,90,65,61,61,100,442,0.8373983739837398,1.0
255,10,10,75,135,55,540,0.3125,30,35,30,100,35,80,310,0.4765625,0.0
53,54,53,37,46,45,288,0.3090909090909091,45,30,40,105,50,20,290,0.031007751937984496,1.0
70,60,70,87,78,85,450,0.6228070175438597,38,36,38,32,36,57,237,0.3893805309734513,1.0
40,30,35,50,70,55,280,0.28205128205128205,40,35,30,20,20,50,195,0.23423423423423423,0.125
110,80,90,95,90,65,530,0.5033557046979866,110,135,60,50,65,88,508,0.7744360902255639,2.0
62,77,62,50,42,65,358,0.4838709677419355,40,45,35,40,40,90,290,0.65,1.0
50,65,64,44,48,43,314,0.2196969696969697,35,46,34,35,45,20,215,0.072,1.0
95,60,79,100,125,81,540,0.6201550387596899,75,75,95,75,95,113,528,0.9015151515151515,0.5
105,105,75,65,100,50,500,0.37593984962406013,86,68,72,109,66,106,507,0.8099173553719008,1.0
59,110,150,45,49,35,448,0.3333333333333333,78,65,68,112,154,75,552,0.628099173553719,0.5
100,50,80,60,80,50,420,0.34375,95,117,184,44,46,28,514,0.2975206611570248,1.0
65,150,60,115,60,115,565,0.935251798561151,70,84,70,65,70,51,410,0.2949640287769784,1.0
80,130,100,160,120,110,700,0.8981481481481481,160,110,65,65,110,30,540,0.35714285714285715,1.0
71,82,64,64,59,112,452,0.9327731092436975,70,90,110,60,75,95,500,0.7333333333333333,1.0
43,70,48,50,60,38,309,0.2391304347826087,80,70,40,100,60,145,495,0.921875,0.5
54,45,47,75,98,52,371,0.39669421487603307,40,30,50,55,55,100,330,0.584070796460177,1.0
81,102,77,85,75,85,505,0.5642857142857143,70,115,60,115,60,55,475,0.4647887323943662,1.0
20,40,90,30,90,25,295,0.11363636363636363,30,40,55,40,55,60,280,0.3237410071942446,2.0
85,60,65,135,105,100,550,0.7518248175182481,58,89,77,45,45,48,362,0.3177570093457944,0.25
75,75,130,75,130,95,580,0.7479674796747967,55,40,85,80,105,40,405,0.23622047244094488,1.0
50,65,107,105,107,86,520,0.7272727272727273,35,70,55,45,55,25,285,0.09420289855072464,2.0
50,65,107,105,107,86,520,0.7272727272727273,70,110,180,60,60,50,530,0.4117647058823529,0.25
65,110,130,60,65,95,525,0.8278145695364238,60,85,40,30,45,68,328,0.6422018348623854,2.0
60,80,50,50,50,40,330,0.23853211009174313,70,140,230,60,80,50,630,0.32432432432432434,0.5
80,160,60,170,130,80,680,0.6180555555555556,57,80,91,80,87,75,470,0.5737704918032787,0.25
85,56,77,50,77,78,423,0.53125,40,30,32,50,52,65,269,0.3671875,0.5
44,75,35,63,33,45,295,0.2647058823529412,38,35,35,65,55,50,278,0.2647058823529412,2.0
80,120,70,110,70,80,530,0.6422764227642277,72,105,115,54,86,68,500,0.5149253731343284,0.5
89,124,80,55,80,55,483,0.5714285714285714,95,23,48,23,48,23,260,0.046153846153846156,2.0
70,65,60,90,75,90,450,0.6571428571428571,40,30,30,55,30,85,270,0.4666666666666667,0.5
51,65,65,80,75,59,395,0.4365079365079365,70,70,40,60,40,60,340,0.4247787610619469,2.0
50,75,70,35,70,48,348,0.29357798165137616,100,100,100,100,100,100,600,0.8345864661654135,1.0
95,109,105,75,85,56,525,0.34513274336283184,80,85,95,30,30,25,345,0.2857142857142857,8.0
95,85,85,65,65,35,430,0.2571428571428571,50,85,40,85,40,35,335,0.1746031746031746,0.25
110,130,80,70,60,80,530,0.5862068965517241,74,48,76,83,81,104,466,0.7322834645669292,1.0
35,35,35,35,35,35,210,0.13385826771653545,60,85,69,65,79,80,438,0.576,0.5
95,117,80,65,70,92,519,0.8409090909090909,79,115,70,125,80,111,580,0.864,0.0
110,80,90,95,90,65,530,0.5033557046979866,70,90,70,60,60,70,420,0.6390977443609023,1.0
55,55,55,85,55,30,335,0.1320754716981132,45,75,60,40,30,50,300,0.304,1.0
79,115,70,125,80,111,580,0.8468468468468469,81,102,77,85,75,85,505,0.5642857142857143,1.0
90,93,55,70,55,55,418,0.3819444444444444,70,130,100,55,80,65,500,0.608,4.0
100,77,77,128,128,90,600,0.6901408450704225,45,55,45,65,45,75,330,0.5692307692307692,1.0
50,20,55,25,25,30,205,0.09774436090225563,150,120,100,120,100,90,680,0.664179104477612,0.5
54,63,52,83,56,97,405,0.7697841726618705,65,50,70,95,80,65,425,0.4262295081967213,1.0
59,45,40,35,40,31,250,0.14285714285714285,123,77,72,99,92,58,521,0.4621212121212121,0.5
40,45,40,62,60,60,307,0.33884297520661155,126,131,95,131,98,99,680,0.8294573643410853,1.0
75,69,72,114,100,104,534,0.8253968253968254,65,90,115,45,115,58,488,0.5041322314049587,0.0
66,117,70,40,50,67,410,0.4573643410852713,60,45,70,45,90,95,405,0.7304964539007093,1.0
85,135,130,60,80,25,515,0.40540540540540543,70,65,65,55,55,70,380,0.5,1.0
70,85,65,105,85,120,530,0.9262295081967213,110,130,80,70,60,80,530,0.5862068965517241,2.0
70,100,115,30,65,30,410,0.24390243902439024,80,70,40,100,60,145,495,0.921875,2.0
65,50,70,95,80,65,425,0.4262295081967213,100,128,90,77,77,128,600,0.959349593495935,1.0
31,45,90,30,30,40,266,0.21929824561403508,55,95,115,45,45,35,390,0.2116788321167883,2.0
71,120,95,120,95,99,600,0.8203125,86,92,88,68,75,73,482,0.6835443037974683,4.0
90,92,75,92,85,60,494,0.49586776859504134,90,70,80,70,95,70,475,0.5190839694656488,0.5
70,70,40,60,40,60,340,0.4247787610619469,55,47,52,40,40,41,275,0.16806722689075632,0.5
80,100,123,122,120,80,625,0.56,45,45,55,45,55,63,308,0.4594594594594595,1.0
50,65,107,105,107,86,520,0.7272727272727273,40,30,35,45,40,55,245,0.31496062992125984,1.0
60,150,50,150,50,60,520,0.5,48,61,40,61,40,50,300,0.2543859649122807,1.0
28,25,25,45,35,40,198,0.16083916083916083,43,80,65,50,35,35,308,0.14193548387096774,1.0
44,58,44,58,44,61,309,0.41964285714285715,85,73,70,73,115,67,483,0.5126050420168067,1.0
70,100,115,30,65,30,410,0.24390243902439024,80,185,115,40,105,75,600,0.6230769230769231,1.0
31,45,90,30,30,40,266,0.21929824561403508,80,185,115,40,105,75,600,0.6230769230769231,0.25
65,75,105,35,65,85,430,0.6940298507462687,60,85,49,60,49,60,363,0.4444444444444444,1.0
60,67,85,77,75,116,480,0.8888888888888888,63,60,55,50,50,71,349,0.5289256198347108,0.5
65,63,45,45,45,45,308,0.2595419847328244,45,49,49,65,65,45,318,0.2781954887218045,2.0
68,165,95,65,115,110,618,0.8615384615384616,69,69,76,69,86,91,460,0.6554621848739496,1.0
108,100,121,81,95,95,600,0.7476635514018691,46,87,60,30,40,57,320,0.37777777777777777,2.0
90,120,120,60,60,50,500,0.35294117647058826,58,89,77,45,45,48,362,0.3177570093457944,2.0
54,66,70,44,55,46,335,0.4214876033057851,38,30,85,55,65,30,303,0.21428571428571427,2.0
50,52,48,65,50,55,320,0.33098591549295775,30,80,90,55,45,55,355,0.4295774647887324,1.0
80,50,100,100,200,50,580,0.2357142857142857,60,40,50,75,85,95,405,0.6044776119402985,1.0
55,65,35,60,30,85,330,0.6126126126126126,70,95,85,55,65,70,440,0.5,2.0
35,20,65,40,65,20,245,0.02459016393442623,65,73,55,47,75,85,400,0.6846846846846847,1.0
45,85,50,55,50,65,350,0.5076923076923077,100,100,100,100,100,100,600,0.8345864661654135,0.5
10,55,25,35,45,95,265,0.5396825396825397,65,125,60,95,60,105,510,0.9236641221374046,1.0
86,76,86,116,56,95,515,0.7982456140350878,90,70,80,70,95,70,475,0.5190839694656488,1.0
60,115,105,65,70,80,495,0.7181818181818181,70,62,67,55,55,56,365,0.38513513513513514,1.0
95,145,130,120,90,120,700,0.9398496240601504,73,100,60,100,60,65,458,0.42657342657342656,1.0
85,105,85,40,50,40,405,0.211864406779661,85,135,130,60,80,25,515,0.40540540540540543,2.0
65,105,60,60,70,95,455,63.0,85,80,70,135,75,90,535,0.7006802721088435,2.0
45,63,37,65,55,95,360,0.8055555555555556,75,90,140,60,60,40,465,0.3008130081300813,1.0
65,47,55,73,75,85,400,0.65,75,90,50,110,80,95,500,0.7985611510791367,1.0
170,90,45,90,45,60,500,0.427536231884058,63,120,85,90,55,55,468,0.2809917355371901,0.5
85,80,70,135,75,90,535,0.7006802721088435,80,185,115,40,105,75,600,0.6230769230769231,1.0
60,65,80,170,95,130,600,0.8625954198473282,70,55,65,95,85,70,440,0.5307692307692308,1.0
70,80,70,80,70,110,480,0.6594202898550725,65,80,140,40,70,70,465,0.5223880597014925,1.0
45,60,40,70,50,45,310,0.2846715328467153,50,50,95,40,50,35,320,0.20279720279720279,1.0
78,70,61,50,61,100,420,0.8145161290322581,75,125,70,125,70,115,580,0.9037037037037037,1.0
65,40,50,125,60,30,370,0.07258064516129033,83,80,75,70,70,101,479,0.8615384615384616,1.0
150,80,44,90,54,80,498,0.625,60,85,60,85,60,55,405,0.3673469387755102,2.0
88,107,122,74,75,64,530,0.4596774193548387,95,110,80,70,80,50,485,0.37209302325581395,2.0
40,50,45,70,45,70,320,0.5517241379310345,80,100,80,80,80,100,520,0.9051724137931034,2.0
30,80,90,55,45,55,355,0.4295774647887324,45,85,70,40,40,60,340,0.5229357798165137,0.5
101,72,72,99,89,29,462,0.1937984496124031,80,80,80,80,80,80,480,0.5606060606060606,1.0
45,75,37,70,55,83,365,0.6183206106870229,50,25,28,45,55,15,218,0.0625,1.0
90,100,70,110,150,80,600,0.6037735849056604,95,124,78,69,71,58,495,0.37398373983739835,1.0
45,53,70,40,60,42,310,0.25735294117647056,68,65,65,125,115,80,518,0.6461538461538462,1.0
40,65,40,80,40,65,330,0.5038167938931297,45,30,50,65,50,45,285,0.13821138211382114,2.0
60,80,50,40,40,30,300,0.15328467153284672,65,76,84,54,96,105,480,0.9008264462809917,1.0
50,70,100,40,40,30,330,0.2222222222222222,75,98,63,98,63,101,498,0.849624060150376,0.5
99,68,83,72,87,51,460,0.417910447761194,43,30,55,40,65,97,330,0.6030534351145038,2.0
30,65,100,45,25,40,305,0.1891891891891892,72,85,70,65,70,58,420,0.41304347826086957,0.5
50,35,55,25,25,15,205,0.05263157894736842,60,40,50,75,85,95,405,0.6044776119402985,1.0
75,75,55,105,85,30,425,0.1619718309859155,125,58,58,76,76,67,460,0.515625,2.0
60,50,70,50,90,65,385,0.39568345323741005,125,130,90,130,90,95,660,0.7734375,1.0
80,80,90,110,130,110,600,0.8721804511278195,78,130,111,130,85,100,634,0.8561151079136691,2.0
52,65,50,45,50,38,300,0.27419354838709675,70,100,115,30,65,30,410,0.24390243902439024,1.0
45,80,100,35,37,28,325,0.3125,85,100,122,58,75,54,494,0.3939393939393939,2.0
60,55,145,75,150,40,525,0.2,85,100,122,58,75,54,494,0.3939393939393939,1.0
90,120,120,60,60,50,500,0.35294117647058826,55,50,65,175,95,150,590,0.7818181818181819,1.0
150,160,100,95,65,100,670,0.8866666666666667,70,60,62,80,82,60,414,0.4375,1.0
50,53,48,53,48,64,316,0.358974358974359,80,75,150,75,150,50,580,0.30973451327433627,1.0
55,95,55,35,75,115,430,0.9380530973451328,45,67,60,35,50,63,320,0.5128205128205128,0.5
55,55,85,65,85,35,380,0.2014388489208633,105,95,80,40,80,90,490,0.753968253968254,1.0
65,75,70,95,70,95,470,0.7272727272727273,50,50,150,50,150,50,500,0.2571428571428571,0.5
77,120,90,60,90,48,485,0.2785714285714286,80,135,85,70,95,150,615,0.9844961240310077,1.0
85,50,95,120,115,80,545,0.5793650793650794,85,100,122,58,75,54,494,0.3939393939393939,2.0
60,40,60,40,60,35,295,0.18055555555555555,75,98,63,98,63,101,498,0.889763779527559,0.5
68,165,95,65,115,110,618,0.8615384615384616,60,80,50,50,50,40,330,0.23853211009174313,2.0
40,45,40,62,60,60,307,0.33884297520661155,75,95,125,45,75,95,510,0.8257575757575758,1.0
55,55,50,45,65,55,325,0.37373737373737376,50,50,40,30,30,50,250,0.2781954887218045,1.0
41,64,45,50,50,50,300,0.36752136752136755,100,100,80,60,60,50,450,0.3050847457627119,1.0
50,48,43,46,41,60,288,0.47297297297297297,100,100,100,100,100,100,600,0.8778625954198473,4.0
60,60,60,105,105,105,495,0.848,75,95,95,95,95,85,540,0.6470588235294118,1.0
65,60,110,130,95,65,525,0.47761194029850745,50,70,50,50,50,70,340,0.5645161290322581,4.0
70,140,230,60,80,50,630,0.32432432432432434,125,130,90,130,90,95,660,0.7734375,2.0
70,95,85,55,65,70,440,0.5,79,115,70,125,80,111,580,0.8468468468468469,2.0
35,45,160,30,45,70,385,0.48148148148148145,68,75,53,83,113,60,452,0.45384615384615384,1.0
52,65,55,58,62,60,352,0.4482758620689655,45,85,50,55,50,65,350,0.5076923076923077,2.0
75,55,70,55,95,110,460,0.8444444444444444,50,85,40,85,40,35,335,0.1746031746031746,1.0
50,85,125,85,115,20,480,0.4306569343065693,65,130,60,75,60,75,465,0.689922480620155,0.25
95,65,65,110,130,60,525,0.4016393442622951,79,115,70,125,80,111,580,0.8468468468468469,1.0
30,56,35,25,35,72,253,0.48148148148148145,69,69,76,69,86,91,460,0.6554621848739496,1.0
50,85,125,85,115,20,480,0.4306569343065693,55,50,45,135,95,120,500,0.7714285714285715,4.0
85,50,95,120,115,80,545,0.5793650793650794,65,65,65,50,50,90,385,0.72,1.0
75,125,70,125,70,115,580,0.9037037037037037,105,140,95,55,65,45,505,0.3,1.0
60,85,42,85,42,91,405,0.8227848101265823,43,30,55,40,65,97,330,0.6030534351145038,1.0
105,130,120,45,45,40,485,0.4444444444444444,60,50,100,85,70,65,430,0.47580645161290325,0.0
65,90,120,85,70,60,490,0.43410852713178294,55,35,50,55,110,85,390,0.6277372262773723,1.0
57,80,91,80,87,75,470,0.5737704918032787,100,164,150,95,120,71,700,0.5645161290322581,4.0
62,48,66,59,57,49,341,0.33884297520661155,52,65,50,45,50,38,300,0.27419354838709675,4.0
59,63,80,65,80,58,405,0.41843971631205673,38,41,40,50,65,65,299,0.4108527131782946,2.0
86,76,86,116,56,95,515,0.7982456140350878,40,40,40,70,40,20,250,0.032520325203252036,0.5
40,40,40,70,40,20,250,0.032520325203252036,79,115,70,125,80,111,580,0.864,1.0
74,94,131,54,116,20,489,0.4485294117647059,75,100,63,80,63,116,497,0.9345794392523364,0.5
60,55,50,40,55,45,305,0.22377622377622378,59,45,40,35,40,31,250,0.14285714285714285,1.0
65,65,65,50,50,90,385,0.72,35,80,50,50,70,120,405,0.84375,2.0
55,66,44,44,56,85,350,0.6888888888888889,100,120,100,150,120,90,680,0.728,1.0
75,98,63,98,63,101,498,0.889763779527559,55,70,40,60,40,40,305,0.26956521739130435,2.0
100,103,75,120,75,127,600,0.940677966101695,97,165,60,65,50,58,495,0.3902439024390244,1.0
62,48,66,59,57,49,341,0.33884297520661155,45,49,49,65,65,45,318,0.2781954887218045,0.5
45,49,65,49,65,45,318,0.275,40,30,30,40,50,30,220,0.07936507936507936,1.0
57,80,91,80,87,75,470,0.5737704918032787,55,50,45,135,95,120,500,0.7714285714285715,1.0
78,92,75,74,63,118,500,0.8842975206611571,91,72,90,129,90,108,580,0.8925619834710744,2.0
65,65,60,130,95,110,525,0.823943661971831,45,35,45,62,53,35,275,0.11851851851851852,1.0
50,85,55,65,65,90,410,0.7478260869565218,115,115,85,90,75,100,580,0.8134328358208955,0.5
100,150,90,180,160,90,770,0.7348484848484849,100,110,90,85,90,60,535,0.47794117647058826,1.0
110,65,105,55,95,80,510,0.6258503401360545,44,38,33,61,43,70,289,0.5267857142857143,0.5
70,105,105,50,40,20,390,0.33587786259541985,95,80,105,40,70,100,490,0.8046875,1.0
40,45,65,100,120,90,460,0.5588235294117647,86,68,72,109,66,106,507,0.8099173553719008,0.5
73,76,75,81,100,100,505,0.8110236220472441,89,125,90,115,80,101,600,0.8725490196078431,1.0
80,130,100,160,120,110,700,0.8981481481481481,65,80,80,59,63,58,405,0.4411764705882353,1.0
100,150,90,180,160,90,770,0.7348484848484849,45,95,50,40,50,75,355,0.54,2.0
91,129,90,72,90,108,580,0.8536585365853658,60,130,80,60,60,70,460,0.5153846153846153,0.5
75,75,60,83,60,60,413,0.39344262295081966,73,95,62,85,65,85,465,0.6666666666666666,1.0
45,35,50,70,50,30,280,0.15753424657534246,85,120,70,50,60,100,485,0.8308823529411765,0.5
35,55,35,30,30,35,220,0.23684210526315788,70,55,55,80,60,45,365,0.2222222222222222,1.0
60,85,60,50,50,125,430,0.9090909090909091,80,80,80,55,55,90,440,0.6417910447761194,1.0
65,100,70,80,80,105,500,0.8666666666666667,58,109,112,48,48,109,484,0.8805970149253731,4.0
90,85,75,115,100,115,580,0.9381443298969072,120,70,120,75,130,85,600,0.6694915254237288,1.0
75,140,65,112,65,110,567,0.9140625,79,115,70,125,80,111,580,0.864,1.0
85,80,70,135,75,90,535,0.7006802721088435,80,100,123,122,120,80,625,0.56,1.0
50,150,50,150,50,150,600,0.9339622641509434,31,45,90,30,30,40,266,0.21929824561403508,2.0
150,80,44,90,54,80,498,0.625,35,55,40,50,50,90,320,0.6838235294117647,0.5
64,66,68,81,76,50,405,0.25190839694656486,100,134,110,95,100,61,600,0.4057971014492754,2.0
108,170,115,120,95,92,700,0.7083333333333334,111,83,68,92,82,39,475,0.1774193548387097,1.0
75,80,60,65,90,102,472,0.8625954198473282,69,55,45,55,55,15,294,0.11666666666666667,1.0
59,74,50,35,50,35,303,0.3125,80,105,105,105,105,80,580,0.5939849624060151,2.0
160,110,65,65,110,30,540,0.35714285714285715,60,55,50,40,55,45,305,0.22377622377622378,1.0
50,105,79,35,110,76,455,0.6214285714285714,85,105,85,40,50,40,405,0.211864406779661,1.0
30,56,35,25,35,72,253,0.48148148148148145,70,55,95,95,110,65,490,0.48872180451127817,1.0
51,65,65,80,75,59,395,0.4365079365079365,95,75,110,100,80,30,490,0.15267175572519084,0.5
190,33,58,33,58,33,405,0.13432835820895522,95,75,180,130,80,30,590,0.13793103448275862,0.5
85,105,55,85,50,115,495,0.9032258064516129,74,100,72,90,72,46,454,0.24561403508771928,0.5
35,35,35,35,35,35,210,0.13385826771653545,95,110,95,40,95,55,490,0.40336134453781514,2.0
60,70,105,70,120,75,500,0.5983606557377049,50,55,50,36,30,43,264,0.2922077922077922,0.0
44,50,91,24,86,10,305,0.1981981981981982,70,90,70,60,60,70,420,0.6390977443609023,1.0
72,95,67,103,71,122,530,0.9606299212598425,91,72,90,129,90,108,580,0.8925619834710744,0.25
44,38,39,61,79,42,303,0.2251655629139073,45,95,50,40,50,75,355,0.54,1.0
70,92,65,80,55,98,460,0.8090909090909091,65,63,45,45,45,45,308,0.2595419847328244,2.0
25,35,70,95,55,45,325,0.16783216783216784,100,164,150,95,120,71,700,0.5645161290322581,2.0
100,120,120,150,100,90,680,0.7880794701986755,70,80,65,90,65,85,455,0.578125,1.0
50,85,125,85,115,20,480,0.4306569343065693,70,55,65,95,85,70,440,0.5307692307692308,4.0
60,30,30,36,56,50,262,0.32432432432432434,150,100,120,100,120,90,680,0.6666666666666666,0.0
50,65,107,105,107,86,520,0.7313432835820896,60,130,80,60,60,70,460,0.5153846153846153,0.25
106,130,90,110,154,90,680,0.719626168224299,55,85,55,50,55,60,360,0.4233576642335766,2.0
150,100,120,100,120,90,680,0.6666666666666666,55,50,45,135,95,120,500,0.7714285714285715,2.0
78,52,60,63,65,23,341,0.06015037593984962,60,59,85,79,105,36,424,0.16666666666666666,1.0
80,95,82,60,82,75,474,0.6,53,54,53,37,46,45,288,0.3090909090909091,1.0
70,83,50,37,50,60,350,0.3360655737704918,106,190,100,154,100,130,780,0.9259259259259259,2.0
150,80,44,90,54,80,498,0.625,100,77,77,128,128,90,600,0.6901408450704225,0.0
75,95,95,95,95,85,540,0.6470588235294118,68,125,65,65,115,80,518,0.6277372262773723,1.0
70,120,40,95,40,95,460,0.8106060606060606,75,140,65,112,65,110,567,0.9140625,2.0
60,70,105,70,120,75,500,0.5983606557377049,40,30,30,40,50,30,220,0.07936507936507936,0.5
63,63,47,41,41,74,329,0.56,55,50,45,135,95,120,500,0.7714285714285715,2.0
91,90,72,90,129,108,580,0.896,60,85,40,30,45,68,328,0.6422018348623854,2.0
90,75,75,90,100,70,500,0.5462184873949579,70,65,65,55,55,70,380,0.5,1.0
45,55,45,65,45,75,330,0.5692307692307692,66,65,48,62,57,52,350,0.36220472440944884,4.0
28,25,25,45,35,40,198,0.16083916083916083,120,120,120,120,120,120,720,0.9344262295081968,1.0
70,80,50,35,35,35,305,0.14,75,55,70,55,95,110,460,0.8444444444444444,0.5
80,105,65,60,75,130,515,0.9645390070921985,72,85,70,65,70,58,420,0.41304347826086957,1.0
40,45,35,65,55,70,310,0.4482758620689655,83,80,75,70,70,101,479,0.8615384615384616,0.5
85,70,80,97,80,123,535,0.9304347826086956,90,120,100,150,120,100,680,0.7718120805369127,2.0
75,80,95,90,100,50,490,0.2158273381294964,80,105,65,60,75,130,515,0.9645390070921985,1.0
85,97,66,105,66,65,484,0.47107438016528924,60,50,100,85,70,65,430,0.47580645161290325,0.5
60,80,110,50,80,45,425,0.2833333333333333,74,48,76,83,81,104,466,0.7913043478260869,1.0
70,100,115,30,65,30,410,0.24390243902439024,80,100,80,80,80,100,520,0.9051724137931034,0.5
68,72,78,38,42,32,330,0.23809523809523808,65,63,45,45,45,45,308,0.2595419847328244,2.0
65,75,105,35,65,85,430,0.6940298507462687,58,64,58,80,65,80,405,0.609271523178808,2.0
75,80,70,65,75,90,455,0.7578125,25,20,15,105,55,90,310,0.32407407407407407,1.0
75,95,125,45,75,95,510,0.8257575757575758,150,80,44,90,54,80,498,0.625,0.0
76,65,45,92,42,91,411,0.7449664429530202,61,90,45,50,50,160,456,0.9230769230769231,2.0
64,66,68,81,76,50,405,0.25190839694656486,125,58,58,76,76,67,460,0.515625,0.5
65,90,120,85,70,60,490,0.43410852713178294,65,55,115,100,40,60,435,0.3798449612403101,2.0
115,45,20,45,25,20,270,0.11538461538461539,30,42,118,42,88,30,350,0.112,0.125
100,75,115,90,115,85,580,0.6446280991735537,59,66,70,44,55,41,335,0.25190839694656486,0.5
75,80,85,110,90,50,490,0.3548387096774194,106,150,70,194,120,140,780,0.952,1.0
45,35,50,70,50,30,280,0.15753424657534246,70,130,100,55,80,65,500,0.608,0.25
100,123,75,57,75,80,510,0.6923076923076923,70,50,30,95,135,105,485,0.8040540540540541,1.0
110,65,75,125,85,30,490,0.15,105,125,100,60,100,100,590,0.8359375,1.0
103,93,67,71,61,84,479,0.7142857142857143,80,50,100,100,200,50,580,0.2357142857142857,1.0
70,55,75,45,65,60,370,0.45901639344262296,75,98,63,98,63,101,498,0.889763779527559,1.0
83,106,65,86,65,85,490,0.6640625,150,100,120,100,120,90,680,0.6666666666666666,0.0
75,98,63,98,63,101,498,0.8091603053435115,106,90,130,90,154,110,680,0.8699186991869918,0.5
105,140,95,55,65,45,505,0.3,65,90,50,85,45,55,390,0.371900826446281,0.5
40,45,65,100,120,90,460,0.5588235294117647,35,60,44,40,54,55,288,0.366412213740458,1.0
88,107,122,74,75,64,530,0.4596774193548387,95,125,79,60,100,81,540,0.6165413533834586,0.5
50,105,79,35,110,76,455,0.6214285714285714,55,45,45,25,25,15,210,0.048,1.0
75,100,66,60,66,115,482,0.918918918918919,100,128,90,77,77,128,600,0.959349593495935,1.0
28,25,25,45,35,40,198,0.16083916083916083,89,125,90,115,80,101,600,0.8725490196078431,2.0
160,110,65,65,110,30,540,0.35714285714285715,62,48,54,63,60,68,355,0.5178571428571429,1.0
48,72,48,72,48,48,336,0.25984251968503935,50,50,40,50,40,64,294,0.45588235294117646,1.0
90,65,65,40,40,15,315,0.19672131147540983,90,110,80,100,80,95,555,0.7982456140350878,2.0
52,65,55,58,62,60,352,0.4482758620689655,50,100,150,100,150,50,600,0.37142857142857144,0.25
70,120,65,45,85,125,510,0.9747899159663865,74,108,133,83,65,32,495,0.32142857142857145,0.5
60,60,60,35,35,30,280,0.11194029850746269,65,100,70,80,80,105,500,0.8666666666666667,1.0
80,80,80,55,55,90,440,0.6417910447761194,95,117,80,65,70,92,519,0.8409090909090909,1.0
150,80,44,90,54,80,498,0.625,65,63,45,45,45,45,308,0.2595419847328244,1.0
44,75,35,63,33,45,295,0.2647058823529412,45,50,35,55,75,40,300,0.21367521367521367,1.0
80,110,120,130,90,70,600,0.6198347107438017,45,100,135,65,135,45,525,0.29411764705882354,1.0
55,35,50,55,110,85,390,0.6277372262773723,40,29,45,29,45,36,224,0.14634146341463414,2.0
71,95,85,110,95,79,535,0.664,100,128,90,77,77,128,600,0.959349593495935,1.0
65,90,50,85,45,55,390,0.371900826446281,60,65,70,85,75,40,395,0.21705426356589147,0.25
62,73,55,56,52,84,382,0.7244094488188977,70,120,40,95,40,95,460,0.8106060606060606,0.5
95,65,110,60,130,65,525,0.5275590551181102,65,65,60,130,95,110,525,0.823943661971831,2.0
72,105,115,54,86,68,500,0.5149253731343284,80,45,65,90,110,80,470,0.5462962962962963,1.0
41,56,40,62,44,71,314,0.568,25,35,70,95,55,45,325,0.16783216783216784,1.0
35,55,40,45,40,60,275,0.35714285714285715,80,110,60,150,130,70,600,0.5042016806722689,1.0
106,110,90,154,90,130,680,0.926829268292683,76,48,48,57,62,34,325,0.11688311688311688,1.0
55,130,115,50,50,75,475,0.5982142857142857,39,52,43,60,50,65,309,0.49107142857142855,2.0
70,105,105,50,40,20,390,0.33587786259541985,53,54,53,37,46,45,288,0.3090909090909091,1.0
50,50,40,50,40,64,294,0.45588235294117646,60,40,50,75,85,95,405,0.6044776119402985,1.0
75,140,65,112,65,110,567,0.9140625,43,70,48,50,60,38,309,0.2391304347826087,2.0
65,60,110,130,95,65,525,0.47761194029850745,55,66,44,44,56,85,350,0.6888888888888889,1.0
60,52,168,47,138,30,495,0.19834710743801653,50,64,50,45,50,41,300,0.22727272727272727,1.0
40,27,60,37,50,66,280,0.36220472440944884,45,50,45,115,55,95,405,0.6936936936936937,0.25
70,65,60,90,75,90,450,0.6571428571428571,45,40,60,40,75,50,310,0.2926829268292683,0.5
55,85,55,50,55,60,360,0.4233576642335766,95,110,80,70,80,50,485,0.37209302325581395,2.0
80,105,65,60,75,130,515,0.9645390070921985,50,72,35,35,35,65,292,0.5373134328358209,0.5
45,60,45,25,45,55,275,0.29,110,80,90,95,90,65,530,0.5033557046979866,1.0
85,97,66,105,66,65,484,0.47107438016528924,91,72,90,129,90,108,580,0.8620689655172413,0.5
50,85,55,65,65,90,410,0.7478260869565218,60,85,60,85,60,55,405,0.3673469387755102,0.5
108,100,121,81,95,95,600,0.7476635514018691,70,120,65,45,85,125,510,0.9747899159663865,1.0
84,86,88,111,101,60,530,0.4634146341463415,73,115,60,60,60,90,458,0.6694915254237288,1.0
55,55,45,63,45,45,308,0.25,50,65,64,44,48,43,314,0.2196969696969697,0.5
65,105,60,60,70,95,455,63.0,39,52,43,60,50,65,309,0.5041322314049587,1.0
60,55,145,75,150,40,525,0.2,64,78,52,78,52,81,405,0.6422764227642277,0.5
105,30,105,140,105,55,540,0.3524590163934426,80,135,85,70,95,150,615,0.9844961240310077,0.5
60,59,85,79,105,36,424,0.16666666666666666,55,112,45,74,45,70,401,0.559322033898305,0.5
60,60,50,40,50,75,335,0.5882352941176471,71,82,64,64,59,112,452,0.9327731092436975,1.0
91,72,90,129,90,108,580,0.8925619834710744,105,95,80,40,80,90,490,0.753968253968254,2.0
63,63,47,41,41,74,329,0.56,75,90,50,110,80,95,500,0.7985611510791367,0.5
71,73,88,120,89,59,500,0.43537414965986393,30,56,35,25,35,72,253,0.48148148148148145,1.0
90,95,105,165,110,45,610,0.2890625,58,50,145,95,105,30,483,0.2459016393442623,1.0
90,95,95,70,90,70,510,0.5230769230769231,40,40,55,40,70,55,300,0.40939597315436244,1.0
100,134,110,95,100,61,600,0.4057971014492754,75,125,75,30,75,85,465,0.625,0.25
60,67,85,77,75,116,480,0.8888888888888888,43,70,48,50,60,38,309,0.2391304347826087,0.5
30,105,90,25,25,50,325,0.2773722627737226,75,80,85,110,90,50,490,0.3548387096774194,0.5
40,70,130,60,130,25,455,0.17355371900826447,74,48,76,83,81,104,466,0.7913043478260869,2.0
85,90,80,70,80,130,535,0.9262295081967213,40,30,32,50,52,65,269,0.3671875,2.0
70,75,80,135,80,135,575,0.917910447761194,70,55,95,95,110,65,490,0.48872180451127817,1.0
50,100,150,100,150,50,600,0.37142857142857144,40,55,30,30,30,85,270,0.688,2.0
72,60,30,20,30,25,237,0.11570247933884298,95,23,48,23,48,23,260,0.046153846153846156,0.5
54,45,47,75,98,52,371,0.39669421487603307,63,63,47,41,41,74,329,0.56,1.0
78,104,78,159,115,100,634,0.8444444444444444,105,95,80,40,80,90,490,0.753968253968254,1.0
110,80,90,95,90,65,530,0.5033557046979866,25,20,15,105,55,90,310,0.32407407407407407,1.0
95,65,110,60,130,65,525,0.5275590551181102,50,20,40,20,40,20,190,0.0962962962962963,0.5
28,25,25,45,35,40,198,0.16083916083916083,110,65,105,55,95,80,510,0.6258503401360545,0.0
40,40,35,50,100,70,335,0.5031847133757962,70,50,30,95,135,105,485,0.8040540540540541,1.0
100,73,83,73,83,55,467,0.371900826446281,45,90,20,65,20,65,305,0.5116279069767442,1.0
55,55,45,63,45,45,308,0.25,35,35,35,35,35,35,210,0.13385826771653545,1.0
78,84,78,109,85,100,534,0.8646616541353384,80,120,70,110,70,80,530,0.6422764227642277,1.0
65,80,140,40,70,70,465,0.5223880597014925,50,85,85,55,55,50,380,0.3902439024390244,0.125
90,93,55,70,55,55,418,0.3819444444444444,60,69,95,69,95,36,424,0.2608695652173913,4.0
50,95,95,35,110,70,455,0.5179856115107914,70,110,75,145,85,145,630,0.9444444444444444,1.0
50,95,90,95,90,180,600,0.9172413793103448,60,60,50,40,50,75,335,0.5882352941176471,1.0
97,165,60,65,50,58,495,0.3902439024390244,60,60,40,65,45,35,305,0.15833333333333333,1.0
38,30,85,55,65,30,303,0.21428571428571427,79,103,120,135,115,78,630,0.5763888888888888,1.0
65,95,100,60,50,50,420,0.34959349593495936,45,50,45,115,55,95,405,0.6936936936936937,1.0
35,55,35,30,30,35,220,0.23684210526315788,30,35,30,100,35,80,310,0.4765625,2.0
60,25,35,70,80,60,330,0.3076923076923077,71,120,95,120,95,99,600,0.8203125,0.5
60,90,55,90,80,110,485,0.8677685950413223,62,44,50,44,50,55,305,0.3629032258064516,4.0
105,95,75,85,75,74,509,0.5714285714285714,71,73,88,120,89,59,500,0.43537414965986393,0.5
75,100,66,60,66,115,482,0.918918918918919,40,45,65,100,120,90,460,0.5588235294117647,1.0
70,55,75,45,65,60,370,0.45901639344262296,150,80,44,90,54,80,498,0.625,2.0
85,76,64,45,55,90,415,0.6739130434782609,70,43,53,43,53,40,302,0.19090909090909092,1.0
90,92,87,75,85,76,505,0.5409836065573771,69,55,45,55,55,15,294,0.11666666666666667,1.0
70,100,70,105,75,40,460,0.23214285714285715,115,115,85,90,75,100,580,0.8134328358208955,1.0
60,50,70,50,90,65,385,0.39568345323741005,70,95,85,55,65,70,440,0.5,1.0
50,65,85,35,35,55,325,0.32575757575757575,30,56,35,25,35,72,253,0.48148148148148145,1.0
80,82,83,100,100,80,525,0.6742424242424242,75,75,75,125,95,40,485,0.15671641791044777,1.0
55,66,44,44,56,85,350,0.6888888888888889,60,60,60,35,35,30,280,0.11194029850746269,1.0
73,100,60,100,60,65,458,0.42657342657342656,95,85,85,65,65,35,430,0.2571428571428571,0.5
70,130,100,55,80,65,500,0.608,28,25,25,45,35,40,198,0.16083916083916083,0.5
255,10,10,75,135,55,540,0.3125,90,93,55,70,55,55,418,0.3819444444444444,1.0
80,110,60,150,130,70,600,0.5042016806722689,60,50,40,85,75,95,405,0.7540983606557377,1.0
95,75,180,130,80,30,590,0.13793103448275862,123,77,72,99,92,58,521,0.4621212121212121,2.0
30,45,135,45,90,30,375,0.09285714285714286,105,105,75,65,100,50,500,0.37593984962406013,1.0
123,100,62,97,81,68,531,0.4806201550387597,40,50,45,70,45,70,320,0.5517241379310345,0.5
45,60,45,25,45,55,275,0.29,55,20,35,20,45,75,250,0.37681159420289856,1.0
50,65,107,105,107,86,520,0.6991150442477876,40,30,35,50,70,55,280,0.28205128205128205,1.0
45,60,40,70,50,45,310,0.2846715328467153,60,80,50,50,50,40,330,0.23853211009174313,1.0
67,89,116,79,116,33,500,0.2624113475177305,75,90,90,140,90,115,600,0.9481481481481482,0.0
65,125,100,55,70,85,500,0.6532258064516129,60,100,89,55,69,112,485,0.9298245614035088,0.5
75,80,70,65,75,90,455,0.7578125,77,120,90,60,90,48,485,0.2785714285714286,1.0
76,48,48,57,62,34,325,0.11688311688311688,60,40,80,60,45,40,325,0.23529411764705882,0.5
108,112,118,68,72,47,525,0.2916666666666667,75,140,65,112,65,110,567,0.9140625,0.0
114,85,70,85,80,30,464,0.2066115702479339,60,130,80,60,60,70,460,0.5153846153846153,1.0
75,75,60,83,60,60,413,0.39344262295081966,60,130,80,60,60,70,460,0.5153846153846153,0.5
45,25,50,25,25,35,205,0.13076923076923078,65,40,50,125,60,30,370,0.07258064516129033,2.0
45,75,37,70,55,83,365,0.6183206106870229,35,55,35,30,30,35,220,0.23684210526315788,1.0
43,80,65,50,35,35,308,0.14193548387096774,100,100,90,150,140,90,670,0.71875,0.5
75,80,60,65,90,102,472,0.8625954198473282,80,80,50,40,50,25,325,0.176056338028169,1.0
95,135,80,110,80,100,600,0.8248175182481752,73,95,62,85,65,85,465,0.6666666666666666,1.0
80,85,95,30,30,25,345,0.2857142857142857,35,55,40,45,40,60,275,0.35714285714285715,2.0
35,60,44,40,54,55,288,0.366412213740458,50,50,62,40,62,65,329,0.4188034188034188,0.5
95,109,105,75,85,56,525,0.34513274336283184,55,50,40,40,40,75,300,0.5945945945945946,1.0
40,30,30,40,50,30,220,0.07936507936507936,60,90,140,50,50,40,430,0.2535211267605634,2.0
50,95,95,35,110,70,455,0.5179856115107914,52,65,55,58,62,60,352,0.4482758620689655,1.0
20,10,230,10,230,5,505,0.0,40,20,30,40,80,55,265,0.22764227642276422,2.0
125,58,58,76,76,67,460,0.515625,75,38,38,56,56,67,330,0.5263157894736842,0.5
73,76,75,81,100,100,505,0.8110236220472441,60,62,80,63,80,60,405,0.4336283185840708,2.0
70,55,75,45,65,60,370,0.45901639344262296,65,65,65,50,50,90,385,0.72,1.0
40,40,40,70,40,20,250,0.032520325203252036,45,65,34,40,34,45,263,0.2589928057553957,1.0
60,110,70,60,60,100,460,0.8461538461538461,110,85,95,80,95,50,515,0.2713178294573643,1.0
120,100,85,30,85,45,465,0.22448979591836735,45,75,60,40,30,50,300,0.304,1.0
55,65,95,95,45,85,440,0.6610169491525424,40,80,100,30,30,20,300,0.11851851851851852,4.0
45,30,40,105,50,20,290,0.031007751937984496,70,40,50,55,50,25,290,0.061068702290076333,1.0
65,83,57,95,85,105,490,0.8914728682170543,30,45,55,70,55,85,340,0.5633802816901409,2.0
70,80,102,80,102,40,474,0.2677165354330709,60,40,80,60,45,40,325,0.23529411764705882,8.0
76,48,48,57,62,34,325,0.11688311688311688,65,95,57,100,85,93,495,0.7441860465116279,2.0
45,30,50,65,50,45,285,0.13821138211382114,60,79,105,59,85,36,424,0.17054263565891473,2.0
75,75,60,83,60,60,413,0.39344262295081966,43,80,65,50,35,35,308,0.14193548387096774,0.5
90,100,70,110,150,80,600,0.6037735849056604,46,57,40,40,40,50,273,0.25,1.0
75,95,67,125,95,83,540,0.7117117117117117,35,20,65,40,65,20,245,0.02459016393442623,1.0
126,131,95,131,98,99,680,0.8102189781021898,100,100,125,110,50,50,535,0.384,2.0
55,70,40,60,40,40,305,0.26956521739130435,105,150,90,150,90,95,680,0.8285714285714286,4.0
50,35,55,25,25,15,205,0.05263157894736842,50,65,107,105,107,86,520,0.7758620689655172,1.0
30,40,55,40,55,60,280,0.3237410071942446,75,125,70,125,70,115,580,0.9037037037037037,0.25
100,50,50,76,96,70,442,0.5,80,45,65,90,110,80,470,0.5462962962962963,1.0
40,80,100,30,30,20,300,0.11851851851851852,50,72,35,35,35,65,292,0.5373134328358209,0.5
50,160,110,160,110,110,700,0.8854961832061069,120,120,120,120,120,120,720,0.9344262295081968,1.0
50,50,77,95,77,91,440,0.5916666666666667,60,79,105,59,85,36,424,0.17054263565891473,0.0
45,100,45,45,45,10,290,0.2949640287769784,62,55,52,109,94,109,481,0.7833333333333333,2.0
50,85,85,55,55,50,380,0.3902439024390244,28,25,25,45,35,40,198,0.16083916083916083,0.5
75,65,55,65,55,69,384,0.43548387096774194,90,90,85,125,90,100,580,0.768595041322314,0.0
30,30,42,30,42,70,244,0.4230769230769231,80,100,123,122,120,80,625,0.56,2.0
60,69,95,69,95,36,424,0.2608695652173913,85,73,70,73,115,67,483,0.5126050420168067,2.0
70,20,50,20,50,40,250,0.1557377049180328,50,92,108,92,108,35,485,0.2457627118644068,2.0
50,50,50,50,50,50,300,0.30708661417322836,92,105,90,125,90,98,600,0.8217054263565892,2.0
60,90,70,60,120,40,440,0.27419354838709675,250,5,5,35,105,50,450,0.15306122448979592,1.0
83,80,80,135,80,121,579,0.9444444444444444,85,76,64,45,55,90,415,0.6739130434782609,1.0
65,65,65,50,50,90,385,0.72,61,84,65,70,70,70,420,0.5,0.5
38,36,38,32,36,57,237,0.3893805309734513,58,70,45,40,45,42,300,0.25925925925925924,1.0
91,134,95,100,100,80,600,0.6304347826086957,30,80,90,55,45,55,355,0.4295774647887324,0.5
67,82,62,46,48,43,348,0.22033898305084745,84,71,43,71,43,48,360,0.25874125874125875,2.0
160,110,65,65,110,30,540,0.35714285714285715,70,80,70,80,70,110,480,0.6594202898550725,0.0
30,65,100,45,25,40,305,0.1891891891891892,100,100,90,150,140,90,670,0.71875,0.5
69,55,45,55,55,15,294,0.11666666666666667,64,88,50,88,50,106,446,0.9111111111111111,1.0
75,75,75,125,95,40,485,0.15671641791044777,70,94,50,94,50,66,424,0.48148148148148145,1.0
60,85,60,85,60,55,405,0.3673469387755102,75,55,70,55,95,110,460,0.8444444444444444,1.0
95,75,110,100,80,30,490,0.15267175572519084,50,50,40,50,40,64,294,0.45588235294117646,0.5
105,140,55,30,55,95,480,0.8195488721804511,85,76,64,45,55,90,415,0.6739130434782609,1.0
90,55,75,60,75,30,385,0.13970588235294118,85,70,80,97,80,123,535,0.9304347826086956,1.0
67,58,57,81,67,101,431,0.8790322580645161,70,110,180,60,60,50,530,0.4117647058823529,0.5
50,40,85,40,65,25,305,0.08870967741935484,90,92,75,92,85,60,494,0.49586776859504134,2.0
50,92,108,92,108,35,485,0.2457627118644068,75,75,60,83,60,60,413,0.39344262295081966,1.0
75,95,125,45,75,95,510,0.8257575757575758,70,62,67,55,55,56,365,0.38513513513513514,2.0
74,48,76,83,81,104,466,0.7322834645669292,70,55,75,45,65,60,370,0.45901639344262296,0.0
70,70,40,60,40,60,340,0.4247787610619469,90,55,75,60,75,30,385,0.13970588235294118,1.0
45,25,50,25,25,35,205,0.13076923076923078,65,95,75,55,55,85,430,0.6933333333333334,0.25
55,95,55,35,75,115,430,0.9380530973451328,165,75,80,40,45,65,470,0.5151515151515151,0.5
62,55,52,109,94,109,481,0.7833333333333333,55,70,55,40,55,85,360,0.7073170731707317,1.0
40,40,40,70,40,20,250,0.032520325203252036,60,45,50,90,80,70,395,0.625,2.0
46,57,40,40,40,50,273,0.25,90,95,105,165,110,45,610,0.2890625,1.0
120,70,120,75,130,85,600,0.6694915254237288,70,40,50,55,50,25,290,0.061068702290076333,1.0
72,60,30,20,30,25,237,0.11570247933884298,72,85,70,65,70,58,420,0.41304347826086957,2.0
70,135,105,60,105,20,495,0.5806451612903226,105,30,105,140,105,55,540,0.3524590163934426,0.5
60,60,40,65,45,35,305,0.15833333333333333,55,70,55,40,55,85,360,0.7073170731707317,1.0
49,66,70,44,55,51,335,0.4260869565217391,78,84,78,109,85,100,534,0.8620689655172413,0.5
75,125,75,30,75,85,465,0.625,80,130,100,160,120,110,700,0.8981481481481481,0.5
45,35,50,70,50,30,280,0.15753424657534246,80,90,80,130,110,110,600,0.856,0.5
75,89,85,55,65,36,405,0.29545454545454547,38,35,40,27,25,35,200,0.08208955223880597,0.5
60,40,60,40,60,35,295,0.18055555555555555,64,78,52,78,52,81,405,0.6422764227642277,0.5
79,115,70,125,80,111,580,0.864,65,73,55,47,75,85,400,0.6846846846846847,2.0
50,47,50,57,50,65,319,0.463768115942029,65,105,60,60,70,95,455,63.0,0.5
95,75,180,130,80,30,590,0.13793103448275862,74,108,133,83,65,32,495,0.32142857142857145,1.0
57,80,91,80,87,75,470,0.5737704918032787,60,80,50,40,40,30,300,0.15328467153284672,0.5
95,125,79,60,100,81,540,0.6165413533834586,80,105,65,60,75,130,515,0.9645390070921985,1.0
75,98,63,98,63,101,498,0.849624060150376,170,90,45,90,45,60,500,0.427536231884058,0.5
45,35,45,62,53,35,275,0.11851851851851852,65,70,60,65,65,115,440,0.8583333333333333,1.0
50,52,48,65,50,55,320,0.33098591549295775,35,55,40,45,40,60,275,0.35714285714285715,1.0
65,90,115,45,115,58,488,0.5041322314049587,85,90,80,70,80,130,535,0.9262295081967213,0.25
105,140,95,55,65,45,505,0.3,75,95,122,58,75,69,494,0.5725806451612904,0.0
60,59,85,79,105,36,424,0.16666666666666666,130,85,80,85,95,60,535,0.43884892086330934,2.0
100,50,80,60,80,50,420,0.34375,85,97,66,105,66,65,484,0.47107438016528924,1.0
89,125,90,115,80,101,600,0.8725490196078431,170,90,45,90,45,60,500,0.427536231884058,1.0
60,60,60,85,85,85,435,0.631578947368421,80,90,80,130,110,110,600,0.856,2.0
83,80,75,70,70,101,479,0.8615384615384616,70,135,105,60,105,20,495,0.5806451612903226,0.5
105,140,95,55,65,45,505,0.3,78,104,78,159,115,100,634,0.8444444444444444,0.5
130,70,35,70,35,60,400,0.4017857142857143,90,110,80,100,80,95,555,0.7982456140350878,2.0
100,128,90,77,77,128,600,0.959349593495935,65,65,45,75,45,95,390,0.72,0.25
150,100,120,100,120,90,680,0.6666666666666666,55,55,55,85,55,30,335,0.1320754716981132,2.0
92,105,90,125,90,98,600,0.8217054263565892,50,85,55,65,65,90,410,0.7478260869565218,1.0
46,87,60,30,40,57,320,0.37777777777777777,80,50,100,100,200,50,580,0.2357142857142857,1.0
70,105,105,50,40,20,390,0.33587786259541985,55,84,105,114,75,52,485,0.2890625,1.0
50,53,62,58,63,44,330,0.13709677419354838,85,80,90,105,95,60,515,0.49074074074074076,1.0
75,123,67,95,85,95,540,0.7642276422764228,45,49,65,49,65,45,318,0.275,0.5
60,60,50,40,50,75,335,0.5882352941176471,55,69,85,32,35,28,304,0.09302325581395349,1.0
70,40,50,55,50,25,290,0.061068702290076333,105,180,100,180,100,115,780,0.9477611940298507,2.0
100,123,75,57,75,80,510,0.6923076923076923,35,85,45,35,35,75,310,0.6492537313432836,1.0
75,100,95,40,70,110,490,0.8717948717948718,85,97,66,105,66,65,484,0.47107438016528924,1.0
110,65,75,125,85,30,490,0.15,45,45,55,45,55,63,308,0.4594594594594595,1.0
65,75,90,97,123,44,494,0.1987179487179487,170,90,45,90,45,60,500,0.427536231884058,1.0
55,55,55,85,55,30,335,0.1320754716981132,75,80,60,65,90,102,472,0.8625954198473282,1.0
60,79,105,59,85,36,424,0.17054263565891473,41,56,40,62,44,71,314,0.568,1.0
70,85,140,85,70,20,470,0.272,115,45,20,45,25,20,270,0.11538461538461539,1.0
50,53,48,53,48,64,316,0.358974358974359,79,115,70,125,80,111,580,0.8468468468468469,1.0
48,72,48,72,48,48,336,0.25984251968503935,50,80,95,10,45,10,290,0.232,1.0
65,63,45,45,45,45,308,0.2595419847328244,70,60,75,110,75,90,480,0.7165354330708661,2.0
40,29,45,29,45,36,224,0.14634146341463414,95,60,79,100,125,81,540,0.6201550387596899,1.0
50,150,50,150,50,150,600,0.9339622641509434,90,85,100,95,125,85,580,0.6834532374100719,1.0
59,45,40,35,40,31,250,0.14285714285714285,45,85,70,40,40,60,340,0.5229357798165137,0.5
41,64,45,50,50,50,300,0.36752136752136755,30,80,90,55,45,55,355,0.4295774647887324,1.0
50,180,20,180,20,150,600,0.9029850746268657,85,110,76,65,82,56,474,0.3933333333333333,1.0
59,45,40,35,40,31,250,0.14285714285714285,58,89,77,45,45,48,362,0.3177570093457944,0.5
65,125,100,60,70,70,490,0.6099290780141844,100,128,90,77,77,128,600,0.959349593495935,0.5
30,105,90,25,25,50,325,0.2773722627737226,64,88,50,88,50,106,446,0.9111111111111111,1.0
50,92,108,92,108,35,485,0.2457627118644068,70,40,50,55,50,25,290,0.061068702290076333,1.0
81,102,77,85,75,85,505,0.5642857142857143,45,30,40,105,50,20,290,0.031007751937984496,1.0
100,100,100,100,100,100,600,0.8758169934640523,84,71,43,71,43,48,360,0.25874125874125875,1.0
90,120,100,150,120,100,680,0.7718120805369127,50,50,120,80,80,30,410,0.07258064516129033,4.0
40,45,40,65,40,65,295,0.5661764705882353,50,70,100,40,40,30,330,0.2222222222222222,1.0
60,60,60,85,85,85,435,0.631578947368421,70,140,230,60,80,50,630,0.32432432432432434,1.0
35,65,35,65,35,65,300,0.46621621621621623,50,105,125,55,95,50,480,0.375886524822695,1.0
60,85,40,30,45,68,328,0.6422018348623854,45,90,20,65,20,65,305,0.5116279069767442,1.0
60,90,140,50,50,40,430,0.2535211267605634,95,117,80,65,70,92,519,0.8409090909090909,0.5
55,70,45,70,50,60,350,0.45,76,48,48,57,62,34,325,0.11688311688311688,0.5
70,92,65,80,55,98,460,0.8090909090909091,95,155,109,70,130,81,640,0.6788321167883211,0.5
80,100,200,50,100,50,580,0.3472222222222222,80,70,65,80,120,100,515,0.8034188034188035,1.0
75,95,67,125,95,83,540,0.7117117117117117,100,100,100,100,100,100,600,0.8758169934640523,2.0
106,190,100,154,100,130,780,0.9259259259259259,60,70,50,100,50,65,395,0.5217391304347826,0.25
40,30,32,50,52,65,269,0.3671875,70,55,75,45,65,60,370,0.45901639344262296,1.0
60,70,65,125,105,90,515,0.6911764705882353,85,120,70,50,60,100,485,0.8308823529411765,0.5
20,40,90,30,90,25,295,0.11363636363636363,76,104,71,104,71,108,534,0.912751677852349,1.0
99,68,83,72,87,51,460,0.417910447761194,85,110,90,45,90,80,500,0.6206896551724138,1.0
70,110,70,115,70,90,525,0.75,55,40,50,65,85,40,335,0.3181818181818182,0.0
40,70,40,35,40,60,285,0.392,65,65,65,50,50,90,385,0.72,1.0
100,70,70,65,65,45,415,0.1897810218978102,80,80,50,40,50,25,325,0.176056338028169,1.0
40,60,30,31,31,70,262,0.4492753623188406,60,100,115,70,85,90,520,0.7557251908396947,0.25
75,90,140,60,60,40,465,0.3008130081300813,50,105,125,55,95,50,480,0.375886524822695,0.0625
165,75,80,40,45,65,470,0.5151515151515151,55,104,105,94,75,52,485,0.36363636363636365,0.5
55,47,52,40,40,41,275,0.16806722689075632,250,5,5,35,105,50,450,0.15306122448979592,1.0
70,110,180,60,60,50,530,0.4117647058823529,70,75,80,135,80,135,575,0.917910447761194,0.5
61,72,57,55,55,65,365,0.3984375,51,65,65,80,75,59,395,0.4365079365079365,1.0
60,85,60,85,60,55,405,0.3673469387755102,54,63,52,83,56,97,405,0.7697841726618705,0.5
65,50,35,115,95,95,455,0.7333333333333333,110,78,73,76,71,60,468,0.3333333333333333,2.0
65,60,70,85,75,40,395,0.1796875,60,50,50,60,70,50,340,0.28346456692913385,1.0
95,155,109,70,130,81,640,0.6788321167883211,110,160,110,80,110,100,670,0.8591549295774648,1.0
70,85,65,105,85,120,530,0.9262295081967213,50,70,160,70,160,90,600,0.7417218543046358,1.0
50,70,50,50,50,40,310,0.16296296296296298,108,100,121,81,95,95,600,0.7476635514018691,1.0
65,55,115,100,40,60,435,0.3798449612403101,50,65,107,105,107,86,520,0.7758620689655172,2.0
25,20,15,105,55,90,310,0.32407407407407407,80,80,50,40,50,25,325,0.176056338028169,2.0
95,80,105,40,70,100,490,0.8046875,73,100,60,100,60,65,458,0.42657342657342656,1.0
60,80,50,40,40,30,300,0.15328467153284672,40,20,30,40,80,55,265,0.22764227642276422,1.0
65,136,94,54,96,135,580,0.9612403100775194,65,63,45,45,45,45,308,0.2595419847328244,1.0
50,100,150,100,150,50,600,0.37142857142857144,80,80,80,80,80,80,480,0.5606060606060606,1.0
78,104,78,159,115,100,634,0.8444444444444444,60,60,75,60,75,80,410,0.7321428571428571,2.0
100,150,120,120,100,90,680,0.6493506493506493,85,56,77,50,77,78,423,0.53125,0.0
125,130,90,130,90,95,660,0.7734375,100,100,100,100,100,100,600,0.831858407079646,1.0
60,80,50,40,40,30,300,0.15328467153284672,55,112,45,74,45,70,401,0.559322033898305,1.0
35,46,34,35,45,20,215,0.072,60,69,95,69,95,36,424,0.2608695652173913,0.5
70,80,70,80,70,110,480,0.6594202898550725,97,165,60,65,50,58,495,0.3902439024390244,1.0
75,95,60,65,60,115,470,0.8778625954198473,100,103,75,120,75,127,600,0.940677966101695,1.0
85,110,76,65,82,56,474,0.3933333333333333,65,75,90,97,123,44,494,0.1987179487179487,0.25
50,100,150,100,150,50,600,0.37142857142857144,70,110,75,145,85,145,630,0.9444444444444444,2.0
30,45,55,70,55,85,340,0.5633802816901409,100,100,100,100,100,100,600,0.831858407079646,1.0
99,68,83,72,87,51,460,0.417910447761194,95,80,105,40,70,100,490,0.8046875,1.0
20,10,55,15,20,80,200,0.17985611510791366,80,130,100,160,120,110,700,0.8981481481481481,0.5
35,35,35,35,35,35,210,0.13385826771653545,70,75,80,135,80,135,575,0.917910447761194,1.0
45,50,35,55,75,40,300,0.21367521367521367,35,55,40,45,40,60,275,0.35714285714285715,1.0
73,115,60,60,60,90,458,0.6694915254237288,70,135,105,60,105,20,495,0.5806451612903226,0.5
41,64,45,50,50,50,300,0.36752136752136755,60,62,50,62,60,40,334,0.18181818181818182,1.0
76,65,45,92,42,91,411,0.7449664429530202,55,50,45,135,95,120,500,0.7714285714285715,1.0
45,50,45,115,55,95,405,0.6936936936936937,80,160,60,170,130,80,680,0.6180555555555556,1.0
50,50,40,30,30,50,250,0.2781954887218045,60,75,85,100,85,115,520,0.8992248062015504,0.5
35,80,50,50,70,120,405,0.84375,80,120,70,110,70,80,530,0.6422764227642277,2.0
70,85,70,60,70,50,405,0.28378378378378377,40,20,30,40,80,55,265,0.22764227642276422,0.0
60,55,90,145,90,80,520,0.6071428571428571,50,50,62,40,62,65,329,0.4188034188034188,1.0
70,55,65,95,85,70,440,0.5307692307692308,30,56,35,25,35,72,253,0.48148148148148145,1.0
20,25,45,70,90,60,310,0.30833333333333335,67,58,57,81,67,101,431,0.8790322580645161,1.0
55,70,45,70,50,60,350,0.45,125,120,90,170,100,95,700,0.78125,1.0
60,25,35,70,80,60,330,0.3076923076923077,37,25,41,25,41,25,194,0.08870967741935484,1.0
90,132,105,132,105,30,594,0.4246575342465753,60,52,168,47,138,30,495,0.19834710743801653,0.5
100,100,125,110,50,50,535,0.384,130,65,60,110,95,65,525,0.5227272727272727,2.0
35,70,55,45,55,25,285,0.09420289855072464,110,130,80,70,60,80,530,0.5862068965517241,2.0
165,75,80,40,45,65,470,0.5151515151515151,59,59,58,90,70,73,409,0.5826086956521739,2.0
70,20,50,20,50,40,250,0.1557377049180328,123,100,62,97,81,68,531,0.4806201550387597,0.5
50,72,35,35,35,65,292,0.5373134328358209,60,59,85,79,105,36,424,0.16666666666666666,0.25
95,85,85,65,65,35,430,0.2571428571428571,60,150,50,150,50,60,520,0.5,2.0
50,20,55,25,25,30,205,0.09774436090225563,40,70,130,60,130,25,455,0.17355371900826447,0.5
70,100,115,30,65,30,410,0.24390243902439024,52,65,55,58,62,60,352,0.4482758620689655,2.0
74,108,133,83,65,32,495,0.32142857142857145,64,66,68,81,76,50,405,0.25190839694656486,0.5
48,72,48,72,48,48,336,0.25984251968503935,50,160,110,160,110,110,700,0.8854961832061069,1.0
65,75,90,97,123,44,494,0.1987179487179487,35,55,40,50,50,90,320,0.6838235294117647,1.0
103,60,126,80,126,50,545,0.36363636363636365,85,76,64,45,55,90,415,0.6739130434782609,1.0
65,95,75,55,55,85,430,0.6933333333333334,50,40,85,40,65,25,305,0.08870967741935484,1.0
106,110,90,154,90,130,680,0.926829268292683,43,70,48,50,60,38,309,0.2391304347826087,1.0
100,110,90,85,90,60,535,0.47794117647058826,50,65,107,105,107,86,520,0.7272727272727273,0.0
90,92,87,75,85,76,505,0.5409836065573771,70,55,95,95,110,65,490,0.48872180451127817,1.0
35,46,34,35,45,20,215,0.072,75,98,63,98,63,101,498,0.8091603053435115,1.0
45,45,55,45,55,63,308,0.4594594594594595,91,90,129,90,72,108,580,0.9140625,0.5
90,92,87,75,85,76,505,0.5409836065573771,110,130,80,70,60,80,530,0.5862068965517241,0.5
90,85,100,95,125,85,580,0.6834532374100719,50,65,64,44,48,43,314,0.2196969696969697,0.5
75,38,38,56,56,67,330,0.5263157894736842,65,150,40,15,80,145,495,0.9663865546218487,1.0
73,100,60,100,60,65,458,0.42657342657342656,50,20,55,25,25,30,205,0.09774436090225563,1.0
45,63,37,65,55,95,360,0.8055555555555556,30,65,100,45,25,40,305,0.1891891891891892,2.0
65,95,75,55,55,85,430,0.6933333333333334,75,95,60,65,60,115,470,0.8778625954198473,1.0
60,50,70,80,80,140,480,0.8449612403100775,42,52,67,39,56,50,306,0.2868217054263566,2.0
25,35,70,95,55,45,325,0.16783216783216784,100,180,160,150,90,90,770,0.7520661157024794,0.0
75,87,63,87,63,98,473,0.865546218487395,95,124,78,69,71,58,495,0.37398373983739835,2.0
80,50,100,100,200,50,580,0.2357142857142857,55,50,40,40,40,75,300,0.5945945945945946,1.0
45,50,43,40,38,62,278,0.40441176470588236,80,105,105,105,105,80,580,0.5939849624060151,1.0
50,70,100,40,40,30,330,0.2222222222222222,60,90,140,50,50,40,430,0.2535211267605634,0.5
85,135,130,60,80,25,515,0.40540540540540543,39,52,43,60,50,65,309,0.49107142857142855,2.0
60,45,50,90,80,70,395,0.625,170,90,45,90,45,60,500,0.427536231884058,1.0
55,50,40,40,40,75,300,0.5945945945945946,40,55,70,45,60,30,300,0.10619469026548672,0.5
101,72,72,99,89,29,462,0.1937984496124031,100,50,80,60,80,50,420,0.34375,1.0
75,90,140,60,60,40,465,0.3008130081300813,103,93,67,71,61,84,479,0.7142857142857143,1.0
85,105,85,40,50,40,405,0.211864406779661,95,80,105,40,70,100,490,0.8046875,2.0
55,75,60,75,60,103,428,0.7982456140350878,45,100,45,45,45,10,290,0.2949640287769784,0.0
50,50,40,30,30,50,250,0.2781954887218045,50,53,48,53,48,64,316,0.4076923076923077,1.0
50,60,60,60,60,30,320,0.11290322580645161,123,100,62,97,81,68,531,0.4806201550387597,1.0
80,80,80,80,80,80,480,0.5606060606060606,65,150,60,115,60,115,565,0.935251798561151,1.0
90,93,55,70,55,55,418,0.3819444444444444,45,60,40,70,50,45,310,0.2846715328467153,0.5
60,105,60,120,60,105,510,0.8849557522123894,75,98,63,98,63,101,498,0.849624060150376,1.0
40,45,40,65,40,65,295,0.5661764705882353,95,135,80,110,80,100,600,0.8248175182481752,1.0
55,50,40,40,40,75,300,0.5945945945945946,77,120,90,60,90,48,485,0.2785714285714286,1.0
80,100,80,80,80,100,520,0.9051724137931034,55,85,55,50,55,60,360,0.4233576642335766,1.0
45,20,50,60,120,50,345,0.24074074074074073,75,75,55,105,85,30,425,0.1619718309859155,1.0
50,95,95,35,110,70,455,0.5179856115107914,80,52,50,90,50,89,411,0.6666666666666666,0.25
71,95,85,110,95,79,535,0.664,55,40,40,65,45,35,280,0.16428571428571428,1.0
95,75,110,100,80,30,490,0.15267175572519084,70,140,70,110,65,105,560,0.95,0.0
55,55,50,45,65,55,325,0.37373737373737376,37,25,41,25,41,25,194,0.08870967741935484,1.0
45,85,50,55,50,65,350,0.5076923076923077,61,72,57,55,55,65,365,0.3984375,0.5
95,60,79,100,125,81,540,0.6201550387596899,49,55,42,42,37,85,310,0.6068376068376068,1.0
45,35,50,70,50,30,280,0.15753424657534246,78,104,78,159,115,100,634,0.8444444444444444,0.25
55,50,40,40,40,75,300,0.5945945945945946,75,125,100,70,80,45,495,0.33035714285714285,0.5
90,95,95,70,90,70,510,0.5230769230769231,63,63,47,41,41,74,329,0.56,1.0
95,75,110,100,80,30,490,0.15267175572519084,70,120,40,95,40,95,460,0.8106060606060606,0.0
67,89,116,79,116,33,500,0.2624113475177305,71,82,64,64,59,112,452,0.9327731092436975,1.0
45,50,35,55,75,40,300,0.21367521367521367,105,95,80,40,80,90,490,0.753968253968254,1.0
70,70,40,60,40,60,340,0.4247787610619469,55,40,85,80,105,40,405,0.23622047244094488,0.25
64,78,52,78,52,81,405,0.6422764227642277,60,95,80,60,80,30,405,0.19480519480519481,2.0
55,55,85,65,85,35,380,0.2014388489208633,66,41,77,61,87,23,355,0.12096774193548387,1.0
110,123,65,100,65,65,528,0.5217391304347826,40,35,30,120,70,105,400,0.6692307692307692,0.5
50,50,40,50,40,64,294,0.45588235294117646,100,128,90,77,77,128,600,0.959349593495935,1.0
80,80,50,40,50,25,325,0.176056338028169,90,90,85,125,90,100,580,0.768595041322314,1.0
78,92,75,74,63,118,500,0.8842975206611571,51,65,65,80,75,59,395,0.4365079365079365,2.0
74,48,76,83,81,104,466,0.7322834645669292,50,80,95,10,45,10,290,0.232,1.0
84,86,88,111,101,60,530,0.4634146341463415,85,60,65,135,105,100,550,0.7518248175182481,1.0
70,55,55,80,60,45,365,0.2222222222222222,75,90,50,110,80,95,500,0.7985611510791367,1.0
60,100,89,55,69,112,485,0.9298245614035088,65,125,100,60,70,70,490,0.6099290780141844,0.0
38,41,40,50,65,65,299,0.4108527131782946,100,100,90,150,140,90,670,0.71875,0.5
60,55,90,145,90,80,520,0.6071428571428571,40,45,35,65,55,70,310,0.4482758620689655,2.0
80,115,80,65,55,93,488,0.7846153846153846,50,120,53,35,110,87,455,0.640625,2.0
106,130,90,110,154,90,680,0.719626168224299,67,58,57,81,67,101,431,0.8790322580645161,0.5
65,60,110,130,95,65,525,0.47761194029850745,60,100,115,70,85,90,520,0.7557251908396947,0.5
50,120,53,35,110,87,455,0.640625,60,110,70,60,60,100,460,0.8461538461538461,1.0
106,110,90,154,90,130,680,0.926829268292683,41,50,37,50,37,66,281,0.5175438596491229,0.0
65,125,100,60,70,70,490,0.6099290780141844,67,125,40,30,30,58,350,0.3431372549019608,2.0
125,120,90,170,100,95,700,0.78125,80,52,50,90,50,89,411,0.6666666666666666,2.0
90,92,75,92,85,60,494,0.49586776859504134,76,65,45,92,42,91,411,0.7449664429530202,1.0
78,65,68,112,154,75,552,0.628099173553719,80,160,60,170,130,80,680,0.6180555555555556,2.0
60,80,50,50,50,40,330,0.23853211009174313,50,85,40,85,40,35,335,0.1746031746031746,1.0
70,75,60,105,60,105,475,0.88,80,70,65,80,120,100,515,0.8034188034188035,2.0
65,110,130,60,65,95,525,0.8278145695364238,70,70,70,70,70,70,420,0.5289256198347108,1.0
110,80,90,95,90,65,530,0.5033557046979866,95,80,105,40,70,100,490,0.8046875,1.0
65,125,100,60,70,70,490,0.6099290780141844,95,95,85,125,65,55,520,0.3894736842105263,2.0
150,100,120,100,120,90,680,0.6666666666666666,35,80,50,50,70,120,405,0.84375,1.0
40,60,40,40,40,30,250,0.0948905109489051,30,40,70,70,25,60,295,0.41353383458646614,1.0
44,75,35,63,33,45,295,0.2647058823529412,80,82,78,95,80,85,500,0.6869565217391305,1.0
91,134,95,100,100,80,600,0.6304347826086957,70,65,60,90,75,90,450,0.6571428571428571,2.0
45,50,35,55,75,40,300,0.21367521367521367,55,55,55,85,55,30,335,0.1320754716981132,1.0
55,35,50,55,110,85,390,0.6277372262773723,50,50,150,50,150,50,500,0.2571428571428571,0.25
126,131,95,131,98,99,680,0.8102189781021898,110,78,73,76,71,60,468,0.3333333333333333,1.0
86,68,72,109,66,106,507,0.8099173553719008,75,80,95,90,100,50,490,0.2158273381294964,2.0
150,160,100,95,65,100,670,0.8866666666666667,70,83,50,37,50,60,350,0.3360655737704918,1.0
65,65,65,50,50,90,385,0.72,105,30,105,140,105,55,540,0.3524590163934426,2.0
30,35,30,100,35,80,310,0.4765625,50,65,90,35,35,15,290,0.14678899082568808,1.0
67,89,116,79,116,33,500,0.2624113475177305,105,95,75,85,75,74,509,0.5714285714285714,1.0
100,164,150,95,120,71,700,0.5645161290322581,68,85,65,165,135,100,618,0.8083333333333333,1.0
108,112,118,68,72,47,525,0.2916666666666667,70,95,85,55,65,70,440,0.5,2.0
100,100,100,100,100,100,600,0.8602941176470589,130,65,60,110,95,65,525,0.5227272727272727,2.0
80,80,80,80,80,80,480,0.6015037593984962,90,60,70,75,70,45,410,0.23880597014925373,0.25
55,20,35,20,45,75,250,0.37681159420289856,50,70,160,70,160,90,600,0.7417218543046358,1.0
35,46,34,35,45,20,215,0.072,65,90,65,61,61,100,442,0.8373983739837398,1.0
59,110,150,45,49,35,448,0.3333333333333333,65,90,50,85,45,55,390,0.371900826446281,1.0
70,85,70,60,70,50,405,0.28378378378378377,76,104,71,104,71,108,534,0.912751677852349,4.0
35,55,40,50,50,90,320,0.6838235294117647,80,125,75,40,95,85,500,0.6911764705882353,1.0
80,92,65,65,80,68,450,0.4824561403508772,75,80,55,25,35,35,305,0.18666666666666668,1.0
70,60,62,80,82,60,414,0.4375,55,47,52,40,40,41,275,0.16806722689075632,0.5
68,165,95,65,115,110,618,0.8615384615384616,50,48,43,46,41,60,288,0.47297297297297297,2.0
75,98,63,98,63,101,498,0.849624060150376,35,60,44,40,54,55,288,0.366412213740458,1.0
95,124,78,69,71,58,495,0.37398373983739835,95,75,80,100,110,30,490,0.24242424242424243,1.0
59,110,150,45,49,35,448,0.3333333333333333,75,125,75,30,75,85,465,0.625,1.0
60,40,50,75,85,95,405,0.6044776119402985,35,35,40,35,55,50,250,0.40336134453781514,1.0
100,90,130,45,65,55,485,0.4253731343283582,70,70,115,130,90,60,535,0.5338983050847458,0.5
60,45,70,45,90,95,405,0.7304964539007093,90,60,70,75,70,45,410,0.23880597014925373,2.0
100,5,5,15,65,30,220,0.07692307692307693,70,110,70,115,70,90,525,0.75,0.5
40,45,40,62,60,60,307,0.33884297520661155,55,55,45,63,45,45,308,0.25,0.5
65,85,70,75,70,40,405,0.203125,40,20,30,40,80,55,265,0.22764227642276422,2.0
70,130,100,55,80,65,500,0.608,80,105,105,105,105,80,580,0.5939849624060151,2.0
65,155,120,65,90,105,600,0.8677685950413223,65,80,65,35,65,60,370,0.38405797101449274,1.0
35,40,100,90,55,35,355,0.1796875,60,90,140,50,50,40,430,0.2535211267605634,1.0
50,45,45,35,35,50,260,0.23529411764705882,65,65,60,110,95,130,525,0.9253731343283582,1.0
86,76,86,116,56,95,515,0.7982456140350878,30,80,90,55,45,55,355,0.4295774647887324,0.5
35,55,40,50,50,90,320,0.6838235294117647,45,30,35,20,20,45,195,0.14782608695652175,1.0
95,110,95,40,95,55,490,0.40336134453781514,40,60,30,31,31,70,262,0.4492753623188406,1.0
50,47,50,57,50,65,319,0.463768115942029,100,123,75,57,75,80,510,0.6923076923076923,1.0
110,80,90,95,90,65,530,0.5033557046979866,37,25,41,25,41,25,194,0.08870967741935484,1.0
77,120,90,60,90,48,485,0.2785714285714286,126,131,95,131,98,99,680,0.8102189781021898,1.0
50,53,48,53,48,64,316,0.358974358974359,95,75,110,100,80,30,490,0.15267175572519084,0.5
55,55,55,85,55,30,335,0.1320754716981132,70,65,60,90,75,90,450,0.6571428571428571,2.0
45,85,50,55,50,65,350,0.5076923076923077,60,85,49,60,49,60,363,0.4444444444444444,1.0
56,61,65,48,45,38,313,0.17567567567567569,95,60,79,100,125,81,540,0.6201550387596899,2.0
62,48,66,59,57,49,341,0.33884297520661155,126,131,95,131,98,99,680,0.8294573643410853,1.0
60,65,70,85,75,40,395,0.21705426356589147,25,35,70,95,55,45,325,0.16783216783216784,0.0
55,20,35,20,45,75,250,0.37681159420289856,105,30,105,140,105,55,540,0.3524590163934426,1.0
120,100,85,30,85,45,465,0.22448979591836735,60,25,35,70,80,60,330,0.3076923076923077,0.5
45,67,60,35,50,63,320,0.5128205128205128,55,20,35,20,45,75,250,0.37681159420289856,1.0
55,47,52,40,40,41,275,0.16806722689075632,100,70,70,65,65,45,415,0.1897810218978102,1.0
64,51,23,51,23,28,240,0.11363636363636363,63,60,55,50,50,71,349,0.5289256198347108,1.0
85,76,64,45,55,90,415,0.6739130434782609,60,70,65,125,105,90,515,0.6911764705882353,1.0
55,84,105,114,75,52,485,0.2890625,45,49,65,49,65,45,318,0.275,0.5
60,110,70,60,60,100,460,0.8461538461538461,50,53,48,53,48,64,316,0.46153846153846156,1.0
60,65,80,170,95,130,600,0.8625954198473282,38,35,35,65,55,50,278,0.2647058823529412,4.0
65,136,94,54,96,135,580,0.9612403100775194,68,125,65,65,115,80,518,0.6277372262773723,0.5
100,73,83,73,83,55,467,0.371900826446281,55,47,52,40,40,41,275,0.16806722689075632,0.5
95,75,180,130,80,30,590,0.13793103448275862,60,65,80,170,95,130,600,0.8625954198473282,2.0
30,42,118,42,88,30,350,0.112,91,72,90,129,90,108,580,0.8925619834710744,0.25
85,73,70,73,115,67,483,0.5126050420168067,65,60,70,85,75,40,395,0.1796875,1.0
95,100,85,108,70,70,528,0.5652173913043478,70,45,48,60,65,35,323,0.15748031496062992,1.0
50,72,35,35,35,65,292,0.5373134328358209,115,45,20,45,25,20,270,0.11538461538461539,0.5
64,66,68,81,76,50,405,0.25190839694656486,44,50,91,24,86,10,305,0.1981981981981982,0.5
100,123,75,57,75,80,510,0.6923076923076923,56,61,65,48,45,38,313,0.17567567567567569,2.0
105,140,55,30,55,95,480,0.8195488721804511,45,25,50,25,25,35,205,0.13076923076923078,2.0
50,105,79,35,110,76,455,0.6214285714285714,61,84,65,70,70,70,420,0.5,1.0
79,115,70,125,80,111,580,0.8468468468468469,50,50,40,30,30,50,250,0.2781954887218045,1.0
64,78,52,78,52,81,405,0.6422764227642277,75,103,80,70,80,92,500,0.7933884297520661,2.0
108,112,118,68,72,47,525,0.2916666666666667,38,30,41,30,41,60,240,0.2897196261682243,1.0
40,55,80,35,60,30,300,0.15037593984962405,55,95,115,45,45,35,390,0.2116788321167883,4.0
75,89,85,55,65,36,405,0.29545454545454547,60,40,60,95,60,55,370,0.4222222222222222,0.5
73,95,62,85,65,85,465,0.6666666666666666,60,75,85,100,85,115,520,0.8992248062015504,1.0
110,65,75,125,85,30,490,0.15,78,81,71,74,69,126,499,0.9090909090909091,1.0
71,73,88,120,89,59,500,0.43537414965986393,30,30,42,30,42,70,244,0.4230769230769231,1.0
39,52,43,60,50,65,309,0.49107142857142855,55,69,85,32,35,28,304,0.09302325581395349,2.0
89,145,90,105,80,91,600,0.8549618320610687,65,70,60,65,65,115,440,0.8583333333333333,1.0
45,50,55,75,65,30,320,0.06293706293706294,48,72,48,72,48,48,336,0.25984251968503935,1.0
55,75,50,40,40,80,340,0.6302521008403361,55,65,35,60,30,85,330,0.6126126126126126,1.0
125,170,100,120,90,95,700,0.77,97,165,60,65,50,58,495,0.3902439024390244,1.0
20,10,230,10,230,5,505,0.0,90,130,80,65,85,55,505,0.4396551724137931,0.25
83,80,75,70,70,101,479,0.8615384615384616,50,85,85,55,55,50,380,0.3902439024390244,0.25
105,180,100,180,100,115,780,0.9477611940298507,70,120,40,95,40,95,460,0.8106060606060606,1.0
86,76,86,116,56,95,515,0.7982456140350878,77,59,50,67,63,46,362,0.23140495867768596,0.5
50,53,48,53,48,64,316,0.46153846153846156,70,55,65,95,85,70,440,0.5307692307692308,0.5
75,95,67,125,95,83,540,0.7117117117117117,55,130,115,50,50,75,475,0.5982142857142857,0.5
110,160,110,80,110,100,670,0.8591549295774648,60,100,85,80,85,100,510,0.7007874015748031,1.0
55,70,55,40,55,85,360,0.7073170731707317,75,125,75,30,75,85,465,0.625,1.0
61,90,45,50,50,160,456,0.9230769230769231,50,120,53,35,110,87,455,0.640625,1.0
45,100,45,45,45,10,290,0.2949640287769784,80,80,80,80,80,80,480,0.5606060606060606,1.0
55,20,35,20,45,75,250,0.37681159420289856,76,48,48,57,62,34,325,0.11688311688311688,1.0
120,100,85,30,85,45,465,0.22448979591836735,55,55,45,63,45,45,308,0.25,1.0
105,180,100,180,100,115,780,0.9477611940298507,59,59,58,90,70,73,409,0.5826086956521739,1.0
123,77,72,99,92,58,521,0.4621212121212121,110,65,105,55,95,80,510,0.6258503401360545,4.0
75,140,65,112,65,110,567,0.9140625,58,64,58,80,65,80,405,0.5423728813559322,2.0
60,85,60,50,50,125,430,0.9090909090909091,90,130,80,65,85,55,505,0.4396551724137931,2.0
40,60,40,40,40,30,250,0.0948905109489051,65,60,110,130,95,65,525,0.47761194029850745,1.0
40,65,40,80,40,65,330,0.5038167938931297,35,85,45,35,35,75,310,0.6492537313432836,1.0
70,120,40,95,40,95,460,0.8106060606060606,90,55,75,60,75,30,385,0.13970588235294118,1.0
91,72,90,129,90,108,580,0.8620689655172413,54,63,52,83,56,97,405,0.7697841726618705,0.5
75,95,60,65,60,115,470,0.8778625954198473,100,100,100,100,100,100,600,0.8758169934640523,0.5
45,35,50,70,50,30,280,0.15753424657534246,43,30,55,40,65,97,330,0.6030534351145038,2.0
100,100,100,100,100,100,600,0.8602941176470589,50,75,45,40,45,60,315,0.4380165289256198,0.5
35,65,35,65,35,65,300,0.46621621621621623,54,45,47,75,98,52,371,0.39669421487603307,1.0
68,90,65,50,55,82,410,0.6165413533834586,95,124,78,69,71,58,495,0.37398373983739835,1.0
100,120,120,150,100,90,680,0.7880794701986755,79,115,70,125,80,111,580,0.8468468468468469,1.0
95,155,109,70,130,81,640,0.6788321167883211,65,65,65,50,50,90,385,0.72,0.5
58,64,58,80,65,80,405,0.5423728813559322,75,98,63,98,63,101,498,0.8091603053435115,2.0
30,35,30,100,35,80,310,0.4765625,40,45,40,62,60,60,307,0.33884297520661155,1.0
50,65,90,35,35,15,290,0.14678899082568808,45,20,50,60,120,50,345,0.24074074074074073,0.5
114,85,70,85,80,30,464,0.2066115702479339,50,47,50,57,50,65,319,0.463768115942029,0.5
75,80,55,25,35,35,305,0.18666666666666668,35,70,55,45,55,25,285,0.09420289855072464,0.5
71,82,64,64,59,112,452,0.9327731092436975,75,70,90,70,105,80,490,0.656,1.0
55,35,50,55,110,85,390,0.6277372262773723,70,83,50,37,50,60,350,0.3360655737704918,0.5
75,125,75,30,75,85,465,0.625,104,91,63,91,73,68,490,0.5118110236220472,2.0
64,51,23,51,23,28,240,0.11363636363636363,40,30,32,50,52,65,269,0.3671875,1.0
85,120,70,50,60,100,485,0.8308823529411765,130,85,80,85,95,60,535,0.43884892086330934,1.0
106,150,70,194,120,140,780,0.952,50,95,90,95,90,180,600,0.9172413793103448,0.5
67,89,116,79,116,33,500,0.2624113475177305,80,80,80,80,80,80,480,0.5606060606060606,0.5
55,85,55,50,55,60,360,0.4233576642335766,40,45,65,100,120,90,460,0.5588235294117647,1.0
55,69,85,32,35,28,304,0.09302325581395349,40,80,100,30,30,20,300,0.11851851851851852,2.0
70,80,70,80,70,110,480,0.6594202898550725,75,75,55,105,85,30,425,0.1619718309859155,2.0
50,75,35,70,30,40,300,0.21296296296296297,100,180,160,150,90,90,770,0.7520661157024794,0.5
80,85,95,30,30,25,345,0.2857142857142857,35,35,35,35,35,35,210,0.13385826771653545,0.5
46,57,40,40,40,50,273,0.25,49,55,42,42,37,85,310,0.6068376068376068,1.0
35,35,40,35,55,50,250,0.40336134453781514,75,100,66,60,66,115,482,0.918918918918919,1.0
40,20,30,40,80,55,265,0.22764227642276422,100,100,100,100,100,100,600,0.8805970149253731,1.0
95,145,130,120,90,120,700,0.9398496240601504,50,50,77,95,77,91,440,0.5916666666666667,0.5
65,70,60,65,65,115,440,0.8583333333333333,50,85,125,85,115,20,480,0.4306569343065693,0.0
35,85,45,35,35,75,310,0.6492537313432836,45,100,45,45,45,10,290,0.2949640287769784,1.0
110,123,65,100,65,65,528,0.5217391304347826,67,58,57,81,67,101,431,0.8790322580645161,0.5
45,85,70,40,40,60,340,0.5229357798165137,79,85,60,55,60,71,410,0.60431654676259,0.5
75,85,200,55,65,30,510,0.16778523489932887,38,41,40,50,65,65,299,0.4108527131782946,1.0
80,135,85,70,95,150,615,0.9844961240310077,65,65,45,75,45,95,390,0.72,8.0
125,130,90,130,90,95,660,0.7734375,55,75,60,75,60,103,428,0.7982456140350878,2.0
28,25,25,45,35,40,198,0.16083916083916083,62,77,62,50,42,65,358,0.4838709677419355,1.0
70,65,65,55,55,70,380,0.5,65,100,70,80,80,105,500,0.8666666666666667,1.0
55,65,95,95,45,85,440,0.6610169491525424,59,74,50,35,50,35,303,0.3125,2.0
38,35,40,27,25,35,200,0.08208955223880597,30,40,55,40,55,60,280,0.3237410071942446,1.0
70,145,88,140,70,112,625,0.8888888888888888,100,150,90,180,160,90,770,0.7348484848484849,0.5
40,35,30,120,70,105,400,0.6692307692307692,50,25,28,45,55,15,218,0.0625,1.0
62,44,50,44,50,55,305,0.3629032258064516,30,42,118,42,88,30,350,0.112,0.5
80,80,80,80,80,80,480,0.5606060606060606,108,170,115,120,95,92,700,0.7083333333333334,1.0
54,63,52,83,56,97,405,0.7697841726618705,83,80,80,135,80,121,579,0.9444444444444444,1.0
30,40,70,70,25,60,295,0.41353383458646614,65,45,55,45,70,45,325,0.24369747899159663,0.5
54,63,52,83,56,97,405,0.7697841726618705,114,85,70,85,80,30,464,0.2066115702479339,0.5
70,85,140,85,70,20,470,0.272,115,45,20,45,25,20,270,0.11538461538461539,1.0
70,110,75,145,85,145,630,0.9444444444444444,35,60,44,40,54,55,288,0.366412213740458,0.5
50,50,77,95,77,91,440,0.5916666666666667,57,24,86,24,86,23,300,0.12727272727272726,2.0
80,70,70,90,100,70,480,0.5609756097560976,70,110,80,55,80,105,500,0.8794326241134752,0.25
40,65,40,80,40,65,330,0.5038167938931297,83,106,65,86,65,85,490,0.6640625,0.5
82,80,86,85,75,72,480,0.6183206106870229,40,45,35,30,40,55,245,0.3793103448275862,0.5
58,64,58,80,65,80,405,0.609271523178808,70,83,50,37,50,60,350,0.3360655737704918,1.0
50,65,107,105,107,86,520,0.7313432835820896,63,63,47,41,41,74,329,0.56,0.5
75,90,50,110,80,95,500,0.7985611510791367,70,62,67,55,55,56,365,0.38513513513513514,1.0
38,35,40,27,25,35,200,0.08208955223880597,80,92,65,65,80,68,450,0.4824561403508772,1.0
45,60,30,80,50,65,330,0.4603174603174603,165,75,80,40,45,65,470,0.5151515151515151,0.5
80,100,70,60,70,95,475,0.7416666666666667,110,160,110,80,110,100,670,0.8591549295774648,1.0
80,110,60,150,130,70,600,0.5042016806722689,50,47,50,57,50,65,319,0.463768115942029,1.0
50,75,45,40,45,60,315,0.4380165289256198,85,80,70,135,75,90,535,0.7006802721088435,1.0
20,40,90,30,90,25,295,0.11363636363636363,45,80,100,35,37,28,325,0.3125,2.0
28,25,25,45,35,40,198,0.16083916083916083,130,70,35,70,35,60,400,0.4017857142857143,1.0
60,69,95,69,95,36,424,0.2608695652173913,30,30,42,30,42,70,244,0.4230769230769231,0.5
45,50,43,40,38,62,278,0.40441176470588236,120,70,120,75,130,85,600,0.6694915254237288,1.0
73,95,62,85,65,85,465,0.6666666666666666,35,35,35,35,35,35,210,0.13385826771653545,1.0
45,45,35,20,30,20,195,0.07246376811594203,30,56,35,25,35,72,253,0.48148148148148145,1.0
1,90,45,30,30,40,236,0.33064516129032256,64,78,52,78,52,81,405,0.6422764227642277,0.25
44,58,44,58,44,61,309,0.41964285714285715,66,65,48,62,57,52,350,0.36220472440944884,2.0
90,100,70,110,150,80,600,0.6037735849056604,108,100,121,81,95,95,600,0.7476635514018691,2.0
100,120,120,150,100,90,680,0.7880794701986755,50,50,77,95,77,91,440,0.5916666666666667,0.5
70,83,50,37,50,60,350,0.3360655737704918,60,67,85,77,75,116,480,0.8888888888888888,2.0
85,135,130,60,80,25,515,0.40540540540540543,75,75,130,75,130,95,580,0.7479674796747967,1.0
150,120,100,120,100,90,680,0.664179104477612,90,60,60,40,40,40,330,0.29545454545454547,1.0
85,76,64,45,55,90,415,0.6739130434782609,75,95,67,125,95,83,540,0.7117117117117117,1.0
60,48,45,43,90,42,328,0.21897810218978103,72,95,67,103,71,122,530,0.9606299212598425,0.0
70,62,67,55,55,56,365,0.38513513513513514,45,85,50,55,50,65,350,0.5076923076923077,1.0
115,140,130,55,55,40,535,0.4519230769230769,50,45,45,35,35,50,260,0.23529411764705882,1.0
45,30,40,105,50,20,290,0.031007751937984496,80,82,78,95,80,85,500,0.6869565217391305,1.0
63,120,85,90,55,55,468,0.2809917355371901,90,92,87,75,85,76,505,0.5409836065573771,2.0
63,63,47,41,41,74,329,0.56,50,65,107,105,107,86,520,0.7758620689655172,1.0
54,66,70,44,55,46,335,0.4214876033057851,100,100,100,100,100,100,600,0.8602941176470589,0.5
60,85,40,30,45,68,328,0.6422018348623854,46,57,40,40,40,50,273,0.25,2.0
70,94,50,94,50,66,424,0.48148148148148145,110,65,75,125,85,30,490,0.15,2.0
95,75,180,130,80,30,590,0.13793103448275862,85,80,70,135,75,90,535,0.7006802721088435,1.0
80,80,50,40,50,25,325,0.176056338028169,65,150,40,15,80,145,495,0.9663865546218487,0.5
50,72,35,35,35,65,292,0.5373134328358209,100,73,83,73,83,55,467,0.371900826446281,2.0
60,45,50,90,80,70,395,0.625,75,69,72,114,100,104,534,0.8253968253968254,1.0
30,56,35,25,35,72,253,0.48148148148148145,80,135,85,70,95,150,615,0.9844961240310077,0.5
80,100,70,60,70,95,475,0.7416666666666667,70,85,70,60,70,50,405,0.28378378378378377,4.0
111,83,68,92,82,39,475,0.1774193548387097,165,75,80,40,45,65,470,0.5151515151515151,0.5
90,90,85,125,90,100,580,0.768595041322314,65,65,60,130,95,110,525,0.823943661971831,1.0
50,105,79,35,110,76,455,0.6214285714285714,25,20,15,105,55,90,310,0.32407407407407407,0.5
85,105,85,40,50,40,405,0.211864406779661,91,129,90,72,90,108,580,0.8536585365853658,2.0
70,85,65,105,85,120,530,0.9262295081967213,44,75,35,63,33,45,295,0.2647058823529412,1.0
85,135,130,60,80,25,515,0.40540540540540543,60,150,50,150,50,60,520,0.5,0.5
35,55,40,45,40,60,275,0.35714285714285715,50,50,120,80,80,30,410,0.07258064516129033,1.0
95,75,80,100,110,30,490,0.24242424242424243,80,110,120,130,90,70,600,0.6198347107438017,1.0
60,65,60,130,75,110,500,0.7719298245614035,49,66,70,44,55,51,335,0.4260869565217391,2.0
65,47,55,73,75,85,400,0.65,90,65,65,40,40,15,315,0.19672131147540983,2.0
110,135,60,50,65,88,508,0.7744360902255639,60,62,80,63,80,60,405,0.4336283185840708,0.5
85,105,100,79,83,78,530,0.5869565217391305,50,35,55,25,25,15,205,0.05263157894736842,1.0
83,80,75,70,70,101,479,0.8615384615384616,60,100,115,70,85,90,520,0.7557251908396947,0.25
55,112,45,74,45,70,401,0.559322033898305,100,120,120,150,100,90,680,0.7880794701986755,0.25
90,65,65,40,40,15,315,0.19672131147540983,58,70,45,40,45,42,300,0.25925925925925924,2.0
60,75,100,55,80,50,420,0.3088235294117647,66,65,48,62,57,52,350,0.36220472440944884,1.0
95,145,130,120,90,120,700,0.9398496240601504,75,125,230,55,95,30,610,0.3448275862068966,0.25
100,180,160,150,90,90,770,0.7520661157024794,50,95,180,85,45,70,525,0.5298507462686567,1.0
105,180,100,180,100,115,780,0.9477611940298507,85,110,76,65,82,56,474,0.3933333333333333,2.0
100,75,115,90,115,85,580,0.6446280991735537,74,100,72,90,72,46,454,0.24561403508771928,0.5
80,105,105,105,105,80,580,0.5939849624060151,50,95,180,85,45,70,525,0.5298507462686567,1.0
73,115,60,60,60,90,458,0.6694915254237288,105,95,75,85,75,74,509,0.5714285714285714,1.0
50,105,125,55,95,50,480,0.375886524822695,30,30,42,30,42,70,244,0.4230769230769231,1.0
44,38,39,61,79,42,303,0.2251655629139073,60,50,40,85,75,95,405,0.7540983606557377,1.0
88,107,122,74,75,64,530,0.4596774193548387,110,80,90,95,90,65,530,0.5033557046979866,4.0
103,60,86,60,86,50,445,0.3458646616541353,55,55,85,65,85,35,380,0.2014388489208633,0.5
60,105,60,120,60,105,510,0.8849557522123894,45,50,55,75,65,30,320,0.06293706293706294,1.0
40,35,30,120,70,105,400,0.6692307692307692,40,30,50,55,55,100,330,0.584070796460177,1.0
70,105,105,50,40,20,390,0.33587786259541985,70,60,125,115,70,55,495,0.35507246376811596,1.0
65,65,60,130,95,110,525,0.823943661971831,60,40,50,75,85,95,405,0.6044776119402985,1.0
120,120,120,120,120,120,720,0.9344262295081968,65,95,75,55,55,85,430,0.6933333333333334,1.0
70,105,105,50,40,20,390,0.33587786259541985,40,40,55,40,70,55,300,0.40939597315436244,0.5
60,45,70,45,90,95,405,0.7304964539007093,95,70,73,95,90,60,483,0.3983739837398374,1.0
69,55,45,55,55,15,294,0.11666666666666667,105,30,105,140,105,55,540,0.3524590163934426,0.5
65,40,70,80,140,70,465,0.5954198473282443,45,25,50,25,25,35,205,0.13076923076923078,2.0
80,82,78,95,80,85,500,0.6869565217391305,55,45,45,25,25,15,210,0.048,1.0
59,74,50,35,50,35,303,0.3125,78,104,78,159,115,100,634,0.8444444444444444,0.0
55,40,85,80,105,40,405,0.23622047244094488,50,50,40,30,30,50,250,0.2781954887218045,1.0
106,90,130,90,154,110,680,0.8699186991869918,75,75,95,75,95,113,528,0.9015151515151515,2.0
45,75,37,70,55,83,365,0.6183206106870229,46,87,60,30,40,57,320,0.37777777777777777,0.5
38,30,41,30,41,60,240,0.2897196261682243,80,80,90,110,130,110,600,0.8721804511278195,1.0
63,63,47,41,41,74,329,0.56,1,90,45,30,30,40,236,0.33064516129032256,1.0
130,65,60,110,95,65,525,0.5227272727272727,60,48,45,43,90,42,328,0.21897810218978103,1.0
65,60,110,130,95,65,525,0.47761194029850745,45,75,60,40,30,50,300,0.304,2.0
80,80,50,40,50,25,325,0.176056338028169,120,70,120,75,130,85,600,0.6694915254237288,1.0
55,85,122,58,75,99,494,0.8099173553719008,63,60,55,50,50,71,349,0.5289256198347108,0.0
65,70,60,65,65,115,440,0.8583333333333333,70,40,50,55,50,25,290,0.061068702290076333,1.0
90,130,80,65,85,55,505,0.4396551724137931,123,100,62,97,81,68,531,0.4806201550387597,1.0
59,74,50,35,50,35,303,0.3125,85,105,55,85,50,115,495,0.9032258064516129,1.0
71,95,85,110,95,79,535,0.664,60,75,85,100,85,115,520,0.8992248062015504,0.5
65,90,115,45,115,58,488,0.5041322314049587,65,130,60,95,110,65,525,0.5303030303030303,1.0
38,30,41,30,41,60,240,0.2897196261682243,30,45,135,45,90,30,375,0.09285714285714286,0.5
45,63,37,65,55,95,360,0.8055555555555556,49,49,56,49,61,66,330,0.5190839694656488,2.0
65,47,55,73,75,85,400,0.65,91,90,72,90,129,108,580,0.896,1.0
71,95,85,110,95,79,535,0.664,95,109,105,75,85,56,525,0.34513274336283184,4.0
65,75,90,97,123,44,494,0.1987179487179487,77,59,50,67,63,46,362,0.23140495867768596,0.5
35,55,40,45,40,60,275,0.35714285714285715,108,130,95,80,85,102,600,0.7637795275590551,0.0
50,53,48,53,48,64,316,0.4076923076923077,104,91,63,91,73,68,490,0.5118110236220472,1.0
95,65,65,110,130,60,525,0.4016393442622951,35,85,45,35,35,75,310,0.6492537313432836,1.0
78,65,68,112,154,75,552,0.628099173553719,75,69,72,114,100,104,534,0.8253968253968254,0.5
69,69,76,69,86,91,460,0.6554621848739496,50,65,90,35,35,15,290,0.14678899082568808,1.0
50,35,55,25,25,15,205,0.05263157894736842,110,78,73,76,71,60,468,0.3333333333333333,1.0
40,30,32,50,52,65,269,0.3671875,55,70,45,70,50,60,350,0.45,1.0
95,155,109,70,130,81,640,0.6788321167883211,40,30,32,50,52,65,269,0.3671875,0.5
50,75,70,35,70,48,348,0.29357798165137616,65,90,115,45,115,58,488,0.5041322314049587,0.5
80,105,65,60,75,130,515,0.9645390070921985,65,90,120,85,70,60,490,0.43410852713178294,1.0
44,38,39,61,79,42,303,0.2251655629139073,84,86,88,111,101,60,530,0.4634146341463415,0.5
75,95,95,95,95,85,540,0.6470588235294118,100,150,110,95,110,70,635,0.5923076923076923,1.0
70,80,102,80,102,40,474,0.2677165354330709,20,40,15,35,35,60,205,0.34285714285714286,0.5
40,35,30,20,20,50,195,0.23423423423423423,100,120,100,150,120,90,680,0.728,0.5
150,160,100,95,65,100,670,0.8866666666666667,95,110,80,70,80,50,485,0.37209302325581395,1.0
110,65,105,55,95,80,510,0.6258503401360545,60,85,60,50,50,125,430,0.9090909090909091,1.0
75,95,125,45,75,95,510,0.8257575757575758,40,45,40,65,40,65,295,0.5661764705882353,1.0
65,80,65,35,65,60,370,0.38405797101449274,64,115,65,83,63,65,455,0.5323741007194245,0.0
30,80,90,55,45,55,355,0.4295774647887324,55,40,50,65,85,40,335,0.3181818181818182,0.5
60,85,60,50,50,125,430,0.9090909090909091,70,135,105,60,105,20,495,0.5806451612903226,0.5
40,50,90,30,55,65,330,0.44680851063829785,65,95,100,60,50,50,420,0.34959349593495936,1.0
55,69,85,32,35,28,304,0.09302325581395349,85,50,95,120,115,80,545,0.5793650793650794,2.0
50,30,55,65,55,20,275,0.13675213675213677,50,95,180,85,45,70,525,0.5298507462686567,1.0
30,45,59,30,39,57,260,0.2803030303030303,60,75,85,100,85,115,520,0.8992248062015504,2.0
71,73,88,120,89,59,500,0.43537414965986393,80,100,70,50,60,45,405,0.25806451612903225,1.0
90,85,75,115,100,115,580,0.9381443298969072,45,30,35,20,20,45,195,0.14782608695652175,1.0
58,89,77,45,45,48,362,0.3177570093457944,70,70,115,130,90,60,535,0.5338983050847458,0.25
55,45,45,25,25,15,210,0.048,50,50,40,30,30,50,250,0.2781954887218045,2.0
78,81,71,74,69,126,499,0.9090909090909091,45,30,40,105,50,20,290,0.031007751937984496,1.0
80,160,80,130,80,100,630,0.8455284552845529,90,120,120,60,60,50,500,0.35294117647058826,1.0
67,57,55,77,55,114,425,0.8879310344827587,50,50,40,50,40,64,294,0.45588235294117646,1.0
60,45,70,45,90,95,405,0.7304964539007093,50,160,110,160,110,110,700,0.8854961832061069,1.0
38,36,38,32,36,57,237,0.3893805309734513,100,100,100,100,100,100,600,0.831858407079646,1.0
103,60,86,60,86,50,445,0.3458646616541353,36,50,50,65,60,44,305,0.16363636363636364,1.0
116,55,85,107,95,29,487,0.06818181818181818,106,130,90,110,154,90,680,0.719626168224299,1.0
45,75,60,40,30,50,300,0.304,90,95,95,70,90,70,510,0.5230769230769231,1.0
65,63,45,45,45,45,308,0.2595419847328244,50,35,55,25,25,15,205,0.05263157894736842,2.0
75,70,90,70,105,80,490,0.656,30,45,59,30,39,57,260,0.2803030303030303,2.0
45,90,20,65,20,65,305,0.5116279069767442,65,95,100,60,50,50,420,0.34959349593495936,0.5
104,91,63,91,73,68,490,0.5118110236220472,40,30,30,40,50,30,220,0.07936507936507936,1.0
76,48,48,57,62,34,325,0.11688311688311688,60,85,69,60,69,77,420,0.518796992481203,1.0
45,80,100,35,37,28,325,0.3125,45,60,40,70,50,45,310,0.2846715328467153,0.5
80,135,85,70,95,150,615,0.9844961240310077,55,70,55,40,55,85,360,0.7073170731707317,1.0
40,65,95,60,45,35,340,0.13986013986013987,100,150,120,120,100,90,680,0.6493506493506493,1.0
70,150,140,65,100,75,600,0.55,70,90,45,15,45,50,315,0.3629032258064516,0.25
60,85,60,50,50,125,430,0.9090909090909091,80,115,80,65,55,93,488,0.7846153846153846,1.0
100,100,100,100,100,100,600,0.8778625954198473,80,110,120,130,90,70,600,0.6198347107438017,0.25
55,45,43,55,43,72,313,0.5853658536585366,80,80,90,110,130,110,600,0.8721804511278195,0.5
60,50,100,85,70,65,430,0.47580645161290325,70,55,95,95,110,65,490,0.48872180451127817,1.0
74,48,76,83,81,104,466,0.7322834645669292,65,65,60,110,95,130,525,0.9253731343283582,1.0
83,80,75,70,70,101,479,0.8615384615384616,95,65,65,110,130,60,525,0.4016393442622951,1.0
55,20,35,20,45,75,250,0.37681159420289856,40,45,40,65,40,65,295,0.5661764705882353,1.0
91,90,72,90,129,108,580,0.896,78,84,78,109,85,100,534,0.8646616541353384,0.125
40,40,35,50,100,70,335,0.5031847133757962,63,63,47,41,41,74,329,0.56,0.5
65,65,60,110,95,130,525,0.9253731343283582,63,63,47,41,41,74,329,0.56,1.0
65,95,75,55,55,85,430,0.6933333333333334,70,145,88,140,70,112,625,0.8888888888888888,0.0
50,50,40,30,30,50,250,0.2781954887218045,55,70,55,40,55,85,360,0.7073170731707317,1.0
45,60,30,80,50,65,330,0.4603174603174603,60,110,70,60,60,100,460,0.8461538461538461,1.0
95,109,105,75,85,56,525,0.34513274336283184,71,95,85,110,95,79,535,0.664,1.0
30,42,118,42,88,30,350,0.112,70,90,90,135,90,125,600,0.9401709401709402,1.0
75,89,85,55,65,36,405,0.29545454545454547,65,150,60,115,60,115,565,0.935251798561151,1.0
90,93,55,70,55,55,418,0.3819444444444444,58,64,58,80,65,80,405,0.5423728813559322,0.5
86,81,97,81,107,43,495,0.203125,85,97,66,105,66,65,484,0.47107438016528924,1.0
50,70,160,70,160,90,600,0.7417218543046358,40,60,30,31,31,70,262,0.4492753623188406,1.0
83,80,75,70,70,101,479,0.8615384615384616,91,90,129,90,72,108,580,0.9140625,0.5
37,25,41,25,41,25,194,0.08870967741935484,45,30,35,20,20,45,195,0.14782608695652175,1.0
10,55,25,35,45,95,265,0.5396825396825397,62,48,54,63,60,68,355,0.5178571428571429,1.0
61,84,65,70,70,70,420,0.5,65,125,60,95,60,105,510,0.9236641221374046,1.0
80,130,100,160,120,110,700,0.8981481481481481,35,46,34,35,45,20,215,0.072,1.0
125,130,90,130,90,95,660,0.7734375,62,50,58,73,54,72,369,0.4435483870967742,0.5
60,95,80,60,80,30,405,0.19480519480519481,45,53,70,40,60,42,310,0.25735294117647056,0.5
70,60,125,115,70,55,495,0.35507246376811596,55,47,52,40,40,41,275,0.16806722689075632,1.0
60,62,50,62,60,40,334,0.18181818181818182,60,65,60,130,75,110,500,0.7719298245614035,0.5
70,140,70,110,65,105,560,0.95,62,48,66,59,57,49,341,0.33884297520661155,0.5
60,100,85,80,85,100,510,0.7007874015748031,100,100,100,100,100,100,600,0.8805970149253731,1.0
50,70,50,50,50,40,310,0.16296296296296298,65,95,100,60,50,50,420,0.34959349593495936,0.5
100,50,50,76,96,70,442,0.5,82,121,119,69,59,71,521,0.5394736842105263,0.25
60,75,85,100,85,115,520,0.8992248062015504,100,50,50,76,96,70,442,0.5,1.0
61,78,95,56,58,57,405,0.40336134453781514,50,30,55,65,55,20,275,0.13675213675213677,0.5
58,64,58,80,65,80,405,0.5423728813559322,68,90,65,50,55,82,410,0.6165413533834586,0.5
190,33,58,33,58,33,405,0.13432835820895522,80,80,90,110,130,110,600,0.8721804511278195,0.5
46,57,40,40,40,50,273,0.25,75,125,230,55,95,30,610,0.3448275862068966,0.0
40,30,30,40,50,30,220,0.07936507936507936,91,90,129,90,72,108,580,0.9140625,0.5
50,53,48,53,48,64,316,0.358974358974359,100,123,75,57,75,80,510,0.6923076923076923,1.0
80,100,80,80,80,100,520,0.9051724137931034,68,165,95,65,115,110,618,0.8615384615384616,1.0
30,42,118,42,88,30,350,0.112,65,105,60,60,70,95,455,63.0,0.5
30,35,30,100,35,80,310,0.4765625,45,20,50,60,120,50,345,0.24074074074074073,1.0
30,65,100,45,25,40,305,0.1891891891891892,90,120,120,60,60,50,500,0.35294117647058826,2.0
92,105,90,125,90,98,600,0.8217054263565892,85,110,90,45,90,80,500,0.6206896551724138,1.0
91,90,106,130,106,77,600,0.648854961832061,100,150,90,180,160,90,770,0.7348484848484849,0.25
55,81,60,50,70,97,413,0.7214285714285714,50,72,35,35,35,65,292,0.5373134328358209,1.0
60,48,45,43,90,42,328,0.21897810218978103,50,85,55,65,65,90,410,0.7478260869565218,1.0
60,82,45,45,45,74,351,0.5752212389380531,75,125,75,30,75,85,465,0.625,0.5
90,110,80,100,80,95,555,0.7982456140350878,75,69,72,114,100,104,534,0.8253968253968254,0.5
78,84,78,109,85,100,534,0.8620689655172413,55,69,85,32,35,28,304,0.09302325581395349,2.0
61,84,65,70,70,70,420,0.5,40,55,30,30,30,60,245,0.43548387096774194,1.0
130,85,80,85,95,60,535,0.43884892086330934,50,105,79,35,110,76,455,0.6214285714285714,1.0
60,90,140,50,50,40,430,0.2535211267605634,103,60,126,80,126,50,545,0.36363636363636365,0.5
80,160,80,130,80,100,630,0.8455284552845529,83,80,80,135,80,121,579,0.9444444444444444,1.0
60,70,50,100,50,65,395,0.5217391304347826,60,80,95,70,85,50,440,0.2231404958677686,0.25
55,55,55,85,55,30,335,0.1320754716981132,90,100,60,90,60,80,480,0.6422764227642277,0.0
40,27,60,37,50,66,280,0.36220472440944884,55,55,50,45,65,55,325,0.37373737373737376,1.0
70,60,62,80,82,60,414,0.4375,38,30,85,55,65,30,303,0.21428571428571427,0.5
55,104,105,94,75,52,485,0.36363636363636365,45,30,50,55,65,45,290,0.208,1.0
64,115,65,83,63,65,455,0.5323741007194245,85,105,100,79,83,78,530,0.5869565217391305,1.0
40,55,30,30,30,85,270,0.688,50,75,45,40,45,60,315,0.4380165289256198,2.0
106,130,90,110,154,90,680,0.719626168224299,60,65,70,85,75,40,395,0.21705426356589147,4.0
75,125,75,30,75,85,465,0.625,95,75,110,100,80,30,490,0.15267175572519084,0.5
45,80,100,35,37,28,325,0.3125,65,95,75,55,55,85,430,0.6933333333333334,0.5
74,94,131,54,116,20,489,0.4485294117647059,40,45,35,30,40,55,245,0.3793103448275862,0.25
80,120,79,95,79,70,523,0.5833333333333334,95,117,184,44,46,28,514,0.2975206611570248,1.0
78,52,60,63,65,23,341,0.06015037593984962,90,75,75,90,100,70,500,0.5462184873949579,1.0
99,68,83,72,87,51,460,0.417910447761194,50,48,43,46,41,60,288,0.47297297297297297,4.0
70,120,65,45,85,125,510,0.9747899159663865,60,60,40,65,45,35,305,0.15833333333333333,1.0
83,106,65,86,65,85,490,0.6640625,75,69,72,114,100,104,534,0.8253968253968254,0.5
105,180,100,180,100,115,780,0.9477611940298507,80,70,65,80,120,100,515,0.8034188034188035,1.0
35,65,35,65,35,65,300,0.46621621621621623,65,155,120,65,90,105,600,0.8677685950413223,1.0
40,45,65,100,120,90,460,0.5588235294117647,83,106,65,86,65,85,490,0.6640625,2.0
85,110,90,45,90,80,500,0.6206896551724138,108,170,115,120,95,92,700,0.7083333333333334,1.0
50,20,55,25,25,30,205,0.09774436090225563,65,90,115,45,115,58,488,0.5041322314049587,1.0
70,40,50,55,50,25,290,0.061068702290076333,65,65,45,75,45,95,390,0.72,2.0
30,45,55,70,55,85,340,0.5633802816901409,40,30,50,55,55,100,330,0.584070796460177,1.0
73,115,60,60,60,90,458,0.6694915254237288,55,75,50,40,40,80,340,0.6302521008403361,1.0
50,75,45,40,45,60,315,0.4380165289256198,90,110,80,100,80,95,555,0.7982456140350878,0.5
35,20,65,40,65,20,245,0.02459016393442623,106,90,130,90,154,110,680,0.8699186991869918,1.0
68,72,78,38,42,32,330,0.23809523809523808,95,75,80,100,110,30,490,0.24242424242424243,1.0
89,125,90,115,80,101,600,0.8725490196078431,70,120,40,95,40,95,460,0.8106060606060606,1.0
100,150,120,120,100,90,680,0.6493506493506493,150,80,44,90,54,80,498,0.625,2.0
60,85,69,60,69,77,420,0.518796992481203,39,52,43,60,50,65,309,0.5041322314049587,1.0
75,103,80,70,80,92,500,0.7933884297520661,123,100,62,97,81,68,531,0.4806201550387597,1.0
109,66,84,81,99,32,471,0.2013888888888889,64,78,52,78,52,81,405,0.6422764227642277,2.0
55,45,50,45,65,80,340,0.5546218487394958,60,25,35,70,80,60,330,0.3076923076923077,1.0
75,80,85,110,90,50,490,0.3548387096774194,40,55,99,40,79,47,360,0.26262626262626265,0.125
60,80,95,70,85,50,440,0.2231404958677686,45,95,50,40,50,75,355,0.54,2.0
95,110,95,40,95,55,490,0.40336134453781514,115,45,20,45,25,20,270,0.11538461538461539,1.0
64,88,50,88,50,106,446,0.9111111111111111,50,50,95,40,50,35,320,0.20279720279720279,1.0
70,110,180,60,60,50,530,0.4117647058823529,100,120,120,150,100,90,680,0.7880794701986755,0.25
79,103,120,135,115,78,630,0.5763888888888888,150,120,100,120,100,90,680,0.664179104477612,0.5
40,27,60,37,50,66,280,0.36220472440944884,40,45,35,40,40,90,290,0.65,1.0
50,70,100,40,40,30,330,0.2222222222222222,55,50,65,175,95,150,590,0.7818181818181819,1.0
95,110,80,70,80,50,485,0.37209302325581395,40,30,35,50,70,55,280,0.28205128205128205,2.0
95,135,80,110,80,100,600,0.8248175182481752,125,170,100,120,90,95,700,0.77,2.0
75,90,140,60,60,40,465,0.3008130081300813,60,90,140,50,50,40,430,0.2535211267605634,0.5
25,20,15,105,55,90,310,0.32407407407407407,60,45,70,75,85,55,390,0.3008130081300813,0.5
53,54,53,37,46,45,288,0.3090909090909091,72,105,115,54,86,68,500,0.5149253731343284,1.0
60,60,60,60,60,60,360,0.38095238095238093,65,45,55,45,70,45,325,0.24369747899159663,1.0
70,45,48,60,65,35,323,0.15748031496062992,80,70,70,90,100,70,480,0.5609756097560976,1.0
20,10,55,15,20,80,200,0.17985611510791366,60,67,85,77,75,116,480,0.8888888888888888,0.5
80,100,200,50,100,50,580,0.3472222222222222,70,83,50,37,50,60,350,0.3360655737704918,2.0
30,40,70,70,25,60,295,0.41353383458646614,85,73,70,73,115,67,483,0.5126050420168067,1.0
150,80,44,90,54,80,498,0.625,45,60,45,25,45,55,275,0.29,0.0
70,120,65,45,85,125,510,0.9747899159663865,72,58,80,103,80,97,490,0.7171052631578947,4.0
70,75,80,135,80,135,575,0.917910447761194,45,30,50,65,50,45,285,0.13821138211382114,1.0
100,100,100,100,100,100,600,0.8602941176470589,80,50,100,100,200,50,580,0.2357142857142857,1.0
89,125,90,115,80,101,600,0.8725490196078431,40,45,35,65,55,70,310,0.4482758620689655,1.0
70,90,70,60,60,70,420,0.6390977443609023,70,60,62,80,82,60,414,0.4375,1.0
70,130,100,55,80,65,500,0.608,72,60,30,20,30,25,237,0.11570247933884298,0.5
50,53,48,53,48,64,316,0.4076923076923077,70,84,70,65,70,51,410,0.2949640287769784,4.0
63,63,47,41,41,74,329,0.56,65,40,50,125,60,30,370,0.07258064516129033,2.0
95,65,65,110,130,60,525,0.4016393442622951,80,52,50,90,50,89,411,0.6666666666666666,1.0
150,160,100,95,65,100,670,0.8866666666666667,50,95,95,35,110,70,455,0.5179856115107914,1.0
70,75,80,135,80,135,575,0.917910447761194,50,65,45,85,65,95,405,0.7238095238095238,0.5
50,95,95,35,110,70,455,0.5179856115107914,35,85,45,35,35,75,310,0.6492537313432836,1.0
80,100,70,60,70,95,475,0.7416666666666667,65,150,60,115,60,115,565,0.935251798561151,1.0
150,100,120,100,120,90,680,0.6666666666666666,50,53,48,53,48,64,316,0.46153846153846156,1.0
116,55,85,107,95,29,487,0.06818181818181818,73,95,62,85,65,85,465,0.6666666666666666,1.0
60,62,80,63,80,60,405,0.4336283185840708,65,130,60,95,110,65,525,0.5303030303030303,0.5
150,80,44,90,54,80,498,0.625,68,90,65,50,55,82,410,0.6165413533834586,1.0
255,10,10,75,135,55,540,0.3125,50,70,100,40,40,30,330,0.2222222222222222,0.25
63,60,55,50,50,71,349,0.5289256198347108,60,60,60,35,35,30,280,0.11194029850746269,1.0
40,70,130,60,130,25,455,0.17355371900826447,50,160,110,160,110,110,700,0.8854961832061069,1.0
75,80,85,110,90,50,490,0.3548387096774194,100,73,83,73,83,55,467,0.371900826446281,0.25
60,55,50,40,55,45,305,0.22377622377622378,60,79,105,59,85,36,424,0.17054263565891473,0.5
65,76,84,54,96,105,480,0.9008264462809917,38,35,35,65,55,50,278,0.2647058823529412,1.0
40,55,70,45,60,30,300,0.10619469026548672,95,100,85,108,70,70,528,0.5652173913043478,0.5
60,55,145,75,150,40,525,0.2,86,76,86,116,56,95,515,0.7982456140350878,4.0
45,30,50,55,65,45,290,0.208,40,29,45,29,45,36,224,0.14634146341463414,1.0
70,100,115,30,65,30,410,0.24390243902439024,60,100,115,70,85,90,520,0.7557251908396947,0.5
100,50,50,76,96,70,442,0.5,100,100,100,100,100,100,600,0.8758169934640523,0.25
90,90,85,125,90,100,580,0.768595041322314,60,85,60,50,50,125,430,0.9090909090909091,2.0
45,22,60,27,30,29,213,0.07518796992481203,80,82,100,83,100,80,525,0.6821705426356589,2.0
80,110,120,130,90,70,600,0.6198347107438017,90,95,105,165,110,45,610,0.2890625,0.25
50,50,150,50,150,50,500,0.2571428571428571,80,75,150,75,150,50,580,0.30973451327433627,0.25
75,90,90,140,90,115,600,0.9481481481481482,100,75,115,90,115,85,580,0.6446280991735537,0.5
60,60,60,60,60,60,360,0.38095238095238093,80,145,150,105,110,110,700,0.8692307692307693,0.5
61,72,57,55,55,65,365,0.3984375,70,110,180,60,60,50,530,0.4117647058823529,0.0
30,35,30,100,35,80,310,0.4765625,78,84,78,109,85,100,534,0.8620689655172413,1.0
50,75,75,65,65,50,380,0.4049586776859504,60,40,80,60,45,40,325,0.23529411764705882,4.0
54,63,52,83,56,97,405,0.7697841726618705,100,120,120,150,100,90,680,0.7880794701986755,0.5
55,45,43,55,43,72,313,0.5853658536585366,62,77,62,50,42,65,358,0.4838709677419355,1.0
40,70,40,35,40,60,285,0.392,97,165,60,65,50,58,495,0.3902439024390244,2.0
111,83,68,92,82,39,475,0.1774193548387097,44,38,39,61,79,42,303,0.2251655629139073,1.0
80,50,100,100,200,50,580,0.2357142857142857,75,70,90,70,105,80,490,0.656,4.0
90,93,55,70,55,55,418,0.3819444444444444,72,85,70,65,70,58,420,0.41304347826086957,1.0
77,120,90,60,90,48,485,0.2785714285714286,90,65,65,40,40,15,315,0.19672131147540983,1.0
35,80,50,50,70,120,405,0.84375,65,155,120,65,90,105,600,0.8677685950413223,0.0
50,50,40,30,30,50,250,0.2781954887218045,60,50,150,50,150,60,520,0.5206611570247934,1.0
75,75,130,75,130,95,580,0.7479674796747967,50,65,107,105,107,86,520,0.6991150442477876,1.0
70,90,110,60,75,95,500,0.7333333333333333,60,60,60,105,105,105,495,0.848,1.0
65,90,122,58,75,84,494,0.71875,110,160,110,80,110,100,670,0.8591549295774648,0.0
85,115,80,105,80,50,515,0.3063063063063063,38,41,40,50,65,65,299,0.4108527131782946,1.0
45,100,135,65,135,45,525,0.29411764705882354,50,40,85,40,65,25,305,0.08870967741935484,1.0
100,164,150,95,120,71,700,0.5645161290322581,55,40,85,80,105,40,405,0.23622047244094488,1.0
45,35,45,62,53,35,275,0.11851851851851852,35,20,65,40,65,20,245,0.02459016393442623,1.0
75,95,125,45,75,95,510,0.8257575757575758,45,49,65,49,65,45,318,0.275,1.0
85,120,70,50,60,100,485,0.8308823529411765,60,62,80,63,80,60,405,0.4336283185840708,2.0
50,50,62,40,62,65,329,0.4188034188034188,60,105,60,120,60,105,510,0.8849557522123894,1.0
68,85,65,165,135,100,618,0.8083333333333333,60,50,150,50,150,60,520,0.5206611570247934,0.25
75,65,55,65,55,69,384,0.43548387096774194,50,65,107,105,107,86,520,0.7758620689655172,1.0
30,65,100,45,25,40,305,0.1891891891891892,1,90,45,30,30,40,236,0.33064516129032256,1.0
125,120,90,170,100,95,700,0.78125,55,85,55,50,55,60,360,0.4233576642335766,0.5
40,55,30,30,30,60,245,0.43548387096774194,65,76,84,54,96,105,480,0.9008264462809917,1.0
70,45,48,60,65,35,323,0.15748031496062992,50,95,180,85,45,70,525,0.5298507462686567,1.0
79,115,70,125,80,111,580,0.864,65,40,50,125,60,30,370,0.07258064516129033,1.0
71,82,64,64,59,112,452,0.9327731092436975,95,110,95,40,95,55,490,0.40336134453781514,1.0
72,60,30,20,30,25,237,0.11570247933884298,100,100,100,100,100,100,600,0.8602941176470589,1.0
45,45,35,20,30,20,195,0.07246376811594203,50,70,50,50,50,70,340,0.5645161290322581,1.0
103,93,67,71,61,84,479,0.7142857142857143,85,105,100,79,83,78,530,0.5869565217391305,1.0
70,110,180,60,60,50,530,0.4117647058823529,70,140,70,110,65,105,560,0.95,0.5
100,50,80,60,80,50,420,0.34375,60,62,63,80,80,60,405,0.38016528925619836,0.25
43,70,48,50,60,38,309,0.2391304347826087,50,95,90,95,90,180,600,0.9172413793103448,2.0
100,50,80,60,80,50,420,0.34375,50,50,77,95,77,91,440,0.5916666666666667,1.0
30,40,70,70,25,60,295,0.41353383458646614,55,75,60,75,60,103,428,0.7982456140350878,1.0
60,85,60,50,50,125,430,0.9090909090909091,45,85,70,40,40,60,340,0.5229357798165137,0.25
100,100,100,100,100,100,600,0.8345864661654135,50,80,95,10,45,10,290,0.232,2.0
100,73,83,73,83,55,467,0.371900826446281,50,120,53,35,110,87,455,0.640625,1.0
75,90,50,110,80,95,500,0.7985611510791367,60,62,80,63,80,60,405,0.4336283185840708,2.0
50,95,90,95,90,180,600,0.9172413793103448,69,55,45,55,55,15,294,0.11666666666666667,2.0
45,30,15,85,65,65,305,0.36220472440944884,60,25,35,70,80,60,330,0.3076923076923077,0.5
105,140,55,30,55,95,480,0.8195488721804511,38,35,40,27,25,35,200,0.08208955223880597,2.0
80,145,150,105,110,110,700,0.8692307692307693,50,72,35,35,35,65,292,0.5373134328358209,0.0
130,85,80,85,95,60,535,0.43884892086330934,95,70,73,95,90,60,483,0.3983739837398374,1.0
105,95,75,85,75,74,509,0.5714285714285714,80,70,70,90,100,70,480,0.5609756097560976,0.125
90,75,85,115,90,55,510,0.3445378151260504,68,72,78,38,42,32,330,0.23809523809523808,0.0
60,48,45,43,90,42,328,0.21897810218978103,30,30,42,30,42,70,244,0.4230769230769231,1.0
50,40,85,40,65,25,305,0.08870967741935484,95,70,73,95,90,60,483,0.3983739837398374,0.5
60,62,50,62,60,40,334,0.18181818181818182,50,65,107,105,107,86,520,0.703125,0.5
50,75,35,70,30,40,300,0.21296296296296297,65,95,100,60,50,50,420,0.34959349593495936,0.5
70,60,75,110,75,90,480,0.7165354330708661,70,80,65,90,65,85,455,0.578125,1.0
45,30,50,65,50,45,285,0.13821138211382114,65,47,55,73,75,85,400,0.65,1.0
57,24,86,24,86,23,300,0.12727272727272726,80,50,100,100,200,50,580,0.2357142857142857,2.0
79,115,70,125,80,111,580,0.864,44,48,65,50,64,43,314,0.1623931623931624,2.0
100,50,50,76,96,70,442,0.5,79,105,70,145,80,101,580,0.8608695652173913,0.5
80,135,85,70,95,150,615,0.9844961240310077,78,65,68,112,154,75,552,0.628099173553719,1.0
106,130,90,110,154,90,680,0.719626168224299,71,95,85,110,95,79,535,0.664,2.0
45,49,49,65,65,45,318,0.2781954887218045,50,48,43,46,41,60,288,0.47297297297297297,2.0
55,75,50,40,40,80,340,0.6302521008403361,72,60,30,20,30,25,237,0.11570247933884298,2.0
30,65,100,45,25,40,305,0.1891891891891892,39,52,43,60,50,65,309,0.5041322314049587,2.0
91,90,106,130,106,77,600,0.648854961832061,115,140,130,55,55,40,535,0.4519230769230769,1.0
50,75,75,65,65,50,380,0.4049586776859504,50,20,40,20,40,20,190,0.0962962962962963,0.0
43,30,55,40,65,97,330,0.6030534351145038,83,106,65,86,65,85,490,0.6640625,1.0
45,53,70,40,60,42,310,0.25735294117647056,85,70,80,97,80,123,535,0.9304347826086956,0.125
115,115,85,90,75,100,580,0.8134328358208955,61,90,45,50,50,160,456,0.9230769230769231,2.0
130,65,60,110,95,65,525,0.5227272727272727,60,40,80,60,45,40,325,0.23529411764705882,0.5
97,165,60,65,50,58,495,0.3902439024390244,80,45,65,90,110,80,470,0.5462962962962963,1.0
48,61,40,61,40,50,300,0.2543859649122807,40,40,50,30,30,30,220,0.0873015873015873,2.0
90,90,85,125,90,100,580,0.768595041322314,110,65,75,125,85,30,490,0.15,1.0
90,50,34,60,44,70,348,0.6283185840707964,50,85,85,55,55,50,380,0.3902439024390244,0.5
64,165,75,93,83,75,555,0.6587301587301587,68,75,53,83,113,60,452,0.45384615384615384,1.0
135,85,40,40,85,5,390,0.6864406779661016,49,66,70,44,55,51,335,0.4260869565217391,0.0
50,53,48,53,48,64,316,0.358974358974359,40,50,90,30,55,65,330,0.44680851063829785,1.0
59,45,40,35,40,31,250,0.14285714285714285,65,80,80,59,63,58,405,0.4411764705882353,1.0
78,92,75,74,63,118,500,0.8842975206611571,55,85,122,58,75,99,494,0.8099173553719008,0.0
126,131,95,131,98,99,680,0.8102189781021898,91,90,106,130,106,77,600,0.648854961832061,0.5
57,80,91,80,87,75,470,0.5737704918032787,50,95,90,95,90,180,600,0.9172413793103448,1.0
95,145,130,120,90,120,700,0.9398496240601504,80,85,95,30,30,25,345,0.2857142857142857,0.5
37,25,41,25,41,25,194,0.08870967741935484,35,45,160,30,45,70,385,0.48148148148148145,1.0
65,80,80,59,63,58,405,0.4411764705882353,120,70,120,75,130,85,600,0.6694915254237288,1.0
80,52,50,90,50,89,411,0.6666666666666666,80,120,70,110,70,80,530,0.6422764227642277,0.5
55,95,55,35,75,115,430,0.9380530973451328,115,115,85,90,75,100,580,0.8134328358208955,0.5
100,100,100,100,100,100,600,0.8345864661654135,50,48,43,46,41,60,288,0.47297297297297297,8.0
30,30,42,30,42,70,244,0.4230769230769231,72,85,70,65,70,58,420,0.41304347826086957,2.0
50,100,150,100,150,50,600,0.37142857142857144,100,128,90,77,77,128,600,0.959349593495935,1.0
86,92,88,68,75,73,482,0.6835443037974683,100,110,90,85,90,60,535,0.47794117647058826,2.0
85,105,100,79,83,78,530,0.5869565217391305,60,50,70,50,90,65,385,0.39568345323741005,1.0
40,70,130,60,130,25,455,0.17355371900826447,60,90,140,50,50,40,430,0.2535211267605634,1.0
50,65,64,44,48,43,314,0.2196969696969697,100,110,90,85,90,60,535,0.47794117647058826,1.0
55,85,122,58,75,99,494,0.8099173553719008,50,105,125,55,95,50,480,0.375886524822695,0.5
30,105,90,25,25,50,325,0.2773722627737226,85,56,77,50,77,78,423,0.53125,2.0
40,30,30,40,50,30,220,0.07936507936507936,80,160,60,170,130,80,680,0.6180555555555556,1.0
45,30,50,65,50,45,285,0.13821138211382114,50,75,45,40,45,60,315,0.4380165289256198,1.0
66,41,77,61,87,23,355,0.12096774193548387,60,85,40,30,45,68,328,0.6422018348623854,1.0
55,63,90,50,80,42,380,0.21138211382113822,100,100,100,100,100,100,600,0.8345864661654135,2.0
45,60,45,25,45,55,275,0.29,105,95,80,40,80,90,490,0.753968253968254,1.0
65,90,50,85,45,55,390,0.371900826446281,65,60,110,130,95,65,525,0.47761194029850745,1.0
50,65,64,44,48,43,314,0.2196969696969697,109,66,84,81,99,32,471,0.2013888888888889,2.0
66,117,70,40,50,67,410,0.4573643410852713,48,72,48,72,48,48,336,0.25984251968503935,1.0
75,105,75,105,75,45,480,0.3274336283185841,80,70,70,90,100,70,480,0.5609756097560976,0.25
85,50,95,120,115,80,545,0.5793650793650794,90,120,120,60,60,50,500,0.35294117647058826,1.0
39,52,43,60,50,65,309,0.49107142857142855,70,50,30,95,135,105,485,0.8040540540540541,2.0
55,85,122,58,75,99,494,0.8099173553719008,55,70,55,40,55,85,360,0.7073170731707317,0.0
83,106,65,86,65,85,490,0.6640625,50,65,107,105,107,86,520,0.703125,2.0
84,86,88,111,101,60,530,0.4634146341463415,90,92,75,92,85,60,494,0.49586776859504134,1.0
73,100,60,100,60,65,458,0.42657342657342656,255,10,10,75,135,55,540,0.3125,1.0
75,100,95,40,70,110,490,0.8717948717948718,130,85,80,85,95,60,535,0.43884892086330934,1.0
78,52,60,63,65,23,341,0.06015037593984962,80,100,200,50,100,50,580,0.3472222222222222,1.0
100,50,80,60,80,50,420,0.34375,65,60,110,130,95,65,525,0.47761194029850745,1.0
90,60,60,40,40,40,330,0.29545454545454547,60,65,60,130,75,110,500,0.7719298245614035,2.0
110,160,110,80,110,100,670,0.8591549295774648,60,90,140,50,50,40,430,0.2535211267605634,0.25
50,50,62,40,62,65,329,0.4188034188034188,77,120,90,60,90,48,485,0.2785714285714286,1.0
75,80,95,90,100,50,490,0.2158273381294964,70,75,60,105,60,105,475,0.88,1.0
75,105,75,105,75,45,480,0.3274336283185841,80,45,65,90,110,80,470,0.5462962962962963,1.0
65,40,50,125,60,30,370,0.07258064516129033,105,105,75,65,100,50,500,0.37593984962406013,2.0
100,70,70,65,65,45,415,0.1897810218978102,75,75,95,75,95,113,528,0.9015151515151515,1.0
55,104,105,94,75,52,485,0.36363636363636365,75,38,38,56,56,67,330,0.5263157894736842,0.5
75,98,63,98,63,101,498,0.8091603053435115,74,94,131,54,116,20,489,0.4485294117647059,0.25
67,57,55,77,55,114,425,0.8879310344827587,62,48,66,59,57,49,341,0.33884297520661155,1.0
60,50,70,50,90,65,385,0.39568345323741005,67,58,57,81,67,101,431,0.8790322580645161,1.0
83,80,75,70,70,101,479,0.8615384615384616,115,45,20,45,25,20,270,0.11538461538461539,1.0
79,85,60,55,60,71,410,0.60431654676259,50,85,125,85,115,20,480,0.4306569343065693,0.0
90,95,105,165,110,45,610,0.2890625,58,64,58,80,65,80,405,0.5423728813559322,1.0
30,30,42,30,42,70,244,0.4230769230769231,74,108,133,83,65,32,495,0.32142857142857145,0.5
55,65,35,60,30,85,330,0.6126126126126126,40,55,70,45,60,30,300,0.10619469026548672,1.0
72,105,115,54,86,68,500,0.5149253731343284,55,66,44,44,56,85,350,0.6888888888888889,1.0
100,123,75,57,75,80,510,0.6923076923076923,45,55,39,35,39,42,255,0.18518518518518517,1.0
90,100,90,125,85,90,580,0.7352941176470589,60,85,40,30,45,68,328,0.6422018348623854,1.0
70,75,80,135,80,135,575,0.917910447761194,90,50,34,60,44,70,348,0.6283185840707964,2.0
40,40,35,50,100,70,335,0.5031847133757962,71,95,85,110,95,79,535,0.664,1.0
95,135,80,110,80,100,600,0.8248175182481752,70,83,50,37,50,60,350,0.3360655737704918,1.0
62,48,54,63,60,68,355,0.5178571428571429,65,130,60,75,60,75,465,0.689922480620155,0.0
58,70,45,40,45,42,300,0.25925925925925924,70,80,50,35,35,35,305,0.14,1.0
70,55,95,95,110,65,490,0.48872180451127817,55,70,45,70,50,60,350,0.45,1.0
61,72,57,55,55,65,365,0.3984375,70,85,65,105,85,120,530,0.9262295081967213,2.0
59,63,80,65,80,58,405,0.41843971631205673,50,65,45,85,65,95,405,0.7238095238095238,0.5
83,80,75,70,70,101,479,0.8615384615384616,35,46,34,35,45,20,215,0.072,1.0
58,64,58,80,65,80,405,0.5423728813559322,38,35,35,65,55,50,278,0.2647058823529412,1.0
57,24,86,24,86,23,300,0.12727272727272726,100,120,120,150,100,90,680,0.7880794701986755,0.25
100,120,100,150,120,90,680,0.728,69,69,76,69,86,91,460,0.6554621848739496,0.5
84,71,43,71,43,48,360,0.25874125874125875,45,35,50,70,50,30,280,0.15753424657534246,1.0
52,65,55,58,62,60,352,0.4482758620689655,62,73,55,56,52,84,382,0.7244094488188977,1.0
60,65,60,130,75,110,500,0.7719298245614035,44,75,35,63,33,45,295,0.2647058823529412,1.0
55,68,64,45,55,31,318,0.11666666666666667,45,49,49,65,65,45,318,0.2781954887218045,0.25
90,50,34,60,44,70,348,0.6283185840707964,80,50,100,100,200,50,580,0.2357142857142857,1.0
80,135,85,70,95,150,615,0.9844961240310077,80,85,95,30,30,25,345,0.2857142857142857,0.25
50,105,125,55,95,50,480,0.375886524822695,36,50,50,65,60,44,305,0.16363636363636364,2.0
80,160,60,170,130,80,680,0.6180555555555556,50,30,55,65,55,20,275,0.13675213675213677,2.0
60,59,85,79,105,36,424,0.16666666666666666,65,60,70,85,75,40,395,0.1796875,1.0
60,60,60,105,105,105,495,0.848,80,82,78,95,80,85,500,0.6869565217391305,1.0
60,60,50,40,50,75,335,0.5882352941176471,58,64,58,80,65,80,405,0.5423728813559322,0.5
72,95,67,103,71,122,530,0.9606299212598425,70,140,230,60,80,50,630,0.32432432432432434,1.0
50,20,40,20,40,20,190,0.0962962962962963,30,45,59,30,39,57,260,0.2803030303030303,0.5
150,80,44,90,54,80,498,0.625,45,85,70,40,40,60,340,0.5229357798165137,0.25
75,69,72,114,100,104,534,0.8253968253968254,75,95,125,45,75,95,510,0.8257575757575758,2.0
100,120,120,150,100,90,680,0.7880794701986755,100,150,120,120,100,90,680,0.6493506493506493,1.0
68,125,65,65,115,80,518,0.6277372262773723,75,125,100,70,80,45,495,0.33035714285714285,1.0
100,50,80,60,80,50,420,0.34375,55,70,45,70,50,60,350,0.45,1.0
78,52,60,63,65,23,341,0.06015037593984962,80,80,50,40,50,25,325,0.176056338028169,0.5
66,117,70,40,50,67,410,0.4573643410852713,95,75,180,130,80,30,590,0.13793103448275862,1.0
66,65,48,62,57,52,350,0.36220472440944884,70,85,65,105,85,120,530,0.9262295081967213,0.5
86,81,97,81,107,43,495,0.203125,78,104,78,159,115,100,634,0.8444444444444444,1.0
65,80,80,59,63,58,405,0.4411764705882353,90,95,105,165,110,45,610,0.2890625,0.5
80,92,65,65,80,68,450,0.4824561403508772,50,20,40,20,40,20,190,0.0962962962962963,1.0
65,150,60,115,60,115,565,0.935251798561151,81,102,77,85,75,85,505,0.5642857142857143,1.0
38,36,38,32,36,57,237,0.3893805309734513,44,58,44,58,44,61,309,0.41964285714285715,1.0
70,60,75,110,75,90,480,0.7165354330708661,55,55,45,63,45,45,308,0.25,2.0
75,55,70,55,95,110,460,0.8444444444444444,55,112,45,74,45,70,401,0.559322033898305,0.5
60,50,70,80,80,140,480,0.8449612403100775,60,55,145,75,150,40,525,0.2,1.0
105,180,100,180,100,115,780,0.9477611940298507,40,80,100,30,30,20,300,0.11851851851851852,0.5
108,170,115,120,95,92,700,0.7083333333333334,80,80,90,110,130,110,600,0.8721804511278195,2.0
65,150,60,115,60,115,565,0.935251798561151,70,65,60,90,75,90,450,0.6571428571428571,1.0
80,130,100,160,120,110,700,0.8981481481481481,55,45,45,25,25,15,210,0.048,2.0
70,95,125,65,75,45,475,0.33613445378151263,40,55,30,30,30,60,245,0.43548387096774194,1.0
70,115,60,115,60,55,475,0.4647887323943662,80,110,120,130,90,70,600,0.6198347107438017,1.0
45,40,60,40,75,50,310,0.2926829268292683,55,65,95,95,45,85,440,0.6610169491525424,1.0
35,40,100,90,55,35,355,0.1796875,255,10,10,75,135,55,540,0.3125,1.0
70,55,95,95,110,65,490,0.48872180451127817,60,85,69,65,79,80,438,0.576,2.0
45,60,30,80,50,65,330,0.4603174603174603,75,38,38,56,56,67,330,0.5263157894736842,0.5
40,50,45,70,45,70,320,0.5517241379310345,50,50,95,40,50,35,320,0.20279720279720279,2.0
100,100,125,110,50,50,535,0.384,110,135,60,50,65,88,508,0.7744360902255639,1.0
78,70,61,50,61,100,420,0.8145161290322581,43,70,48,50,60,38,309,0.2391304347826087,0.0
90,100,60,90,60,80,480,0.6422764227642277,45,30,50,65,50,45,285,0.13821138211382114,2.0
65,55,115,100,40,60,435,0.3798449612403101,40,27,60,37,50,66,280,0.36220472440944884,0.5
40,55,99,40,79,47,360,0.26262626262626265,63,63,47,41,41,74,329,0.56,0.5
70,83,50,37,50,60,350,0.3360655737704918,50,80,95,10,45,10,290,0.232,0.25
44,38,39,61,79,42,303,0.2251655629139073,55,85,55,50,55,60,360,0.4233576642335766,0.5
55,35,50,55,110,85,390,0.6277372262773723,49,55,42,42,37,85,310,0.6068376068376068,1.0
50,95,180,85,45,70,525,0.5298507462686567,100,77,77,128,128,90,600,0.6901408450704225,1.0
50,160,110,160,110,110,700,0.8854961832061069,35,20,65,40,65,20,245,0.02459016393442623,1.0
63,120,85,90,55,55,468,0.2809917355371901,60,70,50,100,50,65,395,0.5217391304347826,1.0
60,45,70,45,90,95,405,0.7304964539007093,60,90,55,90,80,110,485,0.8677685950413223,0.5
36,50,50,65,60,44,305,0.16363636363636364,70,80,70,80,70,110,480,0.6594202898550725,0.5
65,63,45,45,45,45,308,0.2595419847328244,70,110,80,55,80,105,500,0.8794326241134752,2.0
80,120,130,55,65,45,495,0.37037037037037035,95,125,79,60,100,81,540,0.6165413533834586,0.0
65,90,115,45,115,58,488,0.5041322314049587,50,95,90,95,90,180,600,0.9172413793103448,1.0
45,40,60,40,75,50,310,0.2926829268292683,45,55,45,65,45,75,330,0.5692307692307692,1.0
60,82,45,45,45,74,351,0.5752212389380531,62,55,52,109,94,109,481,0.7833333333333333,2.0
65,75,70,95,70,95,470,0.7272727272727273,79,105,70,145,80,101,580,0.8608695652173913,0.5
79,100,80,110,90,121,580,0.968,70,83,50,37,50,60,350,0.3360655737704918,1.0
80,82,100,83,100,80,525,0.6821705426356589,91,129,90,72,90,108,580,0.8536585365853658,2.0
50,47,50,57,50,65,319,0.463768115942029,84,86,88,111,101,60,530,0.4634146341463415,1.0
85,76,64,45,55,90,415,0.6739130434782609,50,60,45,100,80,65,400,0.45689655172413796,1.0
40,30,32,50,52,65,269,0.3671875,108,170,115,120,95,92,700,0.7083333333333334,1.0
67,125,40,30,30,58,350,0.3431372549019608,126,131,95,131,98,99,680,0.8102189781021898,2.0
90,120,100,150,120,100,680,0.7718120805369127,123,100,62,97,81,68,531,0.4806201550387597,0.5
60,45,70,75,85,55,390,0.3008130081300813,90,100,70,110,150,80,600,0.6037735849056604,1.0
43,80,65,50,35,35,308,0.14193548387096774,75,95,60,65,60,115,470,0.8778625954198473,1.0
50,20,40,20,40,20,190,0.0962962962962963,50,50,120,80,80,30,410,0.07258064516129033,0.25
70,100,70,105,75,40,460,0.23214285714285715,50,70,50,50,50,70,340,0.5645161290322581,0.5
45,49,49,65,65,45,318,0.2781954887218045,75,125,100,70,80,45,495,0.33035714285714285,0.5
68,65,65,125,115,80,518,0.6461538461538462,45,49,49,65,65,45,318,0.2781954887218045,1.0
55,55,50,45,65,55,325,0.37373737373737376,60,85,60,50,50,125,430,0.9090909090909091,1.0
106,110,90,154,90,130,680,0.926829268292683,40,45,65,100,120,90,460,0.5588235294117647,0.5
80,125,75,40,95,85,500,0.6911764705882353,35,46,34,35,45,20,215,0.072,2.0
50,72,35,35,35,65,292,0.5373134328358209,60,110,70,60,60,100,460,0.8461538461538461,0.0
59,110,150,45,49,35,448,0.3333333333333333,95,145,130,120,90,120,700,0.9398496240601504,1.0
88,107,122,74,75,64,530,0.4596774193548387,80,80,80,80,80,80,480,0.5606060606060606,2.0
50,50,40,30,30,50,250,0.2781954887218045,45,45,35,20,30,20,195,0.07246376811594203,0.5
55,85,122,58,75,99,494,0.8099173553719008,35,80,50,50,70,120,405,0.84375,2.0
63,120,85,90,55,55,468,0.2809917355371901,78,84,78,109,85,100,534,0.8646616541353384,2.0
50,70,100,40,40,30,330,0.2222222222222222,110,65,75,125,85,30,490,0.15,1.0
20,15,20,10,55,80,200,0.2682926829268293,80,145,150,105,110,110,700,0.8692307692307693,1.0
54,66,70,44,55,46,335,0.4214876033057851,70,60,75,110,75,90,480,0.7165354330708661,0.5
85,105,100,79,83,78,530,0.5869565217391305,50,150,50,150,50,150,600,0.9339622641509434,1.0
70,60,125,115,70,55,495,0.35507246376811596,50,40,85,40,65,25,305,0.08870967741935484,2.0
130,70,35,70,35,60,400,0.4017857142857143,80,70,70,90,100,70,480,0.5609756097560976,0.25
54,78,103,53,45,22,355,0.23255813953488372,50,64,50,45,50,41,300,0.22727272727272727,2.0
50,105,79,35,110,76,455,0.6214285714285714,60,75,100,55,80,50,420,0.3088235294117647,1.0
55,68,64,45,55,31,318,0.11666666666666667,59,63,80,65,80,58,405,0.41843971631205673,2.0
90,93,55,70,55,55,418,0.3819444444444444,50,95,95,35,110,70,455,0.5179856115107914,1.0
70,83,50,37,50,60,350,0.3360655737704918,110,80,90,95,90,65,530,0.5033557046979866,1.0
79,115,70,125,80,111,580,0.8468468468468469,75,75,55,105,85,30,425,0.1619718309859155,2.0
45,40,60,40,75,50,310,0.2926829268292683,60,100,115,70,85,90,520,0.7557251908396947,0.25
100,128,90,77,77,128,600,0.959349593495935,100,164,150,95,120,71,700,0.5645161290322581,2.0
45,45,55,45,55,63,308,0.4594594594594595,30,40,70,70,25,60,295,0.41353383458646614,2.0
90,65,65,40,40,15,315,0.19672131147540983,64,88,50,88,50,106,446,0.9111111111111111,0.0
90,85,100,95,125,85,580,0.6834532374100719,86,92,88,68,75,73,482,0.6835443037974683,1.0
64,115,65,83,63,65,455,0.5323741007194245,43,80,65,50,35,35,308,0.14193548387096774,1.0
50,95,180,85,45,70,525,0.5298507462686567,62,48,54,63,60,68,355,0.5178571428571429,1.0
60,60,40,65,45,35,305,0.15833333333333333,68,75,53,83,113,60,452,0.45384615384615384,0.5
91,129,90,72,90,108,580,0.8536585365853658,65,155,120,65,90,105,600,0.8677685950413223,1.0
103,93,67,71,61,84,479,0.7142857142857143,70,70,115,130,90,60,535,0.5338983050847458,0.0
108,100,121,81,95,95,600,0.7476635514018691,75,38,38,56,56,67,330,0.5263157894736842,2.0
85,105,100,79,83,78,530,0.5869565217391305,79,103,120,135,115,78,630,0.5763888888888888,0.5
70,75,60,105,60,105,475,0.88,65,50,70,95,80,65,425,0.4262295081967213,1.0
43,30,55,40,65,97,330,0.6030534351145038,130,85,80,85,95,60,535,0.43884892086330934,0.5
80,145,150,105,110,110,700,0.8692307692307693,65,75,105,35,65,85,430,0.6940298507462687,2.0
65,80,80,59,63,58,405,0.4411764705882353,50,50,95,40,50,35,320,0.20279720279720279,2.0
80,135,85,70,95,150,615,0.9844961240310077,45,55,39,35,39,42,255,0.18518518518518517,1.0
65,83,57,95,85,105,490,0.8914728682170543,60,60,75,60,75,80,410,0.7321428571428571,1.0
76,65,45,92,42,91,411,0.7449664429530202,75,100,110,45,55,65,450,0.5333333333333333,1.0
150,120,100,120,100,90,680,0.664179104477612,50,35,55,25,25,15,205,0.05263157894736842,1.0
50,60,60,60,60,30,320,0.11290322580645161,74,48,76,83,81,104,466,0.7322834645669292,1.0
28,25,25,45,35,40,198,0.16083916083916083,55,75,50,40,40,80,340,0.6302521008403361,1.0
55,81,60,50,70,97,413,0.7214285714285714,78,84,78,109,85,100,534,0.8620689655172413,1.0
80,120,70,110,70,80,530,0.6422764227642277,35,85,45,35,35,75,310,0.6492537313432836,1.0
100,90,130,45,65,55,485,0.4253731343283582,75,100,66,60,66,115,482,0.918918918918919,1.0
61,72,57,55,55,65,365,0.3984375,85,105,100,79,83,78,530,0.5869565217391305,1.0
75,125,100,70,80,45,495,0.33035714285714285,100,150,120,120,100,90,680,0.6493506493506493,1.0
95,110,80,70,80,50,485,0.37209302325581395,60,150,50,150,50,60,520,0.5,0.5
58,109,112,48,48,109,484,0.8805970149253731,95,117,80,65,70,92,519,0.8409090909090909,2.0
150,120,100,120,100,90,680,0.664179104477612,100,50,50,76,96,70,442,0.5,0.0
75,98,63,98,63,101,498,0.889763779527559,65,95,100,60,50,50,420,0.34959349593495936,0.5
67,89,116,79,116,33,500,0.2624113475177305,45,49,65,49,65,45,318,0.275,1.0
70,135,105,60,105,20,495,0.5806451612903226,100,134,110,95,100,61,600,0.4057971014492754,4.0
70,100,115,30,65,30,410,0.24390243902439024,60,65,80,170,95,130,600,0.8625954198473282,1.0
65,65,65,50,50,90,385,0.72,70,60,62,80,82,60,414,0.4375,1.0
80,90,80,130,110,110,600,0.856,85,110,76,65,82,56,474,0.3933333333333333,1.0
125,170,100,120,90,95,700,0.77,75,95,125,45,75,95,510,0.8257575757575758,4.0
45,30,50,55,65,45,290,0.208,40,27,60,37,50,66,280,0.36220472440944884,1.0
80,135,85,70,95,150,615,0.9844961240310077,67,89,116,79,116,33,500,0.2624113475177305,0.25
150,160,100,95,65,100,670,0.8866666666666667,30,45,59,30,39,57,260,0.2803030303030303,1.0
65,150,40,15,80,145,495,0.9663865546218487,38,41,40,50,65,65,299,0.4108527131782946,0.5
45,49,65,49,65,45,318,0.275,50,50,40,50,40,64,294,0.45588235294117646,2.0
60,85,69,65,79,80,438,0.576,95,145,130,120,90,120,700,0.9398496240601504,1.0
70,85,70,60,70,50,405,0.28378378378378377,62,48,66,59,57,49,341,0.33884297520661155,1.0
40,55,80,35,60,30,300,0.15037593984962405,79,103,120,135,115,78,630,0.5763888888888888,0.5
60,85,60,50,50,125,430,0.9090909090909091,40,65,40,80,40,65,330,0.5038167938931297,1.0
82,121,119,69,59,71,521,0.5394736842105263,42,52,67,39,56,50,306,0.2868217054263566,1.0
50,120,53,35,110,87,455,0.640625,35,55,40,50,50,90,320,0.6838235294117647,1.0
65,73,55,47,75,85,400,0.6846846846846847,125,170,100,120,90,95,700,0.77,1.0
41,50,37,50,37,66,281,0.5175438596491229,95,75,180,130,80,30,590,0.13793103448275862,2.0
60,80,95,70,85,50,440,0.2231404958677686,78,130,111,130,85,100,634,0.8561151079136691,0.5
60,50,40,85,75,95,405,0.7540983606557377,101,72,72,99,89,29,462,0.1937984496124031,1.0
40,30,50,55,55,100,330,0.584070796460177,70,110,75,145,85,145,630,0.9444444444444444,0.25
55,68,64,45,55,31,318,0.11666666666666667,77,85,51,55,51,65,384,0.5163934426229508,0.5
65,50,70,95,80,65,425,0.4262295081967213,28,25,25,45,35,40,198,0.16083916083916083,0.5
65,125,100,55,70,85,500,0.6532258064516129,70,80,70,80,70,110,480,0.6594202898550725,0.5
75,125,100,70,80,45,495,0.33035714285714285,55,63,90,50,80,42,380,0.21138211382113822,4.0
72,95,67,103,71,122,530,0.9606299212598425,80,90,80,130,110,110,600,0.856,1.0
70,105,105,50,40,20,390,0.33587786259541985,90,132,105,132,105,30,594,0.4246575342465753,2.0
85,70,80,97,80,123,535,0.9304347826086956,50,35,55,25,25,15,205,0.05263157894736842,2.0
40,60,30,31,31,70,262,0.4492753623188406,70,110,180,60,60,50,530,0.4117647058823529,0.0625
50,30,55,65,55,20,275,0.13675213675213677,65,95,57,100,85,93,495,0.7441860465116279,0.5
50,47,50,57,50,65,319,0.463768115942029,35,64,85,74,55,32,345,0.19827586206896552,2.0
50,50,62,40,62,65,329,0.4188034188034188,66,65,48,62,57,52,350,0.36220472440944884,2.0
45,50,43,40,38,62,278,0.40441176470588236,55,75,60,75,60,103,428,0.7982456140350878,0.5
40,45,40,35,35,56,251,0.373015873015873,36,50,50,65,60,44,305,0.16363636363636364,1.0
108,100,121,81,95,95,600,0.7476635514018691,40,55,30,30,30,60,245,0.43548387096774194,0.0
70,40,50,55,50,25,290,0.061068702290076333,38,30,41,30,41,60,240,0.2897196261682243,1.0
30,45,55,70,55,85,340,0.5633802816901409,84,71,43,71,43,48,360,0.25874125874125875,1.0
115,140,130,55,55,40,535,0.4519230769230769,56,61,65,48,45,38,313,0.17567567567567569,0.5
108,112,118,68,72,47,525,0.2916666666666667,60,62,63,80,80,60,405,0.38016528925619836,1.0
85,90,80,70,80,130,535,0.9262295081967213,60,150,50,150,50,60,520,0.5,0.0
55,40,85,80,105,40,405,0.23622047244094488,70,55,65,95,85,70,440,0.5307692307692308,0.5
65,155,120,65,90,105,600,0.8677685950413223,60,45,50,90,80,70,395,0.625,1.0
59,66,70,44,55,41,335,0.25190839694656486,90,50,34,60,44,70,348,0.6283185840707964,1.0
110,123,65,100,65,65,528,0.5217391304347826,50,75,70,35,70,48,348,0.29357798165137616,2.0
90,92,75,92,85,60,494,0.49586776859504134,83,80,75,70,70,101,479,0.8615384615384616,1.0
30,42,118,42,88,30,350,0.112,83,80,75,70,70,101,479,0.8615384615384616,2.0
60,60,40,65,45,35,305,0.15833333333333333,65,136,94,54,96,135,580,0.9612403100775194,1.0
95,75,110,100,80,30,490,0.15267175572519084,95,85,85,65,65,35,430,0.2571428571428571,2.0
100,120,120,150,100,90,680,0.7880794701986755,95,124,78,69,71,58,495,0.37398373983739835,1.0
48,72,48,72,48,48,336,0.25984251968503935,46,57,40,40,40,50,273,0.25,2.0
55,104,105,94,75,52,485,0.36363636363636365,55,69,85,32,35,28,304,0.09302325581395349,1.0
55,40,40,65,45,35,280,0.16428571428571428,45,95,50,40,50,75,355,0.54,1.0
78,84,78,109,85,100,534,0.8620689655172413,100,164,150,95,120,71,700,0.5645161290322581,0.5
50,65,85,35,35,55,325,0.32575757575757575,25,20,15,105,55,90,310,0.32407407407407407,2.0
75,95,125,45,75,95,510,0.8257575757575758,65,60,70,85,75,40,395,0.1796875,1.0
90,110,80,100,80,95,555,0.7982456140350878,50,65,64,44,48,43,314,0.2196969696969697,0.5
40,30,30,40,50,30,220,0.07936507936507936,105,140,55,30,55,95,480,0.8195488721804511,1.0
60,70,105,70,120,75,500,0.5983606557377049,45,50,55,75,65,30,320,0.06293706293706294,2.0
30,45,135,45,90,30,375,0.09285714285714286,50,75,75,65,65,50,380,0.4049586776859504,1.0
103,93,67,71,61,84,479,0.7142857142857143,110,65,105,55,95,80,510,0.6258503401360545,0.5
72,58,80,103,80,97,490,0.7171052631578947,120,70,120,75,130,85,600,0.6694915254237288,0.5
62,48,66,59,57,49,341,0.33884297520661155,60,55,50,40,55,45,305,0.22377622377622378,0.5
65,90,40,45,80,75,395,0.625,45,60,32,50,32,76,295,0.5925925925925926,1.0
68,75,53,83,113,60,452,0.45384615384615384,40,45,35,30,40,55,245,0.3793103448275862,1.0
83,80,80,135,80,121,579,0.9444444444444444,105,150,90,150,90,95,680,0.8285714285714286,1.0
105,180,100,180,100,115,780,0.9477611940298507,55,104,105,94,75,52,485,0.36363636363636365,1.0
85,115,80,105,80,50,515,0.3063063063063063,100,100,100,100,100,100,600,0.8758169934640523,1.0
100,150,140,100,90,90,670,0.7969924812030075,43,80,65,50,35,35,308,0.14193548387096774,1.0
130,85,80,85,95,60,535,0.43884892086330934,83,80,80,135,80,121,579,0.9444444444444444,2.0
100,5,5,15,65,30,220,0.07692307692307693,50,60,60,60,60,30,320,0.11290322580645161,1.0
64,88,50,88,50,106,446,0.9111111111111111,125,58,58,76,76,67,460,0.515625,1.0
100,90,130,45,65,55,485,0.4253731343283582,45,30,50,55,65,45,290,0.208,1.0
20,40,15,35,35,60,205,0.34285714285714286,110,123,65,100,65,65,528,0.5217391304347826,1.0
79,85,60,55,60,71,410,0.60431654676259,56,61,65,48,45,38,313,0.17567567567567569,0.5
38,36,38,32,36,57,237,0.3893805309734513,44,38,39,61,79,42,303,0.2251655629139073,1.0
95,65,110,60,130,65,525,0.5275590551181102,35,20,65,40,65,20,245,0.02459016393442623,0.5
70,110,70,115,70,90,525,0.75,55,69,85,32,35,28,304,0.09302325581395349,4.0
50,85,125,85,115,20,480,0.4306569343065693,110,80,90,95,90,65,530,0.5033557046979866,1.0
45,30,15,85,65,65,305,0.36220472440944884,40,50,90,30,55,65,330,0.44680851063829785,2.0
55,95,115,45,45,35,390,0.2116788321167883,70,100,115,30,65,30,410,0.24390243902439024,2.0
70,80,50,35,35,35,305,0.14,60,40,60,40,60,35,295,0.18055555555555555,1.0
75,80,55,25,35,35,305,0.18666666666666668,115,115,85,90,75,100,580,0.8134328358208955,1.0
65,50,70,95,80,65,425,0.4262295081967213,65,60,70,85,75,40,395,0.1796875,1.0
75,100,95,40,70,110,490,0.8717948717948718,75,90,50,110,80,95,500,0.7985611510791367,1.0
75,123,67,95,85,95,540,0.7642276422764228,90,90,85,125,90,100,580,0.768595041322314,1.0
75,140,65,112,65,110,567,0.9140625,40,45,35,30,40,55,245,0.3793103448275862,2.0
30,30,30,30,30,30,180,0.12612612612612611,70,60,125,115,70,55,495,0.35507246376811596,4.0
55,75,85,25,25,15,280,0.1875,30,35,30,100,35,80,310,0.4765625,1.0
75,85,200,55,65,30,510,0.16778523489932887,95,85,85,65,65,35,430,0.2571428571428571,0.5
130,85,80,85,95,60,535,0.43884892086330934,70,43,53,43,53,40,302,0.19090909090909092,1.0
61,84,65,70,70,70,420,0.5,20,15,20,10,55,80,200,0.2682926829268293,1.0
68,90,65,50,55,82,410,0.6165413533834586,65,80,80,59,63,58,405,0.4411764705882353,1.0
46,57,40,40,40,50,273,0.25,57,24,86,24,86,23,300,0.12727272727272726,0.0
150,100,120,100,120,90,680,0.6666666666666666,100,100,100,100,100,100,600,0.8602941176470589,1.0
35,80,50,50,70,120,405,0.84375,75,100,110,45,55,65,450,0.5333333333333333,1.0
38,36,38,32,36,57,237,0.3893805309734513,35,65,35,65,35,65,300,0.46621621621621623,1.0
100,73,83,73,83,55,467,0.371900826446281,50,75,70,35,70,48,348,0.29357798165137616,1.0
40,30,35,50,70,55,280,0.28205128205128205,65,40,70,80,140,70,465,0.5954198473282443,1.0
40,45,65,100,120,90,460,0.5588235294117647,60,60,60,60,60,60,360,0.38095238095238093,1.0
45,50,35,55,75,40,300,0.21367521367521367,75,105,75,105,75,45,480,0.3274336283185841,1.0
70,100,70,105,75,40,460,0.23214285714285715,106,90,130,90,154,110,680,0.8699186991869918,0.0
60,85,60,50,50,125,430,0.9090909090909091,67,82,62,46,48,43,348,0.22033898305084745,2.0
70,83,50,37,50,60,350,0.3360655737704918,40,29,45,29,45,36,224,0.14634146341463414,2.0
70,120,65,45,85,125,510,0.9747899159663865,45,100,135,65,135,45,525,0.29411764705882354,2.0
105,150,90,150,90,95,680,0.8285714285714286,50,65,85,35,35,55,325,0.32575757575757575,1.0
30,42,118,42,88,30,350,0.112,40,55,80,35,60,30,300,0.15037593984962405,0.25
65,50,35,115,95,95,455,0.7333333333333333,45,80,100,35,37,28,325,0.3125,0.25
62,50,58,73,54,72,369,0.4435483870967742,77,85,51,55,51,65,384,0.5163934426229508,2.0
90,120,100,150,120,100,680,0.7718120805369127,71,82,64,64,59,112,452,0.9327731092436975,1.0
75,140,65,112,65,110,567,0.9140625,65,90,115,45,115,58,488,0.5041322314049587,1.0
80,100,200,50,100,50,580,0.3472222222222222,50,70,50,50,50,40,310,0.16296296296296298,1.0
64,88,50,88,50,106,446,0.9111111111111111,60,70,65,125,105,90,515,0.6911764705882353,1.0
103,60,86,60,86,50,445,0.3458646616541353,50,50,50,50,50,50,300,0.30708661417322836,1.0
50,65,64,44,48,43,314,0.2196969696969697,44,75,35,63,33,45,295,0.2647058823529412,1.0
50,95,180,85,45,70,525,0.5298507462686567,70,92,65,80,55,98,460,0.8090909090909091,0.25
55,85,55,50,55,60,360,0.4233576642335766,100,120,120,150,100,90,680,0.7880794701986755,0.5
49,66,70,44,55,51,335,0.4260869565217391,78,130,111,130,85,100,634,0.8561151079136691,0.25
95,65,110,60,130,65,525,0.5275590551181102,75,123,67,95,85,95,540,0.7642276422764228,1.0
70,120,100,145,105,20,560,0.2824427480916031,65,90,122,58,75,84,494,0.71875,1.0
190,33,58,33,58,33,405,0.13432835820895522,60,50,40,85,75,95,405,0.7540983606557377,1.0
79,85,60,55,60,71,410,0.60431654676259,79,103,120,135,115,78,630,0.5763888888888888,0.5
80,90,80,130,110,110,600,0.856,105,140,95,55,65,45,505,0.3,1.0
105,95,80,40,80,90,490,0.753968253968254,76,104,71,104,71,108,534,0.912751677852349,1.0
64,165,75,93,83,75,555,0.6587301587301587,75,98,63,98,63,101,498,0.8091603053435115,1.0
30,42,118,42,88,30,350,0.112,70,115,60,115,60,55,475,0.4647887323943662,1.0
105,140,55,30,55,95,480,0.8195488721804511,100,180,160,150,90,90,770,0.7520661157024794,0.5
60,75,85,100,85,115,520,0.8992248062015504,55,84,105,114,75,52,485,0.2890625,0.5
60,70,65,125,105,90,515,0.6911764705882353,70,120,65,45,85,125,510,0.9747899159663865,1.0
80,82,100,83,100,80,525,0.6821705426356589,65,65,60,130,95,110,525,0.823943661971831,1.0
90,55,75,60,75,30,385,0.13970588235294118,125,130,90,130,90,95,660,0.7734375,1.0
50,65,45,85,65,95,405,0.7238095238095238,70,84,70,65,70,51,410,0.2949640287769784,4.0
60,45,70,45,90,95,405,0.7304964539007093,110,65,75,125,85,30,490,0.15,1.0
73,95,62,85,65,85,465,0.6666666666666666,76,48,48,57,62,34,325,0.11688311688311688,1.0
103,93,67,71,61,84,479,0.7142857142857143,105,140,95,55,65,45,505,0.3,0.5
60,50,70,80,80,140,480,0.8449612403100775,130,70,35,70,35,60,400,0.4017857142857143,2.0
45,45,35,20,30,20,195,0.07246376811594203,55,130,115,50,50,75,475,0.5982142857142857,1.0
250,5,5,35,105,50,450,0.15306122448979592,80,80,90,110,130,110,600,0.8721804511278195,1.0
75,87,63,87,63,98,473,0.865546218487395,60,130,80,60,60,70,460,0.5153846153846153,2.0
100,100,100,100,100,100,600,0.831858407079646,30,45,135,45,90,30,375,0.09285714285714286,1.0
35,80,50,50,70,120,405,0.84375,86,81,97,81,107,43,495,0.203125,1.0
108,130,95,80,85,102,600,0.7637795275590551,80,160,80,130,80,100,630,0.8455284552845529,2.0
130,70,35,70,35,60,400,0.4017857142857143,60,100,89,55,69,112,485,0.9298245614035088,1.0
45,85,50,55,50,65,350,0.5076923076923077,150,100,120,100,120,90,680,0.6666666666666666,0.0
55,50,45,135,95,120,500,0.7714285714285715,60,85,69,60,69,77,420,0.518796992481203,1.0
60,85,42,85,42,91,405,0.8227848101265823,60,60,50,40,50,75,335,0.5882352941176471,2.0
44,38,33,61,43,70,289,0.5267857142857143,65,105,60,60,70,95,455,63.0,1.0
65,60,70,85,75,40,395,0.1796875,80,95,82,60,82,75,474,0.6,1.0
80,110,60,150,130,70,600,0.5042016806722689,65,63,45,45,45,45,308,0.2595419847328244,1.0
65,125,100,60,70,70,490,0.6099290780141844,110,78,73,76,71,60,468,0.3333333333333333,0.5
65,95,100,60,50,50,420,0.34959349593495936,55,66,44,44,56,85,350,0.6888888888888889,1.0
50,53,62,58,63,44,330,0.13709677419354838,80,92,65,65,80,68,450,0.4824561403508772,0.5
45,75,37,70,55,83,365,0.6183206106870229,65,95,75,55,55,85,430,0.6933333333333334,0.5
45,60,40,70,50,45,310,0.2846715328467153,60,80,95,70,85,50,440,0.2231404958677686,2.0
75,75,75,125,95,40,485,0.15671641791044777,35,40,100,90,55,35,355,0.1796875,1.0
50,95,95,35,110,70,455,0.5179856115107914,115,45,20,45,25,20,270,0.11538461538461539,1.0
64,88,50,88,50,106,446,0.9111111111111111,50,75,70,35,70,48,348,0.29357798165137616,0.25
45,22,60,27,30,29,213,0.07518796992481203,75,100,95,40,70,110,490,0.8717948717948718,1.0
70,95,85,55,65,70,440,0.5,61,90,45,50,50,160,456,0.9230769230769231,4.0
55,55,55,85,55,30,335,0.1320754716981132,35,55,40,50,50,90,320,0.6838235294117647,1.0
100,50,80,60,80,50,420,0.34375,65,90,65,61,61,100,442,0.8373983739837398,1.0
100,5,5,15,65,30,220,0.07692307692307693,70,65,65,55,55,70,380,0.5,1.0
50,50,40,30,30,50,250,0.2781954887218045,68,90,65,50,55,82,410,0.6165413533834586,4.0
80,70,70,90,100,70,480,0.5609756097560976,85,90,80,70,80,130,535,0.9262295081967213,0.25
125,130,90,130,90,95,660,0.7734375,80,100,80,80,80,100,520,0.9051724137931034,8.0
85,120,70,50,60,100,485,0.8308823529411765,45,50,35,55,75,40,300,0.21367521367521367,1.0
73,115,60,60,60,90,458,0.6694915254237288,50,95,180,85,45,70,525,0.5298507462686567,1.0
115,45,20,45,25,20,270,0.11538461538461539,50,20,40,20,40,20,190,0.0962962962962963,1.0
70,100,70,105,75,40,460,0.23214285714285715,68,75,53,83,113,60,452,0.45384615384615384,0.5
90,120,120,60,60,50,500,0.35294117647058826,75,90,90,140,90,115,600,0.9481481481481482,2.0
92,105,90,125,90,98,600,0.8217054263565892,110,78,73,76,71,60,468,0.3333333333333333,1.0
80,160,60,170,130,80,680,0.6180555555555556,65,65,45,75,45,95,390,0.72,1.0
68,75,53,83,113,60,452,0.45384615384615384,100,75,115,90,115,85,580,0.6446280991735537,1.0
50,50,120,80,80,30,410,0.07258064516129033,100,70,70,65,65,45,415,0.1897810218978102,1.0
90,120,100,150,120,100,680,0.7718120805369127,100,100,80,60,60,50,450,0.3050847457627119,2.0
55,40,85,80,105,40,405,0.23622047244094488,53,54,53,37,46,45,288,0.3090909090909091,2.0
95,117,184,44,46,28,514,0.2975206611570248,100,150,120,120,100,90,680,0.6493506493506493,2.0
55,81,60,50,70,97,413,0.7214285714285714,103,60,86,60,86,50,445,0.3458646616541353,1.0
106,150,70,194,120,140,780,0.952,115,45,20,45,25,20,270,0.11538461538461539,1.0
100,110,90,85,90,60,535,0.47794117647058826,75,95,60,65,60,115,470,0.8778625954198473,1.0
83,80,80,135,80,121,579,0.9444444444444444,70,100,70,105,75,40,460,0.23214285714285715,1.0
65,76,84,54,96,105,480,0.9008264462809917,90,120,120,60,60,50,500,0.35294117647058826,1.0
114,85,70,85,80,30,464,0.2066115702479339,45,53,70,40,60,42,310,0.25735294117647056,0.5
103,60,126,80,126,50,545,0.36363636363636365,70,80,50,35,35,35,305,0.14,2.0
70,55,65,95,85,70,440,0.5307692307692308,65,150,60,115,60,115,565,0.935251798561151,0.0
70,60,125,115,70,55,495,0.35507246376811596,80,80,80,80,80,80,480,0.6015037593984962,2.0
30,65,100,45,25,40,305,0.1891891891891892,49,66,70,44,55,51,335,0.4260869565217391,0.5
105,105,75,65,100,50,500,0.37593984962406013,80,120,79,95,79,70,523,0.5833333333333334,1.0
37,25,41,25,41,25,194,0.08870967741935484,60,85,49,60,49,60,363,0.4444444444444444,1.0
75,75,60,83,60,60,413,0.39344262295081966,75,105,75,105,75,45,480,0.3274336283185841,0.5
50,65,107,105,107,86,520,0.7272727272727273,70,92,65,80,55,98,460,0.8090909090909091,2.0
65,155,120,65,90,105,600,0.8677685950413223,60,82,45,45,45,74,351,0.5752212389380531,2.0
50,47,50,57,50,65,319,0.463768115942029,40,45,65,100,120,90,460,0.5588235294117647,1.0
100,100,100,100,100,100,600,0.8805970149253731,48,72,48,72,48,48,336,0.25984251968503935,1.0
55,95,55,35,75,115,430,0.9380530973451328,111,83,68,92,82,39,475,0.1774193548387097,1.0
59,45,40,35,40,31,250,0.14285714285714285,60,50,70,80,80,140,480,0.8449612403100775,1.0
50,53,48,53,48,64,316,0.46153846153846156,38,35,35,65,55,50,278,0.2647058823529412,1.0
45,30,40,105,50,20,290,0.031007751937984496,50,64,50,45,50,41,300,0.22727272727272727,2.0
40,30,32,50,52,65,269,0.3671875,70,55,75,45,65,60,370,0.45901639344262296,1.0
60,60,60,60,60,60,360,0.38095238095238093,45,75,60,40,30,50,300,0.304,1.0
44,38,39,61,79,42,303,0.2251655629139073,70,110,180,60,60,50,530,0.4117647058823529,0.5
85,50,95,120,115,80,545,0.5793650793650794,66,41,77,61,87,23,355,0.12096774193548387,1.0
61,90,45,50,50,160,456,0.9230769230769231,70,120,100,145,105,20,560,0.2824427480916031,0.5
75,125,70,125,70,115,580,0.9037037037037037,38,30,85,55,65,30,303,0.21428571428571427,1.0
60,50,50,60,70,50,340,0.28346456692913385,60,90,140,50,50,40,430,0.2535211267605634,2.0
95,70,73,95,90,60,483,0.3983739837398374,40,30,30,40,50,30,220,0.07936507936507936,1.0
45,35,45,62,53,35,275,0.11851851851851852,70,150,140,65,100,75,600,0.55,0.25
75,75,55,105,85,30,425,0.1619718309859155,95,100,85,108,70,70,528,0.5652173913043478,2.0
115,115,85,90,75,100,580,0.8134328358208955,55,69,85,32,35,28,304,0.09302325581395349,2.0
75,80,95,90,100,50,490,0.2158273381294964,90,30,15,40,20,15,210,0.043478260869565216,1.0
35,85,45,35,35,75,310,0.6492537313432836,70,130,100,55,80,65,500,0.608,0.5
55,40,85,80,105,40,405,0.23622047244094488,45,75,37,70,55,83,365,0.6183206106870229,0.5
40,40,55,40,70,55,300,0.40939597315436244,60,85,60,50,50,125,430,0.9090909090909091,0.0
105,150,90,150,90,95,680,0.8285714285714286,82,121,119,69,59,71,521,0.5394736842105263,1.0
73,115,60,60,60,90,458,0.6694915254237288,100,100,100,100,100,100,600,0.8345864661654135,1.0
55,75,85,25,25,15,280,0.1875,74,94,131,54,116,20,489,0.4485294117647059,0.5
30,56,35,25,35,72,253,0.48148148148148145,75,98,63,98,63,101,498,0.849624060150376,1.0
75,100,63,80,63,116,497,0.9345794392523364,100,164,150,95,120,71,700,0.5645161290322581,1.0
45,85,50,55,50,65,350,0.5076923076923077,38,30,41,30,41,60,240,0.2897196261682243,2.0
40,27,60,37,50,66,280,0.36220472440944884,50,75,35,70,30,40,300,0.21296296296296297,0.125
40,40,35,50,100,70,335,0.5031847133757962,55,85,122,58,75,99,494,0.8099173553719008,0.5
60,25,35,70,80,60,330,0.3076923076923077,100,100,125,110,50,50,535,0.384,1.0
72,60,30,20,30,25,237,0.11570247933884298,150,160,100,95,65,100,670,0.8866666666666667,2.0
65,105,60,60,70,95,455,63.0,45,50,45,115,55,95,405,0.6936936936936937,0.0
55,50,45,135,95,120,500,0.7714285714285715,60,100,85,80,85,100,510,0.7007874015748031,0.5
40,70,130,60,130,25,455,0.17355371900826447,66,65,48,62,57,52,350,0.36220472440944884,1.0
77,120,90,60,90,48,485,0.2785714285714286,45,22,60,27,30,29,213,0.07518796992481203,1.0
70,70,40,60,40,60,340,0.4247787610619469,35,45,160,30,45,70,385,0.48148148148148145,4.0
65,50,70,95,80,65,425,0.4262295081967213,44,38,39,61,79,42,303,0.2251655629139073,1.0
55,55,55,85,55,30,335,0.1320754716981132,40,45,65,100,120,90,460,0.5588235294117647,0.5
45,25,50,25,25,35,205,0.13076923076923078,44,58,44,58,44,61,309,0.41964285714285715,0.5
80,135,85,70,95,150,615,0.9844961240310077,66,41,77,61,87,23,355,0.12096774193548387,1.0
100,150,120,120,100,90,680,0.6493506493506493,72,105,115,54,86,68,500,0.5149253731343284,2.0
30,30,42,30,42,70,244,0.4230769230769231,95,117,184,44,46,28,514,0.2975206611570248,1.0
85,80,70,135,75,90,535,0.7006802721088435,90,75,85,115,90,55,510,0.3445378151260504,1.0
75,75,75,125,95,40,485,0.15671641791044777,43,80,65,50,35,35,308,0.14193548387096774,1.0
58,64,58,80,65,80,405,0.609271523178808,97,165,60,65,50,58,495,0.3902439024390244,0.5
190,33,58,33,58,33,405,0.13432835820895522,60,59,85,79,105,36,424,0.16666666666666666,1.0
46,57,40,40,40,50,273,0.25,20,10,55,15,20,80,200,0.17985611510791366,1.0
60,62,80,63,80,60,405,0.4336283185840708,106,110,90,154,90,130,680,0.926829268292683,1.0
70,150,140,65,100,75,600,0.55,70,65,65,55,55,70,380,0.5,1.0
95,60,79,100,125,81,540,0.6201550387596899,40,45,40,62,60,60,307,0.33884297520661155,2.0
80,85,95,30,30,25,345,0.2857142857142857,35,55,40,45,40,60,275,0.35714285714285715,2.0
38,36,38,32,36,57,237,0.3893805309734513,62,50,58,73,54,72,369,0.4435483870967742,1.0
75,98,63,98,63,101,498,0.889763779527559,40,35,30,120,70,105,400,0.6692307692307692,1.0
28,25,25,45,35,40,198,0.16083916083916083,95,23,48,23,48,23,260,0.046153846153846156,0.5
66,41,77,61,87,23,355,0.12096774193548387,57,24,86,24,86,23,300,0.12727272727272726,0.25
50,75,70,35,70,48,348,0.29357798165137616,56,61,65,48,45,38,313,0.17567567567567569,1.0
70,40,50,55,50,25,290,0.061068702290076333,60,95,80,60,80,30,405,0.19480519480519481,1.0
25,35,70,95,55,45,325,0.16783216783216784,90,120,100,150,120,100,680,0.7718120805369127,0.5
45,55,39,35,39,42,255,0.18518518518518517,66,41,77,61,87,23,355,0.12096774193548387,0.5
35,85,45,35,35,75,310,0.6492537313432836,50,20,55,25,25,30,205,0.09774436090225563,2.0
110,65,75,125,85,30,490,0.15,38,35,40,27,25,35,200,0.08208955223880597,1.0
95,124,78,69,71,58,495,0.37398373983739835,62,44,50,44,50,55,305,0.3629032258064516,0.5
50,65,107,105,107,86,520,0.7313432835820896,54,66,70,44,55,46,335,0.4214876033057851,0.25
130,70,35,70,35,60,400,0.4017857142857143,75,75,95,75,95,113,528,0.9015151515151515,0.5
75,98,63,98,63,101,498,0.889763779527559,48,72,48,72,48,48,336,0.25984251968503935,1.0
85,97,66,105,66,65,484,0.47107438016528924,75,70,90,70,105,80,490,0.656,0.5
65,47,55,73,75,85,400,0.65,60,59,85,79,105,36,424,0.16666666666666666,2.0
65,130,60,75,60,75,465,0.689922480620155,60,95,80,60,80,30,405,0.19480519480519481,1.0
45,35,45,62,53,35,275,0.11851851851851852,55,45,50,45,65,80,340,0.5546218487394958,0.25
90,130,80,65,85,55,505,0.4396551724137931,72,105,115,54,86,68,500,0.5149253731343284,2.0
45,22,60,27,30,29,213,0.07518796992481203,45,67,60,35,50,63,320,0.5128205128205128,1.0
58,64,58,80,65,80,405,0.5423728813559322,85,97,66,105,66,65,484,0.47107438016528924,0.5
45,65,34,40,34,45,263,0.2589928057553957,60,75,85,100,85,115,520,0.8992248062015504,2.0
65,75,105,35,65,85,430,0.6940298507462687,75,95,125,45,75,95,510,0.8257575757575758,0.0
65,125,100,60,70,70,490,0.6099290780141844,70,55,55,80,60,45,365,0.2222222222222222,0.5
46,57,40,40,40,50,273,0.25,70,60,62,80,82,60,414,0.4375,1.0
70,20,50,20,50,40,250,0.1557377049180328,106,150,70,194,120,140,780,0.952,1.0
60,90,55,90,80,110,485,0.8677685950413223,20,15,20,10,55,80,200,0.2682926829268293,2.0
50,65,45,85,65,95,405,0.7238095238095238,50,20,40,20,40,20,190,0.0962962962962963,1.0
50,85,125,85,115,20,480,0.4306569343065693,77,85,51,55,51,65,384,0.5163934426229508,1.0
60,30,30,36,56,50,262,0.32432432432432434,38,36,38,32,36,57,237,0.3893805309734513,1.0
62,55,52,109,94,109,481,0.7833333333333333,45,35,50,70,50,30,280,0.15753424657534246,0.5
65,60,70,85,75,40,395,0.1796875,70,60,70,87,78,85,450,0.6228070175438597,1.0
80,82,78,95,80,85,500,0.6869565217391305,91,90,106,130,106,77,600,0.648854961832061,2.0
123,100,62,97,81,68,531,0.4806201550387597,100,120,120,150,100,90,680,0.7880794701986755,0.25
114,85,70,85,80,30,464,0.2066115702479339,75,89,85,55,65,36,405,0.29545454545454547,1.0
55,65,35,60,30,85,330,0.6126126126126126,106,150,70,194,120,140,780,0.952,1.0
77,59,50,67,63,46,362,0.23140495867768596,70,140,70,110,65,105,560,0.95,0.5
60,85,60,85,60,55,405,0.3673469387755102,35,55,40,50,50,90,320,0.6838235294117647,1.0
58,64,58,80,65,80,405,0.609271523178808,65,95,75,55,55,85,430,0.6933333333333334,0.5
55,63,90,50,80,42,380,0.21138211382113822,72,95,67,103,71,122,530,0.9606299212598425,4.0
40,30,35,45,40,55,245,0.31496062992125984,70,80,102,80,102,40,474,0.2677165354330709,2.0
74,100,72,90,72,46,454,0.24561403508771928,50,95,180,85,45,70,525,0.5298507462686567,2.0
110,130,80,70,60,80,530,0.5862068965517241,78,65,68,112,154,75,552,0.628099173553719,1.0
65,70,60,65,65,115,440,0.8583333333333333,65,90,122,58,75,84,494,0.71875,0.0
55,55,45,63,45,45,308,0.25,90,75,75,90,100,70,500,0.5462184873949579,0.5
40,45,40,65,40,65,295,0.5661764705882353,60,45,70,45,90,95,405,0.7304964539007093,0.5
60,65,70,85,75,40,395,0.21705426356589147,85,105,55,85,50,115,495,0.9032258064516129,2.0
105,140,55,30,55,95,480,0.8195488721804511,70,85,70,60,70,50,405,0.28378378378378377,0.5
36,50,50,65,60,44,305,0.16363636363636364,35,46,34,35,45,20,215,0.072,1.0
60,52,168,47,138,30,495,0.19834710743801653,95,65,65,110,130,60,525,0.4016393442622951,0.5
116,55,85,107,95,29,487,0.06818181818181818,45,53,70,40,60,42,310,0.25735294117647056,1.0
85,120,70,50,60,100,485,0.8308823529411765,90,65,65,40,40,15,315,0.19672131147540983,1.0
40,30,32,50,52,65,269,0.3671875,110,78,73,76,71,60,468,0.3333333333333333,1.0
85,56,77,50,77,78,423,0.53125,60,105,60,120,60,105,510,0.8849557522123894,1.0
64,66,68,81,76,50,405,0.25190839694656486,75,70,90,70,105,80,490,0.656,0.5
70,95,125,65,75,45,475,0.33613445378151263,55,69,85,32,35,28,304,0.09302325581395349,2.0
85,80,70,135,75,90,535,0.7006802721088435,70,90,70,60,60,70,420,0.6390977443609023,1.0
70,90,90,135,90,125,600,0.9401709401709402,90,60,60,40,40,40,330,0.29545454545454547,1.0
64,66,68,81,76,50,405,0.25190839694656486,60,30,30,36,56,50,262,0.32432432432432434,1.0
65,110,130,60,65,95,525,0.8278145695364238,40,40,35,50,100,70,335,0.5031847133757962,1.0
70,60,125,115,70,55,495,0.35507246376811596,30,40,70,70,25,60,295,0.41353383458646614,0.5
60,60,60,35,35,30,280,0.11194029850746269,50,50,40,30,30,50,250,0.2781954887218045,1.0
55,45,45,25,25,15,210,0.048,38,41,40,50,65,65,299,0.4108527131782946,4.0
160,110,65,65,110,30,540,0.35714285714285715,65,90,65,61,61,100,442,0.8373983739837398,1.0
60,55,90,145,90,80,520,0.6071428571428571,90,85,75,115,100,115,580,0.9381443298969072,1.0
40,55,70,45,60,30,300,0.10619469026548672,60,60,40,65,45,35,305,0.15833333333333333,0.5
130,85,80,85,95,60,535,0.43884892086330934,62,44,50,44,50,55,305,0.3629032258064516,0.5
100,180,160,150,90,90,770,0.7520661157024794,85,110,76,65,82,56,474,0.3933333333333333,1.0
50,35,55,25,25,15,205,0.05263157894736842,65,40,70,80,140,70,465,0.5954198473282443,0.5
50,105,79,35,110,76,455,0.6214285714285714,30,30,42,30,42,70,244,0.4230769230769231,0.25
60,82,45,45,45,74,351,0.5752212389380531,70,80,65,90,65,85,455,0.578125,2.0
85,80,90,105,95,60,515,0.49074074074074076,65,63,45,45,45,45,308,0.2595419847328244,1.0
106,190,100,154,100,130,780,0.9259259259259259,60,80,95,70,85,50,440,0.2231404958677686,1.0
65,136,94,54,96,135,580,0.9612403100775194,120,120,120,120,120,120,720,0.9344262295081968,2.0
70,80,70,80,70,110,480,0.6594202898550725,73,95,62,85,65,85,465,0.6666666666666666,0.0
65,125,60,95,60,105,510,0.9236641221374046,35,85,45,35,35,75,310,0.6492537313432836,1.0
75,95,60,65,60,115,470,0.8778625954198473,79,115,70,125,80,111,580,0.864,1.0
72,58,80,103,80,97,490,0.7171052631578947,39,52,43,60,50,65,309,0.49107142857142855,1.0
41,56,40,62,44,71,314,0.568,50,65,107,105,107,86,520,0.7313432835820896,0.5
40,40,50,30,30,30,220,0.0873015873015873,54,66,70,44,55,46,335,0.4214876033057851,0.5
88,107,122,74,75,64,530,0.4596774193548387,60,67,85,77,75,116,480,0.8888888888888888,0.25
165,75,80,40,45,65,470,0.5151515151515151,80,100,80,80,80,100,520,0.9051724137931034,1.0
79,105,70,145,80,101,580,0.8608695652173913,95,110,80,70,80,50,485,0.37209302325581395,1.0
40,40,40,70,40,20,250,0.032520325203252036,80,110,120,130,90,70,600,0.6198347107438017,0.25
75,105,75,105,75,45,480,0.3274336283185841,45,22,60,27,30,29,213,0.07518796992481203,1.0
45,25,50,25,25,35,205,0.13076923076923078,60,62,63,80,80,60,405,0.38016528925619836,1.0
100,120,100,150,120,90,680,0.728,105,130,120,45,45,40,485,0.4444444444444444,0.5
90,120,100,150,120,100,680,0.7718120805369127,60,70,50,100,50,65,395,0.5217391304347826,1.0
67,57,55,77,55,114,425,0.8879310344827587,95,109,105,75,85,56,525,0.34513274336283184,4.0
65,125,100,60,70,70,490,0.6099290780141844,50,150,50,150,50,150,600,0.9339622641509434,2.0
85,73,70,73,115,67,483,0.5126050420168067,50,64,50,45,50,41,300,0.22727272727272727,2.0
30,40,70,70,25,60,295,0.41353383458646614,65,90,115,45,115,58,488,0.5041322314049587,1.0
35,85,45,35,35,75,310,0.6492537313432836,55,55,85,65,85,35,380,0.2014388489208633,0.25
70,145,88,140,70,112,625,0.8888888888888888,80,105,65,60,75,130,515,0.9645390070921985,2.0
75,87,63,87,63,98,473,0.865546218487395,80,110,120,130,90,70,600,0.6198347107438017,1.0
65,130,60,95,110,65,525,0.5303030303030303,50,72,35,35,35,65,292,0.5373134328358209,1.0
150,100,120,100,120,90,680,0.6666666666666666,60,48,45,43,90,42,328,0.21897810218978103,2.0
45,45,35,20,30,20,195,0.07246376811594203,60,45,70,75,85,55,390,0.3008130081300813,2.0
75,80,95,90,100,50,490,0.2158273381294964,60,65,70,85,75,40,395,0.21705426356589147,0.25
79,105,70,145,80,101,580,0.8608695652173913,50,105,125,55,95,50,480,0.375886524822695,0.5
35,20,65,40,65,20,245,0.02459016393442623,67,82,62,46,48,43,348,0.22033898305084745,2.0
50,64,50,45,50,41,300,0.22727272727272727,68,75,53,83,113,60,452,0.45384615384615384,1.0
55,95,115,45,45,35,390,0.2116788321167883,95,135,80,110,80,100,600,0.8248175182481752,0.0
50,150,50,150,50,150,600,0.9339622641509434,45,60,40,70,50,45,310,0.2846715328467153,1.0
75,95,122,58,75,69,494,0.5725806451612904,90,30,15,40,20,15,210,0.043478260869565216,0.0
60,60,60,35,35,30,280,0.11194029850746269,60,85,69,65,79,80,438,0.576,1.0
90,100,70,110,150,80,600,0.6037735849056604,100,100,100,100,100,100,600,0.8758169934640523,0.5
70,65,60,90,75,90,450,0.6571428571428571,85,135,130,60,80,25,515,0.40540540540540543,0.5
65,105,60,60,70,95,455,63.0,90,92,87,75,85,76,505,0.5409836065573771,0.5
45,60,30,80,50,65,330,0.4603174603174603,62,73,55,56,52,84,382,0.7244094488188977,0.5
60,110,70,60,60,100,460,0.8461538461538461,85,97,66,105,66,65,484,0.47107438016528924,1.0
40,55,80,35,60,30,300,0.15037593984962405,70,55,95,95,110,65,490,0.48872180451127817,0.5
44,50,91,24,86,10,305,0.1981981981981982,65,90,50,85,45,55,390,0.371900826446281,0.25
60,85,42,85,42,91,405,0.8227848101265823,60,70,105,70,120,75,500,0.5983606557377049,2.0
50,65,107,105,107,86,520,0.7313432835820896,45,22,60,27,30,29,213,0.07518796992481203,0.5
80,105,105,105,105,80,580,0.5939849624060151,60,30,30,36,56,50,262,0.32432432432432434,1.0
80,100,123,122,120,80,625,0.56,60,110,70,60,60,100,460,0.8461538461538461,0.5
63,60,55,50,50,71,349,0.5289256198347108,65,90,65,61,61,100,442,0.8373983739837398,1.0
92,105,90,125,90,98,600,0.8217054263565892,65,60,70,85,75,40,395,0.1796875,1.0
45,55,45,65,45,75,330,0.5692307692307692,95,135,80,110,80,100,600,0.8248175182481752,4.0
55,75,85,25,25,15,280,0.1875,40,30,30,55,30,85,270,0.4666666666666667,2.0
78,84,78,109,85,100,534,0.8646616541353384,80,160,60,170,130,80,680,0.6180555555555556,1.0
71,120,95,120,95,99,600,0.8203125,50,150,50,150,50,150,600,0.9339622641509434,2.0
95,70,73,95,90,60,483,0.3983739837398374,55,66,44,44,56,85,350,0.6888888888888889,1.0
110,85,95,80,95,50,515,0.2713178294573643,50,55,50,36,30,43,264,0.2922077922077922,1.0
50,65,64,44,48,43,314,0.2196969696969697,20,10,230,10,230,5,505,0.0,2.0
100,103,75,120,75,127,600,0.940677966101695,78,84,78,109,85,100,534,0.8620689655172413,0.5
100,100,80,60,60,50,450,0.3050847457627119,60,62,80,63,80,60,405,0.4336283185840708,1.0
110,78,73,76,71,60,468,0.3333333333333333,74,48,76,83,81,104,466,0.7913043478260869,1.0
40,40,50,30,30,30,220,0.0873015873015873,105,105,75,65,100,50,500,0.37593984962406013,0.5
95,75,110,100,80,30,490,0.15267175572519084,50,105,125,55,95,50,480,0.375886524822695,0.5
61,78,95,56,58,57,405,0.40336134453781514,65,80,65,35,65,60,370,0.38405797101449274,1.0
70,120,100,145,105,20,560,0.2824427480916031,37,25,41,25,41,25,194,0.08870967741935484,1.0
70,70,115,130,90,60,535,0.5338983050847458,75,87,63,87,63,98,473,0.865546218487395,2.0
70,20,50,20,50,40,250,0.1557377049180328,85,70,80,97,80,123,535,0.9304347826086956,1.0
105,130,120,45,45,40,485,0.4444444444444444,50,50,62,40,62,65,329,0.4188034188034188,2.0
60,115,105,65,70,80,495,0.7181818181818181,95,23,48,23,48,23,260,0.046153846153846156,1.0
30,30,42,30,42,70,244,0.4230769230769231,64,78,52,78,52,81,405,0.6422764227642277,0.5
60,45,70,75,85,55,390,0.3008130081300813,75,80,70,65,75,90,455,0.7578125,2.0
120,70,120,75,130,85,600,0.6694915254237288,74,100,72,90,72,46,454,0.24561403508771928,1.0
45,55,45,65,45,75,330,0.5692307692307692,50,95,180,85,45,70,525,0.5298507462686567,0.25
80,110,120,130,90,70,600,0.6198347107438017,105,95,80,40,80,90,490,0.753968253968254,1.0
55,65,35,60,30,85,330,0.6126126126126126,126,131,95,131,98,99,680,0.8294573643410853,1.0
76,147,90,60,70,97,540,0.8267716535433071,43,80,65,50,35,35,308,0.14193548387096774,1.0
60,79,105,59,85,36,424,0.17054263565891473,79,100,80,110,90,121,580,0.968,0.0
60,60,60,60,60,60,360,0.38095238095238093,55,112,45,74,45,70,401,0.559322033898305,0.5
55,75,50,40,40,80,340,0.6302521008403361,105,130,120,45,45,40,485,0.4444444444444444,0.25
60,62,50,62,60,40,334,0.18181818181818182,91,134,95,100,100,80,600,0.6304347826086957,1.0
95,117,80,65,70,92,519,0.8409090909090909,80,105,65,60,75,130,515,0.9645390070921985,0.0
60,75,100,55,80,50,420,0.3088235294117647,45,50,35,55,75,40,300,0.21367521367521367,1.0
39,52,43,60,50,65,309,0.49107142857142855,53,54,53,37,46,45,288,0.3090909090909091,1.0
95,110,95,40,95,55,490,0.40336134453781514,50,95,180,85,45,70,525,0.5298507462686567,1.0
75,123,67,95,85,95,540,0.7642276422764228,64,165,75,93,83,75,555,0.6587301587301587,1.0
83,106,65,86,65,85,490,0.6640625,105,140,95,55,65,45,505,0.3,1.0
57,80,91,80,87,75,470,0.5737704918032787,70,120,65,45,85,125,510,0.9747899159663865,4.0
70,120,100,145,105,20,560,0.2824427480916031,110,130,80,70,60,80,530,0.5862068965517241,2.0
70,70,70,70,70,70,420,0.5289256198347108,65,90,120,85,70,60,490,0.43410852713178294,1.0
50,47,50,57,50,65,319,0.463768115942029,10,55,25,35,45,95,265,0.5396825396825397,0.0
73,115,60,60,60,90,458,0.6694915254237288,40,40,55,40,70,55,300,0.40939597315436244,1.0
38,35,35,65,55,50,278,0.2647058823529412,41,64,45,50,50,50,300,0.36752136752136755,2.0
75,65,55,65,55,69,384,0.43548387096774194,40,40,35,50,100,70,335,0.5031847133757962,1.0
45,49,49,65,65,45,318,0.2781954887218045,70,115,60,115,60,55,475,0.4647887323943662,1.0
255,10,10,75,135,55,540,0.3125,95,124,78,69,71,58,495,0.37398373983739835,1.0
115,45,20,45,25,20,270,0.11538461538461539,60,60,60,60,60,60,360,0.38095238095238093,1.0
78,84,78,109,85,100,534,0.8620689655172413,70,80,65,90,65,85,455,0.578125,1.0
73,95,62,85,65,85,465,0.6666666666666666,70,130,100,55,80,65,500,0.608,0.5
65,130,60,95,110,65,525,0.5303030303030303,60,60,50,40,50,75,335,0.5882352941176471,2.0
66,65,48,62,57,52,350,0.36220472440944884,43,30,55,40,65,97,330,0.6030534351145038,2.0
100,100,100,100,100,100,600,0.8805970149253731,50,53,48,53,48,64,316,0.4076923076923077,0.5
30,105,90,25,25,50,325,0.2773722627737226,105,150,90,150,90,95,680,0.8285714285714286,0.5
79,85,60,55,60,71,410,0.60431654676259,150,160,100,95,65,100,670,0.8866666666666667,1.0
60,95,80,60,80,30,405,0.19480519480519481,78,70,61,50,61,100,420,0.8145161290322581,1.0
67,89,116,79,116,33,500,0.2624113475177305,90,92,87,75,85,76,505,0.5409836065573771,4.0
78,130,111,130,85,100,634,0.8561151079136691,40,60,30,31,31,70,262,0.4492753623188406,1.0
35,80,50,50,70,120,405,0.84375,35,40,100,90,55,35,355,0.1796875,2.0
40,30,32,50,52,65,269,0.3671875,70,145,88,140,70,112,625,0.8888888888888888,0.25
70,110,75,145,85,145,630,0.9444444444444444,85,80,90,105,95,60,515,0.49074074074074076,1.0
105,140,55,30,55,95,480,0.8195488721804511,95,60,79,100,125,81,540,0.6201550387596899,0.5
103,93,67,71,61,84,479,0.7142857142857143,40,40,55,40,70,55,300,0.40939597315436244,1.0
60,90,55,90,80,110,485,0.8677685950413223,50,30,55,65,55,20,275,0.13675213675213677,1.0
75,80,60,65,90,102,472,0.8625954198473282,45,35,50,70,50,30,280,0.15753424657534246,1.0
70,140,70,110,65,105,560,0.95,59,63,80,65,80,58,405,0.41843971631205673,0.5
89,145,90,105,80,91,600,0.8549618320610687,74,48,76,83,81,104,466,0.7322834645669292,1.0
90,120,75,60,60,45,450,0.29411764705882354,30,65,100,45,25,40,305,0.1891891891891892,1.0
43,80,65,50,35,35,308,0.14193548387096774,40,50,90,30,55,65,330,0.44680851063829785,1.0
60,55,145,75,150,40,525,0.2,80,100,70,50,60,45,405,0.25806451612903225,0.5
55,50,65,175,95,150,590,0.7818181818181819,85,135,130,60,80,25,515,0.40540540540540543,1.0
55,66,44,44,56,85,350,0.6888888888888889,68,125,65,65,115,80,518,0.6277372262773723,1.0
70,84,70,65,70,51,410,0.2949640287769784,40,65,40,80,40,65,330,0.5038167938931297,1.0
110,160,110,80,110,100,670,0.8591549295774648,135,85,40,40,85,5,390,0.6864406779661016,1.0
90,65,65,40,40,15,315,0.19672131147540983,62,50,58,73,54,72,369,0.4435483870967742,2.0
60,67,85,77,75,116,480,0.8888888888888888,90,65,65,40,40,15,315,0.19672131147540983,2.0
80,145,150,105,110,110,700,0.8692307692307693,45,45,55,45,55,63,308,0.4594594594594595,1.0
90,75,75,90,100,70,500,0.5462184873949579,55,45,50,45,65,80,340,0.5546218487394958,0.5
44,38,39,61,79,42,303,0.2251655629139073,75,125,230,55,95,30,610,0.3448275862068966,0.5
40,60,40,40,40,30,250,0.0948905109489051,55,95,115,45,45,35,390,0.2116788321167883,0.25
40,45,40,62,60,60,307,0.33884297520661155,55,45,43,55,43,72,313,0.5853658536585366,1.0
45,22,60,27,30,29,213,0.07518796992481203,40,40,50,30,30,30,220,0.0873015873015873,2.0
75,75,95,75,95,113,528,0.9015151515151515,95,65,110,60,130,65,525,0.5275590551181102,1.0
65,75,90,97,123,44,494,0.1987179487179487,40,45,40,62,60,60,307,0.33884297520661155,1.0
90,85,100,95,125,85,580,0.6834532374100719,80,70,70,90,100,70,480,0.5609756097560976,2.0
50,35,55,25,25,15,205,0.021739130434782608,115,115,85,90,75,100,580,0.8134328358208955,0.5
50,65,64,44,48,43,314,0.2196969696969697,95,110,80,70,80,50,485,0.37209302325581395,1.0
20,40,90,30,90,25,295,0.11363636363636363,90,70,80,70,95,70,475,0.5190839694656488,1.0
80,80,90,110,130,110,600,0.8721804511278195,80,52,50,90,50,89,411,0.6666666666666666,1.0
70,43,53,43,53,40,302,0.19090909090909092,126,131,95,131,98,99,680,0.8294573643410853,2.0
50,85,55,65,65,90,410,0.7478260869565218,90,92,87,75,85,76,505,0.5409836065573771,1.0
85,110,90,45,90,80,500,0.6206896551724138,90,30,15,40,20,15,210,0.043478260869565216,1.0
90,92,75,92,85,60,494,0.49586776859504134,67,58,57,81,67,101,431,0.8790322580645161,1.0
85,80,90,105,95,60,515,0.49074074074074076,75,38,38,56,56,67,330,0.5263157894736842,1.0
100,90,130,45,65,55,485,0.4253731343283582,35,80,50,50,70,120,405,0.84375,1.0
85,105,55,85,50,115,495,0.9032258064516129,40,40,55,40,70,55,300,0.40939597315436244,2.0
60,65,80,170,95,130,600,0.8625954198473282,40,50,90,30,55,65,330,0.44680851063829785,0.5
50,95,95,35,110,70,455,0.5179856115107914,80,160,80,130,80,100,630,0.8455284552845529,1.0
30,45,135,45,90,30,375,0.09285714285714286,70,80,50,35,35,35,305,0.14,0.5
60,40,80,60,45,40,325,0.23529411764705882,65,125,100,55,70,85,500,0.6532258064516129,0.5
70,100,70,105,75,40,460,0.23214285714285715,55,50,40,40,40,75,300,0.5945945945945946,1.0
70,40,50,55,50,25,290,0.061068702290076333,73,95,62,85,65,85,465,0.6666666666666666,1.0
100,110,90,85,90,60,535,0.47794117647058826,95,155,109,70,130,81,640,0.6788321167883211,0.5
100,100,100,100,100,100,600,0.8778625954198473,50,35,55,25,25,15,205,0.05263157894736842,2.0
60,55,50,40,55,45,305,0.22377622377622378,75,100,66,60,66,115,482,0.918918918918919,1.0
60,105,60,120,60,105,510,0.8849557522123894,125,170,100,120,90,95,700,0.77,1.0
45,65,34,40,34,45,263,0.2589928057553957,105,140,55,30,55,95,480,0.8195488721804511,1.0
42,52,67,39,56,50,306,0.2868217054263566,103,60,86,60,86,50,445,0.3458646616541353,1.0
85,76,64,45,55,90,415,0.6739130434782609,55,40,50,65,85,40,335,0.3181818181818182,0.0
30,40,55,40,55,60,280,0.3237410071942446,55,70,45,70,50,60,350,0.45,1.0
64,115,65,83,63,65,455,0.5323741007194245,40,70,130,60,130,25,455,0.17355371900826447,2.0
50,53,48,53,48,64,316,0.46153846153846156,85,110,76,65,82,56,474,0.3933333333333333,2.0
77,85,51,55,51,65,384,0.5163934426229508,60,85,69,65,79,80,438,0.576,0.5
46,57,40,40,40,50,273,0.25,103,60,86,60,86,50,445,0.3458646616541353,1.0
65,80,65,35,65,60,370,0.38405797101449274,62,48,66,59,57,49,341,0.33884297520661155,1.0
70,60,125,115,70,55,495,0.35507246376811596,65,63,45,45,45,45,308,0.2595419847328244,4.0
108,112,118,68,72,47,525,0.2916666666666667,72,85,70,65,70,58,420,0.41304347826086957,1.0
90,120,100,150,120,100,680,0.7718120805369127,40,60,30,31,31,70,262,0.4492753623188406,1.0
250,5,5,35,105,50,450,0.15306122448979592,40,45,40,65,40,65,295,0.5661764705882353,1.0
37,25,41,25,41,25,194,0.08870967741935484,75,90,140,60,60,40,465,0.3008130081300813,0.5
55,75,85,25,25,15,280,0.1875,86,68,72,109,66,106,507,0.8099173553719008,2.0
75,95,95,95,95,85,540,0.6470588235294118,60,85,49,60,49,60,363,0.4444444444444444,1.0
60,130,80,60,60,70,460,0.5153846153846153,65,73,55,47,75,85,400,0.6846846846846847,0.25
36,50,50,65,60,44,305,0.16363636363636364,44,75,35,63,33,45,295,0.2647058823529412,1.0
43,30,55,40,65,97,330,0.6030534351145038,50,53,62,58,63,44,330,0.13709677419354838,0.5
70,75,80,135,80,135,575,0.917910447761194,60,80,110,50,80,45,425,0.2833333333333333,0.0
55,75,85,25,25,15,280,0.1875,130,65,60,110,95,65,525,0.5227272727272727,1.0
45,67,60,35,50,63,320,0.5128205128205128,85,97,66,105,66,65,484,0.47107438016528924,2.0
40,30,30,55,30,85,270,0.4666666666666667,35,55,40,50,50,90,320,0.6838235294117647,0.5
66,117,70,40,50,67,410,0.4573643410852713,70,90,90,135,90,125,600,0.9401709401709402,1.0
55,75,60,75,60,103,428,0.7982456140350878,79,103,120,135,115,78,630,0.5763888888888888,2.0
50,75,35,70,30,40,300,0.21296296296296297,78,92,75,74,63,118,500,0.8842975206611571,0.5
80,80,50,40,50,25,325,0.176056338028169,85,70,80,97,80,123,535,0.9304347826086956,1.0
60,60,60,85,85,85,435,0.631578947368421,82,80,86,85,75,72,480,0.6183206106870229,1.0
82,121,119,69,59,71,521,0.5394736842105263,65,85,70,75,70,40,405,0.203125,1.0
70,94,50,94,50,66,424,0.48148148148148145,37,25,41,25,41,25,194,0.08870967741935484,2.0
72,95,67,103,71,122,530,0.9606299212598425,106,130,90,110,154,90,680,0.719626168224299,2.0
90,110,80,100,80,95,555,0.7982456140350878,109,66,84,81,99,32,471,0.2013888888888889,1.0
95,125,79,60,100,81,540,0.6165413533834586,35,85,45,35,35,75,310,0.6492537313432836,1.0
45,55,45,65,45,75,330,0.5692307692307692,72,105,115,54,86,68,500,0.5149253731343284,0.25
55,55,85,65,85,35,380,0.2014388489208633,45,35,50,70,50,30,280,0.15753424657534246,0.5
35,70,55,45,55,25,285,0.09420289855072464,55,45,43,55,43,72,313,0.5853658536585366,0.5
70,60,75,110,75,90,480,0.7165354330708661,39,52,43,60,50,65,309,0.49107142857142855,0.5
72,58,80,103,80,97,490,0.7171052631578947,100,128,90,77,77,128,600,0.959349593495935,2.0
90,100,70,110,150,80,600,0.6037735849056604,50,53,48,53,48,64,316,0.4076923076923077,1.0
90,93,55,70,55,55,418,0.3819444444444444,50,65,90,35,35,15,290,0.14678899082568808,1.0
61,72,57,55,55,65,365,0.3984375,100,100,125,110,50,50,535,0.384,2.0
100,100,80,60,60,50,450,0.3050847457627119,70,65,65,55,55,70,380,0.5,1.0
70,75,60,105,60,105,475,0.88,92,105,90,125,90,98,600,0.8217054263565892,0.5
75,55,70,55,95,110,460,0.8444444444444444,50,50,50,50,50,50,300,0.30708661417322836,1.0
85,100,122,58,75,54,494,0.3939393939393939,74,108,133,83,65,32,495,0.32142857142857145,4.0
80,100,70,60,70,95,475,0.7416666666666667,44,58,44,58,44,61,309,0.41964285714285715,0.5
100,150,110,95,110,70,635,0.5923076923076923,60,50,70,50,90,65,385,0.39568345323741005,1.0
100,128,90,77,77,128,600,0.959349593495935,60,90,55,90,80,110,485,0.8677685950413223,1.0
100,50,80,60,80,50,420,0.34375,50,53,48,53,48,64,316,0.358974358974359,0.5
80,50,100,100,200,50,580,0.2357142857142857,79,105,70,145,80,101,580,0.8608695652173913,2.0
100,75,115,90,115,85,580,0.6446280991735537,80,100,123,122,120,80,625,0.56,0.5
50,80,95,10,45,10,290,0.232,40,30,30,40,50,30,220,0.07936507936507936,1.0
40,30,35,45,40,55,245,0.31496062992125984,80,52,50,90,50,89,411,0.6666666666666666,2.0
70,45,48,60,65,35,323,0.15748031496062992,65,65,60,110,95,130,525,0.9253731343283582,1.0
38,41,40,50,65,65,299,0.4108527131782946,75,125,230,55,95,30,610,0.3448275862068966,2.0
100,110,90,85,90,60,535,0.47794117647058826,80,135,130,95,90,70,600,0.5181818181818182,2.0
60,70,50,100,50,65,395,0.5217391304347826,50,30,55,65,55,20,275,0.13675213675213677,0.25
100,50,80,60,80,50,420,0.34375,76,65,45,92,42,91,411,0.7449664429530202,1.0
80,82,78,95,80,85,500,0.6869565217391305,20,40,90,30,90,25,295,0.11363636363636363,1.0
61,84,65,70,70,70,420,0.5,57,24,86,24,86,23,300,0.12727272727272726,0.5
123,77,72,99,92,58,521,0.4621212121212121,60,60,60,85,85,85,435,0.631578947368421,1.0
65,83,57,95,85,105,490,0.8914728682170543,30,45,135,45,90,30,375,0.09285714285714286,1.0
60,60,60,35,35,30,280,0.11194029850746269,75,80,70,65,75,90,455,0.7578125,1.0
45,60,45,25,45,55,275,0.29,60,80,95,70,85,50,440,0.2231404958677686,0.5
130,70,35,70,35,60,400,0.4017857142857143,50,53,48,53,48,64,316,0.46153846153846156,2.0
55,75,85,25,25,15,280,0.1875,60,79,105,59,85,36,424,0.17054263565891473,1.0
120,70,120,75,130,85,600,0.6694915254237288,64,165,75,93,83,75,555,0.6587301587301587,1.0
60,65,60,130,75,110,500,0.7719298245614035,45,80,100,35,37,28,325,0.3125,0.0
66,65,48,62,57,52,350,0.36220472440944884,60,70,50,100,50,65,395,0.5217391304347826,0.25
75,95,95,95,95,85,540,0.6470588235294118,50,50,120,80,80,30,410,0.07258064516129033,4.0
59,66,70,44,55,41,335,0.25190839694656486,110,80,90,95,90,65,530,0.5033557046979866,2.0
59,74,50,35,50,35,303,0.3125,65,90,120,85,70,60,490,0.43410852713178294,2.0
108,170,115,120,95,92,700,0.7083333333333334,30,105,90,25,25,50,325,0.2773722627737226,1.0
95,75,180,130,80,30,590,0.13793103448275862,60,65,60,130,75,110,500,0.7719298245614035,2.0
75,55,70,55,95,110,460,0.8444444444444444,91,134,95,100,100,80,600,0.6304347826086957,0.25
60,60,60,60,60,60,360,0.38095238095238093,72,85,70,65,70,58,420,0.41304347826086957,1.0
150,120,100,120,100,90,680,0.664179104477612,70,60,62,80,82,60,414,0.4375,1.0
90,92,87,75,85,76,505,0.5409836065573771,70,70,40,60,40,60,340,0.4247787610619469,1.0
106,130,90,110,154,90,680,0.719626168224299,45,100,45,45,45,10,290,0.2949640287769784,1.0
78,84,78,109,85,100,534,0.8620689655172413,40,40,55,40,70,55,300,0.40939597315436244,1.0
65,125,100,55,70,85,500,0.6532258064516129,85,90,80,70,80,130,535,0.9262295081967213,0.25
88,107,122,74,75,64,530,0.4596774193548387,40,65,95,60,45,35,340,0.13986013986013987,0.25
45,63,37,65,55,95,360,0.8055555555555556,125,170,100,120,90,95,700,0.77,0.5
80,120,70,110,70,80,530,0.6422764227642277,95,145,130,120,90,120,700,0.9398496240601504,0.25
39,52,43,60,50,65,309,0.49107142857142855,50,55,50,36,30,43,264,0.2922077922077922,1.0
40,45,40,65,40,65,295,0.5661764705882353,72,85,70,65,70,58,420,0.41304347826086957,0.5
60,40,50,75,85,95,405,0.6044776119402985,75,95,125,45,75,95,510,0.8257575757575758,0.0
70,20,50,20,50,40,250,0.1557377049180328,100,150,120,120,100,90,680,0.6493506493506493,1.0
106,130,90,110,154,90,680,0.719626168224299,75,125,100,70,80,45,495,0.33035714285714285,1.0
30,40,70,70,25,60,295,0.41353383458646614,61,72,57,55,55,65,365,0.3984375,1.0
60,70,50,100,50,65,395,0.5217391304347826,85,115,80,105,80,50,515,0.3063063063063063,0.5
105,140,95,55,65,45,505,0.3,95,60,79,100,125,81,540,0.6201550387596899,1.0
75,125,70,125,70,115,580,0.9037037037037037,70,65,60,90,75,90,450,0.6571428571428571,2.0
74,100,72,90,72,46,454,0.24561403508771928,72,105,115,54,86,68,500,0.5149253731343284,4.0
43,80,65,50,35,35,308,0.14193548387096774,80,70,40,100,60,145,495,0.921875,1.0
105,95,80,40,80,90,490,0.753968253968254,40,50,45,70,45,70,320,0.5517241379310345,1.0
65,90,122,58,75,84,494,0.71875,50,75,45,40,45,60,315,0.4380165289256198,0.5
45,30,40,105,50,20,290,0.031007751937984496,35,45,160,30,45,70,385,0.48148148148148145,2.0
74,100,72,90,72,46,454,0.24561403508771928,50,85,125,85,115,20,480,0.4306569343065693,1.0
40,30,30,40,50,30,220,0.07936507936507936,50,92,108,92,108,35,485,0.2457627118644068,1.0
65,50,70,95,80,65,425,0.4262295081967213,80,82,78,95,80,85,500,0.6869565217391305,1.0
43,80,65,50,35,35,308,0.14193548387096774,70,110,70,115,70,90,525,0.75,1.0
55,85,55,50,55,60,360,0.4233576642335766,68,75,53,83,113,60,452,0.45384615384615384,0.5
80,50,100,100,200,50,580,0.2357142857142857,35,55,40,50,50,90,320,0.6838235294117647,1.0
60,60,60,60,60,60,360,0.38095238095238093,80,120,80,120,80,100,580,0.8478260869565217,1.0
80,100,80,80,80,100,520,0.9051724137931034,70,45,48,60,65,35,323,0.15748031496062992,0.0
80,85,95,30,30,25,345,0.2857142857142857,44,58,44,58,44,61,309,0.41964285714285715,4.0
60,85,69,60,69,77,420,0.518796992481203,55,81,60,50,70,97,413,0.7214285714285714,1.0
83,80,75,70,70,101,479,0.8615384615384616,95,95,85,125,65,55,520,0.3894736842105263,2.0
77,120,90,60,90,48,485,0.2785714285714286,78,84,78,109,85,100,534,0.8620689655172413,1.0
89,124,80,55,80,55,483,0.5714285714285714,82,80,86,85,75,72,480,0.6183206106870229,1.0
120,100,85,30,85,45,465,0.22448979591836735,65,125,100,55,70,85,500,0.6532258064516129,0.5
60,90,55,90,80,110,485,0.8677685950413223,60,50,40,85,75,95,405,0.7540983606557377,0.5
100,150,110,95,110,70,635,0.5923076923076923,36,50,50,65,60,44,305,0.16363636363636364,1.0
100,73,83,73,83,55,467,0.371900826446281,80,90,80,130,110,110,600,0.856,1.0
30,40,70,70,25,60,295,0.41353383458646614,40,40,55,40,70,55,300,0.40939597315436244,2.0
60,40,50,75,85,95,405,0.6044776119402985,67,57,55,77,55,114,425,0.8879310344827587,2.0
86,92,88,68,75,73,482,0.6835443037974683,91,134,95,100,100,80,600,0.6304347826086957,1.0
55,104,105,94,75,52,485,0.36363636363636365,65,90,65,61,61,100,442,0.8373983739837398,1.0
100,100,90,150,140,90,670,0.71875,40,65,95,60,45,35,340,0.13986013986013987,1.0
106,130,90,110,154,90,680,0.719626168224299,40,29,45,29,45,36,224,0.14634146341463414,4.0
35,35,35,35,35,35,210,0.13385826771653545,80,45,65,90,110,80,470,0.5462962962962963,0.5
60,85,60,50,50,125,430,0.9090909090909091,35,55,40,50,50,90,320,0.6838235294117647,0.5
74,48,76,83,81,104,466,0.7913043478260869,50,50,62,40,62,65,329,0.4188034188034188,2.0
50,60,45,100,80,65,400,0.45689655172413796,73,115,60,60,60,90,458,0.6694915254237288,1.0
79,115,70,125,80,111,580,0.864,61,78,95,56,58,57,405,0.40336134453781514,1.0
165,75,80,40,45,65,470,0.5151515151515151,40,45,40,65,40,65,295,0.5661764705882353,1.0
40,65,95,60,45,35,340,0.13986013986013987,50,50,120,80,80,30,410,0.07258064516129033,0.5
95,80,105,40,70,100,490,0.8046875,65,90,40,45,80,75,395,0.625,1.0
50,65,64,44,48,43,314,0.2196969696969697,45,35,50,70,50,30,280,0.15753424657534246,0.5
105,95,80,40,80,90,490,0.753968253968254,48,61,40,61,40,50,300,0.2543859649122807,1.0
100,150,120,120,100,90,680,0.6493506493506493,105,125,100,60,100,100,590,0.8359375,1.0
65,47,55,73,75,85,400,0.65,160,110,65,65,110,30,540,0.35714285714285715,1.0
50,70,100,40,40,30,330,0.2222222222222222,55,95,115,45,45,35,390,0.2116788321167883,1.0
45,45,35,20,30,20,195,0.07246376811594203,50,65,45,85,65,95,405,0.7238095238095238,2.0
104,91,63,91,73,68,490,0.5118110236220472,65,90,50,85,45,55,390,0.371900826446281,1.0
1,90,45,30,30,40,236,0.33064516129032256,70,50,30,95,135,105,485,0.8040540540540541,1.0
50,120,53,35,110,87,455,0.640625,150,160,100,95,65,100,670,0.8866666666666667,2.0
30,45,59,30,39,57,260,0.2803030303030303,30,40,70,70,25,60,295,0.41353383458646614,1.0
50,65,107,105,107,86,520,0.6991150442477876,45,30,15,85,65,65,305,0.36220472440944884,2.0
86,76,86,116,56,95,515,0.7982456140350878,40,30,50,55,55,100,330,0.584070796460177,0.5
44,38,33,61,43,70,289,0.5267857142857143,64,115,65,83,63,65,455,0.5323741007194245,0.0
54,78,103,53,45,22,355,0.23255813953488372,78,70,61,50,61,100,420,0.8145161290322581,1.0
104,91,63,91,73,68,490,0.5118110236220472,45,50,43,40,38,62,278,0.40441176470588236,1.0
83,80,80,135,80,121,579,0.9444444444444444,65,55,115,100,40,60,435,0.3798449612403101,2.0
115,115,85,90,75,100,580,0.8134328358208955,43,80,65,50,35,35,308,0.14193548387096774,0.5
70,140,230,60,80,50,630,0.32432432432432434,57,80,91,80,87,75,470,0.5737704918032787,0.25
62,48,66,59,57,49,341,0.33884297520661155,70,85,70,60,70,50,405,0.28378378378378377,1.0
80,82,83,100,100,80,525,0.6742424242424242,30,30,42,30,42,70,244,0.4230769230769231,0.25
60,70,65,125,105,90,515,0.6911764705882353,80,82,100,83,100,80,525,0.6821705426356589,1.0
55,65,95,95,45,85,440,0.6610169491525424,80,100,200,50,100,50,580,0.3472222222222222,2.0
70,100,70,105,75,40,460,0.23214285714285715,70,85,65,105,85,120,530,0.9262295081967213,1.0
35,40,100,90,55,35,355,0.1796875,65,83,57,95,85,105,490,0.8914728682170543,1.0
95,75,80,100,110,30,490,0.24242424242424243,80,82,100,83,100,80,525,0.6821705426356589,0.5
60,40,80,60,45,40,325,0.23529411764705882,75,90,140,60,60,40,465,0.3008130081300813,0.125
45,50,43,40,38,62,278,0.40441176470588236,62,77,62,50,42,65,358,0.4838709677419355,1.0
60,130,80,60,60,70,460,0.5153846153846153,75,125,230,55,95,30,610,0.3448275862068966,2.0
45,95,50,40,50,75,355,0.54,79,85,60,55,60,71,410,0.60431654676259,1.0
82,80,86,85,75,72,480,0.6183206106870229,65,90,120,85,70,60,490,0.43410852713178294,0.5
65,55,115,100,40,60,435,0.3798449612403101,35,70,55,45,55,25,285,0.09420289855072464,0.25
50,60,45,100,80,65,400,0.45689655172413796,80,160,80,130,80,100,630,0.8455284552845529,0.5
50,50,50,50,50,50,300,0.30708661417322836,100,123,75,57,75,80,510,0.6923076923076923,2.0
61,90,45,50,50,160,456,0.9230769230769231,100,120,120,150,100,90,680,0.7880794701986755,0.25
72,58,80,103,80,97,490,0.7171052631578947,40,35,30,120,70,105,400,0.6692307692307692,0.5
115,45,20,45,25,20,270,0.11538461538461539,55,20,35,20,45,75,250,0.37681159420289856,1.0
70,70,115,130,90,60,535,0.5338983050847458,95,80,105,40,70,100,490,0.8046875,1.0
80,145,150,105,110,110,700,0.8692307692307693,78,81,71,74,69,126,499,0.9090909090909091,0.5
75,100,66,60,66,115,482,0.918918918918919,50,35,55,25,25,15,205,0.05263157894736842,1.0
65,45,55,45,70,45,325,0.24369747899159663,95,125,79,60,100,81,540,0.6165413533834586,0.5
111,83,68,92,82,39,475,0.1774193548387097,75,75,130,75,130,95,580,0.7479674796747967,1.0
106,190,100,154,100,130,780,0.9259259259259259,60,150,50,150,50,60,520,0.5,0.0
60,80,50,40,40,30,300,0.15328467153284672,91,72,90,129,90,108,580,0.8620689655172413,2.0
70,70,70,70,70,70,420,0.5289256198347108,60,50,70,50,90,65,385,0.39568345323741005,1.0
91,90,72,90,129,108,580,0.896,38,35,40,27,25,35,200,0.08208955223880597,0.25
62,50,58,73,54,72,369,0.4435483870967742,60,80,95,70,85,50,440,0.2231404958677686,1.0
90,60,70,75,70,45,410,0.23880597014925373,40,60,30,31,31,70,262,0.4492753623188406,2.0
40,45,40,35,35,56,251,0.373015873015873,45,49,65,49,65,45,318,0.275,2.0
76,147,90,60,70,97,540,0.8267716535433071,56,61,65,48,45,38,313,0.17567567567567569,1.0
95,110,80,70,80,50,485,0.37209302325581395,84,71,43,71,43,48,360,0.25874125874125875,1.0
90,85,75,115,100,115,580,0.9381443298969072,108,100,121,81,95,95,600,0.7476635514018691,0.0
59,63,80,65,80,58,405,0.41843971631205673,50,160,110,160,110,110,700,0.8854961832061069,2.0
70,70,115,130,90,60,535,0.5338983050847458,45,45,35,20,30,20,195,0.07246376811594203,1.0
20,40,90,30,90,25,295,0.11363636363636363,40,30,50,55,55,100,330,0.584070796460177,1.0
54,66,70,44,55,46,335,0.4214876033057851,50,65,85,35,35,55,325,0.32575757575757575,1.0
58,89,77,45,45,48,362,0.3177570093457944,91,72,90,129,90,108,580,0.8620689655172413,0.5
70,60,125,115,70,55,495,0.35507246376811596,105,140,55,30,55,95,480,0.8195488721804511,4.0
40,30,30,40,50,30,220,0.07936507936507936,35,55,40,45,40,60,275,0.35714285714285715,1.0
65,80,140,40,70,70,465,0.5223880597014925,95,110,80,70,80,50,485,0.37209302325581395,2.0
58,109,112,48,48,109,484,0.8805970149253731,60,65,70,85,75,40,395,0.21705426356589147,1.0
80,52,50,90,50,89,411,0.6666666666666666,59,74,50,35,50,35,303,0.3125,0.5
70,20,50,20,50,40,250,0.1557377049180328,75,55,70,55,95,110,460,0.8444444444444444,0.5
67,82,62,46,48,43,348,0.22033898305084745,95,109,105,75,85,56,525,0.34513274336283184,1.0
45,55,39,35,39,42,255,0.18518518518518517,55,55,50,45,65,55,325,0.37373737373737376,1.0
62,44,50,44,50,55,305,0.3629032258064516,65,155,120,65,90,105,600,0.8677685950413223,2.0
86,76,86,116,56,95,515,0.7982456140350878,76,25,45,67,55,24,292,0.0390625,2.0
55,55,55,85,55,30,335,0.1320754716981132,20,40,90,30,90,25,295,0.11363636363636363,1.0
80,115,80,65,55,93,488,0.7846153846153846,55,75,85,25,25,15,280,0.1875,0.25
60,55,145,75,150,40,525,0.2,75,110,110,110,105,80,590,0.656934306569343,0.5
95,110,95,40,95,55,490,0.40336134453781514,50,50,120,80,80,30,410,0.07258064516129033,0.5
39,52,43,60,50,65,309,0.49107142857142855,55,75,50,40,40,80,340,0.6302521008403361,1.0
64,78,52,78,52,81,405,0.6422764227642277,64,115,65,83,63,65,455,0.5323741007194245,0.0
45,60,45,25,45,55,275,0.29,45,45,35,20,30,20,195,0.07246376811594203,1.0
75,125,75,30,75,85,465,0.625,73,76,75,81,100,100,505,0.8110236220472441,1.0
55,35,50,55,110,85,390,0.6277372262773723,45,85,50,55,50,65,350,0.5076923076923077,1.0
60,50,70,80,80,140,480,0.8449612403100775,100,77,77,128,128,90,600,0.6901408450704225,1.0
45,75,60,40,30,50,300,0.304,106,150,70,194,120,140,780,0.952,1.0
190,33,58,33,58,33,405,0.13432835820895522,75,80,70,65,75,90,455,0.7578125,2.0
78,104,78,159,115,100,634,0.8444444444444444,75,95,122,58,75,69,494,0.5725806451612904,4.0
55,47,52,40,40,41,275,0.16806722689075632,91,72,90,129,90,108,580,0.8620689655172413,1.0
80,125,75,40,95,85,500,0.6911764705882353,80,110,120,130,90,70,600,0.6198347107438017,0.5
85,70,80,97,80,123,535,0.9304347826086956,91,72,90,129,90,108,580,0.8925619834710744,2.0
100,134,110,95,100,61,600,0.4057971014492754,100,103,75,120,75,127,600,0.940677966101695,2.0
50,105,125,55,95,50,480,0.375886524822695,60,60,60,60,60,60,360,0.38095238095238093,1.0
70,80,50,35,35,35,305,0.14,45,65,34,40,34,45,263,0.2589928057553957,1.0
65,100,70,80,80,105,500,0.8666666666666667,91,72,90,129,90,108,580,0.8925619834710744,0.5
71,82,64,64,59,112,452,0.9327731092436975,70,60,70,87,78,85,450,0.6228070175438597,1.0
165,75,80,40,45,65,470,0.5151515151515151,40,65,40,80,40,65,330,0.5038167938931297,1.0
97,165,60,65,50,58,495,0.3902439024390244,50,65,107,105,107,86,520,0.7272727272727273,2.0
150,160,100,95,65,100,670,0.8866666666666667,65,50,35,115,95,95,455,0.7333333333333333,1.0
84,86,88,111,101,60,530,0.4634146341463415,45,49,49,65,65,45,318,0.2781954887218045,0.5
70,84,70,65,70,51,410,0.2949640287769784,60,110,70,60,60,100,460,0.8461538461538461,0.0
45,55,45,65,45,75,330,0.5692307692307692,70,43,53,43,53,40,302,0.19090909090909092,1.0
91,72,90,129,90,108,580,0.8925619834710744,85,50,95,120,115,80,545,0.5793650793650794,0.25
74,94,131,54,116,20,489,0.4485294117647059,60,80,50,50,50,40,330,0.23853211009174313,1.0
70,85,65,105,85,120,530,0.9262295081967213,75,123,67,95,85,95,540,0.7642276422764228,1.0
60,85,60,85,60,55,405,0.3673469387755102,70,90,70,60,60,70,420,0.6390977443609023,2.0
75,89,85,55,65,36,405,0.29545454545454547,95,75,110,100,80,30,490,0.15267175572519084,2.0
65,90,50,85,45,55,390,0.371900826446281,45,60,30,80,50,65,330,0.4603174603174603,0.5
50,25,28,45,55,15,218,0.0625,50,30,55,65,55,20,275,0.13675213675213677,0.5
40,80,35,35,45,70,305,0.4661016949152542,109,66,84,81,99,32,471,0.2013888888888889,1.0
44,38,33,61,43,70,289,0.5267857142857143,50,75,35,70,30,40,300,0.21296296296296297,0.5
57,24,86,24,86,23,300,0.12727272727272726,55,55,55,85,55,30,335,0.1320754716981132,0.5
55,50,40,40,40,75,300,0.5945945945945946,55,50,45,135,95,120,500,0.7714285714285715,1.0
110,135,60,50,65,88,508,0.7744360902255639,65,75,105,35,65,85,430,0.6940298507462687,0.0
55,65,35,60,30,85,330,0.6126126126126126,70,90,110,60,75,95,500,0.7333333333333333,1.0
74,108,133,83,65,32,495,0.32142857142857145,90,92,87,75,85,76,505,0.5409836065573771,1.0
65,95,57,100,85,93,495,0.7441860465116279,150,120,100,120,100,90,680,0.664179104477612,0.5
40,30,35,45,40,55,245,0.31496062992125984,72,105,115,54,86,68,500,0.5149253731343284,0.5
70,105,105,50,40,20,390,0.33587786259541985,30,45,55,70,55,85,340,0.5633802816901409,1.0
65,80,80,59,63,58,405,0.4411764705882353,66,41,77,61,87,23,355,0.12096774193548387,1.0
65,75,70,95,70,95,470,0.7272727272727273,50,65,107,105,107,86,520,0.703125,0.5
75,80,95,90,100,50,490,0.2158273381294964,70,95,85,55,65,70,440,0.5,2.0
50,60,60,60,60,30,320,0.11290322580645161,250,5,5,35,105,50,450,0.15306122448979592,1.0
80,125,75,40,95,85,500,0.6911764705882353,64,78,52,78,52,81,405,0.6422764227642277,0.25
55,70,55,40,55,85,360,0.7073170731707317,50,52,48,65,50,55,320,0.33098591549295775,1.0
10,55,25,35,45,95,265,0.5396825396825397,45,50,43,40,38,62,278,0.40441176470588236,0.0
80,110,60,150,130,70,600,0.5042016806722689,45,90,20,65,20,65,305,0.5116279069767442,0.0
60,50,40,85,75,95,405,0.7540983606557377,90,95,95,70,90,70,510,0.5230769230769231,2.0
65,90,122,58,75,84,494,0.71875,70,110,70,115,70,90,525,0.75,0.5
30,105,90,25,25,50,325,0.2773722627737226,79,115,70,125,80,111,580,0.864,1.0
70,145,88,140,70,112,625,0.8888888888888888,74,100,72,90,72,46,454,0.24561403508771928,1.0
110,135,60,50,65,88,508,0.7744360902255639,45,40,60,40,75,50,310,0.2926829268292683,0.0
67,57,55,77,55,114,425,0.8879310344827587,45,95,50,40,50,75,355,0.54,1.0
30,56,35,25,35,72,253,0.48148148148148145,90,92,87,75,85,76,505,0.5409836065573771,1.0
45,80,100,35,37,28,325,0.3125,59,63,80,65,80,58,405,0.41843971631205673,0.5
70,100,70,105,75,40,460,0.23214285714285715,70,110,80,55,80,105,500,0.8794326241134752,0.0
79,115,70,125,80,111,580,0.8468468468468469,64,66,68,81,76,50,405,0.25190839694656486,1.0
83,106,65,86,65,85,490,0.6640625,60,50,100,85,70,65,430,0.47580645161290325,0.5
40,50,45,70,45,70,320,0.5517241379310345,60,50,50,60,70,50,340,0.28346456692913385,2.0
70,50,30,95,135,105,485,0.8040540540540541,55,68,64,45,55,31,318,0.11666666666666667,2.0
55,50,45,135,95,120,500,0.7714285714285715,106,110,90,154,90,130,680,0.926829268292683,0.5
85,90,80,70,80,130,535,0.9262295081967213,60,48,45,43,90,42,328,0.21897810218978103,1.0
90,55,75,60,75,30,385,0.13970588235294118,50,75,75,65,65,50,380,0.4049586776859504,0.0
60,60,75,60,75,80,410,0.7321428571428571,75,75,60,83,60,60,413,0.39344262295081966,1.0
75,80,95,90,100,50,490,0.2158273381294964,80,160,80,130,80,100,630,0.8455284552845529,0.5
50,53,62,58,63,44,330,0.13709677419354838,85,105,55,85,50,115,495,0.9032258064516129,0.5
70,55,95,95,110,65,490,0.48872180451127817,90,75,75,90,100,70,500,0.5462184873949579,1.0
45,50,35,55,75,40,300,0.21367521367521367,64,51,23,51,23,28,240,0.11363636363636363,1.0
55,75,50,40,40,80,340,0.6302521008403361,60,50,70,50,90,65,385,0.39568345323741005,2.0
40,65,40,80,40,65,330,0.5038167938931297,61,78,95,56,58,57,405,0.40336134453781514,1.0
46,57,40,40,40,50,273,0.25,109,66,84,81,99,32,471,0.2013888888888889,0.5
79,115,70,125,80,111,580,0.8468468468468469,103,60,126,80,126,50,545,0.36363636363636365,1.0
80,145,150,105,110,110,700,0.8692307692307693,70,110,70,115,70,90,525,0.75,0.25
90,93,55,70,55,55,418,0.3819444444444444,63,63,47,41,41,74,329,0.56,1.0
90,110,80,100,80,95,555,0.7982456140350878,90,85,75,115,100,115,580,0.9381443298969072,1.0
99,68,83,72,87,51,460,0.417910447761194,60,62,50,62,60,40,334,0.18181818181818182,1.0
62,48,66,59,57,49,341,0.33884297520661155,95,124,78,69,71,58,495,0.37398373983739835,4.0
95,75,110,100,80,30,490,0.15267175572519084,50,72,35,35,35,65,292,0.5373134328358209,0.0
50,40,85,40,65,25,305,0.08870967741935484,70,110,180,60,60,50,530,0.4117647058823529,0.5
106,110,90,154,90,130,680,0.926829268292683,70,20,50,20,50,40,250,0.1557377049180328,1.0
60,50,150,50,150,60,520,0.5206611570247934,106,90,130,90,154,110,680,0.8699186991869918,2.0
62,44,50,44,50,55,305,0.3629032258064516,100,77,77,128,128,90,600,0.6901408450704225,1.0
55,35,50,55,110,85,390,0.6277372262773723,125,130,90,130,90,95,660,0.7734375,1.0
30,35,30,100,35,80,310,0.4765625,50,50,40,50,40,64,294,0.45588235294117646,1.0
75,110,110,110,105,80,590,0.656934306569343,100,134,110,95,100,61,600,0.4057971014492754,2.0
55,66,44,44,56,85,350,0.6888888888888889,75,87,63,87,63,98,473,0.865546218487395,1.0
70,80,102,80,102,40,474,0.2677165354330709,77,85,51,55,51,65,384,0.5163934426229508,2.0
40,60,40,40,40,30,250,0.0948905109489051,40,40,55,40,70,55,300,0.40939597315436244,1.0
50,53,48,53,48,64,316,0.46153846153846156,40,55,99,40,79,47,360,0.26262626262626265,2.0
80,75,150,75,150,50,580,0.30973451327433627,75,100,63,80,63,116,497,0.9345794392523364,0.5
80,160,80,130,80,100,630,0.8455284552845529,95,155,109,70,130,81,640,0.6788321167883211,1.0
90,92,87,75,85,76,505,0.5409836065573771,35,45,160,30,45,70,385,0.48148148148148145,0.5
30,56,35,25,35,72,253,0.48148148148148145,45,67,60,35,50,63,320,0.5128205128205128,1.0
20,25,45,70,90,60,310,0.30833333333333335,90,75,85,115,90,55,510,0.3445378151260504,1.0
62,77,62,50,42,65,358,0.4838709677419355,70,55,75,45,65,60,370,0.45901639344262296,1.0
84,86,88,111,101,60,530,0.4634146341463415,50,70,50,50,50,70,340,0.5645161290322581,1.0
70,115,60,115,60,55,475,0.4647887323943662,90,55,75,60,75,30,385,0.13970588235294118,1.0
64,78,52,78,52,81,405,0.6422764227642277,71,73,88,120,89,59,500,0.43537414965986393,0.5
45,85,70,40,40,60,340,0.5229357798165137,70,75,80,135,80,135,575,0.917910447761194,0.5
55,40,85,80,105,40,405,0.23622047244094488,40,55,30,30,30,85,270,0.688,1.0
55,50,45,135,95,120,500,0.7714285714285715,70,135,105,60,105,20,495,0.5806451612903226,0.5
50,64,50,45,50,41,300,0.22727272727272727,86,68,72,109,66,106,507,0.8099173553719008,4.0
85,110,76,65,82,56,474,0.3933333333333333,95,85,85,65,65,35,430,0.2571428571428571,4.0
120,120,120,120,120,120,720,0.9344262295081968,75,75,55,105,85,30,425,0.1619718309859155,1.0
80,125,75,40,95,85,500,0.6911764705882353,70,75,80,135,80,135,575,0.917910447761194,1.0
59,110,150,45,49,35,448,0.3333333333333333,35,45,160,30,45,70,385,0.48148148148148145,2.0
40,40,50,30,30,30,220,0.0873015873015873,85,80,70,135,75,90,535,0.7006802721088435,1.0
50,80,95,10,45,10,290,0.232,80,95,82,60,82,75,474,0.6,1.0
63,60,55,50,50,71,349,0.5289256198347108,65,50,35,115,95,95,455,0.7333333333333333,1.0
95,75,180,130,80,30,590,0.13793103448275862,95,85,85,65,65,35,430,0.2571428571428571,2.0
80,75,150,75,150,50,580,0.30973451327433627,80,95,82,60,82,75,474,0.6,1.0
60,60,60,35,35,30,280,0.11194029850746269,95,155,109,70,130,81,640,0.6788321167883211,1.0
65,47,55,73,75,85,400,0.65,90,55,75,60,75,30,385,0.13970588235294118,1.0
70,70,70,70,70,70,420,0.5289256198347108,20,10,55,15,20,80,200,0.17985611510791366,1.0
95,70,73,95,90,60,483,0.3983739837398374,90,100,60,90,60,80,480,0.6422764227642277,2.0
60,50,70,50,90,65,385,0.39568345323741005,45,60,30,80,50,65,330,0.4603174603174603,1.0
75,55,70,55,95,110,460,0.8444444444444444,55,50,65,175,95,150,590,0.7818181818181819,1.0
65,90,50,85,45,55,390,0.371900826446281,60,110,70,60,60,100,460,0.8461538461538461,0.5
105,130,120,45,45,40,485,0.4444444444444444,130,65,60,110,95,65,525,0.5227272727272727,1.0
90,92,75,92,85,60,494,0.49586776859504134,190,33,58,33,58,33,405,0.13432835820895522,1.0
84,86,88,111,101,60,530,0.4634146341463415,50,50,95,40,50,35,320,0.20279720279720279,2.0
83,106,65,86,65,85,490,0.6640625,50,50,40,50,40,64,294,0.45588235294117646,1.0
40,30,32,50,52,65,269,0.3671875,30,35,30,100,35,80,310,0.4765625,0.25
75,105,75,105,75,45,480,0.3274336283185841,70,85,70,60,70,50,405,0.28378378378378377,1.0
60,50,150,50,150,60,520,0.5206611570247934,58,70,45,40,45,42,300,0.25925925925925924,1.0
67,89,116,79,116,33,500,0.2624113475177305,50,65,85,35,35,55,325,0.32575757575757575,2.0
90,93,55,70,55,55,418,0.3819444444444444,70,90,110,60,75,95,500,0.7333333333333333,1.0
65,90,115,45,115,58,488,0.5041322314049587,35,20,65,40,65,20,245,0.02459016393442623,0.25
70,55,55,80,60,45,365,0.2222222222222222,80,105,105,105,105,80,580,0.5939849624060151,1.0
95,70,73,95,90,60,483,0.3983739837398374,55,35,50,55,110,85,390,0.6277372262773723,1.0
105,30,105,140,105,55,540,0.3524590163934426,55,75,50,40,40,80,340,0.6302521008403361,1.0
50,85,55,65,65,90,410,0.7478260869565218,63,120,85,90,55,55,468,0.2809917355371901,0.5
55,81,60,50,70,97,413,0.7214285714285714,60,60,60,105,105,105,495,0.848,0.0
35,55,40,45,40,60,275,0.35714285714285715,61,78,95,56,58,57,405,0.40336134453781514,0.5
100,150,140,100,90,90,670,0.7969924812030075,35,55,40,50,50,90,320,0.6838235294117647,2.0
61,72,57,55,55,65,365,0.3984375,70,90,70,60,60,70,420,0.6390977443609023,1.0
91,129,90,72,90,108,580,0.8536585365853658,84,86,88,111,101,60,530,0.4634146341463415,1.0
85,110,90,45,90,80,500,0.6206896551724138,90,70,80,70,95,70,475,0.5190839694656488,1.0
55,55,55,85,55,30,335,0.1320754716981132,65,125,100,55,70,85,500,0.6532258064516129,1.0
55,50,45,135,95,120,500,0.7714285714285715,100,70,70,65,65,45,415,0.1897810218978102,1.0
20,10,230,10,230,5,505,0.0,45,35,50,70,50,30,280,0.15753424657534246,2.0
77,85,51,55,51,65,384,0.5163934426229508,100,100,100,100,100,100,600,0.8602941176470589,2.0
80,70,70,90,100,70,480,0.5609756097560976,70,100,70,105,75,40,460,0.23214285714285715,4.0
51,65,65,80,75,59,395,0.4365079365079365,64,165,75,93,83,75,555,0.6587301587301587,1.0
55,75,60,75,60,103,428,0.7982456140350878,60,60,40,65,45,35,305,0.15833333333333333,0.0
68,125,65,65,115,80,518,0.6277372262773723,72,85,70,65,70,58,420,0.41304347826086957,0.0
95,75,80,100,110,30,490,0.24242424242424243,95,135,80,110,80,100,600,0.8248175182481752,0.5
68,72,78,38,42,32,330,0.23809523809523808,72,85,70,65,70,58,420,0.41304347826086957,1.0
91,134,95,100,100,80,600,0.6304347826086957,83,80,75,70,70,101,479,0.8615384615384616,1.0
59,63,80,65,80,58,405,0.41843971631205673,60,67,85,77,75,116,480,0.8888888888888888,0.5
78,104,78,159,115,100,634,0.8444444444444444,85,56,77,50,77,78,423,0.53125,1.0
70,55,95,95,110,65,490,0.48872180451127817,70,75,80,135,80,135,575,0.917910447761194,1.0
50,100,150,100,150,50,600,0.37142857142857144,75,89,85,55,65,36,405,0.29545454545454547,1.0
80,115,80,65,55,93,488,0.7846153846153846,45,50,45,115,55,95,405,0.6936936936936937,0.0
85,120,70,50,60,100,485,0.8308823529411765,30,45,59,30,39,57,260,0.2803030303030303,2.0
40,80,35,35,45,70,305,0.4661016949152542,45,53,70,40,60,42,310,0.25735294117647056,0.5
72,85,70,65,70,58,420,0.41304347826086957,105,30,105,140,105,55,540,0.3524590163934426,2.0
40,50,90,30,55,65,330,0.44680851063829785,50,70,50,50,50,70,340,0.5645161290322581,0.5
68,75,53,83,113,60,452,0.45384615384615384,43,70,48,50,60,38,309,0.2391304347826087,1.0
60,52,168,47,138,30,495,0.19834710743801653,43,80,65,50,35,35,308,0.14193548387096774,0.5
62,44,50,44,50,55,305,0.3629032258064516,50,92,108,92,108,35,485,0.2457627118644068,1.0
70,140,230,60,80,50,630,0.32432432432432434,45,45,35,20,30,20,195,0.07246376811594203,1.0
30,45,135,45,90,30,375,0.09285714285714286,65,75,105,35,65,85,430,0.6940298507462687,1.0
80,50,100,100,200,50,580,0.2357142857142857,70,85,70,60,70,50,405,0.28378378378378377,1.0
56,61,65,48,45,38,313,0.17567567567567569,65,80,140,40,70,70,465,0.5223880597014925,0.25
75,75,55,105,85,30,425,0.1619718309859155,55,35,50,55,110,85,390,0.6277372262773723,0.25
75,125,100,70,80,45,495,0.33035714285714285,43,70,48,50,60,38,309,0.2391304347826087,1.0
99,68,83,72,87,51,460,0.417910447761194,55,81,60,50,70,97,413,0.7214285714285714,1.0
89,125,90,115,80,101,600,0.8725490196078431,108,112,118,68,72,47,525,0.2916666666666667,1.0
84,71,43,71,43,48,360,0.25874125874125875,50,48,43,46,41,60,288,0.47297297297297297,1.0
95,109,105,75,85,56,525,0.34513274336283184,68,85,65,165,135,100,618,0.8083333333333333,1.0
90,95,105,165,110,45,610,0.2890625,65,50,70,95,80,65,425,0.4262295081967213,1.0
49,55,42,42,37,85,310,0.6068376068376068,65,65,60,110,95,130,525,0.9253731343283582,1.0
70,55,55,80,60,45,365,0.2222222222222222,50,45,45,35,35,50,260,0.23529411764705882,1.0
74,108,133,83,65,32,495,0.32142857142857145,50,65,64,44,48,43,314,0.2196969696969697,0.5
70,55,75,45,65,60,370,0.45901639344262296,105,105,75,65,100,50,500,0.37593984962406013,1.0
40,55,30,30,30,85,270,0.688,95,60,79,100,125,81,540,0.6201550387596899,1.0
100,110,90,85,90,60,535,0.47794117647058826,38,41,40,50,65,65,299,0.4108527131782946,4.0
40,55,99,40,79,47,360,0.26262626262626265,43,70,48,50,60,38,309,0.2391304347826087,1.0
79,115,70,125,80,111,580,0.864,55,47,52,40,40,41,275,0.16806722689075632,1.0
59,45,40,35,40,31,250,0.14285714285714285,65,90,65,61,61,100,442,0.8373983739837398,1.0
60,67,85,77,75,116,480,0.8888888888888888,38,35,40,27,25,35,200,0.08208955223880597,0.5
75,89,85,55,65,36,405,0.29545454545454547,103,93,67,71,61,84,479,0.7142857142857143,0.5
62,48,66,59,57,49,341,0.33884297520661155,45,22,60,27,30,29,213,0.07518796992481203,1.0
25,20,15,105,55,90,310,0.32407407407407407,55,85,55,50,55,60,360,0.4233576642335766,1.0
30,40,55,40,55,60,280,0.3237410071942446,10,55,25,35,45,95,265,0.5396825396825397,2.0
40,30,30,40,50,30,220,0.07936507936507936,70,75,80,135,80,135,575,0.917910447761194,1.0
105,130,120,45,45,40,485,0.4444444444444444,50,65,107,105,107,86,520,0.7272727272727273,0.0
91,129,90,72,90,108,580,0.8536585365853658,65,75,105,35,65,85,430,0.6940298507462687,0.5
50,80,95,10,45,10,290,0.232,95,110,80,70,80,50,485,0.37209302325581395,2.0
60,130,80,60,60,70,460,0.5153846153846153,80,82,83,100,100,80,525,0.6742424242424242,0.125
150,100,120,100,120,90,680,0.6666666666666666,95,80,105,40,70,100,490,0.8046875,0.0
70,115,60,115,60,55,475,0.4647887323943662,100,120,120,150,100,90,680,0.7880794701986755,0.25
100,100,90,150,140,90,670,0.71875,75,110,110,110,105,80,590,0.656934306569343,0.5
126,131,95,131,98,99,680,0.8102189781021898,70,90,110,60,75,95,500,0.7333333333333333,0.5
60,59,85,79,105,36,424,0.16666666666666666,62,48,66,59,57,49,341,0.33884297520661155,0.5
75,75,55,105,85,30,425,0.1619718309859155,80,100,80,80,80,100,520,0.9051724137931034,1.0
106,110,90,154,90,130,680,0.926829268292683,53,51,53,61,56,40,314,0.14285714285714285,1.0
60,85,60,85,60,55,405,0.3673469387755102,70,70,70,70,70,70,420,0.5289256198347108,2.0
80,160,60,170,130,80,680,0.6180555555555556,90,90,85,125,90,100,580,0.768595041322314,1.0
60,50,40,85,75,95,405,0.7540983606557377,70,150,140,65,100,75,600,0.55,1.0
70,135,105,60,105,20,495,0.5806451612903226,79,103,120,135,115,78,630,0.5763888888888888,0.5
65,45,55,45,70,45,325,0.24369747899159663,55,40,85,80,105,40,405,0.23622047244094488,1.0
73,100,60,100,60,65,458,0.42657342657342656,60,45,70,75,85,55,390,0.3008130081300813,1.0
45,30,35,20,20,45,195,0.14782608695652175,60,45,50,90,80,70,395,0.625,0.5
78,104,78,159,115,100,634,0.8444444444444444,60,80,50,50,50,40,330,0.23853211009174313,1.0
73,76,75,81,100,100,505,0.8110236220472441,39,52,43,60,50,65,309,0.49107142857142855,0.5
70,110,70,115,70,90,525,0.75,95,155,109,70,130,81,640,0.6788321167883211,1.0
70,110,75,145,85,145,630,0.9444444444444444,100,123,75,57,75,80,510,0.6923076923076923,0.5
40,45,65,100,120,90,460,0.5588235294117647,74,100,72,90,72,46,454,0.24561403508771928,1.0
100,103,75,120,75,127,600,0.940677966101695,74,108,133,83,65,32,495,0.32142857142857145,2.0
55,47,52,40,40,41,275,0.16806722689075632,30,42,118,42,88,30,350,0.112,0.0
100,120,100,150,120,90,680,0.728,44,75,35,63,33,45,295,0.2647058823529412,1.0
35,64,85,74,55,32,345,0.19827586206896552,45,30,40,105,50,20,290,0.031007751937984496,1.0
55,75,50,40,40,80,340,0.6302521008403361,55,45,50,45,65,80,340,0.5546218487394958,2.0
30,35,30,100,35,80,310,0.4765625,60,85,42,85,42,91,405,0.8227848101265823,0.5
80,145,150,105,110,110,700,0.8692307692307693,65,150,60,115,60,115,565,0.935251798561151,0.0
43,80,65,50,35,35,308,0.14193548387096774,50,75,70,35,70,48,348,0.29357798165137616,1.0
100,150,120,120,100,90,680,0.6493506493506493,60,85,49,60,49,60,363,0.4444444444444444,0.5
60,80,50,50,50,40,330,0.23853211009174313,70,95,85,55,65,70,440,0.5,0.5
55,35,50,55,110,85,390,0.6277372262773723,60,85,42,85,42,91,405,0.8227848101265823,1.0
100,120,120,150,100,90,680,0.7880794701986755,72,105,115,54,86,68,500,0.5149253731343284,1.0
103,60,126,80,126,50,545,0.36363636363636365,69,69,76,69,86,91,460,0.6554621848739496,1.0
60,85,60,50,50,125,430,0.9090909090909091,77,120,90,60,90,48,485,0.2785714285714286,1.0
35,55,35,30,30,35,220,0.23684210526315788,45,95,50,40,50,75,355,0.54,1.0
40,55,99,40,79,47,360,0.26262626262626265,65,75,90,97,123,44,494,0.1987179487179487,0.25
50,65,107,105,107,86,520,0.703125,43,70,48,50,60,38,309,0.2391304347826087,1.0
84,86,88,111,101,60,530,0.4634146341463415,70,65,60,90,75,90,450,0.6571428571428571,1.0
59,110,150,45,49,35,448,0.3333333333333333,55,104,105,94,75,52,485,0.36363636363636365,0.5
75,140,65,112,65,110,567,0.9140625,110,65,105,55,95,80,510,0.6258503401360545,2.0
85,110,76,65,82,56,474,0.3933333333333333,78,70,61,50,61,100,420,0.8145161290322581,0.0
65,60,70,85,75,40,395,0.1796875,80,95,82,60,82,75,474,0.6,1.0
65,60,110,130,95,65,525,0.47761194029850745,103,60,126,80,126,50,545,0.36363636363636365,1.0
150,160,100,95,65,100,670,0.8866666666666667,70,55,55,80,60,45,365,0.2222222222222222,1.0
78,84,78,109,85,100,534,0.8620689655172413,50,75,75,65,65,50,380,0.4049586776859504,1.0
79,115,70,125,80,111,580,0.8468468468468469,30,56,35,25,35,72,253,0.48148148148148145,1.0
40,45,40,65,40,65,295,0.5661764705882353,35,55,40,45,40,60,275,0.35714285714285715,0.5
65,75,90,97,123,44,494,0.1987179487179487,75,38,38,56,56,67,330,0.5263157894736842,1.0
74,48,76,83,81,104,466,0.7322834645669292,40,30,35,45,40,55,245,0.31496062992125984,1.0
65,80,65,35,65,60,370,0.38405797101449274,100,180,160,150,90,90,770,0.7520661157024794,1.0
55,50,45,135,95,120,500,0.7714285714285715,70,77,60,97,60,108,472,0.8394160583941606,1.0
78,92,75,74,63,118,500,0.8842975206611571,72,95,67,103,71,122,530,0.9606299212598425,2.0
76,25,45,67,55,24,292,0.0390625,78,84,78,109,85,100,534,0.8646616541353384,1.0
79,85,60,55,60,71,410,0.60431654676259,72,60,30,20,30,25,237,0.11570247933884298,1.0
71,73,88,120,89,59,500,0.43537414965986393,50,45,45,35,35,50,260,0.23529411764705882,1.0
50,72,35,35,35,65,292,0.5373134328358209,255,10,10,75,135,55,540,0.3125,1.0
90,110,80,100,80,95,555,0.7982456140350878,50,92,108,92,108,35,485,0.2457627118644068,1.0
65,130,60,95,110,65,525,0.5303030303030303,60,75,100,55,80,50,420,0.3088235294117647,2.0
40,45,40,65,40,65,295,0.5661764705882353,75,103,80,70,80,92,500,0.7933884297520661,0.5
50,75,35,70,30,40,300,0.21296296296296297,90,70,80,70,95,70,475,0.5190839694656488,2.0
90,85,100,95,125,85,580,0.6834532374100719,55,70,40,60,40,40,305,0.26956521739130435,0.5
130,65,60,110,95,65,525,0.5227272727272727,50,92,108,92,108,35,485,0.2457627118644068,1.0
73,95,62,85,65,85,465,0.6666666666666666,60,95,80,60,80,30,405,0.19480519480519481,1.0
40,30,32,50,52,65,269,0.3671875,59,66,70,44,55,41,335,0.25190839694656486,0.5
60,150,50,150,50,60,520,0.5,54,66,70,44,55,46,335,0.4214876033057851,2.0
50,160,110,160,110,110,700,0.8854961832061069,105,125,100,60,100,100,590,0.8359375,1.0
65,76,84,54,96,105,480,0.9008264462809917,65,63,45,45,45,45,308,0.2595419847328244,1.0
82,121,119,69,59,71,521,0.5394736842105263,35,35,35,35,35,35,210,0.13385826771653545,0.5
85,110,90,45,90,80,500,0.6206896551724138,70,120,100,145,105,20,560,0.2824427480916031,1.0
80,120,70,110,70,80,530,0.6422764227642277,85,100,122,58,75,54,494,0.3939393939393939,0.0
75,95,125,45,75,95,510,0.8257575757575758,100,70,70,65,65,45,415,0.1897810218978102,1.0
75,100,63,80,63,116,497,0.9345794392523364,95,117,80,65,70,92,519,0.8409090909090909,0.0
35,70,55,45,55,25,285,0.09420289855072464,55,130,115,50,50,75,475,0.5982142857142857,2.0
20,10,230,10,230,5,505,0.0,190,33,58,33,58,33,405,0.13432835820895522,2.0
78,104,78,159,115,100,634,0.8444444444444444,50,20,40,20,40,20,190,0.0962962962962963,1.0
55,35,50,55,110,85,390,0.6277372262773723,106,190,100,154,100,130,780,0.9259259259259259,2.0
85,73,70,73,115,67,483,0.5126050420168067,59,63,80,65,80,58,405,0.41843971631205673,1.0
65,80,80,59,63,58,405,0.4411764705882353,72,58,80,103,80,97,490,0.7171052631578947,1.0
70,110,80,55,80,105,500,0.8794326241134752,50,60,60,60,60,30,320,0.11290322580645161,0.5
103,60,126,80,126,50,545,0.36363636363636365,45,60,45,25,45,55,275,0.29,1.0
80,110,60,150,130,70,600,0.5042016806722689,70,70,115,130,90,60,535,0.5338983050847458,0.5
45,30,35,20,20,45,195,0.14782608695652175,100,150,120,120,100,90,680,0.6493506493506493,1.0
99,68,83,72,87,51,460,0.417910447761194,60,70,50,100,50,65,395,0.5217391304347826,0.5
70,120,40,95,40,95,460,0.8106060606060606,50,40,85,40,65,25,305,0.08870967741935484,1.0
64,165,75,93,83,75,555,0.6587301587301587,60,67,85,77,75,116,480,0.8888888888888888,1.0
120,100,85,30,85,45,465,0.22448979591836735,45,50,45,115,55,95,405,0.6936936936936937,0.0
65,47,55,73,75,85,400,0.65,60,85,42,85,42,91,405,0.8227848101265823,1.0
85,56,77,50,77,78,423,0.53125,68,125,65,65,115,80,518,0.6277372262773723,1.0
55,70,55,40,55,85,360,0.7073170731707317,50,50,150,50,150,50,500,0.2571428571428571,0.5
50,105,125,55,95,50,480,0.375886524822695,80,52,50,90,50,89,411,0.6666666666666666,1.0
45,30,15,85,65,65,305,0.36220472440944884,60,60,50,40,50,75,335,0.5882352941176471,2.0
70,90,110,60,75,95,500,0.7333333333333333,60,70,65,125,105,90,515,0.6911764705882353,1.0
75,80,85,110,90,50,490,0.3548387096774194,40,27,60,37,50,66,280,0.36220472440944884,2.0
60,65,80,170,95,130,600,0.8625954198473282,35,65,35,65,35,65,300,0.46621621621621623,1.0
75,89,85,55,65,36,405,0.29545454545454547,44,48,65,50,64,43,314,0.1623931623931624,2.0
67,57,55,77,55,114,425,0.8879310344827587,43,70,48,50,60,38,309,0.2391304347826087,2.0
85,100,122,58,75,54,494,0.3939393939393939,104,91,63,91,73,68,490,0.5118110236220472,0.0
25,20,15,105,55,90,310,0.32407407407407407,30,40,55,40,55,60,280,0.3237410071942446,0.5
72,58,80,103,80,97,490,0.7171052631578947,65,80,80,59,63,58,405,0.4411764705882353,1.0
83,80,75,70,70,101,479,0.8615384615384616,79,100,80,110,90,121,580,0.968,1.0
40,45,40,65,40,65,295,0.5661764705882353,35,85,45,35,35,75,310,0.6492537313432836,2.0
85,90,80,70,80,130,535,0.9262295081967213,95,75,110,100,80,30,490,0.15267175572519084,1.0
65,95,57,100,85,93,495,0.7441860465116279,95,23,48,23,48,23,260,0.046153846153846156,1.0
70,85,140,85,70,20,470,0.272,105,30,105,140,105,55,540,0.3524590163934426,0.5
70,60,75,110,75,90,480,0.7165354330708661,79,85,60,55,60,71,410,0.60431654676259,2.0
54,63,52,83,56,97,405,0.7697841726618705,75,125,70,125,70,115,580,0.9037037037037037,1.0
76,25,45,67,55,24,292,0.0390625,45,35,50,70,50,30,280,0.15753424657534246,1.0
95,70,73,95,90,60,483,0.3983739837398374,55,95,115,45,45,35,390,0.2116788321167883,1.0
130,65,60,110,95,65,525,0.5227272727272727,70,110,180,60,60,50,530,0.4117647058823529,2.0
110,78,73,76,71,60,468,0.3333333333333333,30,65,100,45,25,40,305,0.1891891891891892,0.5
123,77,72,99,92,58,521,0.4621212121212121,68,90,65,50,55,82,410,0.6165413533834586,2.0
40,30,32,50,52,65,269,0.3671875,101,72,72,99,89,29,462,0.1937984496124031,0.5
100,150,110,95,110,70,635,0.5923076923076923,60,65,80,170,95,130,600,0.8625954198473282,2.0
70,60,125,115,70,55,495,0.35507246376811596,80,115,80,65,55,93,488,0.7846153846153846,2.0
36,50,50,65,60,44,305,0.16363636363636364,64,88,50,88,50,106,446,0.9111111111111111,1.0
70,140,230,60,80,50,630,0.32432432432432434,80,52,50,90,50,89,411,0.6666666666666666,1.0
65,50,70,95,80,65,425,0.4262295081967213,80,135,130,95,90,70,600,0.5181818181818182,0.25
100,100,100,100,100,100,600,0.8805970149253731,80,80,50,40,50,25,325,0.176056338028169,1.0
68,125,65,65,115,80,518,0.6277372262773723,80,70,40,100,60,145,495,0.921875,0.5
70,45,48,60,65,35,323,0.15748031496062992,35,46,34,35,45,20,215,0.072,1.0
30,40,70,70,25,60,295,0.41353383458646614,95,117,80,65,70,92,519,0.8409090909090909,2.0
30,56,35,25,35,72,253,0.48148148148148145,108,112,118,68,72,47,525,0.2916666666666667,1.0
75,80,55,25,35,35,305,0.18666666666666668,75,95,60,65,60,115,470,0.8778625954198473,2.0
30,80,90,55,45,55,355,0.4295774647887324,65,150,60,115,60,115,565,0.935251798561151,1.0
62,44,50,44,50,55,305,0.3629032258064516,70,110,80,55,80,105,500,0.8794326241134752,2.0
90,92,75,92,85,60,494,0.49586776859504134,69,55,45,55,55,15,294,0.11666666666666667,0.5
75,95,67,125,95,83,540,0.7117117117117117,106,110,90,154,90,130,680,0.926829268292683,1.0
50,85,40,85,40,35,335,0.1746031746031746,37,25,41,25,41,25,194,0.08870967741935484,0.5
70,120,65,45,85,125,510,0.9747899159663865,75,75,55,105,85,30,425,0.1619718309859155,2.0
75,95,122,58,75,69,494,0.5725806451612904,40,30,32,50,52,65,269,0.3671875,1.0
65,75,90,97,123,44,494,0.1987179487179487,75,105,75,105,75,45,480,0.3274336283185841,1.0
60,95,80,60,80,30,405,0.19480519480519481,75,75,55,105,85,30,425,0.1619718309859155,1.0
75,80,70,65,75,90,455,0.7578125,44,48,65,50,64,43,314,0.1623931623931624,1.0
60,90,55,90,80,110,485,0.8677685950413223,60,100,115,70,85,90,520,0.7557251908396947,1.0
40,70,40,35,40,60,285,0.392,42,52,67,39,56,50,306,0.2868217054263566,2.0
64,115,65,83,63,65,455,0.5323741007194245,65,50,70,95,80,65,425,0.4262295081967213,2.0
75,75,75,125,95,40,485,0.15671641791044777,100,150,140,100,90,90,670,0.7969924812030075,2.0
67,58,57,81,67,101,431,0.8790322580645161,190,33,58,33,58,33,405,0.13432835820895522,1.0
90,95,95,70,90,70,510,0.5230769230769231,30,80,90,55,45,55,355,0.4295774647887324,2.0
55,68,64,45,55,31,318,0.11666666666666667,55,20,35,20,45,75,250,0.37681159420289856,1.0
60,40,60,40,60,35,295,0.18055555555555555,86,76,86,116,56,95,515,0.7982456140350878,0.25
75,98,63,98,63,101,498,0.8091603053435115,70,120,100,145,105,20,560,0.2824427480916031,1.0
55,104,105,94,75,52,485,0.36363636363636365,65,73,55,47,75,85,400,0.6846846846846847,1.0
45,30,15,85,65,65,305,0.36220472440944884,70,77,60,97,60,108,472,0.8394160583941606,1.0
30,105,90,25,25,50,325,0.2773722627737226,60,60,60,60,60,60,360,0.38095238095238093,1.0
65,150,40,15,80,145,495,0.9663865546218487,69,69,76,69,86,91,460,0.6554621848739496,1.0
80,80,80,80,80,80,480,0.6015037593984962,75,69,72,114,100,104,534,0.8253968253968254,0.5
60,80,95,70,85,50,440,0.2231404958677686,45,30,50,65,50,45,285,0.13821138211382114,1.0
110,85,95,80,95,50,515,0.2713178294573643,105,180,100,180,100,115,780,0.9477611940298507,1.0
80,92,65,65,80,68,450,0.4824561403508772,63,120,85,90,55,55,468,0.2809917355371901,0.5
74,108,133,83,65,32,495,0.32142857142857145,35,40,100,90,55,35,355,0.1796875,1.0
50,180,20,180,20,150,600,0.9029850746268657,70,85,140,85,70,20,470,0.272,1.0
55,81,60,50,70,97,413,0.7214285714285714,70,115,60,115,60,55,475,0.4647887323943662,1.0
82,121,119,69,59,71,521,0.5394736842105263,54,63,52,83,56,97,405,0.7697841726618705,1.0
76,65,45,92,42,91,411,0.7449664429530202,35,70,55,45,55,25,285,0.09420289855072464,4.0
125,58,58,76,76,67,460,0.515625,61,72,57,55,55,65,365,0.3984375,1.0
71,73,88,120,89,59,500,0.43537414965986393,95,65,65,110,130,60,525,0.4016393442622951,1.0
75,95,122,58,75,69,494,0.5725806451612904,45,100,135,65,135,45,525,0.29411764705882354,2.0
38,36,38,32,36,57,237,0.3893805309734513,61,72,57,55,55,65,365,0.3984375,1.0
62,55,52,109,94,109,481,0.7833333333333333,76,104,71,104,71,108,534,0.912751677852349,1.0
40,40,35,50,100,70,335,0.5031847133757962,70,150,140,65,100,75,600,0.55,0.0
80,80,50,40,50,25,325,0.176056338028169,20,10,55,15,20,80,200,0.17985611510791366,1.0
55,65,35,60,30,85,330,0.6126126126126126,60,60,75,60,75,80,410,0.7321428571428571,1.0
40,40,40,70,40,20,250,0.032520325203252036,103,60,126,80,126,50,545,0.36363636363636365,1.0
65,105,60,60,70,95,455,63.0,110,65,105,55,95,80,510,0.6258503401360545,1.0
62,77,62,50,42,65,358,0.4838709677419355,100,100,100,100,100,100,600,0.8758169934640523,0.25
80,110,120,130,90,70,600,0.6198347107438017,45,50,45,115,55,95,405,0.6936936936936937,1.0
100,90,130,45,65,55,485,0.4253731343283582,95,117,184,44,46,28,514,0.2975206611570248,2.0
55,70,40,60,40,40,305,0.26956521739130435,65,73,55,47,75,85,400,0.6846846846846847,1.0
44,50,91,24,86,10,305,0.1981981981981982,75,75,55,105,85,30,425,0.1619718309859155,0.5
55,95,55,35,75,115,430,0.9380530973451328,72,85,70,65,70,58,420,0.41304347826086957,1.0
45,55,39,35,39,42,255,0.18518518518518517,35,35,40,35,55,50,250,0.40336134453781514,1.0
62,44,50,44,50,55,305,0.3629032258064516,108,112,118,68,72,47,525,0.2916666666666667,2.0
50,70,160,70,160,90,600,0.7417218543046358,48,61,40,61,40,50,300,0.2543859649122807,2.0
73,115,60,60,60,90,458,0.6694915254237288,78,84,78,109,85,100,534,0.8646616541353384,1.0
50,52,48,65,50,55,320,0.33098591549295775,77,59,50,67,63,46,362,0.23140495867768596,2.0
60,30,30,36,56,50,262,0.32432432432432434,30,42,118,42,88,30,350,0.112,0.0625
78,92,75,74,63,118,500,0.8842975206611571,55,20,35,20,45,75,250,0.37681159420289856,2.0
70,50,30,95,135,105,485,0.8040540540540541,45,45,35,20,30,20,195,0.07246376811594203,1.0
63,120,85,90,55,55,468,0.2809917355371901,40,45,40,62,60,60,307,0.33884297520661155,2.0
108,170,115,120,95,92,700,0.7083333333333334,81,102,77,85,75,85,505,0.5642857142857143,2.0
55,70,55,40,55,85,360,0.7073170731707317,60,75,100,55,80,50,420,0.3088235294117647,0.5
83,80,80,135,80,121,579,0.9444444444444444,60,69,95,69,95,36,424,0.2608695652173913,0.5
40,30,30,55,30,85,270,0.4666666666666667,80,100,123,122,120,80,625,0.56,1.0
105,140,95,55,65,45,505,0.3,90,60,60,40,40,40,330,0.29545454545454547,1.0
75,98,63,98,63,101,498,0.8091603053435115,75,90,90,140,90,115,600,0.9481481481481482,0.5
65,40,70,80,140,70,465,0.5954198473282443,85,73,70,73,115,67,483,0.5126050420168067,1.0
70,62,67,55,55,56,365,0.38513513513513514,40,70,130,60,130,25,455,0.17355371900826447,0.5
50,100,150,100,150,50,600,0.37142857142857144,60,100,85,80,85,100,510,0.7007874015748031,1.0
80,90,80,130,110,110,600,0.856,70,80,102,80,102,40,474,0.2677165354330709,1.0
85,70,80,97,80,123,535,0.9304347826086956,56,61,65,48,45,38,313,0.17567567567567569,2.0
60,60,60,105,105,105,495,0.848,75,125,230,55,95,30,610,0.3448275862068966,1.0
70,110,180,60,60,50,530,0.4117647058823529,60,80,110,50,80,45,425,0.2833333333333333,0.5
30,45,135,45,90,30,375,0.09285714285714286,67,125,40,30,30,58,350,0.3431372549019608,1.0
65,40,70,80,140,70,465,0.5954198473282443,80,75,150,75,150,50,580,0.30973451327433627,0.5
60,60,75,60,75,80,410,0.7321428571428571,75,90,90,140,90,115,600,0.9481481481481482,0.0
45,55,45,65,45,75,330,0.5692307692307692,45,53,70,40,60,42,310,0.25735294117647056,8.0
75,75,55,105,85,30,425,0.1619718309859155,35,45,160,30,45,70,385,0.48148148148148145,4.0
60,70,50,100,50,65,395,0.5217391304347826,60,55,50,40,55,45,305,0.22377622377622378,1.0
70,70,70,70,70,70,420,0.5289256198347108,40,60,40,40,40,30,250,0.0948905109489051,1.0
59,66,70,44,55,41,335,0.25190839694656486,40,80,100,30,30,20,300,0.11851851851851852,4.0
55,55,45,63,45,45,308,0.25,90,60,60,40,40,40,330,0.29545454545454547,2.0
74,48,76,83,81,104,466,0.7913043478260869,68,165,95,65,115,110,618,0.8615384615384616,0.5
88,107,122,74,75,64,530,0.4596774193548387,105,95,75,85,75,74,509,0.5714285714285714,4.0
30,35,30,100,35,80,310,0.4765625,65,80,140,40,70,70,465,0.5223880597014925,0.0
70,85,70,60,70,50,405,0.28378378378378377,100,128,90,77,77,128,600,0.959349593495935,1.0
75,90,50,110,80,95,500,0.7985611510791367,80,45,65,90,110,80,470,0.5462962962962963,2.0
70,95,125,65,75,45,475,0.33613445378151263,70,70,40,60,40,60,340,0.4247787610619469,4.0
45,60,45,25,45,55,275,0.29,99,68,83,72,87,51,460,0.417910447761194,1.0
100,100,100,100,100,100,600,0.8758169934640523,60,60,40,65,45,35,305,0.15833333333333333,1.0
75,90,90,140,90,115,600,0.9481481481481482,40,45,40,35,35,56,251,0.373015873015873,1.0
58,64,58,80,65,80,405,0.5423728813559322,80,80,90,110,130,110,600,0.8721804511278195,0.5
80,110,60,150,130,70,600,0.5042016806722689,75,95,67,125,95,83,540,0.7117117117117117,1.0
60,80,110,50,80,45,425,0.2833333333333333,61,72,57,55,55,65,365,0.3984375,2.0
74,48,76,83,81,104,466,0.7322834645669292,61,78,95,56,58,57,405,0.40336134453781514,1.0
38,30,41,30,41,60,240,0.2897196261682243,44,75,35,63,33,45,295,0.2647058823529412,0.0
75,80,70,65,75,90,455,0.7578125,50,52,48,65,50,55,320,0.33098591549295775,1.0
65,50,70,95,80,65,425,0.4262295081967213,45,85,50,55,50,65,350,0.5076923076923077,1.0
88,107,122,74,75,64,530,0.4596774193548387,135,85,40,40,85,5,390,0.6864406779661016,2.0
79,115,70,125,80,111,580,0.864,70,20,50,20,50,40,250,0.1557377049180328,2.0
65,105,60,60,70,95,455,63.0,40,80,100,30,30,20,300,0.11851851851851852,2.0
70,135,105,60,105,20,495,0.5806451612903226,70,62,67,55,55,56,365,0.38513513513513514,0.5
40,45,35,65,55,70,310,0.4482758620689655,95,23,48,23,48,23,260,0.046153846153846156,1.0
55,70,45,70,50,60,350,0.45,80,110,120,130,90,70,600,0.6198347107438017,0.25
70,45,48,60,65,35,323,0.15748031496062992,40,35,30,120,70,105,400,0.6692307692307692,1.0
120,70,120,75,130,85,600,0.6694915254237288,70,50,30,95,135,105,485,0.8040540540540541,1.0
80,125,75,40,95,85,500,0.6911764705882353,40,45,40,35,35,56,251,0.373015873015873,0.5
40,55,30,30,30,85,270,0.688,50,75,45,40,45,60,315,0.4380165289256198,2.0
60,75,100,55,80,50,420,0.3088235294117647,80,80,80,80,80,80,480,0.5606060606060606,0.5
40,20,30,40,80,55,265,0.22764227642276422,40,65,95,60,45,35,340,0.13986013986013987,0.5
50,70,100,40,40,30,330,0.2222222222222222,90,100,90,125,85,90,580,0.7352941176470589,2.0
40,45,40,65,40,65,295,0.5661764705882353,30,80,90,55,45,55,355,0.4295774647887324,2.0
83,106,65,86,65,85,490,0.6640625,50,85,125,85,115,20,480,0.4306569343065693,0.0
59,59,58,90,70,73,409,0.5826086956521739,40,60,30,31,31,70,262,0.4492753623188406,1.0
70,80,70,80,70,110,480,0.6594202898550725,35,55,35,30,30,35,220,0.23684210526315788,0.5
100,50,80,60,80,50,420,0.34375,95,95,85,125,65,55,520,0.3894736842105263,0.5
55,66,44,44,56,85,350,0.6888888888888889,50,60,45,100,80,65,400,0.45689655172413796,1.0
30,30,42,30,42,70,244,0.4230769230769231,65,95,57,100,85,93,495,0.7441860465116279,0.5
70,55,75,45,65,60,370,0.45901639344262296,90,132,105,132,105,30,594,0.4246575342465753,2.0
85,105,85,40,50,40,405,0.211864406779661,85,105,100,79,83,78,530,0.5869565217391305,1.0
75,75,55,105,85,30,425,0.1619718309859155,55,84,105,114,75,52,485,0.2890625,2.0
65,95,100,60,50,50,420,0.34959349593495936,45,30,35,20,20,45,195,0.14782608695652175,1.0
80,82,100,83,100,80,525,0.6821705426356589,88,107,122,74,75,64,530,0.4596774193548387,0.5
65,125,100,60,70,70,490,0.6099290780141844,55,75,60,75,60,103,428,0.7982456140350878,0.5
60,69,95,69,95,36,424,0.2608695652173913,109,66,84,81,99,32,471,0.2013888888888889,0.5
70,150,140,65,100,75,600,0.55,62,77,62,50,42,65,358,0.4838709677419355,0.5
100,120,100,150,120,90,680,0.728,75,85,200,55,65,30,510,0.16778523489932887,1.0
35,46,34,35,45,20,215,0.072,50,80,95,10,45,10,290,0.232,0.5
95,70,73,95,90,60,483,0.3983739837398374,30,30,42,30,42,70,244,0.4230769230769231,1.0
65,125,60,95,60,105,510,0.9236641221374046,75,87,63,87,63,98,473,0.865546218487395,0.5
60,80,95,70,85,50,440,0.2231404958677686,70,55,75,45,65,60,370,0.45901639344262296,1.0
61,90,45,50,50,160,456,0.9230769230769231,65,110,130,60,65,95,525,0.8278145695364238,4.0
83,80,80,135,80,121,579,0.9444444444444444,45,80,100,35,37,28,325,0.3125,0.0
40,70,130,60,130,25,455,0.17355371900826447,80,80,90,110,130,110,600,0.8721804511278195,2.0
38,35,35,65,55,50,278,0.2647058823529412,50,48,43,46,41,60,288,0.47297297297297297,2.0
95,117,80,65,70,92,519,0.8409090909090909,100,164,150,95,120,71,700,0.5645161290322581,1.0
45,45,35,20,30,20,195,0.07246376811594203,55,65,35,60,30,85,330,0.6126126126126126,1.0
43,80,65,50,35,35,308,0.14193548387096774,85,90,80,70,80,130,535,0.9262295081967213,1.0
75,105,75,105,75,45,480,0.3274336283185841,60,69,95,69,95,36,424,0.2608695652173913,1.0
79,85,60,55,60,71,410,0.60431654676259,60,60,60,105,105,105,495,0.848,0.0
54,78,103,53,45,22,355,0.23255813953488372,60,82,45,45,45,74,351,0.5752212389380531,1.0
60,60,75,60,75,80,410,0.7321428571428571,110,85,95,80,95,50,515,0.2713178294573643,2.0
61,78,95,56,58,57,405,0.40336134453781514,90,132,105,132,105,30,594,0.4246575342465753,0.5
170,90,45,90,45,60,500,0.427536231884058,40,35,30,120,70,105,400,0.6692307692307692,1.0
90,65,65,40,40,15,315,0.19672131147540983,77,85,51,55,51,65,384,0.5163934426229508,1.0
35,40,100,90,55,35,355,0.1796875,130,65,60,110,95,65,525,0.5227272727272727,0.5
50,75,35,70,30,40,300,0.21296296296296297,50,160,110,160,110,110,700,0.8854961832061069,2.0
105,95,80,40,80,90,490,0.753968253968254,31,45,90,30,30,40,266,0.21929824561403508,1.0
55,63,90,50,80,42,380,0.21138211382113822,45,85,50,55,50,65,350,0.5076923076923077,0.5
38,30,85,55,65,30,303,0.21428571428571427,64,78,52,78,52,81,405,0.6422764227642277,1.0
60,75,100,55,80,50,420,0.3088235294117647,80,100,123,122,120,80,625,0.56,2.0
150,120,100,120,100,90,680,0.664179104477612,80,145,150,105,110,110,700,0.8692307692307693,1.0
60,50,70,50,90,65,385,0.39568345323741005,55,50,45,135,95,120,500,0.7714285714285715,2.0
95,109,105,75,85,56,525,0.34513274336283184,76,25,45,67,55,24,292,0.0390625,1.0
100,100,100,100,100,100,600,0.8805970149253731,75,100,95,40,70,110,490,0.8717948717948718,1.0
135,85,40,40,85,5,390,0.6864406779661016,68,85,65,165,135,100,618,0.8083333333333333,1.0
60,70,65,125,105,90,515,0.6911764705882353,42,52,67,39,56,50,306,0.2868217054263566,2.0
74,108,133,83,65,32,495,0.32142857142857145,90,90,85,125,90,100,580,0.768595041322314,2.0
65,40,70,80,140,70,465,0.5954198473282443,55,75,85,25,25,15,280,0.1875,1.0
59,66,70,44,55,41,335,0.25190839694656486,60,45,50,90,80,70,395,0.625,0.25
60,67,85,77,75,116,480,0.8888888888888888,60,62,50,62,60,40,334,0.18181818181818182,0.5
40,55,70,45,60,30,300,0.10619469026548672,75,70,90,70,105,80,490,0.656,1.0
100,164,150,95,120,71,700,0.5645161290322581,100,123,75,57,75,80,510,0.6923076923076923,2.0
70,55,75,45,65,60,370,0.45901639344262296,55,70,55,40,55,85,360,0.7073170731707317,1.0
60,79,105,59,85,36,424,0.17054263565891473,41,56,40,62,44,71,314,0.568,1.0
60,40,60,40,60,35,295,0.18055555555555555,58,89,77,45,45,48,362,0.3177570093457944,1.0
85,80,70,135,75,90,535,0.7006802721088435,70,75,80,135,80,135,575,0.917910447761194,1.0
60,69,95,69,95,36,424,0.2608695652173913,49,55,42,42,37,85,310,0.6068376068376068,1.0
50,50,95,40,50,35,320,0.20279720279720279,75,95,95,95,95,85,540,0.6470588235294118,1.0
55,68,64,45,55,31,318,0.11666666666666667,45,49,49,65,65,45,318,0.2781954887218045,0.25
46,87,60,30,40,57,320,0.37777777777777777,86,92,88,68,75,73,482,0.6835443037974683,1.0
80,82,78,95,80,85,500,0.6869565217391305,80,100,123,122,120,80,625,0.56,0.5
78,65,68,112,154,75,552,0.628099173553719,85,100,122,58,75,54,494,0.3939393939393939,1.0
60,70,105,70,120,75,500,0.5983606557377049,80,75,150,75,150,50,580,0.30973451327433627,1.0
106,190,100,154,100,130,780,0.9259259259259259,50,50,95,40,50,35,320,0.20279720279720279,2.0
55,70,45,70,50,60,350,0.45,115,140,130,55,55,40,535,0.4519230769230769,0.5
20,40,15,35,35,60,205,0.34285714285714286,95,109,105,75,85,56,525,0.34513274336283184,0.0
70,120,40,95,40,95,460,0.8106060606060606,73,115,60,60,60,90,458,0.6694915254237288,1.0
57,80,91,80,87,75,470,0.5737704918032787,40,65,95,60,45,35,340,0.13986013986013987,0.5
75,80,55,25,35,35,305,0.18666666666666668,30,45,59,30,39,57,260,0.2803030303030303,0.25
80,82,78,95,80,85,500,0.6869565217391305,75,80,55,25,35,35,305,0.18666666666666668,1.0
65,50,35,115,95,95,455,0.7333333333333333,60,50,70,80,80,140,480,0.8449612403100775,1.0
60,40,60,95,60,55,370,0.4222222222222222,55,40,85,80,105,40,405,0.23622047244094488,1.0
65,90,40,45,80,75,395,0.625,45,75,60,40,30,50,300,0.304,1.0
111,83,68,92,82,39,475,0.1774193548387097,70,80,50,35,35,35,305,0.14,1.0
50,20,40,20,40,20,190,0.0962962962962963,65,85,70,75,70,40,405,0.203125,1.0
53,51,53,61,56,40,314,0.14285714285714285,40,65,40,80,40,65,330,0.5038167938931297,1.0
45,45,35,20,30,20,195,0.07246376811594203,60,100,85,80,85,100,510,0.7007874015748031,1.0
45,60,40,70,50,45,310,0.2846715328467153,40,50,90,30,55,65,330,0.44680851063829785,2.0
45,35,45,62,53,35,275,0.11851851851851852,60,90,140,50,50,40,430,0.2535211267605634,1.0
75,103,80,70,80,92,500,0.7933884297520661,60,50,70,80,80,140,480,0.8449612403100775,1.0
60,50,100,85,70,65,430,0.47580645161290325,35,35,35,35,35,35,210,0.13385826771653545,2.0
55,75,60,75,60,103,428,0.7982456140350878,70,45,48,60,65,35,323,0.15748031496062992,1.0
90,92,87,75,85,76,505,0.5409836065573771,50,65,107,105,107,86,520,0.7758620689655172,2.0
70,55,95,95,110,65,490,0.48872180451127817,110,78,73,76,71,60,468,0.3333333333333333,2.0
92,105,90,125,90,98,600,0.8217054263565892,75,69,72,114,100,104,534,0.8253968253968254,2.0
85,105,100,79,83,78,530,0.5869565217391305,40,60,30,31,31,70,262,0.4492753623188406,1.0
50,65,90,35,35,15,290,0.14678899082568808,59,59,58,90,70,73,409,0.5826086956521739,0.5
105,105,75,65,100,50,500,0.37593984962406013,56,61,65,48,45,38,313,0.17567567567567569,2.0
65,65,60,130,95,110,525,0.823943661971831,65,75,70,95,70,95,470,0.7272727272727273,0.5
74,108,133,83,65,32,495,0.32142857142857145,60,75,85,100,85,115,520,0.8992248062015504,0.5
60,110,70,60,60,100,460,0.8461538461538461,114,85,70,85,80,30,464,0.2066115702479339,2.0
50,65,45,85,65,95,405,0.7238095238095238,60,70,65,125,105,90,515,0.6911764705882353,0.25
60,67,85,77,75,116,480,0.8888888888888888,80,100,70,50,60,45,405,0.25806451612903225,2.0
85,50,95,120,115,80,545,0.5793650793650794,75,90,90,140,90,115,600,0.9481481481481482,1.0
62,48,66,59,57,49,341,0.33884297520661155,65,125,100,60,70,70,490,0.6099290780141844,1.0
70,80,65,90,65,85,455,0.578125,80,100,70,50,60,45,405,0.25806451612903225,1.0
79,115,70,125,80,111,580,0.864,70,115,60,115,60,55,475,0.4647887323943662,1.0
45,60,40,70,50,45,310,0.2846715328467153,55,70,40,60,40,40,305,0.26956521739130435,2.0
110,80,90,95,90,65,530,0.5033557046979866,37,25,41,25,41,25,194,0.08870967741935484,1.0
80,105,105,105,105,80,580,0.5939849624060151,70,55,95,95,110,65,490,0.48872180451127817,0.5
63,60,55,50,50,71,349,0.5289256198347108,91,90,72,90,129,108,580,0.896,4.0
50,105,125,55,95,50,480,0.375886524822695,82,121,119,69,59,71,521,0.5394736842105263,4.0
85,110,76,65,82,56,474,0.3933333333333333,78,81,71,74,69,126,499,0.9090909090909091,0.25
62,48,66,59,57,49,341,0.33884297520661155,40,40,35,50,100,70,335,0.5031847133757962,0.5
50,53,48,53,48,64,316,0.4076923076923077,70,45,48,60,65,35,323,0.15748031496062992,1.0
78,65,68,112,154,75,552,0.628099173553719,110,80,90,95,90,65,530,0.5033557046979866,1.0
70,90,110,60,75,95,500,0.7333333333333333,100,123,75,57,75,80,510,0.6923076923076923,1.0
75,110,110,110,105,80,590,0.656934306569343,30,45,135,45,90,30,375,0.09285714285714286,1.0
55,40,40,65,45,35,280,0.16428571428571428,55,70,55,40,55,85,360,0.7073170731707317,1.0
110,78,73,76,71,60,468,0.3333333333333333,90,85,100,95,125,85,580,0.6834532374100719,0.0
255,10,10,75,135,55,540,0.3125,60,80,95,70,85,50,440,0.2231404958677686,0.5
38,36,38,32,36,57,237,0.3893805309734513,55,47,52,40,40,41,275,0.16806722689075632,1.0
80,105,65,60,75,130,515,0.9645390070921985,75,75,130,75,130,95,580,0.7479674796747967,1.0
115,140,130,55,55,40,535,0.4519230769230769,75,100,66,60,66,115,482,0.918918918918919,1.0
55,65,95,95,45,85,440,0.6610169491525424,108,130,95,80,85,102,600,0.7637795275590551,1.0
20,40,90,30,90,25,295,0.11363636363636363,40,30,30,55,30,85,270,0.4666666666666667,1.0
106,110,90,154,90,130,680,0.926829268292683,65,45,55,45,70,45,325,0.24369747899159663,1.0
72,58,80,103,80,97,490,0.7171052631578947,40,80,100,30,30,20,300,0.11851851851851852,1.0
70,100,115,30,65,30,410,0.24390243902439024,85,135,130,60,80,25,515,0.40540540540540543,1.0
150,160,100,95,65,100,670,0.8866666666666667,40,55,80,35,60,30,300,0.15037593984962405,0.5
62,77,62,50,42,65,358,0.4838709677419355,78,65,68,112,154,75,552,0.628099173553719,1.0
73,76,75,81,100,100,505,0.8110236220472441,95,70,73,95,90,60,483,0.3983739837398374,1.0
50,50,40,30,30,50,250,0.2781954887218045,45,60,40,70,50,45,310,0.2846715328467153,1.0
95,80,105,40,70,100,490,0.8046875,160,110,65,65,110,30,540,0.35714285714285715,1.0
60,95,80,60,80,30,405,0.19480519480519481,91,129,90,72,90,108,580,0.8536585365853658,1.0
25,20,15,105,55,90,310,0.32407407407407407,95,110,80,70,80,50,485,0.37209302325581395,1.0
80,115,80,65,55,93,488,0.7846153846153846,51,65,65,80,75,59,395,0.4365079365079365,1.0
70,120,100,145,105,20,560,0.2824427480916031,105,105,75,65,100,50,500,0.37593984962406013,2.0
35,70,55,45,55,25,285,0.09420289855072464,75,95,122,58,75,69,494,0.5725806451612904,0.5
85,80,70,135,75,90,535,0.7006802721088435,80,80,90,110,130,110,600,0.8721804511278195,1.0
40,45,65,100,120,90,460,0.5588235294117647,52,65,50,45,50,38,300,0.27419354838709675,0.0
68,125,65,65,115,80,518,0.6277372262773723,44,48,65,50,64,43,314,0.1623931623931624,1.0
41,64,45,50,50,50,300,0.36752136752136755,30,40,70,70,25,60,295,0.41353383458646614,1.0
44,75,35,63,33,45,295,0.2647058823529412,50,65,45,85,65,95,405,0.7238095238095238,1.0
28,25,25,45,35,40,198,0.16083916083916083,40,30,30,55,30,85,270,0.4666666666666667,1.0
73,95,62,85,65,85,465,0.6666666666666666,60,62,80,63,80,60,405,0.4336283185840708,1.0
40,70,40,35,40,60,285,0.392,40,29,45,29,45,36,224,0.14634146341463414,0.5
55,112,45,74,45,70,401,0.559322033898305,40,29,45,29,45,36,224,0.14634146341463414,4.0
110,65,75,125,85,30,490,0.15,62,48,54,63,60,68,355,0.5178571428571429,0.5
65,83,57,95,85,105,490,0.8914728682170543,1,90,45,30,30,40,236,0.33064516129032256,1.0
90,120,75,60,60,45,450,0.29411764705882354,60,90,55,90,80,110,485,0.8677685950413223,1.0
80,160,80,130,80,100,630,0.8455284552845529,65,80,80,59,63,58,405,0.4411764705882353,0.5
80,185,115,40,105,75,600,0.6230769230769231,38,35,35,65,55,50,278,0.2647058823529412,0.25
55,70,45,70,50,60,350,0.45,70,85,70,60,70,50,405,0.28378378378378377,0.5
58,50,145,95,105,30,483,0.2459016393442623,35,60,44,40,54,55,288,0.366412213740458,1.0
35,40,100,90,55,35,355,0.1796875,100,128,90,77,77,128,600,0.959349593495935,0.5
40,35,30,20,20,50,195,0.23423423423423423,100,75,115,90,115,85,580,0.6446280991735537,1.0
80,70,40,100,60,145,495,0.921875,70,60,62,80,82,60,414,0.4375,0.5
73,115,60,60,60,90,458,0.6694915254237288,71,82,64,64,59,112,452,0.9327731092436975,1.0
89,125,90,115,80,101,600,0.8725490196078431,50,85,55,65,65,90,410,0.7478260869565218,2.0
45,22,60,27,30,29,213,0.07518796992481203,60,65,70,85,75,40,395,0.21705426356589147,1.0
105,30,105,140,105,55,540,0.3524590163934426,44,75,35,63,33,45,295,0.2647058823529412,1.0
80,100,123,122,120,80,625,0.56,60,85,60,50,50,125,430,0.9090909090909091,0.5
80,100,200,50,100,50,580,0.3472222222222222,50,95,90,95,90,180,600,0.9172413793103448,1.0
88,107,122,74,75,64,530,0.4596774193548387,105,30,105,140,105,55,540,0.3524590163934426,0.25
86,92,88,68,75,73,482,0.6835443037974683,100,70,70,65,65,45,415,0.1897810218978102,1.0
60,50,70,50,90,65,385,0.39568345323741005,130,70,35,70,35,60,400,0.4017857142857143,1.0
82,80,86,85,75,72,480,0.6183206106870229,60,85,69,60,69,77,420,0.518796992481203,1.0
50,50,50,50,50,50,300,0.30708661417322836,110,80,90,95,90,65,530,0.5033557046979866,0.25
70,65,60,90,75,90,450,0.6571428571428571,65,95,75,55,55,85,430,0.6933333333333334,0.25
70,65,65,55,55,70,380,0.5,80,120,79,95,79,70,523,0.5833333333333334,1.0
75,140,65,112,65,110,567,0.9140625,80,120,79,95,79,70,523,0.5833333333333334,0.5
165,75,80,40,45,65,470,0.5151515151515151,90,100,70,110,150,80,600,0.6037735849056604,0.5
50,50,77,95,77,91,440,0.5916666666666667,74,48,76,83,81,104,466,0.7913043478260869,2.0
75,95,60,65,60,115,470,0.8778625954198473,105,140,55,30,55,95,480,0.8195488721804511,1.0
50,65,107,105,107,86,520,0.703125,106,190,100,154,100,130,780,0.9259259259259259,1.0
111,83,68,92,82,39,475,0.1774193548387097,97,165,60,65,50,58,495,0.3902439024390244,4.0
50,85,125,85,115,20,480,0.4306569343065693,75,75,60,83,60,60,413,0.39344262295081966,1.0
71,120,95,120,95,99,600,0.8203125,59,63,80,65,80,58,405,0.41843971631205673,0.5
45,30,50,55,65,45,290,0.208,55,50,40,40,40,75,300,0.5945945945945946,1.0
90,95,105,165,110,45,610,0.2890625,70,85,65,105,85,120,530,0.9262295081967213,0.5
45,49,65,49,65,45,318,0.275,80,100,80,80,80,100,520,0.9051724137931034,1.0
55,130,115,50,50,75,475,0.5982142857142857,100,75,115,90,115,85,580,0.6446280991735537,0.5
89,145,90,105,80,91,600,0.8549618320610687,45,35,45,62,53,35,275,0.11851851851851852,1.0
100,150,110,95,110,70,635,0.5923076923076923,40,40,55,40,70,55,300,0.40939597315436244,2.0
40,45,40,62,60,60,307,0.33884297520661155,75,125,75,30,75,85,465,0.625,1.0
60,95,80,60,80,30,405,0.19480519480519481,45,60,32,50,32,76,295,0.5925925925925926,1.0
75,90,90,140,90,115,600,0.9481481481481482,100,100,100,100,100,100,600,0.8778625954198473,1.0
80,110,60,150,130,70,600,0.5042016806722689,45,45,35,20,30,20,195,0.07246376811594203,1.0
60,62,63,80,80,60,405,0.38016528925619836,105,140,55,30,55,95,480,0.8195488721804511,0.5
65,65,60,110,95,130,525,0.9253731343283582,120,120,120,120,120,120,720,0.9344262295081968,1.0
40,55,80,35,60,30,300,0.15037593984962405,25,20,15,105,55,90,310,0.32407407407407407,0.5
68,85,65,165,135,100,618,0.8083333333333333,60,79,105,59,85,36,424,0.17054263565891473,2.0
80,80,50,40,50,25,325,0.176056338028169,77,120,90,60,90,48,485,0.2785714285714286,1.0
80,80,50,40,50,25,325,0.176056338028169,71,120,95,120,95,99,600,0.8203125,0.0
35,85,45,35,35,75,310,0.6492537313432836,67,58,57,81,67,101,431,0.8790322580645161,0.5
60,85,69,65,79,80,438,0.576,75,95,95,95,95,85,540,0.6470588235294118,1.0
65,80,80,59,63,58,405,0.4411764705882353,100,150,110,95,110,70,635,0.5923076923076923,1.0
45,50,43,40,38,62,278,0.40441176470588236,50,65,90,35,35,15,290,0.14678899082568808,2.0
65,75,90,97,123,44,494,0.1987179487179487,65,125,100,60,70,70,490,0.6099290780141844,0.0
100,150,90,180,160,90,770,0.7348484848484849,55,70,40,60,40,40,305,0.26956521739130435,1.0
70,60,125,115,70,55,495,0.35507246376811596,75,110,110,110,105,80,590,0.656934306569343,0.5
45,80,100,35,37,28,325,0.3125,73,95,62,85,65,85,465,0.6666666666666666,0.0
45,40,60,40,75,50,310,0.2926829268292683,75,87,63,87,63,98,473,0.865546218487395,1.0
65,63,45,45,45,45,308,0.2595419847328244,91,72,90,129,90,108,580,0.8620689655172413,0.5
85,60,65,135,105,100,550,0.7518248175182481,55,40,40,65,45,35,280,0.16428571428571428,1.0
80,80,80,80,80,80,480,0.5606060606060606,70,50,30,95,135,105,485,0.8040540540540541,1.0
89,145,90,105,80,91,600,0.8549618320610687,50,75,75,65,65,50,380,0.4049586776859504,1.0
78,130,111,130,85,100,634,0.8561151079136691,64,51,23,51,23,28,240,0.11363636363636363,1.0
60,90,140,50,50,40,430,0.2535211267605634,59,63,80,65,80,58,405,0.41843971631205673,0.5
60,60,60,85,85,85,435,0.631578947368421,95,60,79,100,125,81,540,0.6201550387596899,1.0
73,100,60,100,60,65,458,0.42657342657342656,75,95,95,95,95,85,540,0.6470588235294118,1.0
60,105,60,120,60,105,510,0.8849557522123894,77,59,50,67,63,46,362,0.23140495867768596,1.0
65,136,94,54,96,135,580,0.9612403100775194,85,73,70,73,115,67,483,0.5126050420168067,0.5
70,65,60,90,75,90,450,0.6571428571428571,55,65,35,60,30,85,330,0.6126126126126126,1.0
54,78,103,53,45,22,355,0.23255813953488372,73,95,62,85,65,85,465,0.6666666666666666,1.0
44,75,35,63,33,45,295,0.2647058823529412,110,85,95,80,95,50,515,0.2713178294573643,0.0
65,80,140,40,70,70,465,0.5223880597014925,130,70,35,70,35,60,400,0.4017857142857143,0.5
45,60,30,80,50,65,330,0.4603174603174603,38,30,85,55,65,30,303,0.21428571428571427,2.0
63,120,85,90,55,55,468,0.2809917355371901,90,90,85,125,90,100,580,0.768595041322314,1.0
95,155,109,70,130,81,640,0.6788321167883211,44,38,39,61,79,42,303,0.2251655629139073,0.5
70,40,50,55,50,25,290,0.061068702290076333,35,55,35,30,30,35,220,0.23684210526315788,1.0
75,90,140,60,60,40,465,0.3008130081300813,80,160,80,130,80,100,630,0.8455284552845529,0.125
95,117,80,65,70,92,519,0.8409090909090909,60,25,35,70,80,60,330,0.3076923076923077,2.0
80,90,80,130,110,110,600,0.856,75,80,95,90,100,50,490,0.2158273381294964,1.0
105,150,90,150,90,95,680,0.8285714285714286,60,85,60,85,60,55,405,0.3673469387755102,2.0
40,30,32,50,52,65,269,0.3671875,106,190,100,154,100,130,780,0.9259259259259259,1.0
50,52,48,65,50,55,320,0.33098591549295775,30,105,90,25,25,50,325,0.2773722627737226,0.5
80,85,95,30,30,25,345,0.2857142857142857,70,90,70,60,60,70,420,0.6390977443609023,1.0
55,85,122,58,75,99,494,0.8099173553719008,92,105,90,125,90,98,600,0.8217054263565892,0.25
70,80,50,35,35,35,305,0.14,100,150,120,120,100,90,680,0.6493506493506493,1.0
126,131,95,131,98,99,680,0.8102189781021898,90,75,85,115,90,55,510,0.3445378151260504,0.5
61,78,95,56,58,57,405,0.40336134453781514,60,50,40,85,75,95,405,0.7540983606557377,1.0
75,105,75,105,75,45,480,0.3274336283185841,60,59,85,79,105,36,424,0.16666666666666666,0.5
80,70,70,90,100,70,480,0.5609756097560976,45,30,35,20,20,45,195,0.14782608695652175,0.5
52,65,55,58,62,60,352,0.4482758620689655,35,80,50,50,70,120,405,0.84375,1.0
60,95,80,60,80,30,405,0.19480519480519481,62,48,54,63,60,68,355,0.5178571428571429,2.0
100,100,100,100,100,100,600,0.8345864661654135,110,123,65,100,65,65,528,0.5217391304347826,0.5
68,90,65,50,55,82,410,0.6165413533834586,150,120,100,120,100,90,680,0.664179104477612,2.0
50,60,45,100,80,65,400,0.45689655172413796,50,52,48,65,50,55,320,0.33098591549295775,2.0
170,90,45,90,45,60,500,0.427536231884058,80,145,150,105,110,110,700,0.8692307692307693,1.0
35,60,44,40,54,55,288,0.366412213740458,76,104,71,104,71,108,534,0.912751677852349,1.0
63,60,55,50,50,71,349,0.5289256198347108,50,95,90,95,90,180,600,0.9172413793103448,1.0
45,50,43,40,38,62,278,0.40441176470588236,100,100,100,100,100,100,600,0.8778625954198473,1.0
50,70,100,40,40,30,330,0.2222222222222222,90,120,100,150,120,100,680,0.7718120805369127,0.5
50,75,75,65,65,50,380,0.4049586776859504,125,58,58,76,76,67,460,0.515625,1.0
70,140,70,110,65,105,560,0.95,82,80,86,85,75,72,480,0.6183206106870229,0.5
100,180,160,150,90,90,770,0.7520661157024794,40,65,40,80,40,65,330,0.5038167938931297,1.0
45,75,60,40,30,50,300,0.304,100,100,100,100,100,100,600,0.8758169934640523,0.5
59,74,50,35,50,35,303,0.3125,35,85,45,35,35,75,310,0.6492537313432836,0.0
55,69,85,32,35,28,304,0.09302325581395349,100,164,150,95,120,71,700,0.5645161290322581,1.0
90,65,65,40,40,15,315,0.19672131147540983,60,67,85,77,75,116,480,0.8888888888888888,0.5
80,120,130,55,65,45,495,0.37037037037037035,65,75,105,35,65,85,430,0.6940298507462687,0.0
75,70,90,70,105,80,490,0.656,55,55,55,85,55,30,335,0.1320754716981132,1.0
95,80,105,40,70,100,490,0.8046875,75,105,75,105,75,45,480,0.3274336283185841,1.0
65,75,90,97,123,44,494,0.1987179487179487,80,82,100,83,100,80,525,0.6821705426356589,2.0
40,20,30,40,80,55,265,0.22764227642276422,70,85,65,105,85,120,530,0.9262295081967213,4.0
35,55,40,45,40,60,275,0.35714285714285715,100,77,77,128,128,90,600,0.6901408450704225,1.0
50,53,62,58,63,44,330,0.13709677419354838,70,100,70,105,75,40,460,0.23214285714285715,4.0
60,90,70,60,120,40,440,0.27419354838709675,40,70,40,35,40,60,285,0.392,1.0
60,100,85,80,85,100,510,0.7007874015748031,60,105,60,120,60,105,510,0.8849557522123894,0.0
50,70,50,50,50,40,310,0.16296296296296298,85,50,95,120,115,80,545,0.5793650793650794,1.0
105,130,120,45,45,40,485,0.4444444444444444,89,124,80,55,80,55,483,0.5714285714285714,0.5
65,95,75,55,55,85,430,0.6933333333333334,45,75,37,70,55,83,365,0.6183206106870229,2.0
49,66,70,44,55,51,335,0.4260869565217391,80,90,80,130,110,110,600,0.856,1.0
60,60,40,65,45,35,305,0.15833333333333333,91,129,90,72,90,108,580,0.8536585365853658,1.0
76,48,48,57,62,34,325,0.11688311688311688,77,59,50,67,63,46,362,0.23140495867768596,2.0
55,75,60,75,60,103,428,0.7982456140350878,76,104,71,104,71,108,534,0.912751677852349,2.0
103,93,67,71,61,84,479,0.7142857142857143,80,120,79,95,79,70,523,0.5833333333333334,1.0
60,75,85,100,85,115,520,0.8992248062015504,54,78,103,53,45,22,355,0.23255813953488372,1.0
35,45,160,30,45,70,385,0.48148148148148145,60,75,100,55,80,50,420,0.3088235294117647,1.0
108,112,118,68,72,47,525,0.2916666666666667,90,100,90,125,85,90,580,0.7352941176470589,0.0
40,55,70,45,60,30,300,0.10619469026548672,70,115,60,115,60,55,475,0.4647887323943662,1.0
55,45,45,25,25,15,210,0.048,81,102,77,85,75,85,505,0.5642857142857143,4.0
75,90,90,140,90,115,600,0.9481481481481482,40,45,35,30,40,55,245,0.3793103448275862,1.0
30,40,55,40,55,60,280,0.3237410071942446,50,50,77,95,77,91,440,0.5916666666666667,0.0
50,85,55,65,65,90,410,0.7478260869565218,50,50,40,50,40,64,294,0.45588235294117646,0.5
100,100,90,150,140,90,670,0.71875,55,75,85,25,25,15,280,0.1875,2.0
60,40,60,40,60,35,295,0.18055555555555555,50,70,50,50,50,70,340,0.5645161290322581,1.0
100,100,100,100,100,100,600,0.8345864661654135,30,40,55,40,55,60,280,0.3237410071942446,0.5
45,67,60,35,50,63,320,0.5128205128205128,75,80,55,25,35,35,305,0.18666666666666668,1.0
75,123,67,95,85,95,540,0.7642276422764228,55,20,35,20,45,75,250,0.37681159420289856,1.0
95,75,80,100,110,30,490,0.24242424242424243,70,85,140,85,70,20,470,0.272,2.0
85,60,65,135,105,100,550,0.7518248175182481,70,80,50,35,35,35,305,0.14,0.5
50,85,125,85,115,20,480,0.4306569343065693,100,150,120,120,100,90,680,0.6493506493506493,1.0
90,120,120,60,60,50,500,0.35294117647058826,60,69,95,69,95,36,424,0.2608695652173913,1.0
99,68,83,72,87,51,460,0.417910447761194,64,51,23,51,23,28,240,0.11363636363636363,1.0
35,35,40,35,55,50,250,0.40336134453781514,80,105,105,105,105,80,580,0.5939849624060151,1.0
50,65,107,105,107,86,520,0.7313432835820896,35,60,44,40,54,55,288,0.366412213740458,0.5
62,77,62,50,42,65,358,0.4838709677419355,65,95,75,55,55,85,430,0.6933333333333334,1.0
50,53,62,58,63,44,330,0.13709677419354838,55,20,35,20,45,75,250,0.37681159420289856,1.0
90,120,100,150,120,100,680,0.7718120805369127,65,50,70,95,80,65,425,0.4262295081967213,1.0
75,80,55,25,35,35,305,0.18666666666666668,75,55,70,55,95,110,460,0.8444444444444444,0.5
100,150,110,95,110,70,635,0.5923076923076923,55,50,40,40,40,75,300,0.5945945945945946,1.0
79,115,70,125,80,111,580,0.864,38,30,41,30,41,60,240,0.2897196261682243,1.0
65,90,40,45,80,75,395,0.625,50,53,48,53,48,64,316,0.358974358974359,1.0
20,10,55,15,20,80,200,0.17985611510791366,40,40,55,40,70,55,300,0.40939597315436244,2.0
70,90,110,60,75,95,500,0.7333333333333333,65,60,70,85,75,40,395,0.1796875,1.0
85,70,80,97,80,123,535,0.9304347826086956,65,40,50,125,60,30,370,0.07258064516129033,1.0
80,105,105,105,105,80,580,0.5939849624060151,44,48,65,50,64,43,314,0.1623931623931624,1.0
70,60,70,87,78,85,450,0.6228070175438597,85,135,130,60,80,25,515,0.40540540540540543,2.0
75,85,200,55,65,30,510,0.16778523489932887,90,120,100,150,120,100,680,0.7718120805369127,0.5
50,30,55,65,55,20,275,0.13675213675213677,90,93,55,70,55,55,418,0.3819444444444444,0.5
30,80,90,55,45,55,355,0.4295774647887324,30,45,59,30,39,57,260,0.2803030303030303,2.0
79,115,70,125,80,111,580,0.8468468468468469,68,85,65,165,135,100,618,0.8083333333333333,1.0
60,52,168,47,138,30,495,0.19834710743801653,70,80,102,80,102,40,474,0.2677165354330709,4.0
74,108,133,83,65,32,495,0.32142857142857145,55,20,35,20,45,75,250,0.37681159420289856,1.0
85,70,80,97,80,123,535,0.9304347826086956,30,42,118,42,88,30,350,0.112,0.125
75,98,63,98,63,101,498,0.889763779527559,55,68,64,45,55,31,318,0.11666666666666667,2.0
103,60,86,60,86,50,445,0.3458646616541353,45,55,39,35,39,42,255,0.18518518518518517,1.0
70,70,70,70,70,70,420,0.5289256198347108,165,75,80,40,45,65,470,0.5151515151515151,1.0
80,80,80,55,55,90,440,0.6417910447761194,60,40,80,60,45,40,325,0.23529411764705882,1.0
95,117,80,65,70,92,519,0.8409090909090909,38,30,85,55,65,30,303,0.21428571428571427,2.0
50,75,75,65,65,50,380,0.4049586776859504,75,55,70,55,95,110,460,0.8444444444444444,1.0
89,145,90,105,80,91,600,0.8549618320610687,50,53,48,53,48,64,316,0.358974358974359,1.0
60,90,140,50,50,40,430,0.2535211267605634,60,85,69,60,69,77,420,0.518796992481203,1.0
91,72,90,129,90,108,580,0.8620689655172413,75,95,122,58,75,69,494,0.5725806451612904,0.0
60,85,42,85,42,91,405,0.8227848101265823,85,135,130,60,80,25,515,0.40540540540540543,0.5
79,115,70,125,80,111,580,0.864,60,90,140,50,50,40,430,0.2535211267605634,0.25
61,84,65,70,70,70,420,0.5,55,75,60,75,60,103,428,0.7982456140350878,1.0
130,65,60,110,95,65,525,0.5227272727272727,45,30,15,85,65,65,305,0.36220472440944884,1.0
76,104,71,104,71,108,534,0.912751677852349,80,160,60,170,130,80,680,0.6180555555555556,1.0
90,92,87,75,85,76,505,0.5409836065573771,60,80,95,70,85,50,440,0.2231404958677686,0.0
45,85,70,40,40,60,340,0.5229357798165137,53,51,53,61,56,40,314,0.14285714285714285,0.5
50,50,40,50,40,64,294,0.45588235294117646,105,125,100,60,100,100,590,0.8359375,1.0
61,78,95,56,58,57,405,0.40336134453781514,50,30,55,65,55,20,275,0.13675213675213677,0.5
190,33,58,33,58,33,405,0.13432835820895522,95,85,85,65,65,35,430,0.2571428571428571,2.0
110,135,60,50,65,88,508,0.7744360902255639,69,55,45,55,55,15,294,0.11666666666666667,1.0
120,120,120,120,120,120,720,0.9344262295081968,75,95,60,65,60,115,470,0.8778625954198473,1.0
60,130,80,60,60,70,460,0.5153846153846153,110,135,60,50,65,88,508,0.7744360902255639,2.0
65,70,60,65,65,115,440,0.8583333333333333,70,80,70,80,70,110,480,0.6594202898550725,0.0
108,170,115,120,95,92,700,0.7083333333333334,45,45,35,20,30,20,195,0.07246376811594203,0.5
55,20,35,20,45,75,250,0.37681159420289856,100,150,120,120,100,90,680,0.6493506493506493,1.0
65,95,75,55,55,85,430,0.6933333333333334,30,35,30,100,35,80,310,0.4765625,0.25
45,45,35,20,30,20,195,0.07246376811594203,77,120,90,60,90,48,485,0.2785714285714286,1.0
60,30,30,36,56,50,262,0.32432432432432434,104,91,63,91,73,68,490,0.5118110236220472,1.0
50,53,48,53,48,64,316,0.358974358974359,75,100,110,45,55,65,450,0.5333333333333333,2.0
55,35,50,55,110,85,390,0.6277372262773723,100,150,140,100,90,90,670,0.7969924812030075,1.0
40,45,65,100,120,90,460,0.5588235294117647,55,112,45,74,45,70,401,0.559322033898305,1.0
50,50,62,40,62,65,329,0.4188034188034188,77,59,50,67,63,46,362,0.23140495867768596,0.5
95,23,48,23,48,23,260,0.046153846153846156,95,75,110,100,80,30,490,0.15267175572519084,0.5
65,90,50,85,45,55,390,0.371900826446281,28,25,25,45,35,40,198,0.16083916083916083,2.0
40,35,30,120,70,105,400,0.6692307692307692,50,70,50,50,50,40,310,0.16296296296296298,1.0
40,45,65,100,120,90,460,0.5588235294117647,80,95,82,60,82,75,474,0.6,1.0
78,84,78,109,85,100,534,0.8620689655172413,50,50,95,40,50,35,320,0.20279720279720279,1.0
73,76,75,81,100,100,505,0.8110236220472441,60,85,60,85,60,55,405,0.3673469387755102,0.5
76,104,71,104,71,108,534,0.912751677852349,85,56,77,50,77,78,423,0.53125,2.0
44,75,35,63,33,45,295,0.2647058823529412,45,30,50,55,65,45,290,0.208,2.0
90,75,75,90,100,70,500,0.5462184873949579,79,103,120,135,115,78,630,0.5763888888888888,0.5
35,64,85,74,55,32,345,0.19827586206896552,35,55,35,30,30,35,220,0.23684210526315788,1.0
70,120,40,95,40,95,460,0.8106060606060606,70,83,50,37,50,60,350,0.3360655737704918,1.0
55,35,50,55,110,85,390,0.6277372262773723,59,45,40,35,40,31,250,0.14285714285714285,1.0
50,50,50,50,50,50,300,0.30708661417322836,80,92,65,65,80,68,450,0.4824561403508772,0.5
70,110,80,55,80,105,500,0.8794326241134752,114,85,70,85,80,30,464,0.2066115702479339,2.0
46,57,40,40,40,50,273,0.25,75,90,50,110,80,95,500,0.7985611510791367,1.0
106,110,90,154,90,130,680,0.926829268292683,70,60,62,80,82,60,414,0.4375,1.0
40,30,30,55,30,85,270,0.4666666666666667,55,68,64,45,55,31,318,0.11666666666666667,1.0
100,120,120,150,100,90,680,0.7880794701986755,95,110,95,40,95,55,490,0.40336134453781514,1.0
60,85,42,85,42,91,405,0.8227848101265823,62,55,52,109,94,109,481,0.7833333333333333,0.5
80,92,65,65,80,68,450,0.4824561403508772,49,55,42,42,37,85,310,0.6068376068376068,1.0
100,110,90,85,90,60,535,0.47794117647058826,95,85,85,65,65,35,430,0.2571428571428571,1.0
100,164,150,95,120,71,700,0.5645161290322581,60,67,85,77,75,116,480,0.8888888888888888,0.5
75,95,95,95,95,85,540,0.6470588235294118,45,40,60,40,75,50,310,0.2926829268292683,1.0
80,80,80,80,80,80,480,0.5606060606060606,54,63,52,83,56,97,405,0.7697841726618705,0.5
100,50,80,60,80,50,420,0.34375,75,80,85,110,90,50,490,0.3548387096774194,0.25
55,85,55,50,55,60,360,0.4233576642335766,78,52,60,63,65,23,341,0.06015037593984962,0.5
85,80,90,105,95,60,515,0.49074074074074076,86,76,86,116,56,95,515,0.7982456140350878,1.0
83,80,75,70,70,101,479,0.8615384615384616,70,145,88,140,70,112,625,0.8888888888888888,0.5
80,105,65,60,75,130,515,0.9645390070921985,80,100,200,50,100,50,580,0.3472222222222222,0.5
80,160,80,130,80,100,630,0.8455284552845529,91,72,90,129,90,108,580,0.8925619834710744,0.5
20,25,45,70,90,60,310,0.30833333333333335,65,110,130,60,65,95,525,0.8278145695364238,1.0
95,23,48,23,48,23,260,0.046153846153846156,50,55,50,36,30,43,264,0.2922077922077922,1.0
45,75,37,70,55,83,365,0.6183206106870229,160,110,65,65,110,30,540,0.35714285714285715,1.0
91,72,90,129,90,108,580,0.8620689655172413,20,10,55,15,20,80,200,0.17985611510791366,0.5
40,40,40,70,40,20,250,0.032520325203252036,75,140,65,112,65,110,567,0.9140625,0.5
31,45,90,30,30,40,266,0.21929824561403508,75,95,122,58,75,69,494,0.5725806451612904,0.5
55,47,52,40,40,41,275,0.16806722689075632,10,55,25,35,45,95,265,0.5396825396825397,0.5
45,85,50,55,50,65,350,0.5076923076923077,60,62,63,80,80,60,405,0.38016528925619836,0.5
70,110,75,145,85,145,630,0.9444444444444444,40,40,35,50,100,70,335,0.5031847133757962,1.0
68,125,65,65,115,80,518,0.6277372262773723,70,60,62,80,82,60,414,0.4375,0.25
70,85,140,85,70,20,470,0.272,40,29,45,29,45,36,224,0.14634146341463414,2.0
75,140,65,112,65,110,567,0.9140625,45,60,40,70,50,45,310,0.2846715328467153,2.0
42,52,67,39,56,50,306,0.2868217054263566,70,140,230,60,80,50,630,0.32432432432432434,0.5
30,45,59,30,39,57,260,0.2803030303030303,65,70,60,65,65,115,440,0.8583333333333333,1.0
60,55,50,40,55,45,305,0.22377622377622378,74,100,72,90,72,46,454,0.24561403508771928,4.0
77,120,90,60,90,48,485,0.2785714285714286,10,55,25,35,45,95,265,0.5396825396825397,1.0
64,115,65,83,63,65,455,0.5323741007194245,55,20,35,20,45,75,250,0.37681159420289856,0.0
38,35,40,27,25,35,200,0.08208955223880597,80,120,80,120,80,100,580,0.8478260869565217,1.0
100,150,90,180,160,90,770,0.7348484848484849,95,145,130,120,90,120,700,0.9398496240601504,0.5
108,112,118,68,72,47,525,0.2916666666666667,55,69,85,32,35,28,304,0.09302325581395349,1.0
40,45,40,62,60,60,307,0.33884297520661155,50,52,48,65,50,55,320,0.33098591549295775,0.5
75,75,55,105,85,30,425,0.1619718309859155,38,30,41,30,41,60,240,0.2897196261682243,1.0
54,63,52,83,56,97,405,0.7697841726618705,77,120,90,60,90,48,485,0.2785714285714286,0.5
35,80,50,50,70,120,405,0.84375,73,115,60,60,60,90,458,0.6694915254237288,1.0
160,110,65,65,110,30,540,0.35714285714285715,75,38,38,56,56,67,330,0.5263157894736842,1.0
70,90,110,60,75,95,500,0.7333333333333333,70,55,65,95,85,70,440,0.5307692307692308,1.0
60,70,105,70,120,75,500,0.5983606557377049,45,25,50,25,25,35,205,0.13076923076923078,2.0
60,50,70,80,80,140,480,0.8449612403100775,73,95,62,85,65,85,465,0.6666666666666666,1.0
95,125,79,60,100,81,540,0.6165413533834586,80,100,200,50,100,50,580,0.3472222222222222,1.0
35,55,35,30,30,35,220,0.23684210526315788,65,50,70,95,80,65,425,0.4262295081967213,2.0
75,80,70,65,75,90,455,0.7578125,80,120,79,95,79,70,523,0.5833333333333334,0.5
30,56,35,25,35,72,253,0.48148148148148145,80,160,60,170,130,80,680,0.6180555555555556,1.0
64,115,65,83,63,65,455,0.5323741007194245,115,140,130,55,55,40,535,0.4519230769230769,1.0
64,78,52,78,52,81,405,0.6422764227642277,76,48,48,57,62,34,325,0.11688311688311688,0.5
46,57,40,40,40,50,273,0.25,50,50,95,40,50,35,320,0.20279720279720279,0.5
55,85,55,50,55,60,360,0.4233576642335766,95,75,80,100,110,30,490,0.24242424242424243,1.0
100,103,75,120,75,127,600,0.940677966101695,100,100,80,60,60,50,450,0.3050847457627119,2.0
70,120,40,95,40,95,460,0.8106060606060606,65,90,115,45,115,58,488,0.5041322314049587,0.25
30,40,55,40,55,60,280,0.3237410071942446,67,82,62,46,48,43,348,0.22033898305084745,1.0
46,57,40,40,40,50,273,0.25,70,70,70,70,70,70,420,0.5289256198347108,1.0
85,80,70,135,75,90,535,0.7006802721088435,45,50,35,55,75,40,300,0.21367521367521367,1.0
95,60,79,100,125,81,540,0.6201550387596899,30,105,90,25,25,50,325,0.2773722627737226,0.5
65,55,115,100,40,60,435,0.3798449612403101,80,82,100,83,100,80,525,0.6821705426356589,0.5
90,75,85,115,90,55,510,0.3445378151260504,85,97,66,105,66,65,484,0.47107438016528924,1.0
40,40,35,50,100,70,335,0.5031847133757962,50,50,95,40,50,35,320,0.20279720279720279,1.0
75,89,85,55,65,36,405,0.29545454545454547,55,130,115,50,50,75,475,0.5982142857142857,2.0
83,80,75,70,70,101,479,0.8615384615384616,135,85,40,40,85,5,390,0.6864406779661016,1.0
65,150,40,15,80,145,495,0.9663865546218487,60,110,70,60,60,100,460,0.8461538461538461,0.5
40,70,130,60,130,25,455,0.17355371900826447,60,55,145,75,150,40,525,0.2,1.0
65,130,60,75,60,75,465,0.689922480620155,72,58,80,103,80,97,490,0.7171052631578947,2.0
44,38,39,61,79,42,303,0.2251655629139073,90,90,85,125,90,100,580,0.768595041322314,1.0
30,105,90,25,25,50,325,0.2773722627737226,50,64,50,45,50,41,300,0.22727272727272727,4.0
40,30,30,40,50,30,220,0.07936507936507936,65,136,94,54,96,135,580,0.9612403100775194,1.0
80,100,200,50,100,50,580,0.3472222222222222,65,80,140,40,70,70,465,0.5223880597014925,1.0
45,50,35,55,75,40,300,0.21367521367521367,75,98,63,98,63,101,498,0.8091603053435115,1.0
75,70,90,70,105,80,490,0.656,95,95,85,125,65,55,520,0.3894736842105263,2.0
100,110,90,85,90,60,535,0.47794117647058826,55,35,50,55,110,85,390,0.6277372262773723,0.0
75,103,80,70,80,92,500,0.7933884297520661,45,60,30,80,50,65,330,0.4603174603174603,0.5
43,80,65,50,35,35,308,0.14193548387096774,65,150,40,15,80,145,495,0.9663865546218487,1.0
80,80,80,55,55,90,440,0.6417910447761194,95,125,79,60,100,81,540,0.6165413533834586,1.0
100,100,80,60,60,50,450,0.3050847457627119,65,150,60,115,60,115,565,0.935251798561151,1.0
67,82,62,46,48,43,348,0.22033898305084745,50,52,48,65,50,55,320,0.33098591549295775,1.0
65,95,75,55,55,85,430,0.6933333333333334,55,50,45,135,95,120,500,0.7714285714285715,1.0
39,52,43,60,50,65,309,0.5041322314049587,50,65,107,105,107,86,520,0.7313432835820896,2.0
80,85,95,30,30,25,345,0.2857142857142857,85,115,80,105,80,50,515,0.3063063063063063,2.0
72,105,115,54,86,68,500,0.5149253731343284,105,180,100,180,100,115,780,0.9477611940298507,1.0
90,100,60,90,60,80,480,0.6422764227642277,80,110,60,150,130,70,600,0.5042016806722689,4.0
75,75,130,75,130,95,580,0.7479674796747967,95,75,110,100,80,30,490,0.15267175572519084,0.5
80,160,60,170,130,80,680,0.6180555555555556,70,60,62,80,82,60,414,0.4375,1.0
65,85,70,75,70,40,405,0.203125,84,86,88,111,101,60,530,0.4634146341463415,2.0
64,51,23,51,23,28,240,0.11363636363636363,95,117,80,65,70,92,519,0.8409090909090909,1.0
70,110,80,55,80,105,500,0.8794326241134752,35,55,40,45,40,60,275,0.35714285714285715,0.5
74,100,72,90,72,46,454,0.24561403508771928,110,65,75,125,85,30,490,0.15,1.0
95,125,79,60,100,81,540,0.6165413533834586,91,134,95,100,100,80,600,0.6304347826086957,0.5
70,85,70,60,70,50,405,0.28378378378378377,55,95,55,35,75,115,430,0.9380530973451328,1.0
50,53,48,53,48,64,316,0.46153846153846156,30,80,90,55,45,55,355,0.4295774647887324,0.25
73,100,60,100,60,65,458,0.42657342657342656,60,85,69,60,69,77,420,0.518796992481203,1.0
45,50,45,115,55,95,405,0.6936936936936937,31,45,90,30,30,40,266,0.21929824561403508,0.5
55,81,60,50,70,97,413,0.7214285714285714,125,130,90,130,90,95,660,0.7734375,1.0
80,70,65,80,120,100,515,0.8034188034188035,79,115,70,125,80,111,580,0.8468468468468469,1.0
80,85,95,30,30,25,345,0.2857142857142857,86,92,88,68,75,73,482,0.6835443037974683,1.0
75,95,122,58,75,69,494,0.5725806451612904,65,47,55,73,75,85,400,0.65,0.5
71,73,88,120,89,59,500,0.43537414965986393,40,45,40,65,40,65,295,0.5661764705882353,1.0
91,72,90,129,90,108,580,0.8925619834710744,80,80,80,80,80,80,480,0.6015037593984962,2.0
20,10,230,10,230,5,505,0.0,58,64,58,80,65,80,405,0.609271523178808,1.0
35,70,55,45,55,25,285,0.09420289855072464,90,55,75,60,75,30,385,0.13970588235294118,1.0
85,80,70,135,75,90,535,0.7006802721088435,35,35,40,35,55,50,250,0.40336134453781514,1.0
65,75,90,97,123,44,494,0.1987179487179487,80,160,60,170,130,80,680,0.6180555555555556,1.0
40,80,100,30,30,20,300,0.11851851851851852,60,85,60,85,60,55,405,0.3673469387755102,2.0
40,80,35,35,45,70,305,0.4661016949152542,75,98,63,98,63,101,498,0.849624060150376,1.0
100,73,83,73,83,55,467,0.371900826446281,100,134,110,95,100,61,600,0.4057971014492754,0.5
150,80,44,90,54,80,498,0.625,68,65,65,125,115,80,518,0.6461538461538462,2.0
50,65,90,35,35,15,290,0.14678899082568808,45,35,45,62,53,35,275,0.11851851851851852,2.0
60,150,50,150,50,60,520,0.5,85,60,65,135,105,100,550,0.7518248175182481,0.5
55,20,35,20,45,75,250,0.37681159420289856,30,80,90,55,45,55,355,0.4295774647887324,0.5
75,75,55,105,85,30,425,0.1619718309859155,110,80,90,95,90,65,530,0.5033557046979866,2.0
68,125,65,65,115,80,518,0.6277372262773723,62,50,58,73,54,72,369,0.4435483870967742,2.0
75,95,67,125,95,83,540,0.7117117117117117,75,100,95,40,70,110,490,0.8717948717948718,1.0
68,75,53,83,113,60,452,0.45384615384615384,60,80,50,50,50,40,330,0.23853211009174313,1.0
25,35,70,95,55,45,325,0.16783216783216784,60,45,70,45,90,95,405,0.7304964539007093,0.25
91,129,90,72,90,108,580,0.8536585365853658,65,125,100,55,70,85,500,0.6532258064516129,1.0
60,85,60,85,60,55,405,0.3673469387755102,92,105,90,125,90,98,600,0.8217054263565892,1.0
99,68,83,72,87,51,460,0.417910447761194,100,100,100,100,100,100,600,0.8778625954198473,0.5
50,70,50,50,50,70,340,0.5645161290322581,50,45,45,35,35,50,260,0.23529411764705882,1.0
45,63,37,65,55,95,360,0.8055555555555556,31,45,90,30,30,40,266,0.21929824561403508,0.0
45,100,135,65,135,45,525,0.29411764705882354,50,85,40,85,40,35,335,0.1746031746031746,1.0
105,140,95,55,65,45,505,0.3,50,105,125,55,95,50,480,0.375886524822695,1.0
123,100,62,97,81,68,531,0.4806201550387597,65,95,100,60,50,50,420,0.34959349593495936,0.5
45,49,49,65,65,45,318,0.2781954887218045,100,128,90,77,77,128,600,0.959349593495935,1.0
100,50,80,60,80,50,420,0.34375,70,130,100,55,80,65,500,0.608,0.5
50,65,45,85,65,95,405,0.7238095238095238,70,100,70,105,75,40,460,0.23214285714285715,1.0
63,120,85,90,55,55,468,0.2809917355371901,70,50,30,95,135,105,485,0.8040540540540541,1.0
85,135,130,60,80,25,515,0.40540540540540543,70,110,80,55,80,105,500,0.8794326241134752,4.0
55,95,115,45,45,35,390,0.2116788321167883,89,124,80,55,80,55,483,0.5714285714285714,0.5
72,95,67,103,71,122,530,0.9606299212598425,60,85,42,85,42,91,405,0.8227848101265823,0.5
63,120,85,90,55,55,468,0.2809917355371901,95,23,48,23,48,23,260,0.046153846153846156,2.0
45,25,50,25,25,35,205,0.13076923076923078,100,100,100,100,100,100,600,0.8345864661654135,8.0
60,67,85,77,75,116,480,0.8888888888888888,80,105,65,60,75,130,515,0.9645390070921985,1.0
60,85,49,60,49,60,363,0.4444444444444444,70,55,75,45,65,60,370,0.45901639344262296,2.0
50,20,55,25,25,30,205,0.09774436090225563,70,80,102,80,102,40,474,0.2677165354330709,0.5
59,66,70,44,55,41,335,0.25190839694656486,80,145,150,105,110,110,700,0.8692307692307693,1.0
75,87,63,87,63,98,473,0.865546218487395,65,100,70,80,80,105,500,0.8666666666666667,2.0
60,25,35,70,80,60,330,0.3076923076923077,67,82,62,46,48,43,348,0.22033898305084745,1.0
100,103,75,120,75,127,600,0.940677966101695,10,55,25,35,45,95,265,0.5396825396825397,2.0
60,90,140,50,50,40,430,0.2535211267605634,100,75,115,90,115,85,580,0.6446280991735537,0.5
50,180,20,180,20,150,600,0.9029850746268657,73,115,60,60,60,90,458,0.6694915254237288,1.0
80,120,80,120,80,100,580,0.8478260869565217,36,50,50,65,60,44,305,0.16363636363636364,0.5
63,60,55,50,50,71,349,0.5289256198347108,70,90,45,15,45,50,315,0.3629032258064516,1.0
89,145,90,105,80,91,600,0.8549618320610687,45,49,65,49,65,45,318,0.275,1.0
60,90,55,90,80,110,485,0.8677685950413223,67,89,116,79,116,33,500,0.2624113475177305,1.0
50,75,35,70,30,40,300,0.21296296296296297,70,95,85,55,65,70,440,0.5,1.0
150,160,100,95,65,100,670,0.8866666666666667,40,80,35,35,45,70,305,0.4661016949152542,1.0
55,45,45,25,25,15,210,0.048,100,73,83,73,83,55,467,0.371900826446281,2.0
30,40,55,40,55,60,280,0.3237410071942446,91,90,106,130,106,77,600,0.648854961832061,1.0
90,92,87,75,85,76,505,0.5409836065573771,35,55,40,45,40,60,275,0.35714285714285715,2.0
70,92,65,80,55,98,460,0.8090909090909091,55,70,55,40,55,85,360,0.7073170731707317,1.0
70,62,67,55,55,56,365,0.38513513513513514,50,40,85,40,65,25,305,0.08870967741935484,1.0
50,47,50,57,50,65,319,0.463768115942029,51,65,65,80,75,59,395,0.4365079365079365,1.0
35,55,35,30,30,35,220,0.23684210526315788,40,60,30,31,31,70,262,0.4492753623188406,1.0
75,98,63,98,63,101,498,0.889763779527559,75,80,85,110,90,50,490,0.3548387096774194,2.0
30,56,35,25,35,72,253,0.48148148148148145,39,52,43,60,50,65,309,0.5041322314049587,1.0
70,80,50,35,35,35,305,0.14,70,50,30,95,135,105,485,0.8040540540540541,2.0
52,65,50,45,50,38,300,0.27419354838709675,90,130,80,65,85,55,505,0.4396551724137931,0.5
80,115,80,65,55,93,488,0.7846153846153846,100,180,160,150,90,90,770,0.7520661157024794,1.0
83,80,80,135,80,121,579,0.9444444444444444,50,92,108,92,108,35,485,0.2457627118644068,0.0
80,110,60,150,130,70,600,0.5042016806722689,75,105,75,105,75,45,480,0.3274336283185841,1.0
106,130,90,110,154,90,680,0.719626168224299,40,55,80,35,60,30,300,0.15037593984962405,1.0
108,130,95,80,85,102,600,0.7637795275590551,45,60,32,50,32,76,295,0.5925925925925926,2.0
65,60,110,130,95,65,525,0.47761194029850745,35,70,55,45,55,25,285,0.09420289855072464,2.0
74,108,133,83,65,32,495,0.32142857142857145,79,105,70,145,80,101,580,0.8608695652173913,2.0
50,65,107,105,107,86,520,0.6991150442477876,40,45,35,40,40,90,290,0.65,1.0
49,49,56,49,61,66,330,0.5190839694656488,75,75,95,75,95,113,528,0.9015151515151515,0.5
90,100,60,90,60,80,480,0.6422764227642277,105,180,100,180,100,115,780,0.9477611940298507,0.25
79,85,60,55,60,71,410,0.60431654676259,78,81,71,74,69,126,499,0.9090909090909091,2.0
95,85,85,65,65,35,430,0.2571428571428571,108,130,95,80,85,102,600,0.7637795275590551,1.0
70,84,70,65,70,51,410,0.2949640287769784,85,110,76,65,82,56,474,0.3933333333333333,0.5
105,125,100,60,100,100,590,0.8359375,70,150,140,65,100,75,600,0.55,0.5
62,73,55,56,52,84,382,0.7244094488188977,45,55,39,35,39,42,255,0.18518518518518517,1.0
75,80,55,25,35,35,305,0.18666666666666668,82,121,119,69,59,71,521,0.5394736842105263,2.0
40,55,80,35,60,30,300,0.15037593984962405,75,55,70,55,95,110,460,0.8444444444444444,1.0
55,66,44,44,56,85,350,0.6888888888888889,50,20,55,25,25,30,205,0.09774436090225563,1.0
53,54,53,37,46,45,288,0.3090909090909091,70,20,50,20,50,40,250,0.1557377049180328,0.5
50,70,100,40,40,30,330,0.2222222222222222,110,135,60,50,65,88,508,0.7744360902255639,0.125
80,110,120,130,90,70,600,0.6198347107438017,75,80,95,90,100,50,490,0.2158273381294964,1.0
50,75,35,70,30,40,300,0.21296296296296297,100,5,5,15,65,30,220,0.07692307692307693,1.0
70,90,70,60,60,70,420,0.6390977443609023,50,35,55,25,25,15,205,0.021739130434782608,1.0
55,85,122,58,75,99,494,0.8099173553719008,95,117,184,44,46,28,514,0.2975206611570248,1.0
50,50,150,50,150,50,500,0.2571428571428571,42,52,67,39,56,50,306,0.2868217054263566,1.0
70,140,230,60,80,50,630,0.32432432432432434,123,77,72,99,92,58,521,0.4621212121212121,4.0
92,105,90,125,90,98,600,0.8217054263565892,85,80,70,135,75,90,535,0.7006802721088435,1.0
77,120,90,60,90,48,485,0.2785714285714286,65,80,80,59,63,58,405,0.4411764705882353,1.0
90,65,65,40,40,15,315,0.19672131147540983,126,131,95,131,98,99,680,0.8294573643410853,1.0
91,72,90,129,90,108,580,0.8925619834710744,65,50,70,95,80,65,425,0.4262295081967213,0.5
80,82,100,83,100,80,525,0.6821705426356589,66,117,70,40,50,67,410,0.4573643410852713,0.5
91,90,129,90,72,108,580,0.9140625,70,90,45,15,45,50,315,0.3629032258064516,0.5
70,65,60,90,75,90,450,0.6571428571428571,35,55,40,45,40,60,275,0.35714285714285715,1.0
44,38,39,61,79,42,303,0.2251655629139073,59,63,80,65,80,58,405,0.41843971631205673,1.0
78,130,111,130,85,100,634,0.8561151079136691,80,80,80,80,80,80,480,0.5606060606060606,0.5
35,64,85,74,55,32,345,0.19827586206896552,38,35,35,65,55,50,278,0.2647058823529412,1.0
80,85,95,30,30,25,345,0.2857142857142857,70,95,125,65,75,45,475,0.33613445378151263,2.0
50,45,45,35,35,50,260,0.23529411764705882,35,55,40,45,40,60,275,0.35714285714285715,1.0
78,84,78,109,85,100,534,0.8620689655172413,60,75,85,100,85,115,520,0.8992248062015504,0.5
120,120,120,120,120,120,720,0.9344262295081968,75,70,90,70,105,80,490,0.656,1.0
70,80,65,90,65,85,455,0.578125,79,103,120,135,115,78,630,0.5763888888888888,1.0
50,75,45,40,45,60,315,0.4380165289256198,64,115,65,83,63,65,455,0.5323741007194245,0.5
100,164,150,95,120,71,700,0.5645161290322581,60,50,70,80,80,140,480,0.8449612403100775,1.0
65,80,65,35,65,60,370,0.38405797101449274,38,35,35,65,55,50,278,0.2647058823529412,1.0
31,45,90,30,30,40,266,0.21929824561403508,50,45,45,35,35,50,260,0.23529411764705882,1.0
60,95,80,60,80,30,405,0.19480519480519481,65,50,70,95,80,65,425,0.4262295081967213,2.0
65,55,115,100,40,60,435,0.3798449612403101,100,73,83,73,83,55,467,0.371900826446281,0.5
250,5,5,35,105,50,450,0.15306122448979592,61,90,45,50,50,160,456,0.9230769230769231,1.0
70,70,40,60,40,60,340,0.4247787610619469,60,50,70,50,90,65,385,0.39568345323741005,0.25
110,80,90,95,90,65,530,0.5033557046979866,60,52,168,47,138,30,495,0.19834710743801653,1.0
66,65,48,62,57,52,350,0.36220472440944884,50,70,100,40,40,30,330,0.2222222222222222,1.0
69,69,76,69,86,91,460,0.6554621848739496,100,50,50,76,96,70,442,0.5,1.0
45,20,50,60,120,50,345,0.24074074074074073,70,85,70,60,70,50,405,0.28378378378378377,1.0
115,45,20,45,25,20,270,0.11538461538461539,70,110,75,145,85,145,630,0.9444444444444444,2.0
35,70,55,45,55,25,285,0.09420289855072464,45,65,34,40,34,45,263,0.2589928057553957,1.0
61,90,45,50,50,160,456,0.9230769230769231,70,85,140,85,70,20,470,0.272,0.5
90,30,15,40,20,15,210,0.043478260869565216,45,22,60,27,30,29,213,0.07518796992481203,1.0
108,130,95,80,85,102,600,0.7637795275590551,85,135,130,60,80,25,515,0.40540540540540543,2.0
72,95,67,103,71,122,530,0.9606299212598425,44,75,35,63,33,45,295,0.2647058823529412,2.0
70,43,53,43,53,40,302,0.19090909090909092,43,80,65,50,35,35,308,0.14193548387096774,1.0
90,85,75,115,100,115,580,0.9381443298969072,150,100,120,100,120,90,680,0.6666666666666666,0.5
30,80,90,55,45,55,355,0.4295774647887324,70,84,70,65,70,51,410,0.2949640287769784,2.0
80,70,65,80,120,100,515,0.8034188034188035,75,69,72,114,100,104,534,0.8253968253968254,2.0
58,109,112,48,48,109,484,0.8805970149253731,91,90,129,90,72,108,580,0.9140625,0.125
40,55,30,30,30,85,270,0.688,58,50,145,95,105,30,483,0.2459016393442623,0.0
76,65,45,92,42,91,411,0.7449664429530202,55,85,55,50,55,60,360,0.4233576642335766,2.0
150,100,120,100,120,90,680,0.6666666666666666,71,82,64,64,59,112,452,0.9327731092436975,0.0
91,134,95,100,100,80,600,0.6304347826086957,103,93,67,71,61,84,479,0.7142857142857143,1.0
126,131,95,131,98,99,680,0.8294573643410853,78,92,75,74,63,118,500,0.8842975206611571,2.0
70,145,88,140,70,112,625,0.8888888888888888,62,77,62,50,42,65,358,0.4838709677419355,1.0
52,65,55,58,62,60,352,0.4482758620689655,72,58,80,103,80,97,490,0.7171052631578947,1.0
95,124,78,69,71,58,495,0.37398373983739835,75,98,63,98,63,101,498,0.849624060150376,1.0
49,55,42,42,37,85,310,0.6068376068376068,78,70,61,50,61,100,420,0.8145161290322581,1.0
100,164,150,95,120,71,700,0.5645161290322581,70,50,30,95,135,105,485,0.8040540540540541,2.0
55,55,45,63,45,45,308,0.25,85,105,85,40,50,40,405,0.211864406779661,1.0
105,30,105,140,105,55,540,0.3524590163934426,45,53,70,40,60,42,310,0.25735294117647056,4.0
65,55,115,100,40,60,435,0.3798449612403101,60,55,50,40,55,45,305,0.22377622377622378,0.25
78,84,78,109,85,100,534,0.8620689655172413,126,131,95,131,98,99,680,0.8102189781021898,1.0
80,145,150,105,110,110,700,0.8692307692307693,65,90,120,85,70,60,490,0.43410852713178294,2.0
80,120,130,55,65,45,495,0.37037037037037035,76,48,48,57,62,34,325,0.11688311688311688,1.0
100,120,120,150,100,90,680,0.7880794701986755,105,125,100,60,100,100,590,0.8359375,1.0
55,55,85,65,85,35,380,0.2014388489208633,52,65,55,58,62,60,352,0.4482758620689655,2.0
65,90,115,45,115,58,488,0.5041322314049587,50,72,35,35,35,65,292,0.5373134328358209,1.0
79,85,60,55,60,71,410,0.60431654676259,36,50,50,65,60,44,305,0.16363636363636364,1.0
55,68,64,45,55,31,318,0.11666666666666667,90,132,105,132,105,30,594,0.4246575342465753,0.5
115,140,130,55,55,40,535,0.4519230769230769,55,40,85,80,105,40,405,0.23622047244094488,0.0
55,55,45,63,45,45,308,0.25,100,120,100,150,120,90,680,0.728,1.0
40,55,30,30,30,60,245,0.43548387096774194,106,90,130,90,154,110,680,0.8699186991869918,1.0
65,95,75,55,55,85,430,0.6933333333333334,71,95,85,110,95,79,535,0.664,1.0
70,90,70,60,60,70,420,0.6390977443609023,75,80,55,25,35,35,305,0.18666666666666668,0.5
38,41,40,50,65,65,299,0.4108527131782946,74,94,131,54,116,20,489,0.4485294117647059,4.0
40,30,35,50,70,55,280,0.28205128205128205,50,40,85,40,65,25,305,0.08870967741935484,0.5
55,65,95,95,45,85,440,0.6610169491525424,65,50,70,95,80,65,425,0.4262295081967213,1.0
85,135,130,60,80,25,515,0.40540540540540543,75,98,63,98,63,101,498,0.849624060150376,1.0
80,80,80,80,80,80,480,0.6015037593984962,58,109,112,48,48,109,484,0.8805970149253731,0.5
50,45,45,35,35,50,260,0.23529411764705882,99,68,83,72,87,51,460,0.417910447761194,1.0
70,110,180,60,60,50,530,0.4117647058823529,90,85,75,115,100,115,580,0.9381443298969072,0.5
65,80,140,40,70,70,465,0.5223880597014925,45,75,37,70,55,83,365,0.6183206106870229,0.5
78,65,68,112,154,75,552,0.628099173553719,60,79,105,59,85,36,424,0.17054263565891473,1.0
72,58,80,103,80,97,490,0.7171052631578947,80,120,79,95,79,70,523,0.5833333333333334,0.5
95,85,85,65,65,35,430,0.2571428571428571,60,85,69,65,79,80,438,0.576,2.0
100,150,90,180,160,90,770,0.7348484848484849,60,60,60,105,105,105,495,0.848,1.0
67,125,40,30,30,58,350,0.3431372549019608,65,60,110,130,95,65,525,0.47761194029850745,2.0
85,105,100,79,83,78,530,0.5869565217391305,70,70,70,70,70,70,420,0.5289256198347108,1.0
30,40,55,40,55,60,280,0.3237410071942446,95,65,110,60,130,65,525,0.5275590551181102,0.0
60,100,89,55,69,112,485,0.9298245614035088,110,65,75,125,85,30,490,0.15,2.0
40,80,100,30,30,20,300,0.11851851851851852,60,69,95,69,95,36,424,0.2608695652173913,1.0
35,35,40,35,55,50,250,0.40336134453781514,95,109,105,75,85,56,525,0.34513274336283184,2.0
65,125,60,95,60,105,510,0.9236641221374046,75,123,67,95,85,95,540,0.7642276422764228,1.0
92,105,90,125,90,98,600,0.8217054263565892,65,65,60,110,95,130,525,0.9253731343283582,1.0
20,15,20,10,55,80,200,0.2682926829268293,95,65,65,110,130,60,525,0.4016393442622951,1.0
58,70,45,40,45,42,300,0.25925925925925924,95,80,105,40,70,100,490,0.8046875,1.0
95,65,110,60,130,65,525,0.5275590551181102,105,140,95,55,65,45,505,0.3,0.5
114,85,70,85,80,30,464,0.2066115702479339,60,45,50,90,80,70,395,0.625,0.25
75,38,38,56,56,67,330,0.5263157894736842,50,70,100,40,40,30,330,0.2222222222222222,2.0
100,120,100,150,120,90,680,0.728,91,90,72,90,129,108,580,0.896,2.0
60,65,80,170,95,130,600,0.8625954198473282,60,62,63,80,80,60,405,0.38016528925619836,1.0
100,100,90,150,140,90,670,0.71875,79,115,70,125,80,111,580,0.864,1.0
62,48,66,59,57,49,341,0.33884297520661155,55,95,55,35,75,115,430,0.9380530973451328,2.0
60,40,60,95,60,55,370,0.4222222222222222,65,80,80,59,63,58,405,0.4411764705882353,0.5
30,80,90,55,45,55,355,0.4295774647887324,55,69,85,32,35,28,304,0.09302325581395349,2.0
70,60,125,115,70,55,495,0.35507246376811596,45,50,45,115,55,95,405,0.6936936936936937,1.0
40,60,30,31,31,70,262,0.4492753623188406,40,30,50,55,55,100,330,0.584070796460177,0.5
126,131,95,131,98,99,680,0.8102189781021898,85,110,76,65,82,56,474,0.3933333333333333,4.0
40,70,130,60,130,25,455,0.17355371900826447,85,105,100,79,83,78,530,0.5869565217391305,1.0
70,77,60,97,60,108,472,0.8394160583941606,95,110,95,40,95,55,490,0.40336134453781514,1.0
31,45,90,30,30,40,266,0.21929824561403508,70,90,110,60,75,95,500,0.7333333333333333,2.0
120,70,120,75,130,85,600,0.6694915254237288,30,56,35,25,35,72,253,0.48148148148148145,1.0
60,65,70,85,75,40,395,0.21705426356589147,45,49,49,65,65,45,318,0.2781954887218045,0.25
50,75,35,70,30,40,300,0.21296296296296297,65,75,90,97,123,44,494,0.1987179487179487,0.125
80,110,60,150,130,70,600,0.5042016806722689,60,80,110,50,80,45,425,0.2833333333333333,2.0
55,50,45,135,95,120,500,0.7714285714285715,44,58,44,58,44,61,309,0.41964285714285715,1.0
74,108,133,83,65,32,495,0.32142857142857145,150,160,100,95,65,100,670,0.8866666666666667,1.0
70,85,70,60,70,50,405,0.28378378378378377,50,65,90,35,35,15,290,0.14678899082568808,0.5
60,60,50,40,50,75,335,0.5882352941176471,50,75,75,65,65,50,380,0.4049586776859504,0.0
100,100,100,100,100,100,600,0.8602941176470589,70,105,105,50,40,20,390,0.33587786259541985,2.0
78,84,78,109,85,100,534,0.8646616541353384,45,85,50,55,50,65,350,0.5076923076923077,2.0
108,130,95,80,85,102,600,0.7637795275590551,70,85,70,60,70,50,405,0.28378378378378377,1.0
39,52,43,60,50,65,309,0.5041322314049587,68,165,95,65,115,110,618,0.8615384615384616,1.0
95,145,130,120,90,120,700,0.9398496240601504,100,150,120,120,100,90,680,0.6493506493506493,1.0
69,69,76,69,86,91,460,0.6554621848739496,50,30,55,65,55,20,275,0.13675213675213677,2.0
70,115,60,115,60,55,475,0.4647887323943662,40,30,30,55,30,85,270,0.4666666666666667,1.0
40,40,50,30,30,30,220,0.0873015873015873,130,70,35,70,35,60,400,0.4017857142857143,2.0
75,89,85,55,65,36,405,0.29545454545454547,65,65,45,75,45,95,390,0.72,0.25
40,60,40,40,40,30,250,0.0948905109489051,84,86,88,111,101,60,530,0.4634146341463415,0.0
165,75,80,40,45,65,470,0.5151515151515151,100,164,150,95,120,71,700,0.5645161290322581,2.0
66,117,70,40,50,67,410,0.4573643410852713,41,50,37,50,37,66,281,0.5175438596491229,1.0
50,85,55,65,65,90,410,0.7478260869565218,59,63,80,65,80,58,405,0.41843971631205673,0.5
55,104,105,94,75,52,485,0.36363636363636365,55,55,50,45,65,55,325,0.37373737373737376,1.0
45,50,35,55,75,40,300,0.21367521367521367,80,100,70,60,70,95,475,0.7416666666666667,1.0
80,82,78,95,80,85,500,0.6869565217391305,65,110,130,60,65,95,525,0.8278145695364238,0.5
90,110,80,100,80,95,555,0.7982456140350878,60,110,70,60,60,100,460,0.8461538461538461,1.0
78,130,111,130,85,100,634,0.8561151079136691,75,100,63,80,63,116,497,0.9345794392523364,1.0
55,81,60,50,70,97,413,0.7214285714285714,85,120,70,50,60,100,485,0.8308823529411765,1.0
75,85,200,55,65,30,510,0.16778523489932887,75,75,60,83,60,60,413,0.39344262295081966,0.5
43,80,65,50,35,35,308,0.14193548387096774,60,115,105,65,70,80,495,0.7181818181818181,1.0
55,63,90,50,80,42,380,0.21138211382113822,103,60,86,60,86,50,445,0.3458646616541353,1.0
80,52,50,90,50,89,411,0.6666666666666666,75,100,95,40,70,110,490,0.8717948717948718,1.0
90,65,65,40,40,15,315,0.19672131147540983,60,80,50,50,50,40,330,0.23853211009174313,1.0
70,95,85,55,65,70,440,0.5,75,95,95,95,95,85,540,0.6470588235294118,1.0
90,130,80,65,85,55,505,0.4396551724137931,45,30,40,105,50,20,290,0.031007751937984496,0.5
80,95,82,60,82,75,474,0.6,106,110,90,154,90,130,680,0.926829268292683,1.0
45,22,60,27,30,29,213,0.07518796992481203,70,105,105,50,40,20,390,0.33587786259541985,1.0
65,55,115,100,40,60,435,0.3798449612403101,108,130,95,80,85,102,600,0.7637795275590551,1.0
50,35,55,25,25,15,205,0.021739130434782608,60,50,50,60,70,50,340,0.28346456692913385,2.0
60,50,40,85,75,95,405,0.7540983606557377,55,69,85,32,35,28,304,0.09302325581395349,1.0
65,105,60,60,70,95,455,63.0,79,103,120,135,115,78,630,0.5763888888888888,1.0
40,40,35,50,100,70,335,0.5031847133757962,105,150,90,150,90,95,680,0.8285714285714286,0.5
75,89,85,55,65,36,405,0.29545454545454547,55,55,85,65,85,35,380,0.2014388489208633,4.0
50,20,55,25,25,30,205,0.09774436090225563,75,69,72,114,100,104,534,0.8253968253968254,1.0
75,98,63,98,63,101,498,0.849624060150376,85,50,95,120,115,80,545,0.5793650793650794,1.0
70,55,65,95,85,70,440,0.5307692307692308,45,30,35,20,20,45,195,0.14782608695652175,2.0
130,70,35,70,35,60,400,0.4017857142857143,70,60,62,80,82,60,414,0.4375,1.0
60,105,60,120,60,105,510,0.8849557522123894,45,80,100,35,37,28,325,0.3125,2.0
65,130,60,75,60,75,465,0.689922480620155,59,110,150,45,49,35,448,0.3333333333333333,2.0
255,10,10,75,135,55,540,0.3125,91,72,90,129,90,108,580,0.8620689655172413,1.0
78,81,71,74,69,126,499,0.9090909090909091,80,100,200,50,100,50,580,0.3472222222222222,0.25
74,94,131,54,116,20,489,0.4485294117647059,90,75,85,115,90,55,510,0.3445378151260504,0.5
68,72,78,38,42,32,330,0.23809523809523808,35,35,35,35,35,35,210,0.13385826771653545,1.0
30,30,30,30,30,30,180,0.12612612612612611,95,109,105,75,85,56,525,0.34513274336283184,1.0
79,100,80,110,90,121,580,0.968,55,130,115,50,50,75,475,0.5982142857142857,1.0
55,55,45,63,45,45,308,0.25,60,48,45,43,90,42,328,0.21897810218978103,1.0
70,85,70,60,70,50,405,0.28378378378378377,70,80,70,80,70,110,480,0.6594202898550725,1.0
76,48,48,57,62,34,325,0.11688311688311688,60,40,80,60,45,40,325,0.23529411764705882,0.5
55,75,85,25,25,15,280,0.1875,68,72,78,38,42,32,330,0.23809523809523808,0.5
100,100,100,100,100,100,600,0.8805970149253731,95,124,78,69,71,58,495,0.37398373983739835,1.0
65,90,40,45,80,75,395,0.625,67,89,116,79,116,33,500,0.2624113475177305,0.0
77,85,51,55,51,65,384,0.5163934426229508,90,90,85,125,90,100,580,0.768595041322314,0.5
80,75,150,75,150,50,580,0.30973451327433627,50,95,180,85,45,70,525,0.5298507462686567,1.0
91,72,90,129,90,108,580,0.8925619834710744,60,90,70,60,120,40,440,0.27419354838709675,2.0
57,80,91,80,87,75,470,0.5737704918032787,123,77,72,99,92,58,521,0.4621212121212121,4.0
70,75,80,135,80,135,575,0.917910447761194,76,104,71,104,71,108,534,0.912751677852349,1.0
75,95,67,125,95,83,540,0.7117117117117117,30,40,55,40,55,60,280,0.3237410071942446,1.0
50,72,35,35,35,65,292,0.5373134328358209,50,75,45,40,45,60,315,0.4380165289256198,0.5
42,52,67,39,56,50,306,0.2868217054263566,100,134,110,95,100,61,600,0.4057971014492754,2.0
50,120,53,35,110,87,455,0.640625,45,60,32,50,32,76,295,0.5925925925925926,1.0
75,75,130,75,130,95,580,0.7479674796747967,45,75,37,70,55,83,365,0.6183206106870229,1.0
70,90,110,60,75,95,500,0.7333333333333333,100,100,80,60,60,50,450,0.3050847457627119,0.5
45,20,50,60,120,50,345,0.24074074074074073,40,45,35,40,40,90,290,0.65,1.0
75,70,90,70,105,80,490,0.656,115,140,130,55,55,40,535,0.4519230769230769,0.5
35,65,35,65,35,65,300,0.46621621621621623,60,45,70,75,85,55,390,0.3008130081300813,1.0
38,36,38,32,36,57,237,0.3893805309734513,85,90,80,70,80,130,535,0.9262295081967213,1.0
40,20,30,40,80,55,265,0.22764227642276422,74,48,76,83,81,104,466,0.7322834645669292,2.0
60,50,40,85,75,95,405,0.7540983606557377,100,123,75,57,75,80,510,0.6923076923076923,2.0
65,50,35,115,95,95,455,0.7333333333333333,45,50,43,40,38,62,278,0.40441176470588236,2.0
63,63,47,41,41,74,329,0.56,63,60,55,50,50,71,349,0.5289256198347108,1.0
50,75,45,40,45,60,315,0.4380165289256198,65,155,120,65,90,105,600,0.8677685950413223,0.5
103,60,86,60,86,50,445,0.3458646616541353,72,58,80,103,80,97,490,0.7171052631578947,1.0
71,82,64,64,59,112,452,0.9327731092436975,68,65,65,125,115,80,518,0.6461538461538462,1.0
100,180,160,150,90,90,770,0.7520661157024794,120,100,85,30,85,45,465,0.22448979591836735,1.0
61,78,95,56,58,57,405,0.40336134453781514,50,92,108,92,108,35,485,0.2457627118644068,1.0
40,30,32,50,52,65,269,0.3671875,40,70,130,60,130,25,455,0.17355371900826447,0.5
50,95,180,85,45,70,525,0.5298507462686567,60,75,85,100,85,115,520,0.8992248062015504,0.25
60,80,50,40,40,30,300,0.15328467153284672,80,82,78,95,80,85,500,0.6869565217391305,1.0
105,140,55,30,55,95,480,0.8195488721804511,60,60,60,35,35,30,280,0.11194029850746269,1.0
50,80,95,10,45,10,290,0.232,75,75,75,125,95,40,485,0.15671641791044777,1.0
65,130,60,75,60,75,465,0.689922480620155,50,85,125,85,115,20,480,0.4306569343065693,1.0
91,90,106,130,106,77,600,0.648854961832061,75,95,122,58,75,69,494,0.5725806451612904,2.0
100,50,50,76,96,70,442,0.5,80,135,85,70,95,150,615,0.9844961240310077,0.25
103,60,126,80,126,50,545,0.36363636363636365,65,70,60,65,65,115,440,0.8583333333333333,1.0
45,30,35,20,20,45,195,0.14782608695652175,60,30,30,36,56,50,262,0.32432432432432434,0.5
100,77,77,128,128,90,600,0.6901408450704225,44,75,35,63,33,45,295,0.2647058823529412,0.0
50,72,35,35,35,65,292,0.5373134328358209,130,65,60,110,95,65,525,0.5227272727272727,1.0
80,90,80,130,110,110,600,0.856,50,95,95,35,110,70,455,0.5179856115107914,1.0
99,68,83,72,87,51,460,0.417910447761194,60,80,50,40,40,30,300,0.15328467153284672,1.0
65,95,75,55,55,85,430,0.6933333333333334,57,80,91,80,87,75,470,0.5737704918032787,0.0
45,75,60,40,30,50,300,0.304,60,75,85,100,85,115,520,0.8992248062015504,1.0
55,84,105,114,75,52,485,0.2890625,60,80,50,40,40,30,300,0.15328467153284672,1.0
44,38,33,61,43,70,289,0.5267857142857143,85,120,70,50,60,100,485,0.8308823529411765,2.0
70,45,48,60,65,35,323,0.15748031496062992,52,65,55,58,62,60,352,0.4482758620689655,1.0
41,56,40,62,44,71,314,0.568,70,75,80,135,80,135,575,0.917910447761194,1.0
60,75,100,55,80,50,420,0.3088235294117647,70,80,65,90,65,85,455,0.578125,0.5
45,100,45,45,45,10,290,0.2949640287769784,45,75,60,40,30,50,300,0.304,1.0
105,95,80,40,80,90,490,0.753968253968254,110,65,105,55,95,80,510,0.6258503401360545,1.0
45,75,60,40,30,50,300,0.304,30,40,55,40,55,60,280,0.3237410071942446,1.0
69,55,45,55,55,15,294,0.11666666666666667,97,165,60,65,50,58,495,0.3902439024390244,1.0
110,78,73,76,71,60,468,0.3333333333333333,73,95,62,85,65,85,465,0.6666666666666666,1.0
110,130,80,70,60,80,530,0.5862068965517241,60,100,115,70,85,90,520,0.7557251908396947,1.0
68,65,65,125,115,80,518,0.6461538461538462,60,40,60,40,60,35,295,0.18055555555555555,1.0
70,150,140,65,100,75,600,0.55,85,100,122,58,75,54,494,0.3939393939393939,1.0
45,50,55,75,65,30,320,0.06293706293706294,37,25,41,25,41,25,194,0.08870967741935484,0.5
39,52,43,60,50,65,309,0.49107142857142855,40,45,40,65,40,65,295,0.5661764705882353,1.0
100,77,77,128,128,90,600,0.6901408450704225,71,82,64,64,59,112,452,0.9327731092436975,1.0
61,90,45,50,50,160,456,0.9230769230769231,91,90,129,90,72,108,580,0.9140625,0.25
75,65,55,65,55,69,384,0.43548387096774194,80,45,65,90,110,80,470,0.5462962962962963,1.0
68,85,65,165,135,100,618,0.8083333333333333,80,145,150,105,110,110,700,0.8692307692307693,0.125
20,10,55,15,20,80,200,0.17985611510791366,85,105,55,85,50,115,495,0.9032258064516129,0.5
62,44,50,44,50,55,305,0.3629032258064516,100,100,100,100,100,100,600,0.8805970149253731,0.5
60,100,89,55,69,112,485,0.9298245614035088,76,104,71,104,71,108,534,0.912751677852349,0.25
55,65,95,95,45,85,440,0.6610169491525424,64,88,50,88,50,106,446,0.9111111111111111,1.0
60,40,60,95,60,55,370,0.4222222222222222,90,30,15,40,20,15,210,0.043478260869565216,0.0
85,105,55,85,50,115,495,0.9032258064516129,50,65,107,105,107,86,520,0.703125,1.0
78,84,78,109,85,100,534,0.8646616541353384,60,69,95,69,95,36,424,0.2608695652173913,4.0
60,55,50,40,55,45,305,0.22377622377622378,45,50,43,40,38,62,278,0.40441176470588236,0.5
65,75,70,95,70,95,470,0.7272727272727273,57,24,86,24,86,23,300,0.12727272727272726,0.125
75,95,125,45,75,95,510,0.8257575757575758,70,60,62,80,82,60,414,0.4375,0.0
50,53,48,53,48,64,316,0.358974358974359,55,40,85,80,105,40,405,0.23622047244094488,1.0
105,95,80,40,80,90,490,0.753968253968254,105,140,95,55,65,45,505,0.3,1.0
85,115,80,105,80,50,515,0.3063063063063063,35,85,45,35,35,75,310,0.6492537313432836,2.0
70,140,70,110,65,105,560,0.95,35,46,34,35,45,20,215,0.072,1.0
60,52,168,47,138,30,495,0.19834710743801653,50,48,43,46,41,60,288,0.47297297297297297,0.25
130,85,80,85,95,60,535,0.43884892086330934,64,165,75,93,83,75,555,0.6587301587301587,1.0
101,72,72,99,89,29,462,0.1937984496124031,55,70,45,70,50,60,350,0.45,0.5
65,90,50,85,45,55,390,0.371900826446281,100,50,80,60,80,50,420,0.34375,4.0
40,40,35,50,100,70,335,0.5031847133757962,80,85,95,30,30,25,345,0.2857142857142857,1.0
74,48,76,83,81,104,466,0.7913043478260869,80,135,130,95,90,70,600,0.5181818181818182,0.25
64,165,75,93,83,75,555,0.6587301587301587,20,15,20,10,55,80,200,0.2682926829268293,1.0
95,65,110,60,130,65,525,0.5275590551181102,70,62,67,55,55,56,365,0.38513513513513514,1.0
76,65,45,92,42,91,411,0.7449664429530202,60,67,85,77,75,116,480,0.8888888888888888,2.0
85,76,64,45,55,90,415,0.6739130434782609,64,78,52,78,52,81,405,0.6422764227642277,1.0
80,70,70,90,100,70,480,0.5609756097560976,50,30,55,65,55,20,275,0.13675213675213677,1.0
75,85,200,55,65,30,510,0.16778523489932887,60,50,50,60,70,50,340,0.28346456692913385,0.25
100,50,80,60,80,50,420,0.34375,65,80,65,35,65,60,370,0.38405797101449274,1.0
80,115,80,65,55,93,488,0.7846153846153846,65,76,84,54,96,105,480,0.9008264462809917,1.0
55,85,55,50,55,60,360,0.4233576642335766,40,29,45,29,45,36,224,0.14634146341463414,2.0
95,110,80,70,80,50,485,0.37209302325581395,65,90,40,45,80,75,395,0.625,1.0
45,30,15,85,65,65,305,0.36220472440944884,80,80,50,40,50,25,325,0.176056338028169,2.0
86,81,97,81,107,43,495,0.203125,44,38,33,61,43,70,289,0.5267857142857143,1.0
86,81,97,81,107,43,495,0.203125,78,70,61,50,61,100,420,0.8145161290322581,1.0
85,115,80,105,80,50,515,0.3063063063063063,68,75,53,83,113,60,452,0.45384615384615384,0.5
60,60,60,85,85,85,435,0.631578947368421,75,87,63,87,63,98,473,0.865546218487395,1.0
38,36,38,32,36,57,237,0.3893805309734513,50,47,50,57,50,65,319,0.463768115942029,1.0
89,145,90,105,80,91,600,0.8549618320610687,100,164,150,95,120,71,700,0.5645161290322581,1.0
55,35,50,55,110,85,390,0.6277372262773723,75,38,38,56,56,67,330,0.5263157894736842,0.5
40,50,90,30,55,65,330,0.44680851063829785,55,130,115,50,50,75,475,0.5982142857142857,1.0
45,63,37,65,55,95,360,0.8055555555555556,75,80,85,110,90,50,490,0.3548387096774194,0.5
50,30,55,65,55,20,275,0.13675213675213677,100,164,150,95,120,71,700,0.5645161290322581,0.25
40,45,40,65,40,65,295,0.5661764705882353,45,65,34,40,34,45,263,0.2589928057553957,0.5
100,128,90,77,77,128,600,0.959349593495935,80,120,80,120,80,100,580,0.8478260869565217,2.0
75,98,63,98,63,101,498,0.8091603053435115,86,92,88,68,75,73,482,0.6835443037974683,1.0
40,55,70,45,60,30,300,0.10619469026548672,85,60,65,135,105,100,550,0.7518248175182481,0.5
30,45,135,45,90,30,375,0.09285714285714286,90,93,55,70,55,55,418,0.3819444444444444,1.0
65,125,100,60,70,70,490,0.6099290780141844,65,70,60,65,65,115,440,0.8583333333333333,1.0
50,75,45,40,45,60,315,0.4380165289256198,75,80,55,25,35,35,305,0.18666666666666668,0.5
62,73,55,56,52,84,382,0.7244094488188977,75,89,85,55,65,36,405,0.29545454545454547,4.0
50,53,62,58,63,44,330,0.13709677419354838,60,70,50,100,50,65,395,0.5217391304347826,1.0
60,85,69,60,69,77,420,0.518796992481203,45,100,45,45,45,10,290,0.2949640287769784,1.0
35,65,35,65,35,65,300,0.46621621621621623,89,145,90,105,80,91,600,0.8549618320610687,2.0
60,50,50,60,70,50,340,0.28346456692913385,65,80,65,35,65,60,370,0.38405797101449274,1.0
86,76,86,116,56,95,515,0.7982456140350878,120,120,120,120,120,120,720,0.9344262295081968,1.0
78,130,111,130,85,100,634,0.8561151079136691,80,95,82,60,82,75,474,0.6,1.0
100,77,77,128,128,90,600,0.6901408450704225,52,65,55,58,62,60,352,0.4482758620689655,1.0
62,48,54,63,60,68,355,0.5178571428571429,110,85,95,80,95,50,515,0.2713178294573643,1.0
20,10,55,15,20,80,200,0.17985611510791366,190,33,58,33,58,33,405,0.13432835820895522,1.0
150,120,100,120,100,90,680,0.664179104477612,45,100,135,65,135,45,525,0.29411764705882354,2.0
70,80,102,80,102,40,474,0.2677165354330709,75,140,65,112,65,110,567,0.9140625,0.25
68,90,65,50,55,82,410,0.6165413533834586,82,80,86,85,75,72,480,0.6183206106870229,0.0
40,45,40,62,60,60,307,0.33884297520661155,90,70,80,70,95,70,475,0.5190839694656488,1.0
103,60,86,60,86,50,445,0.3458646616541353,71,95,85,110,95,79,535,0.664,1.0
45,25,50,25,25,35,205,0.13076923076923078,20,40,15,35,35,60,205,0.34285714285714286,1.0
58,109,112,48,48,109,484,0.8805970149253731,65,60,70,85,75,40,395,0.1796875,1.0
61,90,45,50,50,160,456,0.9230769230769231,100,180,160,150,90,90,770,0.7520661157024794,0.5
50,65,90,35,35,15,290,0.14678899082568808,74,94,131,54,116,20,489,0.4485294117647059,1.0
45,60,45,25,45,55,275,0.29,40,70,130,60,130,25,455,0.17355371900826447,0.0
108,170,115,120,95,92,700,0.7083333333333334,70,65,60,90,75,90,450,0.6571428571428571,1.0
65,150,60,115,60,115,565,0.935251798561151,95,117,80,65,70,92,519,0.8409090909090909,0.5
75,80,60,65,90,102,472,0.8625954198473282,44,58,44,58,44,61,309,0.41964285714285715,1.0
30,56,35,25,35,72,253,0.48148148148148145,61,72,57,55,55,65,365,0.3984375,1.0
55,75,85,25,25,15,280,0.1875,45,35,50,70,50,30,280,0.15753424657534246,1.0
103,60,126,80,126,50,545,0.36363636363636365,75,70,90,70,105,80,490,0.656,2.0
70,90,110,60,75,95,500,0.7333333333333333,45,45,35,20,30,20,195,0.07246376811594203,1.0
49,49,56,49,61,66,330,0.5190839694656488,60,60,60,105,105,105,495,0.848,1.0
40,55,99,40,79,47,360,0.26262626262626265,50,52,48,65,50,55,320,0.33098591549295775,1.0
38,41,40,50,65,65,299,0.4108527131782946,90,100,60,90,60,80,480,0.6422764227642277,2.0
105,180,100,180,100,115,780,0.9477611940298507,165,75,80,40,45,65,470,0.5151515151515151,1.0
45,67,60,35,50,63,320,0.5128205128205128,80,130,100,160,120,110,700,0.8981481481481481,0.5
77,85,51,55,51,65,384,0.5163934426229508,50,50,120,80,80,30,410,0.07258064516129033,0.5
65,150,60,115,60,115,565,0.935251798561151,44,75,35,63,33,45,295,0.2647058823529412,2.0
55,70,55,40,55,85,360,0.7073170731707317,65,80,80,59,63,58,405,0.4411764705882353,1.0
91,72,90,129,90,108,580,0.8925619834710744,60,55,145,75,150,40,525,0.2,8.0
51,65,65,80,75,59,395,0.4365079365079365,80,70,70,90,100,70,480,0.5609756097560976,1.0
61,78,95,56,58,57,405,0.40336134453781514,75,80,70,65,75,90,455,0.7578125,0.25
95,145,130,120,90,120,700,0.9398496240601504,71,95,85,110,95,79,535,0.664,1.0
65,73,55,47,75,85,400,0.6846846846846847,50,92,108,92,108,35,485,0.2457627118644068,1.0
45,40,60,40,75,50,310,0.2926829268292683,75,89,85,55,65,36,405,0.29545454545454547,2.0
72,58,80,103,80,97,490,0.7171052631578947,44,48,65,50,64,43,314,0.1623931623931624,1.0
70,92,65,80,55,98,460,0.8090909090909091,86,76,86,116,56,95,515,0.7982456140350878,1.0
55,50,40,40,40,75,300,0.5945945945945946,49,55,42,42,37,85,310,0.6068376068376068,1.0
44,58,44,58,44,61,309,0.41964285714285715,75,103,80,70,80,92,500,0.7933884297520661,4.0
75,103,80,70,80,92,500,0.7933884297520661,60,82,45,45,45,74,351,0.5752212389380531,4.0
78,70,61,50,61,100,420,0.8145161290322581,50,65,64,44,48,43,314,0.2196969696969697,1.0
90,65,65,40,40,15,315,0.19672131147540983,30,35,30,100,35,80,310,0.4765625,2.0
100,90,130,45,65,55,485,0.4253731343283582,70,60,75,110,75,90,480,0.7165354330708661,0.5
115,45,20,45,25,20,270,0.11538461538461539,50,65,90,35,35,15,290,0.14678899082568808,1.0
75,103,80,70,80,92,500,0.7933884297520661,74,108,133,83,65,32,495,0.32142857142857145,4.0
75,70,90,70,105,80,490,0.656,75,90,50,110,80,95,500,0.7985611510791367,1.0
58,64,58,80,65,80,405,0.609271523178808,80,100,200,50,100,50,580,0.3472222222222222,0.5
91,129,90,72,90,108,580,0.8536585365853658,75,123,67,95,85,95,540,0.7642276422764228,1.0
83,80,75,70,70,101,479,0.8615384615384616,80,95,82,60,82,75,474,0.6,1.0
90,92,87,75,85,76,505,0.5409836065573771,70,120,40,95,40,95,460,0.8106060606060606,1.0
104,91,63,91,73,68,490,0.5118110236220472,60,85,60,85,60,55,405,0.3673469387755102,1.0
70,140,230,60,80,50,630,0.32432432432432434,95,117,80,65,70,92,519,0.8409090909090909,1.0
30,45,135,45,90,30,375,0.09285714285714286,85,56,77,50,77,78,423,0.53125,0.5
100,128,90,77,77,128,600,0.959349593495935,73,115,60,60,60,90,458,0.6694915254237288,2.0
116,55,85,107,95,29,487,0.06818181818181818,70,55,95,95,110,65,490,0.48872180451127817,0.5
90,70,80,70,95,70,475,0.5190839694656488,53,54,53,37,46,45,288,0.3090909090909091,1.0
55,104,105,94,75,52,485,0.36363636363636365,45,50,55,75,65,30,320,0.06293706293706294,0.5
48,61,40,61,40,50,300,0.2543859649122807,70,60,70,87,78,85,450,0.6228070175438597,2.0
91,90,72,90,129,108,580,0.896,78,52,60,63,65,23,341,0.06015037593984962,0.5
77,59,50,67,63,46,362,0.23140495867768596,70,77,60,97,60,108,472,0.8394160583941606,2.0
70,94,50,94,50,66,424,0.48148148148148145,43,70,48,50,60,38,309,0.2391304347826087,2.0
60,80,50,50,50,40,330,0.23853211009174313,65,50,35,115,95,95,455,0.7333333333333333,1.0
105,125,100,60,100,100,590,0.8359375,50,95,90,95,90,180,600,0.9172413793103448,1.0
35,64,85,74,55,32,345,0.19827586206896552,78,81,71,74,69,126,499,0.9090909090909091,2.0
60,85,42,85,42,91,405,0.8227848101265823,75,98,63,98,63,101,498,0.889763779527559,1.0
50,50,50,50,50,50,300,0.30708661417322836,40,70,130,60,130,25,455,0.17355371900826447,1.0
60,150,50,150,50,60,520,0.5,54,66,70,44,55,46,335,0.4214876033057851,2.0
76,48,48,57,62,34,325,0.11688311688311688,30,30,30,30,30,30,180,0.12612612612612611,0.5
70,70,40,60,40,60,340,0.4247787610619469,100,50,50,76,96,70,442,0.5,0.5
40,45,65,100,120,90,460,0.5588235294117647,57,80,91,80,87,75,470,0.5737704918032787,0.25
50,70,50,50,50,40,310,0.16296296296296298,65,90,120,85,70,60,490,0.43410852713178294,1.0
65,75,90,97,123,44,494,0.1987179487179487,70,110,80,55,80,105,500,0.8794326241134752,1.0
84,86,88,111,101,60,530,0.4634146341463415,50,50,95,40,50,35,320,0.20279720279720279,2.0
126,131,95,131,98,99,680,0.8102189781021898,60,40,80,60,45,40,325,0.23529411764705882,4.0
115,115,85,90,75,100,580,0.8134328358208955,80,100,123,122,120,80,625,0.56,2.0
53,54,53,37,46,45,288,0.3090909090909091,55,81,60,50,70,97,413,0.7214285714285714,1.0
40,80,35,35,45,70,305,0.4661016949152542,65,95,100,60,50,50,420,0.34959349593495936,1.0
70,150,140,65,100,75,600,0.55,125,130,90,130,90,95,660,0.7734375,2.0
80,135,130,95,90,70,600,0.5181818181818182,40,40,35,50,100,70,335,0.5031847133757962,1.0
40,20,30,40,80,55,265,0.22764227642276422,106,130,90,110,154,90,680,0.719626168224299,0.25
75,110,110,110,105,80,590,0.656934306569343,35,35,35,35,35,35,210,0.13385826771653545,2.0
30,45,135,45,90,30,375,0.09285714285714286,40,40,40,70,40,20,250,0.032520325203252036,2.0
60,70,50,100,50,65,395,0.5217391304347826,70,60,70,87,78,85,450,0.6228070175438597,4.0
75,140,65,112,65,110,567,0.9140625,100,128,90,77,77,128,600,0.959349593495935,1.0
85,80,90,105,95,60,515,0.49074074074074076,70,65,65,55,55,70,380,0.5,1.0
50,35,55,25,25,15,205,0.05263157894736842,79,105,70,145,80,101,580,0.8608695652173913,0.5
70,110,75,145,85,145,630,0.9444444444444444,60,85,42,85,42,91,405,0.8227848101265823,0.5
80,120,79,95,79,70,523,0.5833333333333334,40,45,40,35,35,56,251,0.373015873015873,2.0
60,80,95,70,85,50,440,0.2231404958677686,70,77,60,97,60,108,472,0.8394160583941606,0.5
100,110,90,85,90,60,535,0.47794117647058826,85,120,70,50,60,100,485,0.8308823529411765,0.0
70,105,105,50,40,20,390,0.33587786259541985,105,130,120,45,45,40,485,0.4444444444444444,0.5
80,105,105,105,105,80,580,0.5939849624060151,60,65,80,170,95,130,600,0.8625954198473282,2.0
65,95,75,55,55,85,430,0.6933333333333334,50,50,40,50,40,64,294,0.45588235294117646,0.5
60,65,80,170,95,130,600,0.8625954198473282,68,65,65,125,115,80,518,0.6461538461538462,4.0
75,125,230,55,95,30,610,0.3448275862068966,75,95,122,58,75,69,494,0.5725806451612904,0.5
90,100,70,110,150,80,600,0.6037735849056604,123,77,72,99,92,58,521,0.4621212121212121,1.0
37,25,41,25,41,25,194,0.08870967741935484,30,80,90,55,45,55,355,0.4295774647887324,1.0
80,130,100,160,120,110,700,0.8981481481481481,110,65,105,55,95,80,510,0.6258503401360545,0.0
90,30,15,40,20,15,210,0.043478260869565216,70,55,55,80,60,45,365,0.2222222222222222,1.0
50,65,107,105,107,86,520,0.7272727272727273,30,65,100,45,25,40,305,0.1891891891891892,2.0
75,95,125,45,75,95,510,0.8257575757575758,50,50,150,50,150,50,500,0.2571428571428571,1.0
50,120,53,35,110,87,455,0.640625,67,89,116,79,116,33,500,0.2624113475177305,1.0
75,95,125,45,75,95,510,0.8257575757575758,50,120,53,35,110,87,455,0.640625,2.0
80,120,130,55,65,45,495,0.37037037037037035,45,45,55,45,55,63,308,0.4594594594594595,0.5
65,65,60,130,95,110,525,0.823943661971831,45,60,30,80,50,65,330,0.4603174603174603,0.0
70,83,50,37,50,60,350,0.3360655737704918,60,62,80,63,80,60,405,0.4336283185840708,2.0
40,45,40,65,40,65,295,0.5661764705882353,40,55,99,40,79,47,360,0.26262626262626265,1.0
53,51,53,61,56,40,314,0.14285714285714285,45,45,55,45,55,63,308,0.4594594594594595,0.5
100,100,100,100,100,100,600,0.8805970149253731,38,35,35,65,55,50,278,0.2647058823529412,1.0
40,30,35,45,40,55,245,0.31496062992125984,50,180,20,180,20,150,600,0.9029850746268657,1.0
55,45,43,55,43,72,313,0.5853658536585366,55,35,50,55,110,85,390,0.6277372262773723,2.0
48,72,48,72,48,48,336,0.25984251968503935,75,75,60,83,60,60,413,0.39344262295081966,1.0
75,80,70,65,75,90,455,0.7578125,35,40,100,90,55,35,355,0.1796875,0.25
45,49,49,65,65,45,318,0.2781954887218045,40,45,40,65,40,65,295,0.5661764705882353,1.0
80,110,120,130,90,70,600,0.6198347107438017,40,80,35,35,45,70,305,0.4661016949152542,1.0
55,20,35,20,45,75,250,0.37681159420289856,65,75,90,97,123,44,494,0.1987179487179487,1.0
60,40,60,40,60,35,295,0.18055555555555555,125,170,100,120,90,95,700,0.77,0.5
50,70,160,70,160,90,600,0.7417218543046358,100,100,125,110,50,50,535,0.384,1.0
45,85,50,55,50,65,350,0.5076923076923077,115,140,130,55,55,40,535,0.4519230769230769,2.0
45,53,70,40,60,42,310,0.25735294117647056,110,130,80,70,60,80,530,0.5862068965517241,2.0
55,45,45,25,25,15,210,0.048,60,65,80,170,95,130,600,0.8625954198473282,2.0
80,160,60,170,130,80,680,0.6180555555555556,65,83,57,95,85,105,490,0.8914728682170543,1.0
50,120,53,35,110,87,455,0.640625,80,110,60,150,130,70,600,0.5042016806722689,0.0
20,25,45,70,90,60,310,0.30833333333333335,65,125,100,60,70,70,490,0.6099290780141844,0.0
130,85,80,85,95,60,535,0.43884892086330934,60,59,85,79,105,36,424,0.16666666666666666,1.0
75,80,60,65,90,102,472,0.8625954198473282,70,75,80,135,80,135,575,0.917910447761194,1.0
105,125,100,60,100,100,590,0.8359375,70,100,115,30,65,30,410,0.24390243902439024,0.5
40,45,35,65,55,70,310,0.4482758620689655,58,109,112,48,48,109,484,0.8805970149253731,0.25
58,64,58,80,65,80,405,0.5423728813559322,65,125,100,55,70,85,500,0.6532258064516129,2.0
62,55,52,109,94,109,481,0.7833333333333333,38,35,35,65,55,50,278,0.2647058823529412,1.0
70,120,100,145,105,20,560,0.2824427480916031,55,75,50,40,40,80,340,0.6302521008403361,0.0
85,115,80,105,80,50,515,0.3063063063063063,60,150,50,150,50,60,520,0.5,1.0
79,100,80,110,90,121,580,0.968,65,90,115,45,115,58,488,0.5041322314049587,2.0
85,100,122,58,75,54,494,0.3939393939393939,51,65,65,80,75,59,395,0.4365079365079365,1.0
100,100,125,110,50,50,535,0.384,62,55,52,109,94,109,481,0.7833333333333333,1.0
75,90,140,60,60,40,465,0.3008130081300813,85,105,55,85,50,115,495,0.9032258064516129,0.5
78,130,111,130,85,100,634,0.8561151079136691,66,41,77,61,87,23,355,0.12096774193548387,1.0
95,80,105,40,70,100,490,0.8046875,101,72,72,99,89,29,462,0.1937984496124031,1.0
75,125,100,70,80,45,495,0.33035714285714285,79,85,60,55,60,71,410,0.60431654676259,1.0
60,100,115,70,85,90,520,0.7557251908396947,116,55,85,107,95,29,487,0.06818181818181818,1.0
35,65,35,65,35,65,300,0.46621621621621623,80,185,115,40,105,75,600,0.6230769230769231,1.0
66,117,70,40,50,67,410,0.4573643410852713,35,60,44,40,54,55,288,0.366412213740458,1.0
110,80,90,95,90,65,530,0.5033557046979866,65,83,57,95,85,105,490,0.8914728682170543,1.0
80,82,100,83,100,80,525,0.6821705426356589,70,45,48,60,65,35,323,0.15748031496062992,1.0
70,135,105,60,105,20,495,0.5806451612903226,43,30,55,40,65,97,330,0.6030534351145038,0.5
83,106,65,86,65,85,490,0.6640625,40,45,65,100,120,90,460,0.5588235294117647,0.5
83,80,80,135,80,121,579,0.9444444444444444,95,65,110,60,130,65,525,0.5275590551181102,1.0
64,88,50,88,50,106,446,0.9111111111111111,83,80,80,135,80,121,579,0.9444444444444444,1.0
50,50,77,95,77,91,440,0.5916666666666667,50,65,85,35,35,55,325,0.32575757575757575,1.0
79,103,120,135,115,78,630,0.5763888888888888,130,65,60,110,95,65,525,0.5227272727272727,0.5
91,90,72,90,129,108,580,0.896,60,100,115,70,85,90,520,0.7557251908396947,1.0
125,58,58,76,76,67,460,0.515625,78,52,60,63,65,23,341,0.06015037593984962,1.0
79,115,70,125,80,111,580,0.864,44,38,39,61,79,42,303,0.2251655629139073,1.0
80,80,50,40,50,25,325,0.176056338028169,65,80,65,35,65,60,370,0.38405797101449274,1.0
80,185,115,40,105,75,600,0.6230769230769231,75,98,63,98,63,101,498,0.8091603053435115,2.0
75,70,90,70,105,80,490,0.656,61,72,57,55,55,65,365,0.3984375,1.0
40,35,30,120,70,105,400,0.6692307692307692,70,77,60,97,60,108,472,0.8394160583941606,1.0
100,150,120,120,100,90,680,0.6493506493506493,45,75,37,70,55,83,365,0.6183206106870229,1.0
50,40,85,40,65,25,305,0.08870967741935484,45,55,45,65,45,75,330,0.5692307692307692,0.5
60,85,49,60,49,60,363,0.4444444444444444,109,66,84,81,99,32,471,0.2013888888888889,0.0
126,131,95,131,98,99,680,0.8102189781021898,67,58,57,81,67,101,431,0.8790322580645161,0.25
65,45,55,45,70,45,325,0.24369747899159663,75,75,95,75,95,113,528,0.9015151515151515,0.5
70,110,80,55,80,105,500,0.8794326241134752,80,92,65,65,80,68,450,0.4824561403508772,1.0
89,125,90,115,80,101,600,0.8725490196078431,50,60,60,60,60,30,320,0.11290322580645161,2.0
65,125,100,60,70,70,490,0.6099290780141844,38,35,35,65,55,50,278,0.2647058823529412,0.5
50,50,40,30,30,50,250,0.2781954887218045,50,50,95,40,50,35,320,0.20279720279720279,2.0
85,76,64,45,55,90,415,0.6739130434782609,44,38,33,61,43,70,289,0.5267857142857143,1.0
55,66,44,44,56,85,350,0.6888888888888889,70,55,65,95,85,70,440,0.5307692307692308,0.5
91,90,106,130,106,77,600,0.648854961832061,85,97,66,105,66,65,484,0.47107438016528924,0.25
38,35,40,27,25,35,200,0.08208955223880597,70,55,95,95,110,65,490,0.48872180451127817,2.0
35,55,40,45,40,60,275,0.35714285714285715,75,125,70,125,70,115,580,0.9037037037037037,1.0
95,124,78,69,71,58,495,0.37398373983739835,60,100,115,70,85,90,520,0.7557251908396947,2.0
50,45,45,35,35,50,260,0.23529411764705882,44,48,65,50,64,43,314,0.1623931623931624,1.0
40,45,35,30,40,55,245,0.3793103448275862,70,84,70,65,70,51,410,0.2949640287769784,0.125
40,35,30,120,70,105,400,0.6692307692307692,90,120,100,150,120,100,680,0.7718120805369127,1.0
31,45,90,30,30,40,266,0.21929824561403508,74,94,131,54,116,20,489,0.4485294117647059,1.0
83,80,80,135,80,121,579,0.9444444444444444,44,48,65,50,64,43,314,0.1623931623931624,1.0
110,65,105,55,95,80,510,0.6258503401360545,75,123,67,95,85,95,540,0.7642276422764228,0.5
70,75,80,135,80,135,575,0.917910447761194,38,41,40,50,65,65,299,0.4108527131782946,1.0
80,90,80,130,110,110,600,0.856,85,115,80,105,80,50,515,0.3063063063063063,1.0
100,100,100,100,100,100,600,0.8602941176470589,60,55,90,145,90,80,520,0.6071428571428571,0.5
38,35,35,65,55,50,278,0.2647058823529412,55,50,40,40,40,75,300,0.5945945945945946,1.0
66,41,77,61,87,23,355,0.12096774193548387,70,55,75,45,65,60,370,0.45901639344262296,1.0
50,75,75,65,65,50,380,0.4049586776859504,85,115,80,105,80,50,515,0.3063063063063063,1.0
45,49,49,65,65,45,318,0.2781954887218045,65,125,100,60,70,70,490,0.6099290780141844,0.0
65,80,80,59,63,58,405,0.4411764705882353,78,52,60,63,65,23,341,0.06015037593984962,1.0
30,80,90,55,45,55,355,0.4295774647887324,100,100,100,100,100,100,600,0.8805970149253731,0.5
70,75,80,135,80,135,575,0.917910447761194,55,130,115,50,50,75,475,0.5982142857142857,2.0
85,70,80,97,80,123,535,0.9304347826086956,70,120,40,95,40,95,460,0.8106060606060606,1.0
30,45,59,30,39,57,260,0.2803030303030303,46,87,60,30,40,57,320,0.37777777777777777,1.0
90,60,60,40,40,40,330,0.29545454545454547,74,100,72,90,72,46,454,0.24561403508771928,0.5
50,53,48,53,48,64,316,0.46153846153846156,60,50,150,50,150,60,520,0.5206611570247934,2.0
45,100,135,65,135,45,525,0.29411764705882354,80,100,70,50,60,45,405,0.25806451612903225,1.0
36,50,50,65,60,44,305,0.16363636363636364,60,50,150,50,150,60,520,0.5206611570247934,0.5
60,80,50,50,50,40,330,0.23853211009174313,90,120,100,150,120,100,680,0.7718120805369127,1.0
70,85,65,105,85,120,530,0.9262295081967213,60,60,40,65,45,35,305,0.15833333333333333,1.0
50,52,48,65,50,55,320,0.33098591549295775,80,160,80,130,80,100,630,0.8455284552845529,2.0
75,55,70,55,95,110,460,0.8444444444444444,84,86,88,111,101,60,530,0.4634146341463415,0.5
95,125,79,60,100,81,540,0.6165413533834586,80,82,100,83,100,80,525,0.6821705426356589,1.0
65,90,122,58,75,84,494,0.71875,40,45,35,65,55,70,310,0.4482758620689655,0.5
77,85,51,55,51,65,384,0.5163934426229508,39,52,43,60,50,65,309,0.5041322314049587,0.5
80,185,115,40,105,75,600,0.6230769230769231,62,73,55,56,52,84,382,0.7244094488188977,0.125
80,52,50,90,50,89,411,0.6666666666666666,78,92,75,74,63,118,500,0.8842975206611571,0.5
55,55,85,65,85,35,380,0.2014388489208633,90,75,75,90,100,70,500,0.5462184873949579,0.5
65,73,55,47,75,85,400,0.6846846846846847,70,100,70,105,75,40,460,0.23214285714285715,0.5
100,120,100,150,120,90,680,0.728,70,60,75,110,75,90,480,0.7165354330708661,2.0
82,80,86,85,75,72,480,0.6183206106870229,55,45,50,45,65,80,340,0.5546218487394958,1.0
60,50,50,60,70,50,340,0.28346456692913385,90,90,85,125,90,100,580,0.768595041322314,0.5
55,81,60,50,70,97,413,0.7214285714285714,70,62,67,55,55,56,365,0.38513513513513514,1.0
65,95,100,60,50,50,420,0.34959349593495936,73,76,75,81,100,100,505,0.8110236220472441,1.0
60,60,40,65,45,35,305,0.15833333333333333,30,40,70,70,25,60,295,0.41353383458646614,0.5
85,135,130,60,80,25,515,0.40540540540540543,75,125,75,30,75,85,465,0.625,0.5
55,55,45,63,45,45,308,0.25,106,110,90,154,90,130,680,0.926829268292683,1.0
105,130,120,45,45,40,485,0.4444444444444444,45,50,43,40,38,62,278,0.40441176470588236,0.0
58,50,145,95,105,30,483,0.2459016393442623,65,90,120,85,70,60,490,0.43410852713178294,1.0
70,55,95,95,110,65,490,0.48872180451127817,20,10,230,10,230,5,505,0.0,1.0
70,65,60,90,75,90,450,0.6571428571428571,50,70,160,70,160,90,600,0.7417218543046358,2.0
35,35,40,35,55,50,250,0.40336134453781514,65,60,110,130,95,65,525,0.47761194029850745,1.0
65,65,45,75,45,95,390,0.72,60,45,70,45,90,95,405,0.7304964539007093,0.5
135,85,40,40,85,5,390,0.6864406779661016,55,81,60,50,70,97,413,0.7214285714285714,1.0
58,89,77,45,45,48,362,0.3177570093457944,90,75,85,115,90,55,510,0.3445378151260504,1.0
95,85,85,65,65,35,430,0.2571428571428571,130,85,80,85,95,60,535,0.43884892086330934,0.5
65,47,55,73,75,85,400,0.65,45,63,37,65,55,95,360,0.8055555555555556,1.0
45,75,37,70,55,83,365,0.6183206106870229,40,45,40,65,40,65,295,0.5661764705882353,1.0
100,100,100,100,100,100,600,0.8345864661654135,108,130,95,80,85,102,600,0.7637795275590551,2.0
55,45,43,55,43,72,313,0.5853658536585366,80,105,65,60,75,130,515,0.9645390070921985,0.5
79,85,60,55,60,71,410,0.60431654676259,120,70,120,75,130,85,600,0.6694915254237288,1.0
100,75,115,90,115,85,580,0.6446280991735537,55,50,65,175,95,150,590,0.7818181818181819,1.0
100,100,90,150,140,90,670,0.71875,55,104,105,94,75,52,485,0.36363636363636365,0.5
50,65,107,105,107,86,520,0.703125,50,75,35,70,30,40,300,0.21296296296296297,1.0
80,75,150,75,150,50,580,0.30973451327433627,105,95,75,85,75,74,509,0.5714285714285714,0.5
70,92,65,80,55,98,460,0.8090909090909091,75,55,70,55,95,110,460,0.8444444444444444,0.5
108,170,115,120,95,92,700,0.7083333333333334,50,70,50,50,50,70,340,0.5645161290322581,2.0
74,100,72,90,72,46,454,0.24561403508771928,70,70,40,60,40,60,340,0.4247787610619469,0.5
50,80,95,10,45,10,290,0.232,150,80,44,90,54,80,498,0.625,2.0
80,80,80,55,55,90,440,0.6417910447761194,70,105,105,50,40,20,390,0.33587786259541985,0.5
55,55,85,65,85,35,380,0.2014388489208633,65,65,60,130,95,110,525,0.823943661971831,1.0
55,45,43,55,43,72,313,0.5853658536585366,30,40,55,40,55,60,280,0.3237410071942446,1.0
65,90,50,85,45,55,390,0.371900826446281,64,88,50,88,50,106,446,0.9111111111111111,1.0
40,27,60,37,50,66,280,0.36220472440944884,50,65,64,44,48,43,314,0.2196969696969697,2.0
35,55,40,45,40,60,275,0.35714285714285715,80,120,80,120,80,100,580,0.8478260869565217,1.0
38,35,40,27,25,35,200,0.08208955223880597,60,40,60,40,60,35,295,0.18055555555555555,2.0
103,93,67,71,61,84,479,0.7142857142857143,83,80,75,70,70,101,479,0.8615384615384616,1.0
42,52,67,39,56,50,306,0.2868217054263566,20,10,55,15,20,80,200,0.17985611510791366,0.5
95,70,73,95,90,60,483,0.3983739837398374,40,45,40,35,35,56,251,0.373015873015873,1.0
51,65,65,80,75,59,395,0.4365079365079365,105,150,90,150,90,95,680,0.8285714285714286,4.0
60,70,50,100,50,65,395,0.5217391304347826,61,90,45,50,50,160,456,0.9230769230769231,1.0
25,35,70,95,55,45,325,0.16783216783216784,44,58,44,58,44,61,309,0.41964285714285715,0.5
85,110,90,45,90,80,500,0.6206896551724138,25,35,70,95,55,45,325,0.16783216783216784,0.5
40,45,35,30,40,55,245,0.3793103448275862,45,30,35,20,20,45,195,0.14782608695652175,2.0
70,135,105,60,105,20,495,0.5806451612903226,70,110,80,55,80,105,500,0.8794326241134752,0.5
74,108,133,83,65,32,495,0.32142857142857145,61,72,57,55,55,65,365,0.3984375,1.0
45,95,50,40,50,75,355,0.54,40,30,32,50,52,65,269,0.3671875,2.0
100,50,50,76,96,70,442,0.5,67,57,55,77,55,114,425,0.8879310344827587,1.0
70,75,60,105,60,105,475,0.88,60,150,50,150,50,60,520,0.5,1.0
75,100,95,40,70,110,490,0.8717948717948718,75,95,122,58,75,69,494,0.5725806451612904,0.0
50,52,48,65,50,55,320,0.33098591549295775,65,125,100,60,70,70,490,0.6099290780141844,1.0
70,150,140,65,100,75,600,0.55,50,50,77,95,77,91,440,0.5916666666666667,0.25
65,100,70,80,80,105,500,0.8666666666666667,75,95,95,95,95,85,540,0.6470588235294118,0.25
30,40,55,40,55,60,280,0.3237410071942446,40,55,30,30,30,85,270,0.688,1.0
50,70,160,70,160,90,600,0.7417218543046358,60,70,50,100,50,65,395,0.5217391304347826,1.0
67,125,40,30,30,58,350,0.3431372549019608,78,84,78,109,85,100,534,0.8620689655172413,2.0
100,100,125,110,50,50,535,0.384,109,66,84,81,99,32,471,0.2013888888888889,2.0
90,95,105,165,110,45,610,0.2890625,80,100,200,50,100,50,580,0.3472222222222222,1.0
100,100,90,150,140,90,670,0.71875,50,65,107,105,107,86,520,0.7313432835820896,0.5
65,125,60,95,60,105,510,0.9236641221374046,80,82,100,83,100,80,525,0.6821705426356589,1.0
105,105,75,65,100,50,500,0.37593984962406013,71,120,95,120,95,99,600,0.8203125,0.0
100,50,50,76,96,70,442,0.5,43,80,65,50,35,35,308,0.14193548387096774,1.0
25,20,15,105,55,90,310,0.32407407407407407,70,130,100,55,80,65,500,0.608,0.5
30,35,30,100,35,80,310,0.4765625,55,104,105,94,75,52,485,0.36363636363636365,1.0
70,85,70,60,70,50,405,0.28378378378378377,70,85,65,105,85,120,530,0.9262295081967213,0.25
75,125,230,55,95,30,610,0.3448275862068966,45,53,70,40,60,42,310,0.25735294117647056,0.25
95,60,79,100,125,81,540,0.6201550387596899,50,50,50,50,50,50,300,0.30708661417322836,1.0
120,70,120,75,130,85,600,0.6694915254237288,65,150,60,115,60,115,565,0.935251798561151,0.0
70,85,65,105,85,120,530,0.9262295081967213,70,85,70,60,70,50,405,0.28378378378378377,4.0
115,140,130,55,55,40,535,0.4519230769230769,60,62,50,62,60,40,334,0.18181818181818182,1.0
70,50,30,95,135,105,485,0.8040540540540541,65,45,55,45,70,45,325,0.24369747899159663,0.5
91,90,106,130,106,77,600,0.648854961832061,42,52,67,39,56,50,306,0.2868217054263566,0.25
90,85,75,115,100,115,580,0.9381443298969072,62,55,52,109,94,109,481,0.7833333333333333,0.5
70,50,30,95,135,105,485,0.8040540540540541,80,145,150,105,110,110,700,0.8692307692307693,0.5
70,120,40,95,40,95,460,0.8106060606060606,60,95,80,60,80,30,405,0.19480519480519481,0.5
75,125,75,30,75,85,465,0.625,90,85,100,95,125,85,580,0.6834532374100719,1.0
50,75,45,40,45,60,315,0.4380165289256198,80,100,70,60,70,95,475,0.7416666666666667,2.0
50,65,107,105,107,86,520,0.7313432835820896,123,77,72,99,92,58,521,0.4621212121212121,2.0
100,5,5,15,65,30,220,0.07692307692307693,75,85,200,55,65,30,510,0.16778523489932887,0.5
108,170,115,120,95,92,700,0.7083333333333334,75,98,63,98,63,101,498,0.889763779527559,2.0
120,120,120,120,120,120,720,0.9344262295081968,65,155,120,65,90,105,600,0.8677685950413223,1.0
40,80,100,30,30,20,300,0.11851851851851852,40,60,40,40,40,30,250,0.0948905109489051,2.0
100,100,100,100,100,100,600,0.8345864661654135,50,35,55,25,25,15,205,0.021739130434782608,0.5
55,55,85,65,85,35,380,0.2014388489208633,60,45,50,90,80,70,395,0.625,4.0
108,170,115,120,95,92,700,0.7083333333333334,25,35,70,95,55,45,325,0.16783216783216784,2.0
50,120,53,35,110,87,455,0.640625,40,35,30,120,70,105,400,0.6692307692307692,0.5
60,150,50,150,50,60,520,0.5,45,30,50,55,65,45,290,0.208,2.0
25,20,15,105,55,90,310,0.32407407407407407,75,80,55,25,35,35,305,0.18666666666666668,1.0
45,40,60,40,75,50,310,0.2926829268292683,60,30,30,36,56,50,262,0.32432432432432434,1.0
54,45,47,75,98,52,371,0.39669421487603307,80,80,80,55,55,90,440,0.6417910447761194,1.0
95,109,105,75,85,56,525,0.34513274336283184,60,85,69,60,69,77,420,0.518796992481203,1.0
80,105,105,105,105,80,580,0.5939849624060151,68,165,95,65,115,110,618,0.8615384615384616,0.5
79,85,60,55,60,71,410,0.60431654676259,75,95,67,125,95,83,540,0.7117117117117117,2.0
42,52,67,39,56,50,306,0.2868217054263566,60,48,45,43,90,42,328,0.21897810218978103,1.0
68,75,53,83,113,60,452,0.45384615384615384,60,100,89,55,69,112,485,0.9298245614035088,1.0
65,75,105,35,65,85,430,0.6940298507462687,70,43,53,43,53,40,302,0.19090909090909092,2.0
30,80,90,55,45,55,355,0.4295774647887324,78,52,60,63,65,23,341,0.06015037593984962,1.0
100,134,110,95,100,61,600,0.4057971014492754,95,100,85,108,70,70,528,0.5652173913043478,1.0
60,105,60,120,60,105,510,0.8849557522123894,50,50,95,40,50,35,320,0.20279720279720279,1.0
60,105,60,120,60,105,510,0.8849557522123894,59,45,40,35,40,31,250,0.14285714285714285,1.0
54,78,103,53,45,22,355,0.23255813953488372,55,95,55,35,75,115,430,0.9380530973451328,2.0
105,140,95,55,65,45,505,0.3,65,63,45,45,45,45,308,0.2595419847328244,1.0
80,70,65,80,120,100,515,0.8034188034188035,75,95,125,45,75,95,510,0.8257575757575758,1.0
70,60,125,115,70,55,495,0.35507246376811596,50,35,55,25,25,15,205,0.021739130434782608,2.0
45,30,40,105,50,20,290,0.031007751937984496,60,59,85,79,105,36,424,0.16666666666666666,1.0
58,89,77,45,45,48,362,0.3177570093457944,95,65,65,110,130,60,525,0.4016393442622951,0.0
50,50,40,30,30,50,250,0.2781954887218045,55,40,85,80,105,40,405,0.23622047244094488,0.0
40,29,45,29,45,36,224,0.14634146341463414,120,120,120,120,120,120,720,0.9344262295081968,1.0
40,40,55,40,70,55,300,0.40939597315436244,55,55,85,65,85,35,380,0.2014388489208633,2.0
85,90,80,70,80,130,535,0.9262295081967213,78,104,78,159,115,100,634,0.8444444444444444,1.0
30,30,42,30,42,70,244,0.4230769230769231,35,35,40,35,55,50,250,0.40336134453781514,2.0
60,60,60,35,35,30,280,0.11194029850746269,70,85,70,60,70,50,405,0.28378378378378377,1.0
95,85,85,65,65,35,430,0.2571428571428571,80,110,120,130,90,70,600,0.6198347107438017,2.0
100,75,115,90,115,85,580,0.6446280991735537,90,95,95,70,90,70,510,0.5230769230769231,0.5
50,95,90,95,90,180,600,0.9172413793103448,55,55,45,63,45,45,308,0.25,1.0
37,25,41,25,41,25,194,0.08870967741935484,50,160,110,160,110,110,700,0.8854961832061069,0.5
70,85,65,105,85,120,530,0.9262295081967213,110,78,73,76,71,60,468,0.3333333333333333,4.0
75,110,110,110,105,80,590,0.656934306569343,60,100,85,80,85,100,510,0.7007874015748031,2.0
74,48,76,83,81,104,466,0.7322834645669292,100,50,80,60,80,50,420,0.34375,1.0
50,70,160,70,160,90,600,0.7417218543046358,63,120,85,90,55,55,468,0.2809917355371901,0.0
45,30,40,105,50,20,290,0.031007751937984496,45,45,55,45,55,63,308,0.4594594594594595,1.0
65,83,57,95,85,105,490,0.8914728682170543,54,66,70,44,55,46,335,0.4214876033057851,0.5
44,48,65,50,64,43,314,0.1623931623931624,50,50,40,30,30,50,250,0.2781954887218045,2.0
86,92,88,68,75,73,482,0.6835443037974683,51,65,65,80,75,59,395,0.4365079365079365,1.0
20,10,230,10,230,5,505,0.0,95,125,79,60,100,81,540,0.6165413533834586,1.0
60,150,50,150,50,60,520,0.5,40,65,40,80,40,65,330,0.5038167938931297,0.5
95,135,80,110,80,100,600,0.8248175182481752,70,62,67,55,55,56,365,0.38513513513513514,1.0
40,60,40,40,40,30,250,0.0948905109489051,50,105,125,55,95,50,480,0.375886524822695,0.0
55,40,50,65,85,40,335,0.3181818181818182,75,125,70,125,70,115,580,0.9037037037037037,2.0
190,33,58,33,58,33,405,0.13432835820895522,80,135,130,95,90,70,600,0.5181818181818182,0.25
74,108,133,83,65,32,495,0.32142857142857145,115,45,20,45,25,20,270,0.11538461538461539,1.0
74,48,76,83,81,104,466,0.7913043478260869,95,95,85,125,65,55,520,0.3894736842105263,0.5
68,125,65,65,115,80,518,0.6277372262773723,111,83,68,92,82,39,475,0.1774193548387097,2.0
38,36,38,32,36,57,237,0.3893805309734513,35,35,35,35,35,35,210,0.13385826771653545,1.0
49,66,70,44,55,51,335,0.4260869565217391,65,110,130,60,65,95,525,0.8278145695364238,0.5
60,130,80,60,60,70,460,0.5153846153846153,65,95,57,100,85,93,495,0.7441860465116279,0.5
68,75,53,83,113,60,452,0.45384615384615384,80,125,75,40,95,85,500,0.6911764705882353,1.0
50,95,90,95,90,180,600,0.9172413793103448,170,90,45,90,45,60,500,0.427536231884058,1.0
50,35,55,25,25,15,205,0.021739130434782608,95,75,80,100,110,30,490,0.24242424242424243,2.0
36,50,50,65,60,44,305,0.16363636363636364,80,82,78,95,80,85,500,0.6869565217391305,0.5
90,30,15,40,20,15,210,0.043478260869565216,75,75,75,125,95,40,485,0.15671641791044777,1.0
44,38,33,61,43,70,289,0.5267857142857143,65,40,70,80,140,70,465,0.5954198473282443,4.0
55,55,50,45,65,55,325,0.37373737373737376,30,80,90,55,45,55,355,0.4295774647887324,0.5
35,85,45,35,35,75,310,0.6492537313432836,50,100,150,100,150,50,600,0.37142857142857144,0.25
50,95,90,95,90,180,600,0.9172413793103448,83,80,75,70,70,101,479,0.8615384615384616,1.0
78,92,75,74,63,118,500,0.8842975206611571,45,35,45,62,53,35,275,0.11851851851851852,2.0
45,85,70,40,40,60,340,0.5229357798165137,50,100,150,100,150,50,600,0.37142857142857144,0.5
45,90,20,65,20,65,305,0.5116279069767442,95,75,110,100,80,30,490,0.15267175572519084,1.0
85,105,85,40,50,40,405,0.211864406779661,50,50,40,50,40,64,294,0.45588235294117646,1.0
65,65,65,50,50,90,385,0.72,150,120,100,120,100,90,680,0.664179104477612,0.5
65,75,70,95,70,95,470,0.7272727272727273,60,55,50,40,55,45,305,0.22377622377622378,4.0
125,58,58,76,76,67,460,0.515625,85,120,70,50,60,100,485,0.8308823529411765,2.0
65,150,60,115,60,115,565,0.935251798561151,65,155,120,65,90,105,600,0.8677685950413223,1.0
60,100,115,70,85,90,520,0.7557251908396947,45,53,70,40,60,42,310,0.25735294117647056,1.0
62,77,62,50,42,65,358,0.4838709677419355,40,45,35,30,40,55,245,0.3793103448275862,1.0
38,30,85,55,65,30,303,0.21428571428571427,90,120,100,150,120,100,680,0.7718120805369127,1.0
35,35,40,35,55,50,250,0.40336134453781514,30,45,55,70,55,85,340,0.5633802816901409,2.0
95,145,130,120,90,120,700,0.9398496240601504,45,35,45,62,53,35,275,0.11851851851851852,2.0
63,63,47,41,41,74,329,0.56,75,100,110,45,55,65,450,0.5333333333333333,0.5
125,130,90,130,90,95,660,0.7734375,80,80,80,80,80,80,480,0.5606060606060606,0.5
40,35,30,20,20,50,195,0.23423423423423423,69,55,45,55,55,15,294,0.11666666666666667,1.0
40,40,40,70,40,20,250,0.032520325203252036,100,90,130,45,65,55,485,0.4253731343283582,0.25
62,44,50,44,50,55,305,0.3629032258064516,60,100,115,70,85,90,520,0.7557251908396947,0.5
85,105,85,40,50,40,405,0.211864406779661,106,110,90,154,90,130,680,0.926829268292683,0.5
55,55,85,65,85,35,380,0.2014388489208633,40,45,40,65,40,65,295,0.5661764705882353,1.0
60,70,105,70,120,75,500,0.5983606557377049,20,40,15,35,35,60,205,0.34285714285714286,2.0
150,120,100,120,100,90,680,0.664179104477612,95,75,180,130,80,30,590,0.13793103448275862,2.0
75,95,125,45,75,95,510,0.8257575757575758,100,100,100,100,100,100,600,0.831858407079646,1.0
35,45,160,30,45,70,385,0.48148148148148145,65,50,70,95,80,65,425,0.4262295081967213,1.0
50,95,95,35,110,70,455,0.5179856115107914,40,45,35,30,40,55,245,0.3793103448275862,0.25
126,131,95,131,98,99,680,0.8102189781021898,75,75,95,75,95,113,528,0.9015151515151515,2.0
75,95,95,95,95,85,540,0.6470588235294118,95,110,95,40,95,55,490,0.40336134453781514,1.0
45,90,20,65,20,65,305,0.5116279069767442,60,67,85,77,75,116,480,0.8888888888888888,0.25
50,180,20,180,20,150,600,0.9029850746268657,50,20,55,25,25,30,205,0.09774436090225563,1.0
45,20,50,60,120,50,345,0.24074074074074073,90,55,75,60,75,30,385,0.13970588235294118,1.0
86,76,86,116,56,95,515,0.7982456140350878,55,50,45,135,95,120,500,0.7714285714285715,2.0
55,40,50,65,85,40,335,0.3181818181818182,45,50,55,75,65,30,320,0.06293706293706294,0.5
90,70,80,70,95,70,475,0.5190839694656488,45,63,37,65,55,95,360,0.8055555555555556,1.0
60,45,70,45,90,95,405,0.7304964539007093,80,125,75,40,95,85,500,0.6911764705882353,1.0
75,105,75,105,75,45,480,0.3274336283185841,105,150,90,150,90,95,680,0.8285714285714286,0.5
91,134,95,100,100,80,600,0.6304347826086957,110,80,90,95,90,65,530,0.5033557046979866,1.0
38,35,40,27,25,35,200,0.08208955223880597,10,55,25,35,45,95,265,0.5396825396825397,1.0
75,95,60,65,60,115,470,0.8778625954198473,65,65,60,110,95,130,525,0.9253731343283582,1.0
40,80,35,35,45,70,305,0.4661016949152542,64,115,65,83,63,65,455,0.5323741007194245,0.0
55,47,52,40,40,41,275,0.16806722689075632,75,89,85,55,65,36,405,0.29545454545454547,2.0
80,92,65,65,80,68,450,0.4824561403508772,45,63,37,65,55,95,360,0.8055555555555556,1.0
81,102,77,85,75,85,505,0.5642857142857143,55,55,55,85,55,30,335,0.1320754716981132,1.0
64,115,65,83,63,65,455,0.5323741007194245,65,80,80,59,63,58,405,0.4411764705882353,1.0
30,35,30,100,35,80,310,0.4765625,80,130,100,160,120,110,700,0.8981481481481481,2.0
68,75,53,83,113,60,452,0.45384615384615384,80,120,70,110,70,80,530,0.6422764227642277,1.0
80,50,100,100,200,50,580,0.2357142857142857,70,95,85,55,65,70,440,0.5,1.0
45,50,35,55,75,40,300,0.21367521367521367,106,130,90,110,154,90,680,0.719626168224299,1.0
106,150,70,194,120,140,780,0.952,35,20,65,40,65,20,245,0.02459016393442623,1.0
44,38,33,61,43,70,289,0.5267857142857143,75,95,122,58,75,69,494,0.5725806451612904,0.0
60,55,50,40,55,45,305,0.22377622377622378,60,115,105,65,70,80,495,0.7181818181818181,0.5
91,72,90,129,90,108,580,0.8620689655172413,50,75,75,65,65,50,380,0.4049586776859504,0.0
90,85,75,115,100,115,580,0.9381443298969072,64,115,65,83,63,65,455,0.5323741007194245,1.0
79,105,70,145,80,101,580,0.8608695652173913,70,85,140,85,70,20,470,0.272,1.0
104,91,63,91,73,68,490,0.5118110236220472,78,84,78,109,85,100,534,0.8646616541353384,1.0
95,23,48,23,48,23,260,0.046153846153846156,91,90,106,130,106,77,600,0.648854961832061,0.5
60,67,85,77,75,116,480,0.8888888888888888,65,80,80,59,63,58,405,0.4411764705882353,2.0
40,30,32,50,52,65,269,0.3671875,65,55,115,100,40,60,435,0.3798449612403101,1.0
61,90,45,50,50,160,456,0.9230769230769231,40,27,60,37,50,66,280,0.36220472440944884,2.0
30,45,59,30,39,57,260,0.2803030303030303,59,66,70,44,55,41,335,0.25190839694656486,1.0
83,80,75,70,70,101,479,0.8615384615384616,60,85,42,85,42,91,405,0.8227848101265823,1.0
100,180,160,150,90,90,770,0.7520661157024794,50,53,62,58,63,44,330,0.13709677419354838,0.5
60,150,50,150,50,60,520,0.5,75,55,70,55,95,110,460,0.8444444444444444,1.0
90,92,75,92,85,60,494,0.49586776859504134,80,160,80,130,80,100,630,0.8455284552845529,0.25
60,85,49,60,49,60,363,0.4444444444444444,67,89,116,79,116,33,500,0.2624113475177305,1.0
71,73,88,120,89,59,500,0.43537414965986393,55,70,45,70,50,60,350,0.45,2.0
85,60,65,135,105,100,550,0.7518248175182481,95,125,79,60,100,81,540,0.6165413533834586,0.25
65,83,57,95,85,105,490,0.8914728682170543,60,79,105,59,85,36,424,0.17054263565891473,0.0
54,63,52,83,56,97,405,0.7697841726618705,75,98,63,98,63,101,498,0.849624060150376,0.5
52,65,55,58,62,60,352,0.4482758620689655,35,60,44,40,54,55,288,0.366412213740458,1.0
54,45,47,75,98,52,371,0.39669421487603307,70,50,30,95,135,105,485,0.8040540540540541,1.0
75,100,66,60,66,115,482,0.918918918918919,67,125,40,30,30,58,350,0.3431372549019608,0.5
40,55,70,45,60,30,300,0.10619469026548672,75,80,85,110,90,50,490,0.3548387096774194,1.0
40,27,60,37,50,66,280,0.36220472440944884,85,110,76,65,82,56,474,0.3933333333333333,0.5
45,25,50,25,25,35,205,0.13076923076923078,100,128,90,77,77,128,600,0.959349593495935,0.5
25,35,70,95,55,45,325,0.16783216783216784,100,128,90,77,77,128,600,0.959349593495935,1.0
85,60,65,135,105,100,550,0.7518248175182481,80,80,90,110,130,110,600,0.8721804511278195,1.0
65,63,45,45,45,45,308,0.2595419847328244,70,55,55,80,60,45,365,0.2222222222222222,1.0
72,58,80,103,80,97,490,0.7171052631578947,43,70,48,50,60,38,309,0.2391304347826087,2.0
40,60,30,31,31,70,262,0.4492753623188406,59,59,58,90,70,73,409,0.5826086956521739,1.0
90,95,95,70,90,70,510,0.5230769230769231,76,147,90,60,70,97,540,0.8267716535433071,0.5
45,49,49,65,65,45,318,0.2781954887218045,60,80,95,70,85,50,440,0.2231404958677686,0.0
50,65,85,35,35,55,325,0.32575757575757575,85,110,76,65,82,56,474,0.3933333333333333,1.0
50,72,35,35,35,65,292,0.5373134328358209,85,60,65,135,105,100,550,0.7518248175182481,1.0
40,55,30,30,30,85,270,0.688,60,40,80,60,45,40,325,0.23529411764705882,2.0
55,70,40,60,40,40,305,0.26956521739130435,69,55,45,55,55,15,294,0.11666666666666667,2.0
68,165,95,65,115,110,618,0.8615384615384616,50,50,77,95,77,91,440,0.5916666666666667,0.0
40,30,35,45,40,55,245,0.31496062992125984,65,50,35,115,95,95,455,0.7333333333333333,1.0
62,77,62,50,42,65,358,0.4838709677419355,55,55,45,63,45,45,308,0.25,1.0
45,50,43,40,38,62,278,0.40441176470588236,135,85,40,40,85,5,390,0.6864406779661016,1.0
99,68,83,72,87,51,460,0.417910447761194,70,20,50,20,50,40,250,0.1557377049180328,2.0
75,89,85,55,65,36,405,0.29545454545454547,78,92,75,74,63,118,500,0.8842975206611571,0.5
90,100,60,90,60,80,480,0.6422764227642277,60,48,45,43,90,42,328,0.21897810218978103,2.0
86,81,97,81,107,43,495,0.203125,50,75,45,40,45,60,315,0.4380165289256198,1.0
75,80,95,90,100,50,490,0.2158273381294964,75,90,90,140,90,115,600,0.9481481481481482,0.5
84,71,43,71,43,48,360,0.25874125874125875,50,85,55,65,65,90,410,0.7478260869565218,1.0
45,55,39,35,39,42,255,0.18518518518518517,59,110,150,45,49,35,448,0.3333333333333333,0.0
60,110,70,60,60,100,460,0.8461538461538461,60,50,100,85,70,65,430,0.47580645161290325,1.0
120,100,85,30,85,45,465,0.22448979591836735,55,40,85,80,105,40,405,0.23622047244094488,0.25
40,45,40,62,60,60,307,0.33884297520661155,100,77,77,128,128,90,600,0.6901408450704225,1.0
71,73,88,120,89,59,500,0.43537414965986393,80,82,100,83,100,80,525,0.6821705426356589,0.5
70,85,70,60,70,50,405,0.28378378378378377,20,40,15,35,35,60,205,0.34285714285714286,2.0
90,30,15,40,20,15,210,0.043478260869565216,59,59,58,90,70,73,409,0.5826086956521739,0.5
50,48,43,46,41,60,288,0.47297297297297297,30,105,90,25,25,50,325,0.2773722627737226,0.5
48,61,40,61,40,50,300,0.2543859649122807,54,78,103,53,45,22,355,0.23255813953488372,1.0
55,40,50,65,85,40,335,0.3181818181818182,70,95,85,55,65,70,440,0.5,4.0
130,65,60,110,95,65,525,0.5227272727272727,57,80,91,80,87,75,470,0.5737704918032787,1.0
60,85,60,50,50,125,430,0.9090909090909091,59,74,50,35,50,35,303,0.3125,0.0
49,49,56,49,61,66,330,0.5190839694656488,45,55,39,35,39,42,255,0.18518518518518517,1.0
60,115,105,65,70,80,495,0.7181818181818181,45,30,40,105,50,20,290,0.031007751937984496,1.0
90,75,85,115,90,55,510,0.3445378151260504,65,90,122,58,75,84,494,0.71875,0.5
75,95,95,95,95,85,540,0.6470588235294118,65,155,120,65,90,105,600,0.8677685950413223,1.0
55,55,55,85,55,30,335,0.1320754716981132,65,70,60,65,65,115,440,0.8583333333333333,1.0
105,130,120,45,45,40,485,0.4444444444444444,35,55,35,30,30,35,220,0.23684210526315788,1.0
50,100,150,100,150,50,600,0.37142857142857144,55,55,45,63,45,45,308,0.25,1.0
77,59,50,67,63,46,362,0.23140495867768596,135,85,40,40,85,5,390,0.6864406779661016,1.0
65,75,90,97,123,44,494,0.1987179487179487,70,55,65,95,85,70,440,0.5307692307692308,0.5
50,50,40,50,40,64,294,0.45588235294117646,110,78,73,76,71,60,468,0.3333333333333333,1.0
55,35,50,55,110,85,390,0.6277372262773723,40,40,55,40,70,55,300,0.40939597315436244,2.0
80,52,50,90,50,89,411,0.6666666666666666,75,95,60,65,60,115,470,0.8778625954198473,1.0
69,69,76,69,86,91,460,0.6554621848739496,60,85,42,85,42,91,405,0.8227848101265823,1.0
75,95,122,58,75,69,494,0.5725806451612904,90,95,105,165,110,45,610,0.2890625,0.5
45,49,65,49,65,45,318,0.275,65,110,130,60,65,95,525,0.8278145695364238,0.5
72,105,115,54,86,68,500,0.5149253731343284,65,47,55,73,75,85,400,0.65,2.0
50,53,48,53,48,64,316,0.46153846153846156,65,125,100,55,70,85,500,0.6532258064516129,2.0
150,120,100,120,100,90,680,0.664179104477612,55,66,44,44,56,85,350,0.6888888888888889,0.0
45,90,20,65,20,65,305,0.5116279069767442,10,55,25,35,45,95,265,0.5396825396825397,2.0
35,64,85,74,55,32,345,0.19827586206896552,80,105,65,60,75,130,515,0.9645390070921985,2.0
95,80,105,40,70,100,490,0.8046875,65,80,140,40,70,70,465,0.5223880597014925,0.5
90,30,15,40,20,15,210,0.043478260869565216,104,91,63,91,73,68,490,0.5118110236220472,1.0
60,79,105,59,85,36,424,0.17054263565891473,40,45,40,35,35,56,251,0.373015873015873,0.0
55,85,122,58,75,99,494,0.8099173553719008,75,98,63,98,63,101,498,0.8091603053435115,0.5
55,85,55,50,55,60,360,0.4233576642335766,70,120,40,95,40,95,460,0.8106060606060606,1.0
49,55,42,42,37,85,310,0.6068376068376068,100,120,120,150,100,90,680,0.7880794701986755,0.5
50,75,45,40,45,60,315,0.4380165289256198,40,29,45,29,45,36,224,0.14634146341463414,1.0
58,64,58,80,65,80,405,0.609271523178808,65,90,50,85,45,55,390,0.371900826446281,2.0
30,56,35,25,35,72,253,0.48148148148148145,81,102,77,85,75,85,505,0.5642857142857143,1.0
100,100,100,100,100,100,600,0.8602941176470589,35,65,35,65,35,65,300,0.46621621621621623,2.0
55,75,85,25,25,15,280,0.1875,60,45,70,75,85,55,390,0.3008130081300813,1.0
75,103,80,70,80,92,500,0.7933884297520661,80,120,130,55,65,45,495,0.37037037037037035,4.0
60,40,60,95,60,55,370,0.4222222222222222,79,103,120,135,115,78,630,0.5763888888888888,0.5
100,100,90,150,140,90,670,0.71875,40,30,35,50,70,55,280,0.28205128205128205,0.5
90,92,87,75,85,76,505,0.5409836065573771,70,100,70,105,75,40,460,0.23214285714285715,1.0
84,71,43,71,43,48,360,0.25874125874125875,30,40,70,70,25,60,295,0.41353383458646614,1.0
90,132,105,132,105,30,594,0.4246575342465753,70,100,115,30,65,30,410,0.24390243902439024,2.0
105,140,55,30,55,95,480,0.8195488721804511,50,20,55,25,25,30,205,0.09774436090225563,2.0
65,85,70,75,70,40,405,0.203125,67,89,116,79,116,33,500,0.2624113475177305,1.0
60,85,69,65,79,80,438,0.576,170,90,45,90,45,60,500,0.427536231884058,1.0
50,65,90,35,35,15,290,0.14678899082568808,31,45,90,30,30,40,266,0.21929824561403508,1.0
90,100,60,90,60,80,480,0.6422764227642277,75,125,100,70,80,45,495,0.33035714285714285,1.0
100,103,75,120,75,127,600,0.940677966101695,126,131,95,131,98,99,680,0.8294573643410853,1.0
60,85,69,65,79,80,438,0.576,100,134,110,95,100,61,600,0.4057971014492754,0.5
55,55,45,63,45,45,308,0.25,90,65,65,40,40,15,315,0.19672131147540983,0.5
71,95,85,110,95,79,535,0.664,72,60,30,20,30,25,237,0.11570247933884298,1.0
80,70,40,100,60,145,495,0.921875,76,147,90,60,70,97,540,0.8267716535433071,1.0
55,70,45,70,50,60,350,0.45,60,115,105,65,70,80,495,0.7181818181818181,0.25
75,100,63,80,63,116,497,0.9345794392523364,60,85,49,60,49,60,363,0.4444444444444444,0.5
69,55,45,55,55,15,294,0.11666666666666667,20,10,55,15,20,80,200,0.17985611510791366,2.0
90,50,34,60,44,70,348,0.6283185840707964,50,53,62,58,63,44,330,0.13709677419354838,1.0
40,65,95,60,45,35,340,0.13986013986013987,85,105,55,85,50,115,495,0.9032258064516129,1.0
35,60,44,40,54,55,288,0.366412213740458,40,40,55,40,70,55,300,0.40939597315436244,0.5
50,53,48,53,48,64,316,0.46153846153846156,83,80,75,70,70,101,479,0.8615384615384616,1.0
57,80,91,80,87,75,470,0.5737704918032787,45,60,32,50,32,76,295,0.5925925925925926,0.5
120,120,120,120,120,120,720,0.9344262295081968,52,65,55,58,62,60,352,0.4482758620689655,1.0
75,103,80,70,80,92,500,0.7933884297520661,100,75,115,90,115,85,580,0.6446280991735537,2.0
65,125,60,95,60,105,510,0.9236641221374046,95,109,105,75,85,56,525,0.34513274336283184,1.0
70,110,80,55,80,105,500,0.8794326241134752,65,75,105,35,65,85,430,0.6940298507462687,0.5
50,65,107,105,107,86,520,0.7758620689655172,60,25,35,70,80,60,330,0.3076923076923077,1.0
50,55,50,36,30,43,264,0.2922077922077922,82,121,119,69,59,71,521,0.5394736842105263,0.25
80,100,123,122,120,80,625,0.56,55,69,85,32,35,28,304,0.09302325581395349,1.0
95,85,85,65,65,35,430,0.2571428571428571,90,100,60,90,60,80,480,0.6422764227642277,0.25
45,100,135,65,135,45,525,0.29411764705882354,75,125,75,30,75,85,465,0.625,1.0
60,105,60,120,60,105,510,0.8849557522123894,71,120,95,120,95,99,600,0.8203125,1.0
60,85,60,85,60,55,405,0.3673469387755102,39,52,43,60,50,65,309,0.49107142857142855,0.5
55,95,115,45,45,35,390,0.2116788321167883,70,80,102,80,102,40,474,0.2677165354330709,0.0
150,80,44,90,54,80,498,0.625,55,68,64,45,55,31,318,0.11666666666666667,2.0
20,40,15,35,35,60,205,0.34285714285714286,50,50,77,95,77,91,440,0.5916666666666667,0.5
52,65,50,45,50,38,300,0.27419354838709675,75,75,95,75,95,113,528,0.9015151515151515,1.0
60,90,140,50,50,40,430,0.2535211267605634,56,61,65,48,45,38,313,0.17567567567567569,1.0
75,125,70,125,70,115,580,0.9037037037037037,20,40,90,30,90,25,295,0.11363636363636363,1.0
69,55,45,55,55,15,294,0.11666666666666667,106,110,90,154,90,130,680,0.926829268292683,1.0
70,115,60,115,60,55,475,0.4647887323943662,50,75,75,65,65,50,380,0.4049586776859504,1.0
75,69,72,114,100,104,534,0.8253968253968254,100,150,90,180,160,90,770,0.7348484848484849,0.5
130,70,35,70,35,60,400,0.4017857142857143,103,60,86,60,86,50,445,0.3458646616541353,1.0
20,10,230,10,230,5,505,0.0,70,95,125,65,75,45,475,0.33613445378151263,2.0
65,75,70,95,70,95,470,0.7272727272727273,70,50,30,95,135,105,485,0.8040540540540541,1.0
50,53,48,53,48,64,316,0.46153846153846156,70,55,95,95,110,65,490,0.48872180451127817,1.0
108,100,121,81,95,95,600,0.7476635514018691,75,125,230,55,95,30,610,0.3448275862068966,1.0
43,70,48,50,60,38,309,0.2391304347826087,65,47,55,73,75,85,400,0.65,0.5
65,100,70,80,80,105,500,0.8666666666666667,60,90,140,50,50,40,430,0.2535211267605634,1.0
100,128,90,77,77,128,600,0.959349593495935,68,90,65,50,55,82,410,0.6165413533834586,1.0
60,45,70,45,90,95,405,0.7304964539007093,45,95,50,40,50,75,355,0.54,1.0
80,120,79,95,79,70,523,0.5833333333333334,100,100,100,100,100,100,600,0.8758169934640523,1.0
25,35,70,95,55,45,325,0.16783216783216784,30,56,35,25,35,72,253,0.48148148148148145,1.0
53,51,53,61,56,40,314,0.14285714285714285,65,130,60,75,60,75,465,0.689922480620155,1.0
70,110,75,145,85,145,630,0.9444444444444444,57,24,86,24,86,23,300,0.12727272727272726,0.25
70,55,95,95,110,65,490,0.48872180451127817,70,55,75,45,65,60,370,0.45901639344262296,0.0
90,120,100,150,120,100,680,0.7718120805369127,115,140,130,55,55,40,535,0.4519230769230769,4.0
45,85,50,55,50,65,350,0.5076923076923077,125,58,58,76,76,67,460,0.515625,1.0
65,90,50,85,45,55,390,0.371900826446281,90,70,80,70,95,70,475,0.5190839694656488,2.0
74,48,76,83,81,104,466,0.7322834645669292,60,75,100,55,80,50,420,0.3088235294117647,0.25
60,60,60,85,85,85,435,0.631578947368421,60,95,80,60,80,30,405,0.19480519480519481,1.0
50,160,110,160,110,110,700,0.8854961832061069,30,42,118,42,88,30,350,0.112,0.25
70,80,65,90,65,85,455,0.578125,60,48,45,43,90,42,328,0.21897810218978103,0.5
85,80,70,135,75,90,535,0.7006802721088435,40,60,40,40,40,30,250,0.0948905109489051,1.0
90,132,105,132,105,30,594,0.4246575342465753,100,100,125,110,50,50,535,0.384,1.0
45,20,50,60,120,50,345,0.24074074074074073,103,60,126,80,126,50,545,0.36363636363636365,1.0
125,170,100,120,90,95,700,0.77,50,70,50,50,50,40,310,0.16296296296296298,0.5
45,35,45,62,53,35,275,0.11851851851851852,46,57,40,40,40,50,273,0.25,0.5
75,95,67,125,95,83,540,0.7117117117117117,41,64,45,50,50,50,300,0.36752136752136755,0.5
40,60,30,31,31,70,262,0.4492753623188406,70,85,70,60,70,50,405,0.28378378378378377,1.0
90,75,75,90,100,70,500,0.5462184873949579,85,76,64,45,55,90,415,0.6739130434782609,1.0
60,65,60,130,75,110,500,0.7719298245614035,60,150,50,150,50,60,520,0.5,0.0
106,90,130,90,154,110,680,0.8699186991869918,60,70,65,125,105,90,515,0.6911764705882353,4.0
65,130,60,75,60,75,465,0.689922480620155,97,165,60,65,50,58,495,0.3902439024390244,1.0
80,70,40,100,60,145,495,0.921875,70,120,100,145,105,20,560,0.2824427480916031,0.5
30,30,30,30,30,30,180,0.12612612612612611,50,100,150,100,150,50,600,0.37142857142857144,2.0
80,50,100,100,200,50,580,0.2357142857142857,54,66,70,44,55,46,335,0.4214876033057851,2.0
30,40,55,40,55,60,280,0.3237410071942446,50,75,45,40,45,60,315,0.4380165289256198,0.5
110,123,65,100,65,65,528,0.5217391304347826,61,90,45,50,50,160,456,0.9230769230769231,0.5
90,100,60,90,60,80,480,0.6422764227642277,85,105,55,85,50,115,495,0.9032258064516129,2.0
45,22,60,27,30,29,213,0.07518796992481203,60,65,80,170,95,130,600,0.8625954198473282,0.25
80,92,65,65,80,68,450,0.4824561403508772,75,125,100,70,80,45,495,0.33035714285714285,2.0
90,120,75,60,60,45,450,0.29411764705882354,100,100,100,100,100,100,600,0.831858407079646,1.0
61,90,45,50,50,160,456,0.9230769230769231,95,100,85,108,70,70,528,0.5652173913043478,1.0
70,77,60,97,60,108,472,0.8394160583941606,70,84,70,65,70,51,410,0.2949640287769784,0.0
55,112,45,74,45,70,401,0.559322033898305,65,90,120,85,70,60,490,0.43410852713178294,1.0
67,125,40,30,30,58,350,0.3431372549019608,45,85,70,40,40,60,340,0.5229357798165137,0.5
100,150,140,100,90,90,670,0.7969924812030075,91,90,106,130,106,77,600,0.648854961832061,4.0
80,82,100,83,100,80,525,0.6821705426356589,80,135,130,95,90,70,600,0.5181818181818182,0.5
50,20,40,20,40,20,190,0.0962962962962963,70,115,60,115,60,55,475,0.4647887323943662,2.0
50,20,40,20,40,20,190,0.0962962962962963,50,75,35,70,30,40,300,0.21296296296296297,0.5
84,71,43,71,43,48,360,0.25874125874125875,45,60,45,25,45,55,275,0.29,1.0
52,65,55,58,62,60,352,0.4482758620689655,100,120,120,150,100,90,680,0.7880794701986755,0.25
38,35,40,27,25,35,200,0.08208955223880597,63,120,85,90,55,55,468,0.2809917355371901,2.0
58,89,77,45,45,48,362,0.3177570093457944,64,66,68,81,76,50,405,0.25190839694656486,1.0
59,59,58,90,70,73,409,0.5826086956521739,50,72,35,35,35,65,292,0.5373134328358209,1.0
79,85,60,55,60,71,410,0.60431654676259,150,100,120,100,120,90,680,0.6666666666666666,0.0
60,85,69,65,79,80,438,0.576,40,50,45,70,45,70,320,0.5517241379310345,1.0
58,64,58,80,65,80,405,0.609271523178808,50,95,95,35,110,70,455,0.5179856115107914,1.0
55,55,45,63,45,45,308,0.25,70,70,40,60,40,60,340,0.4247787610619469,0.5
55,35,50,55,110,85,390,0.6277372262773723,85,105,85,40,50,40,405,0.211864406779661,1.0
55,81,60,50,70,97,413,0.7214285714285714,70,40,50,55,50,25,290,0.061068702290076333,1.0
110,160,110,80,110,100,670,0.8591549295774648,50,65,90,35,35,15,290,0.14678899082568808,1.0
70,100,70,105,75,40,460,0.23214285714285715,45,63,37,65,55,95,360,0.8055555555555556,2.0
110,65,105,55,95,80,510,0.6258503401360545,75,95,67,125,95,83,540,0.7117117117117117,1.0
60,60,50,40,50,75,335,0.5882352941176471,35,46,34,35,45,20,215,0.072,1.0
75,65,55,65,55,69,384,0.43548387096774194,80,52,50,90,50,89,411,0.6666666666666666,0.0
40,65,95,60,45,35,340,0.13986013986013987,66,65,48,62,57,52,350,0.36220472440944884,2.0
45,30,50,55,65,45,290,0.208,105,140,55,30,55,95,480,0.8195488721804511,1.0
55,50,65,175,95,150,590,0.7818181818181819,25,20,15,105,55,90,310,0.32407407407407407,0.5
75,125,75,30,75,85,465,0.625,60,62,63,80,80,60,405,0.38016528925619836,0.5
45,55,45,65,45,75,330,0.5692307692307692,100,150,140,100,90,90,670,0.7969924812030075,2.0
80,50,100,100,200,50,580,0.2357142857142857,76,48,48,57,62,34,325,0.11688311688311688,0.5
65,73,55,47,75,85,400,0.6846846846846847,38,35,40,27,25,35,200,0.08208955223880597,1.0
110,85,95,80,95,50,515,0.2713178294573643,66,41,77,61,87,23,355,0.12096774193548387,0.5
90,95,105,165,110,45,610,0.2890625,65,60,70,85,75,40,395,0.1796875,1.0
65,45,55,45,70,45,325,0.24369747899159663,59,59,58,90,70,73,409,0.5826086956521739,2.0
70,120,65,45,85,125,510,0.9747899159663865,91,134,95,100,100,80,600,0.6304347826086957,4.0
84,86,88,111,101,60,530,0.4634146341463415,49,49,56,49,61,66,330,0.5190839694656488,0.25
40,80,100,30,30,20,300,0.11851851851851852,60,85,42,85,42,91,405,0.8227848101265823,0.0
80,45,65,90,110,80,470,0.5462962962962963,100,120,100,150,120,90,680,0.728,1.0
70,110,70,115,70,90,525,0.75,70,55,95,95,110,65,490,0.48872180451127817,0.5
55,63,90,50,80,42,380,0.21138211382113822,70,130,100,55,80,65,500,0.608,0.125
75,90,140,60,60,40,465,0.3008130081300813,45,55,39,35,39,42,255,0.18518518518518517,1.0
68,165,95,65,115,110,618,0.8615384615384616,90,55,75,60,75,30,385,0.13970588235294118,2.0
75,100,110,45,55,65,450,0.5333333333333333,40,40,35,50,100,70,335,0.5031847133757962,2.0
60,100,89,55,69,112,485,0.9298245614035088,43,30,55,40,65,97,330,0.6030534351145038,1.0
60,150,50,150,50,60,520,0.5,100,70,70,65,65,45,415,0.1897810218978102,0.0
50,50,150,50,150,50,500,0.2571428571428571,75,140,65,112,65,110,567,0.9140625,2.0
60,40,60,95,60,55,370,0.4222222222222222,65,83,57,95,85,105,490,0.8914728682170543,1.0
115,115,85,90,75,100,580,0.8134328358208955,65,95,57,100,85,93,495,0.7441860465116279,0.5
89,145,90,105,80,91,600,0.8549618320610687,44,38,33,61,43,70,289,0.5267857142857143,1.0
60,25,35,70,80,60,330,0.3076923076923077,80,82,100,83,100,80,525,0.6821705426356589,1.0
77,59,50,67,63,46,362,0.23140495867768596,100,100,100,100,100,100,600,0.8345864661654135,2.0
65,50,35,115,95,95,455,0.7333333333333333,75,69,72,114,100,104,534,0.8253968253968254,0.25
80,105,105,105,105,80,580,0.5939849624060151,50,85,125,85,115,20,480,0.4306569343065693,0.0
75,123,67,95,85,95,540,0.7642276422764228,50,52,48,65,50,55,320,0.33098591549295775,2.0
85,56,77,50,77,78,423,0.53125,70,70,70,70,70,70,420,0.5289256198347108,1.0
38,36,38,32,36,57,237,0.3893805309734513,35,85,45,35,35,75,310,0.6492537313432836,1.0
105,125,100,60,100,100,590,0.8359375,55,95,55,35,75,115,430,0.9380530973451328,1.0
40,65,40,80,40,65,330,0.5038167938931297,80,52,50,90,50,89,411,0.6666666666666666,1.0
70,85,65,105,85,120,530,0.9262295081967213,120,120,120,120,120,120,720,0.9344262295081968,1.0
75,125,70,125,70,115,580,0.9037037037037037,50,105,125,55,95,50,480,0.375886524822695,0.5
70,95,125,65,75,45,475,0.33613445378151263,59,45,40,35,40,31,250,0.14285714285714285,1.0
114,85,70,85,80,30,464,0.2066115702479339,75,110,110,110,105,80,590,0.656934306569343,1.0
90,85,100,95,125,85,580,0.6834532374100719,55,45,43,55,43,72,313,0.5853658536585366,2.0
35,46,34,35,45,20,215,0.072,55,55,50,45,65,55,325,0.37373737373737376,1.0
75,75,75,125,95,40,485,0.15671641791044777,10,55,25,35,45,95,265,0.5396825396825397,2.0
100,50,50,76,96,70,442,0.5,75,125,75,30,75,85,465,0.625,2.0
68,85,65,165,135,100,618,0.8083333333333333,60,45,70,45,90,95,405,0.7304964539007093,1.0
86,76,86,116,56,95,515,0.7982456140350878,50,75,70,35,70,48,348,0.29357798165137616,2.0
80,75,150,75,150,50,580,0.30973451327433627,45,30,50,55,65,45,290,0.208,1.0
68,65,65,125,115,80,518,0.6461538461538462,100,100,100,100,100,100,600,0.8602941176470589,1.0
100,150,120,120,100,90,680,0.6493506493506493,70,90,110,60,75,95,500,0.7333333333333333,1.0
75,75,95,75,95,113,528,0.9015151515151515,40,60,40,40,40,30,250,0.0948905109489051,0.25
50,35,55,25,25,15,205,0.05263157894736842,80,82,100,83,100,80,525,0.6821705426356589,2.0
49,55,42,42,37,85,310,0.6068376068376068,80,135,130,95,90,70,600,0.5181818181818182,0.5
80,110,120,130,90,70,600,0.6198347107438017,90,85,100,95,125,85,580,0.6834532374100719,2.0
40,30,35,45,40,55,245,0.31496062992125984,90,100,70,110,150,80,600,0.6037735849056604,2.0
85,105,100,79,83,78,530,0.5869565217391305,35,60,44,40,54,55,288,0.366412213740458,1.0
38,36,38,32,36,57,237,0.3893805309734513,100,70,70,65,65,45,415,0.1897810218978102,1.0
45,60,32,50,32,76,295,0.5925925925925926,100,73,83,73,83,55,467,0.371900826446281,1.0
110,130,80,70,60,80,530,0.5862068965517241,57,80,91,80,87,75,470,0.5737704918032787,1.0
38,41,40,50,65,65,299,0.4108527131782946,65,76,84,54,96,105,480,0.9008264462809917,1.0
65,60,70,85,75,40,395,0.1796875,70,120,100,145,105,20,560,0.2824427480916031,1.0
50,75,35,70,30,40,300,0.21296296296296297,69,55,45,55,55,15,294,0.11666666666666667,0.25
55,75,85,25,25,15,280,0.1875,72,85,70,65,70,58,420,0.41304347826086957,1.0
106,150,70,194,120,140,780,0.952,60,67,85,77,75,116,480,0.8888888888888888,1.0
65,65,60,130,95,110,525,0.823943661971831,65,80,65,35,65,60,370,0.38405797101449274,1.0
85,90,80,70,80,130,535,0.9262295081967213,80,82,100,83,100,80,525,0.6821705426356589,4.0
61,72,57,55,55,65,365,0.3984375,60,50,40,85,75,95,405,0.7540983606557377,1.0
50,65,85,35,35,55,325,0.32575757575757575,125,130,90,130,90,95,660,0.7734375,2.0
60,25,35,70,80,60,330,0.3076923076923077,86,68,72,109,66,106,507,0.8099173553719008,1.0
84,71,43,71,43,48,360,0.25874125874125875,110,80,90,95,90,65,530,0.5033557046979866,1.0
70,110,80,55,80,105,500,0.8794326241134752,45,40,60,40,75,50,310,0.2926829268292683,0.5
75,110,110,110,105,80,590,0.656934306569343,35,55,40,45,40,60,275,0.35714285714285715,1.0
104,91,63,91,73,68,490,0.5118110236220472,75,75,60,83,60,60,413,0.39344262295081966,1.0
75,123,67,95,85,95,540,0.7642276422764228,35,64,85,74,55,32,345,0.19827586206896552,2.0
65,63,45,45,45,45,308,0.2595419847328244,60,65,70,85,75,40,395,0.21705426356589147,2.0
76,65,45,92,42,91,411,0.7449664429530202,50,65,85,35,35,55,325,0.32575757575757575,0.5
60,52,168,47,138,30,495,0.19834710743801653,110,160,110,80,110,100,670,0.8591549295774648,1.0
70,45,48,60,65,35,323,0.15748031496062992,80,70,65,80,120,100,515,0.8034188034188035,0.5
95,60,79,100,125,81,540,0.6201550387596899,59,74,50,35,50,35,303,0.3125,2.0
80,145,150,105,110,110,700,0.8692307692307693,75,100,66,60,66,115,482,0.918918918918919,1.0
79,105,70,145,80,101,580,0.8608695652173913,50,85,85,55,55,50,380,0.3902439024390244,0.5
85,135,130,60,80,25,515,0.40540540540540543,75,80,55,25,35,35,305,0.18666666666666668,0.5
75,90,140,60,60,40,465,0.3008130081300813,50,70,160,70,160,90,600,0.7417218543046358,2.0
68,90,65,50,55,82,410,0.6165413533834586,60,50,100,85,70,65,430,0.47580645161290325,0.0
103,93,67,71,61,84,479,0.7142857142857143,105,125,100,60,100,100,590,0.8359375,1.0
115,45,20,45,25,20,270,0.11538461538461539,78,65,68,112,154,75,552,0.628099173553719,1.0
95,75,80,100,110,30,490,0.24242424242424243,52,65,50,45,50,38,300,0.27419354838709675,0.0
75,110,110,110,105,80,590,0.656934306569343,45,60,45,25,45,55,275,0.29,1.0
70,110,75,145,85,145,630,0.9444444444444444,78,104,78,159,115,100,634,0.8444444444444444,0.25
65,95,57,100,85,93,495,0.7441860465116279,105,95,80,40,80,90,490,0.753968253968254,1.0
80,120,80,120,80,100,580,0.8478260869565217,45,53,70,40,60,42,310,0.25735294117647056,2.0
75,98,63,98,63,101,498,0.889763779527559,45,90,20,65,20,65,305,0.5116279069767442,0.5
61,72,57,55,55,65,365,0.3984375,135,85,40,40,85,5,390,0.6864406779661016,1.0
50,65,107,105,107,86,520,0.7313432835820896,120,100,85,30,85,45,465,0.22448979591836735,1.0
100,150,140,100,90,90,670,0.7969924812030075,31,45,90,30,30,40,266,0.21929824561403508,0.5
255,10,10,75,135,55,540,0.3125,65,40,70,80,140,70,465,0.5954198473282443,1.0
56,61,65,48,45,38,313,0.17567567567567569,100,100,90,150,140,90,670,0.71875,2.0
43,30,55,40,65,97,330,0.6030534351145038,100,100,100,100,100,100,600,0.8758169934640523,1.0
65,110,130,60,65,95,525,0.8278145695364238,70,94,50,94,50,66,424,0.48148148148148145,0.25
55,40,40,65,45,35,280,0.16428571428571428,42,52,67,39,56,50,306,0.2868217054263566,2.0
75,75,55,105,85,30,425,0.1619718309859155,70,90,45,15,45,50,315,0.3629032258064516,0.5
67,58,57,81,67,101,431,0.8790322580645161,95,75,180,130,80,30,590,0.13793103448275862,2.0
40,50,90,30,55,65,330,0.44680851063829785,73,76,75,81,100,100,505,0.8110236220472441,0.5
60,79,105,59,85,36,424,0.17054263565891473,95,110,80,70,80,50,485,0.37209302325581395,1.0
64,115,65,83,63,65,455,0.5323741007194245,91,90,72,90,129,108,580,0.896,1.0
70,130,100,55,80,65,500,0.608,89,145,90,105,80,91,600,0.8549618320610687,0.5
50,20,40,20,40,20,190,0.0962962962962963,52,65,50,45,50,38,300,0.27419354838709675,4.0
89,145,90,105,80,91,600,0.8549618320610687,45,60,45,25,45,55,275,0.29,1.0
65,55,115,100,40,60,435,0.3798449612403101,75,125,75,30,75,85,465,0.625,1.0
25,35,70,95,55,45,325,0.16783216783216784,60,50,50,60,70,50,340,0.28346456692913385,0.5
80,75,150,75,150,50,580,0.30973451327433627,70,85,65,105,85,120,530,0.9262295081967213,1.0
85,70,80,97,80,123,535,0.9304347826086956,45,50,35,55,75,40,300,0.21367521367521367,2.0
50,50,150,50,150,50,500,0.2571428571428571,30,40,55,40,55,60,280,0.3237410071942446,1.0
68,85,65,165,135,100,618,0.8083333333333333,130,85,80,85,95,60,535,0.43884892086330934,1.0
97,165,60,65,50,58,495,0.3902439024390244,38,30,85,55,65,30,303,0.21428571428571427,1.0
77,59,50,67,63,46,362,0.23140495867768596,40,45,40,35,35,56,251,0.373015873015873,4.0
50,53,48,53,48,64,316,0.358974358974359,50,65,45,85,65,95,405,0.7238095238095238,0.5
190,33,58,33,58,33,405,0.13432835820895522,70,85,65,105,85,120,530,0.9262295081967213,1.0
38,30,85,55,65,30,303,0.21428571428571427,50,70,50,50,50,70,340,0.5645161290322581,1.0
67,125,40,30,30,58,350,0.3431372549019608,40,45,65,100,120,90,460,0.5588235294117647,1.0
95,65,65,110,130,60,525,0.4016393442622951,75,98,63,98,63,101,498,0.889763779527559,0.5
86,92,88,68,75,73,482,0.6835443037974683,60,59,85,79,105,36,424,0.16666666666666666,1.0
99,68,83,72,87,51,460,0.417910447761194,30,35,30,100,35,80,310,0.4765625,0.5
70,84,70,65,70,51,410,0.2949640287769784,40,60,40,40,40,30,250,0.0948905109489051,2.0
40,30,30,40,50,30,220,0.07936507936507936,35,65,35,65,35,65,300,0.46621621621621623,1.0
45,60,45,25,45,55,275,0.29,65,130,60,75,60,75,465,0.689922480620155,1.0
58,64,58,80,65,80,405,0.609271523178808,95,65,110,60,130,65,525,0.5275590551181102,1.0
90,85,75,115,100,115,580,0.9381443298969072,50,50,40,30,30,50,250,0.2781954887218045,0.0
50,64,50,45,50,41,300,0.22727272727272727,100,123,75,57,75,80,510,0.6923076923076923,0.0
65,76,84,54,96,105,480,0.9008264462809917,75,90,140,60,60,40,465,0.3008130081300813,0.5
60,79,105,59,85,36,424,0.17054263565891473,95,60,79,100,125,81,540,0.6201550387596899,1.0
45,60,40,70,50,45,310,0.2846715328467153,95,65,110,60,130,65,525,0.5275590551181102,1.0
68,165,95,65,115,110,618,0.8615384615384616,53,51,53,61,56,40,314,0.14285714285714285,1.0
55,68,64,45,55,31,318,0.11666666666666667,40,30,35,45,40,55,245,0.31496062992125984,0.25
104,91,63,91,73,68,490,0.5118110236220472,75,95,60,65,60,115,470,0.8778625954198473,1.0
75,105,75,105,75,45,480,0.3274336283185841,40,30,50,55,55,100,330,0.584070796460177,1.0
58,64,58,80,65,80,405,0.609271523178808,70,80,65,90,65,85,455,0.578125,1.0
70,55,55,80,60,45,365,0.2222222222222222,76,147,90,60,70,97,540,0.8267716535433071,0.5
35,55,40,45,40,60,275,0.35714285714285715,68,165,95,65,115,110,618,0.8615384615384616,1.0
54,66,70,44,55,46,335,0.4214876033057851,53,51,53,61,56,40,314,0.14285714285714285,2.0
130,85,80,85,95,60,535,0.43884892086330934,103,60,86,60,86,50,445,0.3458646616541353,1.0
55,45,43,55,43,72,313,0.5853658536585366,63,63,47,41,41,74,329,0.56,0.0
80,70,40,100,60,145,495,0.921875,30,40,55,40,55,60,280,0.3237410071942446,1.0
70,85,140,85,70,20,470,0.272,44,58,44,58,44,61,309,0.41964285714285715,0.5
50,30,55,65,55,20,275,0.13675213675213677,45,50,43,40,38,62,278,0.40441176470588236,0.0
50,60,60,60,60,30,320,0.11290322580645161,90,100,70,110,150,80,600,0.6037735849056604,0.5
45,65,34,40,34,45,263,0.2589928057553957,76,104,71,104,71,108,534,0.912751677852349,1.0
55,85,55,50,55,60,360,0.4233576642335766,35,35,40,35,55,50,250,0.40336134453781514,2.0
90,132,105,132,105,30,594,0.4246575342465753,41,50,37,50,37,66,281,0.5175438596491229,1.0
65,155,120,65,90,105,600,0.8677685950413223,85,97,66,105,66,65,484,0.47107438016528924,0.5
92,105,90,125,90,98,600,0.8217054263565892,79,85,60,55,60,71,410,0.60431654676259,1.0
62,50,58,73,54,72,369,0.4435483870967742,68,72,78,38,42,32,330,0.23809523809523808,1.0
35,35,35,35,35,35,210,0.13385826771653545,10,55,25,35,45,95,265,0.5396825396825397,1.0
78,84,78,109,85,100,534,0.8646616541353384,35,60,44,40,54,55,288,0.366412213740458,1.0
55,104,105,94,75,52,485,0.36363636363636365,31,45,90,30,30,40,266,0.21929824561403508,2.0
50,30,55,65,55,20,275,0.13675213675213677,85,90,80,70,80,130,535,0.9262295081967213,1.0
90,100,70,110,150,80,600,0.6037735849056604,50,75,35,70,30,40,300,0.21296296296296297,1.0
90,65,65,40,40,15,315,0.19672131147540983,60,85,40,30,45,68,328,0.6422018348623854,4.0
59,63,80,65,80,58,405,0.41843971631205673,65,65,60,130,95,110,525,0.823943661971831,1.0
110,80,90,95,90,65,530,0.5033557046979866,70,60,125,115,70,55,495,0.35507246376811596,0.5
50,65,64,44,48,43,314,0.2196969696969697,55,95,55,35,75,115,430,0.9380530973451328,1.0
75,75,95,75,95,113,528,0.9015151515151515,105,105,75,65,100,50,500,0.37593984962406013,0.5
45,30,50,55,65,45,290,0.208,65,47,55,73,75,85,400,0.65,1.0
30,45,59,30,39,57,260,0.2803030303030303,70,90,70,60,60,70,420,0.6390977443609023,2.0
40,70,40,35,40,60,285,0.392,60,62,80,63,80,60,405,0.4336283185840708,1.0
30,30,30,30,30,30,180,0.12612612612612611,150,160,100,95,65,100,670,0.8866666666666667,1.0
50,40,85,40,65,25,305,0.08870967741935484,60,50,150,50,150,60,520,0.5206611570247934,0.25
65,65,45,75,45,95,390,0.72,85,60,65,135,105,100,550,0.7518248175182481,1.0
65,83,57,95,85,105,490,0.8914728682170543,70,80,50,35,35,35,305,0.14,1.0
50,53,62,58,63,44,330,0.13709677419354838,50,95,180,85,45,70,525,0.5298507462686567,0.5
60,85,60,85,60,55,405,0.3673469387755102,43,80,65,50,35,35,308,0.14193548387096774,0.5
90,60,70,75,70,45,410,0.23880597014925373,45,20,50,60,120,50,345,0.24074074074074073,0.5
67,58,57,81,67,101,431,0.8790322580645161,65,65,45,75,45,95,390,0.72,2.0
75,80,95,90,100,50,490,0.2158273381294964,90,100,60,90,60,80,480,0.6422764227642277,0.5
65,90,122,58,75,84,494,0.71875,53,51,53,61,56,40,314,0.14285714285714285,2.0
45,25,50,25,25,35,205,0.13076923076923078,70,140,70,110,65,105,560,0.95,2.0
55,20,35,20,45,75,250,0.37681159420289856,44,38,33,61,43,70,289,0.5267857142857143,1.0
64,51,23,51,23,28,240,0.11363636363636363,75,98,63,98,63,101,498,0.889763779527559,1.0
43,70,48,50,60,38,309,0.2391304347826087,45,100,45,45,45,10,290,0.2949640287769784,2.0
85,105,100,79,83,78,530,0.5869565217391305,70,62,67,55,55,56,365,0.38513513513513514,1.0
65,50,70,95,80,65,425,0.4262295081967213,50,70,50,50,50,70,340,0.5645161290322581,2.0
60,70,50,100,50,65,395,0.5217391304347826,78,92,75,74,63,118,500,0.8842975206611571,0.5
95,109,105,75,85,56,525,0.34513274336283184,115,45,20,45,25,20,270,0.11538461538461539,1.0
44,38,33,61,43,70,289,0.5267857142857143,86,81,97,81,107,43,495,0.203125,0.25
100,77,77,128,128,90,600,0.6901408450704225,64,165,75,93,83,75,555,0.6587301587301587,0.0
100,100,100,100,100,100,600,0.8758169934640523,50,105,79,35,110,76,455,0.6214285714285714,1.0
70,100,115,30,65,30,410,0.24390243902439024,150,160,100,95,65,100,670,0.8866666666666667,1.0
75,87,63,87,63,98,473,0.865546218487395,70,95,125,65,75,45,475,0.33613445378151263,2.0
80,160,80,130,80,100,630,0.8455284552845529,40,45,40,65,40,65,295,0.5661764705882353,1.0
109,66,84,81,99,32,471,0.2013888888888889,100,100,90,150,140,90,670,0.71875,2.0
70,110,180,60,60,50,530,0.4117647058823529,60,130,80,60,60,70,460,0.5153846153846153,0.5
40,30,35,50,70,55,280,0.28205128205128205,70,50,30,95,135,105,485,0.8040540540540541,1.0
60,70,65,125,105,90,515,0.6911764705882353,85,110,90,45,90,80,500,0.6206896551724138,1.0
75,103,80,70,80,92,500,0.7933884297520661,100,100,90,150,140,90,670,0.71875,2.0
55,50,45,135,95,120,500,0.7714285714285715,103,60,86,60,86,50,445,0.3458646616541353,1.0
20,40,90,30,90,25,295,0.11363636363636363,105,95,75,85,75,74,509,0.5714285714285714,1.0
80,100,70,50,60,45,405,0.25806451612903225,65,95,57,100,85,93,495,0.7441860465116279,1.0
79,115,70,125,80,111,580,0.8468468468468469,110,160,110,80,110,100,670,0.8591549295774648,1.0
40,30,35,45,40,55,245,0.31496062992125984,65,75,70,95,70,95,470,0.7272727272727273,1.0
45,49,65,49,65,45,318,0.275,58,50,145,95,105,30,483,0.2459016393442623,1.0
60,85,49,60,49,60,363,0.4444444444444444,65,90,50,85,45,55,390,0.371900826446281,0.5
60,55,145,75,150,40,525,0.2,70,70,115,130,90,60,535,0.5338983050847458,0.125
100,123,75,57,75,80,510,0.6923076923076923,85,105,85,40,50,40,405,0.211864406779661,2.0
65,95,100,60,50,50,420,0.34959349593495936,65,95,75,55,55,85,430,0.6933333333333334,1.0
85,105,55,85,50,115,495,0.9032258064516129,65,60,70,85,75,40,395,0.1796875,1.0
83,106,65,86,65,85,490,0.6640625,62,48,54,63,60,68,355,0.5178571428571429,0.5
126,131,95,131,98,99,680,0.8294573643410853,70,55,75,45,65,60,370,0.45901639344262296,2.0
85,80,90,105,95,60,515,0.49074074074074076,60,80,110,50,80,45,425,0.2833333333333333,1.0
50,105,125,55,95,50,480,0.375886524822695,35,85,45,35,35,75,310,0.6492537313432836,1.0
80,145,150,105,110,110,700,0.8692307692307693,50,48,43,46,41,60,288,0.47297297297297297,1.0
35,64,85,74,55,32,345,0.19827586206896552,75,75,60,83,60,60,413,0.39344262295081966,0.5
85,105,55,85,50,115,495,0.9032258064516129,95,70,73,95,90,60,483,0.3983739837398374,1.0
80,70,40,100,60,145,495,0.921875,50,65,64,44,48,43,314,0.2196969696969697,1.0
105,140,95,55,65,45,505,0.3,45,50,35,55,75,40,300,0.21367521367521367,1.0
79,105,70,145,80,101,580,0.8608695652173913,70,60,70,87,78,85,450,0.6228070175438597,1.0
100,123,75,57,75,80,510,0.6923076923076923,60,150,50,150,50,60,520,0.5,0.0
65,100,70,80,80,105,500,0.8666666666666667,40,40,35,50,100,70,335,0.5031847133757962,0.5
115,45,20,45,25,20,270,0.11538461538461539,60,65,80,170,95,130,600,0.8625954198473282,0.0
110,160,110,80,110,100,670,0.8591549295774648,55,95,55,35,75,115,430,0.9380530973451328,1.0
56,61,65,48,45,38,313,0.17567567567567569,40,30,32,50,52,65,269,0.3671875,1.0
79,115,70,125,80,111,580,0.8468468468468469,72,95,67,103,71,122,530,0.9606299212598425,1.0
80,160,60,170,130,80,680,0.6180555555555556,55,95,115,45,45,35,390,0.2116788321167883,2.0
55,104,105,94,75,52,485,0.36363636363636365,105,140,55,30,55,95,480,0.8195488721804511,2.0
65,125,60,95,60,105,510,0.9236641221374046,65,90,50,85,45,55,390,0.371900826446281,0.5
64,51,23,51,23,28,240,0.11363636363636363,114,85,70,85,80,30,464,0.2066115702479339,1.0
40,40,50,30,30,30,220,0.0873015873015873,65,65,60,110,95,130,525,0.9253731343283582,1.0
60,75,100,55,80,50,420,0.3088235294117647,95,65,110,60,130,65,525,0.5275590551181102,0.0
90,120,100,150,120,100,680,0.7718120805369127,78,52,60,63,65,23,341,0.06015037593984962,0.0
58,64,58,80,65,80,405,0.609271523178808,35,20,65,40,65,20,245,0.02459016393442623,1.0
81,102,77,85,75,85,505,0.5642857142857143,106,110,90,154,90,130,680,0.926829268292683,1.0
30,45,55,70,55,85,340,0.5633802816901409,62,50,58,73,54,72,369,0.4435483870967742,2.0
95,85,85,65,65,35,430,0.2571428571428571,58,70,45,40,45,42,300,0.25925925925925924,1.0
65,47,55,73,75,85,400,0.65,100,100,100,100,100,100,600,0.8602941176470589,2.0
50,20,55,25,25,30,205,0.09774436090225563,30,35,30,100,35,80,310,0.4765625,0.25
75,95,60,65,60,115,470,0.8778625954198473,50,105,79,35,110,76,455,0.6214285714285714,1.0
40,45,40,35,35,56,251,0.373015873015873,45,55,45,65,45,75,330,0.5692307692307692,1.0
80,100,70,50,60,45,405,0.25806451612903225,59,63,80,65,80,58,405,0.41843971631205673,1.0
90,120,100,150,120,100,680,0.7718120805369127,50,35,55,25,25,15,205,0.05263157894736842,1.0
70,84,70,65,70,51,410,0.2949640287769784,41,50,37,50,37,66,281,0.5175438596491229,1.0
58,89,77,45,45,48,362,0.3177570093457944,61,72,57,55,55,65,365,0.3984375,1.0
70,135,105,60,105,20,495,0.5806451612903226,88,107,122,74,75,64,530,0.4596774193548387,1.0
45,85,70,40,40,60,340,0.5229357798165137,110,160,110,80,110,100,670,0.8591549295774648,1.0
70,43,53,43,53,40,302,0.19090909090909092,65,95,57,100,85,93,495,0.7441860465116279,1.0
126,131,95,131,98,99,680,0.8294573643410853,39,52,43,60,50,65,309,0.49107142857142855,0.5
55,85,122,58,75,99,494,0.8099173553719008,70,55,75,45,65,60,370,0.45901639344262296,0.25
52,65,50,45,50,38,300,0.27419354838709675,85,50,95,120,115,80,545,0.5793650793650794,0.0
50,105,79,35,110,76,455,0.6214285714285714,65,110,130,60,65,95,525,0.8278145695364238,1.0
50,52,48,65,50,55,320,0.33098591549295775,86,81,97,81,107,43,495,0.203125,1.0
70,55,75,45,65,60,370,0.45901639344262296,80,120,79,95,79,70,523,0.5833333333333334,0.5
40,45,40,65,40,65,295,0.5661764705882353,77,120,90,60,90,48,485,0.2785714285714286,0.5
65,130,60,95,110,65,525,0.5303030303030303,125,120,90,170,100,95,700,0.78125,1.0
77,59,50,67,63,46,362,0.23140495867768596,44,48,65,50,64,43,314,0.1623931623931624,0.5
30,45,135,45,90,30,375,0.09285714285714286,80,120,79,95,79,70,523,0.5833333333333334,1.0
56,61,65,48,45,38,313,0.17567567567567569,90,120,120,60,60,50,500,0.35294117647058826,2.0
75,55,70,55,95,110,460,0.8444444444444444,83,80,75,70,70,101,479,0.8615384615384616,0.5
80,80,50,40,50,25,325,0.176056338028169,77,59,50,67,63,46,362,0.23140495867768596,0.5
100,128,90,77,77,128,600,0.959349593495935,40,40,35,50,100,70,335,0.5031847133757962,0.5
65,83,57,95,85,105,490,0.8914728682170543,50,70,50,50,50,70,340,0.5645161290322581,0.0
43,30,55,40,65,97,330,0.6030534351145038,55,104,105,94,75,52,485,0.36363636363636365,0.5
50,65,107,105,107,86,520,0.7758620689655172,70,83,50,37,50,60,350,0.3360655737704918,2.0
60,100,85,80,85,100,510,0.7007874015748031,106,110,90,154,90,130,680,0.926829268292683,0.25
41,64,45,50,50,50,300,0.36752136752136755,130,85,80,85,95,60,535,0.43884892086330934,1.0
53,51,53,61,56,40,314,0.14285714285714285,65,110,130,60,65,95,525,0.8278145695364238,0.5
60,40,60,95,60,55,370,0.4222222222222222,45,60,30,80,50,65,330,0.4603174603174603,0.25
75,125,75,30,75,85,465,0.625,105,95,75,85,75,74,509,0.5714285714285714,1.0
70,95,125,65,75,45,475,0.33613445378151263,63,63,47,41,41,74,329,0.56,1.0
35,45,160,30,45,70,385,0.48148148148148145,70,85,70,60,70,50,405,0.28378378378378377,0.5
65,90,65,61,61,100,442,0.8373983739837398,50,85,55,65,65,90,410,0.7478260869565218,1.0
150,100,120,100,120,90,680,0.6666666666666666,65,75,105,35,65,85,430,0.6940298507462687,1.0
50,64,50,45,50,41,300,0.22727272727272727,30,40,55,40,55,60,280,0.3237410071942446,0.5
65,50,35,115,95,95,455,0.7333333333333333,65,47,55,73,75,85,400,0.65,1.0
70,140,230,60,80,50,630,0.32432432432432434,53,51,53,61,56,40,314,0.14285714285714285,0.5
50,65,90,35,35,15,290,0.14678899082568808,70,75,60,105,60,105,475,0.88,1.0
106,190,100,154,100,130,780,0.9259259259259259,66,41,77,61,87,23,355,0.12096774193548387,2.0
79,105,70,145,80,101,580,0.8608695652173913,68,65,65,125,115,80,518,0.6461538461538462,1.0
65,130,60,75,60,75,465,0.689922480620155,55,55,45,63,45,45,308,0.25,1.0
55,63,90,50,80,42,380,0.21138211382113822,60,55,90,145,90,80,520,0.6071428571428571,0.125
53,51,53,61,56,40,314,0.14285714285714285,78,92,75,74,63,118,500,0.8842975206611571,1.0
100,100,100,100,100,100,600,0.831858407079646,130,65,60,110,95,65,525,0.5227272727272727,1.0
50,65,107,105,107,86,520,0.7313432835820896,90,55,75,60,75,30,385,0.13970588235294118,1.0
106,130,90,110,154,90,680,0.719626168224299,67,82,62,46,48,43,348,0.22033898305084745,2.0
80,95,82,60,82,75,474,0.6,125,170,100,120,90,95,700,0.77,1.0
45,30,15,85,65,65,305,0.36220472440944884,70,85,140,85,70,20,470,0.272,0.5
74,48,76,83,81,104,466,0.7913043478260869,64,51,23,51,23,28,240,0.11363636363636363,1.0
77,59,50,67,63,46,362,0.23140495867768596,106,110,90,154,90,130,680,0.926829268292683,1.0
68,72,78,38,42,32,330,0.23809523809523808,106,90,130,90,154,110,680,0.8699186991869918,0.0
50,100,150,100,150,50,600,0.37142857142857144,106,150,70,194,120,140,780,0.952,1.0
82,80,86,85,75,72,480,0.6183206106870229,72,95,67,103,71,122,530,0.9606299212598425,2.0
80,45,65,90,110,80,470,0.5462962962962963,59,66,70,44,55,41,335,0.25190839694656486,1.0
103,60,86,60,86,50,445,0.3458646616541353,50,80,95,10,45,10,290,0.232,0.5
60,65,70,85,75,40,395,0.21705426356589147,79,100,80,110,90,121,580,0.968,0.5
65,76,84,54,96,105,480,0.9008264462809917,50,55,50,36,30,43,264,0.2922077922077922,1.0
81,102,77,85,75,85,505,0.5642857142857143,70,45,48,60,65,35,323,0.15748031496062992,2.0
65,55,115,100,40,60,435,0.3798449612403101,109,66,84,81,99,32,471,0.2013888888888889,2.0
62,55,52,109,94,109,481,0.7833333333333333,103,60,86,60,86,50,445,0.3458646616541353,1.0
40,40,35,50,100,70,335,0.5031847133757962,110,123,65,100,65,65,528,0.5217391304347826,2.0
50,50,150,50,150,50,500,0.2571428571428571,75,75,95,75,95,113,528,0.9015151515151515,1.0
126,131,95,131,98,99,680,0.8102189781021898,91,90,106,130,106,77,600,0.648854961832061,0.5
65,110,130,60,65,95,525,0.8278145695364238,90,95,95,70,90,70,510,0.5230769230769231,2.0
60,80,110,50,80,45,425,0.2833333333333333,30,40,55,40,55,60,280,0.3237410071942446,1.0
70,95,85,55,65,70,440,0.5,55,65,95,95,45,85,440,0.6610169491525424,1.0
55,50,45,135,95,120,500,0.7714285714285715,89,124,80,55,80,55,483,0.5714285714285714,2.0
150,160,100,95,65,100,670,0.8866666666666667,37,25,41,25,41,25,194,0.08870967741935484,1.0
60,67,85,77,75,116,480,0.8888888888888888,50,53,62,58,63,44,330,0.13709677419354838,2.0
85,105,55,85,50,115,495,0.9032258064516129,70,20,50,20,50,40,250,0.1557377049180328,0.5
160,110,65,65,110,30,540,0.35714285714285715,40,55,70,45,60,30,300,0.10619469026548672,0.5
100,100,100,100,100,100,600,0.8758169934640523,65,130,60,75,60,75,465,0.689922480620155,0.0
50,52,48,65,50,55,320,0.33098591549295775,106,90,130,90,154,110,680,0.8699186991869918,1.0
70,140,230,60,80,50,630,0.32432432432432434,46,57,40,40,40,50,273,0.25,1.0
50,50,40,50,40,64,294,0.45588235294117646,36,50,50,65,60,44,305,0.16363636363636364,1.0
35,80,50,50,70,120,405,0.84375,55,20,35,20,45,75,250,0.37681159420289856,1.0
60,90,55,90,80,110,485,0.8677685950413223,50,65,107,105,107,86,520,0.7313432835820896,0.25
103,60,126,80,126,50,545,0.36363636363636365,50,50,95,40,50,35,320,0.20279720279720279,1.0
40,55,30,30,30,85,270,0.688,40,80,35,35,45,70,305,0.4661016949152542,2.0
65,125,100,60,70,70,490,0.6099290780141844,40,50,90,30,55,65,330,0.44680851063829785,1.0
40,30,50,55,55,100,330,0.584070796460177,50,180,20,180,20,150,600,0.9029850746268657,1.0
55,35,50,55,110,85,390,0.6277372262773723,44,38,33,61,43,70,289,0.5267857142857143,0.5
75,75,95,75,95,113,528,0.9015151515151515,67,58,57,81,67,101,431,0.8790322580645161,1.0
101,72,72,99,89,29,462,0.1937984496124031,80,92,65,65,80,68,450,0.4824561403508772,1.0
60,30,30,36,56,50,262,0.32432432432432434,45,53,70,40,60,42,310,0.25735294117647056,4.0
50,95,180,85,45,70,525,0.5298507462686567,70,60,125,115,70,55,495,0.35507246376811596,0.5
65,90,115,45,115,58,488,0.5041322314049587,55,75,85,25,25,15,280,0.1875,2.0
71,120,95,120,95,99,600,0.8203125,52,65,50,45,50,38,300,0.27419354838709675,2.0
95,109,105,75,85,56,525,0.34513274336283184,50,65,107,105,107,86,520,0.703125,2.0
85,110,76,65,82,56,474,0.3933333333333333,40,55,30,30,30,60,245,0.43548387096774194,0.0
80,145,150,105,110,110,700,0.8692307692307693,35,64,85,74,55,32,345,0.19827586206896552,0.5
60,60,60,35,35,30,280,0.11194029850746269,55,45,43,55,43,72,313,0.5853658536585366,1.0
64,165,75,93,83,75,555,0.6587301587301587,70,85,70,60,70,50,405,0.28378378378378377,1.0
70,55,55,80,60,45,365,0.2222222222222222,51,65,65,80,75,59,395,0.4365079365079365,1.0
70,90,70,60,60,70,420,0.6390977443609023,50,75,45,40,45,60,315,0.4380165289256198,1.0
38,41,40,50,65,65,299,0.4108527131782946,61,84,65,70,70,70,420,0.5,0.5
45,90,20,65,20,65,305,0.5116279069767442,20,15,20,10,55,80,200,0.2682926829268293,0.5
45,50,43,40,38,62,278,0.40441176470588236,59,110,150,45,49,35,448,0.3333333333333333,0.0
56,61,65,48,45,38,313,0.17567567567567569,80,130,100,160,120,110,700,0.8981481481481481,0.5
50,65,90,35,35,15,290,0.14678899082568808,92,105,90,125,90,98,600,0.8217054263565892,2.0
75,125,75,30,75,85,465,0.625,45,49,49,65,65,45,318,0.2781954887218045,0.5
20,10,230,10,230,5,505,0.0,39,52,43,60,50,65,309,0.5041322314049587,1.0
68,165,95,65,115,110,618,0.8615384615384616,58,70,45,40,45,42,300,0.25925925925925924,2.0
71,82,64,64,59,112,452,0.9327731092436975,75,90,90,140,90,115,600,0.9481481481481482,1.0
60,79,105,59,85,36,424,0.17054263565891473,35,60,44,40,54,55,288,0.366412213740458,1.0
25,20,15,105,55,90,310,0.32407407407407407,50,92,108,92,108,35,485,0.2457627118644068,0.0
60,45,70,45,90,95,405,0.7304964539007093,40,50,90,30,55,65,330,0.44680851063829785,1.0
60,70,65,125,105,90,515,0.6911764705882353,90,100,90,125,85,90,580,0.7352941176470589,0.25
35,45,160,30,45,70,385,0.48148148148148145,75,95,67,125,95,83,540,0.7117117117117117,4.0
85,56,77,50,77,78,423,0.53125,45,55,45,65,45,75,330,0.5692307692307692,0.0
70,43,53,43,53,40,302,0.19090909090909092,100,75,115,90,115,85,580,0.6446280991735537,1.0
110,80,90,95,90,65,530,0.5033557046979866,55,40,50,65,85,40,335,0.3181818181818182,0.25
75,98,63,98,63,101,498,0.849624060150376,68,125,65,65,115,80,518,0.6277372262773723,1.0
50,53,62,58,63,44,330,0.13709677419354838,78,104,78,159,115,100,634,0.8444444444444444,2.0
90,95,105,165,110,45,610,0.2890625,50,40,85,40,65,25,305,0.08870967741935484,1.0
105,140,95,55,65,45,505,0.3,55,68,64,45,55,31,318,0.11666666666666667,1.0
86,92,88,68,75,73,482,0.6835443037974683,79,115,70,125,80,111,580,0.8468468468468469,1.0
50,180,20,180,20,150,600,0.9029850746268657,60,69,95,69,95,36,424,0.2608695652173913,0.5
70,90,110,60,75,95,500,0.7333333333333333,130,85,80,85,95,60,535,0.43884892086330934,1.0
40,40,35,50,100,70,335,0.5031847133757962,80,92,65,65,80,68,450,0.4824561403508772,0.5
42,52,67,39,56,50,306,0.2868217054263566,78,81,71,74,69,126,499,0.9090909090909091,8.0
85,60,65,135,105,100,550,0.7518248175182481,55,45,43,55,43,72,313,0.5853658536585366,1.0
45,50,35,55,75,40,300,0.21367521367521367,54,63,52,83,56,97,405,0.7697841726618705,1.0
70,84,70,65,70,51,410,0.2949640287769784,82,80,86,85,75,72,480,0.6183206106870229,1.0
55,84,105,114,75,52,485,0.2890625,70,84,70,65,70,51,410,0.2949640287769784,4.0
65,83,57,95,85,105,490,0.8914728682170543,80,92,65,65,80,68,450,0.4824561403508772,2.0
58,109,112,48,48,109,484,0.8805970149253731,50,60,45,100,80,65,400,0.45689655172413796,1.0
105,140,95,55,65,45,505,0.3,30,105,90,25,25,50,325,0.2773722627737226,1.0
78,92,75,74,63,118,500,0.8842975206611571,50,80,95,10,45,10,290,0.232,1.0
91,129,90,72,90,108,580,0.8536585365853658,60,48,45,43,90,42,328,0.21897810218978103,0.5
60,60,60,35,35,30,280,0.11194029850746269,108,112,118,68,72,47,525,0.2916666666666667,1.0
76,104,71,104,71,108,534,0.912751677852349,95,100,85,108,70,70,528,0.5652173913043478,0.5
50,70,50,50,50,40,310,0.16296296296296298,64,78,52,78,52,81,405,0.6422764227642277,2.0
80,105,105,105,105,80,580,0.5939849624060151,85,56,77,50,77,78,423,0.53125,2.0
90,30,15,40,20,15,210,0.043478260869565216,65,75,70,95,70,95,470,0.7272727272727273,1.0
55,130,115,50,50,75,475,0.5982142857142857,65,80,140,40,70,70,465,0.5223880597014925,1.0
45,63,37,65,55,95,360,0.8055555555555556,70,65,65,55,55,70,380,0.5,1.0
45,60,30,80,50,65,330,0.4603174603174603,60,70,65,125,105,90,515,0.6911764705882353,2.0
80,80,50,40,50,25,325,0.176056338028169,35,55,40,50,50,90,320,0.6838235294117647,1.0
40,45,35,65,55,70,310,0.4482758620689655,83,80,80,135,80,121,579,0.9444444444444444,0.5
45,35,45,62,53,35,275,0.11851851851851852,68,75,53,83,113,60,452,0.45384615384615384,0.5
75,89,85,55,65,36,405,0.29545454545454547,45,60,40,70,50,45,310,0.2846715328467153,0.5
60,150,50,150,50,60,520,0.5,90,95,105,165,110,45,610,0.2890625,0.5
74,94,131,54,116,20,489,0.4485294117647059,45,30,15,85,65,65,305,0.36220472440944884,2.0
100,110,90,85,90,60,535,0.47794117647058826,60,85,69,65,79,80,438,0.576,2.0
40,40,50,30,30,30,220,0.0873015873015873,55,95,115,45,45,35,390,0.2116788321167883,4.0
70,140,230,60,80,50,630,0.32432432432432434,110,80,90,95,90,65,530,0.5033557046979866,1.0
45,100,45,45,45,10,290,0.2949640287769784,55,84,105,114,75,52,485,0.2890625,1.0
55,112,45,74,45,70,401,0.559322033898305,75,85,200,55,65,30,510,0.16778523489932887,0.125
70,94,50,94,50,66,424,0.48148148148148145,109,66,84,81,99,32,471,0.2013888888888889,0.5
100,100,90,150,140,90,670,0.71875,73,76,75,81,100,100,505,0.8110236220472441,2.0
30,30,30,30,30,30,180,0.12612612612612611,65,50,70,95,80,65,425,0.4262295081967213,1.0
75,75,60,83,60,60,413,0.39344262295081966,65,63,45,45,45,45,308,0.2595419847328244,2.0
40,35,30,120,70,105,400,0.6692307692307692,60,90,55,90,80,110,485,0.8677685950413223,1.0
85,120,70,50,60,100,485,0.8308823529411765,105,95,75,85,75,74,509,0.5714285714285714,1.0
85,80,70,135,75,90,535,0.7006802721088435,40,30,30,55,30,85,270,0.4666666666666667,1.0
100,100,100,100,100,100,600,0.8345864661654135,78,65,68,112,154,75,552,0.628099173553719,1.0
35,55,40,50,50,90,320,0.6838235294117647,110,160,110,80,110,100,670,0.8591549295774648,1.0
35,55,40,45,40,60,275,0.35714285714285715,108,100,121,81,95,95,600,0.7476635514018691,0.0
80,82,100,83,100,80,525,0.6821705426356589,62,73,55,56,52,84,382,0.7244094488188977,0.25
50,64,50,45,50,41,300,0.22727272727272727,60,85,42,85,42,91,405,0.8227848101265823,0.0
90,95,95,70,90,70,510,0.5230769230769231,95,75,180,130,80,30,590,0.13793103448275862,0.25
100,150,120,120,100,90,680,0.6493506493506493,84,86,88,111,101,60,530,0.4634146341463415,1.0
70,90,90,135,90,125,600,0.9401709401709402,115,115,85,90,75,100,580,0.8134328358208955,1.0
60,100,115,70,85,90,520,0.7557251908396947,74,94,131,54,116,20,489,0.4485294117647059,0.5
78,84,78,109,85,100,534,0.8620689655172413,55,68,64,45,55,31,318,0.11666666666666667,2.0
50,60,60,60,60,30,320,0.11290322580645161,95,155,109,70,130,81,640,0.6788321167883211,0.5
60,80,50,40,40,30,300,0.15328467153284672,51,65,65,80,75,59,395,0.4365079365079365,1.0
45,67,60,35,50,63,320,0.5128205128205128,45,53,70,40,60,42,310,0.25735294117647056,0.5
40,45,35,40,40,90,290,0.65,55,40,50,65,85,40,335,0.3181818181818182,0.0
50,50,40,30,30,50,250,0.2781954887218045,70,43,53,43,53,40,302,0.19090909090909092,2.0
30,40,70,70,25,60,295,0.41353383458646614,40,30,35,45,40,55,245,0.31496062992125984,0.5
79,115,70,125,80,111,580,0.864,64,51,23,51,23,28,240,0.11363636363636363,1.0
55,112,45,74,45,70,401,0.559322033898305,35,80,50,50,70,120,405,0.84375,0.5
75,95,67,125,95,83,540,0.7117117117117117,78,65,68,112,154,75,552,0.628099173553719,1.0
55,75,85,25,25,15,280,0.1875,110,65,105,55,95,80,510,0.6258503401360545,2.0
90,120,75,60,60,45,450,0.29411764705882354,80,100,80,80,80,100,520,0.9051724137931034,2.0
60,110,70,60,60,100,460,0.8461538461538461,50,95,95,35,110,70,455,0.5179856115107914,2.0
58,89,77,45,45,48,362,0.3177570093457944,65,65,60,110,95,130,525,0.9253731343283582,1.0
36,50,50,65,60,44,305,0.16363636363636364,65,95,100,60,50,50,420,0.34959349593495936,2.0
85,110,76,65,82,56,474,0.3933333333333333,38,30,85,55,65,30,303,0.21428571428571427,2.0
60,90,140,50,50,40,430,0.2535211267605634,255,10,10,75,135,55,540,0.3125,1.0
55,55,85,65,85,35,380,0.2014388489208633,75,75,55,105,85,30,425,0.1619718309859155,0.5
60,45,70,45,90,95,405,0.7304964539007093,60,85,69,60,69,77,420,0.518796992481203,1.0
70,80,50,35,35,35,305,0.14,55,95,115,45,45,35,390,0.2116788321167883,2.0
85,80,90,105,95,60,515,0.49074074074074076,45,85,70,40,40,60,340,0.5229357798165137,0.5
70,85,65,105,85,120,530,0.9262295081967213,86,68,72,109,66,106,507,0.8099173553719008,0.5
40,70,40,35,40,60,285,0.392,91,72,90,129,90,108,580,0.8620689655172413,1.0
95,110,95,40,95,55,490,0.40336134453781514,75,100,95,40,70,110,490,0.8717948717948718,1.0
90,75,75,90,100,70,500,0.5462184873949579,50,95,90,95,90,180,600,0.9172413793103448,1.0
75,100,110,45,55,65,450,0.5333333333333333,49,66,70,44,55,51,335,0.4260869565217391,0.5
70,60,62,80,82,60,414,0.4375,50,95,95,35,110,70,455,0.5179856115107914,1.0
55,40,85,80,105,40,405,0.23622047244094488,59,63,80,65,80,58,405,0.41843971631205673,1.0
90,75,75,90,100,70,500,0.5462184873949579,110,160,110,80,110,100,670,0.8591549295774648,1.0
70,140,230,60,80,50,630,0.32432432432432434,70,20,50,20,50,40,250,0.1557377049180328,0.25
40,45,35,65,55,70,310,0.4482758620689655,91,72,90,129,90,108,580,0.8620689655172413,2.0
55,95,55,35,75,115,430,0.9380530973451328,150,100,120,100,120,90,680,0.6666666666666666,4.0
91,90,106,130,106,77,600,0.648854961832061,50,20,40,20,40,20,190,0.0962962962962963,0.5
65,80,140,40,70,70,465,0.5223880597014925,90,60,70,75,70,45,410,0.23880597014925373,1.0
43,70,48,50,60,38,309,0.2391304347826087,45,50,55,75,65,30,320,0.06293706293706294,0.25
45,25,50,25,25,35,205,0.13076923076923078,28,25,25,45,35,40,198,0.16083916083916083,2.0
55,63,90,50,80,42,380,0.21138211382113822,90,50,34,60,44,70,348,0.6283185840707964,0.125
70,90,45,15,45,50,315,0.3629032258064516,79,105,70,145,80,101,580,0.8608695652173913,1.0
80,80,80,55,55,90,440,0.6417910447761194,75,140,65,112,65,110,567,0.9140625,0.5
70,75,60,105,60,105,475,0.88,75,75,75,125,95,40,485,0.15671641791044777,1.0
55,40,85,80,105,40,405,0.23622047244094488,80,105,105,105,105,80,580,0.5939849624060151,1.0
70,80,50,35,35,35,305,0.14,120,100,85,30,85,45,465,0.22448979591836735,1.0
60,30,30,36,56,50,262,0.32432432432432434,30,80,90,55,45,55,355,0.4295774647887324,0.25
44,38,39,61,79,42,303,0.2251655629139073,40,30,30,40,50,30,220,0.07936507936507936,1.0
65,95,75,55,55,85,430,0.6933333333333334,35,64,85,74,55,32,345,0.19827586206896552,0.5
45,100,45,45,45,10,290,0.2949640287769784,45,60,32,50,32,76,295,0.5925925925925926,2.0
79,115,70,125,80,111,580,0.8468468468468469,35,65,35,65,35,65,300,0.46621621621621623,1.0
45,60,40,70,50,45,310,0.2846715328467153,70,50,30,95,135,105,485,0.8040540540540541,2.0
75,100,110,45,55,65,450,0.5333333333333333,65,125,60,95,60,105,510,0.9236641221374046,1.0
52,65,50,45,50,38,300,0.27419354838709675,85,105,85,40,50,40,405,0.211864406779661,0.5
101,72,72,99,89,29,462,0.1937984496124031,50,50,150,50,150,50,500,0.2571428571428571,1.0
46,57,40,40,40,50,273,0.25,75,125,230,55,95,30,610,0.3448275862068966,0.0
70,55,95,95,110,65,490,0.48872180451127817,55,65,35,60,30,85,330,0.6126126126126126,1.0
100,50,80,60,80,50,420,0.34375,56,61,65,48,45,38,313,0.17567567567567569,0.5
75,125,70,125,70,115,580,0.9037037037037037,55,104,105,94,75,52,485,0.36363636363636365,1.0
84,86,88,111,101,60,530,0.4634146341463415,43,70,48,50,60,38,309,0.2391304347826087,0.5
90,95,95,70,90,70,510,0.5230769230769231,70,85,70,60,70,50,405,0.28378378378378377,1.0
65,90,50,85,45,55,390,0.371900826446281,45,30,35,20,20,45,195,0.14782608695652175,0.5
101,72,72,99,89,29,462,0.1937984496124031,65,60,110,130,95,65,525,0.47761194029850745,1.0
45,49,49,65,65,45,318,0.2781954887218045,90,120,120,60,60,50,500,0.35294117647058826,1.0
60,85,69,65,79,80,438,0.576,60,85,42,85,42,91,405,0.8227848101265823,1.0
75,125,70,125,70,115,580,0.9037037037037037,60,50,50,60,70,50,340,0.28346456692913385,1.0
45,49,49,65,65,45,318,0.2781954887218045,75,87,63,87,63,98,473,0.865546218487395,1.0
90,50,34,60,44,70,348,0.6283185840707964,106,150,70,194,120,140,780,0.952,2.0
103,60,86,60,86,50,445,0.3458646616541353,77,59,50,67,63,46,362,0.23140495867768596,0.5
50,95,95,35,110,70,455,0.5179856115107914,65,83,57,95,85,105,490,0.8914728682170543,1.0
74,48,76,83,81,104,466,0.7913043478260869,40,30,35,50,70,55,280,0.28205128205128205,2.0
90,50,34,60,44,70,348,0.6283185840707964,90,100,60,90,60,80,480,0.6422764227642277,1.0
90,95,105,165,110,45,610,0.2890625,58,109,112,48,48,109,484,0.8805970149253731,0.5
50,53,48,53,48,64,316,0.46153846153846156,30,35,30,100,35,80,310,0.4765625,1.0
68,165,95,65,115,110,618,0.8615384615384616,75,110,110,110,105,80,590,0.656934306569343,0.5
68,165,95,65,115,110,618,0.8615384615384616,65,90,120,85,70,60,490,0.43410852713178294,1.0
95,145,130,120,90,120,700,0.9398496240601504,55,75,60,75,60,103,428,0.7982456140350878,0.5
60,130,80,60,60,70,460,0.5153846153846153,50,85,55,65,65,90,410,0.7478260869565218,0.5
50,50,50,50,50,50,300,0.30708661417322836,75,85,200,55,65,30,510,0.16778523489932887,1.0
120,100,85,30,85,45,465,0.22448979591836735,71,95,85,110,95,79,535,0.664,2.0
50,105,79,35,110,76,455,0.6214285714285714,61,84,65,70,70,70,420,0.5,1.0
48,61,40,61,40,50,300,0.2543859649122807,55,104,105,94,75,52,485,0.36363636363636365,1.0
75,80,95,90,100,50,490,0.2158273381294964,75,75,130,75,130,95,580,0.7479674796747967,1.0
38,35,35,65,55,50,278,0.2647058823529412,90,60,60,40,40,40,330,0.29545454545454547,2.0
70,100,115,30,65,30,410,0.24390243902439024,50,65,85,35,35,55,325,0.32575757575757575,2.0
45,80,100,35,37,28,325,0.3125,80,50,100,100,200,50,580,0.2357142857142857,2.0
60,45,70,75,85,55,390,0.3008130081300813,70,110,75,145,85,145,630,0.9444444444444444,1.0
100,90,130,45,65,55,485,0.4253731343283582,79,103,120,135,115,78,630,0.5763888888888888,0.5
40,80,100,30,30,20,300,0.11851851851851852,60,60,60,60,60,60,360,0.38095238095238093,1.0
54,78,103,53,45,22,355,0.23255813953488372,57,80,91,80,87,75,470,0.5737704918032787,0.5
73,95,62,85,65,85,465,0.6666666666666666,50,50,77,95,77,91,440,0.5916666666666667,0.0
95,85,85,65,65,35,430,0.2571428571428571,55,55,85,65,85,35,380,0.2014388489208633,2.0
50,65,107,105,107,86,520,0.6991150442477876,45,50,43,40,38,62,278,0.40441176470588236,2.0
80,185,115,40,105,75,600,0.6230769230769231,105,130,120,45,45,40,485,0.4444444444444444,2.0
64,66,68,81,76,50,405,0.25190839694656486,125,58,58,76,76,67,460,0.515625,0.5
45,65,34,40,34,45,263,0.2589928057553957,70,100,115,30,65,30,410,0.24390243902439024,1.0
100,100,125,110,50,50,535,0.384,60,52,168,47,138,30,495,0.19834710743801653,1.0
76,48,48,57,62,34,325,0.11688311688311688,59,45,40,35,40,31,250,0.14285714285714285,1.0
60,60,60,60,60,60,360,0.38095238095238093,50,85,85,55,55,50,380,0.3902439024390244,0.5
85,100,122,58,75,54,494,0.3939393939393939,74,100,72,90,72,46,454,0.24561403508771928,0.5
75,38,38,56,56,67,330,0.5263157894736842,50,50,150,50,150,50,500,0.2571428571428571,2.0
45,55,45,65,45,75,330,0.5692307692307692,65,55,115,100,40,60,435,0.3798449612403101,4.0
110,80,90,95,90,65,530,0.5033557046979866,41,56,40,62,44,71,314,0.568,0.25
90,85,100,95,125,85,580,0.6834532374100719,50,95,180,85,45,70,525,0.5298507462686567,0.25
37,25,41,25,41,25,194,0.08870967741935484,50,65,107,105,107,86,520,0.7272727272727273,0.5
75,80,95,90,100,50,490,0.2158273381294964,150,100,120,100,120,90,680,0.6666666666666666,0.5
45,45,55,45,55,63,308,0.4594594594594595,65,65,45,75,45,95,390,0.72,0.25
106,110,90,154,90,130,680,0.926829268292683,100,164,150,95,120,71,700,0.5645161290322581,0.0
48,72,48,72,48,48,336,0.25984251968503935,65,73,55,47,75,85,400,0.6846846846846847,1.0
70,110,75,145,85,145,630,0.9444444444444444,111,83,68,92,82,39,475,0.1774193548387097,4.0
80,110,120,130,90,70,600,0.6198347107438017,60,60,60,85,85,85,435,0.631578947368421,1.0
80,70,70,90,100,70,480,0.5609756097560976,110,80,90,95,90,65,530,0.5033557046979866,1.0
35,55,40,50,50,90,320,0.6838235294117647,40,60,40,40,40,30,250,0.0948905109489051,1.0
55,45,50,45,65,80,340,0.5546218487394958,43,30,55,40,65,97,330,0.6030534351145038,2.0
70,60,62,80,82,60,414,0.4375,100,90,130,45,65,55,485,0.4253731343283582,0.5
55,70,55,40,55,85,360,0.7073170731707317,65,125,100,60,70,70,490,0.6099290780141844,0.5
35,35,40,35,55,50,250,0.40336134453781514,62,55,52,109,94,109,481,0.7833333333333333,0.5
35,20,65,40,65,20,245,0.02459016393442623,67,58,57,81,67,101,431,0.8790322580645161,1.0
70,90,45,15,45,50,315,0.3629032258064516,75,100,110,45,55,65,450,0.5333333333333333,1.0
60,100,89,55,69,112,485,0.9298245614035088,20,40,15,35,35,60,205,0.34285714285714286,1.0
64,51,23,51,23,28,240,0.11363636363636363,100,73,83,73,83,55,467,0.371900826446281,1.0
135,85,40,40,85,5,390,0.6864406779661016,54,63,52,83,56,97,405,0.7697841726618705,1.0
75,105,75,105,75,45,480,0.3274336283185841,58,64,58,80,65,80,405,0.609271523178808,2.0
100,164,150,95,120,71,700,0.5645161290322581,40,80,100,30,30,20,300,0.11851851851851852,0.5
30,30,30,30,30,30,180,0.12612612612612611,85,76,64,45,55,90,415,0.6739130434782609,1.0
85,135,130,60,80,25,515,0.40540540540540543,20,10,230,10,230,5,505,0.0,2.0
60,60,50,40,50,75,335,0.5882352941176471,72,105,115,54,86,68,500,0.5149253731343284,2.0
50,50,50,50,50,50,300,0.30708661417322836,70,150,140,65,100,75,600,0.55,0.5
45,35,50,70,50,30,280,0.15753424657534246,85,80,70,135,75,90,535,0.7006802721088435,1.0
75,125,100,70,80,45,495,0.33035714285714285,50,52,48,65,50,55,320,0.33098591549295775,1.0
66,41,77,61,87,23,355,0.12096774193548387,64,51,23,51,23,28,240,0.11363636363636363,1.0
50,50,150,50,150,50,500,0.2571428571428571,126,131,95,131,98,99,680,0.8294573643410853,1.0
45,30,40,105,50,20,290,0.031007751937984496,70,75,60,105,60,105,475,0.88,1.0
60,55,145,75,150,40,525,0.2,62,44,50,44,50,55,305,0.3629032258064516,1.0
40,20,30,40,80,55,265,0.22764227642276422,65,65,60,110,95,130,525,0.9253731343283582,0.5
123,77,72,99,92,58,521,0.4621212121212121,105,130,120,45,45,40,485,0.4444444444444444,1.0
106,150,70,194,120,140,780,0.952,63,63,47,41,41,74,329,0.56,0.0
68,75,53,83,113,60,452,0.45384615384615384,115,115,85,90,75,100,580,0.8134328358208955,1.0
100,5,5,15,65,30,220,0.07692307692307693,65,95,100,60,50,50,420,0.34959349593495936,1.0
70,90,70,60,60,70,420,0.6390977443609023,70,65,65,55,55,70,380,0.5,1.0
55,81,60,50,70,97,413,0.7214285714285714,85,60,65,135,105,100,550,0.7518248175182481,1.0
40,55,70,45,60,30,300,0.10619469026548672,65,63,45,45,45,45,308,0.2595419847328244,0.5
60,50,40,85,75,95,405,0.7540983606557377,55,40,40,65,45,35,280,0.16428571428571428,0.5
68,85,65,165,135,100,618,0.8083333333333333,66,65,48,62,57,52,350,0.36220472440944884,1.0
120,120,120,120,120,120,720,0.9344262295081968,58,109,112,48,48,109,484,0.8805970149253731,0.5
91,90,129,90,72,108,580,0.9140625,74,48,76,83,81,104,466,0.7913043478260869,0.5
75,87,63,87,63,98,473,0.865546218487395,123,77,72,99,92,58,521,0.4621212121212121,1.0
55,85,55,50,55,60,360,0.4233576642335766,60,60,75,60,75,80,410,0.7321428571428571,1.0
50,53,48,53,48,64,316,0.46153846153846156,90,92,87,75,85,76,505,0.5409836065573771,1.0
50,53,48,53,48,64,316,0.4076923076923077,60,85,69,60,69,77,420,0.518796992481203,1.0
64,165,75,93,83,75,555,0.6587301587301587,60,40,80,60,45,40,325,0.23529411764705882,2.0
70,110,80,55,80,105,500,0.8794326241134752,130,70,35,70,35,60,400,0.4017857142857143,1.0
106,150,70,194,120,140,780,0.952,50,85,125,85,115,20,480,0.4306569343065693,0.0
105,180,100,180,100,115,780,0.9477611940298507,65,45,55,45,70,45,325,0.24369747899159663,1.0
50,53,48,53,48,64,316,0.46153846153846156,54,63,52,83,56,97,405,0.7697841726618705,0.5
70,62,67,55,55,56,365,0.38513513513513514,72,85,70,65,70,58,420,0.41304347826086957,1.0
45,20,50,60,120,50,345,0.24074074074074073,55,70,40,60,40,40,305,0.26956521739130435,1.0
69,69,76,69,86,91,460,0.6554621848739496,70,110,80,55,80,105,500,0.8794326241134752,1.0
90,90,85,125,90,100,580,0.768595041322314,105,130,120,45,45,40,485,0.4444444444444444,0.0
65,75,70,95,70,95,470,0.7272727272727273,50,60,60,60,60,30,320,0.11290322580645161,2.0
100,77,77,128,128,90,600,0.6901408450704225,80,115,80,65,55,93,488,0.7846153846153846,1.0
70,140,230,60,80,50,630,0.32432432432432434,50,20,55,25,25,30,205,0.09774436090225563,1.0
31,45,90,30,30,40,266,0.21929824561403508,55,68,64,45,55,31,318,0.11666666666666667,1.0
103,60,86,60,86,50,445,0.3458646616541353,100,50,50,76,96,70,442,0.5,1.0
73,76,75,81,100,100,505,0.8110236220472441,65,90,122,58,75,84,494,0.71875,2.0
75,85,200,55,65,30,510,0.16778523489932887,116,55,85,107,95,29,487,0.06818181818181818,1.0
45,100,135,65,135,45,525,0.29411764705882354,97,165,60,65,50,58,495,0.3902439024390244,1.0
100,100,100,100,100,100,600,0.8805970149253731,59,45,40,35,40,31,250,0.14285714285714285,1.0
60,130,80,60,60,70,460,0.5153846153846153,50,50,77,95,77,91,440,0.5916666666666667,0.0
75,98,63,98,63,101,498,0.849624060150376,61,72,57,55,55,65,365,0.3984375,1.0
70,83,50,37,50,60,350,0.3360655737704918,55,35,50,55,110,85,390,0.6277372262773723,2.0
100,100,100,100,100,100,600,0.8758169934640523,60,62,50,62,60,40,334,0.18181818181818182,2.0
45,60,40,70,50,45,310,0.2846715328467153,50,70,160,70,160,90,600,0.7417218543046358,1.0
64,88,50,88,50,106,446,0.9111111111111111,58,64,58,80,65,80,405,0.609271523178808,1.0
45,40,60,40,75,50,310,0.2926829268292683,40,30,35,50,70,55,280,0.28205128205128205,2.0
111,83,68,92,82,39,475,0.1774193548387097,30,40,70,70,25,60,295,0.41353383458646614,0.5
90,92,75,92,85,60,494,0.49586776859504134,65,85,70,75,70,40,405,0.203125,1.0
106,110,90,154,90,130,680,0.926829268292683,95,155,109,70,130,81,640,0.6788321167883211,0.0
40,45,35,65,55,70,310,0.4482758620689655,60,50,40,85,75,95,405,0.7540983606557377,1.0
86,76,86,116,56,95,515,0.7982456140350878,50,53,48,53,48,64,316,0.358974358974359,1.0
70,100,115,30,65,30,410,0.24390243902439024,60,45,70,75,85,55,390,0.3008130081300813,1.0
45,30,50,55,65,45,290,0.208,75,125,75,30,75,85,465,0.625,1.0
50,95,90,95,90,180,600,0.9172413793103448,58,89,77,45,45,48,362,0.3177570093457944,1.0
55,104,105,94,75,52,485,0.36363636363636365,80,120,79,95,79,70,523,0.5833333333333334,1.0
89,125,90,115,80,101,600,0.8725490196078431,80,70,70,90,100,70,480,0.5609756097560976,1.0
50,150,50,150,50,150,600,0.9339622641509434,64,115,65,83,63,65,455,0.5323741007194245,1.0
125,130,90,130,90,95,660,0.7734375,91,90,106,130,106,77,600,0.648854961832061,0.125
41,50,37,50,37,66,281,0.5175438596491229,40,45,65,100,120,90,460,0.5588235294117647,1.0
60,48,45,43,90,42,328,0.21897810218978103,50,50,40,50,40,64,294,0.45588235294117646,1.0
78,65,68,112,154,75,552,0.628099173553719,70,20,50,20,50,40,250,0.1557377049180328,1.0
78,84,78,109,85,100,534,0.8620689655172413,55,45,50,45,65,80,340,0.5546218487394958,2.0
78,104,78,159,115,100,634,0.8444444444444444,75,75,95,75,95,113,528,0.9015151515151515,4.0
73,76,75,81,100,100,505,0.8110236220472441,45,53,70,40,60,42,310,0.25735294117647056,4.0
30,30,30,30,30,30,180,0.12612612612612611,50,105,125,55,95,50,480,0.375886524822695,0.5
50,95,90,95,90,180,600,0.9172413793103448,50,160,110,160,110,110,700,0.8854961832061069,1.0
50,160,110,160,110,110,700,0.8854961832061069,45,60,32,50,32,76,295,0.5925925925925926,1.0
100,100,125,110,50,50,535,0.384,35,64,85,74,55,32,345,0.19827586206896552,2.0
40,60,30,31,31,70,262,0.4492753623188406,70,55,75,45,65,60,370,0.45901639344262296,1.0
46,57,40,40,40,50,273,0.25,100,100,100,100,100,100,600,0.8602941176470589,2.0
80,110,120,130,90,70,600,0.6198347107438017,65,150,60,115,60,115,565,0.935251798561151,1.0
45,65,34,40,34,45,263,0.2589928057553957,65,70,60,65,65,115,440,0.8583333333333333,1.0
105,95,80,40,80,90,490,0.753968253968254,40,35,30,20,20,50,195,0.23423423423423423,1.0
73,76,75,81,100,100,505,0.8110236220472441,45,100,45,45,45,10,290,0.2949640287769784,1.0
40,45,35,65,55,70,310,0.4482758620689655,62,48,66,59,57,49,341,0.33884297520661155,1.0
55,63,90,50,80,42,380,0.21138211382113822,38,36,38,32,36,57,237,0.3893805309734513,1.0
45,90,20,65,20,65,305,0.5116279069767442,50,65,107,105,107,86,520,0.703125,1.0
80,105,105,105,105,80,580,0.5939849624060151,65,83,57,95,85,105,490,0.8914728682170543,1.0
70,110,180,60,60,50,530,0.4117647058823529,80,135,85,70,95,150,615,0.9844961240310077,4.0
80,120,130,55,65,45,495,0.37037037037037035,97,165,60,65,50,58,495,0.3902439024390244,2.0
101,72,72,99,89,29,462,0.1937984496124031,70,55,55,80,60,45,365,0.2222222222222222,1.0
50,80,95,10,45,10,290,0.232,80,145,150,105,110,110,700,0.8692307692307693,0.5
65,80,140,40,70,70,465,0.5223880597014925,103,60,126,80,126,50,545,0.36363636363636365,0.5
40,50,90,30,55,65,330,0.44680851063829785,95,75,180,130,80,30,590,0.13793103448275862,2.0
44,38,39,61,79,42,303,0.2251655629139073,58,70,45,40,45,42,300,0.25925925925925924,2.0
90,75,75,90,100,70,500,0.5462184873949579,75,90,90,140,90,115,600,0.9481481481481482,2.0
90,30,15,40,20,15,210,0.043478260869565216,35,60,44,40,54,55,288,0.366412213740458,0.5
60,40,60,40,60,35,295,0.18055555555555555,65,155,120,65,90,105,600,0.8677685950413223,0.25
65,75,70,95,70,95,470,0.7272727272727273,65,83,57,95,85,105,490,0.8914728682170543,0.5
30,45,55,70,55,85,340,0.5633802816901409,36,50,50,65,60,44,305,0.16363636363636364,1.0
80,125,75,40,95,85,500,0.6911764705882353,60,65,80,170,95,130,600,0.8625954198473282,0.0
74,48,76,83,81,104,466,0.7913043478260869,60,40,60,40,60,35,295,0.18055555555555555,1.0
45,63,37,65,55,95,360,0.8055555555555556,40,70,130,60,130,25,455,0.17355371900826447,1.0
35,45,160,30,45,70,385,0.48148148148148145,30,40,70,70,25,60,295,0.41353383458646614,1.0
108,170,115,120,95,92,700,0.7083333333333334,76,25,45,67,55,24,292,0.0390625,1.0
65,95,57,100,85,93,495,0.7441860465116279,71,95,85,110,95,79,535,0.664,2.0
55,55,45,63,45,45,308,0.25,79,115,70,125,80,111,580,0.8468468468468469,1.0
63,60,55,50,50,71,349,0.5289256198347108,91,129,90,72,90,108,580,0.8536585365853658,0.5
70,90,110,60,75,95,500,0.7333333333333333,45,35,45,62,53,35,275,0.11851851851851852,2.0
65,80,65,35,65,60,370,0.38405797101449274,50,65,107,105,107,86,520,0.703125,1.0
45,60,45,25,45,55,275,0.29,70,75,80,135,80,135,575,0.917910447761194,1.0
85,97,66,105,66,65,484,0.47107438016528924,130,70,35,70,35,60,400,0.4017857142857143,0.5
50,85,40,85,40,35,335,0.1746031746031746,90,100,90,125,85,90,580,0.7352941176470589,0.25
80,92,65,65,80,68,450,0.4824561403508772,100,150,90,180,160,90,770,0.7348484848484849,0.5
90,75,75,90,100,70,500,0.5462184873949579,75,80,95,90,100,50,490,0.2158273381294964,0.5
65,55,115,100,40,60,435,0.3798449612403101,75,89,85,55,65,36,405,0.29545454545454547,0.5
60,40,60,40,60,35,295,0.18055555555555555,70,130,100,55,80,65,500,0.608,0.25
50,100,150,100,150,50,600,0.37142857142857144,50,50,95,40,50,35,320,0.20279720279720279,0.5
70,145,88,140,70,112,625,0.8888888888888888,100,100,100,100,100,100,600,0.8345864661654135,0.5
60,85,69,60,69,77,420,0.518796992481203,115,140,130,55,55,40,535,0.4519230769230769,0.5
81,102,77,85,75,85,505,0.5642857142857143,70,110,80,55,80,105,500,0.8794326241134752,0.0
45,25,50,25,25,35,205,0.13076923076923078,45,30,50,55,65,45,290,0.208,2.0
70,140,230,60,80,50,630,0.32432432432432434,65,110,130,60,65,95,525,0.8278145695364238,1.0
110,123,65,100,65,65,528,0.5217391304347826,85,80,70,135,75,90,535,0.7006802721088435,2.0
46,87,60,30,40,57,320,0.37777777777777777,65,125,100,60,70,70,490,0.6099290780141844,0.5
60,69,95,69,95,36,424,0.2608695652173913,100,100,90,150,140,90,670,0.71875,0.5
63,120,85,90,55,55,468,0.2809917355371901,55,84,105,114,75,52,485,0.2890625,0.5
100,150,120,120,100,90,680,0.6493506493506493,40,40,50,30,30,30,220,0.0873015873015873,0.5
100,50,80,60,80,50,420,0.34375,65,125,100,60,70,70,490,0.6099290780141844,1.0
70,65,65,55,55,70,380,0.5,70,140,70,110,65,105,560,0.95,1.0
80,120,130,55,65,45,495,0.37037037037037035,30,45,55,70,55,85,340,0.5633802816901409,1.0
82,121,119,69,59,71,521,0.5394736842105263,50,92,108,92,108,35,485,0.2457627118644068,1.0
65,90,115,45,115,58,488,0.5041322314049587,80,80,90,110,130,110,600,0.8721804511278195,1.0
50,105,125,55,95,50,480,0.375886524822695,60,85,40,30,45,68,328,0.6422018348623854,1.0
95,70,73,95,90,60,483,0.3983739837398374,80,80,80,80,80,80,480,0.5606060606060606,1.0
95,135,80,110,80,100,600,0.8248175182481752,86,92,88,68,75,73,482,0.6835443037974683,1.0
60,50,150,50,150,60,520,0.5206611570247934,95,125,79,60,100,81,540,0.6165413533834586,0.5
100,100,100,100,100,100,600,0.8805970149253731,91,134,95,100,100,80,600,0.6304347826086957,0.5
40,40,40,70,40,20,250,0.032520325203252036,250,5,5,35,105,50,450,0.15306122448979592,1.0
126,131,95,131,98,99,680,0.8294573643410853,50,53,48,53,48,64,316,0.358974358974359,1.0
80,160,60,170,130,80,680,0.6180555555555556,40,45,35,40,40,90,290,0.65,1.0
49,66,70,44,55,51,335,0.4260869565217391,105,140,95,55,65,45,505,0.3,1.0
44,75,35,63,33,45,295,0.2647058823529412,40,65,40,80,40,65,330,0.5038167938931297,0.5
80,80,80,80,80,80,480,0.5606060606060606,30,56,35,25,35,72,253,0.48148148148148145,1.0
65,65,45,75,45,95,390,0.72,63,120,85,90,55,55,468,0.2809917355371901,2.0
50,50,120,80,80,30,410,0.07258064516129033,45,65,34,40,34,45,263,0.2589928057553957,1.0
55,40,85,80,105,40,405,0.23622047244094488,40,80,100,30,30,20,300,0.11851851851851852,0.5
70,110,75,145,85,145,630,0.9444444444444444,55,50,65,175,95,150,590,0.7818181818181819,1.0
55,50,40,40,40,75,300,0.5945945945945946,80,100,70,60,70,95,475,0.7416666666666667,1.0
100,120,120,150,100,90,680,0.7880794701986755,100,100,100,100,100,100,600,0.8758169934640523,0.25
50,105,79,35,110,76,455,0.6214285714285714,86,68,72,109,66,106,507,0.8099173553719008,2.0
77,85,51,55,51,65,384,0.5163934426229508,70,95,85,55,65,70,440,0.5,2.0
35,40,100,90,55,35,355,0.1796875,50,64,50,45,50,41,300,0.22727272727272727,2.0
60,65,60,130,75,110,500,0.7719298245614035,110,65,105,55,95,80,510,0.6258503401360545,0.5
50,105,125,55,95,50,480,0.375886524822695,60,62,80,63,80,60,405,0.4336283185840708,1.0
65,75,105,35,65,85,430,0.6940298507462687,70,60,70,87,78,85,450,0.6228070175438597,1.0
97,165,60,65,50,58,495,0.3902439024390244,45,55,39,35,39,42,255,0.18518518518518517,1.0
65,125,100,55,70,85,500,0.6532258064516129,70,80,102,80,102,40,474,0.2677165354330709,0.5
75,75,130,75,130,95,580,0.7479674796747967,60,90,70,60,120,40,440,0.27419354838709675,1.0
55,40,40,65,45,35,280,0.16428571428571428,70,120,40,95,40,95,460,0.8106060606060606,2.0
89,125,90,115,80,101,600,0.8725490196078431,40,40,55,40,70,55,300,0.40939597315436244,1.0
70,145,88,140,70,112,625,0.8888888888888888,45,75,37,70,55,83,365,0.6183206106870229,0.5
105,95,80,40,80,90,490,0.753968253968254,80,50,100,100,200,50,580,0.2357142857142857,1.0
105,140,55,30,55,95,480,0.8195488721804511,60,55,145,75,150,40,525,0.2,1.0
50,65,107,105,107,86,520,0.7272727272727273,35,20,65,40,65,20,245,0.02459016393442623,1.0
60,45,70,45,90,95,405,0.7304964539007093,50,50,150,50,150,50,500,0.2571428571428571,1.0
40,40,35,50,100,70,335,0.5031847133757962,40,45,35,40,40,90,290,0.65,1.0
170,90,45,90,45,60,500,0.427536231884058,130,70,35,70,35,60,400,0.4017857142857143,0.5
75,100,110,45,55,65,450,0.5333333333333333,75,80,55,25,35,35,305,0.18666666666666668,1.0
85,73,70,73,115,67,483,0.5126050420168067,45,49,49,65,65,45,318,0.2781954887218045,2.0
75,55,70,55,95,110,460,0.8444444444444444,30,30,42,30,42,70,244,0.4230769230769231,0.5
35,46,34,35,45,20,215,0.072,54,45,47,75,98,52,371,0.39669421487603307,1.0
150,80,44,90,54,80,498,0.625,123,77,72,99,92,58,521,0.4621212121212121,0.5
60,65,60,130,75,110,500,0.7719298245614035,79,100,80,110,90,121,580,0.968,1.0
70,90,45,15,45,50,315,0.3629032258064516,70,95,125,65,75,45,475,0.33613445378151263,1.0
37,25,41,25,41,25,194,0.08870967741935484,50,100,150,100,150,50,600,0.37142857142857144,0.5
103,93,67,71,61,84,479,0.7142857142857143,85,50,95,120,115,80,545,0.5793650793650794,1.0
85,115,80,105,80,50,515,0.3063063063063063,115,140,130,55,55,40,535,0.4519230769230769,0.0
74,48,76,83,81,104,466,0.7913043478260869,80,80,50,40,50,25,325,0.176056338028169,2.0
59,59,58,90,70,73,409,0.5826086956521739,42,52,67,39,56,50,306,0.2868217054263566,0.25
80,125,75,40,95,85,500,0.6911764705882353,64,88,50,88,50,106,446,0.9111111111111111,4.0
50,85,125,85,115,20,480,0.4306569343065693,55,95,115,45,45,35,390,0.2116788321167883,1.0
110,65,75,125,85,30,490,0.15,40,30,30,40,50,30,220,0.07936507936507936,1.0
45,25,50,25,25,35,205,0.13076923076923078,115,115,85,90,75,100,580,0.8134328358208955,0.5
62,77,62,50,42,65,358,0.4838709677419355,65,40,70,80,140,70,465,0.5954198473282443,1.0
45,60,40,70,50,45,310,0.2846715328467153,111,83,68,92,82,39,475,0.1774193548387097,0.5
50,50,40,50,40,64,294,0.45588235294117646,103,60,86,60,86,50,445,0.3458646616541353,1.0
65,90,122,58,75,84,494,0.71875,44,75,35,63,33,45,295,0.2647058823529412,2.0
45,95,50,40,50,75,355,0.54,50,55,50,36,30,43,264,0.2922077922077922,1.0
76,48,48,57,62,34,325,0.11688311688311688,95,85,85,65,65,35,430,0.2571428571428571,1.0
76,48,48,57,62,34,325,0.11688311688311688,50,85,125,85,115,20,480,0.4306569343065693,1.0
95,75,80,100,110,30,490,0.24242424242424243,30,45,135,45,90,30,375,0.09285714285714286,2.0
108,170,115,120,95,92,700,0.7083333333333334,100,5,5,15,65,30,220,0.07692307692307693,1.0
52,65,50,45,50,38,300,0.27419354838709675,75,65,55,65,55,69,384,0.43548387096774194,1.0
80,135,130,95,90,70,600,0.5181818181818182,62,77,62,50,42,65,358,0.4838709677419355,1.0
80,50,100,100,200,50,580,0.2357142857142857,55,70,55,40,55,85,360,0.7073170731707317,1.0
44,48,65,50,64,43,314,0.1623931623931624,65,90,122,58,75,84,494,0.71875,0.5
91,90,106,130,106,77,600,0.648854961832061,85,70,80,97,80,123,535,0.9304347826086956,0.5
95,117,184,44,46,28,514,0.2975206611570248,50,70,160,70,160,90,600,0.7417218543046358,1.0
75,90,50,110,80,95,500,0.7985611510791367,90,120,120,60,60,50,500,0.35294117647058826,1.0
62,48,66,59,57,49,341,0.33884297520661155,70,105,105,50,40,20,390,0.33587786259541985,1.0
75,103,80,70,80,92,500,0.7933884297520661,70,150,140,65,100,75,600,0.55,0.125
90,132,105,132,105,30,594,0.4246575342465753,116,55,85,107,95,29,487,0.06818181818181818,1.0
90,75,75,90,100,70,500,0.5462184873949579,50,65,107,105,107,86,520,0.7758620689655172,0.5
70,80,50,35,35,35,305,0.14,70,140,230,60,80,50,630,0.32432432432432434,2.0
63,120,85,90,55,55,468,0.2809917355371901,85,105,55,85,50,115,495,0.9032258064516129,0.5
90,75,75,90,100,70,500,0.5462184873949579,75,75,75,125,95,40,485,0.15671641791044777,1.0
31,45,90,30,30,40,266,0.21929824561403508,50,50,40,50,40,64,294,0.45588235294117646,1.0
65,105,60,60,70,95,455,63.0,70,55,75,45,65,60,370,0.45901639344262296,1.0
70,100,70,105,75,40,460,0.23214285714285715,85,110,76,65,82,56,474,0.3933333333333333,1.0
65,90,122,58,75,84,494,0.71875,70,100,70,105,75,40,460,0.23214285714285715,1.0
75,90,140,60,60,40,465,0.3008130081300813,65,40,70,80,140,70,465,0.5954198473282443,0.25
71,82,64,64,59,112,452,0.9327731092436975,75,69,72,114,100,104,534,0.8253968253968254,1.0
90,95,105,165,110,45,610,0.2890625,60,100,85,80,85,100,510,0.7007874015748031,1.0
80,70,40,100,60,145,495,0.921875,255,10,10,75,135,55,540,0.3125,1.0
70,43,53,43,53,40,302,0.19090909090909092,60,50,70,50,90,65,385,0.39568345323741005,0.5
70,110,180,60,60,50,530,0.4117647058823529,65,100,70,80,80,105,500,0.8666666666666667,1.0
74,108,133,83,65,32,495,0.32142857142857145,60,90,55,90,80,110,485,0.8677685950413223,1.0
100,100,100,100,100,100,600,0.8602941176470589,100,50,80,60,80,50,420,0.34375,2.0
40,55,30,30,30,85,270,0.688,40,40,35,50,100,70,335,0.5031847133757962,1.0
40,55,30,30,30,60,245,0.43548387096774194,85,120,70,50,60,100,485,0.8308823529411765,1.0
70,43,53,43,53,40,302,0.19090909090909092,100,164,150,95,120,71,700,0.5645161290322581,0.5
55,84,105,114,75,52,485,0.2890625,25,20,15,105,55,90,310,0.32407407407407407,1.0
60,60,60,85,85,85,435,0.631578947368421,75,125,75,30,75,85,465,0.625,1.0
67,89,116,79,116,33,500,0.2624113475177305,78,104,78,159,115,100,634,0.8444444444444444,0.5
91,90,129,90,72,108,580,0.9140625,40,30,30,55,30,85,270,0.4666666666666667,0.25
40,60,40,40,40,30,250,0.0948905109489051,60,75,85,100,85,115,520,0.8992248062015504,2.0
160,110,65,65,110,30,540,0.35714285714285715,70,70,40,60,40,60,340,0.4247787610619469,1.0
76,48,48,57,62,34,325,0.11688311688311688,60,115,105,65,70,80,495,0.7181818181818181,1.0
45,30,40,105,50,20,290,0.031007751937984496,80,85,95,30,30,25,345,0.2857142857142857,2.0
70,60,70,87,78,85,450,0.6228070175438597,70,110,80,55,80,105,500,0.8794326241134752,0.25
95,145,130,120,90,120,700,0.9398496240601504,90,75,75,90,100,70,500,0.5462184873949579,1.0
160,110,65,65,110,30,540,0.35714285714285715,65,80,80,59,63,58,405,0.4411764705882353,1.0
60,75,100,55,80,50,420,0.3088235294117647,130,65,60,110,95,65,525,0.5227272727272727,0.5
55,81,60,50,70,97,413,0.7214285714285714,78,52,60,63,65,23,341,0.06015037593984962,1.0
65,90,50,85,45,55,390,0.371900826446281,31,45,90,30,30,40,266,0.21929824561403508,0.5
45,100,135,65,135,45,525,0.29411764705882354,40,45,65,100,120,90,460,0.5588235294117647,2.0
65,73,55,47,75,85,400,0.6846846846846847,80,70,65,80,120,100,515,0.8034188034188035,0.5
40,40,55,40,70,55,300,0.40939597315436244,100,120,120,150,100,90,680,0.7880794701986755,1.0
70,55,75,45,65,60,370,0.45901639344262296,50,180,20,180,20,150,600,0.9029850746268657,2.0
40,55,30,30,30,60,245,0.43548387096774194,190,33,58,33,58,33,405,0.13432835820895522,1.0
60,40,50,75,85,95,405,0.6044776119402985,62,55,52,109,94,109,481,0.7833333333333333,0.5
75,80,60,65,90,102,472,0.8625954198473282,70,84,70,65,70,51,410,0.2949640287769784,0.5
80,90,80,130,110,110,600,0.856,38,30,41,30,41,60,240,0.2897196261682243,1.0
40,65,40,80,40,65,330,0.5038167938931297,73,95,62,85,65,85,465,0.6666666666666666,1.0
80,185,115,40,105,75,600,0.6230769230769231,60,110,70,60,60,100,460,0.8461538461538461,0.5
60,30,30,36,56,50,262,0.32432432432432434,70,75,60,105,60,105,475,0.88,0.5
52,65,50,45,50,38,300,0.27419354838709675,50,92,108,92,108,35,485,0.2457627118644068,1.0
77,120,90,60,90,48,485,0.2785714285714286,40,40,35,50,100,70,335,0.5031847133757962,1.0
59,74,50,35,50,35,303,0.3125,105,150,90,150,90,95,680,0.8285714285714286,0.0
77,85,51,55,51,65,384,0.5163934426229508,106,110,90,154,90,130,680,0.926829268292683,2.0
75,90,50,110,80,95,500,0.7985611510791367,70,100,70,105,75,40,460,0.23214285714285715,0.5
56,61,65,48,45,38,313,0.17567567567567569,60,75,85,100,85,115,520,0.8992248062015504,2.0
48,61,40,61,40,50,300,0.2543859649122807,105,105,75,65,100,50,500,0.37593984962406013,0.25
55,130,115,50,50,75,475,0.5982142857142857,48,61,40,61,40,50,300,0.2543859649122807,1.0
78,104,78,159,115,100,634,0.8444444444444444,120,120,120,120,120,120,720,0.9344262295081968,1.0
75,125,230,55,95,30,610,0.3448275862068966,65,130,60,95,110,65,525,0.5303030303030303,1.0
120,120,120,120,120,120,720,0.9344262295081968,74,94,131,54,116,20,489,0.4485294117647059,0.5
65,125,60,95,60,105,510,0.9236641221374046,40,40,55,40,70,55,300,0.40939597315436244,0.5
40,45,35,65,55,70,310,0.4482758620689655,61,72,57,55,55,65,365,0.3984375,0.5
60,50,150,50,150,60,520,0.5206611570247934,70,70,70,70,70,70,420,0.5289256198347108,0.0
55,47,52,40,40,41,275,0.16806722689075632,84,71,43,71,43,48,360,0.25874125874125875,1.0
70,85,70,60,70,50,405,0.28378378378378377,74,94,131,54,116,20,489,0.4485294117647059,0.5
255,10,10,75,135,55,540,0.3125,105,150,90,150,90,95,680,0.8285714285714286,1.0
35,64,85,74,55,32,345,0.19827586206896552,49,66,70,44,55,51,335,0.4260869565217391,0.5
60,45,70,75,85,55,390,0.3008130081300813,70,50,30,95,135,105,485,0.8040540540540541,1.0
45,60,30,80,50,65,330,0.4603174603174603,89,124,80,55,80,55,483,0.5714285714285714,2.0
64,51,23,51,23,28,240,0.11363636363636363,80,82,100,83,100,80,525,0.6821705426356589,1.0
72,95,67,103,71,122,530,0.9606299212598425,100,75,115,90,115,85,580,0.6446280991735537,0.5
75,95,95,95,95,85,540,0.6470588235294118,90,90,85,125,90,100,580,0.768595041322314,1.0
45,65,34,40,34,45,263,0.2589928057553957,72,85,70,65,70,58,420,0.41304347826086957,0.5
89,125,90,115,80,101,600,0.8725490196078431,95,60,79,100,125,81,540,0.6201550387596899,1.0
90,92,75,92,85,60,494,0.49586776859504134,50,50,150,50,150,50,500,0.2571428571428571,2.0
30,56,35,25,35,72,253,0.48148148148148145,95,60,79,100,125,81,540,0.6201550387596899,1.0
77,59,50,67,63,46,362,0.23140495867768596,92,105,90,125,90,98,600,0.8217054263565892,2.0
50,53,62,58,63,44,330,0.13709677419354838,55,47,52,40,40,41,275,0.16806722689075632,1.0
30,105,90,25,25,50,325,0.2773722627737226,50,50,77,95,77,91,440,0.5916666666666667,1.0
45,30,15,85,65,65,305,0.36220472440944884,60,50,70,50,90,65,385,0.39568345323741005,2.0
110,135,60,50,65,88,508,0.7744360902255639,76,25,45,67,55,24,292,0.0390625,1.0
60,45,70,45,90,95,405,0.7304964539007093,75,85,200,55,65,30,510,0.16778523489932887,0.0
170,90,45,90,45,60,500,0.427536231884058,1,90,45,30,30,40,236,0.33064516129032256,1.0
65,125,100,55,70,85,500,0.6532258064516129,80,160,80,130,80,100,630,0.8455284552845529,0.25
40,80,35,35,45,70,305,0.4661016949152542,60,85,42,85,42,91,405,0.8227848101265823,1.0
70,92,65,80,55,98,460,0.8090909090909091,78,84,78,109,85,100,534,0.8620689655172413,2.0
55,55,55,85,55,30,335,0.1320754716981132,60,85,40,30,45,68,328,0.6422018348623854,2.0
75,80,60,65,90,102,472,0.8625954198473282,64,78,52,78,52,81,405,0.6422764227642277,1.0
123,77,72,99,92,58,521,0.4621212121212121,40,40,40,70,40,20,250,0.032520325203252036,1.0
110,65,75,125,85,30,490,0.15,73,76,75,81,100,100,505,0.8110236220472441,1.0
100,103,75,120,75,127,600,0.940677966101695,60,62,63,80,80,60,405,0.38016528925619836,0.5
62,44,50,44,50,55,305,0.3629032258064516,80,145,150,105,110,110,700,0.8692307692307693,0.5
60,45,70,45,90,95,405,0.7304964539007093,60,85,40,30,45,68,328,0.6422018348623854,0.0
49,55,42,42,37,85,310,0.6068376068376068,55,75,60,75,60,103,428,0.7982456140350878,1.0
64,51,23,51,23,28,240,0.11363636363636363,80,82,83,100,100,80,525,0.6742424242424242,1.0
65,70,60,65,65,115,440,0.8583333333333333,50,40,85,40,65,25,305,0.08870967741935484,1.0
38,41,40,50,65,65,299,0.4108527131782946,70,100,70,105,75,40,460,0.23214285714285715,0.5
55,104,105,94,75,52,485,0.36363636363636365,100,70,70,65,65,45,415,0.1897810218978102,1.0
70,60,125,115,70,55,495,0.35507246376811596,85,50,95,120,115,80,545,0.5793650793650794,2.0
35,65,35,65,35,65,300,0.46621621621621623,63,60,55,50,50,71,349,0.5289256198347108,1.0
106,150,70,194,120,140,780,0.952,85,120,70,50,60,100,485,0.8308823529411765,1.0
58,64,58,80,65,80,405,0.5423728813559322,50,75,70,35,70,48,348,0.29357798165137616,1.0
170,90,45,90,45,60,500,0.427536231884058,50,120,53,35,110,87,455,0.640625,1.0
55,70,40,60,40,40,305,0.26956521739130435,50,65,107,105,107,86,520,0.703125,0.5
50,92,108,92,108,35,485,0.2457627118644068,100,77,77,128,128,90,600,0.6901408450704225,0.0
85,60,65,135,105,100,550,0.7518248175182481,67,125,40,30,30,58,350,0.3431372549019608,0.5
61,72,57,55,55,65,365,0.3984375,80,85,95,30,30,25,345,0.2857142857142857,0.25
50,65,107,105,107,86,520,0.7313432835820896,40,60,40,40,40,30,250,0.0948905109489051,0.25
52,65,50,45,50,38,300,0.27419354838709675,100,128,90,77,77,128,600,0.959349593495935,0.5
91,90,106,130,106,77,600,0.648854961832061,45,53,70,40,60,42,310,0.25735294117647056,4.0
65,90,40,45,80,75,395,0.625,65,110,130,60,65,95,525,0.8278145695364238,4.0
100,164,150,95,120,71,700,0.5645161290322581,70,94,50,94,50,66,424,0.48148148148148145,4.0
100,70,70,65,65,45,415,0.1897810218978102,85,97,66,105,66,65,484,0.47107438016528924,1.0
59,74,50,35,50,35,303,0.3125,89,124,80,55,80,55,483,0.5714285714285714,2.0
68,75,53,83,113,60,452,0.45384615384615384,80,110,120,130,90,70,600,0.6198347107438017,1.0
90,60,70,75,70,45,410,0.23880597014925373,75,90,140,60,60,40,465,0.3008130081300813,0.5
35,55,35,30,30,35,220,0.23684210526315788,59,63,80,65,80,58,405,0.41843971631205673,1.0
83,106,65,86,65,85,490,0.6640625,54,63,52,83,56,97,405,0.7697841726618705,1.0
83,80,75,70,70,101,479,0.8615384615384616,64,115,65,83,63,65,455,0.5323741007194245,0.0
70,105,105,50,40,20,390,0.33587786259541985,64,115,65,83,63,65,455,0.5323741007194245,1.0
45,60,40,70,50,45,310,0.2846715328467153,100,50,80,60,80,50,420,0.34375,0.5
50,50,40,50,40,64,294,0.45588235294117646,70,55,95,95,110,65,490,0.48872180451127817,1.0
50,65,107,105,107,86,520,0.703125,90,100,90,125,85,90,580,0.7352941176470589,2.0
70,110,80,55,80,105,500,0.8794326241134752,40,65,95,60,45,35,340,0.13986013986013987,0.5
70,120,65,45,85,125,510,0.9747899159663865,89,125,90,115,80,101,600,0.8725490196078431,4.0
50,70,50,50,50,70,340,0.5645161290322581,75,90,50,110,80,95,500,0.7985611510791367,2.0
40,50,90,30,55,65,330,0.44680851063829785,65,65,60,110,95,130,525,0.9253731343283582,1.0
45,35,45,62,53,35,275,0.11851851851851852,75,87,63,87,63,98,473,0.865546218487395,1.0
60,60,40,65,45,35,305,0.15833333333333333,110,65,105,55,95,80,510,0.6258503401360545,0.0
50,45,45,35,35,50,260,0.23529411764705882,35,80,50,50,70,120,405,0.84375,1.0
30,80,90,55,45,55,355,0.4295774647887324,45,35,50,70,50,30,280,0.15753424657534246,0.5
48,61,40,61,40,50,300,0.2543859649122807,55,50,40,40,40,75,300,0.5945945945945946,2.0
73,95,62,85,65,85,465,0.6666666666666666,80,105,105,105,105,80,580,0.5939849624060151,1.0
65,65,60,130,95,110,525,0.823943661971831,35,55,40,50,50,90,320,0.6838235294117647,1.0
65,90,122,58,75,84,494,0.71875,70,110,80,55,80,105,500,0.8794326241134752,0.25
60,75,100,55,80,50,420,0.3088235294117647,20,25,45,70,90,60,310,0.30833333333333335,0.25
50,50,120,80,80,30,410,0.07258064516129033,100,134,110,95,100,61,600,0.4057971014492754,0.5
55,70,55,40,55,85,360,0.7073170731707317,46,57,40,40,40,50,273,0.25,1.0
40,65,95,60,45,35,340,0.13986013986013987,80,115,80,65,55,93,488,0.7846153846153846,1.0
45,25,50,25,25,35,205,0.13076923076923078,45,45,55,45,55,63,308,0.4594594594594595,4.0
45,63,37,65,55,95,360,0.8055555555555556,85,120,70,50,60,100,485,0.8308823529411765,2.0
55,45,43,55,43,72,313,0.5853658536585366,30,56,35,25,35,72,253,0.48148148148148145,1.0
40,70,130,60,130,25,455,0.17355371900826447,60,62,50,62,60,40,334,0.18181818181818182,1.0
50,53,48,53,48,64,316,0.46153846153846156,40,55,99,40,79,47,360,0.26262626262626265,2.0
105,180,100,180,100,115,780,0.9477611940298507,91,72,90,129,90,108,580,0.8620689655172413,2.0
190,33,58,33,58,33,405,0.13432835820895522,67,89,116,79,116,33,500,0.2624113475177305,0.25
35,35,40,35,55,50,250,0.40336134453781514,75,65,55,65,55,69,384,0.43548387096774194,4.0
100,77,77,128,128,90,600,0.6901408450704225,75,75,55,105,85,30,425,0.1619718309859155,1.0
40,65,95,60,45,35,340,0.13986013986013987,50,25,28,45,55,15,218,0.0625,2.0
43,70,48,50,60,38,309,0.2391304347826087,55,55,50,45,65,55,325,0.37373737373737376,0.0
100,100,90,150,140,90,670,0.71875,90,100,70,110,150,80,600,0.6037735849056604,0.5
60,40,80,60,45,40,325,0.23529411764705882,40,30,30,40,50,30,220,0.07936507936507936,1.0
85,80,90,105,95,60,515,0.49074074074074076,70,95,125,65,75,45,475,0.33613445378151263,0.5
50,75,45,40,45,60,315,0.4380165289256198,60,59,85,79,105,36,424,0.16666666666666666,2.0
41,56,40,62,44,71,314,0.568,40,40,55,40,70,55,300,0.40939597315436244,2.0
95,117,80,65,70,92,519,0.8409090909090909,75,75,130,75,130,95,580,0.7479674796747967,2.0
71,73,88,120,89,59,500,0.43537414965986393,55,45,43,55,43,72,313,0.5853658536585366,1.0
70,120,40,95,40,95,460,0.8106060606060606,30,30,30,30,30,30,180,0.12612612612612611,0.5
100,100,100,100,100,100,600,0.831858407079646,70,90,110,60,75,95,500,0.7333333333333333,0.0
60,45,50,90,80,70,395,0.625,10,55,25,35,45,95,265,0.5396825396825397,1.0
70,85,140,85,70,20,470,0.272,190,33,58,33,58,33,405,0.13432835820895522,1.0
50,20,40,20,40,20,190,0.0962962962962963,60,55,145,75,150,40,525,0.2,0.125
45,95,50,40,50,75,355,0.54,55,84,105,114,75,52,485,0.2890625,1.0
65,90,115,45,115,58,488,0.5041322314049587,40,80,100,30,30,20,300,0.11851851851851852,2.0
55,69,85,32,35,28,304,0.09302325581395349,35,35,35,35,35,35,210,0.13385826771653545,1.0
100,90,130,45,65,55,485,0.4253731343283582,75,98,63,98,63,101,498,0.849624060150376,0.5
50,47,50,57,50,65,319,0.463768115942029,130,70,35,70,35,60,400,0.4017857142857143,2.0
50,50,95,40,50,35,320,0.20279720279720279,60,40,50,75,85,95,405,0.6044776119402985,2.0
50,35,55,25,25,15,205,0.021739130434782608,50,85,85,55,55,50,380,0.3902439024390244,0.25
75,80,85,110,90,50,490,0.3548387096774194,80,45,65,90,110,80,470,0.5462962962962963,1.0
75,98,63,98,63,101,498,0.889763779527559,130,85,80,85,95,60,535,0.43884892086330934,1.0
35,40,100,90,55,35,355,0.1796875,52,65,55,58,62,60,352,0.4482758620689655,2.0
30,105,90,25,25,50,325,0.2773722627737226,89,145,90,105,80,91,600,0.8549618320610687,2.0
125,58,58,76,76,67,460,0.515625,116,55,85,107,95,29,487,0.06818181818181818,1.0
77,120,90,60,90,48,485,0.2785714285714286,60,85,60,85,60,55,405,0.3673469387755102,1.0
55,50,45,135,95,120,500,0.7714285714285715,35,80,50,50,70,120,405,0.84375,2.0
59,74,50,35,50,35,303,0.3125,83,80,80,135,80,121,579,0.9444444444444444,0.0
95,110,95,40,95,55,490,0.40336134453781514,90,132,105,132,105,30,594,0.4246575342465753,1.0
65,83,57,95,85,105,490,0.8914728682170543,55,55,85,65,85,35,380,0.2014388489208633,2.0
70,80,70,80,70,110,480,0.6594202898550725,100,150,110,95,110,70,635,0.5923076923076923,1.0
90,30,15,40,20,15,210,0.043478260869565216,80,50,100,100,200,50,580,0.2357142857142857,1.0
60,60,75,60,75,80,410,0.7321428571428571,55,65,95,95,45,85,440,0.6610169491525424,1.0
50,65,107,105,107,86,520,0.7313432835820896,60,90,140,50,50,40,430,0.2535211267605634,1.0
70,110,80,55,80,105,500,0.8794326241134752,80,145,150,105,110,110,700,0.8692307692307693,0.5
65,95,57,100,85,93,495,0.7441860465116279,95,145,130,120,90,120,700,0.9398496240601504,0.5
45,95,50,40,50,75,355,0.54,40,29,45,29,45,36,224,0.14634146341463414,2.0
54,78,103,53,45,22,355,0.23255813953488372,60,40,60,95,60,55,370,0.4222222222222222,4.0
55,68,64,45,55,31,318,0.11666666666666667,45,60,40,70,50,45,310,0.2846715328467153,0.5
60,65,80,170,95,130,600,0.8625954198473282,40,30,50,55,55,100,330,0.584070796460177,1.0
63,63,47,41,41,74,329,0.56,80,70,65,80,120,100,515,0.8034188034188035,0.5
58,109,112,48,48,109,484,0.8805970149253731,70,55,95,95,110,65,490,0.48872180451127817,2.0
65,150,40,15,80,145,495,0.9663865546218487,90,92,75,92,85,60,494,0.49586776859504134,4.0
50,20,40,20,40,20,190,0.0962962962962963,78,104,78,159,115,100,634,0.8444444444444444,0.5
80,85,95,30,30,25,345,0.2857142857142857,60,40,60,40,60,35,295,0.18055555555555555,0.5
70,110,180,60,60,50,530,0.4117647058823529,65,90,120,85,70,60,490,0.43410852713178294,1.0
95,109,105,75,85,56,525,0.34513274336283184,190,33,58,33,58,33,405,0.13432835820895522,1.0
60,150,50,150,50,60,520,0.5,65,130,60,75,60,75,465,0.689922480620155,0.5
50,50,95,40,50,35,320,0.20279720279720279,91,72,90,129,90,108,580,0.8925619834710744,1.0
60,55,90,145,90,80,520,0.6071428571428571,45,30,40,105,50,20,290,0.031007751937984496,2.0
80,135,130,95,90,70,600,0.5181818181818182,50,45,45,35,35,50,260,0.23529411764705882,1.0
100,100,100,100,100,100,600,0.8778625954198473,50,50,120,80,80,30,410,0.07258064516129033,0.25
62,50,58,73,54,72,369,0.4435483870967742,79,103,120,135,115,78,630,0.5763888888888888,0.5
92,105,90,125,90,98,600,0.8217054263565892,80,80,80,80,80,80,480,0.5606060606060606,1.0
74,108,133,83,65,32,495,0.32142857142857145,70,84,70,65,70,51,410,0.2949640287769784,2.0
55,70,45,70,50,60,350,0.45,100,180,160,150,90,90,770,0.7520661157024794,0.5
75,80,60,65,90,102,472,0.8625954198473282,65,83,57,95,85,105,490,0.8914728682170543,1.0
90,100,60,90,60,80,480,0.6422764227642277,60,50,70,50,90,65,385,0.39568345323741005,0.25
54,66,70,44,55,46,335,0.4214876033057851,50,65,107,105,107,86,520,0.7313432835820896,0.5
70,140,230,60,80,50,630,0.32432432432432434,85,110,90,45,90,80,500,0.6206896551724138,1.0
70,60,125,115,70,55,495,0.35507246376811596,54,66,70,44,55,46,335,0.4214876033057851,0.5
90,132,105,132,105,30,594,0.4246575342465753,78,84,78,109,85,100,534,0.8646616541353384,0.25
45,40,60,40,75,50,310,0.2926829268292683,40,45,65,100,120,90,460,0.5588235294117647,1.0
60,90,140,50,50,40,430,0.2535211267605634,60,50,100,85,70,65,430,0.47580645161290325,1.0
100,100,80,60,60,50,450,0.3050847457627119,68,72,78,38,42,32,330,0.23809523809523808,2.0
115,45,20,45,25,20,270,0.11538461538461539,80,85,95,30,30,25,345,0.2857142857142857,0.5
60,40,80,60,45,40,325,0.23529411764705882,78,52,60,63,65,23,341,0.06015037593984962,1.0
74,108,133,83,65,32,495,0.32142857142857145,44,38,39,61,79,42,303,0.2251655629139073,1.0
65,63,45,45,45,45,308,0.2595419847328244,55,104,105,94,75,52,485,0.36363636363636365,0.5
80,80,80,55,55,90,440,0.6417910447761194,45,50,55,75,65,30,320,0.06293706293706294,1.0
90,85,75,115,100,115,580,0.9381443298969072,79,115,70,125,80,111,580,0.864,1.0
70,60,62,80,82,60,414,0.4375,83,80,75,70,70,101,479,0.8615384615384616,0.5
80,92,65,65,80,68,450,0.4824561403508772,84,71,43,71,43,48,360,0.25874125874125875,1.0
100,128,90,77,77,128,600,0.959349593495935,20,40,90,30,90,25,295,0.11363636363636363,0.0
70,75,80,135,80,135,575,0.917910447761194,40,45,35,40,40,90,290,0.65,1.0
60,90,70,60,120,40,440,0.27419354838709675,50,50,120,80,80,30,410,0.07258064516129033,0.5
72,58,80,103,80,97,490,0.7171052631578947,80,160,60,170,130,80,680,0.6180555555555556,0.0
50,95,90,95,90,180,600,0.9172413793103448,110,135,60,50,65,88,508,0.7744360902255639,1.0
58,70,45,40,45,42,300,0.25925925925925924,60,85,69,65,79,80,438,0.576,2.0
255,10,10,75,135,55,540,0.3125,74,94,131,54,116,20,489,0.4485294117647059,0.5
70,90,70,60,60,70,420,0.6390977443609023,55,50,40,40,40,75,300,0.5945945945945946,1.0
55,55,45,63,45,45,308,0.25,35,55,40,50,50,90,320,0.6838235294117647,1.0
100,128,90,77,77,128,600,0.959349593495935,45,60,30,80,50,65,330,0.4603174603174603,2.0
80,145,150,105,110,110,700,0.8692307692307693,48,61,40,61,40,50,300,0.2543859649122807,2.0
75,80,55,25,35,35,305,0.18666666666666668,73,95,62,85,65,85,465,0.6666666666666666,2.0
80,80,80,80,80,80,480,0.5606060606060606,55,45,50,45,65,80,340,0.5546218487394958,0.5
45,30,50,65,50,45,285,0.13821138211382114,60,55,90,145,90,80,520,0.6071428571428571,1.0
95,65,65,110,130,60,525,0.4016393442622951,40,27,60,37,50,66,280,0.36220472440944884,1.0
30,40,55,40,55,60,280,0.3237410071942446,30,40,70,70,25,60,295,0.41353383458646614,1.0
63,120,85,90,55,55,468,0.2809917355371901,86,68,72,109,66,106,507,0.8099173553719008,2.0
50,75,75,65,65,50,380,0.4049586776859504,85,76,64,45,55,90,415,0.6739130434782609,0.0
85,110,76,65,82,56,474,0.3933333333333333,95,125,79,60,100,81,540,0.6165413533834586,1.0
126,131,95,131,98,99,680,0.8102189781021898,86,92,88,68,75,73,482,0.6835443037974683,1.0
60,60,60,85,85,85,435,0.631578947368421,60,60,50,40,50,75,335,0.5882352941176471,0.0
30,40,55,40,55,60,280,0.3237410071942446,85,60,65,135,105,100,550,0.7518248175182481,0.5
90,50,34,60,44,70,348,0.6283185840707964,70,65,60,90,75,90,450,0.6571428571428571,2.0
44,75,35,63,33,45,295,0.2647058823529412,75,110,110,110,105,80,590,0.656934306569343,1.0
40,40,55,40,70,55,300,0.40939597315436244,130,65,60,110,95,65,525,0.5227272727272727,1.0
65,155,120,65,90,105,600,0.8677685950413223,70,60,70,87,78,85,450,0.6228070175438597,4.0
50,80,95,10,45,10,290,0.232,70,140,70,110,65,105,560,0.95,1.0
40,30,35,45,40,55,245,0.31496062992125984,86,81,97,81,107,43,495,0.203125,1.0
45,50,55,75,65,30,320,0.06293706293706294,45,30,50,55,65,45,290,0.208,1.0
65,90,122,58,75,84,494,0.71875,40,27,60,37,50,66,280,0.36220472440944884,0.5
103,60,126,80,126,50,545,0.36363636363636365,60,50,70,80,80,140,480,0.8449612403100775,1.0
75,90,90,140,90,115,600,0.9481481481481482,41,50,37,50,37,66,281,0.5175438596491229,0.5
65,75,90,97,123,44,494,0.1987179487179487,50,60,60,60,60,30,320,0.11290322580645161,0.5
65,40,50,125,60,30,370,0.07258064516129033,50,53,48,53,48,64,316,0.46153846153846156,1.0
59,74,50,35,50,35,303,0.3125,60,130,80,60,60,70,460,0.5153846153846153,0.5
45,63,37,65,55,95,360,0.8055555555555556,95,65,65,110,130,60,525,0.4016393442622951,1.0
70,105,105,50,40,20,390,0.33587786259541985,100,150,140,100,90,90,670,0.7969924812030075,0.5
78,52,60,63,65,23,341,0.06015037593984962,55,85,55,50,55,60,360,0.4233576642335766,0.5
70,105,105,50,40,20,390,0.33587786259541985,45,75,60,40,30,50,300,0.304,1.0
85,120,70,50,60,100,485,0.8308823529411765,105,95,75,85,75,74,509,0.5714285714285714,1.0
89,145,90,105,80,91,600,0.8549618320610687,75,70,90,70,105,80,490,0.656,0.0
50,20,40,20,40,20,190,0.0962962962962963,58,50,145,95,105,30,483,0.2459016393442623,0.0
85,105,100,79,83,78,530,0.5869565217391305,50,55,50,36,30,43,264,0.2922077922077922,1.0
50,35,55,25,25,15,205,0.05263157894736842,250,5,5,35,105,50,450,0.15306122448979592,1.0
50,50,40,30,30,50,250,0.2781954887218045,85,80,70,135,75,90,535,0.7006802721088435,1.0
63,120,85,90,55,55,468,0.2809917355371901,70,85,70,60,70,50,405,0.28378378378378377,1.0
70,120,40,95,40,95,460,0.8106060606060606,35,20,65,40,65,20,245,0.02459016393442623,0.5
85,80,90,105,95,60,515,0.49074074074074076,108,130,95,80,85,102,600,0.7637795275590551,1.0
123,77,72,99,92,58,521,0.4621212121212121,60,60,75,60,75,80,410,0.7321428571428571,0.5
60,62,50,62,60,40,334,0.18181818181818182,50,85,85,55,55,50,380,0.3902439024390244,0.25
70,70,40,60,40,60,340,0.4247787610619469,108,170,115,120,95,92,700,0.7083333333333334,1.0
75,125,100,70,80,45,495,0.33035714285714285,35,40,100,90,55,35,355,0.1796875,1.0
45,90,20,65,20,65,305,0.5116279069767442,35,46,34,35,45,20,215,0.072,1.0
70,80,102,80,102,40,474,0.2677165354330709,75,75,130,75,130,95,580,0.7479674796747967,2.0
70,84,70,65,70,51,410,0.2949640287769784,73,100,60,100,60,65,458,0.42657342657342656,2.0
70,75,60,105,60,105,475,0.88,80,120,130,55,65,45,495,0.37037037037037035,0.0
95,124,78,69,71,58,495,0.37398373983739835,30,105,90,25,25,50,325,0.2773722627737226,1.0
90,30,15,40,20,15,210,0.043478260869565216,60,60,75,60,75,80,410,0.7321428571428571,2.0
70,84,70,65,70,51,410,0.2949640287769784,45,20,50,60,120,50,345,0.24074074074074073,0.0
100,123,75,57,75,80,510,0.6923076923076923,45,49,65,49,65,45,318,0.275,2.0
110,123,65,100,65,65,528,0.5217391304347826,40,40,40,70,40,20,250,0.032520325203252036,0.5
100,100,100,100,100,100,600,0.8778625954198473,50,20,40,20,40,20,190,0.0962962962962963,1.0
54,63,52,83,56,97,405,0.7697841726618705,75,70,90,70,105,80,490,0.656,0.5
20,10,55,15,20,80,200,0.17985611510791366,90,132,105,132,105,30,594,0.4246575342465753,0.5
50,75,45,40,45,60,315,0.4380165289256198,50,60,45,100,80,65,400,0.45689655172413796,1.0
45,50,43,40,38,62,278,0.40441176470588236,35,40,100,90,55,35,355,0.1796875,0.25
60,40,50,75,85,95,405,0.6044776119402985,65,150,40,15,80,145,495,0.9663865546218487,1.0
40,40,50,30,30,30,220,0.0873015873015873,65,65,60,110,95,130,525,0.9253731343283582,1.0
40,55,70,45,60,30,300,0.10619469026548672,40,45,40,35,35,56,251,0.373015873015873,1.0
35,60,44,40,54,55,288,0.366412213740458,45,50,55,75,65,30,320,0.06293706293706294,1.0
103,60,86,60,86,50,445,0.3458646616541353,50,50,150,50,150,50,500,0.2571428571428571,0.5
58,109,112,48,48,109,484,0.8805970149253731,59,110,150,45,49,35,448,0.3333333333333333,0.125
95,70,73,95,90,60,483,0.3983739837398374,41,50,37,50,37,66,281,0.5175438596491229,2.0
100,77,77,128,128,90,600,0.6901408450704225,60,40,80,60,45,40,325,0.23529411764705882,0.5
100,150,140,100,90,90,670,0.7969924812030075,65,63,45,45,45,45,308,0.2595419847328244,2.0
55,55,55,85,55,30,335,0.1320754716981132,45,65,34,40,34,45,263,0.2589928057553957,1.0
30,42,118,42,88,30,350,0.112,45,49,49,65,65,45,318,0.2781954887218045,1.0
60,60,60,60,60,60,360,0.38095238095238093,44,75,35,63,33,45,295,0.2647058823529412,0.0
60,55,90,145,90,80,520,0.6071428571428571,75,125,100,70,80,45,495,0.33035714285714285,1.0
60,85,49,60,49,60,363,0.4444444444444444,50,85,40,85,40,35,335,0.1746031746031746,0.5
60,65,80,170,95,130,600,0.8625954198473282,82,121,119,69,59,71,521,0.5394736842105263,0.5
70,60,62,80,82,60,414,0.4375,64,78,52,78,52,81,405,0.6422764227642277,0.5
67,125,40,30,30,58,350,0.3431372549019608,79,103,120,135,115,78,630,0.5763888888888888,1.0
95,23,48,23,48,23,260,0.046153846153846156,65,47,55,73,75,85,400,0.65,1.0
55,85,55,50,55,60,360,0.4233576642335766,100,100,100,100,100,100,600,0.8345864661654135,8.0
50,105,125,55,95,50,480,0.375886524822695,75,100,63,80,63,116,497,0.9345794392523364,0.5
80,120,130,55,65,45,495,0.37037037037037035,80,70,40,100,60,145,495,0.921875,1.0
105,130,120,45,45,40,485,0.4444444444444444,67,58,57,81,67,101,431,0.8790322580645161,2.0
70,65,65,55,55,70,380,0.5,85,105,85,40,50,40,405,0.211864406779661,1.0
45,50,55,75,65,30,320,0.06293706293706294,100,100,90,150,140,90,670,0.71875,2.0
40,70,130,60,130,25,455,0.17355371900826447,86,68,72,109,66,106,507,0.8099173553719008,0.0
46,87,60,30,40,57,320,0.37777777777777777,35,70,55,45,55,25,285,0.09420289855072464,1.0
150,100,120,100,120,90,680,0.6666666666666666,250,5,5,35,105,50,450,0.15306122448979592,0.0
75,89,85,55,65,36,405,0.29545454545454547,160,110,65,65,110,30,540,0.35714285714285715,1.0
73,76,75,81,100,100,505,0.8110236220472441,70,70,115,130,90,60,535,0.5338983050847458,2.0
55,75,85,25,25,15,280,0.1875,55,40,85,80,105,40,405,0.23622047244094488,2.0
90,92,87,75,85,76,505,0.5409836065573771,50,70,50,50,50,70,340,0.5645161290322581,0.5
58,70,45,40,45,42,300,0.25925925925925924,40,30,30,40,50,30,220,0.07936507936507936,0.5
80,70,40,100,60,145,495,0.921875,45,55,45,65,45,75,330,0.5692307692307692,0.5
60,25,35,70,80,60,330,0.3076923076923077,60,90,140,50,50,40,430,0.2535211267605634,0.5
65,80,140,40,70,70,465,0.5223880597014925,95,100,85,108,70,70,528,0.5652173913043478,0.5
80,110,60,150,130,70,600,0.5042016806722689,60,50,70,80,80,140,480,0.8449612403100775,1.0
20,15,20,10,55,80,200,0.2682926829268293,40,60,40,40,40,30,250,0.0948905109489051,1.0
55,85,55,50,55,60,360,0.4233576642335766,65,60,70,85,75,40,395,0.1796875,1.0
60,115,105,65,70,80,495,0.7181818181818181,110,78,73,76,71,60,468,0.3333333333333333,0.5
60,67,85,77,75,116,480,0.8888888888888888,73,115,60,60,60,90,458,0.6694915254237288,1.0
106,150,70,194,120,140,780,0.952,65,75,105,35,65,85,430,0.6940298507462687,2.0
55,85,122,58,75,99,494,0.8099173553719008,88,107,122,74,75,64,530,0.4596774193548387,0.5
95,110,95,40,95,55,490,0.40336134453781514,28,25,25,45,35,40,198,0.16083916083916083,1.0
50,75,70,35,70,48,348,0.29357798165137616,70,140,230,60,80,50,630,0.32432432432432434,2.0
70,140,70,110,65,105,560,0.95,80,100,70,50,60,45,405,0.25806451612903225,0.5
114,85,70,85,80,30,464,0.2066115702479339,65,90,40,45,80,75,395,0.625,0.125
114,85,70,85,80,30,464,0.2066115702479339,30,42,118,42,88,30,350,0.112,0.0
30,45,55,70,55,85,340,0.5633802816901409,100,90,130,45,65,55,485,0.4253731343283582,1.0
75,105,75,105,75,45,480,0.3274336283185841,50,35,55,25,25,15,205,0.05263157894736842,1.0
75,100,95,40,70,110,490,0.8717948717948718,86,92,88,68,75,73,482,0.6835443037974683,1.0
50,55,50,36,30,43,264,0.2922077922077922,60,70,50,100,50,65,395,0.5217391304347826,2.0
55,68,64,45,55,31,318,0.11666666666666667,55,75,50,40,40,80,340,0.6302521008403361,0.5
100,50,50,76,96,70,442,0.5,120,120,120,120,120,120,720,0.9344262295081968,1.0
50,160,110,160,110,110,700,0.8854961832061069,73,76,75,81,100,100,505,0.8110236220472441,1.0
60,52,168,47,138,30,495,0.19834710743801653,30,105,90,25,25,50,325,0.2773722627737226,0.5
55,84,105,114,75,52,485,0.2890625,100,100,100,100,100,100,600,0.831858407079646,1.0
120,100,85,30,85,45,465,0.22448979591836735,85,80,90,105,95,60,515,0.49074074074074076,2.0
95,145,130,120,90,120,700,0.9398496240601504,44,48,65,50,64,43,314,0.1623931623931624,1.0
60,130,80,60,60,70,460,0.5153846153846153,64,88,50,88,50,106,446,0.9111111111111111,2.0
110,135,60,50,65,88,508,0.7744360902255639,70,75,60,105,60,105,475,0.88,1.0
76,65,45,92,42,91,411,0.7449664429530202,105,180,100,180,100,115,780,0.9477611940298507,1.0
100,103,75,120,75,127,600,0.940677966101695,65,65,60,110,95,130,525,0.9253731343283582,0.5
30,40,55,40,55,60,280,0.3237410071942446,50,120,53,35,110,87,455,0.640625,1.0
30,80,90,55,45,55,355,0.4295774647887324,68,75,53,83,113,60,452,0.45384615384615384,0.5
75,89,85,55,65,36,405,0.29545454545454547,60,70,50,100,50,65,395,0.5217391304347826,0.25
69,69,76,69,86,91,460,0.6554621848739496,65,80,65,35,65,60,370,0.38405797101449274,1.0
80,82,78,95,80,85,500,0.6869565217391305,125,120,90,170,100,95,700,0.78125,0.5
75,100,95,40,70,110,490,0.8717948717948718,110,130,80,70,60,80,530,0.5862068965517241,1.0
78,130,111,130,85,100,634,0.8561151079136691,70,65,65,55,55,70,380,0.5,1.0
78,104,78,159,115,100,634,0.8444444444444444,115,140,130,55,55,40,535,0.4519230769230769,0.25
85,56,77,50,77,78,423,0.53125,80,120,80,120,80,100,580,0.8478260869565217,1.0
57,24,86,24,86,23,300,0.12727272727272726,95,135,80,110,80,100,600,0.8248175182481752,1.0
105,140,95,55,65,45,505,0.3,110,80,90,95,90,65,530,0.5033557046979866,2.0
69,69,76,69,86,91,460,0.6554621848739496,100,150,110,95,110,70,635,0.5923076923076923,1.0
65,80,65,35,65,60,370,0.38405797101449274,100,100,100,100,100,100,600,0.8345864661654135,1.0
57,24,86,24,86,23,300,0.12727272727272726,50,80,95,10,45,10,290,0.232,2.0
55,81,60,50,70,97,413,0.7214285714285714,58,64,58,80,65,80,405,0.609271523178808,1.0
41,50,37,50,37,66,281,0.5175438596491229,50,180,20,180,20,150,600,0.9029850746268657,2.0
83,80,80,135,80,121,579,0.9444444444444444,50,50,150,50,150,50,500,0.2571428571428571,0.25
67,82,62,46,48,43,348,0.22033898305084745,75,100,110,45,55,65,450,0.5333333333333333,1.0
120,70,120,75,130,85,600,0.6694915254237288,50,48,43,46,41,60,288,0.47297297297297297,2.0
60,50,70,80,80,140,480,0.8449612403100775,106,90,130,90,154,110,680,0.8699186991869918,2.0
85,90,80,70,80,130,535,0.9262295081967213,62,48,66,59,57,49,341,0.33884297520661155,2.0
116,55,85,107,95,29,487,0.06818181818181818,65,60,70,85,75,40,395,0.1796875,1.0
120,120,120,120,120,120,720,0.9344262295081968,70,62,67,55,55,56,365,0.38513513513513514,1.0
73,115,60,60,60,90,458,0.6694915254237288,70,70,40,60,40,60,340,0.4247787610619469,1.0
69,55,45,55,55,15,294,0.11666666666666667,74,100,72,90,72,46,454,0.24561403508771928,1.0
70,20,50,20,50,40,250,0.1557377049180328,35,85,45,35,35,75,310,0.6492537313432836,1.0
92,105,90,125,90,98,600,0.8217054263565892,57,80,91,80,87,75,470,0.5737704918032787,0.0
75,125,230,55,95,30,610,0.3448275862068966,60,62,50,62,60,40,334,0.18181818181818182,1.0
125,170,100,120,90,95,700,0.77,45,50,43,40,38,62,278,0.40441176470588236,2.0
65,47,55,73,75,85,400,0.65,85,115,80,105,80,50,515,0.3063063063063063,1.0
55,70,40,60,40,40,305,0.26956521739130435,75,100,95,40,70,110,490,0.8717948717948718,1.0
72,60,30,20,30,25,237,0.11570247933884298,74,48,76,83,81,104,466,0.7913043478260869,0.5
95,80,105,40,70,100,490,0.8046875,66,117,70,40,50,67,410,0.4573643410852713,1.0
53,54,53,37,46,45,288,0.3090909090909091,80,130,100,160,120,110,700,0.8981481481481481,1.0
75,69,72,114,100,104,534,0.8253968253968254,70,92,65,80,55,98,460,0.8090909090909091,0.5
40,50,45,70,45,70,320,0.5517241379310345,55,55,55,85,55,30,335,0.1320754716981132,0.5
75,80,60,65,90,102,472,0.8625954198473282,70,62,67,55,55,56,365,0.38513513513513514,1.0
80,45,65,90,110,80,470,0.5462962962962963,104,91,63,91,73,68,490,0.5118110236220472,1.0
40,80,35,35,45,70,305,0.4661016949152542,86,92,88,68,75,73,482,0.6835443037974683,1.0
40,55,30,30,30,85,270,0.688,90,100,70,110,150,80,600,0.6037735849056604,1.0
100,100,100,100,100,100,600,0.8602941176470589,50,65,107,105,107,86,520,0.7313432835820896,0.5
65,90,65,61,61,100,442,0.8373983739837398,90,85,100,95,125,85,580,0.6834532374100719,1.0
48,72,48,72,48,48,336,0.25984251968503935,55,47,52,40,40,41,275,0.16806722689075632,2.0
50,30,55,65,55,20,275,0.13675213675213677,70,90,110,60,75,95,500,0.7333333333333333,0.5
60,70,65,125,105,90,515,0.6911764705882353,55,68,64,45,55,31,318,0.11666666666666667,1.0
73,76,75,81,100,100,505,0.8110236220472441,75,90,50,110,80,95,500,0.7985611510791367,0.5
60,70,65,125,105,90,515,0.6911764705882353,70,60,62,80,82,60,414,0.4375,0.25
95,125,79,60,100,81,540,0.6165413533834586,55,69,85,32,35,28,304,0.09302325581395349,1.0
100,100,100,100,100,100,600,0.8778625954198473,100,70,70,65,65,45,415,0.1897810218978102,1.0
65,50,70,95,80,65,425,0.4262295081967213,80,90,80,130,110,110,600,0.856,0.5
75,98,63,98,63,101,498,0.8091603053435115,80,70,70,90,100,70,480,0.5609756097560976,1.0
135,85,40,40,85,5,390,0.6864406779661016,44,50,91,24,86,10,305,0.1981981981981982,0.5
55,35,50,55,110,85,390,0.6277372262773723,70,62,67,55,55,56,365,0.38513513513513514,0.5
40,30,35,50,70,55,280,0.28205128205128205,85,90,80,70,80,130,535,0.9262295081967213,0.125
60,40,60,40,60,35,295,0.18055555555555555,75,140,65,112,65,110,567,0.9140625,1.0
68,125,65,65,115,80,518,0.6277372262773723,40,45,35,65,55,70,310,0.4482758620689655,1.0
116,55,85,107,95,29,487,0.06818181818181818,55,112,45,74,45,70,401,0.559322033898305,1.0
75,95,95,95,95,85,540,0.6470588235294118,110,65,105,55,95,80,510,0.6258503401360545,1.0
111,83,68,92,82,39,475,0.1774193548387097,86,81,97,81,107,43,495,0.203125,1.0
75,98,63,98,63,101,498,0.8091603053435115,75,75,55,105,85,30,425,0.1619718309859155,0.5
60,60,60,60,60,60,360,0.38095238095238093,60,75,85,100,85,115,520,0.8992248062015504,1.0
70,65,65,55,55,70,380,0.5,50,55,50,36,30,43,264,0.2922077922077922,1.0
50,95,90,95,90,180,600,0.9172413793103448,40,60,40,40,40,30,250,0.0948905109489051,2.0
108,170,115,120,95,92,700,0.7083333333333334,62,77,62,50,42,65,358,0.4838709677419355,0.0
46,57,40,40,40,50,273,0.25,65,65,45,75,45,95,390,0.72,1.0
85,110,76,65,82,56,474,0.3933333333333333,40,45,40,65,40,65,295,0.5661764705882353,1.0
83,80,75,70,70,101,479,0.8615384615384616,95,95,85,125,65,55,520,0.3894736842105263,2.0
126,131,95,131,98,99,680,0.8102189781021898,75,75,55,105,85,30,425,0.1619718309859155,2.0
50,30,55,65,55,20,275,0.13675213675213677,60,80,50,40,40,30,300,0.15328467153284672,1.0
40,45,35,40,40,90,290,0.65,50,120,53,35,110,87,455,0.640625,1.0
55,112,45,74,45,70,401,0.559322033898305,86,81,97,81,107,43,495,0.203125,1.0
60,65,80,170,95,130,600,0.8625954198473282,65,75,105,35,65,85,430,0.6940298507462687,0.5
60,60,60,35,35,30,280,0.11194029850746269,90,75,85,115,90,55,510,0.3445378151260504,1.0
40,45,40,62,60,60,307,0.33884297520661155,65,55,115,100,40,60,435,0.3798449612403101,2.0
65,63,45,45,45,45,308,0.2595419847328244,52,65,50,45,50,38,300,0.27419354838709675,0.5
85,100,122,58,75,54,494,0.3939393939393939,78,84,78,109,85,100,534,0.8620689655172413,0.5
48,72,48,72,48,48,336,0.25984251968503935,40,20,30,40,80,55,265,0.22764227642276422,1.0
55,65,35,60,30,85,330,0.6126126126126126,255,10,10,75,135,55,540,0.3125,1.0
55,35,50,55,110,85,390,0.6277372262773723,75,123,67,95,85,95,540,0.7642276422764228,0.5
65,95,75,55,55,85,430,0.6933333333333334,59,110,150,45,49,35,448,0.3333333333333333,0.0
54,78,103,53,45,22,355,0.23255813953488372,85,76,64,45,55,90,415,0.6739130434782609,1.0
60,67,85,77,75,116,480,0.8888888888888888,85,105,100,79,83,78,530,0.5869565217391305,2.0
70,80,65,90,65,85,455,0.578125,126,131,95,131,98,99,680,0.8294573643410853,1.0
40,40,40,70,40,20,250,0.032520325203252036,100,50,50,76,96,70,442,0.5,1.0
40,60,40,40,40,30,250,0.0948905109489051,45,65,34,40,34,45,263,0.2589928057553957,1.0
43,30,55,40,65,97,330,0.6030534351145038,100,100,80,60,60,50,450,0.3050847457627119,2.0
50,70,50,50,50,70,340,0.5645161290322581,83,80,80,135,80,121,579,0.9444444444444444,0.0
70,65,65,55,55,70,380,0.5,65,65,60,130,95,110,525,0.823943661971831,1.0
70,55,65,95,85,70,440,0.5307692307692308,150,120,100,120,100,90,680,0.664179104477612,1.0
75,65,55,65,55,69,384,0.43548387096774194,60,85,49,60,49,60,363,0.4444444444444444,2.0
35,55,35,30,30,35,220,0.23684210526315788,55,85,122,58,75,99,494,0.8099173553719008,2.0
50,35,55,25,25,15,205,0.021739130434782608,60,85,69,65,79,80,438,0.576,0.5
80,120,130,55,65,45,495,0.37037037037037035,80,82,100,83,100,80,525,0.6821705426356589,0.5
45,50,43,40,38,62,278,0.40441176470588236,50,75,70,35,70,48,348,0.29357798165137616,2.0
75,98,63,98,63,101,498,0.8091603053435115,110,65,75,125,85,30,490,0.15,1.0
40,60,40,40,40,30,250,0.0948905109489051,65,100,70,80,80,105,500,0.8666666666666667,0.5
70,20,50,20,50,40,250,0.1557377049180328,75,75,60,83,60,60,413,0.39344262295081966,0.5
70,85,70,60,70,50,405,0.28378378378378377,49,55,42,42,37,85,310,0.6068376068376068,1.0
60,50,50,60,70,50,340,0.28346456692913385,65,75,70,95,70,95,470,0.7272727272727273,0.5
40,45,40,35,35,56,251,0.373015873015873,110,65,75,125,85,30,490,0.15,1.0
71,73,88,120,89,59,500,0.43537414965986393,95,117,184,44,46,28,514,0.2975206611570248,1.0
54,78,103,53,45,22,355,0.23255813953488372,60,100,115,70,85,90,520,0.7557251908396947,0.5
59,59,58,90,70,73,409,0.5826086956521739,50,105,125,55,95,50,480,0.375886524822695,2.0
85,97,66,105,66,65,484,0.47107438016528924,39,52,43,60,50,65,309,0.49107142857142855,0.5
50,20,55,25,25,30,205,0.09774436090225563,75,55,70,55,95,110,460,0.8444444444444444,1.0
60,70,65,125,105,90,515,0.6911764705882353,100,150,120,120,100,90,680,0.6493506493506493,0.5
45,75,60,40,30,50,300,0.304,38,30,41,30,41,60,240,0.2897196261682243,1.0
75,75,55,105,85,30,425,0.1619718309859155,60,30,30,36,56,50,262,0.32432432432432434,0.5
100,73,83,73,83,55,467,0.371900826446281,100,50,80,60,80,50,420,0.34375,2.0
80,110,120,130,90,70,600,0.6198347107438017,80,100,70,60,70,95,475,0.7416666666666667,1.0
100,120,100,150,120,90,680,0.728,60,60,40,65,45,35,305,0.15833333333333333,0.5
74,108,133,83,65,32,495,0.32142857142857145,59,110,150,45,49,35,448,0.3333333333333333,0.5
125,130,90,130,90,95,660,0.7734375,50,160,110,160,110,110,700,0.8854961832061069,0.0
70,85,140,85,70,20,470,0.272,91,129,90,72,90,108,580,0.8536585365853658,0.5
65,60,110,130,95,65,525,0.47761194029850745,75,98,63,98,63,101,498,0.8091603053435115,2.0
50,85,85,55,55,50,380,0.3902439024390244,55,50,65,175,95,150,590,0.7818181818181819,1.0
64,165,75,93,83,75,555,0.6587301587301587,55,45,43,55,43,72,313,0.5853658536585366,2.0
100,50,80,60,80,50,420,0.34375,70,85,70,60,70,50,405,0.28378378378378377,1.0
50,95,90,95,90,180,600,0.9172413793103448,95,80,105,40,70,100,490,0.8046875,1.0
100,164,150,95,120,71,700,0.5645161290322581,40,20,30,40,80,55,265,0.22764227642276422,4.0
95,70,73,95,90,60,483,0.3983739837398374,58,70,45,40,45,42,300,0.25925925925925924,2.0
90,60,70,75,70,45,410,0.23880597014925373,70,77,60,97,60,108,472,0.8394160583941606,1.0
80,75,150,75,150,50,580,0.30973451327433627,48,61,40,61,40,50,300,0.2543859649122807,1.0
30,45,59,30,39,57,260,0.2803030303030303,70,110,180,60,60,50,530,0.4117647058823529,0.0
55,112,45,74,45,70,401,0.559322033898305,72,95,67,103,71,122,530,0.9606299212598425,1.0
115,45,20,45,25,20,270,0.11538461538461539,50,20,40,20,40,20,190,0.0962962962962963,1.0
45,30,50,65,50,45,285,0.13821138211382114,80,120,80,120,80,100,580,0.8478260869565217,1.0
70,110,180,60,60,50,530,0.4117647058823529,50,85,85,55,55,50,380,0.3902439024390244,0.125
40,55,30,30,30,85,270,0.688,108,130,95,80,85,102,600,0.7637795275590551,1.0
55,55,85,65,85,35,380,0.2014388489208633,85,76,64,45,55,90,415,0.6739130434782609,1.0
60,85,60,85,60,55,405,0.3673469387755102,75,95,60,65,60,115,470,0.8778625954198473,2.0
70,100,115,30,65,30,410,0.24390243902439024,80,50,100,100,200,50,580,0.2357142857142857,2.0
35,46,34,35,45,20,215,0.072,50,50,50,50,50,50,300,0.30708661417322836,1.0
80,105,65,60,75,130,515,0.9645390070921985,41,64,45,50,50,50,300,0.36752136752136755,1.0
50,120,53,35,110,87,455,0.640625,100,100,80,60,60,50,450,0.3050847457627119,2.0
40,50,45,70,45,70,320,0.5517241379310345,44,38,33,61,43,70,289,0.5267857142857143,0.5
40,70,130,60,130,25,455,0.17355371900826447,108,100,121,81,95,95,600,0.7476635514018691,1.0
60,40,60,40,60,35,295,0.18055555555555555,108,130,95,80,85,102,600,0.7637795275590551,1.0
90,50,34,60,44,70,348,0.6283185840707964,170,90,45,90,45,60,500,0.427536231884058,1.0
65,90,120,85,70,60,490,0.43410852713178294,70,75,80,135,80,135,575,0.917910447761194,1.0
60,90,70,60,120,40,440,0.27419354838709675,75,85,200,55,65,30,510,0.16778523489932887,0.5
60,90,70,60,120,40,440,0.27419354838709675,100,180,160,150,90,90,770,0.7520661157024794,1.0
80,80,80,80,80,80,480,0.6015037593984962,60,50,70,80,80,140,480,0.8449612403100775,1.0
106,130,90,110,154,90,680,0.719626168224299,75,69,72,114,100,104,534,0.8253968253968254,0.5
45,50,55,75,65,30,320,0.06293706293706294,110,160,110,80,110,100,670,0.8591549295774648,1.0
110,160,110,80,110,100,670,0.8591549295774648,135,85,40,40,85,5,390,0.6864406779661016,1.0
59,74,50,35,50,35,303,0.3125,65,80,140,40,70,70,465,0.5223880597014925,0.0
65,80,140,40,70,70,465,0.5223880597014925,75,90,90,140,90,115,600,0.9481481481481482,0.5
67,125,40,30,30,58,350,0.3431372549019608,50,65,107,105,107,86,520,0.6991150442477876,2.0
70,80,65,90,65,85,455,0.578125,108,100,121,81,95,95,600,0.7476635514018691,2.0
65,47,55,73,75,85,400,0.65,116,55,85,107,95,29,487,0.06818181818181818,2.0
74,100,72,90,72,46,454,0.24561403508771928,40,50,45,70,45,70,320,0.5517241379310345,0.5
60,60,60,35,35,30,280,0.11194029850746269,75,75,55,105,85,30,425,0.1619718309859155,1.0
103,93,67,71,61,84,479,0.7142857142857143,80,100,200,50,100,50,580,0.3472222222222222,0.5
76,48,48,57,62,34,325,0.11688311688311688,75,80,60,65,90,102,472,0.8625954198473282,1.0
60,90,140,50,50,40,430,0.2535211267605634,90,132,105,132,105,30,594,0.4246575342465753,4.0
50,150,50,150,50,150,600,0.9339622641509434,80,125,75,40,95,85,500,0.6911764705882353,1.0
45,50,55,75,65,30,320,0.06293706293706294,105,150,90,150,90,95,680,0.8285714285714286,0.25
54,78,103,53,45,22,355,0.23255813953488372,58,89,77,45,45,48,362,0.3177570093457944,1.0
76,65,45,92,42,91,411,0.7449664429530202,60,70,105,70,120,75,500,0.5983606557377049,1.0
35,55,35,30,30,35,220,0.23684210526315788,70,90,45,15,45,50,315,0.3629032258064516,1.0
108,100,121,81,95,95,600,0.7476635514018691,75,80,95,90,100,50,490,0.2158273381294964,0.5
50,70,100,40,40,30,330,0.2222222222222222,91,72,90,129,90,108,580,0.8925619834710744,0.25
70,85,70,60,70,50,405,0.28378378378378377,85,97,66,105,66,65,484,0.47107438016528924,4.0
100,150,110,95,110,70,635,0.5923076923076923,50,75,45,40,45,60,315,0.4380165289256198,0.5
60,85,60,50,50,125,430,0.9090909090909091,125,120,90,170,100,95,700,0.78125,1.0
55,84,105,114,75,52,485,0.2890625,110,65,105,55,95,80,510,0.6258503401360545,1.0
70,60,62,80,82,60,414,0.4375,70,120,100,145,105,20,560,0.2824427480916031,0.5
60,90,140,50,50,40,430,0.2535211267605634,75,100,95,40,70,110,490,0.8717948717948718,1.0
50,160,110,160,110,110,700,0.8854961832061069,75,75,95,75,95,113,528,0.9015151515151515,1.0
53,51,53,61,56,40,314,0.14285714285714285,75,80,60,65,90,102,472,0.8625954198473282,1.0
80,80,50,40,50,25,325,0.176056338028169,60,80,50,50,50,40,330,0.23853211009174313,1.0
45,30,50,55,65,45,290,0.208,105,140,95,55,65,45,505,0.3,1.0
50,70,50,50,50,40,310,0.16296296296296298,58,64,58,80,65,80,405,0.609271523178808,2.0
55,104,105,94,75,52,485,0.36363636363636365,106,110,90,154,90,130,680,0.926829268292683,1.0
65,110,130,60,65,95,525,0.8278145695364238,120,100,85,30,85,45,465,0.22448979591836735,1.0
71,95,85,110,95,79,535,0.664,60,40,60,95,60,55,370,0.4222222222222222,0.5
110,160,110,80,110,100,670,0.8591549295774648,65,95,75,55,55,85,430,0.6933333333333334,1.0
45,50,43,40,38,62,278,0.40441176470588236,91,90,106,130,106,77,600,0.648854961832061,0.25
30,40,55,40,55,60,280,0.3237410071942446,50,105,125,55,95,50,480,0.375886524822695,0.5
91,90,129,90,72,108,580,0.9140625,60,25,35,70,80,60,330,0.3076923076923077,0.5
30,40,70,70,25,60,295,0.41353383458646614,35,46,34,35,45,20,215,0.072,1.0
40,35,30,120,70,105,400,0.6692307692307692,100,150,140,100,90,90,670,0.7969924812030075,2.0
40,40,55,40,70,55,300,0.40939597315436244,55,85,122,58,75,99,494,0.8099173553719008,0.5
60,85,69,60,69,77,420,0.518796992481203,40,55,80,35,60,30,300,0.15037593984962405,0.5
123,77,72,99,92,58,521,0.4621212121212121,65,65,60,130,95,110,525,0.823943661971831,1.0
75,123,67,95,85,95,540,0.7642276422764228,75,87,63,87,63,98,473,0.865546218487395,4.0
35,60,44,40,54,55,288,0.366412213740458,67,57,55,77,55,114,425,0.8879310344827587,1.0
60,85,40,30,45,68,328,0.6422018348623854,60,59,85,79,105,36,424,0.16666666666666666,0.25
97,165,60,65,50,58,495,0.3902439024390244,60,62,80,63,80,60,405,0.4336283185840708,1.0
75,100,95,40,70,110,490,0.8717948717948718,75,75,75,125,95,40,485,0.15671641791044777,1.0
70,140,70,110,65,105,560,0.95,50,48,43,46,41,60,288,0.47297297297297297,1.0
110,160,110,80,110,100,670,0.8591549295774648,35,55,40,45,40,60,275,0.35714285714285715,1.0
40,40,35,50,100,70,335,0.5031847133757962,45,63,37,65,55,95,360,0.8055555555555556,1.0
110,78,73,76,71,60,468,0.3333333333333333,50,120,53,35,110,87,455,0.640625,1.0
65,85,70,75,70,40,405,0.203125,65,90,120,85,70,60,490,0.43410852713178294,1.0
100,5,5,15,65,30,220,0.07692307692307693,100,100,90,150,140,90,670,0.71875,1.0
74,94,131,54,116,20,489,0.4485294117647059,85,97,66,105,66,65,484,0.47107438016528924,0.25
86,76,86,116,56,95,515,0.7982456140350878,45,30,50,55,65,45,290,0.208,2.0
85,73,70,73,115,67,483,0.5126050420168067,63,63,47,41,41,74,329,0.56,0.0
60,80,50,50,50,40,330,0.23853211009174313,85,76,64,45,55,90,415,0.6739130434782609,1.0
50,50,77,95,77,91,440,0.5916666666666667,35,64,85,74,55,32,345,0.19827586206896552,2.0
90,95,105,165,110,45,610,0.2890625,90,30,15,40,20,15,210,0.043478260869565216,0.0
71,120,95,120,95,99,600,0.8203125,50,80,95,10,45,10,290,0.232,2.0
69,69,76,69,86,91,460,0.6554621848739496,60,95,80,60,80,30,405,0.19480519480519481,0.5
75,95,67,125,95,83,540,0.7117117117117117,40,50,90,30,55,65,330,0.44680851063829785,2.0
57,24,86,24,86,23,300,0.12727272727272726,40,30,35,45,40,55,245,0.31496062992125984,1.0
50,65,107,105,107,86,520,0.6991150442477876,72,60,30,20,30,25,237,0.11570247933884298,1.0
54,78,103,53,45,22,355,0.23255813953488372,65,65,60,130,95,110,525,0.823943661971831,1.0
80,120,79,95,79,70,523,0.5833333333333334,71,95,85,110,95,79,535,0.664,1.0
64,165,75,93,83,75,555,0.6587301587301587,38,41,40,50,65,65,299,0.4108527131782946,1.0
40,45,40,65,40,65,295,0.5661764705882353,79,103,120,135,115,78,630,0.5763888888888888,2.0
78,52,60,63,65,23,341,0.06015037593984962,75,80,70,65,75,90,455,0.7578125,0.5
60,48,45,43,90,42,328,0.21897810218978103,65,95,75,55,55,85,430,0.6933333333333334,2.0
59,66,70,44,55,41,335,0.25190839694656486,95,117,184,44,46,28,514,0.2975206611570248,1.0
45,60,32,50,32,76,295,0.5925925925925926,75,110,110,110,105,80,590,0.656934306569343,0.5
35,40,100,90,55,35,355,0.1796875,70,80,102,80,102,40,474,0.2677165354330709,4.0
78,52,60,63,65,23,341,0.06015037593984962,105,95,75,85,75,74,509,0.5714285714285714,1.0
55,66,44,44,56,85,350,0.6888888888888889,80,100,123,122,120,80,625,0.56,1.0
60,82,45,45,45,74,351,0.5752212389380531,20,40,90,30,90,25,295,0.11363636363636363,2.0
60,50,70,50,90,65,385,0.39568345323741005,40,29,45,29,45,36,224,0.14634146341463414,1.0
80,125,75,40,95,85,500,0.6911764705882353,100,70,70,65,65,45,415,0.1897810218978102,2.0
50,50,62,40,62,65,329,0.4188034188034188,70,100,70,105,75,40,460,0.23214285714285715,0.5
40,80,100,30,30,20,300,0.11851851851851852,70,110,70,115,70,90,525,0.75,0.5
80,80,90,110,130,110,600,0.8721804511278195,65,76,84,54,96,105,480,0.9008264462809917,1.0
50,65,64,44,48,43,314,0.2196969696969697,70,95,125,65,75,45,475,0.33613445378151263,2.0
76,147,90,60,70,97,540,0.8267716535433071,65,80,140,40,70,70,465,0.5223880597014925,0.5
125,170,100,120,90,95,700,0.77,78,92,75,74,63,118,500,0.8842975206611571,2.0
45,95,50,40,50,75,355,0.54,50,85,85,55,55,50,380,0.3902439024390244,0.125
60,85,69,65,79,80,438,0.576,95,70,73,95,90,60,483,0.3983739837398374,2.0
35,80,50,50,70,120,405,0.84375,85,80,90,105,95,60,515,0.49074074074074076,1.0
60,85,40,30,45,68,328,0.6422018348623854,50,85,125,85,115,20,480,0.4306569343065693,1.0
115,140,130,55,55,40,535,0.4519230769230769,90,90,85,125,90,100,580,0.768595041322314,0.0
86,68,72,109,66,106,507,0.8099173553719008,70,110,75,145,85,145,630,0.9444444444444444,1.0
40,45,35,30,40,55,245,0.3793103448275862,95,117,184,44,46,28,514,0.2975206611570248,1.0
105,95,80,40,80,90,490,0.753968253968254,40,30,50,55,55,100,330,0.584070796460177,1.0
50,50,40,50,40,64,294,0.45588235294117646,62,77,62,50,42,65,358,0.4838709677419355,1.0
45,60,30,80,50,65,330,0.4603174603174603,90,130,80,65,85,55,505,0.4396551724137931,0.5
25,35,70,95,55,45,325,0.16783216783216784,53,51,53,61,56,40,314,0.14285714285714285,1.0
104,91,63,91,73,68,490,0.5118110236220472,38,41,40,50,65,65,299,0.4108527131782946,1.0
108,170,115,120,95,92,700,0.7083333333333334,120,70,120,75,130,85,600,0.6694915254237288,1.0
44,38,39,61,79,42,303,0.2251655629139073,150,120,100,120,100,90,680,0.664179104477612,2.0
90,92,87,75,85,76,505,0.5409836065573771,65,83,57,95,85,105,490,0.8914728682170543,2.0
55,75,50,40,40,80,340,0.6302521008403361,60,40,80,60,45,40,325,0.23529411764705882,2.0
75,89,85,55,65,36,405,0.29545454545454547,90,50,34,60,44,70,348,0.6283185840707964,0.5
30,42,118,42,88,30,350,0.112,75,75,75,125,95,40,485,0.15671641791044777,1.0
65,80,65,35,65,60,370,0.38405797101449274,70,120,65,45,85,125,510,0.9747899159663865,1.0
80,70,40,100,60,145,495,0.921875,80,50,100,100,200,50,580,0.2357142857142857,1.0
45,35,50,70,50,30,280,0.15753424657534246,64,115,65,83,63,65,455,0.5323741007194245,1.0
80,130,100,160,120,110,700,0.8981481481481481,55,63,90,50,80,42,380,0.21138211382113822,1.0
55,45,43,55,43,72,313,0.5853658536585366,40,45,35,30,40,55,245,0.3793103448275862,2.0
53,54,53,37,46,45,288,0.3090909090909091,68,165,95,65,115,110,618,0.8615384615384616,0.5
50,65,107,105,107,86,520,0.6991150442477876,100,100,125,110,50,50,535,0.384,1.0
100,100,90,150,140,90,670,0.71875,60,50,40,85,75,95,405,0.7540983606557377,1.0
100,50,80,60,80,50,420,0.34375,95,135,80,110,80,100,600,0.8248175182481752,1.0
45,22,60,27,30,29,213,0.07518796992481203,80,100,70,60,70,95,475,0.7416666666666667,2.0
60,70,65,125,105,90,515,0.6911764705882353,91,72,90,129,90,108,580,0.8925619834710744,2.0
59,66,70,44,55,41,335,0.25190839694656486,80,110,120,130,90,70,600,0.6198347107438017,1.0
55,112,45,74,45,70,401,0.559322033898305,49,49,56,49,61,66,330,0.5190839694656488,1.0
65,60,70,85,75,40,395,0.1796875,60,85,40,30,45,68,328,0.6422018348623854,1.0
80,115,80,65,55,93,488,0.7846153846153846,250,5,5,35,105,50,450,0.15306122448979592,1.0
65,125,60,95,60,105,510,0.9236641221374046,28,25,25,45,35,40,198,0.16083916083916083,0.25
80,70,40,100,60,145,495,0.921875,50,75,70,35,70,48,348,0.29357798165137616,1.0
45,55,45,65,45,75,330,0.5692307692307692,126,131,95,131,98,99,680,0.8102189781021898,2.0
78,65,68,112,154,75,552,0.628099173553719,45,50,43,40,38,62,278,0.40441176470588236,1.0
50,65,45,85,65,95,405,0.7238095238095238,70,90,70,60,60,70,420,0.6390977443609023,1.0
55,50,45,135,95,120,500,0.7714285714285715,70,90,90,135,90,125,600,0.9401709401709402,0.0
75,75,75,125,95,40,485,0.15671641791044777,65,83,57,95,85,105,490,0.8914728682170543,1.0
80,185,115,40,105,75,600,0.6230769230769231,65,125,100,55,70,85,500,0.6532258064516129,0.5
74,108,133,83,65,32,495,0.32142857142857145,50,65,107,105,107,86,520,0.703125,2.0
108,130,95,80,85,102,600,0.7637795275590551,50,40,85,40,65,25,305,0.08870967741935484,0.5
86,92,88,68,75,73,482,0.6835443037974683,68,72,78,38,42,32,330,0.23809523809523808,2.0
40,20,30,40,80,55,265,0.22764227642276422,80,70,40,100,60,145,495,0.921875,2.0
103,60,126,80,126,50,545,0.36363636363636365,60,62,63,80,80,60,405,0.38016528925619836,0.5
80,70,70,90,100,70,480,0.5609756097560976,150,160,100,95,65,100,670,0.8866666666666667,1.0
105,105,75,65,100,50,500,0.37593984962406013,63,60,55,50,50,71,349,0.5289256198347108,1.0
45,30,50,55,65,45,290,0.208,70,75,60,105,60,105,475,0.88,1.0
95,145,130,120,90,120,700,0.9398496240601504,67,89,116,79,116,33,500,0.2624113475177305,0.25
45,45,55,45,55,63,308,0.4594594594594595,60,55,50,40,55,45,305,0.22377622377622378,0.25
50,60,60,60,60,30,320,0.11290322580645161,80,100,80,80,80,100,520,0.9051724137931034,0.5
40,50,90,30,55,65,330,0.44680851063829785,50,70,160,70,160,90,600,0.7417218543046358,2.0
95,65,110,60,130,65,525,0.5275590551181102,83,106,65,86,65,85,490,0.6640625,0.5
74,48,76,83,81,104,466,0.7322834645669292,30,45,55,70,55,85,340,0.5633802816901409,1.0
70,55,55,80,60,45,365,0.2222222222222222,105,105,75,65,100,50,500,0.37593984962406013,1.0
69,55,45,55,55,15,294,0.11666666666666667,100,100,80,60,60,50,450,0.3050847457627119,1.0
50,85,40,85,40,35,335,0.1746031746031746,68,65,65,125,115,80,518,0.6461538461538462,1.0
80,70,40,100,60,145,495,0.921875,65,60,70,85,75,40,395,0.1796875,1.0
90,70,80,70,95,70,475,0.5190839694656488,100,180,160,150,90,90,770,0.7520661157024794,4.0
100,110,90,85,90,60,535,0.47794117647058826,63,60,55,50,50,71,349,0.5289256198347108,0.0
53,51,53,61,56,40,314,0.14285714285714285,45,35,45,62,53,35,275,0.11851851851851852,0.5
65,75,105,35,65,85,430,0.6940298507462687,20,25,45,70,90,60,310,0.30833333333333335,1.0
110,123,65,100,65,65,528,0.5217391304347826,49,66,70,44,55,51,335,0.4260869565217391,0.0
74,108,133,83,65,32,495,0.32142857142857145,70,105,105,50,40,20,390,0.33587786259541985,2.0
35,35,35,35,35,35,210,0.13385826771653545,30,56,35,25,35,72,253,0.48148148148148145,2.0
50,70,50,50,50,70,340,0.5645161290322581,45,90,20,65,20,65,305,0.5116279069767442,1.0
55,68,64,45,55,31,318,0.11666666666666667,45,30,40,105,50,20,290,0.031007751937984496,1.0
80,95,82,60,82,75,474,0.6,80,125,75,40,95,85,500,0.6911764705882353,1.0
45,30,40,105,50,20,290,0.031007751937984496,45,60,30,80,50,65,330,0.4603174603174603,0.0
50,85,125,85,115,20,480,0.4306569343065693,79,85,60,55,60,71,410,0.60431654676259,0.0
51,65,65,80,75,59,395,0.4365079365079365,77,85,51,55,51,65,384,0.5163934426229508,1.0
50,85,85,55,55,50,380,0.3902439024390244,45,60,45,25,45,55,275,0.29,1.0
106,150,70,194,120,140,780,0.952,59,66,70,44,55,41,335,0.25190839694656486,1.0
80,110,120,130,90,70,600,0.6198347107438017,44,50,91,24,86,10,305,0.1981981981981982,2.0
79,100,80,110,90,121,580,0.968,80,115,80,65,55,93,488,0.7846153846153846,1.0
65,47,55,73,75,85,400,0.65,65,80,140,40,70,70,465,0.5223880597014925,0.25
55,55,45,63,45,45,308,0.25,95,145,130,120,90,120,700,0.9398496240601504,0.5
40,27,60,37,50,66,280,0.36220472440944884,75,103,80,70,80,92,500,0.7933884297520661,0.25
75,125,70,125,70,115,580,0.9037037037037037,106,150,70,194,120,140,780,0.952,0.5
60,50,40,85,75,95,405,0.7540983606557377,100,90,130,45,65,55,485,0.4253731343283582,2.0
70,90,110,60,75,95,500,0.7333333333333333,60,90,140,50,50,40,430,0.2535211267605634,0.0
74,108,133,83,65,32,495,0.32142857142857145,35,70,55,45,55,25,285,0.09420289855072464,1.0
50,60,60,60,60,30,320,0.11290322580645161,80,130,100,160,120,110,700,0.8981481481481481,0.5
68,65,65,125,115,80,518,0.6461538461538462,95,100,85,108,70,70,528,0.5652173913043478,1.0
100,100,100,100,100,100,600,0.8345864661654135,40,55,80,35,60,30,300,0.15037593984962405,0.125
55,85,55,50,55,60,360,0.4233576642335766,35,55,40,45,40,60,275,0.35714285714285715,1.0
90,60,70,75,70,45,410,0.23880597014925373,60,85,42,85,42,91,405,0.8227848101265823,2.0
60,115,105,65,70,80,495,0.7181818181818181,90,93,55,70,55,55,418,0.3819444444444444,2.0
90,92,87,75,85,76,505,0.5409836065573771,70,110,180,60,60,50,530,0.4117647058823529,0.0
69,69,76,69,86,91,460,0.6554621848739496,35,35,35,35,35,35,210,0.13385826771653545,1.0
60,150,50,150,50,60,520,0.5,90,120,120,60,60,50,500,0.35294117647058826,1.0
80,185,115,40,105,75,600,0.6230769230769231,75,95,60,65,60,115,470,0.8778625954198473,2.0
60,45,50,90,80,70,395,0.625,100,100,100,100,100,100,600,0.8778625954198473,1.0
35,46,34,35,45,20,215,0.072,50,20,55,25,25,30,205,0.09774436090225563,1.0
75,69,72,114,100,104,534,0.8253968253968254,95,135,80,110,80,100,600,0.8248175182481752,0.5
75,70,90,70,105,80,490,0.656,100,120,100,150,120,90,680,0.728,2.0
60,80,110,50,80,45,425,0.2833333333333333,108,112,118,68,72,47,525,0.2916666666666667,1.0
69,55,45,55,55,15,294,0.11666666666666667,90,75,75,90,100,70,500,0.5462184873949579,2.0
106,130,90,110,154,90,680,0.719626168224299,60,50,150,50,150,60,520,0.5206611570247934,1.0
150,160,100,95,65,100,670,0.8866666666666667,41,64,45,50,50,50,300,0.36752136752136755,1.0
90,110,80,100,80,95,555,0.7982456140350878,100,180,160,150,90,90,770,0.7520661157024794,0.5
100,120,100,150,120,90,680,0.728,20,10,55,15,20,80,200,0.17985611510791366,0.5
52,65,50,45,50,38,300,0.27419354838709675,30,42,118,42,88,30,350,0.112,0.5
65,55,115,100,40,60,435,0.3798449612403101,50,70,50,50,50,70,340,0.5645161290322581,1.0
76,25,45,67,55,24,292,0.0390625,45,60,40,70,50,45,310,0.2846715328467153,1.0
66,117,70,40,50,67,410,0.4573643410852713,110,160,110,80,110,100,670,0.8591549295774648,1.0
70,110,180,60,60,50,530,0.4117647058823529,38,35,40,27,25,35,200,0.08208955223880597,2.0
43,30,55,40,65,97,330,0.6030534351145038,85,73,70,73,115,67,483,0.5126050420168067,1.0
55,70,40,60,40,40,305,0.26956521739130435,40,40,55,40,70,55,300,0.40939597315436244,2.0
85,97,66,105,66,65,484,0.47107438016528924,73,100,60,100,60,65,458,0.42657342657342656,1.0
95,65,110,60,130,65,525,0.5275590551181102,65,95,75,55,55,85,430,0.6933333333333334,1.0
105,95,80,40,80,90,490,0.753968253968254,48,61,40,61,40,50,300,0.2543859649122807,1.0
75,80,60,65,90,102,472,0.8625954198473282,60,65,70,85,75,40,395,0.21705426356589147,1.0
80,145,150,105,110,110,700,0.8692307692307693,60,50,70,80,80,140,480,0.8449612403100775,0.5
70,65,60,90,75,90,450,0.6571428571428571,90,60,70,75,70,45,410,0.23880597014925373,1.0
70,65,65,55,55,70,380,0.5,80,75,150,75,150,50,580,0.30973451327433627,0.5
71,82,64,64,59,112,452,0.9327731092436975,70,84,70,65,70,51,410,0.2949640287769784,0.5
116,55,85,107,95,29,487,0.06818181818181818,100,77,77,128,128,90,600,0.6901408450704225,0.5
65,65,45,75,45,95,390,0.72,55,81,60,50,70,97,413,0.7214285714285714,1.0
106,150,70,194,120,140,780,0.952,45,60,45,25,45,55,275,0.29,1.0
65,90,50,85,45,55,390,0.371900826446281,90,30,15,40,20,15,210,0.043478260869565216,2.0
70,55,75,45,65,60,370,0.45901639344262296,65,65,60,110,95,130,525,0.9253731343283582,0.5
68,90,65,50,55,82,410,0.6165413533834586,82,121,119,69,59,71,521,0.5394736842105263,4.0
90,100,60,90,60,80,480,0.6422764227642277,60,80,50,40,40,30,300,0.15328467153284672,0.5
60,85,69,60,69,77,420,0.518796992481203,80,95,82,60,82,75,474,0.6,1.0
50,47,50,57,50,65,319,0.463768115942029,80,145,150,105,110,110,700,0.8692307692307693,1.0
70,130,100,55,80,65,500,0.608,54,63,52,83,56,97,405,0.7697841726618705,0.5
60,90,55,90,80,110,485,0.8677685950413223,55,75,85,25,25,15,280,0.1875,1.0
52,65,55,58,62,60,352,0.4482758620689655,65,75,90,97,123,44,494,0.1987179487179487,1.0
80,135,130,95,90,70,600,0.5181818181818182,50,95,95,35,110,70,455,0.5179856115107914,1.0
30,45,135,45,90,30,375,0.09285714285714286,150,160,100,95,65,100,670,0.8866666666666667,1.0
1,90,45,30,30,40,236,0.33064516129032256,106,190,100,154,100,130,780,0.9259259259259259,2.0
55,50,45,135,95,120,500,0.7714285714285715,40,55,99,40,79,47,360,0.26262626262626265,2.0
101,72,72,99,89,29,462,0.1937984496124031,70,150,140,65,100,75,600,0.55,0.5
55,45,43,55,43,72,313,0.5853658536585366,30,65,100,45,25,40,305,0.1891891891891892,1.0
100,100,100,100,100,100,600,0.8602941176470589,75,80,95,90,100,50,490,0.2158273381294964,0.5
103,93,67,71,61,84,479,0.7142857142857143,68,90,65,50,55,82,410,0.6165413533834586,0.5
68,85,65,165,135,100,618,0.8083333333333333,100,100,125,110,50,50,535,0.384,1.0
75,38,38,56,56,67,330,0.5263157894736842,55,40,50,65,85,40,335,0.3181818181818182,1.0
60,85,49,60,49,60,363,0.4444444444444444,100,100,100,100,100,100,600,0.8778625954198473,1.0
61,84,65,70,70,70,420,0.5,49,66,70,44,55,51,335,0.4260869565217391,1.0
55,104,105,94,75,52,485,0.36363636363636365,50,40,85,40,65,25,305,0.08870967741935484,1.0
68,85,65,165,135,100,618,0.8083333333333333,65,70,60,65,65,115,440,0.8583333333333333,1.0
64,115,65,83,63,65,455,0.5323741007194245,50,180,20,180,20,150,600,0.9029850746268657,2.0
61,84,65,70,70,70,420,0.5,36,50,50,65,60,44,305,0.16363636363636364,1.0
75,125,70,125,70,115,580,0.9037037037037037,65,125,100,60,70,70,490,0.6099290780141844,0.0
40,60,40,40,40,30,250,0.0948905109489051,103,60,126,80,126,50,545,0.36363636363636365,1.0
60,82,45,45,45,74,351,0.5752212389380531,50,105,79,35,110,76,455,0.6214285714285714,0.5
95,80,105,40,70,100,490,0.8046875,130,85,80,85,95,60,535,0.43884892086330934,1.0
75,95,125,45,75,95,510,0.8257575757575758,40,30,32,50,52,65,269,0.3671875,1.0
65,40,70,80,140,70,465,0.5954198473282443,50,120,53,35,110,87,455,0.640625,2.0
70,85,140,85,70,20,470,0.272,40,45,40,35,35,56,251,0.373015873015873,1.0
70,130,100,55,80,65,500,0.608,110,160,110,80,110,100,670,0.8591549295774648,1.0
85,110,76,65,82,56,474,0.3933333333333333,85,70,80,97,80,123,535,0.9304347826086956,0.25
45,30,15,85,65,65,305,0.36220472440944884,60,70,50,100,50,65,395,0.5217391304347826,2.0
60,85,40,30,45,68,328,0.6422018348623854,45,63,37,65,55,95,360,0.8055555555555556,2.0
31,45,90,30,30,40,266,0.21929824561403508,45,49,49,65,65,45,318,0.2781954887218045,1.0
70,75,60,105,60,105,475,0.88,55,95,55,35,75,115,430,0.9380530973451328,1.0
65,55,115,100,40,60,435,0.3798449612403101,65,70,60,65,65,115,440,0.8583333333333333,1.0
79,100,80,110,90,121,580,0.968,60,130,80,60,60,70,460,0.5153846153846153,4.0
80,135,130,95,90,70,600,0.5181818181818182,95,100,85,108,70,70,528,0.5652173913043478,0.5
65,83,57,95,85,105,490,0.8914728682170543,30,45,135,45,90,30,375,0.09285714285714286,1.0
50,65,85,35,35,55,325,0.32575757575757575,90,120,100,150,120,100,680,0.7718120805369127,1.0
60,60,50,40,50,75,335,0.5882352941176471,70,135,105,60,105,20,495,0.5806451612903226,0.125
75,75,130,75,130,95,580,0.7479674796747967,70,135,105,60,105,20,495,0.5806451612903226,0.5
80,100,200,50,100,50,580,0.3472222222222222,78,81,71,74,69,126,499,0.9090909090909091,4.0
75,90,90,140,90,115,600,0.9481481481481482,59,74,50,35,50,35,303,0.3125,2.0
35,64,85,74,55,32,345,0.19827586206896552,104,91,63,91,73,68,490,0.5118110236220472,1.0
60,60,50,40,50,75,335,0.5882352941176471,95,75,110,100,80,30,490,0.15267175572519084,2.0
68,125,65,65,115,80,518,0.6277372262773723,75,103,80,70,80,92,500,0.7933884297520661,0.5
90,93,55,70,55,55,418,0.3819444444444444,85,120,70,50,60,100,485,0.8308823529411765,1.0
75,95,67,125,95,83,540,0.7117117117117117,90,60,70,75,70,45,410,0.23880597014925373,1.0
73,76,75,81,100,100,505,0.8110236220472441,91,72,90,129,90,108,580,0.8620689655172413,0.5
40,60,30,31,31,70,262,0.4492753623188406,35,80,50,50,70,120,405,0.84375,1.0
73,100,60,100,60,65,458,0.42657342657342656,72,95,67,103,71,122,530,0.9606299212598425,1.0
59,63,80,65,80,58,405,0.41843971631205673,60,90,70,60,120,40,440,0.27419354838709675,1.0
39,52,43,60,50,65,309,0.49107142857142855,105,95,75,85,75,74,509,0.5714285714285714,0.5
70,55,95,95,110,65,490,0.48872180451127817,70,70,40,60,40,60,340,0.4247787610619469,0.0
60,62,50,62,60,40,334,0.18181818181818182,40,45,65,100,120,90,460,0.5588235294117647,1.0
63,120,85,90,55,55,468,0.2809917355371901,80,82,78,95,80,85,500,0.6869565217391305,0.5
55,104,105,94,75,52,485,0.36363636363636365,106,130,90,110,154,90,680,0.719626168224299,2.0
75,110,110,110,105,80,590,0.656934306569343,62,73,55,56,52,84,382,0.7244094488188977,0.5
75,125,70,125,70,115,580,0.9037037037037037,123,100,62,97,81,68,531,0.4806201550387597,1.0
72,95,67,103,71,122,530,0.9606299212598425,91,72,90,129,90,108,580,0.8620689655172413,0.25
110,123,65,100,65,65,528,0.5217391304347826,65,130,60,75,60,75,465,0.689922480620155,2.0
60,75,100,55,80,50,420,0.3088235294117647,35,46,34,35,45,20,215,0.072,1.0
55,55,85,65,85,35,380,0.2014388489208633,71,82,64,64,59,112,452,0.9327731092436975,1.0
70,65,60,90,75,90,450,0.6571428571428571,59,110,150,45,49,35,448,0.3333333333333333,0.0
120,100,85,30,85,45,465,0.22448979591836735,75,90,50,110,80,95,500,0.7985611510791367,2.0
50,65,107,105,107,86,520,0.703125,90,30,15,40,20,15,210,0.043478260869565216,1.0
75,80,70,65,75,90,455,0.7578125,60,82,45,45,45,74,351,0.5752212389380531,0.5
91,90,106,130,106,77,600,0.648854961832061,76,65,45,92,42,91,411,0.7449664429530202,1.0
80,95,82,60,82,75,474,0.6,78,65,68,112,154,75,552,0.628099173553719,2.0
58,64,58,80,65,80,405,0.5423728813559322,40,45,35,30,40,55,245,0.3793103448275862,1.0
90,75,85,115,90,55,510,0.3445378151260504,50,75,75,65,65,50,380,0.4049586776859504,1.0
80,120,70,110,70,80,530,0.6422764227642277,50,150,50,150,50,150,600,0.9339622641509434,0.5
45,67,60,35,50,63,320,0.5128205128205128,106,110,90,154,90,130,680,0.926829268292683,1.0
70,110,80,55,80,105,500,0.8794326241134752,55,68,64,45,55,31,318,0.11666666666666667,4.0
106,190,100,154,100,130,780,0.9259259259259259,45,40,60,40,75,50,310,0.2926829268292683,1.0
79,105,70,145,80,101,580,0.8608695652173913,40,29,45,29,45,36,224,0.14634146341463414,2.0
50,30,55,65,55,20,275,0.13675213675213677,90,120,100,150,120,100,680,0.7718120805369127,0.25
45,30,15,85,65,65,305,0.36220472440944884,110,80,90,95,90,65,530,0.5033557046979866,0.25
60,90,140,50,50,40,430,0.2535211267605634,90,95,105,165,110,45,610,0.2890625,0.5
52,65,50,45,50,38,300,0.27419354838709675,80,105,65,60,75,130,515,0.9645390070921985,1.0
65,110,130,60,65,95,525,0.8278145695364238,70,80,70,80,70,110,480,0.6594202898550725,1.0
105,150,90,150,90,95,680,0.8285714285714286,40,40,35,50,100,70,335,0.5031847133757962,1.0
40,30,32,50,52,65,269,0.3671875,72,60,30,20,30,25,237,0.11570247933884298,0.5
60,30,30,36,56,50,262,0.32432432432432434,65,125,100,55,70,85,500,0.6532258064516129,2.0
45,30,50,55,65,45,290,0.208,100,100,100,100,100,100,600,0.8805970149253731,1.0
38,35,40,27,25,35,200,0.08208955223880597,50,95,90,95,90,180,600,0.9172413793103448,2.0
60,50,40,85,75,95,405,0.7540983606557377,70,62,67,55,55,56,365,0.38513513513513514,1.0
106,190,100,154,100,130,780,0.9259259259259259,62,73,55,56,52,84,382,0.7244094488188977,0.5
48,61,40,61,40,50,300,0.2543859649122807,55,81,60,50,70,97,413,0.7214285714285714,2.0
114,85,70,85,80,30,464,0.2066115702479339,100,150,90,180,160,90,770,0.7348484848484849,2.0
41,50,37,50,37,66,281,0.5175438596491229,50,50,62,40,62,65,329,0.4188034188034188,1.0
123,77,72,99,92,58,521,0.4621212121212121,95,117,184,44,46,28,514,0.2975206611570248,1.0
90,75,85,115,90,55,510,0.3445378151260504,100,77,77,128,128,90,600,0.6901408450704225,1.0
75,65,55,65,55,69,384,0.43548387096774194,125,130,90,130,90,95,660,0.7734375,0.5
70,85,140,85,70,20,470,0.272,65,70,60,65,65,115,440,0.8583333333333333,1.0
70,80,70,80,70,110,480,0.6594202898550725,105,95,80,40,80,90,490,0.753968253968254,0.0
70,60,62,80,82,60,414,0.4375,75,75,95,75,95,113,528,0.9015151515151515,4.0
40,35,30,20,20,50,195,0.23423423423423423,64,115,65,83,63,65,455,0.5323741007194245,0.25
55,75,85,25,25,15,280,0.1875,65,80,65,35,65,60,370,0.38405797101449274,1.0
60,62,63,80,80,60,405,0.38016528925619836,46,57,40,40,40,50,273,0.25,0.25
100,100,100,100,100,100,600,0.831858407079646,50,95,180,85,45,70,525,0.5298507462686567,1.0
95,135,80,110,80,100,600,0.8248175182481752,70,84,70,65,70,51,410,0.2949640287769784,0.5
80,80,80,80,80,80,480,0.5606060606060606,105,95,80,40,80,90,490,0.753968253968254,1.0
60,85,49,60,49,60,363,0.4444444444444444,61,78,95,56,58,57,405,0.40336134453781514,0.5
80,92,65,65,80,68,450,0.4824561403508772,62,77,62,50,42,65,358,0.4838709677419355,1.0
125,58,58,76,76,67,460,0.515625,100,120,120,150,100,90,680,0.7880794701986755,0.25
106,110,90,154,90,130,680,0.926829268292683,110,80,90,95,90,65,530,0.5033557046979866,1.0
110,160,110,80,110,100,670,0.8591549295774648,126,131,95,131,98,99,680,0.8294573643410853,1.0
58,70,45,40,45,42,300,0.25925925925925924,90,92,87,75,85,76,505,0.5409836065573771,2.0
64,66,68,81,76,50,405,0.25190839694656486,40,45,35,30,40,55,245,0.3793103448275862,1.0
70,140,230,60,80,50,630,0.32432432432432434,40,70,40,35,40,60,285,0.392,1.0
40,20,30,40,80,55,265,0.22764227642276422,40,30,32,50,52,65,269,0.3671875,2.0
70,83,50,37,50,60,350,0.3360655737704918,50,95,90,95,90,180,600,0.9172413793103448,1.0
55,69,85,32,35,28,304,0.09302325581395349,61,90,45,50,50,160,456,0.9230769230769231,2.0
90,60,70,75,70,45,410,0.23880597014925373,110,80,90,95,90,65,530,0.5033557046979866,0.125
30,45,55,70,55,85,340,0.5633802816901409,74,48,76,83,81,104,466,0.7322834645669292,1.0
80,130,100,160,120,110,700,0.8981481481481481,60,79,105,59,85,36,424,0.17054263565891473,2.0
70,84,70,65,70,51,410,0.2949640287769784,80,90,80,130,110,110,600,0.856,1.0
70,85,70,60,70,50,405,0.28378378378378377,80,82,83,100,100,80,525,0.6742424242424242,0.5
91,90,106,130,106,77,600,0.648854961832061,100,90,130,45,65,55,485,0.4253731343283582,0.25
43,80,65,50,35,35,308,0.14193548387096774,68,125,65,65,115,80,518,0.6277372262773723,1.0
59,110,150,45,49,35,448,0.3333333333333333,50,48,43,46,41,60,288,0.47297297297297297,0.5
63,120,85,90,55,55,468,0.2809917355371901,91,72,90,129,90,108,580,0.8925619834710744,0.25
66,41,77,61,87,23,355,0.12096774193548387,76,147,90,60,70,97,540,0.8267716535433071,0.5
40,30,32,50,52,65,269,0.3671875,62,77,62,50,42,65,358,0.4838709677419355,0.5
40,60,30,31,31,70,262,0.4492753623188406,54,45,47,75,98,52,371,0.39669421487603307,1.0
80,120,130,55,65,45,495,0.37037037037037035,85,97,66,105,66,65,484,0.47107438016528924,4.0
40,30,30,40,50,30,220,0.07936507936507936,45,20,50,60,120,50,345,0.24074074074074073,0.5
80,85,95,30,30,25,345,0.2857142857142857,40,40,35,50,100,70,335,0.5031847133757962,2.0
55,50,45,135,95,120,500,0.7714285714285715,55,45,45,25,25,15,210,0.048,2.0
60,65,80,170,95,130,600,0.8625954198473282,75,125,100,70,80,45,495,0.33035714285714285,0.5
90,120,75,60,60,45,450,0.29411764705882354,75,75,75,125,95,40,485,0.15671641791044777,1.0
75,87,63,87,63,98,473,0.865546218487395,63,60,55,50,50,71,349,0.5289256198347108,1.0
45,49,65,49,65,45,318,0.275,80,80,80,80,80,80,480,0.5606060606060606,2.0
60,90,70,60,120,40,440,0.27419354838709675,40,65,40,80,40,65,330,0.5038167938931297,1.0
50,120,53,35,110,87,455,0.640625,100,100,100,100,100,100,600,0.8758169934640523,1.0
50,65,107,105,107,86,520,0.703125,78,65,68,112,154,75,552,0.628099173553719,1.0
31,45,90,30,30,40,266,0.21929824561403508,45,55,45,65,45,75,330,0.5692307692307692,0.0
35,45,160,30,45,70,385,0.48148148148148145,80,50,100,100,200,50,580,0.2357142857142857,2.0
90,120,75,60,60,45,450,0.29411764705882354,114,85,70,85,80,30,464,0.2066115702479339,0.5
80,110,120,130,90,70,600,0.6198347107438017,30,40,55,40,55,60,280,0.3237410071942446,1.0
100,180,160,150,90,90,770,0.7520661157024794,40,29,45,29,45,36,224,0.14634146341463414,1.0
100,100,100,100,100,100,600,0.831858407079646,55,55,50,45,65,55,325,0.37373737373737376,1.0
65,90,115,45,115,58,488,0.5041322314049587,66,65,48,62,57,52,350,0.36220472440944884,1.0
80,45,65,90,110,80,470,0.5462962962962963,30,45,55,70,55,85,340,0.5633802816901409,1.0
55,50,40,40,40,75,300,0.5945945945945946,65,90,120,85,70,60,490,0.43410852713178294,1.0
59,63,80,65,80,58,405,0.41843971631205673,105,95,75,85,75,74,509,0.5714285714285714,1.0
76,65,45,92,42,91,411,0.7449664429530202,60,75,85,100,85,115,520,0.8992248062015504,1.0
126,131,95,131,98,99,680,0.8294573643410853,100,100,100,100,100,100,600,0.8602941176470589,1.0
110,85,95,80,95,50,515,0.2713178294573643,50,120,53,35,110,87,455,0.640625,1.0
70,70,115,130,90,60,535,0.5338983050847458,68,165,95,65,115,110,618,0.8615384615384616,1.0
95,145,130,120,90,120,700,0.9398496240601504,70,62,67,55,55,56,365,0.38513513513513514,1.0
90,60,60,40,40,40,330,0.29545454545454547,65,45,55,45,70,45,325,0.24369747899159663,1.0
75,75,95,75,95,113,528,0.9015151515151515,70,70,70,70,70,70,420,0.5289256198347108,1.0
100,100,80,60,60,50,450,0.3050847457627119,60,65,80,170,95,130,600,0.8625954198473282,2.0
75,87,63,87,63,98,473,0.865546218487395,123,77,72,99,92,58,521,0.4621212121212121,1.0
103,60,86,60,86,50,445,0.3458646616541353,110,65,75,125,85,30,490,0.15,1.0
35,64,85,74,55,32,345,0.19827586206896552,60,85,60,85,60,55,405,0.3673469387755102,2.0
123,77,72,99,92,58,521,0.4621212121212121,70,55,55,80,60,45,365,0.2222222222222222,1.0
108,170,115,120,95,92,700,0.7083333333333334,75,98,63,98,63,101,498,0.8091603053435115,0.5
55,95,115,45,45,35,390,0.2116788321167883,58,64,58,80,65,80,405,0.5423728813559322,4.0
255,10,10,75,135,55,540,0.3125,90,75,85,115,90,55,510,0.3445378151260504,1.0
70,130,100,55,80,65,500,0.608,50,70,50,50,50,40,310,0.16296296296296298,0.5
40,45,65,100,120,90,460,0.5588235294117647,45,100,45,45,45,10,290,0.2949640287769784,2.0
110,135,60,50,65,88,508,0.7744360902255639,58,64,58,80,65,80,405,0.609271523178808,1.0
60,67,85,77,75,116,480,0.8888888888888888,40,80,35,35,45,70,305,0.4661016949152542,2.0
84,71,43,71,43,48,360,0.25874125874125875,90,65,65,40,40,15,315,0.19672131147540983,1.0
86,81,97,81,107,43,495,0.203125,79,100,80,110,90,121,580,0.968,1.0
50,50,77,95,77,91,440,0.5916666666666667,50,105,125,55,95,50,480,0.375886524822695,1.0
50,70,50,50,50,70,340,0.5645161290322581,70,70,40,60,40,60,340,0.4247787610619469,0.5
100,120,100,150,120,90,680,0.728,45,60,40,70,50,45,310,0.2846715328467153,0.5
95,145,130,120,90,120,700,0.9398496240601504,50,55,50,36,30,43,264,0.2922077922077922,1.0
76,48,48,57,62,34,325,0.11688311688311688,80,82,83,100,100,80,525,0.6742424242424242,0.5
85,50,95,120,115,80,545,0.5793650793650794,50,50,50,50,50,50,300,0.30708661417322836,1.0
90,92,87,75,85,76,505,0.5409836065573771,60,62,63,80,80,60,405,0.38016528925619836,1.0
50,50,150,50,150,50,500,0.2571428571428571,100,70,70,65,65,45,415,0.1897810218978102,1.0
100,50,50,76,96,70,442,0.5,40,45,40,35,35,56,251,0.373015873015873,1.0
40,45,65,100,120,90,460,0.5588235294117647,105,140,95,55,65,45,505,0.3,2.0
57,24,86,24,86,23,300,0.12727272727272726,70,92,65,80,55,98,460,0.8090909090909091,0.5
45,55,39,35,39,42,255,0.18518518518518517,68,125,65,65,115,80,518,0.6277372262773723,1.0
90,110,80,100,80,95,555,0.7982456140350878,60,90,70,60,120,40,440,0.27419354838709675,1.0
10,55,25,35,45,95,265,0.5396825396825397,95,75,110,100,80,30,490,0.15267175572519084,1.0
66,41,77,61,87,23,355,0.12096774193548387,54,78,103,53,45,22,355,0.23255813953488372,4.0
95,100,85,108,70,70,528,0.5652173913043478,64,78,52,78,52,81,405,0.6422764227642277,2.0
65,90,120,85,70,60,490,0.43410852713178294,150,100,120,100,120,90,680,0.6666666666666666,0.5
78,84,78,109,85,100,534,0.8620689655172413,65,73,55,47,75,85,400,0.6846846846846847,2.0
90,132,105,132,105,30,594,0.4246575342465753,85,56,77,50,77,78,423,0.53125,4.0
90,92,87,75,85,76,505,0.5409836065573771,45,53,70,40,60,42,310,0.25735294117647056,0.5
82,121,119,69,59,71,521,0.5394736842105263,1,90,45,30,30,40,236,0.33064516129032256,2.0
95,60,79,100,125,81,540,0.6201550387596899,65,75,105,35,65,85,430,0.6940298507462687,2.0
65,80,80,59,63,58,405,0.4411764705882353,100,123,75,57,75,80,510,0.6923076923076923,1.0
45,75,37,70,55,83,365,0.6183206106870229,60,50,40,85,75,95,405,0.7540983606557377,1.0
100,100,100,100,100,100,600,0.8345864661654135,78,52,60,63,65,23,341,0.06015037593984962,1.0
60,65,70,85,75,40,395,0.21705426356589147,43,70,48,50,60,38,309,0.2391304347826087,0.5
39,52,43,60,50,65,309,0.49107142857142855,65,80,140,40,70,70,465,0.5223880597014925,2.0
80,135,130,95,90,70,600,0.5181818181818182,45,80,100,35,37,28,325,0.3125,0.25
110,130,80,70,60,80,530,0.5862068965517241,100,100,100,100,100,100,600,0.831858407079646,1.0
75,98,63,98,63,101,498,0.889763779527559,86,92,88,68,75,73,482,0.6835443037974683,1.0
35,64,85,74,55,32,345,0.19827586206896552,40,60,40,40,40,30,250,0.0948905109489051,1.0
130,65,60,110,95,65,525,0.5227272727272727,60,48,45,43,90,42,328,0.21897810218978103,1.0
65,65,60,110,95,130,525,0.9253731343283582,75,85,200,55,65,30,510,0.16778523489932887,0.0
50,72,35,35,35,65,292,0.5373134328358209,78,84,78,109,85,100,534,0.8646616541353384,0.0
50,48,43,46,41,60,288,0.47297297297297297,90,70,80,70,95,70,475,0.5190839694656488,0.5
65,55,115,100,40,60,435,0.3798449612403101,80,95,82,60,82,75,474,0.6,0.5
40,70,130,60,130,25,455,0.17355371900826447,79,115,70,125,80,111,580,0.864,1.0
30,40,55,40,55,60,280,0.3237410071942446,95,60,79,100,125,81,540,0.6201550387596899,1.0
70,135,105,60,105,20,495,0.5806451612903226,53,54,53,37,46,45,288,0.3090909090909091,4.0
70,120,65,45,85,125,510,0.9747899159663865,55,69,85,32,35,28,304,0.09302325581395349,0.5
100,100,100,100,100,100,600,0.8778625954198473,75,95,95,95,95,85,540,0.6470588235294118,0.25
1,90,45,30,30,40,236,0.33064516129032256,60,65,60,130,75,110,500,0.7719298245614035,0.5
80,80,90,110,130,110,600,0.8721804511278195,80,125,75,40,95,85,500,0.6911764705882353,1.0
50,65,64,44,48,43,314,0.2196969696969697,55,45,45,25,25,15,210,0.048,1.0
20,25,45,70,90,60,310,0.30833333333333335,110,160,110,80,110,100,670,0.8591549295774648,1.0
44,38,33,61,43,70,289,0.5267857142857143,69,69,76,69,86,91,460,0.6554621848739496,2.0
90,85,75,115,100,115,580,0.9381443298969072,90,110,80,100,80,95,555,0.7982456140350878,1.0
70,60,70,87,78,85,450,0.6228070175438597,65,40,50,125,60,30,370,0.07258064516129033,1.0
70,70,40,60,40,60,340,0.4247787610619469,42,52,67,39,56,50,306,0.2868217054263566,4.0
38,30,41,30,41,60,240,0.2897196261682243,44,75,35,63,33,45,295,0.2647058823529412,0.0
30,40,55,40,55,60,280,0.3237410071942446,90,75,75,90,100,70,500,0.5462184873949579,1.0
90,120,120,60,60,50,500,0.35294117647058826,50,50,40,30,30,50,250,0.2781954887218045,1.0
70,150,140,65,100,75,600,0.55,80,100,70,60,70,95,475,0.7416666666666667,2.0
40,55,80,35,60,30,300,0.15037593984962405,60,50,70,80,80,140,480,0.8449612403100775,0.5
65,50,35,115,95,95,455,0.7333333333333333,50,95,180,85,45,70,525,0.5298507462686567,0.25
91,72,90,129,90,108,580,0.8925619834710744,35,20,65,40,65,20,245,0.02459016393442623,0.5
83,106,65,86,65,85,490,0.6640625,90,95,95,70,90,70,510,0.5230769230769231,1.0
30,35,30,100,35,80,310,0.4765625,70,145,88,140,70,112,625,0.8888888888888888,0.0
40,80,100,30,30,20,300,0.11851851851851852,80,100,200,50,100,50,580,0.3472222222222222,2.0
50,53,62,58,63,44,330,0.13709677419354838,75,98,63,98,63,101,498,0.889763779527559,2.0
70,83,50,37,50,60,350,0.3360655737704918,97,165,60,65,50,58,495,0.3902439024390244,0.25
71,73,88,120,89,59,500,0.43537414965986393,90,50,34,60,44,70,348,0.6283185840707964,1.0
65,40,50,125,60,30,370,0.07258064516129033,50,52,48,65,50,55,320,0.33098591549295775,1.0
30,105,90,25,25,50,325,0.2773722627737226,67,58,57,81,67,101,431,0.8790322580645161,1.0
45,60,40,70,50,45,310,0.2846715328467153,40,55,30,30,30,85,270,0.688,1.0
86,92,88,68,75,73,482,0.6835443037974683,45,80,100,35,37,28,325,0.3125,1.0
65,125,60,95,60,105,510,0.9236641221374046,60,80,50,40,40,30,300,0.15328467153284672,0.5
65,155,120,65,90,105,600,0.8677685950413223,45,85,50,55,50,65,350,0.5076923076923077,1.0
65,95,75,55,55,85,430,0.6933333333333334,38,41,40,50,65,65,299,0.4108527131782946,2.0
70,45,48,60,65,35,323,0.15748031496062992,60,80,95,70,85,50,440,0.2231404958677686,0.5
44,75,35,63,33,45,295,0.2647058823529412,36,50,50,65,60,44,305,0.16363636363636364,1.0
67,82,62,46,48,43,348,0.22033898305084745,86,81,97,81,107,43,495,0.203125,2.0
60,70,65,125,105,90,515,0.6911764705882353,35,35,35,35,35,35,210,0.13385826771653545,1.0
55,50,45,135,95,120,500,0.7714285714285715,79,115,70,125,80,111,580,0.864,1.0
45,80,100,35,37,28,325,0.3125,45,35,50,70,50,30,280,0.15753424657534246,1.0
60,55,50,40,55,45,305,0.22377622377622378,73,95,62,85,65,85,465,0.6666666666666666,1.0
100,100,100,100,100,100,600,0.8758169934640523,50,105,125,55,95,50,480,0.375886524822695,0.125
40,70,130,60,130,25,455,0.17355371900826447,45,65,34,40,34,45,263,0.2589928057553957,1.0
60,55,50,40,55,45,305,0.22377622377622378,40,45,40,65,40,65,295,0.5661764705882353,1.0
65,125,100,55,70,85,500,0.6532258064516129,79,100,80,110,90,121,580,0.968,0.5
41,50,37,50,37,66,281,0.5175438596491229,50,100,150,100,150,50,600,0.37142857142857144,0.5
65,80,65,35,65,60,370,0.38405797101449274,95,117,184,44,46,28,514,0.2975206611570248,1.0
50,65,107,105,107,86,520,0.7758620689655172,86,92,88,68,75,73,482,0.6835443037974683,1.0
70,150,140,65,100,75,600,0.55,91,90,129,90,72,108,580,0.9140625,0.125
255,10,10,75,135,55,540,0.3125,55,75,85,25,25,15,280,0.1875,0.5
55,55,85,65,85,35,380,0.2014388489208633,104,91,63,91,73,68,490,0.5118110236220472,1.0
75,89,85,55,65,36,405,0.29545454545454547,75,100,66,60,66,115,482,0.918918918918919,1.0
65,80,80,59,63,58,405,0.4411764705882353,108,100,121,81,95,95,600,0.7476635514018691,1.0
64,115,65,83,63,65,455,0.5323741007194245,37,25,41,25,41,25,194,0.08870967741935484,1.0
80,105,65,60,75,130,515,0.9645390070921985,45,45,35,20,30,20,195,0.07246376811594203,4.0
64,66,68,81,76,50,405,0.25190839694656486,72,60,30,20,30,25,237,0.11570247933884298,1.0
65,90,40,45,80,75,395,0.625,65,47,55,73,75,85,400,0.65,1.0
58,64,58,80,65,80,405,0.609271523178808,60,40,60,40,60,35,295,0.18055555555555555,2.0
60,65,70,85,75,40,395,0.21705426356589147,31,45,90,30,30,40,266,0.21929824561403508,0.5
64,78,52,78,52,81,405,0.6422764227642277,80,82,100,83,100,80,525,0.6821705426356589,2.0
66,65,48,62,57,52,350,0.36220472440944884,62,48,54,63,60,68,355,0.5178571428571429,1.0
60,70,105,70,120,75,500,0.5983606557377049,85,135,130,60,80,25,515,0.40540540540540543,2.0
45,80,100,35,37,28,325,0.3125,58,64,58,80,65,80,405,0.5423728813559322,0.5
90,132,105,132,105,30,594,0.4246575342465753,60,55,145,75,150,40,525,0.2,0.5
80,105,105,105,105,80,580,0.5939849624060151,40,55,99,40,79,47,360,0.26262626262626265,2.0
65,90,115,45,115,58,488,0.5041322314049587,91,134,95,100,100,80,600,0.6304347826086957,0.5
55,66,44,44,56,85,350,0.6888888888888889,105,125,100,60,100,100,590,0.8359375,1.0
60,62,63,80,80,60,405,0.38016528925619836,80,120,80,120,80,100,580,0.8478260869565217,1.0
62,77,62,50,42,65,358,0.4838709677419355,80,70,65,80,120,100,515,0.8034188034188035,1.0
35,64,85,74,55,32,345,0.19827586206896552,53,54,53,37,46,45,288,0.3090909090909091,1.0
125,58,58,76,76,67,460,0.515625,90,55,75,60,75,30,385,0.13970588235294118,1.0
40,65,40,80,40,65,330,0.5038167938931297,125,58,58,76,76,67,460,0.515625,1.0
75,80,95,90,100,50,490,0.2158273381294964,106,110,90,154,90,130,680,0.926829268292683,1.0
62,73,55,56,52,84,382,0.7244094488188977,103,60,86,60,86,50,445,0.3458646616541353,1.0
60,85,60,85,60,55,405,0.3673469387755102,40,55,30,30,30,85,270,0.688,1.0
90,95,105,165,110,45,610,0.2890625,71,82,64,64,59,112,452,0.9327731092436975,1.0
100,150,120,120,100,90,680,0.6493506493506493,45,80,100,35,37,28,325,0.3125,0.5
70,60,75,110,75,90,480,0.7165354330708661,44,38,39,61,79,42,303,0.2251655629139073,1.0
40,45,40,35,35,56,251,0.373015873015873,65,90,120,85,70,60,490,0.43410852713178294,1.0
60,55,90,145,90,80,520,0.6071428571428571,40,60,30,31,31,70,262,0.4492753623188406,0.0
45,35,45,62,53,35,275,0.11851851851851852,72,85,70,65,70,58,420,0.41304347826086957,0.5
50,150,50,150,50,150,600,0.9339622641509434,40,70,40,35,40,60,285,0.392,1.0
55,50,45,135,95,120,500,0.7714285714285715,50,50,150,50,150,50,500,0.2571428571428571,1.0
75,98,63,98,63,101,498,0.849624060150376,90,120,75,60,60,45,450,0.29411764705882354,1.0
45,49,65,49,65,45,318,0.275,85,105,55,85,50,115,495,0.9032258064516129,2.0
90,50,34,60,44,70,348,0.6283185840707964,105,125,100,60,100,100,590,0.8359375,0.0
97,165,60,65,50,58,495,0.3902439024390244,80,95,82,60,82,75,474,0.6,1.0
90,100,90,125,85,90,580,0.7352941176470589,50,85,55,65,65,90,410,0.7478260869565218,0.5
45,75,60,40,30,50,300,0.304,70,100,70,105,75,40,460,0.23214285714285715,1.0
40,29,45,29,45,36,224,0.14634146341463414,75,125,75,30,75,85,465,0.625,0.5
40,30,50,55,55,100,330,0.584070796460177,25,35,70,95,55,45,325,0.16783216783216784,0.5
44,38,33,61,43,70,289,0.5267857142857143,55,55,50,45,65,55,325,0.37373737373737376,1.0
60,62,80,63,80,60,405,0.4336283185840708,70,45,48,60,65,35,323,0.15748031496062992,1.0
40,30,32,50,52,65,269,0.3671875,60,90,55,90,80,110,485,0.8677685950413223,1.0
80,80,80,55,55,90,440,0.6417910447761194,35,70,55,45,55,25,285,0.09420289855072464,1.0
60,150,50,150,50,60,520,0.5,38,30,41,30,41,60,240,0.2897196261682243,0.0
50,25,28,45,55,15,218,0.0625,40,50,90,30,55,65,330,0.44680851063829785,0.5
88,107,122,74,75,64,530,0.4596774193548387,105,180,100,180,100,115,780,0.9477611940298507,0.125
40,55,99,40,79,47,360,0.26262626262626265,70,62,67,55,55,56,365,0.38513513513513514,0.25
45,50,45,115,55,95,405,0.6936936936936937,40,50,90,30,55,65,330,0.44680851063829785,0.5
77,59,50,67,63,46,362,0.23140495867768596,65,125,60,95,60,105,510,0.9236641221374046,0.5
60,65,80,170,95,130,600,0.8625954198473282,95,117,80,65,70,92,519,0.8409090909090909,0.25
80,85,95,30,30,25,345,0.2857142857142857,20,40,90,30,90,25,295,0.11363636363636363,1.0
100,150,110,95,110,70,635,0.5923076923076923,50,75,45,40,45,60,315,0.4380165289256198,0.5
65,155,120,65,90,105,600,0.8677685950413223,55,85,122,58,75,99,494,0.8099173553719008,2.0
160,110,65,65,110,30,540,0.35714285714285715,100,150,110,95,110,70,635,0.5923076923076923,1.0
63,63,47,41,41,74,329,0.56,90,50,34,60,44,70,348,0.6283185840707964,1.0
75,95,125,45,75,95,510,0.8257575757575758,65,125,100,55,70,85,500,0.6532258064516129,1.0
100,103,75,120,75,127,600,0.940677966101695,85,80,90,105,95,60,515,0.49074074074074076,1.0
110,85,95,80,95,50,515,0.2713178294573643,150,100,120,100,120,90,680,0.6666666666666666,0.0
68,165,95,65,115,110,618,0.8615384615384616,49,49,56,49,61,66,330,0.5190839694656488,1.0
80,120,130,55,65,45,495,0.37037037037037035,40,30,30,40,50,30,220,0.07936507936507936,0.5
75,69,72,114,100,104,534,0.8253968253968254,35,35,40,35,55,50,250,0.40336134453781514,2.0
95,125,79,60,100,81,540,0.6165413533834586,72,95,67,103,71,122,530,0.9606299212598425,0.5
60,25,35,70,80,60,330,0.3076923076923077,80,75,150,75,150,50,580,0.30973451327433627,0.5
60,60,60,60,60,60,360,0.38095238095238093,91,72,90,129,90,108,580,0.8925619834710744,1.0
55,55,45,63,45,45,308,0.25,71,95,85,110,95,79,535,0.664,1.0
59,45,40,35,40,31,250,0.14285714285714285,44,50,91,24,86,10,305,0.1981981981981982,0.5
60,65,70,85,75,40,395,0.21705426356589147,70,94,50,94,50,66,424,0.48148148148148145,0.25
90,75,75,90,100,70,500,0.5462184873949579,95,60,79,100,125,81,540,0.6201550387596899,0.5
50,50,40,50,40,64,294,0.45588235294117646,100,120,100,150,120,90,680,0.728,1.0
108,112,118,68,72,47,525,0.2916666666666667,66,41,77,61,87,23,355,0.12096774193548387,1.0
55,95,55,35,75,115,430,0.9380530973451328,68,85,65,165,135,100,618,0.8083333333333333,1.0
50,60,60,60,60,30,320,0.11290322580645161,50,45,45,35,35,50,260,0.23529411764705882,1.0
65,75,90,97,123,44,494,0.1987179487179487,50,70,160,70,160,90,600,0.7417218543046358,1.0
95,75,110,100,80,30,490,0.15267175572519084,106,90,130,90,154,110,680,0.8699186991869918,0.5
106,130,90,110,154,90,680,0.719626168224299,91,72,90,129,90,108,580,0.8925619834710744,1.0
49,49,56,49,61,66,330,0.5190839694656488,85,90,80,70,80,130,535,0.9262295081967213,1.0
70,80,70,80,70,110,480,0.6594202898550725,63,60,55,50,50,71,349,0.5289256198347108,0.0
80,52,50,90,50,89,411,0.6666666666666666,190,33,58,33,58,33,405,0.13432835820895522,2.0
40,80,100,30,30,20,300,0.11851851851851852,90,100,90,125,85,90,580,0.7352941176470589,0.0
60,40,50,75,85,95,405,0.6044776119402985,50,100,150,100,150,50,600,0.37142857142857144,1.0
38,36,38,32,36,57,237,0.3893805309734513,109,66,84,81,99,32,471,0.2013888888888889,1.0
100,90,130,45,65,55,485,0.4253731343283582,60,90,140,50,50,40,430,0.2535211267605634,1.0
70,85,70,60,70,50,405,0.28378378378378377,130,65,60,110,95,65,525,0.5227272727272727,0.5
60,45,70,75,85,55,390,0.3008130081300813,70,77,60,97,60,108,472,0.8394160583941606,1.0
61,90,45,50,50,160,456,0.9230769230769231,55,95,55,35,75,115,430,0.9380530973451328,2.0
40,40,35,50,100,70,335,0.5031847133757962,70,110,80,55,80,105,500,0.8794326241134752,1.0
95,70,73,95,90,60,483,0.3983739837398374,80,80,80,80,80,80,480,0.5606060606060606,1.0
40,40,35,50,100,70,335,0.5031847133757962,110,85,95,80,95,50,515,0.2713178294573643,1.0
60,70,50,100,50,65,395,0.5217391304347826,80,100,70,60,70,95,475,0.7416666666666667,4.0
50,53,48,53,48,64,316,0.46153846153846156,65,130,60,75,60,75,465,0.689922480620155,1.0
65,95,57,100,85,93,495,0.7441860465116279,60,82,45,45,45,74,351,0.5752212389380531,1.0
55,45,43,55,43,72,313,0.5853658536585366,50,85,85,55,55,50,380,0.3902439024390244,0.25
85,105,100,79,83,78,530,0.5869565217391305,55,66,44,44,56,85,350,0.6888888888888889,1.0
66,41,77,61,87,23,355,0.12096774193548387,70,85,140,85,70,20,470,0.272,1.0
91,129,90,72,90,108,580,0.8536585365853658,80,120,130,55,65,45,495,0.37037037037037035,1.0
75,98,63,98,63,101,498,0.8091603053435115,105,180,100,180,100,115,780,0.9477611940298507,0.25
30,30,42,30,42,70,244,0.4230769230769231,71,82,64,64,59,112,452,0.9327731092436975,1.0
60,85,42,85,42,91,405,0.8227848101265823,80,185,115,40,105,75,600,0.6230769230769231,2.0
60,69,95,69,95,36,424,0.2608695652173913,70,60,62,80,82,60,414,0.4375,0.5
35,70,55,45,55,25,285,0.09420289855072464,80,70,65,80,120,100,515,0.8034188034188035,0.5
50,150,50,150,50,150,600,0.9339622641509434,45,53,70,40,60,42,310,0.25735294117647056,1.0
60,60,60,105,105,105,495,0.848,35,70,55,45,55,25,285,0.09420289855072464,1.0
95,65,110,60,130,65,525,0.5275590551181102,91,90,129,90,72,108,580,0.9140625,0.5
55,75,50,40,40,80,340,0.6302521008403361,35,20,65,40,65,20,245,0.02459016393442623,1.0
74,48,76,83,81,104,466,0.7913043478260869,35,46,34,35,45,20,215,0.072,1.0
60,50,150,50,150,60,520,0.5206611570247934,40,55,80,35,60,30,300,0.15037593984962405,1.0
40,55,70,45,60,30,300,0.10619469026548672,45,45,55,45,55,63,308,0.4594594594594595,1.0
60,65,70,85,75,40,395,0.21705426356589147,52,65,50,45,50,38,300,0.27419354838709675,0.5
60,85,69,60,69,77,420,0.518796992481203,75,89,85,55,65,36,405,0.29545454545454547,1.0
53,51,53,61,56,40,314,0.14285714285714285,55,66,44,44,56,85,350,0.6888888888888889,1.0
61,78,95,56,58,57,405,0.40336134453781514,38,35,35,65,55,50,278,0.2647058823529412,1.0
80,105,65,60,75,130,515,0.9645390070921985,60,95,80,60,80,30,405,0.19480519480519481,8.0
70,70,70,70,70,70,420,0.5289256198347108,35,55,40,45,40,60,275,0.35714285714285715,1.0
66,65,48,62,57,52,350,0.36220472440944884,100,110,90,85,90,60,535,0.47794117647058826,4.0
105,150,90,150,90,95,680,0.8285714285714286,90,90,85,125,90,100,580,0.768595041322314,0.5
45,30,40,105,50,20,290,0.031007751937984496,80,80,80,80,80,80,480,0.5606060606060606,1.0
71,95,85,110,95,79,535,0.664,78,81,71,74,69,126,499,0.9090909090909091,1.0
67,58,57,81,67,101,431,0.8790322580645161,54,63,52,83,56,97,405,0.7697841726618705,2.0
70,90,70,60,60,70,420,0.6390977443609023,45,60,32,50,32,76,295,0.5925925925925926,1.0
39,52,43,60,50,65,309,0.5041322314049587,75,69,72,114,100,104,534,0.8253968253968254,0.5
38,35,40,27,25,35,200,0.08208955223880597,45,50,43,40,38,62,278,0.40441176470588236,0.5
95,125,79,60,100,81,540,0.6165413533834586,1,90,45,30,30,40,236,0.33064516129032256,2.0
77,85,51,55,51,65,384,0.5163934426229508,35,55,40,50,50,90,320,0.6838235294117647,1.0
60,85,60,85,60,55,405,0.3673469387755102,80,110,60,150,130,70,600,0.5042016806722689,0.0
76,147,90,60,70,97,540,0.8267716535433071,78,84,78,109,85,100,534,0.8646616541353384,1.0
44,48,65,50,64,43,314,0.1623931623931624,60,85,60,50,50,125,430,0.9090909090909091,1.0
100,150,140,100,90,90,670,0.7969924812030075,60,85,69,65,79,80,438,0.576,2.0
65,83,57,95,85,105,490,0.8914728682170543,42,52,67,39,56,50,306,0.2868217054263566,2.0
40,50,45,70,45,70,320,0.5517241379310345,45,55,45,65,45,75,330,0.5692307692307692,1.0
51,65,65,80,75,59,395,0.4365079365079365,90,50,34,60,44,70,348,0.6283185840707964,2.0
40,55,99,40,79,47,360,0.26262626262626265,20,40,15,35,35,60,205,0.34285714285714286,1.0
100,75,115,90,115,85,580,0.6446280991735537,76,25,45,67,55,24,292,0.0390625,1.0
70,55,65,95,85,70,440,0.5307692307692308,55,45,45,25,25,15,210,0.048,1.0
50,105,125,55,95,50,480,0.375886524822695,54,78,103,53,45,22,355,0.23255813953488372,1.0
80,80,80,55,55,90,440,0.6417910447761194,80,52,50,90,50,89,411,0.6666666666666666,1.0
64,51,23,51,23,28,240,0.11363636363636363,80,145,150,105,110,110,700,0.8692307692307693,0.5
60,40,60,95,60,55,370,0.4222222222222222,86,92,88,68,75,73,482,0.6835443037974683,1.0
90,85,100,95,125,85,580,0.6834532374100719,45,100,135,65,135,45,525,0.29411764705882354,1.0
43,30,55,40,65,97,330,0.6030534351145038,50,70,160,70,160,90,600,0.7417218543046358,1.0
45,85,50,55,50,65,350,0.5076923076923077,50,85,85,55,55,50,380,0.3902439024390244,1.0
90,65,65,40,40,15,315,0.19672131147540983,60,48,45,43,90,42,328,0.21897810218978103,0.5
70,84,70,65,70,51,410,0.2949640287769784,79,103,120,135,115,78,630,0.5763888888888888,1.0
80,92,65,65,80,68,450,0.4824561403508772,85,73,70,73,115,67,483,0.5126050420168067,1.0
50,50,77,95,77,91,440,0.5916666666666667,60,40,60,95,60,55,370,0.4222222222222222,2.0
45,100,45,45,45,10,290,0.2949640287769784,91,90,72,90,129,108,580,0.896,0.5
50,65,107,105,107,86,520,0.7272727272727273,116,55,85,107,95,29,487,0.06818181818181818,1.0
45,22,60,27,30,29,213,0.07518796992481203,55,81,60,50,70,97,413,0.7214285714285714,1.0
90,93,55,70,55,55,418,0.3819444444444444,45,35,50,70,50,30,280,0.15753424657534246,2.0
30,35,30,100,35,80,310,0.4765625,69,55,45,55,55,15,294,0.11666666666666667,1.0
66,117,70,40,50,67,410,0.4573643410852713,125,58,58,76,76,67,460,0.515625,1.0
40,80,100,30,30,20,300,0.11851851851851852,45,30,15,85,65,65,305,0.36220472440944884,2.0
55,65,95,95,45,85,440,0.6610169491525424,76,104,71,104,71,108,534,0.912751677852349,2.0
75,90,140,60,60,40,465,0.3008130081300813,95,75,80,100,110,30,490,0.24242424242424243,1.0
103,60,86,60,86,50,445,0.3458646616541353,60,40,80,60,45,40,325,0.23529411764705882,1.0
64,51,23,51,23,28,240,0.11363636363636363,106,90,130,90,154,110,680,0.8699186991869918,1.0
70,60,62,80,82,60,414,0.4375,55,45,43,55,43,72,313,0.5853658536585366,1.0
68,125,65,65,115,80,518,0.6277372262773723,70,110,180,60,60,50,530,0.4117647058823529,2.0
79,103,120,135,115,78,630,0.5763888888888888,30,30,42,30,42,70,244,0.4230769230769231,1.0
60,70,105,70,120,75,500,0.5983606557377049,50,50,50,50,50,50,300,0.30708661417322836,1.0
150,80,44,90,54,80,498,0.625,60,62,50,62,60,40,334,0.18181818181818182,2.0
90,75,85,115,90,55,510,0.3445378151260504,50,40,85,40,65,25,305,0.08870967741935484,1.0
70,55,55,80,60,45,365,0.2222222222222222,40,29,45,29,45,36,224,0.14634146341463414,1.0
62,77,62,50,42,65,358,0.4838709677419355,95,110,80,70,80,50,485,0.37209302325581395,1.0
60,59,85,79,105,36,424,0.16666666666666666,65,125,100,60,70,70,490,0.6099290780141844,0.5
75,125,230,55,95,30,610,0.3448275862068966,80,120,79,95,79,70,523,0.5833333333333334,1.0
65,45,55,45,70,45,325,0.24369747899159663,71,120,95,120,95,99,600,0.8203125,1.0
65,40,50,125,60,30,370,0.07258064516129033,65,90,65,61,61,100,442,0.8373983739837398,1.0
50,60,60,60,60,30,320,0.11290322580645161,50,70,50,50,50,70,340,0.5645161290322581,0.5
70,55,55,80,60,45,365,0.2222222222222222,82,80,86,85,75,72,480,0.6183206106870229,1.0
55,70,40,60,40,40,305,0.26956521739130435,70,95,125,65,75,45,475,0.33613445378151263,1.0
40,55,99,40,79,47,360,0.26262626262626265,38,36,38,32,36,57,237,0.3893805309734513,1.0
55,20,35,20,45,75,250,0.37681159420289856,70,20,50,20,50,40,250,0.1557377049180328,1.0
60,55,145,75,150,40,525,0.2,77,59,50,67,63,46,362,0.23140495867768596,8.0
85,110,76,65,82,56,474,0.3933333333333333,70,135,105,60,105,20,495,0.5806451612903226,0.25
85,120,70,50,60,100,485,0.8308823529411765,35,55,35,30,30,35,220,0.23684210526315788,1.0
65,125,100,60,70,70,490,0.6099290780141844,86,92,88,68,75,73,482,0.6835443037974683,1.0
80,80,80,80,80,80,480,0.6015037593984962,126,131,95,131,98,99,680,0.8294573643410853,1.0
65,90,120,85,70,60,490,0.43410852713178294,65,90,50,85,45,55,390,0.371900826446281,1.0
70,40,50,55,50,25,290,0.061068702290076333,79,100,80,110,90,121,580,0.968,2.0
50,60,60,60,60,30,320,0.11290322580645161,52,65,55,58,62,60,352,0.4482758620689655,1.0
65,60,110,130,95,65,525,0.47761194029850745,80,100,70,60,70,95,475,0.7416666666666667,2.0
74,108,133,83,65,32,495,0.32142857142857145,45,50,55,75,65,30,320,0.06293706293706294,0.5
55,40,85,80,105,40,405,0.23622047244094488,75,75,75,125,95,40,485,0.15671641791044777,1.0
50,50,120,80,80,30,410,0.07258064516129033,55,68,64,45,55,31,318,0.11666666666666667,2.0
90,95,105,165,110,45,610,0.2890625,72,58,80,103,80,97,490,0.7171052631578947,2.0
80,100,80,80,80,100,520,0.9051724137931034,40,45,40,65,40,65,295,0.5661764705882353,2.0
60,79,105,59,85,36,424,0.17054263565891473,70,70,115,130,90,60,535,0.5338983050847458,2.0
70,90,90,135,90,125,600,0.9401709401709402,70,120,65,45,85,125,510,0.9747899159663865,0.5
60,45,70,45,90,95,405,0.7304964539007093,68,72,78,38,42,32,330,0.23809523809523808,0.0
62,44,50,44,50,55,305,0.3629032258064516,75,70,90,70,105,80,490,0.656,0.5
60,85,42,85,42,91,405,0.8227848101265823,55,70,40,60,40,40,305,0.26956521739130435,1.0
75,90,90,140,90,115,600,0.9481481481481482,130,65,60,110,95,65,525,0.5227272727272727,0.5
90,85,100,95,125,85,580,0.6834532374100719,45,65,34,40,34,45,263,0.2589928057553957,0.5
70,55,65,95,85,70,440,0.5307692307692308,45,60,30,80,50,65,330,0.4603174603174603,0.0
90,100,70,110,150,80,600,0.6037735849056604,75,95,122,58,75,69,494,0.5725806451612904,1.0
60,70,50,100,50,65,395,0.5217391304347826,110,160,110,80,110,100,670,0.8591549295774648,1.0
90,92,75,92,85,60,494,0.49586776859504134,86,81,97,81,107,43,495,0.203125,2.0
50,75,75,65,65,50,380,0.4049586776859504,100,90,130,45,65,55,485,0.4253731343283582,1.0
50,65,64,44,48,43,314,0.2196969696969697,90,100,90,125,85,90,580,0.7352941176470589,2.0
60,40,80,60,45,40,325,0.23529411764705882,60,70,105,70,120,75,500,0.5983606557377049,2.0
55,85,122,58,75,99,494,0.8099173553719008,78,70,61,50,61,100,420,0.8145161290322581,0.0
60,85,40,30,45,68,328,0.6422018348623854,75,55,70,55,95,110,460,0.8444444444444444,0.0
46,57,40,40,40,50,273,0.25,67,82,62,46,48,43,348,0.22033898305084745,1.0
50,70,50,50,50,40,310,0.16296296296296298,84,86,88,111,101,60,530,0.4634146341463415,0.5
65,90,120,85,70,60,490,0.43410852713178294,62,77,62,50,42,65,358,0.4838709677419355,1.0
95,70,73,95,90,60,483,0.3983739837398374,45,63,37,65,55,95,360,0.8055555555555556,1.0
55,68,64,45,55,31,318,0.11666666666666667,125,120,90,170,100,95,700,0.78125,0.5
95,80,105,40,70,100,490,0.8046875,45,25,50,25,25,35,205,0.13076923076923078,1.0
55,75,85,25,25,15,280,0.1875,80,45,65,90,110,80,470,0.5462962962962963,1.0
70,60,125,115,70,55,495,0.35507246376811596,75,125,70,125,70,115,580,0.9037037037037037,1.0
90,120,100,150,120,100,680,0.7718120805369127,70,100,115,30,65,30,410,0.24390243902439024,2.0
65,90,122,58,75,84,494,0.71875,50,25,28,45,55,15,218,0.0625,1.0
68,85,65,165,135,100,618,0.8083333333333333,40,35,30,20,20,50,195,0.23423423423423423,1.0
65,80,80,59,63,58,405,0.4411764705882353,70,110,75,145,85,145,630,0.9444444444444444,0.25
80,120,79,95,79,70,523,0.5833333333333334,75,95,122,58,75,69,494,0.5725806451612904,0.5
103,93,67,71,61,84,479,0.7142857142857143,91,72,90,129,90,108,580,0.8925619834710744,0.5
80,82,83,100,100,80,525,0.6742424242424242,50,50,150,50,150,50,500,0.2571428571428571,2.0
1,90,45,30,30,40,236,0.33064516129032256,80,82,100,83,100,80,525,0.6821705426356589,2.0
60,80,95,70,85,50,440,0.2231404958677686,105,95,75,85,75,74,509,0.5714285714285714,0.5
78,65,68,112,154,75,552,0.628099173553719,65,150,60,115,60,115,565,0.935251798561151,2.0
30,30,42,30,42,70,244,0.4230769230769231,45,90,20,65,20,65,305,0.5116279069767442,2.0
190,33,58,33,58,33,405,0.13432835820895522,71,73,88,120,89,59,500,0.43537414965986393,1.0
60,75,85,100,85,115,520,0.8992248062015504,50,53,48,53,48,64,316,0.46153846153846156,2.0
85,135,130,60,80,25,515,0.40540540540540543,65,80,65,35,65,60,370,0.38405797101449274,1.0
90,85,75,115,100,115,580,0.9381443298969072,40,80,35,35,45,70,305,0.4661016949152542,1.0
150,80,44,90,54,80,498,0.625,70,65,65,55,55,70,380,0.5,0.0
67,57,55,77,55,114,425,0.8879310344827587,40,65,95,60,45,35,340,0.13986013986013987,2.0
45,63,37,65,55,95,360,0.8055555555555556,35,64,85,74,55,32,345,0.19827586206896552,2.0
80,135,130,95,90,70,600,0.5181818181818182,100,123,75,57,75,80,510,0.6923076923076923,1.0
75,125,100,70,80,45,495,0.33035714285714285,75,75,95,75,95,113,528,0.9015151515151515,2.0
100,100,100,100,100,100,600,0.8345864661654135,83,80,75,70,70,101,479,0.8615384615384616,0.5
45,53,70,40,60,42,310,0.25735294117647056,95,117,80,65,70,92,519,0.8409090909090909,4.0
70,135,105,60,105,20,495,0.5806451612903226,100,110,90,85,90,60,535,0.47794117647058826,0.5
77,85,51,55,51,65,384,0.5163934426229508,100,164,150,95,120,71,700,0.5645161290322581,2.0
40,30,30,55,30,85,270,0.4666666666666667,103,60,86,60,86,50,445,0.3458646616541353,1.0
100,70,70,65,65,45,415,0.1897810218978102,70,83,50,37,50,60,350,0.3360655737704918,1.0
100,100,100,100,100,100,600,0.8602941176470589,60,59,85,79,105,36,424,0.16666666666666666,0.25
55,84,105,114,75,52,485,0.2890625,105,150,90,150,90,95,680,0.8285714285714286,0.5
80,80,80,55,55,90,440,0.6417910447761194,45,100,45,45,45,10,290,0.2949640287769784,1.0
50,65,90,35,35,15,290,0.14678899082568808,70,45,48,60,65,35,323,0.15748031496062992,0.5
80,80,90,110,130,110,600,0.8721804511278195,30,65,100,45,25,40,305,0.1891891891891892,1.0
75,125,230,55,95,30,610,0.3448275862068966,70,70,115,130,90,60,535,0.5338983050847458,1.0
45,50,45,115,55,95,405,0.6936936936936937,95,109,105,75,85,56,525,0.34513274336283184,1.0
100,73,83,73,83,55,467,0.371900826446281,45,50,45,115,55,95,405,0.6936936936936937,0.25
100,100,100,100,100,100,600,0.8345864661654135,50,85,55,65,65,90,410,0.7478260869565218,0.5
64,78,52,78,52,81,405,0.6422764227642277,50,65,107,105,107,86,520,0.6991150442477876,0.5
66,65,48,62,57,52,350,0.36220472440944884,70,60,62,80,82,60,414,0.4375,0.25
40,55,30,30,30,60,245,0.43548387096774194,30,30,42,30,42,70,244,0.4230769230769231,2.0
65,45,55,45,70,45,325,0.24369747899159663,40,60,40,40,40,30,250,0.0948905109489051,1.0
67,57,55,77,55,114,425,0.8879310344827587,95,65,65,110,130,60,525,0.4016393442622951,1.0
50,85,40,85,40,35,335,0.1746031746031746,60,100,85,80,85,100,510,0.7007874015748031,1.0
50,50,50,50,50,50,300,0.30708661417322836,95,85,85,65,65,35,430,0.2571428571428571,1.0
84,86,88,111,101,60,530,0.4634146341463415,64,88,50,88,50,106,446,0.9111111111111111,1.0
75,125,75,30,75,85,465,0.625,69,55,45,55,55,15,294,0.11666666666666667,0.5
54,66,70,44,55,46,335,0.4214876033057851,90,92,87,75,85,76,505,0.5409836065573771,1.0
40,45,40,65,40,65,295,0.5661764705882353,74,100,72,90,72,46,454,0.24561403508771928,0.5
80,120,130,55,65,45,495,0.37037037037037035,60,45,70,45,90,95,405,0.7304964539007093,2.0
70,70,115,130,90,60,535,0.5338983050847458,106,110,90,154,90,130,680,0.926829268292683,1.0
59,59,58,90,70,73,409,0.5826086956521739,80,82,83,100,100,80,525,0.6742424242424242,2.0
51,65,65,80,75,59,395,0.4365079365079365,50,95,90,95,90,180,600,0.9172413793103448,1.0
64,51,23,51,23,28,240,0.11363636363636363,95,85,85,65,65,35,430,0.2571428571428571,1.0
20,10,230,10,230,5,505,0.0,55,45,45,25,25,15,210,0.048,0.5
30,45,59,30,39,57,260,0.2803030303030303,30,30,30,30,30,30,180,0.12612612612612611,4.0
120,120,120,120,120,120,720,0.9344262295081968,85,60,65,135,105,100,550,0.7518248175182481,1.0
50,35,55,25,25,15,205,0.05263157894736842,46,87,60,30,40,57,320,0.37777777777777777,1.0
67,89,116,79,116,33,500,0.2624113475177305,100,100,100,100,100,100,600,0.8345864661654135,0.5
70,65,60,90,75,90,450,0.6571428571428571,76,25,45,67,55,24,292,0.0390625,2.0
37,25,41,25,41,25,194,0.08870967741935484,40,40,50,30,30,30,220,0.0873015873015873,2.0
30,30,42,30,42,70,244,0.4230769230769231,70,60,70,87,78,85,450,0.6228070175438597,4.0
255,10,10,75,135,55,540,0.3125,100,73,83,73,83,55,467,0.371900826446281,1.0
65,95,57,100,85,93,495,0.7441860465116279,103,60,86,60,86,50,445,0.3458646616541353,1.0
50,50,150,50,150,50,500,0.2571428571428571,110,85,95,80,95,50,515,0.2713178294573643,1.0
75,89,85,55,65,36,405,0.29545454545454547,100,150,90,180,160,90,770,0.7348484848484849,2.0
126,131,95,131,98,99,680,0.8102189781021898,110,78,73,76,71,60,468,0.3333333333333333,1.0
73,115,60,60,60,90,458,0.6694915254237288,80,85,95,30,30,25,345,0.2857142857142857,0.5
85,100,122,58,75,54,494,0.3939393939393939,69,55,45,55,55,15,294,0.11666666666666667,0.25
75,75,95,75,95,113,528,0.9015151515151515,50,20,55,25,25,30,205,0.09774436090225563,0.5
72,58,80,103,80,97,490,0.7171052631578947,38,41,40,50,65,65,299,0.4108527131782946,1.0
106,190,100,154,100,130,780,0.9259259259259259,74,94,131,54,116,20,489,0.4485294117647059,1.0
95,135,80,110,80,100,600,0.8248175182481752,100,100,90,150,140,90,670,0.71875,1.0
59,63,80,65,80,58,405,0.41843971631205673,45,100,45,45,45,10,290,0.2949640287769784,2.0
75,80,55,25,35,35,305,0.18666666666666668,111,83,68,92,82,39,475,0.1774193548387097,1.0
79,103,120,135,115,78,630,0.5763888888888888,62,44,50,44,50,55,305,0.3629032258064516,0.5
60,82,45,45,45,74,351,0.5752212389380531,110,78,73,76,71,60,468,0.3333333333333333,1.0
30,45,55,70,55,85,340,0.5633802816901409,66,117,70,40,50,67,410,0.4573643410852713,0.5
60,75,85,100,85,115,520,0.8992248062015504,65,80,65,35,65,60,370,0.38405797101449274,1.0
73,115,60,60,60,90,458,0.6694915254237288,40,30,50,55,55,100,330,0.584070796460177,1.0
40,35,30,120,70,105,400,0.6692307692307692,73,95,62,85,65,85,465,0.6666666666666666,1.0
100,134,110,95,100,61,600,0.4057971014492754,75,80,60,65,90,102,472,0.8625954198473282,1.0
85,110,90,45,90,80,500,0.6206896551724138,74,48,76,83,81,104,466,0.7913043478260869,1.0
35,65,35,65,35,65,300,0.46621621621621623,63,63,47,41,41,74,329,0.56,1.0
70,150,140,65,100,75,600,0.55,61,84,65,70,70,70,420,0.5,1.0
70,55,55,80,60,45,365,0.2222222222222222,50,95,180,85,45,70,525,0.5298507462686567,2.0
95,100,85,108,70,70,528,0.5652173913043478,75,95,125,45,75,95,510,0.8257575757575758,2.0
60,60,50,40,50,75,335,0.5882352941176471,60,90,140,50,50,40,430,0.2535211267605634,0.25
75,100,110,45,55,65,450,0.5333333333333333,95,75,110,100,80,30,490,0.15267175572519084,1.0
75,90,50,110,80,95,500,0.7985611510791367,111,83,68,92,82,39,475,0.1774193548387097,0.5
90,100,70,110,150,80,600,0.6037735849056604,74,48,76,83,81,104,466,0.7322834645669292,1.0
48,61,40,61,40,50,300,0.2543859649122807,35,35,40,35,55,50,250,0.40336134453781514,1.0
70,120,40,95,40,95,460,0.8106060606060606,115,115,85,90,75,100,580,0.8134328358208955,2.0
74,100,72,90,72,46,454,0.24561403508771928,100,110,90,85,90,60,535,0.47794117647058826,4.0
80,80,80,80,80,80,480,0.6015037593984962,44,48,65,50,64,43,314,0.1623931623931624,0.5
65,90,120,85,70,60,490,0.43410852713178294,40,30,30,40,50,30,220,0.07936507936507936,2.0
70,110,80,55,80,105,500,0.8794326241134752,50,65,64,44,48,43,314,0.2196969696969697,1.0
90,60,60,40,40,40,330,0.29545454545454547,80,70,70,90,100,70,480,0.5609756097560976,0.5
40,30,35,50,70,55,280,0.28205128205128205,105,30,105,140,105,55,540,0.3524590163934426,0.5
72,85,70,65,70,58,420,0.41304347826086957,103,93,67,71,61,84,479,0.7142857142857143,0.5
35,60,44,40,54,55,288,0.366412213740458,70,95,85,55,65,70,440,0.5,0.5
72,105,115,54,86,68,500,0.5149253731343284,75,80,70,65,75,90,455,0.7578125,2.0
55,20,35,20,45,75,250,0.37681159420289856,45,60,32,50,32,76,295,0.5925925925925926,1.0
72,85,70,65,70,58,420,0.41304347826086957,65,83,57,95,85,105,490,0.8914728682170543,1.0
37,25,41,25,41,25,194,0.08870967741935484,79,100,80,110,90,121,580,0.968,0.5
95,110,80,70,80,50,485,0.37209302325581395,43,30,55,40,65,97,330,0.6030534351145038,0.5
80,100,200,50,100,50,580,0.3472222222222222,90,130,80,65,85,55,505,0.4396551724137931,0.5
65,70,60,65,65,115,440,0.8583333333333333,85,120,70,50,60,100,485,0.8308823529411765,1.0
60,60,60,35,35,30,280,0.11194029850746269,80,145,150,105,110,110,700,0.8692307692307693,0.5
55,84,105,114,75,52,485,0.2890625,99,68,83,72,87,51,460,0.417910447761194,0.5
89,145,90,105,80,91,600,0.8549618320610687,75,65,55,65,55,69,384,0.43548387096774194,1.0
60,85,42,85,42,91,405,0.8227848101265823,105,130,120,45,45,40,485,0.4444444444444444,0.5
89,125,90,115,80,101,600,0.8725490196078431,71,95,85,110,95,79,535,0.664,1.0
90,93,55,70,55,55,418,0.3819444444444444,65,83,57,95,85,105,490,0.8914728682170543,1.0
63,63,47,41,41,74,329,0.56,50,65,107,105,107,86,520,0.7272727272727273,1.0
50,180,20,180,20,150,600,0.9029850746268657,116,55,85,107,95,29,487,0.06818181818181818,0.5
65,90,50,85,45,55,390,0.371900826446281,58,70,45,40,45,42,300,0.25925925925925924,0.5
38,35,40,27,25,35,200,0.08208955223880597,108,112,118,68,72,47,525,0.2916666666666667,1.0
30,105,90,25,25,50,325,0.2773722627737226,50,85,40,85,40,35,335,0.1746031746031746,0.5
38,41,40,50,65,65,299,0.4108527131782946,90,70,80,70,95,70,475,0.5190839694656488,1.0
108,130,95,80,85,102,600,0.7637795275590551,59,66,70,44,55,41,335,0.25190839694656486,0.5
45,100,135,65,135,45,525,0.29411764705882354,105,95,80,40,80,90,490,0.753968253968254,0.0
75,125,70,125,70,115,580,0.9037037037037037,44,58,44,58,44,61,309,0.41964285714285715,1.0
60,100,89,55,69,112,485,0.9298245614035088,45,100,45,45,45,10,290,0.2949640287769784,0.5
55,55,55,85,55,30,335,0.1320754716981132,65,70,60,65,65,115,440,0.8583333333333333,1.0
95,65,65,110,130,60,525,0.4016393442622951,70,85,70,60,70,50,405,0.28378378378378377,1.0
60,40,50,75,85,95,405,0.6044776119402985,60,60,60,105,105,105,495,0.848,1.0
35,85,45,35,35,75,310,0.6492537313432836,65,60,70,85,75,40,395,0.1796875,1.0
70,50,30,95,135,105,485,0.8040540540540541,105,180,100,180,100,115,780,0.9477611940298507,4.0
85,100,122,58,75,54,494,0.3939393939393939,70,110,75,145,85,145,630,0.9444444444444444,0.25
60,75,85,100,85,115,520,0.8992248062015504,80,100,70,50,60,45,405,0.25806451612903225,1.0
78,92,75,74,63,118,500,0.8842975206611571,40,45,35,65,55,70,310,0.4482758620689655,2.0
70,110,70,115,70,90,525,0.75,70,110,80,55,80,105,500,0.8794326241134752,0.25
45,60,32,50,32,76,295,0.5925925925925926,45,90,20,65,20,65,305,0.5116279069767442,2.0
70,55,75,45,65,60,370,0.45901639344262296,60,85,42,85,42,91,405,0.8227848101265823,0.5
55,50,45,135,95,120,500,0.7714285714285715,80,45,65,90,110,80,470,0.5462962962962963,0.5
45,60,45,25,45,55,275,0.29,70,85,65,105,85,120,530,0.9262295081967213,1.0
55,85,122,58,75,99,494,0.8099173553719008,30,40,55,40,55,60,280,0.3237410071942446,2.0
80,82,100,83,100,80,525,0.6821705426356589,82,121,119,69,59,71,521,0.5394736842105263,1.0
90,92,87,75,85,76,505,0.5409836065573771,85,56,77,50,77,78,423,0.53125,0.5
44,75,35,63,33,45,295,0.2647058823529412,30,30,30,30,30,30,180,0.12612612612612611,1.0
91,134,95,100,100,80,600,0.6304347826086957,54,78,103,53,45,22,355,0.23255813953488372,0.5
90,92,75,92,85,60,494,0.49586776859504134,40,65,40,80,40,65,330,0.5038167938931297,1.0
100,75,115,90,115,85,580,0.6446280991735537,55,40,40,65,45,35,280,0.16428571428571428,1.0
65,155,120,65,90,105,600,0.8677685950413223,55,55,55,85,55,30,335,0.1320754716981132,2.0
50,50,120,80,80,30,410,0.07258064516129033,50,65,90,35,35,15,290,0.14678899082568808,4.0
40,80,100,30,30,20,300,0.11851851851851852,70,140,70,110,65,105,560,0.95,1.0
95,85,85,65,65,35,430,0.2571428571428571,80,80,80,55,55,90,440,0.6417910447761194,1.0
80,45,65,90,110,80,470,0.5462962962962963,50,53,48,53,48,64,316,0.358974358974359,1.0
30,80,90,55,45,55,355,0.4295774647887324,90,100,90,125,85,90,580,0.7352941176470589,8.0
91,129,90,72,90,108,580,0.8536585365853658,60,80,50,50,50,40,330,0.23853211009174313,2.0
75,70,90,70,105,80,490,0.656,59,59,58,90,70,73,409,0.5826086956521739,1.0
95,145,130,120,90,120,700,0.9398496240601504,70,120,65,45,85,125,510,0.9747899159663865,1.0
80,185,115,40,105,75,600,0.6230769230769231,91,90,129,90,72,108,580,0.9140625,0.5
45,49,65,49,65,45,318,0.275,130,65,60,110,95,65,525,0.5227272727272727,2.0
45,45,55,45,55,63,308,0.4594594594594595,65,125,60,95,60,105,510,0.9236641221374046,1.0
90,100,60,90,60,80,480,0.6422764227642277,75,87,63,87,63,98,473,0.865546218487395,1.0
45,35,50,70,50,30,280,0.15753424657534246,75,85,200,55,65,30,510,0.16778523489932887,1.0
38,36,38,32,36,57,237,0.3893805309734513,65,50,35,115,95,95,455,0.7333333333333333,1.0
55,40,40,65,45,35,280,0.16428571428571428,71,73,88,120,89,59,500,0.43537414965986393,2.0
43,30,55,40,65,97,330,0.6030534351145038,79,103,120,135,115,78,630,0.5763888888888888,0.5
59,66,70,44,55,41,335,0.25190839694656486,45,20,50,60,120,50,345,0.24074074074074073,1.0
58,50,145,95,105,30,483,0.2459016393442623,150,80,44,90,54,80,498,0.625,2.0
106,110,90,154,90,130,680,0.926829268292683,62,73,55,56,52,84,382,0.7244094488188977,1.0
90,95,105,165,110,45,610,0.2890625,85,76,64,45,55,90,415,0.6739130434782609,1.0
55,55,85,65,85,35,380,0.2014388489208633,105,105,75,65,100,50,500,0.37593984962406013,1.0
53,51,53,61,56,40,314,0.14285714285714285,65,80,80,59,63,58,405,0.4411764705882353,0.5
30,42,118,42,88,30,350,0.112,55,95,55,35,75,115,430,0.9380530973451328,4.0
50,105,125,55,95,50,480,0.375886524822695,65,110,130,60,65,95,525,0.8278145695364238,1.0
64,78,52,78,52,81,405,0.6422764227642277,75,80,70,65,75,90,455,0.7578125,0.25
95,95,85,125,65,55,520,0.3894736842105263,43,30,55,40,65,97,330,0.6030534351145038,2.0
91,90,72,90,129,108,580,0.896,55,84,105,114,75,52,485,0.2890625,2.0
103,93,67,71,61,84,479,0.7142857142857143,65,75,90,97,123,44,494,0.1987179487179487,0.5
35,55,40,45,40,60,275,0.35714285714285715,89,145,90,105,80,91,600,0.8549618320610687,0.0
53,51,53,61,56,40,314,0.14285714285714285,130,70,35,70,35,60,400,0.4017857142857143,0.5
10,55,25,35,45,95,265,0.5396825396825397,85,120,70,50,60,100,485,0.8308823529411765,0.0
75,98,63,98,63,101,498,0.849624060150376,65,75,70,95,70,95,470,0.7272727272727273,1.0
110,135,60,50,65,88,508,0.7744360902255639,100,110,90,85,90,60,535,0.47794117647058826,0.5
65,75,105,35,65,85,430,0.6940298507462687,85,105,100,79,83,78,530,0.5869565217391305,1.0
45,67,60,35,50,63,320,0.5128205128205128,75,100,110,45,55,65,450,0.5333333333333333,2.0
170,90,45,90,45,60,500,0.427536231884058,60,75,100,55,80,50,420,0.3088235294117647,1.0
85,60,65,135,105,100,550,0.7518248175182481,30,56,35,25,35,72,253,0.48148148148148145,1.0
53,51,53,61,56,40,314,0.14285714285714285,65,90,115,45,115,58,488,0.5041322314049587,1.0
125,120,90,170,100,95,700,0.78125,60,90,70,60,120,40,440,0.27419354838709675,1.0
100,90,130,45,65,55,485,0.4253731343283582,116,55,85,107,95,29,487,0.06818181818181818,1.0
95,155,109,70,130,81,640,0.6788321167883211,85,90,80,70,80,130,535,0.9262295081967213,1.0
35,35,40,35,55,50,250,0.40336134453781514,65,75,70,95,70,95,470,0.7272727272727273,0.5
30,40,55,40,55,60,280,0.3237410071942446,100,150,120,120,100,90,680,0.6493506493506493,1.0
35,60,44,40,54,55,288,0.366412213740458,106,130,90,110,154,90,680,0.719626168224299,1.0
50,53,48,53,48,64,316,0.358974358974359,39,52,43,60,50,65,309,0.49107142857142855,2.0
111,83,68,92,82,39,475,0.1774193548387097,64,78,52,78,52,81,405,0.6422764227642277,4.0
35,64,85,74,55,32,345,0.19827586206896552,91,90,106,130,106,77,600,0.648854961832061,2.0
90,90,85,125,90,100,580,0.768595041322314,65,80,140,40,70,70,465,0.5223880597014925,1.0
40,60,40,40,40,30,250,0.0948905109489051,43,80,65,50,35,35,308,0.14193548387096774,1.0
59,74,50,35,50,35,303,0.3125,100,150,110,95,110,70,635,0.5923076923076923,1.0
76,65,45,92,42,91,411,0.7449664429530202,85,105,85,40,50,40,405,0.211864406779661,2.0
25,35,70,95,55,45,325,0.16783216783216784,105,140,55,30,55,95,480,0.8195488721804511,0.5
75,110,110,110,105,80,590,0.656934306569343,42,52,67,39,56,50,306,0.2868217054263566,1.0
70,110,180,60,60,50,530,0.4117647058823529,60,60,75,60,75,80,410,0.7321428571428571,0.5
50,50,77,95,77,91,440,0.5916666666666667,116,55,85,107,95,29,487,0.06818181818181818,2.0
80,160,60,170,130,80,680,0.6180555555555556,74,100,72,90,72,46,454,0.24561403508771928,1.0
64,51,23,51,23,28,240,0.11363636363636363,60,45,70,45,90,95,405,0.7304964539007093,1.0
59,110,150,45,49,35,448,0.3333333333333333,105,150,90,150,90,95,680,0.8285714285714286,1.0
91,90,129,90,72,108,580,0.9140625,44,38,39,61,79,42,303,0.2251655629139073,0.25
50,60,45,100,80,65,400,0.45689655172413796,67,82,62,46,48,43,348,0.22033898305084745,1.0
50,105,125,55,95,50,480,0.375886524822695,65,130,60,75,60,75,465,0.689922480620155,2.0
74,94,131,54,116,20,489,0.4485294117647059,125,120,90,170,100,95,700,0.78125,1.0
50,120,53,35,110,87,455,0.640625,76,147,90,60,70,97,540,0.8267716535433071,1.0
40,45,40,35,35,56,251,0.373015873015873,50,75,45,40,45,60,315,0.4380165289256198,2.0
85,97,66,105,66,65,484,0.47107438016528924,100,100,100,100,100,100,600,0.8602941176470589,2.0
50,53,48,53,48,64,316,0.4076923076923077,50,65,107,105,107,86,520,0.7313432835820896,0.5
65,125,100,55,70,85,500,0.6532258064516129,78,84,78,109,85,100,534,0.8646616541353384,0.25
70,110,80,55,80,105,500,0.8794326241134752,110,78,73,76,71,60,468,0.3333333333333333,1.0
86,68,72,109,66,106,507,0.8099173553719008,45,100,45,45,45,10,290,0.2949640287769784,1.0
76,104,71,104,71,108,534,0.912751677852349,70,110,80,55,80,105,500,0.8794326241134752,0.5
105,105,75,65,100,50,500,0.37593984962406013,44,58,44,58,44,61,309,0.41964285714285715,1.0
110,65,105,55,95,80,510,0.6258503401360545,20,10,230,10,230,5,505,0.0,1.0
55,45,50,45,65,80,340,0.5546218487394958,73,115,60,60,60,90,458,0.6694915254237288,1.0
64,115,65,83,63,65,455,0.5323741007194245,120,120,120,120,120,120,720,0.9344262295081968,0.0
105,105,75,65,100,50,500,0.37593984962406013,90,50,34,60,44,70,348,0.6283185840707964,0.5
44,48,65,50,64,43,314,0.1623931623931624,170,90,45,90,45,60,500,0.427536231884058,0.5
106,190,100,154,100,130,780,0.9259259259259259,90,85,100,95,125,85,580,0.6834532374100719,1.0
70,65,60,90,75,90,450,0.6571428571428571,60,62,50,62,60,40,334,0.18181818181818182,4.0
60,50,70,80,80,140,480,0.8449612403100775,80,70,70,90,100,70,480,0.5609756097560976,1.0
45,75,37,70,55,83,365,0.6183206106870229,60,55,90,145,90,80,520,0.6071428571428571,0.5
85,120,70,50,60,100,485,0.8308823529411765,69,55,45,55,55,15,294,0.11666666666666667,2.0
70,70,115,130,90,60,535,0.5338983050847458,70,150,140,65,100,75,600,0.55,0.5
83,80,80,135,80,121,579,0.9444444444444444,50,95,90,95,90,180,600,0.9172413793103448,1.0
72,95,67,103,71,122,530,0.9606299212598425,72,58,80,103,80,97,490,0.7171052631578947,2.0
79,105,70,145,80,101,580,0.8608695652173913,55,65,95,95,45,85,440,0.6610169491525424,2.0
86,76,86,116,56,95,515,0.7982456140350878,105,95,80,40,80,90,490,0.753968253968254,1.0
40,50,45,70,45,70,320,0.5517241379310345,45,50,45,115,55,95,405,0.6936936936936937,2.0
80,75,150,75,150,50,580,0.30973451327433627,60,60,60,105,105,105,495,0.848,1.0
90,75,85,115,90,55,510,0.3445378151260504,40,55,80,35,60,30,300,0.15037593984962405,1.0
70,60,62,80,82,60,414,0.4375,74,48,76,83,81,104,466,0.7913043478260869,2.0
70,84,70,65,70,51,410,0.2949640287769784,50,50,95,40,50,35,320,0.20279720279720279,0.5
88,107,122,74,75,64,530,0.4596774193548387,31,45,90,30,30,40,266,0.21929824561403508,0.5
50,20,40,20,40,20,190,0.0962962962962963,50,50,40,50,40,64,294,0.45588235294117646,1.0
64,115,65,83,63,65,455,0.5323741007194245,120,70,120,75,130,85,600,0.6694915254237288,2.0
44,48,65,50,64,43,314,0.1623931623931624,65,47,55,73,75,85,400,0.65,1.0
80,80,80,80,80,80,480,0.5606060606060606,60,85,60,50,50,125,430,0.9090909090909091,1.0
65,100,70,80,80,105,500,0.8666666666666667,50,40,85,40,65,25,305,0.08870967741935484,2.0
70,55,65,95,85,70,440,0.5307692307692308,73,76,75,81,100,100,505,0.8110236220472441,2.0
78,130,111,130,85,100,634,0.8561151079136691,54,63,52,83,56,97,405,0.7697841726618705,0.5
70,62,67,55,55,56,365,0.38513513513513514,80,80,50,40,50,25,325,0.176056338028169,0.5
30,45,55,70,55,85,340,0.5633802816901409,46,57,40,40,40,50,273,0.25,1.0
60,60,60,105,105,105,495,0.848,50,50,62,40,62,65,329,0.4188034188034188,1.0
35,55,40,50,50,90,320,0.6838235294117647,60,150,50,150,50,60,520,0.5,1.0
60,80,50,50,50,40,330,0.23853211009174313,45,85,70,40,40,60,340,0.5229357798165137,0.5
35,55,40,50,50,90,320,0.6838235294117647,50,35,55,25,25,15,205,0.05263157894736842,1.0
80,120,70,110,70,80,530,0.6422764227642277,45,53,70,40,60,42,310,0.25735294117647056,2.0
100,150,120,120,100,90,680,0.6493506493506493,61,90,45,50,50,160,456,0.9230769230769231,2.0
75,98,63,98,63,101,498,0.849624060150376,125,120,90,170,100,95,700,0.78125,0.5
80,185,115,40,105,75,600,0.6230769230769231,44,38,39,61,79,42,303,0.2251655629139073,0.25
100,100,80,60,60,50,450,0.3050847457627119,100,120,120,150,100,90,680,0.7880794701986755,2.0
70,75,80,135,80,135,575,0.917910447761194,72,60,30,20,30,25,237,0.11570247933884298,1.0
40,45,40,35,35,56,251,0.373015873015873,59,59,58,90,70,73,409,0.5826086956521739,1.0
60,55,50,40,55,45,305,0.22377622377622378,90,75,85,115,90,55,510,0.3445378151260504,1.0
90,130,80,65,85,55,505,0.4396551724137931,65,150,40,15,80,145,495,0.9663865546218487,0.25
75,95,67,125,95,83,540,0.7117117117117117,125,58,58,76,76,67,460,0.515625,0.5
85,110,76,65,82,56,474,0.3933333333333333,80,125,75,40,95,85,500,0.6911764705882353,0.5
65,65,60,110,95,130,525,0.9253731343283582,150,120,100,120,100,90,680,0.664179104477612,0.5
95,110,95,40,95,55,490,0.40336134453781514,60,100,85,80,85,100,510,0.7007874015748031,1.0
65,80,65,35,65,60,370,0.38405797101449274,53,51,53,61,56,40,314,0.14285714285714285,1.0
60,40,80,60,45,40,325,0.23529411764705882,125,130,90,130,90,95,660,0.7734375,0.5
65,40,70,80,140,70,465,0.5954198473282443,64,78,52,78,52,81,405,0.6422764227642277,4.0
78,130,111,130,85,100,634,0.8561151079136691,65,95,75,55,55,85,430,0.6933333333333334,0.5
40,55,30,30,30,60,245,0.43548387096774194,45,100,135,65,135,45,525,0.29411764705882354,0.0
60,100,89,55,69,112,485,0.9298245614035088,50,160,110,160,110,110,700,0.8854961832061069,0.5
55,40,50,65,85,40,335,0.3181818181818182,85,110,90,45,90,80,500,0.6206896551724138,0.0
85,76,64,45,55,90,415,0.6739130434782609,90,120,75,60,60,45,450,0.29411764705882354,1.0
60,130,80,60,60,70,460,0.5153846153846153,70,80,70,80,70,110,480,0.6594202898550725,0.0
50,180,20,180,20,150,600,0.9029850746268657,95,109,105,75,85,56,525,0.34513274336283184,2.0
95,60,79,100,125,81,540,0.6201550387596899,50,65,107,105,107,86,520,0.7272727272727273,1.0
45,50,45,115,55,95,405,0.6936936936936937,110,80,90,95,90,65,530,0.5033557046979866,1.0
110,130,80,70,60,80,530,0.5862068965517241,50,100,150,100,150,50,600,0.37142857142857144,2.0
55,69,85,32,35,28,304,0.09302325581395349,125,170,100,120,90,95,700,0.77,1.0
71,82,64,64,59,112,452,0.9327731092436975,62,50,58,73,54,72,369,0.4435483870967742,1.0
45,65,34,40,34,45,263,0.2589928057553957,130,70,35,70,35,60,400,0.4017857142857143,2.0
75,80,95,90,100,50,490,0.2158273381294964,78,92,75,74,63,118,500,0.8842975206611571,0.5
50,65,85,35,35,55,325,0.32575757575757575,77,120,90,60,90,48,485,0.2785714285714286,1.0
35,35,40,35,55,50,250,0.40336134453781514,43,30,55,40,65,97,330,0.6030534351145038,2.0
165,75,80,40,45,65,470,0.5151515151515151,43,80,65,50,35,35,308,0.14193548387096774,0.5
90,85,75,115,100,115,580,0.9381443298969072,70,120,40,95,40,95,460,0.8106060606060606,2.0
91,72,90,129,90,108,580,0.8620689655172413,95,125,79,60,100,81,540,0.6165413533834586,0.25
70,75,80,135,80,135,575,0.917910447761194,70,80,102,80,102,40,474,0.2677165354330709,2.0
80,75,150,75,150,50,580,0.30973451327433627,80,90,80,130,110,110,600,0.856,1.0
60,80,50,40,40,30,300,0.15328467153284672,70,77,60,97,60,108,472,0.8394160583941606,1.0
48,61,40,61,40,50,300,0.2543859649122807,70,84,70,65,70,51,410,0.2949640287769784,0.5
50,65,107,105,107,86,520,0.6991150442477876,120,70,120,75,130,85,600,0.6694915254237288,1.0
84,86,88,111,101,60,530,0.4634146341463415,77,120,90,60,90,48,485,0.2785714285714286,0.5
90,55,75,60,75,30,385,0.13970588235294118,65,95,75,55,55,85,430,0.6933333333333334,1.0
70,94,50,94,50,66,424,0.48148148148148145,55,70,40,60,40,40,305,0.26956521739130435,1.0
70,115,60,115,60,55,475,0.4647887323943662,120,70,120,75,130,85,600,0.6694915254237288,2.0
60,55,50,40,55,45,305,0.22377622377622378,114,85,70,85,80,30,464,0.2066115702479339,1.0
100,100,80,60,60,50,450,0.3050847457627119,75,95,122,58,75,69,494,0.5725806451612904,1.0
80,95,82,60,82,75,474,0.6,65,70,60,65,65,115,440,0.8583333333333333,1.0
40,55,30,30,30,85,270,0.688,38,30,41,30,41,60,240,0.2897196261682243,1.0
75,95,95,95,95,85,540,0.6470588235294118,78,81,71,74,69,126,499,0.9090909090909091,2.0
60,40,50,75,85,95,405,0.6044776119402985,76,25,45,67,55,24,292,0.0390625,1.0
74,108,133,83,65,32,495,0.32142857142857145,45,40,60,40,75,50,310,0.2926829268292683,2.0
73,115,60,60,60,90,458,0.6694915254237288,35,55,40,45,40,60,275,0.35714285714285715,1.0
50,70,50,50,50,40,310,0.16296296296296298,30,105,90,25,25,50,325,0.2773722627737226,0.5
70,120,65,45,85,125,510,0.9747899159663865,75,98,63,98,63,101,498,0.849624060150376,0.5
95,75,80,100,110,30,490,0.24242424242424243,85,105,55,85,50,115,495,0.9032258064516129,0.5
70,40,50,55,50,25,290,0.061068702290076333,45,25,50,25,25,35,205,0.13076923076923078,1.0
75,100,110,45,55,65,450,0.5333333333333333,78,130,111,130,85,100,634,0.8561151079136691,2.0
110,80,90,95,90,65,530,0.5033557046979866,50,65,64,44,48,43,314,0.2196969696969697,0.25
86,68,72,109,66,106,507,0.8099173553719008,62,77,62,50,42,65,358,0.4838709677419355,1.0
95,124,78,69,71,58,495,0.37398373983739835,110,80,90,95,90,65,530,0.5033557046979866,2.0
60,60,60,35,35,30,280,0.11194029850746269,60,40,60,40,60,35,295,0.18055555555555555,1.0
79,103,120,135,115,78,630,0.5763888888888888,150,160,100,95,65,100,670,0.8866666666666667,1.0
78,52,60,63,65,23,341,0.06015037593984962,1,90,45,30,30,40,236,0.33064516129032256,1.0
90,120,75,60,60,45,450,0.29411764705882354,70,75,80,135,80,135,575,0.917910447761194,1.0
60,50,150,50,150,60,520,0.5206611570247934,73,115,60,60,60,90,458,0.6694915254237288,0.0
95,60,79,100,125,81,540,0.6201550387596899,43,30,55,40,65,97,330,0.6030534351145038,0.5
80,110,120,130,90,70,600,0.6198347107438017,60,115,105,65,70,80,495,0.7181818181818181,0.25
70,120,40,95,40,95,460,0.8106060606060606,75,65,55,65,55,69,384,0.43548387096774194,1.0
110,80,90,95,90,65,530,0.5033557046979866,75,95,125,45,75,95,510,0.8257575757575758,8.0
39,52,43,60,50,65,309,0.5041322314049587,60,80,50,50,50,40,330,0.23853211009174313,1.0
90,30,15,40,20,15,210,0.043478260869565216,91,90,129,90,72,108,580,0.9140625,0.5
60,55,50,40,55,45,305,0.22377622377622378,70,84,70,65,70,51,410,0.2949640287769784,0.25
110,160,110,80,110,100,670,0.8591549295774648,80,120,79,95,79,70,523,0.5833333333333334,1.0
70,77,60,97,60,108,472,0.8394160583941606,60,60,40,65,45,35,305,0.15833333333333333,0.0
30,30,42,30,42,70,244,0.4230769230769231,75,85,200,55,65,30,510,0.16778523489932887,0.25
60,150,50,150,50,60,520,0.5,53,54,53,37,46,45,288,0.3090909090909091,1.0
44,50,91,24,86,10,305,0.1981981981981982,90,60,60,40,40,40,330,0.29545454545454547,2.0
40,45,40,65,40,65,295,0.5661764705882353,55,66,44,44,56,85,350,0.6888888888888889,1.0
104,91,63,91,73,68,490,0.5118110236220472,50,50,120,80,80,30,410,0.07258064516129033,0.5
59,45,40,35,40,31,250,0.14285714285714285,80,110,60,150,130,70,600,0.5042016806722689,0.0
125,170,100,120,90,95,700,0.77,60,50,150,50,150,60,520,0.5206611570247934,0.25
60,45,50,90,80,70,395,0.625,44,38,39,61,79,42,303,0.2251655629139073,0.5
71,120,95,120,95,99,600,0.8203125,100,70,70,65,65,45,415,0.1897810218978102,1.0
78,70,61,50,61,100,420,0.8145161290322581,71,120,95,120,95,99,600,0.8203125,0.5
74,94,131,54,116,20,489,0.4485294117647059,75,100,95,40,70,110,490,0.8717948717948718,1.0
60,90,55,90,80,110,485,0.8677685950413223,100,150,110,95,110,70,635,0.5923076923076923,0.0
106,150,70,194,120,140,780,0.952,68,90,65,50,55,82,410,0.6165413533834586,2.0
45,67,60,35,50,63,320,0.5128205128205128,70,75,80,135,80,135,575,0.917910447761194,1.0
40,40,35,50,100,70,335,0.5031847133757962,95,125,79,60,100,81,540,0.6165413533834586,0.5
75,90,50,110,80,95,500,0.7985611510791367,60,69,95,69,95,36,424,0.2608695652173913,4.0
100,73,83,73,83,55,467,0.371900826446281,65,90,65,61,61,100,442,0.8373983739837398,1.0
49,66,70,44,55,51,335,0.4260869565217391,75,125,75,30,75,85,465,0.625,1.0
100,150,110,95,110,70,635,0.5923076923076923,90,55,75,60,75,30,385,0.13970588235294118,1.0
46,57,40,40,40,50,273,0.25,45,25,50,25,25,35,205,0.13076923076923078,0.5
111,83,68,92,82,39,475,0.1774193548387097,95,70,73,95,90,60,483,0.3983739837398374,1.0
60,40,80,60,45,40,325,0.23529411764705882,63,60,55,50,50,71,349,0.5289256198347108,0.5
64,51,23,51,23,28,240,0.11363636363636363,45,100,45,45,45,10,290,0.2949640287769784,1.0
55,55,45,63,45,45,308,0.25,60,60,40,65,45,35,305,0.15833333333333333,4.0
55,35,50,55,110,85,390,0.6277372262773723,55,50,45,135,95,120,500,0.7714285714285715,2.0
65,50,35,115,95,95,455,0.7333333333333333,60,75,100,55,80,50,420,0.3088235294117647,0.125
40,50,45,70,45,70,320,0.5517241379310345,65,45,55,45,70,45,325,0.24369747899159663,1.0
80,125,75,40,95,85,500,0.6911764705882353,55,50,40,40,40,75,300,0.5945945945945946,2.0
45,40,60,40,75,50,310,0.2926829268292683,65,85,70,75,70,40,405,0.203125,0.5
83,80,80,135,80,121,579,0.9444444444444444,50,150,50,150,50,150,600,0.9339622641509434,1.0
60,40,60,40,60,35,295,0.18055555555555555,44,75,35,63,33,45,295,0.2647058823529412,1.0
50,60,45,100,80,65,400,0.45689655172413796,75,80,60,65,90,102,472,0.8625954198473282,1.0
90,110,80,100,80,95,555,0.7982456140350878,100,164,150,95,120,71,700,0.5645161290322581,0.5
80,120,70,110,70,80,530,0.6422764227642277,88,107,122,74,75,64,530,0.4596774193548387,2.0
55,45,50,45,65,80,340,0.5546218487394958,70,140,230,60,80,50,630,0.32432432432432434,0.25
65,95,57,100,85,93,495,0.7441860465116279,40,55,70,45,60,30,300,0.10619469026548672,2.0
100,120,100,150,120,90,680,0.728,68,165,95,65,115,110,618,0.8615384615384616,1.0
60,60,60,85,85,85,435,0.631578947368421,84,71,43,71,43,48,360,0.25874125874125875,0.0
95,100,85,108,70,70,528,0.5652173913043478,90,132,105,132,105,30,594,0.4246575342465753,0.5
40,30,30,55,30,85,270,0.4666666666666667,106,110,90,154,90,130,680,0.926829268292683,1.0
65,73,55,47,75,85,400,0.6846846846846847,62,48,66,59,57,49,341,0.33884297520661155,0.5
75,75,60,83,60,60,413,0.39344262295081966,40,45,35,65,55,70,310,0.4482758620689655,0.5
50,85,125,85,115,20,480,0.4306569343065693,58,50,145,95,105,30,483,0.2459016393442623,4.0
40,55,80,35,60,30,300,0.15037593984962405,170,90,45,90,45,60,500,0.427536231884058,0.5
81,102,77,85,75,85,505,0.5642857142857143,60,50,40,85,75,95,405,0.7540983606557377,2.0
65,50,70,95,80,65,425,0.4262295081967213,91,72,90,129,90,108,580,0.8620689655172413,1.0
65,150,60,115,60,115,565,0.935251798561151,106,150,70,194,120,140,780,0.952,2.0
65,65,45,75,45,95,390,0.72,75,98,63,98,63,101,498,0.889763779527559,0.5
70,110,180,60,60,50,530,0.4117647058823529,75,89,85,55,65,36,405,0.29545454545454547,1.0
85,76,64,45,55,90,415,0.6739130434782609,60,75,85,100,85,115,520,0.8992248062015504,1.0
75,110,110,110,105,80,590,0.656934306569343,60,85,60,85,60,55,405,0.3673469387755102,1.0
75,110,110,110,105,80,590,0.656934306569343,40,29,45,29,45,36,224,0.14634146341463414,1.0
72,58,80,103,80,97,490,0.7171052631578947,45,80,100,35,37,28,325,0.3125,0.25
76,147,90,60,70,97,540,0.8267716535433071,100,50,50,76,96,70,442,0.5,1.0
80,100,70,50,60,45,405,0.25806451612903225,65,95,100,60,50,50,420,0.34959349593495936,1.0
60,85,42,85,42,91,405,0.8227848101265823,50,70,50,50,50,40,310,0.16296296296296298,1.0
65,65,45,75,45,95,390,0.72,67,57,55,77,55,114,425,0.8879310344827587,1.0
95,125,79,60,100,81,540,0.6165413533834586,30,40,55,40,55,60,280,0.3237410071942446,2.0
123,77,72,99,92,58,521,0.4621212121212121,100,100,100,100,100,100,600,0.8602941176470589,2.0
100,120,100,150,120,90,680,0.728,40,30,32,50,52,65,269,0.3671875,1.0
62,48,66,59,57,49,341,0.33884297520661155,55,45,50,45,65,80,340,0.5546218487394958,1.0
65,125,100,60,70,70,490,0.6099290780141844,91,90,129,90,72,108,580,0.9140625,0.25
40,40,35,50,100,70,335,0.5031847133757962,70,84,70,65,70,51,410,0.2949640287769784,1.0
73,76,75,81,100,100,505,0.8110236220472441,65,40,70,80,140,70,465,0.5954198473282443,0.5
61,72,57,55,55,65,365,0.3984375,95,80,105,40,70,100,490,0.8046875,1.0
60,48,45,43,90,42,328,0.21897810218978103,35,85,45,35,35,75,310,0.6492537313432836,1.0
70,140,70,110,65,105,560,0.95,55,55,45,63,45,45,308,0.25,0.5
42,52,67,39,56,50,306,0.2868217054263566,30,45,55,70,55,85,340,0.5633802816901409,0.5
95,135,80,110,80,100,600,0.8248175182481752,50,80,95,10,45,10,290,0.232,0.5
35,65,35,65,35,65,300,0.46621621621621623,100,150,90,180,160,90,770,0.7348484848484849,0.5
70,120,100,145,105,20,560,0.2824427480916031,105,130,120,45,45,40,485,0.4444444444444444,1.0
50,180,20,180,20,150,600,0.9029850746268657,45,25,50,25,25,35,205,0.13076923076923078,2.0
95,155,109,70,130,81,640,0.6788321167883211,80,120,130,55,65,45,495,0.37037037037037035,4.0
90,120,75,60,60,45,450,0.29411764705882354,43,30,55,40,65,97,330,0.6030534351145038,1.0
50,53,48,53,48,64,316,0.4076923076923077,64,165,75,93,83,75,555,0.6587301587301587,1.0
70,60,62,80,82,60,414,0.4375,85,105,85,40,50,40,405,0.211864406779661,1.0
68,75,53,83,113,60,452,0.45384615384615384,45,35,50,70,50,30,280,0.15753424657534246,1.0
80,145,150,105,110,110,700,0.8692307692307693,40,40,40,70,40,20,250,0.032520325203252036,0.5
40,45,65,100,120,90,460,0.5588235294117647,105,140,55,30,55,95,480,0.8195488721804511,0.5
85,105,85,40,50,40,405,0.211864406779661,65,105,60,60,70,95,455,63.0,1.0
75,87,63,87,63,98,473,0.865546218487395,75,100,63,80,63,116,497,0.9345794392523364,0.5
60,100,89,55,69,112,485,0.9298245614035088,58,70,45,40,45,42,300,0.25925925925925924,0.5
45,55,39,35,39,42,255,0.18518518518518517,60,70,105,70,120,75,500,0.5983606557377049,1.0
50,35,55,25,25,15,205,0.021739130434782608,60,85,60,85,60,55,405,0.3673469387755102,0.25
55,40,50,65,85,40,335,0.3181818181818182,80,52,50,90,50,89,411,0.6666666666666666,1.0
39,52,43,60,50,65,309,0.49107142857142855,75,65,55,65,55,69,384,0.43548387096774194,0.5
60,55,145,75,150,40,525,0.2,95,110,80,70,80,50,485,0.37209302325581395,4.0
91,90,72,90,129,108,580,0.896,50,95,95,35,110,70,455,0.5179856115107914,1.0
45,63,37,65,55,95,360,0.8055555555555556,50,65,85,35,35,55,325,0.32575757575757575,1.0
40,80,35,35,45,70,305,0.4661016949152542,30,56,35,25,35,72,253,0.48148148148148145,2.0
70,80,50,35,35,35,305,0.14,170,90,45,90,45,60,500,0.427536231884058,1.0
40,40,55,40,70,55,300,0.40939597315436244,100,150,120,120,100,90,680,0.6493506493506493,2.0
95,95,85,125,65,55,520,0.3894736842105263,80,135,85,70,95,150,615,0.9844961240310077,1.0
55,70,55,40,55,85,360,0.7073170731707317,65,90,122,58,75,84,494,0.71875,0.0
110,160,110,80,110,100,670,0.8591549295774648,100,180,160,150,90,90,770,0.7520661157024794,1.0
45,60,45,25,45,55,275,0.29,125,58,58,76,76,67,460,0.515625,1.0
108,100,121,81,95,95,600,0.7476635514018691,55,85,55,50,55,60,360,0.4233576642335766,1.0
95,85,85,65,65,35,430,0.2571428571428571,80,90,80,130,110,110,600,0.856,0.5
60,50,70,80,80,140,480,0.8449612403100775,150,120,100,120,100,90,680,0.664179104477612,0.5
48,61,40,61,40,50,300,0.2543859649122807,50,50,40,30,30,50,250,0.2781954887218045,1.0
65,47,55,73,75,85,400,0.65,55,45,43,55,43,72,313,0.5853658536585366,1.0
95,145,130,120,90,120,700,0.9398496240601504,70,120,40,95,40,95,460,0.8106060606060606,1.0
80,120,130,55,65,45,495,0.37037037037037035,40,50,45,70,45,70,320,0.5517241379310345,0.0
65,40,70,80,140,70,465,0.5954198473282443,101,72,72,99,89,29,462,0.1937984496124031,1.0
60,82,45,45,45,74,351,0.5752212389380531,89,145,90,105,80,91,600,0.8549618320610687,0.0
45,55,39,35,39,42,255,0.18518518518518517,90,30,15,40,20,15,210,0.043478260869565216,1.0
38,35,40,27,25,35,200,0.08208955223880597,20,25,45,70,90,60,310,0.30833333333333335,1.0
44,75,35,63,33,45,295,0.2647058823529412,70,70,70,70,70,70,420,0.5289256198347108,0.0
70,55,95,95,110,65,490,0.48872180451127817,58,109,112,48,48,109,484,0.8805970149253731,0.5
65,45,55,45,70,45,325,0.24369747899159663,48,72,48,72,48,48,336,0.25984251968503935,1.0
46,57,40,40,40,50,273,0.25,70,90,70,60,60,70,420,0.6390977443609023,1.0
57,24,86,24,86,23,300,0.12727272727272726,66,65,48,62,57,52,350,0.36220472440944884,1.0
61,84,65,70,70,70,420,0.5,85,110,76,65,82,56,474,0.3933333333333333,1.0
106,190,100,154,100,130,780,0.9259259259259259,50,65,107,105,107,86,520,0.7313432835820896,1.0
106,190,100,154,100,130,780,0.9259259259259259,55,45,50,45,65,80,340,0.5546218487394958,0.5
70,94,50,94,50,66,424,0.48148148148148145,66,65,48,62,57,52,350,0.36220472440944884,4.0
65,110,130,60,65,95,525,0.8278145695364238,75,80,55,25,35,35,305,0.18666666666666668,1.0
55,130,115,50,50,75,475,0.5982142857142857,73,95,62,85,65,85,465,0.6666666666666666,1.0
72,60,30,20,30,25,237,0.11570247933884298,70,80,70,80,70,110,480,0.6594202898550725,0.0
75,80,70,65,75,90,455,0.7578125,58,64,58,80,65,80,405,0.5423728813559322,1.0
77,59,50,67,63,46,362,0.23140495867768596,65,60,110,130,95,65,525,0.47761194029850745,1.0
75,90,50,110,80,95,500,0.7985611510791367,80,135,85,70,95,150,615,0.9844961240310077,0.5
190,33,58,33,58,33,405,0.13432835820895522,30,65,100,45,25,40,305,0.1891891891891892,1.0
100,100,100,100,100,100,600,0.8805970149253731,50,40,85,40,65,25,305,0.08870967741935484,1.0
59,63,80,65,80,58,405,0.41843971631205673,70,60,62,80,82,60,414,0.4375,1.0
55,47,52,40,40,41,275,0.16806722689075632,55,68,64,45,55,31,318,0.11666666666666667,2.0
60,70,105,70,120,75,500,0.5983606557377049,70,105,105,50,40,20,390,0.33587786259541985,2.0
130,85,80,85,95,60,535,0.43884892086330934,86,81,97,81,107,43,495,0.203125,2.0
100,100,80,60,60,50,450,0.3050847457627119,65,90,115,45,115,58,488,0.5041322314049587,1.0
70,120,65,45,85,125,510,0.9747899159663865,50,180,20,180,20,150,600,0.9029850746268657,2.0
60,90,140,50,50,40,430,0.2535211267605634,65,83,57,95,85,105,490,0.8914728682170543,0.5
40,60,30,31,31,70,262,0.4492753623188406,35,55,40,45,40,60,275,0.35714285714285715,0.5
50,65,107,105,107,86,520,0.6991150442477876,90,92,75,92,85,60,494,0.49586776859504134,2.0
61,90,45,50,50,160,456,0.9230769230769231,61,84,65,70,70,70,420,0.5,1.0
75,95,125,45,75,95,510,0.8257575757575758,30,30,30,30,30,30,180,0.12612612612612611,1.0
40,30,35,50,70,55,280,0.28205128205128205,105,140,95,55,65,45,505,0.3,1.0
70,120,40,95,40,95,460,0.8106060606060606,45,85,50,55,50,65,350,0.5076923076923077,0.5
54,45,47,75,98,52,371,0.39669421487603307,65,125,60,95,60,105,510,0.9236641221374046,2.0
100,100,125,110,50,50,535,0.384,64,51,23,51,23,28,240,0.11363636363636363,1.0
70,145,88,140,70,112,625,0.8888888888888888,100,77,77,128,128,90,600,0.6901408450704225,1.0
80,85,95,30,30,25,345,0.2857142857142857,90,110,80,100,80,95,555,0.7982456140350878,4.0
70,94,50,94,50,66,424,0.48148148148148145,100,75,115,90,115,85,580,0.6446280991735537,1.0
71,73,88,120,89,59,500,0.43537414965986393,48,72,48,72,48,48,336,0.25984251968503935,1.0
46,87,60,30,40,57,320,0.37777777777777777,56,61,65,48,45,38,313,0.17567567567567569,1.0
85,73,70,73,115,67,483,0.5126050420168067,40,55,99,40,79,47,360,0.26262626262626265,2.0
72,60,30,20,30,25,237,0.11570247933884298,78,65,68,112,154,75,552,0.628099173553719,0.5
60,62,50,62,60,40,334,0.18181818181818182,40,45,35,40,40,90,290,0.65,1.0
101,72,72,99,89,29,462,0.1937984496124031,40,80,35,35,45,70,305,0.4661016949152542,2.0
110,65,75,125,85,30,490,0.15,75,125,100,70,80,45,495,0.33035714285714285,1.0
90,120,100,150,120,100,680,0.7718120805369127,72,105,115,54,86,68,500,0.5149253731343284,1.0
105,125,100,60,100,100,590,0.8359375,80,100,200,50,100,50,580,0.3472222222222222,0.5
65,90,120,85,70,60,490,0.43410852713178294,40,65,95,60,45,35,340,0.13986013986013987,0.5
70,90,70,60,60,70,420,0.6390977443609023,45,55,39,35,39,42,255,0.18518518518518517,1.0
60,40,80,60,45,40,325,0.23529411764705882,68,85,65,165,135,100,618,0.8083333333333333,0.5
60,115,105,65,70,80,495,0.7181818181818181,75,69,72,114,100,104,534,0.8253968253968254,4.0
60,60,60,85,85,85,435,0.631578947368421,90,93,55,70,55,55,418,0.3819444444444444,1.0
65,65,45,75,45,95,390,0.72,50,120,53,35,110,87,455,0.640625,1.0
45,85,50,55,50,65,350,0.5076923076923077,95,117,184,44,46,28,514,0.2975206611570248,2.0
55,55,50,45,65,55,325,0.37373737373737376,65,125,60,95,60,105,510,0.9236641221374046,1.0
50,30,55,65,55,20,275,0.13675213675213677,70,120,65,45,85,125,510,0.9747899159663865,1.0
75,75,95,75,95,113,528,0.9015151515151515,60,55,145,75,150,40,525,0.2,1.0
70,145,88,140,70,112,625,0.8888888888888888,30,40,55,40,55,60,280,0.3237410071942446,0.5
60,90,140,50,50,40,430,0.2535211267605634,38,35,35,65,55,50,278,0.2647058823529412,0.5
105,180,100,180,100,115,780,0.9477611940298507,40,29,45,29,45,36,224,0.14634146341463414,2.0
99,68,83,72,87,51,460,0.417910447761194,58,89,77,45,45,48,362,0.3177570093457944,0.5
60,85,60,85,60,55,405,0.3673469387755102,73,95,62,85,65,85,465,0.6666666666666666,2.0
55,40,40,65,45,35,280,0.16428571428571428,54,66,70,44,55,46,335,0.4214876033057851,0.5
50,40,85,40,65,25,305,0.08870967741935484,80,95,82,60,82,75,474,0.6,0.5
68,75,53,83,113,60,452,0.45384615384615384,110,130,80,70,60,80,530,0.5862068965517241,1.0
60,48,45,43,90,42,328,0.21897810218978103,35,20,65,40,65,20,245,0.02459016393442623,1.0
50,53,48,53,48,64,316,0.4076923076923077,58,70,45,40,45,42,300,0.25925925925925924,1.0
255,10,10,75,135,55,540,0.3125,35,85,45,35,35,75,310,0.6492537313432836,1.0
70,65,65,55,55,70,380,0.5,30,45,135,45,90,30,375,0.09285714285714286,0.5
50,50,40,30,30,50,250,0.2781954887218045,90,65,65,40,40,15,315,0.19672131147540983,0.5
105,150,90,150,90,95,680,0.8285714285714286,78,104,78,159,115,100,634,0.8444444444444444,1.0
55,55,50,45,65,55,325,0.37373737373737376,80,85,95,30,30,25,345,0.2857142857142857,0.5
110,85,95,80,95,50,515,0.2713178294573643,45,25,50,25,25,35,205,0.13076923076923078,1.0
50,50,95,40,50,35,320,0.20279720279720279,60,40,60,95,60,55,370,0.4222222222222222,2.0
80,120,79,95,79,70,523,0.5833333333333334,55,85,55,50,55,60,360,0.4233576642335766,1.0
100,100,100,100,100,100,600,0.8758169934640523,37,25,41,25,41,25,194,0.08870967741935484,1.0
60,85,40,30,45,68,328,0.6422018348623854,75,125,70,125,70,115,580,0.9037037037037037,1.0
115,45,20,45,25,20,270,0.11538461538461539,20,40,90,30,90,25,295,0.11363636363636363,0.0
105,180,100,180,100,115,780,0.9477611940298507,67,82,62,46,48,43,348,0.22033898305084745,2.0
105,150,90,150,90,95,680,0.8285714285714286,50,180,20,180,20,150,600,0.9029850746268657,1.0
116,55,85,107,95,29,487,0.06818181818181818,35,60,44,40,54,55,288,0.366412213740458,2.0
70,115,60,115,60,55,475,0.4647887323943662,91,72,90,129,90,108,580,0.8620689655172413,1.0
70,85,70,60,70,50,405,0.28378378378378377,63,63,47,41,41,74,329,0.56,2.0
72,95,67,103,71,122,530,0.9606299212598425,70,90,45,15,45,50,315,0.3629032258064516,2.0
95,117,184,44,46,28,514,0.2975206611570248,85,80,70,135,75,90,535,0.7006802721088435,1.0
125,130,90,130,90,95,660,0.7734375,62,50,58,73,54,72,369,0.4435483870967742,0.5
60,50,70,80,80,140,480,0.8449612403100775,80,100,70,60,70,95,475,0.7416666666666667,0.5
50,85,40,85,40,35,335,0.1746031746031746,90,92,87,75,85,76,505,0.5409836065573771,1.0
62,48,54,63,60,68,355,0.5178571428571429,30,80,90,55,45,55,355,0.4295774647887324,1.0
95,155,109,70,130,81,640,0.6788321167883211,44,50,91,24,86,10,305,0.1981981981981982,0.5
76,104,71,104,71,108,534,0.912751677852349,70,85,70,60,70,50,405,0.28378378378378377,0.5
70,60,125,115,70,55,495,0.35507246376811596,30,45,59,30,39,57,260,0.2803030303030303,2.0
80,85,95,30,30,25,345,0.2857142857142857,60,69,95,69,95,36,424,0.2608695652173913,1.0
40,45,40,62,60,60,307,0.33884297520661155,78,84,78,109,85,100,534,0.8646616541353384,0.5
95,110,80,70,80,50,485,0.37209302325581395,80,125,75,40,95,85,500,0.6911764705882353,1.0
50,50,40,50,40,64,294,0.45588235294117646,90,75,85,115,90,55,510,0.3445378151260504,1.0
55,65,95,95,45,85,440,0.6610169491525424,51,65,65,80,75,59,395,0.4365079365079365,1.0
95,85,85,65,65,35,430,0.2571428571428571,60,60,60,60,60,60,360,0.38095238095238093,1.0
20,10,55,15,20,80,200,0.17985611510791366,70,100,115,30,65,30,410,0.24390243902439024,2.0
70,50,30,95,135,105,485,0.8040540540540541,50,180,20,180,20,150,600,0.9029850746268657,1.0
55,70,40,60,40,40,305,0.26956521739130435,85,80,70,135,75,90,535,0.7006802721088435,1.0
45,30,40,105,50,20,290,0.031007751937984496,65,85,70,75,70,40,405,0.203125,1.0
43,80,65,50,35,35,308,0.14193548387096774,45,85,70,40,40,60,340,0.5229357798165137,1.0
106,90,130,90,154,110,680,0.8699186991869918,65,150,40,15,80,145,495,0.9663865546218487,4.0
106,130,90,110,154,90,680,0.719626168224299,80,80,80,80,80,80,480,0.6015037593984962,2.0
65,40,70,80,140,70,465,0.5954198473282443,65,90,65,61,61,100,442,0.8373983739837398,1.0
79,103,120,135,115,78,630,0.5763888888888888,59,66,70,44,55,41,335,0.25190839694656486,0.5
110,123,65,100,65,65,528,0.5217391304347826,60,85,69,65,79,80,438,0.576,0.5
50,65,107,105,107,86,520,0.7313432835820896,70,55,55,80,60,45,365,0.2222222222222222,0.5
45,50,43,40,38,62,278,0.40441176470588236,37,25,41,25,41,25,194,0.08870967741935484,2.0
116,55,85,107,95,29,487,0.06818181818181818,40,55,30,30,30,60,245,0.43548387096774194,1.0
60,65,70,85,75,40,395,0.21705426356589147,72,85,70,65,70,58,420,0.41304347826086957,0.5
35,70,55,45,55,25,285,0.09420289855072464,85,80,70,135,75,90,535,0.7006802721088435,1.0
58,70,45,40,45,42,300,0.25925925925925924,90,120,120,60,60,50,500,0.35294117647058826,1.0
105,180,100,180,100,115,780,0.9477611940298507,104,91,63,91,73,68,490,0.5118110236220472,1.0
45,90,20,65,20,65,305,0.5116279069767442,72,60,30,20,30,25,237,0.11570247933884298,0.5
30,80,90,55,45,55,355,0.4295774647887324,70,80,50,35,35,35,305,0.14,0.5
55,55,55,85,55,30,335,0.1320754716981132,60,100,115,70,85,90,520,0.7557251908396947,0.5
30,56,35,25,35,72,253,0.48148148148148145,62,50,58,73,54,72,369,0.4435483870967742,1.0
68,72,78,38,42,32,330,0.23809523809523808,40,65,95,60,45,35,340,0.13986013986013987,2.0
62,55,52,109,94,109,481,0.7833333333333333,100,100,125,110,50,50,535,0.384,0.5
65,130,60,95,110,65,525,0.5303030303030303,78,130,111,130,85,100,634,0.8561151079136691,0.25
38,36,38,32,36,57,237,0.3893805309734513,35,55,40,50,50,90,320,0.6838235294117647,1.0
78,84,78,109,85,100,534,0.8646616541353384,80,100,80,80,80,100,520,0.9051724137931034,0.5
95,70,73,95,90,60,483,0.3983739837398374,69,69,76,69,86,91,460,0.6554621848739496,1.0
91,134,95,100,100,80,600,0.6304347826086957,64,78,52,78,52,81,405,0.6422764227642277,2.0
130,65,60,110,95,65,525,0.5227272727272727,45,35,45,62,53,35,275,0.11851851851851852,0.5
35,55,40,45,40,60,275,0.35714285714285715,50,180,20,180,20,150,600,0.9029850746268657,1.0
60,25,35,70,80,60,330,0.3076923076923077,65,90,122,58,75,84,494,0.71875,1.0
58,64,58,80,65,80,405,0.5423728813559322,80,80,80,80,80,80,480,0.5606060606060606,0.5
55,50,40,40,40,75,300,0.5945945945945946,1,90,45,30,30,40,236,0.33064516129032256,0.0
80,120,79,95,79,70,523,0.5833333333333334,62,48,54,63,60,68,355,0.5178571428571429,1.0
45,50,45,115,55,95,405,0.6936936936936937,42,52,67,39,56,50,306,0.2868217054263566,0.5
35,40,100,90,55,35,355,0.1796875,40,45,35,40,40,90,290,0.65,1.0
60,70,65,125,105,90,515,0.6911764705882353,50,75,35,70,30,40,300,0.21296296296296297,0.25
86,92,88,68,75,73,482,0.6835443037974683,70,150,140,65,100,75,600,0.55,0.5
75,95,67,125,95,83,540,0.7117117117117117,123,100,62,97,81,68,531,0.4806201550387597,2.0
50,65,107,105,107,86,520,0.6991150442477876,70,55,95,95,110,65,490,0.48872180451127817,1.0
91,129,90,72,90,108,580,0.8536585365853658,91,72,90,129,90,108,580,0.8925619834710744,0.5
72,60,30,20,30,25,237,0.11570247933884298,50,50,77,95,77,91,440,0.5916666666666667,0.0
40,50,45,70,45,70,320,0.5517241379310345,70,130,100,55,80,65,500,0.608,0.5
79,105,70,145,80,101,580,0.8608695652173913,1,90,45,30,30,40,236,0.33064516129032256,2.0
80,80,80,55,55,90,440,0.6417910447761194,20,40,90,30,90,25,295,0.11363636363636363,0.0
75,95,67,125,95,83,540,0.7117117117117117,40,30,50,55,55,100,330,0.584070796460177,1.0
90,95,105,165,110,45,610,0.2890625,65,40,50,125,60,30,370,0.07258064516129033,1.0
65,50,70,95,80,65,425,0.4262295081967213,125,120,90,170,100,95,700,0.78125,1.0
62,48,54,63,60,68,355,0.5178571428571429,100,75,115,90,115,85,580,0.6446280991735537,1.0
55,20,35,20,45,75,250,0.37681159420289856,68,72,78,38,42,32,330,0.23809523809523808,1.0
60,60,60,85,85,85,435,0.631578947368421,79,100,80,110,90,121,580,0.968,1.0
50,25,28,45,55,15,218,0.0625,70,55,65,95,85,70,440,0.5307692307692308,1.0
55,130,115,50,50,75,475,0.5982142857142857,105,150,90,150,90,95,680,0.8285714285714286,0.5
84,86,88,111,101,60,530,0.4634146341463415,86,81,97,81,107,43,495,0.203125,2.0
100,128,90,77,77,128,600,0.959349593495935,30,45,135,45,90,30,375,0.09285714285714286,1.0
31,45,90,30,30,40,266,0.21929824561403508,65,76,84,54,96,105,480,0.9008264462809917,1.0
66,117,70,40,50,67,410,0.4573643410852713,50,70,160,70,160,90,600,0.7417218543046358,1.0
65,65,65,50,50,90,385,0.72,80,160,80,130,80,100,630,0.8455284552845529,2.0
70,60,62,80,82,60,414,0.4375,50,95,180,85,45,70,525,0.5298507462686567,1.0
79,85,60,55,60,71,410,0.60431654676259,40,30,30,40,50,30,220,0.07936507936507936,0.25
45,40,60,40,75,50,310,0.2926829268292683,70,55,55,80,60,45,365,0.2222222222222222,0.5
65,70,60,65,65,115,440,0.8583333333333333,30,105,90,25,25,50,325,0.2773722627737226,1.0
60,55,50,40,55,45,305,0.22377622377622378,55,50,45,135,95,120,500,0.7714285714285715,2.0
60,55,145,75,150,40,525,0.2,38,35,35,65,55,50,278,0.2647058823529412,0.5
60,45,50,90,80,70,395,0.625,68,72,78,38,42,32,330,0.23809523809523808,1.0
55,84,105,114,75,52,485,0.2890625,75,95,60,65,60,115,470,0.8778625954198473,1.0
20,10,230,10,230,5,505,0.0,80,135,85,70,95,150,615,0.9844961240310077,1.0
80,120,80,120,80,100,580,0.8478260869565217,65,90,122,58,75,84,494,0.71875,2.0
76,147,90,60,70,97,540,0.8267716535433071,85,80,90,105,95,60,515,0.49074074074074076,1.0
85,110,90,45,90,80,500,0.6206896551724138,45,60,45,25,45,55,275,0.29,1.0
44,38,39,61,79,42,303,0.2251655629139073,65,85,70,75,70,40,405,0.203125,1.0
75,87,63,87,63,98,473,0.865546218487395,56,61,65,48,45,38,313,0.17567567567567569,1.0
160,110,65,65,110,30,540,0.35714285714285715,78,84,78,109,85,100,534,0.8620689655172413,1.0
103,93,67,71,61,84,479,0.7142857142857143,35,55,40,45,40,60,275,0.35714285714285715,1.0
70,90,45,15,45,50,315,0.3629032258064516,60,67,85,77,75,116,480,0.8888888888888888,2.0
76,104,71,104,71,108,534,0.912751677852349,49,66,70,44,55,51,335,0.4260869565217391,0.0
60,60,50,40,50,75,335,0.5882352941176471,40,50,90,30,55,65,330,0.44680851063829785,0.25
65,70,60,65,65,115,440,0.8583333333333333,30,35,30,100,35,80,310,0.4765625,0.0
61,78,95,56,58,57,405,0.40336134453781514,85,90,80,70,80,130,535,0.9262295081967213,0.25
50,75,45,40,45,60,315,0.4380165289256198,70,83,50,37,50,60,350,0.3360655737704918,0.5
90,100,90,125,85,90,580,0.7352941176470589,65,90,65,61,61,100,442,0.8373983739837398,1.0
76,48,48,57,62,34,325,0.11688311688311688,45,30,15,85,65,65,305,0.36220472440944884,1.0
50,105,125,55,95,50,480,0.375886524822695,75,125,230,55,95,30,610,0.3448275862068966,0.25
80,135,130,95,90,70,600,0.5181818181818182,70,120,65,45,85,125,510,0.9747899159663865,0.0
70,40,50,55,50,25,290,0.061068702290076333,106,90,130,90,154,110,680,0.8699186991869918,2.0
85,76,64,45,55,90,415,0.6739130434782609,45,75,37,70,55,83,365,0.6183206106870229,1.0
55,70,40,60,40,40,305,0.26956521739130435,80,70,70,90,100,70,480,0.5609756097560976,1.0
60,80,95,70,85,50,440,0.2231404958677686,130,65,60,110,95,65,525,0.5227272727272727,0.5
40,55,30,30,30,85,270,0.688,85,60,65,135,105,100,550,0.7518248175182481,2.0
95,65,110,60,130,65,525,0.5275590551181102,50,180,20,180,20,150,600,0.9029850746268657,2.0
80,80,90,110,130,110,600,0.8721804511278195,65,90,40,45,80,75,395,0.625,2.0
90,30,15,40,20,15,210,0.043478260869565216,20,10,55,15,20,80,200,0.17985611510791366,1.0
48,72,48,72,48,48,336,0.25984251968503935,125,170,100,120,90,95,700,0.77,1.0
55,40,40,65,45,35,280,0.16428571428571428,45,50,55,75,65,30,320,0.06293706293706294,0.5
40,45,65,100,120,90,460,0.5588235294117647,89,145,90,105,80,91,600,0.8549618320610687,2.0
50,65,64,44,48,43,314,0.2196969696969697,60,67,85,77,75,116,480,0.8888888888888888,0.5
90,93,55,70,55,55,418,0.3819444444444444,50,53,48,53,48,64,316,0.4076923076923077,2.0
75,103,80,70,80,92,500,0.7933884297520661,40,30,35,50,70,55,280,0.28205128205128205,0.25
60,85,60,50,50,125,430,0.9090909090909091,90,30,15,40,20,15,210,0.043478260869565216,1.0
90,120,100,150,120,100,680,0.7718120805369127,20,40,15,35,35,60,205,0.34285714285714286,1.0
65,75,90,97,123,44,494,0.1987179487179487,59,66,70,44,55,41,335,0.25190839694656486,1.0
58,64,58,80,65,80,405,0.5423728813559322,30,40,70,70,25,60,295,0.41353383458646614,0.5
85,73,70,73,115,67,483,0.5126050420168067,108,112,118,68,72,47,525,0.2916666666666667,2.0
55,55,45,63,45,45,308,0.25,54,45,47,75,98,52,371,0.39669421487603307,1.0
70,80,102,80,102,40,474,0.2677165354330709,38,35,35,65,55,50,278,0.2647058823529412,1.0
75,90,50,110,80,95,500,0.7985611510791367,55,20,35,20,45,75,250,0.37681159420289856,1.0
65,73,55,47,75,85,400,0.6846846846846847,40,30,32,50,52,65,269,0.3671875,1.0
59,45,40,35,40,31,250,0.14285714285714285,45,75,37,70,55,83,365,0.6183206106870229,1.0
91,129,90,72,90,108,580,0.8536585365853658,95,23,48,23,48,23,260,0.046153846153846156,0.5
108,130,95,80,85,102,600,0.7637795275590551,100,100,90,150,140,90,670,0.71875,1.0
100,100,100,100,100,100,600,0.8345864661654135,55,85,55,50,55,60,360,0.4233576642335766,0.25
35,70,55,45,55,25,285,0.09420289855072464,100,150,110,95,110,70,635,0.5923076923076923,4.0
85,90,80,70,80,130,535,0.9262295081967213,40,45,40,35,35,56,251,0.373015873015873,1.0
45,55,39,35,39,42,255,0.18518518518518517,38,30,41,30,41,60,240,0.2897196261682243,1.0
95,70,73,95,90,60,483,0.3983739837398374,50,50,120,80,80,30,410,0.07258064516129033,0.5
80,70,70,90,100,70,480,0.5609756097560976,50,85,40,85,40,35,335,0.1746031746031746,0.25
65,150,60,115,60,115,565,0.935251798561151,79,115,70,125,80,111,580,0.8468468468468469,1.0
25,35,70,95,55,45,325,0.16783216783216784,60,60,60,35,35,30,280,0.11194029850746269,1.0
105,180,100,180,100,115,780,0.9477611940298507,71,82,64,64,59,112,452,0.9327731092436975,1.0
75,123,67,95,85,95,540,0.7642276422764228,50,75,70,35,70,48,348,0.29357798165137616,1.0
90,130,80,65,85,55,505,0.4396551724137931,55,50,45,135,95,120,500,0.7714285714285715,0.5
53,51,53,61,56,40,314,0.14285714285714285,78,52,60,63,65,23,341,0.06015037593984962,1.0
60,85,60,85,60,55,405,0.3673469387755102,68,125,65,65,115,80,518,0.6277372262773723,0.5
70,70,40,60,40,60,340,0.4247787610619469,65,110,130,60,65,95,525,0.8278145695364238,0.5
60,85,40,30,45,68,328,0.6422018348623854,65,75,90,97,123,44,494,0.1987179487179487,2.0
60,100,85,80,85,100,510,0.7007874015748031,50,95,95,35,110,70,455,0.5179856115107914,1.0
83,80,80,135,80,121,579,0.9444444444444444,40,40,50,30,30,30,220,0.0873015873015873,2.0
80,80,80,80,80,80,480,0.5606060606060606,70,140,70,110,65,105,560,0.95,0.5
35,85,45,35,35,75,310,0.6492537313432836,55,47,52,40,40,41,275,0.16806722689075632,1.0
53,51,53,61,56,40,314,0.14285714285714285,70,65,60,90,75,90,450,0.6571428571428571,1.0
65,90,65,61,61,100,442,0.8373983739837398,59,110,150,45,49,35,448,0.3333333333333333,0.0
85,105,85,40,50,40,405,0.211864406779661,40,60,30,31,31,70,262,0.4492753623188406,1.0
100,150,140,100,90,90,670,0.7969924812030075,60,60,60,85,85,85,435,0.631578947368421,1.0
80,80,80,55,55,90,440,0.6417910447761194,55,70,45,70,50,60,350,0.45,1.0
50,95,180,85,45,70,525,0.5298507462686567,60,55,145,75,150,40,525,0.2,1.0
60,60,60,60,60,60,360,0.38095238095238093,45,45,35,20,30,20,195,0.07246376811594203,1.0
54,78,103,53,45,22,355,0.23255813953488372,70,145,88,140,70,112,625,0.8888888888888888,0.25
40,55,30,30,30,85,270,0.688,75,110,110,110,105,80,590,0.656934306569343,1.0
50,150,50,150,50,150,600,0.9339622641509434,50,20,40,20,40,20,190,0.0962962962962963,1.0
100,100,100,100,100,100,600,0.8778625954198473,75,65,55,65,55,69,384,0.43548387096774194,1.0
79,85,60,55,60,71,410,0.60431654676259,60,90,140,50,50,40,430,0.2535211267605634,0.5
100,110,90,85,90,60,535,0.47794117647058826,91,129,90,72,90,108,580,0.8536585365853658,4.0
85,70,80,97,80,123,535,0.9304347826086956,100,70,70,65,65,45,415,0.1897810218978102,1.0
75,55,70,55,95,110,460,0.8444444444444444,40,30,30,55,30,85,270,0.4666666666666667,1.0
65,90,120,85,70,60,490,0.43410852713178294,50,45,45,35,35,50,260,0.23529411764705882,1.0
68,125,65,65,115,80,518,0.6277372262773723,60,52,168,47,138,30,495,0.19834710743801653,2.0
75,95,125,45,75,95,510,0.8257575757575758,65,63,45,45,45,45,308,0.2595419847328244,2.0
45,49,65,49,65,45,318,0.275,39,52,43,60,50,65,309,0.5041322314049587,0.5
90,92,75,92,85,60,494,0.49586776859504134,70,65,65,55,55,70,380,0.5,1.0
62,73,55,56,52,84,382,0.7244094488188977,90,100,70,110,150,80,600,0.6037735849056604,0.5
50,50,50,50,50,50,300,0.30708661417322836,50,70,50,50,50,40,310,0.16296296296296298,0.5
80,82,83,100,100,80,525,0.6742424242424242,58,89,77,45,45,48,362,0.3177570093457944,0.5
60,60,60,35,35,30,280,0.11194029850746269,60,90,55,90,80,110,485,0.8677685950413223,1.0
38,30,41,30,41,60,240,0.2897196261682243,70,90,45,15,45,50,315,0.3629032258064516,1.0
115,115,85,90,75,100,580,0.8134328358208955,90,55,75,60,75,30,385,0.13970588235294118,1.0
80,75,150,75,150,50,580,0.30973451327433627,65,80,140,40,70,70,465,0.5223880597014925,0.5
50,85,85,55,55,50,380,0.3902439024390244,45,49,65,49,65,45,318,0.275,1.0
35,85,45,35,35,75,310,0.6492537313432836,50,45,45,35,35,50,260,0.23529411764705882,1.0
105,180,100,180,100,115,780,0.9477611940298507,28,25,25,45,35,40,198,0.16083916083916083,0.0
64,78,52,78,52,81,405,0.6422764227642277,65,90,115,45,115,58,488,0.5041322314049587,2.0
68,90,65,50,55,82,410,0.6165413533834586,90,55,75,60,75,30,385,0.13970588235294118,1.0
62,48,54,63,60,68,355,0.5178571428571429,90,100,90,125,85,90,580,0.7352941176470589,1.0
90,65,65,40,40,15,315,0.19672131147540983,110,65,105,55,95,80,510,0.6258503401360545,0.0
45,100,135,65,135,45,525,0.29411764705882354,60,70,50,100,50,65,395,0.5217391304347826,1.0
90,130,80,65,85,55,505,0.4396551724137931,40,40,55,40,70,55,300,0.40939597315436244,0.5
63,60,55,50,50,71,349,0.5289256198347108,55,55,50,45,65,55,325,0.37373737373737376,1.0
100,100,80,60,60,50,450,0.3050847457627119,80,120,80,120,80,100,580,0.8478260869565217,0.5
45,60,45,25,45,55,275,0.29,40,35,30,20,20,50,195,0.23423423423423423,1.0
31,45,90,30,30,40,266,0.21929824561403508,84,86,88,111,101,60,530,0.4634146341463415,1.0
70,60,70,87,78,85,450,0.6228070175438597,55,55,50,45,65,55,325,0.37373737373737376,1.0
86,68,72,109,66,106,507,0.8099173553719008,255,10,10,75,135,55,540,0.3125,1.0
65,125,100,55,70,85,500,0.6532258064516129,60,79,105,59,85,36,424,0.17054263565891473,1.0
91,134,95,100,100,80,600,0.6304347826086957,50,65,107,105,107,86,520,0.7313432835820896,1.0
80,125,75,40,95,85,500,0.6911764705882353,50,95,180,85,45,70,525,0.5298507462686567,2.0
91,134,95,100,100,80,600,0.6304347826086957,40,55,30,30,30,85,270,0.688,1.0
60,70,105,70,120,75,500,0.5983606557377049,54,66,70,44,55,46,335,0.4214876033057851,0.5
40,65,95,60,45,35,340,0.13986013986013987,110,65,75,125,85,30,490,0.15,1.0
66,41,77,61,87,23,355,0.12096774193548387,130,70,35,70,35,60,400,0.4017857142857143,2.0
44,58,44,58,44,61,309,0.41964285714285715,85,135,130,60,80,25,515,0.40540540540540543,0.5
60,55,90,145,90,80,520,0.6071428571428571,40,45,65,100,120,90,460,0.5588235294117647,2.0
30,45,55,70,55,85,340,0.5633802816901409,74,48,76,83,81,104,466,0.7322834645669292,1.0
70,70,115,130,90,60,535,0.5338983050847458,90,100,90,125,85,90,580,0.7352941176470589,1.0
59,74,50,35,50,35,303,0.3125,45,50,43,40,38,62,278,0.40441176470588236,0.0
40,40,55,40,70,55,300,0.40939597315436244,45,90,20,65,20,65,305,0.5116279069767442,0.0
60,85,60,85,60,55,405,0.3673469387755102,100,100,90,150,140,90,670,0.71875,0.5
103,60,126,80,126,50,545,0.36363636363636365,150,80,44,90,54,80,498,0.625,0.0
58,64,58,80,65,80,405,0.609271523178808,50,48,43,46,41,60,288,0.47297297297297297,0.5
65,150,40,15,80,145,495,0.9663865546218487,90,92,75,92,85,60,494,0.49586776859504134,4.0
79,105,70,145,80,101,580,0.8608695652173913,60,62,63,80,80,60,405,0.38016528925619836,1.0
100,123,75,57,75,80,510,0.6923076923076923,45,35,50,70,50,30,280,0.15753424657534246,2.0
20,40,15,35,35,60,205,0.34285714285714286,40,55,30,30,30,60,245,0.43548387096774194,2.0
75,95,125,45,75,95,510,0.8257575757575758,70,80,70,80,70,110,480,0.6594202898550725,1.0
41,56,40,62,44,71,314,0.568,45,50,55,75,65,30,320,0.06293706293706294,0.5
75,75,75,125,95,40,485,0.15671641791044777,95,75,110,100,80,30,490,0.15267175572519084,0.5
20,15,20,10,55,80,200,0.2682926829268293,80,85,95,30,30,25,345,0.2857142857142857,4.0
67,89,116,79,116,33,500,0.2624113475177305,72,85,70,65,70,58,420,0.41304347826086957,0.0
60,95,80,60,80,30,405,0.19480519480519481,60,60,60,35,35,30,280,0.11194029850746269,1.0
70,80,65,90,65,85,455,0.578125,40,55,80,35,60,30,300,0.15037593984962405,0.125
40,45,40,62,60,60,307,0.33884297520661155,67,89,116,79,116,33,500,0.2624113475177305,2.0
77,59,50,67,63,46,362,0.23140495867768596,75,65,55,65,55,69,384,0.43548387096774194,0.5
60,65,60,130,75,110,500,0.7719298245614035,89,124,80,55,80,55,483,0.5714285714285714,0.5
100,73,83,73,83,55,467,0.371900826446281,75,75,75,125,95,40,485,0.15671641791044777,1.0
90,120,120,60,60,50,500,0.35294117647058826,40,40,35,50,100,70,335,0.5031847133757962,2.0
35,35,35,35,35,35,210,0.13385826771653545,70,65,65,55,55,70,380,0.5,2.0
45,45,55,45,55,63,308,0.4594594594594595,68,75,53,83,113,60,452,0.45384615384615384,0.5
50,40,85,40,65,25,305,0.08870967741935484,30,45,59,30,39,57,260,0.2803030303030303,0.5
82,121,119,69,59,71,521,0.5394736842105263,65,100,70,80,80,105,500,0.8666666666666667,2.0
45,75,60,40,30,50,300,0.304,65,75,70,95,70,95,470,0.7272727272727273,1.0
45,95,50,40,50,75,355,0.54,74,94,131,54,116,20,489,0.4485294117647059,0.5
80,160,60,170,130,80,680,0.6180555555555556,90,60,70,75,70,45,410,0.23880597014925373,1.0
65,75,105,35,65,85,430,0.6940298507462687,60,62,50,62,60,40,334,0.18181818181818182,1.0
72,58,80,103,80,97,490,0.7171052631578947,55,65,95,95,45,85,440,0.6610169491525424,1.0
60,50,40,85,75,95,405,0.7540983606557377,65,80,65,35,65,60,370,0.38405797101449274,1.0
75,110,110,110,105,80,590,0.656934306569343,70,94,50,94,50,66,424,0.48148148148148145,1.0
58,89,77,45,45,48,362,0.3177570093457944,68,85,65,165,135,100,618,0.8083333333333333,0.0
38,35,40,27,25,35,200,0.08208955223880597,75,95,122,58,75,69,494,0.5725806451612904,1.0
40,45,40,62,60,60,307,0.33884297520661155,55,75,85,25,25,15,280,0.1875,0.5
70,75,80,135,80,135,575,0.917910447761194,76,65,45,92,42,91,411,0.7449664429530202,2.0
70,55,75,45,65,60,370,0.45901639344262296,110,160,110,80,110,100,670,0.8591549295774648,1.0
84,71,43,71,43,48,360,0.25874125874125875,70,70,115,130,90,60,535,0.5338983050847458,0.5
36,50,50,65,60,44,305,0.16363636363636364,70,50,30,95,135,105,485,0.8040540540540541,0.5
65,83,57,95,85,105,490,0.8914728682170543,35,55,35,30,30,35,220,0.23684210526315788,1.0
75,80,70,65,75,90,455,0.7578125,104,91,63,91,73,68,490,0.5118110236220472,1.0
100,100,100,100,100,100,600,0.8778625954198473,53,51,53,61,56,40,314,0.14285714285714285,0.5
59,66,70,44,55,41,335,0.25190839694656486,77,85,51,55,51,65,384,0.5163934426229508,0.5
65,130,60,75,60,75,465,0.689922480620155,76,48,48,57,62,34,325,0.11688311688311688,1.0
80,50,100,100,200,50,580,0.2357142857142857,70,120,100,145,105,20,560,0.2824427480916031,1.0
54,66,70,44,55,46,335,0.4214876033057851,70,65,60,90,75,90,450,0.6571428571428571,0.25
50,75,35,70,30,40,300,0.21296296296296297,70,140,70,110,65,105,560,0.95,2.0
59,63,80,65,80,58,405,0.41843971631205673,45,65,34,40,34,45,263,0.2589928057553957,1.0
85,80,70,135,75,90,535,0.7006802721088435,95,125,79,60,100,81,540,0.6165413533834586,1.0
50,47,50,57,50,65,319,0.463768115942029,65,125,60,95,60,105,510,0.9236641221374046,0.5
108,100,121,81,95,95,600,0.7476635514018691,60,79,105,59,85,36,424,0.17054263565891473,0.5
50,53,62,58,63,44,330,0.13709677419354838,91,134,95,100,100,80,600,0.6304347826086957,0.5
97,165,60,65,50,58,495,0.3902439024390244,55,45,50,45,65,80,340,0.5546218487394958,2.0
105,130,120,45,45,40,485,0.4444444444444444,80,90,80,130,110,110,600,0.856,1.0
165,75,80,40,45,65,470,0.5151515151515151,82,80,86,85,75,72,480,0.6183206106870229,1.0
70,80,65,90,65,85,455,0.578125,55,68,64,45,55,31,318,0.11666666666666667,1.0
75,80,55,25,35,35,305,0.18666666666666668,50,95,90,95,90,180,600,0.9172413793103448,0.5
85,50,95,120,115,80,545,0.5793650793650794,91,90,129,90,72,108,580,0.9140625,1.0
76,65,45,92,42,91,411,0.7449664429530202,80,92,65,65,80,68,450,0.4824561403508772,1.0
72,95,67,103,71,122,530,0.9606299212598425,54,45,47,75,98,52,371,0.39669421487603307,0.5
70,90,45,15,45,50,315,0.3629032258064516,45,40,60,40,75,50,310,0.2926829268292683,1.0
35,85,45,35,35,75,310,0.6492537313432836,50,20,55,25,25,30,205,0.09774436090225563,2.0
80,90,80,130,110,110,600,0.856,65,100,70,80,80,105,500,0.8666666666666667,1.0
65,90,50,85,45,55,390,0.371900826446281,50,85,40,85,40,35,335,0.1746031746031746,1.0
50,45,45,35,35,50,260,0.23529411764705882,36,50,50,65,60,44,305,0.16363636363636364,1.0
73,76,75,81,100,100,505,0.8110236220472441,55,45,50,45,65,80,340,0.5546218487394958,2.0
69,69,76,69,86,91,460,0.6554621848739496,50,65,45,85,65,95,405,0.7238095238095238,0.5
65,65,65,50,50,90,385,0.72,45,80,100,35,37,28,325,0.3125,1.0
100,50,50,76,96,70,442,0.5,60,48,45,43,90,42,328,0.21897810218978103,1.0
45,45,35,20,30,20,195,0.07246376811594203,70,65,60,90,75,90,450,0.6571428571428571,0.5
20,25,45,70,90,60,310,0.30833333333333335,90,70,80,70,95,70,475,0.5190839694656488,1.0
70,85,140,85,70,20,470,0.272,90,95,105,165,110,45,610,0.2890625,0.5
90,75,75,90,100,70,500,0.5462184873949579,45,49,65,49,65,45,318,0.275,0.5
85,105,100,79,83,78,530,0.5869565217391305,90,65,65,40,40,15,315,0.19672131147540983,0.5
50,55,50,36,30,43,264,0.2922077922077922,65,45,55,45,70,45,325,0.24369747899159663,1.0
95,65,110,60,130,65,525,0.5275590551181102,70,80,65,90,65,85,455,0.578125,2.0
20,40,90,30,90,25,295,0.11363636363636363,90,85,75,115,100,115,580,0.9381443298969072,1.0
45,85,50,55,50,65,350,0.5076923076923077,75,140,65,112,65,110,567,0.9140625,1.0
39,52,43,60,50,65,309,0.5041322314049587,55,84,105,114,75,52,485,0.2890625,0.5
50,70,50,50,50,40,310,0.16296296296296298,40,30,30,40,50,30,220,0.07936507936507936,0.25
65,65,45,75,45,95,390,0.72,85,80,90,105,95,60,515,0.49074074074074076,1.0
75,105,75,105,75,45,480,0.3274336283185841,120,120,120,120,120,120,720,0.9344262295081968,1.0
100,70,70,65,65,45,415,0.1897810218978102,70,84,70,65,70,51,410,0.2949640287769784,0.5
30,42,118,42,88,30,350,0.112,60,110,70,60,60,100,460,0.8461538461538461,2.0
55,55,55,85,55,30,335,0.1320754716981132,50,50,40,50,40,64,294,0.45588235294117646,1.0
70,110,180,60,60,50,530,0.4117647058823529,45,30,15,85,65,65,305,0.36220472440944884,4.0
60,70,105,70,120,75,500,0.5983606557377049,75,80,70,65,75,90,455,0.7578125,0.0
104,91,63,91,73,68,490,0.5118110236220472,60,60,40,65,45,35,305,0.15833333333333333,1.0
70,85,65,105,85,120,530,0.9262295081967213,80,90,80,130,110,110,600,0.856,0.5
45,100,45,45,45,10,290,0.2949640287769784,80,100,200,50,100,50,580,0.3472222222222222,2.0
50,75,70,35,70,48,348,0.29357798165137616,40,45,65,100,120,90,460,0.5588235294117647,0.25
40,45,35,40,40,90,290,0.65,71,73,88,120,89,59,500,0.43537414965986393,1.0
76,25,45,67,55,24,292,0.0390625,105,130,120,45,45,40,485,0.4444444444444444,2.0
50,85,125,85,115,20,480,0.4306569343065693,75,123,67,95,85,95,540,0.7642276422764228,1.0
35,45,160,30,45,70,385,0.48148148148148145,75,125,75,30,75,85,465,0.625,0.5
60,40,50,75,85,95,405,0.6044776119402985,70,80,102,80,102,40,474,0.2677165354330709,2.0
49,55,42,42,37,85,310,0.6068376068376068,75,140,65,112,65,110,567,0.9140625,0.5
70,110,80,55,80,105,500,0.8794326241134752,65,130,60,75,60,75,465,0.689922480620155,2.0
44,58,44,58,44,61,309,0.41964285714285715,44,75,35,63,33,45,295,0.2647058823529412,1.0
44,50,91,24,86,10,305,0.1981981981981982,86,81,97,81,107,43,495,0.203125,2.0
85,50,95,120,115,80,545,0.5793650793650794,60,100,89,55,69,112,485,0.9298245614035088,1.0
67,82,62,46,48,43,348,0.22033898305084745,74,94,131,54,116,20,489,0.4485294117647059,2.0
95,110,95,40,95,55,490,0.40336134453781514,100,100,100,100,100,100,600,0.8602941176470589,1.0
104,91,63,91,73,68,490,0.5118110236220472,60,62,50,62,60,40,334,0.18181818181818182,1.0
40,70,130,60,130,25,455,0.17355371900826447,30,65,100,45,25,40,305,0.1891891891891892,1.0
65,60,70,85,75,40,395,0.1796875,50,65,45,85,65,95,405,0.7238095238095238,1.0
115,115,85,90,75,100,580,0.8134328358208955,49,66,70,44,55,51,335,0.4260869565217391,2.0
90,132,105,132,105,30,594,0.4246575342465753,106,130,90,110,154,90,680,0.719626168224299,0.25
150,160,100,95,65,100,670,0.8866666666666667,95,75,110,100,80,30,490,0.15267175572519084,1.0
50,48,43,46,41,60,288,0.47297297297297297,50,53,62,58,63,44,330,0.13709677419354838,0.5
54,45,47,75,98,52,371,0.39669421487603307,25,20,15,105,55,90,310,0.32407407407407407,1.0
50,85,125,85,115,20,480,0.4306569343065693,65,150,40,15,80,145,495,0.9663865546218487,1.0
71,120,95,120,95,99,600,0.8203125,46,57,40,40,40,50,273,0.25,0.5
35,55,35,30,30,35,220,0.23684210526315788,75,75,75,125,95,40,485,0.15671641791044777,2.0
60,70,50,100,50,65,395,0.5217391304347826,90,90,85,125,90,100,580,0.768595041322314,0.25
40,50,90,30,55,65,330,0.44680851063829785,30,30,42,30,42,70,244,0.4230769230769231,0.5
55,55,85,65,85,35,380,0.2014388489208633,65,50,35,115,95,95,455,0.7333333333333333,2.0
75,110,110,110,105,80,590,0.656934306569343,100,100,125,110,50,50,535,0.384,1.0
114,85,70,85,80,30,464,0.2066115702479339,70,55,65,95,85,70,440,0.5307692307692308,1.0
50,52,48,65,50,55,320,0.33098591549295775,90,95,105,165,110,45,610,0.2890625,0.5
103,60,126,80,126,50,545,0.36363636363636365,115,140,130,55,55,40,535,0.4519230769230769,0.5
64,88,50,88,50,106,446,0.9111111111111111,44,75,35,63,33,45,295,0.2647058823529412,2.0
90,60,70,75,70,45,410,0.23880597014925373,52,65,50,45,50,38,300,0.27419354838709675,1.0
70,94,50,94,50,66,424,0.48148148148148145,65,130,60,95,110,65,525,0.5303030303030303,0.5
78,52,60,63,65,23,341,0.06015037593984962,90,60,60,40,40,40,330,0.29545454545454547,1.0
50,92,108,92,108,35,485,0.2457627118644068,61,90,45,50,50,160,456,0.9230769230769231,1.0
64,165,75,93,83,75,555,0.6587301587301587,65,155,120,65,90,105,600,0.8677685950413223,1.0
114,85,70,85,80,30,464,0.2066115702479339,250,5,5,35,105,50,450,0.15306122448979592,1.0
50,65,45,85,65,95,405,0.7238095238095238,30,45,55,70,55,85,340,0.5633802816901409,2.0
80,100,200,50,100,50,580,0.3472222222222222,75,95,60,65,60,115,470,0.8778625954198473,1.0
64,66,68,81,76,50,405,0.25190839694656486,100,123,75,57,75,80,510,0.6923076923076923,1.0
95,75,110,100,80,30,490,0.15267175572519084,64,51,23,51,23,28,240,0.11363636363636363,1.0
105,140,55,30,55,95,480,0.8195488721804511,55,40,40,65,45,35,280,0.16428571428571428,1.0
75,98,63,98,63,101,498,0.8091603053435115,30,40,70,70,25,60,295,0.41353383458646614,2.0
90,120,120,60,60,50,500,0.35294117647058826,45,60,40,70,50,45,310,0.2846715328467153,2.0
78,52,60,63,65,23,341,0.06015037593984962,60,48,45,43,90,42,328,0.21897810218978103,1.0
90,75,85,115,90,55,510,0.3445378151260504,48,72,48,72,48,48,336,0.25984251968503935,1.0
70,115,60,115,60,55,475,0.4647887323943662,80,120,70,110,70,80,530,0.6422764227642277,0.25
65,100,70,80,80,105,500,0.8666666666666667,75,110,110,110,105,80,590,0.656934306569343,0.5
80,120,130,55,65,45,495,0.37037037037037035,20,10,230,10,230,5,505,0.0,2.0
75,75,95,75,95,113,528,0.9015151515151515,72,95,67,103,71,122,530,0.9606299212598425,2.0
59,63,80,65,80,58,405,0.41843971631205673,80,80,50,40,50,25,325,0.176056338028169,1.0
45,80,100,35,37,28,325,0.3125,55,70,40,60,40,40,305,0.26956521739130435,2.0
58,64,58,80,65,80,405,0.609271523178808,50,55,50,36,30,43,264,0.2922077922077922,1.0
45,22,60,27,30,29,213,0.07518796992481203,75,75,60,83,60,60,413,0.39344262295081966,1.0
40,35,30,120,70,105,400,0.6692307692307692,58,64,58,80,65,80,405,0.609271523178808,1.0
110,78,73,76,71,60,468,0.3333333333333333,75,140,65,112,65,110,567,0.9140625,0.0
45,40,60,40,75,50,310,0.2926829268292683,65,90,50,85,45,55,390,0.371900826446281,2.0
101,72,72,99,89,29,462,0.1937984496124031,65,75,70,95,70,95,470,0.7272727272727273,1.0
65,60,70,85,75,40,395,0.1796875,46,57,40,40,40,50,273,0.25,1.0
35,60,44,40,54,55,288,0.366412213740458,44,58,44,58,44,61,309,0.41964285714285715,1.0
60,40,60,95,60,55,370,0.4222222222222222,70,62,67,55,55,56,365,0.38513513513513514,1.0
45,80,100,35,37,28,325,0.3125,70,120,65,45,85,125,510,0.9747899159663865,1.0
65,90,50,85,45,55,390,0.371900826446281,50,35,55,25,25,15,205,0.05263157894736842,0.5
55,35,50,55,110,85,390,0.6277372262773723,65,130,60,95,110,65,525,0.5303030303030303,0.5
45,90,20,65,20,65,305,0.5116279069767442,60,60,60,35,35,30,280,0.11194029850746269,1.0
75,85,200,55,65,30,510,0.16778523489932887,70,20,50,20,50,40,250,0.1557377049180328,0.25
63,63,47,41,41,74,329,0.56,36,50,50,65,60,44,305,0.16363636363636364,1.0
40,40,50,30,30,30,220,0.0873015873015873,70,65,60,90,75,90,450,0.6571428571428571,0.25
40,30,50,55,55,100,330,0.584070796460177,30,65,100,45,25,40,305,0.1891891891891892,2.0
104,91,63,91,73,68,490,0.5118110236220472,40,45,40,62,60,60,307,0.33884297520661155,1.0
50,105,125,55,95,50,480,0.375886524822695,108,170,115,120,95,92,700,0.7083333333333334,2.0
90,75,85,115,90,55,510,0.3445378151260504,50,95,90,95,90,180,600,0.9172413793103448,1.0
50,50,50,50,50,50,300,0.30708661417322836,75,105,75,105,75,45,480,0.3274336283185841,0.5
40,70,130,60,130,25,455,0.17355371900826447,40,45,35,40,40,90,290,0.65,0.0
85,50,95,120,115,80,545,0.5793650793650794,75,125,75,30,75,85,465,0.625,4.0
64,88,50,88,50,106,446,0.9111111111111111,40,45,35,30,40,55,245,0.3793103448275862,1.0
55,130,115,50,50,75,475,0.5982142857142857,10,55,25,35,45,95,265,0.5396825396825397,2.0
80,70,65,80,120,100,515,0.8034188034188035,80,120,80,120,80,100,580,0.8478260869565217,1.0
65,85,70,75,70,40,405,0.203125,75,87,63,87,63,98,473,0.865546218487395,4.0
40,55,30,30,30,85,270,0.688,100,75,115,90,115,85,580,0.6446280991735537,1.0
60,85,69,60,69,77,420,0.518796992481203,60,55,145,75,150,40,525,0.2,0.25
126,131,95,131,98,99,680,0.8294573643410853,40,30,35,50,70,55,280,0.28205128205128205,0.5
35,60,44,40,54,55,288,0.366412213740458,55,55,85,65,85,35,380,0.2014388489208633,0.5
75,75,60,83,60,60,413,0.39344262295081966,40,50,90,30,55,65,330,0.44680851063829785,1.0
35,55,35,30,30,35,220,0.23684210526315788,114,85,70,85,80,30,464,0.2066115702479339,1.0
80,70,65,80,120,100,515,0.8034188034188035,70,65,60,90,75,90,450,0.6571428571428571,0.5
45,30,35,20,20,45,195,0.14782608695652175,100,73,83,73,83,55,467,0.371900826446281,0.5
55,75,85,25,25,15,280,0.1875,53,54,53,37,46,45,288,0.3090909090909091,1.0
60,110,70,60,60,100,460,0.8461538461538461,54,66,70,44,55,46,335,0.4214876033057851,0.0
64,78,52,78,52,81,405,0.6422764227642277,55,50,45,135,95,120,500,0.7714285714285715,0.5
50,65,107,105,107,86,520,0.6991150442477876,30,45,59,30,39,57,260,0.2803030303030303,2.0
79,103,120,135,115,78,630,0.5763888888888888,75,80,70,65,75,90,455,0.7578125,1.0
95,65,110,60,130,65,525,0.5275590551181102,60,50,100,85,70,65,430,0.47580645161290325,1.0
90,85,100,95,125,85,580,0.6834532374100719,65,83,57,95,85,105,490,0.8914728682170543,0.5
74,108,133,83,65,32,495,0.32142857142857145,61,84,65,70,70,70,420,0.5,0.5
41,56,40,62,44,71,314,0.568,40,45,35,30,40,55,245,0.3793103448275862,1.0
70,90,110,60,75,95,500,0.7333333333333333,80,120,80,120,80,100,580,0.8478260869565217,1.0
85,100,122,58,75,54,494,0.3939393939393939,70,145,88,140,70,112,625,0.8888888888888888,0.5
85,105,85,40,50,40,405,0.211864406779661,90,75,85,115,90,55,510,0.3445378151260504,1.0
90,132,105,132,105,30,594,0.4246575342465753,95,75,110,100,80,30,490,0.15267175572519084,1.0
40,45,35,30,40,55,245,0.3793103448275862,75,100,95,40,70,110,490,0.8717948717948718,1.0
75,90,140,60,60,40,465,0.3008130081300813,85,100,122,58,75,54,494,0.3939393939393939,1.0
73,76,75,81,100,100,505,0.8110236220472441,50,20,55,25,25,30,205,0.09774436090225563,2.0
75,90,140,60,60,40,465,0.3008130081300813,35,60,44,40,54,55,288,0.366412213740458,0.5
38,30,85,55,65,30,303,0.21428571428571427,30,40,55,40,55,60,280,0.3237410071942446,2.0
40,65,40,80,40,65,330,0.5038167938931297,100,120,100,150,120,90,680,0.728,1.0
55,45,43,55,43,72,313,0.5853658536585366,31,45,90,30,30,40,266,0.21929824561403508,4.0
70,145,88,140,70,112,625,0.8888888888888888,50,50,150,50,150,50,500,0.2571428571428571,1.0
59,110,150,45,49,35,448,0.3333333333333333,60,85,42,85,42,91,405,0.8227848101265823,0.5
85,60,65,135,105,100,550,0.7518248175182481,62,50,58,73,54,72,369,0.4435483870967742,0.25
103,93,67,71,61,84,479,0.7142857142857143,110,135,60,50,65,88,508,0.7744360902255639,0.0
90,120,100,150,120,100,680,0.7718120805369127,65,60,110,130,95,65,525,0.47761194029850745,1.0
25,35,70,95,55,45,325,0.16783216783216784,40,30,32,50,52,65,269,0.3671875,1.0
65,75,105,35,65,85,430,0.6940298507462687,40,30,32,50,52,65,269,0.3671875,1.0
50,95,180,85,45,70,525,0.5298507462686567,83,80,75,70,70,101,479,0.8615384615384616,2.0
75,85,200,55,65,30,510,0.16778523489932887,57,80,91,80,87,75,470,0.5737704918032787,0.5
50,65,107,105,107,86,520,0.6991150442477876,75,125,230,55,95,30,610,0.3448275862068966,0.0
25,20,15,105,55,90,310,0.32407407407407407,80,70,70,90,100,70,480,0.5609756097560976,1.0
80,95,82,60,82,75,474,0.6,58,64,58,80,65,80,405,0.609271523178808,1.0
70,130,100,55,80,65,500,0.608,60,100,89,55,69,112,485,0.9298245614035088,0.5
48,72,48,72,48,48,336,0.25984251968503935,38,36,38,32,36,57,237,0.3893805309734513,1.0
35,85,45,35,35,75,310,0.6492537313432836,91,72,90,129,90,108,580,0.8620689655172413,2.0
90,75,75,90,100,70,500,0.5462184873949579,85,50,95,120,115,80,545,0.5793650793650794,1.0
170,90,45,90,45,60,500,0.427536231884058,89,145,90,105,80,91,600,0.8549618320610687,2.0
30,45,135,45,90,30,375,0.09285714285714286,90,100,60,90,60,80,480,0.6422764227642277,1.0
80,160,60,170,130,80,680,0.6180555555555556,58,64,58,80,65,80,405,0.5423728813559322,1.0
38,30,85,55,65,30,303,0.21428571428571427,100,120,120,150,100,90,680,0.7880794701986755,1.0
37,25,41,25,41,25,194,0.08870967741935484,78,52,60,63,65,23,341,0.06015037593984962,0.5
70,20,50,20,50,40,250,0.1557377049180328,25,20,15,105,55,90,310,0.32407407407407407,1.0
50,50,40,50,40,64,294,0.45588235294117646,45,30,15,85,65,65,305,0.36220472440944884,1.0
35,45,160,30,45,70,385,0.48148148148148145,84,71,43,71,43,48,360,0.25874125874125875,1.0
75,38,38,56,56,67,330,0.5263157894736842,75,123,67,95,85,95,540,0.7642276422764228,0.5
30,45,59,30,39,57,260,0.2803030303030303,50,65,90,35,35,15,290,0.14678899082568808,1.0
59,63,80,65,80,58,405,0.41843971631205673,50,70,160,70,160,90,600,0.7417218543046358,1.0
65,83,57,95,85,105,490,0.8914728682170543,90,120,120,60,60,50,500,0.35294117647058826,0.0
105,95,75,85,75,74,509,0.5714285714285714,75,125,75,30,75,85,465,0.625,1.0
85,50,95,120,115,80,545,0.5793650793650794,45,22,60,27,30,29,213,0.07518796992481203,2.0
75,85,200,55,65,30,510,0.16778523489932887,45,60,45,25,45,55,275,0.29,1.0
150,80,44,90,54,80,498,0.625,60,69,95,69,95,36,424,0.2608695652173913,1.0
80,160,60,170,130,80,680,0.6180555555555556,70,120,65,45,85,125,510,0.9747899159663865,0.0
79,115,70,125,80,111,580,0.8468468468468469,75,95,95,95,95,85,540,0.6470588235294118,1.0
60,85,69,60,69,77,420,0.518796992481203,41,64,45,50,50,50,300,0.36752136752136755,1.0
55,112,45,74,45,70,401,0.559322033898305,50,85,125,85,115,20,480,0.4306569343065693,1.0
59,59,58,90,70,73,409,0.5826086956521739,60,48,45,43,90,42,328,0.21897810218978103,1.0
60,50,70,80,80,140,480,0.8449612403100775,79,115,70,125,80,111,580,0.8468468468468469,2.0
76,25,45,67,55,24,292,0.0390625,75,95,60,65,60,115,470,0.8778625954198473,1.0
80,120,130,55,65,45,495,0.37037037037037035,70,110,80,55,80,105,500,0.8794326241134752,0.0
50,55,50,36,30,43,264,0.2922077922077922,80,105,65,60,75,130,515,0.9645390070921985,0.25
65,60,110,130,95,65,525,0.47761194029850745,70,50,30,95,135,105,485,0.8040540540540541,0.5
50,60,45,100,80,65,400,0.45689655172413796,85,110,90,45,90,80,500,0.6206896551724138,1.0
40,35,30,20,20,50,195,0.23423423423423423,50,35,55,25,25,15,205,0.021739130434782608,1.0
95,80,105,40,70,100,490,0.8046875,58,64,58,80,65,80,405,0.5423728813559322,1.0
37,25,41,25,41,25,194,0.08870967741935484,60,59,85,79,105,36,424,0.16666666666666666,2.0
73,115,60,60,60,90,458,0.6694915254237288,75,75,95,75,95,113,528,0.9015151515151515,1.0
78,70,61,50,61,100,420,0.8145161290322581,65,50,70,95,80,65,425,0.4262295081967213,1.0
80,85,95,30,30,25,345,0.2857142857142857,90,130,80,65,85,55,505,0.4396551724137931,0.5
60,50,50,60,70,50,340,0.28346456692913385,45,30,15,85,65,65,305,0.36220472440944884,1.0
55,95,115,45,45,35,390,0.2116788321167883,71,82,64,64,59,112,452,0.9327731092436975,1.0
60,40,50,75,85,95,405,0.6044776119402985,70,150,140,65,100,75,600,0.55,1.0
35,80,50,50,70,120,405,0.84375,91,72,90,129,90,108,580,0.8620689655172413,1.0
70,85,65,105,85,120,530,0.9262295081967213,45,65,34,40,34,45,263,0.2589928057553957,1.0
100,150,120,120,100,90,680,0.6493506493506493,89,145,90,105,80,91,600,0.8549618320610687,0.0
44,58,44,58,44,61,309,0.41964285714285715,60,60,75,60,75,80,410,0.7321428571428571,1.0
55,20,35,20,45,75,250,0.37681159420289856,60,40,50,75,85,95,405,0.6044776119402985,1.0
90,60,60,40,40,40,330,0.29545454545454547,60,59,85,79,105,36,424,0.16666666666666666,0.25
90,100,60,90,60,80,480,0.6422764227642277,110,65,105,55,95,80,510,0.6258503401360545,0.25
70,60,70,87,78,85,450,0.6228070175438597,60,50,70,50,90,65,385,0.39568345323741005,0.25
45,60,32,50,32,76,295,0.5925925925925926,85,115,80,105,80,50,515,0.3063063063063063,0.5
70,150,140,65,100,75,600,0.55,50,75,70,35,70,48,348,0.29357798165137616,1.0
78,52,60,63,65,23,341,0.06015037593984962,72,85,70,65,70,58,420,0.41304347826086957,4.0
85,120,70,50,60,100,485,0.8308823529411765,45,30,50,65,50,45,285,0.13821138211382114,1.0
64,78,52,78,52,81,405,0.6422764227642277,78,84,78,109,85,100,534,0.8620689655172413,0.5
48,72,48,72,48,48,336,0.25984251968503935,90,93,55,70,55,55,418,0.3819444444444444,1.0
35,46,34,35,45,20,215,0.072,60,25,35,70,80,60,330,0.3076923076923077,1.0
80,80,50,40,50,25,325,0.176056338028169,75,89,85,55,65,36,405,0.29545454545454547,2.0
55,55,55,85,55,30,335,0.1320754716981132,67,89,116,79,116,33,500,0.2624113475177305,0.25
50,70,50,50,50,40,310,0.16296296296296298,130,65,60,110,95,65,525,0.5227272727272727,0.5
105,180,100,180,100,115,780,0.9477611940298507,105,140,55,30,55,95,480,0.8195488721804511,1.0
106,110,90,154,90,130,680,0.926829268292683,30,42,118,42,88,30,350,0.112,0.5
95,155,109,70,130,81,640,0.6788321167883211,110,65,75,125,85,30,490,0.15,2.0
60,100,89,55,69,112,485,0.9298245614035088,30,35,30,100,35,80,310,0.4765625,0.0625
76,147,90,60,70,97,540,0.8267716535433071,90,60,70,75,70,45,410,0.23880597014925373,1.0
50,105,125,55,95,50,480,0.375886524822695,70,135,105,60,105,20,495,0.5806451612903226,0.25
100,123,75,57,75,80,510,0.6923076923076923,65,90,122,58,75,84,494,0.71875,0.0
70,110,70,115,70,90,525,0.75,45,35,50,70,50,30,280,0.15753424657534246,1.0
55,85,55,50,55,60,360,0.4233576642335766,100,100,80,60,60,50,450,0.3050847457627119,2.0
40,27,60,37,50,66,280,0.36220472440944884,65,73,55,47,75,85,400,0.6846846846846847,0.5
90,85,100,95,125,85,580,0.6834532374100719,95,80,105,40,70,100,490,0.8046875,1.0
75,98,63,98,63,101,498,0.8091603053435115,60,62,50,62,60,40,334,0.18181818181818182,0.5
97,165,60,65,50,58,495,0.3902439024390244,86,68,72,109,66,106,507,0.8099173553719008,2.0
90,120,75,60,60,45,450,0.29411764705882354,70,70,40,60,40,60,340,0.4247787610619469,2.0
75,70,90,70,105,80,490,0.656,85,97,66,105,66,65,484,0.47107438016528924,1.0
100,100,100,100,100,100,600,0.8602941176470589,35,85,45,35,35,75,310,0.6492537313432836,0.5
60,48,45,43,90,42,328,0.21897810218978103,38,36,38,32,36,57,237,0.3893805309734513,1.0
45,30,15,85,65,65,305,0.36220472440944884,55,40,50,65,85,40,335,0.3181818181818182,0.5
60,50,50,60,70,50,340,0.28346456692913385,80,120,79,95,79,70,523,0.5833333333333334,1.0
75,80,70,65,75,90,455,0.7578125,70,60,125,115,70,55,495,0.35507246376811596,0.25
75,90,50,110,80,95,500,0.7985611510791367,74,100,72,90,72,46,454,0.24561403508771928,2.0
90,132,105,132,105,30,594,0.4246575342465753,130,70,35,70,35,60,400,0.4017857142857143,1.0
65,95,75,55,55,85,430,0.6933333333333334,48,61,40,61,40,50,300,0.2543859649122807,0.5
100,70,70,65,65,45,415,0.1897810218978102,90,110,80,100,80,95,555,0.7982456140350878,1.0
50,75,75,65,65,50,380,0.4049586776859504,40,60,40,40,40,30,250,0.0948905109489051,1.0
74,108,133,83,65,32,495,0.32142857142857145,45,49,49,65,65,45,318,0.2781954887218045,0.5
60,60,60,35,35,30,280,0.11194029850746269,62,48,66,59,57,49,341,0.33884297520661155,1.0
67,125,40,30,30,58,350,0.3431372549019608,40,30,30,55,30,85,270,0.4666666666666667,2.0
60,59,85,79,105,36,424,0.16666666666666666,58,50,145,95,105,30,483,0.2459016393442623,0.5
100,150,110,95,110,70,635,0.5923076923076923,70,120,65,45,85,125,510,0.9747899159663865,1.0
120,120,120,120,120,120,720,0.9344262295081968,65,85,70,75,70,40,405,0.203125,1.0
45,50,43,40,38,62,278,0.40441176470588236,50,45,45,35,35,50,260,0.23529411764705882,1.0
50,160,110,160,110,110,700,0.8854961832061069,50,70,160,70,160,90,600,0.7417218543046358,1.0
65,95,57,100,85,93,495,0.7441860465116279,50,70,50,50,50,70,340,0.5645161290322581,0.5
55,35,50,55,110,85,390,0.6277372262773723,64,165,75,93,83,75,555,0.6587301587301587,0.5
110,65,105,55,95,80,510,0.6258503401360545,106,150,70,194,120,140,780,0.952,2.0
73,115,60,60,60,90,458,0.6694915254237288,100,100,100,100,100,100,600,0.8758169934640523,0.5
55,84,105,114,75,52,485,0.2890625,60,59,85,79,105,36,424,0.16666666666666666,0.5
80,80,80,55,55,90,440,0.6417910447761194,90,85,75,115,100,115,580,0.9381443298969072,1.0
85,60,65,135,105,100,550,0.7518248175182481,70,43,53,43,53,40,302,0.19090909090909092,0.5
75,100,63,80,63,116,497,0.9345794392523364,41,64,45,50,50,50,300,0.36752136752136755,0.5
60,105,60,120,60,105,510,0.8849557522123894,73,76,75,81,100,100,505,0.8110236220472441,1.0
45,50,43,40,38,62,278,0.40441176470588236,68,125,65,65,115,80,518,0.6277372262773723,2.0
100,123,75,57,75,80,510,0.6923076923076923,85,105,100,79,83,78,530,0.5869565217391305,1.0
100,150,110,95,110,70,635,0.5923076923076923,35,55,35,30,30,35,220,0.23684210526315788,1.0
100,103,75,120,75,127,600,0.940677966101695,44,50,91,24,86,10,305,0.1981981981981982,0.25
50,72,35,35,35,65,292,0.5373134328358209,75,75,60,83,60,60,413,0.39344262295081966,1.0
70,77,60,97,60,108,472,0.8394160583941606,60,70,50,100,50,65,395,0.5217391304347826,1.0
50,20,55,25,25,30,205,0.09774436090225563,40,45,40,35,35,56,251,0.373015873015873,0.5
70,115,60,115,60,55,475,0.4647887323943662,91,90,106,130,106,77,600,0.648854961832061,0.25
70,43,53,43,53,40,302,0.19090909090909092,90,130,80,65,85,55,505,0.4396551724137931,1.0
65,75,105,35,65,85,430,0.6940298507462687,91,72,90,129,90,108,580,0.8620689655172413,2.0
80,95,82,60,82,75,474,0.6,85,115,80,105,80,50,515,0.3063063063063063,1.0
70,90,45,15,45,50,315,0.3629032258064516,108,130,95,80,85,102,600,0.7637795275590551,0.5
70,90,110,60,75,95,500,0.7333333333333333,55,81,60,50,70,97,413,0.7214285714285714,1.0
95,135,80,110,80,100,600,0.8248175182481752,75,90,140,60,60,40,465,0.3008130081300813,0.5
100,120,120,150,100,90,680,0.7880794701986755,70,62,67,55,55,56,365,0.38513513513513514,1.0
60,90,140,50,50,40,430,0.2535211267605634,75,90,140,60,60,40,465,0.3008130081300813,0.5
79,105,70,145,80,101,580,0.8608695652173913,70,94,50,94,50,66,424,0.48148148148148145,4.0
45,55,45,65,45,75,330,0.5692307692307692,41,50,37,50,37,66,281,0.5175438596491229,1.0
110,78,73,76,71,60,468,0.3333333333333333,75,98,63,98,63,101,498,0.849624060150376,0.5
77,85,51,55,51,65,384,0.5163934426229508,55,45,45,25,25,15,210,0.048,1.0
90,100,60,90,60,80,480,0.6422764227642277,45,63,37,65,55,95,360,0.8055555555555556,1.0
50,35,55,25,25,15,205,0.021739130434782608,75,80,70,65,75,90,455,0.7578125,0.25
40,40,35,50,100,70,335,0.5031847133757962,53,54,53,37,46,45,288,0.3090909090909091,1.0
150,160,100,95,65,100,670,0.8866666666666667,30,35,30,100,35,80,310,0.4765625,0.0
91,129,90,72,90,108,580,0.8536585365853658,30,40,70,70,25,60,295,0.41353383458646614,1.0
70,110,80,55,80,105,500,0.8794326241134752,80,82,83,100,100,80,525,0.6742424242424242,2.0
35,70,55,45,55,25,285,0.09420289855072464,70,92,65,80,55,98,460,0.8090909090909091,2.0
95,109,105,75,85,56,525,0.34513274336283184,65,80,80,59,63,58,405,0.4411764705882353,2.0
65,40,50,125,60,30,370,0.07258064516129033,50,25,28,45,55,15,218,0.0625,1.0
60,67,85,77,75,116,480,0.8888888888888888,80,70,70,90,100,70,480,0.5609756097560976,1.0
106,110,90,154,90,130,680,0.926829268292683,80,100,200,50,100,50,580,0.3472222222222222,1.0
91,134,95,100,100,80,600,0.6304347826086957,40,45,40,62,60,60,307,0.33884297520661155,1.0
45,63,37,65,55,95,360,0.8055555555555556,100,73,83,73,83,55,467,0.371900826446281,1.0
60,30,30,36,56,50,262,0.32432432432432434,100,150,110,95,110,70,635,0.5923076923076923,1.0
55,45,45,25,25,15,210,0.048,35,55,40,45,40,60,275,0.35714285714285715,2.0
40,30,30,55,30,85,270,0.4666666666666667,65,100,70,80,80,105,500,0.8666666666666667,2.0
55,104,105,94,75,52,485,0.36363636363636365,95,75,80,100,110,30,490,0.24242424242424243,0.5
67,125,40,30,30,58,350,0.3431372549019608,46,87,60,30,40,57,320,0.37777777777777777,1.0
70,95,125,65,75,45,475,0.33613445378151263,60,85,42,85,42,91,405,0.8227848101265823,2.0
20,10,230,10,230,5,505,0.0,65,45,55,45,70,45,325,0.24369747899159663,1.0
30,45,135,45,90,30,375,0.09285714285714286,44,48,65,50,64,43,314,0.1623931623931624,1.0
70,95,125,65,75,45,475,0.33613445378151263,45,49,49,65,65,45,318,0.2781954887218045,1.0
100,123,75,57,75,80,510,0.6923076923076923,84,71,43,71,43,48,360,0.25874125874125875,1.0
55,95,115,45,45,35,390,0.2116788321167883,130,85,80,85,95,60,535,0.43884892086330934,2.0
84,71,43,71,43,48,360,0.25874125874125875,40,45,35,30,40,55,245,0.3793103448275862,1.0
80,80,80,55,55,90,440,0.6417910447761194,60,100,89,55,69,112,485,0.9298245614035088,1.0
165,75,80,40,45,65,470,0.5151515151515151,75,98,63,98,63,101,498,0.849624060150376,0.5
65,50,70,95,80,65,425,0.4262295081967213,75,98,63,98,63,101,498,0.8091603053435115,1.0
50,50,40,30,30,50,250,0.2781954887218045,70,105,105,50,40,20,390,0.33587786259541985,2.0
45,50,35,55,75,40,300,0.21367521367521367,55,55,85,65,85,35,380,0.2014388489208633,1.0
70,80,50,35,35,35,305,0.14,45,45,55,45,55,63,308,0.4594594594594595,1.0
91,90,106,130,106,77,600,0.648854961832061,82,121,119,69,59,71,521,0.5394736842105263,0.5
45,63,37,65,55,95,360,0.8055555555555556,90,120,75,60,60,45,450,0.29411764705882354,1.0
45,45,55,45,55,63,308,0.4594594594594595,45,60,32,50,32,76,295,0.5925925925925926,1.0
108,112,118,68,72,47,525,0.2916666666666667,71,82,64,64,59,112,452,0.9327731092436975,1.0
45,90,20,65,20,65,305,0.5116279069767442,60,50,100,85,70,65,430,0.47580645161290325,0.5
100,150,120,120,100,90,680,0.6493506493506493,60,70,65,125,105,90,515,0.6911764705882353,0.5
50,160,110,160,110,110,700,0.8854961832061069,20,25,45,70,90,60,310,0.30833333333333335,1.0
100,120,120,150,100,90,680,0.7880794701986755,79,85,60,55,60,71,410,0.60431654676259,0.5
40,30,35,45,40,55,245,0.31496062992125984,60,90,70,60,120,40,440,0.27419354838709675,1.0
80,125,75,40,95,85,500,0.6911764705882353,85,105,100,79,83,78,530,0.5869565217391305,1.0
40,45,35,40,40,90,290,0.65,90,75,75,90,100,70,500,0.5462184873949579,1.0
70,62,67,55,55,56,365,0.38513513513513514,40,45,35,30,40,55,245,0.3793103448275862,0.5
31,45,90,30,30,40,266,0.21929824561403508,70,110,80,55,80,105,500,0.8794326241134752,0.0
72,60,30,20,30,25,237,0.11570247933884298,90,93,55,70,55,55,418,0.3819444444444444,1.0
35,80,50,50,70,120,405,0.84375,90,120,120,60,60,50,500,0.35294117647058826,1.0
70,100,115,30,65,30,410,0.24390243902439024,50,95,95,35,110,70,455,0.5179856115107914,0.5
55,130,115,50,50,75,475,0.5982142857142857,95,65,65,110,130,60,525,0.4016393442622951,1.0
28,25,25,45,35,40,198,0.16083916083916083,58,70,45,40,45,42,300,0.25925925925925924,4.0
80,130,100,160,120,110,700,0.8981481481481481,75,80,60,65,90,102,472,0.8625954198473282,1.0
35,55,35,30,30,35,220,0.23684210526315788,50,65,64,44,48,43,314,0.2196969696969697,1.0
35,65,35,65,35,65,300,0.46621621621621623,70,95,85,55,65,70,440,0.5,2.0
1,90,45,30,30,40,236,0.33064516129032256,65,105,60,60,70,95,455,63.0,0.5
75,85,200,55,65,30,510,0.16778523489932887,84,71,43,71,43,48,360,0.25874125874125875,1.0
30,56,35,25,35,72,253,0.48148148148148145,80,100,70,60,70,95,475,0.7416666666666667,1.0
65,90,115,45,115,58,488,0.5041322314049587,40,70,130,60,130,25,455,0.17355371900826447,0.0
60,55,50,40,55,45,305,0.22377622377622378,110,85,95,80,95,50,515,0.2713178294573643,1.0
58,64,58,80,65,80,405,0.609271523178808,60,70,65,125,105,90,515,0.6911764705882353,2.0
80,80,80,80,80,80,480,0.5606060606060606,55,65,35,60,30,85,330,0.6126126126126126,0.5
81,102,77,85,75,85,505,0.5642857142857143,30,56,35,25,35,72,253,0.48148148148148145,1.0
100,73,83,73,83,55,467,0.371900826446281,50,50,62,40,62,65,329,0.4188034188034188,0.5
100,100,125,110,50,50,535,0.384,101,72,72,99,89,29,462,0.1937984496124031,1.0
106,150,70,194,120,140,780,0.952,90,132,105,132,105,30,594,0.4246575342465753,1.0
60,55,90,145,90,80,520,0.6071428571428571,60,65,70,85,75,40,395,0.21705426356589147,2.0
126,131,95,131,98,99,680,0.8294573643410853,80,80,80,80,80,80,480,0.5606060606060606,1.0
78,104,78,159,115,100,634,0.8444444444444444,55,95,115,45,45,35,390,0.2116788321167883,0.25
65,70,60,65,65,115,440,0.8583333333333333,70,70,40,60,40,60,340,0.4247787610619469,1.0
110,160,110,80,110,100,670,0.8591549295774648,80,95,82,60,82,75,474,0.6,1.0
70,55,75,45,65,60,370,0.45901639344262296,70,105,105,50,40,20,390,0.33587786259541985,0.5
115,115,85,90,75,100,580,0.8134328358208955,78,70,61,50,61,100,420,0.8145161290322581,1.0
60,52,168,47,138,30,495,0.19834710743801653,30,45,135,45,90,30,375,0.09285714285714286,2.0
95,65,110,60,130,65,525,0.5275590551181102,57,80,91,80,87,75,470,0.5737704918032787,0.5
40,80,100,30,30,20,300,0.11851851851851852,80,100,80,80,80,100,520,0.9051724137931034,0.5
40,40,55,40,70,55,300,0.40939597315436244,100,50,80,60,80,50,420,0.34375,1.0
75,100,66,60,66,115,482,0.918918918918919,80,100,123,122,120,80,625,0.56,1.0
85,76,64,45,55,90,415,0.6739130434782609,57,24,86,24,86,23,300,0.12727272727272726,0.5
40,55,99,40,79,47,360,0.26262626262626265,86,92,88,68,75,73,482,0.6835443037974683,4.0
50,85,40,85,40,35,335,0.1746031746031746,70,50,30,95,135,105,485,0.8040540540540541,1.0
80,120,70,110,70,80,530,0.6422764227642277,30,45,55,70,55,85,340,0.5633802816901409,0.5
70,100,70,105,75,40,460,0.23214285714285715,90,120,75,60,60,45,450,0.29411764705882354,1.0
95,75,110,100,80,30,490,0.15267175572519084,45,40,60,40,75,50,310,0.2926829268292683,1.0
70,80,102,80,102,40,474,0.2677165354330709,65,70,60,65,65,115,440,0.8583333333333333,1.0
80,105,65,60,75,130,515,0.9645390070921985,125,120,90,170,100,95,700,0.78125,2.0
125,120,90,170,100,95,700,0.78125,60,62,50,62,60,40,334,0.18181818181818182,1.0
62,73,55,56,52,84,382,0.7244094488188977,45,45,35,20,30,20,195,0.07246376811594203,4.0
45,20,50,60,120,50,345,0.24074074074074073,82,80,86,85,75,72,480,0.6183206106870229,1.0
80,85,95,30,30,25,345,0.2857142857142857,75,125,230,55,95,30,610,0.3448275862068966,0.5
40,80,100,30,30,20,300,0.11851851851851852,55,130,115,50,50,75,475,0.5982142857142857,1.0
60,60,75,60,75,80,410,0.7321428571428571,45,75,60,40,30,50,300,0.304,1.0
100,120,100,150,120,90,680,0.728,100,73,83,73,83,55,467,0.371900826446281,1.0
125,130,90,130,90,95,660,0.7734375,105,105,75,65,100,50,500,0.37593984962406013,1.0
50,70,50,50,50,40,310,0.16296296296296298,60,60,60,35,35,30,280,0.11194029850746269,1.0
45,30,40,105,50,20,290,0.031007751937984496,75,75,60,83,60,60,413,0.39344262295081966,1.0
70,115,60,115,60,55,475,0.4647887323943662,95,85,85,65,65,35,430,0.2571428571428571,4.0
70,120,40,95,40,95,460,0.8106060606060606,40,35,30,20,20,50,195,0.23423423423423423,1.0
60,100,89,55,69,112,485,0.9298245614035088,80,100,123,122,120,80,625,0.56,1.0
55,65,35,60,30,85,330,0.6126126126126126,40,55,70,45,60,30,300,0.10619469026548672,1.0
59,74,50,35,50,35,303,0.3125,100,180,160,150,90,90,770,0.7520661157024794,2.0
70,60,70,87,78,85,450,0.6228070175438597,75,75,130,75,130,95,580,0.7479674796747967,1.0
45,50,35,55,75,40,300,0.21367521367521367,50,47,50,57,50,65,319,0.463768115942029,1.0
50,48,43,46,41,60,288,0.47297297297297297,75,80,60,65,90,102,472,0.8625954198473282,1.0
80,82,78,95,80,85,500,0.6869565217391305,125,58,58,76,76,67,460,0.515625,0.5
60,55,145,75,150,40,525,0.2,40,80,100,30,30,20,300,0.11851851851851852,1.0
80,105,65,60,75,130,515,0.9645390070921985,74,108,133,83,65,32,495,0.32142857142857145,0.5
95,95,85,125,65,55,520,0.3894736842105263,85,80,70,135,75,90,535,0.7006802721088435,1.0
55,40,85,80,105,40,405,0.23622047244094488,65,63,45,45,45,45,308,0.2595419847328244,0.5
35,60,44,40,54,55,288,0.366412213740458,65,105,60,60,70,95,455,63.0,1.0
170,90,45,90,45,60,500,0.427536231884058,95,124,78,69,71,58,495,0.37398373983739835,1.0
70,50,30,95,135,105,485,0.8040540540540541,84,86,88,111,101,60,530,0.4634146341463415,0.25
45,100,45,45,45,10,290,0.2949640287769784,50,50,40,50,40,64,294,0.45588235294117646,1.0
104,91,63,91,73,68,490,0.5118110236220472,45,30,50,65,50,45,285,0.13821138211382114,1.0
100,150,140,100,90,90,670,0.7969924812030075,101,72,72,99,89,29,462,0.1937984496124031,1.0
80,75,150,75,150,50,580,0.30973451327433627,85,110,76,65,82,56,474,0.3933333333333333,1.0
55,63,90,50,80,42,380,0.21138211382113822,65,40,70,80,140,70,465,0.5954198473282443,0.5
40,35,30,20,20,50,195,0.23423423423423423,50,180,20,180,20,150,600,0.9029850746268657,2.0
58,89,77,45,45,48,362,0.3177570093457944,30,45,135,45,90,30,375,0.09285714285714286,1.0
65,155,120,65,90,105,600,0.8677685950413223,57,24,86,24,86,23,300,0.12727272727272726,0.5
70,45,48,60,65,35,323,0.15748031496062992,109,66,84,81,99,32,471,0.2013888888888889,1.0
59,63,80,65,80,58,405,0.41843971631205673,45,100,45,45,45,10,290,0.2949640287769784,2.0
50,80,95,10,45,10,290,0.232,110,65,105,55,95,80,510,0.6258503401360545,2.0
25,35,70,95,55,45,325,0.16783216783216784,50,65,107,105,107,86,520,0.7272727272727273,0.5
60,67,85,77,75,116,480,0.8888888888888888,90,132,105,132,105,30,594,0.4246575342465753,0.5
50,65,90,35,35,15,290,0.14678899082568808,43,30,55,40,65,97,330,0.6030534351145038,1.0
35,35,40,35,55,50,250,0.40336134453781514,20,40,15,35,35,60,205,0.34285714285714286,0.5
37,25,41,25,41,25,194,0.08870967741935484,60,85,42,85,42,91,405,0.8227848101265823,1.0
82,80,86,85,75,72,480,0.6183206106870229,82,121,119,69,59,71,521,0.5394736842105263,2.0
35,70,55,45,55,25,285,0.09420289855072464,50,50,50,50,50,50,300,0.30708661417322836,1.0
38,30,41,30,41,60,240,0.2897196261682243,106,130,90,110,154,90,680,0.719626168224299,1.0
85,97,66,105,66,65,484,0.47107438016528924,105,95,75,85,75,74,509,0.5714285714285714,0.5
75,95,95,95,95,85,540,0.6470588235294118,40,30,30,40,50,30,220,0.07936507936507936,0.25
83,80,80,135,80,121,579,0.9444444444444444,80,50,100,100,200,50,580,0.2357142857142857,1.0
58,64,58,80,65,80,405,0.5423728813559322,35,35,35,35,35,35,210,0.13385826771653545,1.0
70,94,50,94,50,66,424,0.48148148148148145,75,75,55,105,85,30,425,0.1619718309859155,4.0
65,136,94,54,96,135,580,0.9612403100775194,30,65,100,45,25,40,305,0.1891891891891892,1.0
125,120,90,170,100,95,700,0.78125,100,50,50,76,96,70,442,0.5,2.0
40,55,99,40,79,47,360,0.26262626262626265,65,150,60,115,60,115,565,0.935251798561151,2.0
40,55,99,40,79,47,360,0.26262626262626265,58,70,45,40,45,42,300,0.25925925925925924,0.5
125,130,90,130,90,95,660,0.7734375,74,48,76,83,81,104,466,0.7322834645669292,1.0
61,90,45,50,50,160,456,0.9230769230769231,125,130,90,130,90,95,660,0.7734375,1.0
60,100,115,70,85,90,520,0.7557251908396947,40,30,32,50,52,65,269,0.3671875,0.5
74,100,72,90,72,46,454,0.24561403508771928,95,95,85,125,65,55,520,0.3894736842105263,0.5
105,105,75,65,100,50,500,0.37593984962406013,80,100,70,50,60,45,405,0.25806451612903225,1.0
75,123,67,95,85,95,540,0.7642276422764228,77,120,90,60,90,48,485,0.2785714285714286,0.5
80,135,85,70,95,150,615,0.9844961240310077,65,125,60,95,60,105,510,0.9236641221374046,1.0
80,70,65,80,120,100,515,0.8034188034188035,65,60,110,130,95,65,525,0.47761194029850745,1.0
72,60,30,20,30,25,237,0.11570247933884298,78,84,78,109,85,100,534,0.8646616541353384,0.5
70,62,67,55,55,56,365,0.38513513513513514,90,90,85,125,90,100,580,0.768595041322314,1.0
50,72,35,35,35,65,292,0.5373134328358209,80,120,80,120,80,100,580,0.8478260869565217,1.0
65,90,115,45,115,58,488,0.5041322314049587,100,103,75,120,75,127,600,0.940677966101695,0.5
80,80,80,80,80,80,480,0.5606060606060606,38,30,85,55,65,30,303,0.21428571428571427,1.0
45,60,40,70,50,45,310,0.2846715328467153,73,76,75,81,100,100,505,0.8110236220472441,0.5
50,65,64,44,48,43,314,0.2196969696969697,41,64,45,50,50,50,300,0.36752136752136755,0.5
55,45,43,55,43,72,313,0.5853658536585366,50,75,70,35,70,48,348,0.29357798165137616,0.0
45,22,60,27,30,29,213,0.07518796992481203,55,95,55,35,75,115,430,0.9380530973451328,2.0
70,55,75,45,65,60,370,0.45901639344262296,90,93,55,70,55,55,418,0.3819444444444444,1.0
92,105,90,125,90,98,600,0.8217054263565892,80,80,50,40,50,25,325,0.176056338028169,1.0
50,65,107,105,107,86,520,0.7313432835820896,50,35,55,25,25,15,205,0.05263157894736842,0.5
45,85,50,55,50,65,350,0.5076923076923077,48,61,40,61,40,50,300,0.2543859649122807,0.5
106,90,130,90,154,110,680,0.8699186991869918,45,85,70,40,40,60,340,0.5229357798165137,0.0
50,70,50,50,50,70,340,0.5645161290322581,54,78,103,53,45,22,355,0.23255813953488372,2.0
77,120,90,60,90,48,485,0.2785714285714286,90,110,80,100,80,95,555,0.7982456140350878,1.0
95,65,65,110,130,60,525,0.4016393442622951,50,48,43,46,41,60,288,0.47297297297297297,1.0
100,164,150,95,120,71,700,0.5645161290322581,62,48,54,63,60,68,355,0.5178571428571429,2.0
75,95,95,95,95,85,540,0.6470588235294118,55,50,65,175,95,150,590,0.7818181818181819,1.0
60,40,60,95,60,55,370,0.4222222222222222,50,50,50,50,50,50,300,0.30708661417322836,2.0
55,69,85,32,35,28,304,0.09302325581395349,45,80,100,35,37,28,325,0.3125,0.5
60,100,115,70,85,90,520,0.7557251908396947,48,61,40,61,40,50,300,0.2543859649122807,1.0
80,82,83,100,100,80,525,0.6742424242424242,44,38,39,61,79,42,303,0.2251655629139073,2.0
45,45,35,20,30,20,195,0.07246376811594203,50,20,40,20,40,20,190,0.0962962962962963,0.5
40,45,40,35,35,56,251,0.373015873015873,38,36,38,32,36,57,237,0.3893805309734513,1.0
135,85,40,40,85,5,390,0.6864406779661016,80,90,80,130,110,110,600,0.856,1.0
40,50,45,70,45,70,320,0.5517241379310345,68,125,65,65,115,80,518,0.6277372262773723,1.0
55,69,85,32,35,28,304,0.09302325581395349,45,60,30,80,50,65,330,0.4603174603174603,0.5
80,100,123,122,120,80,625,0.56,65,65,60,130,95,110,525,0.823943661971831,1.0
85,105,85,40,50,40,405,0.211864406779661,115,140,130,55,55,40,535,0.4519230769230769,2.0
60,60,40,65,45,35,305,0.15833333333333333,70,90,90,135,90,125,600,0.9401709401709402,1.0
67,58,57,81,67,101,431,0.8790322580645161,76,48,48,57,62,34,325,0.11688311688311688,2.0
114,85,70,85,80,30,464,0.2066115702479339,30,105,90,25,25,50,325,0.2773722627737226,2.0
35,45,160,30,45,70,385,0.48148148148148145,40,55,80,35,60,30,300,0.15037593984962405,1.0
44,75,35,63,33,45,295,0.2647058823529412,35,80,50,50,70,120,405,0.84375,1.0
60,67,85,77,75,116,480,0.8888888888888888,70,110,180,60,60,50,530,0.4117647058823529,0.5
68,165,95,65,115,110,618,0.8615384615384616,90,120,120,60,60,50,500,0.35294117647058826,2.0
105,130,120,45,45,40,485,0.4444444444444444,72,85,70,65,70,58,420,0.41304347826086957,1.0
50,65,107,105,107,86,520,0.7758620689655172,71,95,85,110,95,79,535,0.664,1.0
80,110,60,150,130,70,600,0.5042016806722689,45,20,50,60,120,50,345,0.24074074074074073,1.0
100,110,90,85,90,60,535,0.47794117647058826,130,65,60,110,95,65,525,0.5227272727272727,0.5
75,75,60,83,60,60,413,0.39344262295081966,105,150,90,150,90,95,680,0.8285714285714286,0.5
75,95,67,125,95,83,540,0.7117117117117117,69,69,76,69,86,91,460,0.6554621848739496,0.5
75,70,90,70,105,80,490,0.656,82,80,86,85,75,72,480,0.6183206106870229,0.0
90,130,80,65,85,55,505,0.4396551724137931,91,90,106,130,106,77,600,0.648854961832061,2.0
130,70,35,70,35,60,400,0.4017857142857143,45,63,37,65,55,95,360,0.8055555555555556,1.0
54,45,47,75,98,52,371,0.39669421487603307,50,65,107,105,107,86,520,0.7313432835820896,1.0
45,30,15,85,65,65,305,0.36220472440944884,45,80,100,35,37,28,325,0.3125,0.25
65,125,60,95,60,105,510,0.9236641221374046,50,20,40,20,40,20,190,0.0962962962962963,1.0
54,78,103,53,45,22,355,0.23255813953488372,44,48,65,50,64,43,314,0.1623931623931624,0.5
60,62,50,62,60,40,334,0.18181818181818182,50,75,75,65,65,50,380,0.4049586776859504,1.0
60,80,50,40,40,30,300,0.15328467153284672,150,160,100,95,65,100,670,0.8866666666666667,1.0
95,23,48,23,48,23,260,0.046153846153846156,85,80,70,135,75,90,535,0.7006802721088435,1.0
40,45,40,35,35,56,251,0.373015873015873,90,85,100,95,125,85,580,0.6834532374100719,1.0
60,110,70,60,60,100,460,0.8461538461538461,60,70,65,125,105,90,515,0.6911764705882353,2.0
65,65,65,50,50,90,385,0.72,60,62,80,63,80,60,405,0.4336283185840708,0.5
95,75,180,130,80,30,590,0.13793103448275862,50,65,107,105,107,86,520,0.7313432835820896,0.5
60,40,50,75,85,95,405,0.6044776119402985,45,90,20,65,20,65,305,0.5116279069767442,2.0
50,70,50,50,50,40,310,0.16296296296296298,70,110,70,115,70,90,525,0.75,1.0
110,80,90,95,90,65,530,0.5033557046979866,58,70,45,40,45,42,300,0.25925925925925924,4.0
91,72,90,129,90,108,580,0.8620689655172413,75,80,55,25,35,35,305,0.18666666666666668,1.0
50,65,45,85,65,95,405,0.7238095238095238,75,80,60,65,90,102,472,0.8625954198473282,1.0
90,132,105,132,105,30,594,0.4246575342465753,60,45,70,75,85,55,390,0.3008130081300813,1.0
50,60,60,60,60,30,320,0.11290322580645161,83,80,75,70,70,101,479,0.8615384615384616,1.0
60,70,65,125,105,90,515,0.6911764705882353,95,117,184,44,46,28,514,0.2975206611570248,1.0
50,65,107,105,107,86,520,0.6991150442477876,44,48,65,50,64,43,314,0.1623931623931624,1.0
60,105,60,120,60,105,510,0.8849557522123894,90,55,75,60,75,30,385,0.13970588235294118,1.0
80,100,200,50,100,50,580,0.3472222222222222,95,117,184,44,46,28,514,0.2975206611570248,2.0
70,40,50,55,50,25,290,0.061068702290076333,165,75,80,40,45,65,470,0.5151515151515151,0.25
60,50,70,80,80,140,480,0.8449612403100775,68,125,65,65,115,80,518,0.6277372262773723,1.0
75,89,85,55,65,36,405,0.29545454545454547,86,92,88,68,75,73,482,0.6835443037974683,1.0
30,105,90,25,25,50,325,0.2773722627737226,125,130,90,130,90,95,660,0.7734375,0.5
45,30,50,55,65,45,290,0.208,50,35,55,25,25,15,205,0.021739130434782608,1.0
60,60,60,105,105,105,495,0.848,108,130,95,80,85,102,600,0.7637795275590551,1.0
70,85,140,85,70,20,470,0.272,70,95,125,65,75,45,475,0.33613445378151263,1.0
59,74,50,35,50,35,303,0.3125,70,130,100,55,80,65,500,0.608,1.0
76,48,48,57,62,34,325,0.11688311688311688,72,58,80,103,80,97,490,0.7171052631578947,1.0
55,55,55,85,55,30,335,0.1320754716981132,73,100,60,100,60,65,458,0.42657342657342656,2.0
30,40,70,70,25,60,295,0.41353383458646614,75,100,95,40,70,110,490,0.8717948717948718,1.0
60,80,95,70,85,50,440,0.2231404958677686,95,125,79,60,100,81,540,0.6165413533834586,0.5
50,53,48,53,48,64,316,0.358974358974359,35,35,40,35,55,50,250,0.40336134453781514,0.5
76,65,45,92,42,91,411,0.7449664429530202,84,86,88,111,101,60,530,0.4634146341463415,0.25
65,110,130,60,65,95,525,0.8278145695364238,40,40,40,70,40,20,250,0.032520325203252036,0.5
40,70,130,60,130,25,455,0.17355371900826447,40,80,100,30,30,20,300,0.11851851851851852,1.0
70,90,45,15,45,50,315,0.3629032258064516,60,75,85,100,85,115,520,0.8992248062015504,0.5
80,120,130,55,65,45,495,0.37037037037037035,71,73,88,120,89,59,500,0.43537414965986393,1.0
30,45,135,45,90,30,375,0.09285714285714286,55,55,55,85,55,30,335,0.1320754716981132,1.0
40,45,40,62,60,60,307,0.33884297520661155,65,65,65,50,50,90,385,0.72,0.5
80,50,100,100,200,50,580,0.2357142857142857,60,100,89,55,69,112,485,0.9298245614035088,1.0
73,115,60,60,60,90,458,0.6694915254237288,50,45,45,35,35,50,260,0.23529411764705882,1.0
85,135,130,60,80,25,515,0.40540540540540543,59,74,50,35,50,35,303,0.3125,0.5
75,125,230,55,95,30,610,0.3448275862068966,80,80,90,110,130,110,600,0.8721804511278195,1.0
79,115,70,125,80,111,580,0.8468468468468469,50,95,180,85,45,70,525,0.5298507462686567,1.0
65,90,115,45,115,58,488,0.5041322314049587,60,50,70,50,90,65,385,0.39568345323741005,0.25
60,100,89,55,69,112,485,0.9298245614035088,60,40,60,95,60,55,370,0.4222222222222222,0.125
100,77,77,128,128,90,600,0.6901408450704225,80,125,75,40,95,85,500,0.6911764705882353,1.0
75,87,63,87,63,98,473,0.865546218487395,59,59,58,90,70,73,409,0.5826086956521739,2.0
56,61,65,48,45,38,313,0.17567567567567569,75,98,63,98,63,101,498,0.889763779527559,0.5
83,106,65,86,65,85,490,0.6640625,65,40,70,80,140,70,465,0.5954198473282443,0.5
50,35,55,25,25,15,205,0.021739130434782608,70,65,60,90,75,90,450,0.6571428571428571,0.5
90,65,65,40,40,15,315,0.19672131147540983,108,170,115,120,95,92,700,0.7083333333333334,2.0
95,145,130,120,90,120,700,0.9398496240601504,45,30,15,85,65,65,305,0.36220472440944884,1.0
65,50,70,95,80,65,425,0.4262295081967213,40,45,35,65,55,70,310,0.4482758620689655,1.0
40,40,55,40,70,55,300,0.40939597315436244,65,83,57,95,85,105,490,0.8914728682170543,2.0
65,75,70,95,70,95,470,0.7272727272727273,101,72,72,99,89,29,462,0.1937984496124031,1.0
50,50,95,40,50,35,320,0.20279720279720279,80,135,85,70,95,150,615,0.9844961240310077,0.0
75,80,85,110,90,50,490,0.3548387096774194,50,95,180,85,45,70,525,0.5298507462686567,2.0
58,50,145,95,105,30,483,0.2459016393442623,65,110,130,60,65,95,525,0.8278145695364238,1.0
100,150,90,180,160,90,770,0.7348484848484849,50,70,50,50,50,70,340,0.5645161290322581,1.0
78,84,78,109,85,100,534,0.8646616541353384,35,40,100,90,55,35,355,0.1796875,0.125
40,45,35,40,40,90,290,0.65,90,60,70,75,70,45,410,0.23880597014925373,1.0
62,77,62,50,42,65,358,0.4838709677419355,70,140,230,60,80,50,630,0.32432432432432434,0.25
69,69,76,69,86,91,460,0.6554621848739496,74,108,133,83,65,32,495,0.32142857142857145,1.0
75,75,55,105,85,30,425,0.1619718309859155,70,110,180,60,60,50,530,0.4117647058823529,1.0
70,55,75,45,65,60,370,0.45901639344262296,54,45,47,75,98,52,371,0.39669421487603307,0.5
55,95,115,45,45,35,390,0.2116788321167883,150,120,100,120,100,90,680,0.664179104477612,1.0
75,80,60,65,90,102,472,0.8625954198473282,50,85,55,65,65,90,410,0.7478260869565218,1.0
25,35,70,95,55,45,325,0.16783216783216784,91,72,90,129,90,108,580,0.8620689655172413,1.0
84,71,43,71,43,48,360,0.25874125874125875,60,82,45,45,45,74,351,0.5752212389380531,1.0
85,135,130,60,80,25,515,0.40540540540540543,90,70,80,70,95,70,475,0.5190839694656488,2.0
70,70,115,130,90,60,535,0.5338983050847458,60,150,50,150,50,60,520,0.5,0.5
62,55,52,109,94,109,481,0.7833333333333333,75,105,75,105,75,45,480,0.3274336283185841,2.0
68,65,65,125,115,80,518,0.6461538461538462,30,80,90,55,45,55,355,0.4295774647887324,1.0
50,50,50,50,50,50,300,0.30708661417322836,95,109,105,75,85,56,525,0.34513274336283184,4.0
55,55,45,63,45,45,308,0.25,50,70,50,50,50,70,340,0.5645161290322581,1.0
72,95,67,103,71,122,530,0.9606299212598425,45,75,60,40,30,50,300,0.304,0.5
110,78,73,76,71,60,468,0.3333333333333333,55,50,45,135,95,120,500,0.7714285714285715,1.0
72,58,80,103,80,97,490,0.7171052631578947,60,75,85,100,85,115,520,0.8992248062015504,0.5
38,35,35,65,55,50,278,0.2647058823529412,50,50,120,80,80,30,410,0.07258064516129033,0.5
55,70,45,70,50,60,350,0.45,105,180,100,180,100,115,780,0.9477611940298507,0.5
95,75,80,100,110,30,490,0.24242424242424243,45,49,49,65,65,45,318,0.2781954887218045,1.0
75,103,80,70,80,92,500,0.7933884297520661,45,53,70,40,60,42,310,0.25735294117647056,0.5
76,25,45,67,55,24,292,0.0390625,79,105,70,145,80,101,580,0.8608695652173913,1.0
75,85,200,55,65,30,510,0.16778523489932887,75,90,90,140,90,115,600,0.9481481481481482,1.0
60,45,70,45,90,95,405,0.7304964539007093,20,10,55,15,20,80,200,0.17985611510791366,2.0
70,85,65,105,85,120,530,0.9262295081967213,76,48,48,57,62,34,325,0.11688311688311688,2.0
45,53,70,40,60,42,310,0.25735294117647056,50,50,77,95,77,91,440,0.5916666666666667,0.5
76,147,90,60,70,97,540,0.8267716535433071,91,90,72,90,129,108,580,0.896,1.0
64,165,75,93,83,75,555,0.6587301587301587,85,60,65,135,105,100,550,0.7518248175182481,1.0
85,105,55,85,50,115,495,0.9032258064516129,72,95,67,103,71,122,530,0.9606299212598425,0.5
59,59,58,90,70,73,409,0.5826086956521739,63,63,47,41,41,74,329,0.56,1.0
45,60,45,25,45,55,275,0.29,110,65,75,125,85,30,490,0.15,1.0
150,160,100,95,65,100,670,0.8866666666666667,95,100,85,108,70,70,528,0.5652173913043478,1.0
50,53,48,53,48,64,316,0.4076923076923077,90,60,60,40,40,40,330,0.29545454545454547,2.0
40,50,45,70,45,70,320,0.5517241379310345,78,65,68,112,154,75,552,0.628099173553719,1.0
55,95,115,45,45,35,390,0.2116788321167883,76,147,90,60,70,97,540,0.8267716535433071,1.0
150,160,100,95,65,100,670,0.8866666666666667,80,75,150,75,150,50,580,0.30973451327433627,0.5
80,105,105,105,105,80,580,0.5939849624060151,60,115,105,65,70,80,495,0.7181818181818181,1.0
69,55,45,55,55,15,294,0.11666666666666667,45,55,39,35,39,42,255,0.18518518518518517,1.0
80,45,65,90,110,80,470,0.5462962962962963,74,48,76,83,81,104,466,0.7322834645669292,0.5
70,130,100,55,80,65,500,0.608,80,120,130,55,65,45,495,0.37037037037037035,2.0
75,98,63,98,63,101,498,0.889763779527559,55,81,60,50,70,97,413,0.7214285714285714,1.0
82,121,119,69,59,71,521,0.5394736842105263,60,40,60,40,60,35,295,0.18055555555555555,1.0
106,130,90,110,154,90,680,0.719626168224299,44,50,91,24,86,10,305,0.1981981981981982,4.0
120,70,120,75,130,85,600,0.6694915254237288,70,95,85,55,65,70,440,0.5,0.5
80,120,130,55,65,45,495,0.37037037037037035,72,58,80,103,80,97,490,0.7171052631578947,0.0
65,50,35,115,95,95,455,0.7333333333333333,65,65,45,75,45,95,390,0.72,2.0
100,100,100,100,100,100,600,0.831858407079646,40,40,40,70,40,20,250,0.032520325203252036,1.0
100,50,50,76,96,70,442,0.5,75,75,75,125,95,40,485,0.15671641791044777,1.0
35,70,55,45,55,25,285,0.09420289855072464,50,55,50,36,30,43,264,0.2922077922077922,0.25
43,70,48,50,60,38,309,0.2391304347826087,54,45,47,75,98,52,371,0.39669421487603307,1.0
75,100,63,80,63,116,497,0.9345794392523364,70,85,65,105,85,120,530,0.9262295081967213,0.5
65,90,122,58,75,84,494,0.71875,41,56,40,62,44,71,314,0.568,2.0
70,80,102,80,102,40,474,0.2677165354330709,50,65,107,105,107,86,520,0.703125,0.5
50,53,48,53,48,64,316,0.4076923076923077,50,70,160,70,160,90,600,0.7417218543046358,1.0
55,85,55,50,55,60,360,0.4233576642335766,55,45,45,25,25,15,210,0.048,0.5
100,100,100,100,100,100,600,0.8805970149253731,45,55,39,35,39,42,255,0.18518518518518517,1.0
70,20,50,20,50,40,250,0.1557377049180328,65,90,120,85,70,60,490,0.43410852713178294,0.5
65,76,84,54,96,105,480,0.9008264462809917,70,75,80,135,80,135,575,0.917910447761194,1.0
45,60,40,70,50,45,310,0.2846715328467153,80,145,150,105,110,110,700,0.8692307692307693,2.0
60,50,70,80,80,140,480,0.8449612403100775,45,20,50,60,120,50,345,0.24074074074074073,4.0
84,71,43,71,43,48,360,0.25874125874125875,55,45,50,45,65,80,340,0.5546218487394958,1.0
50,85,55,65,65,90,410,0.7478260869565218,30,45,59,30,39,57,260,0.2803030303030303,2.0
100,150,140,100,90,90,670,0.7969924812030075,70,75,60,105,60,105,475,0.88,2.0
40,45,40,62,60,60,307,0.33884297520661155,82,121,119,69,59,71,521,0.5394736842105263,0.25
170,90,45,90,45,60,500,0.427536231884058,91,72,90,129,90,108,580,0.8620689655172413,0.5
79,105,70,145,80,101,580,0.8608695652173913,58,70,45,40,45,42,300,0.25925925925925924,0.0
54,66,70,44,55,46,335,0.4214876033057851,75,95,122,58,75,69,494,0.5725806451612904,1.0
125,58,58,76,76,67,460,0.515625,55,63,90,50,80,42,380,0.21138211382113822,0.25
45,35,45,62,53,35,275,0.11851851851851852,50,85,125,85,115,20,480,0.4306569343065693,1.0
59,45,40,35,40,31,250,0.14285714285714285,50,85,40,85,40,35,335,0.1746031746031746,1.0
86,76,86,116,56,95,515,0.7982456140350878,160,110,65,65,110,30,540,0.35714285714285715,1.0
90,70,80,70,95,70,475,0.5190839694656488,65,95,100,60,50,50,420,0.34959349593495936,1.0
90,93,55,70,55,55,418,0.3819444444444444,40,50,90,30,55,65,330,0.44680851063829785,0.5
75,103,80,70,80,92,500,0.7933884297520661,70,130,100,55,80,65,500,0.608,0.125
55,75,50,40,40,80,340,0.6302521008403361,80,75,150,75,150,50,580,0.30973451327433627,0.25
65,76,84,54,96,105,480,0.9008264462809917,60,82,45,45,45,74,351,0.5752212389380531,1.0
50,53,48,53,48,64,316,0.358974358974359,75,123,67,95,85,95,540,0.7642276422764228,1.0
30,45,135,45,90,30,375,0.09285714285714286,85,97,66,105,66,65,484,0.47107438016528924,2.0
60,90,140,50,50,40,430,0.2535211267605634,55,112,45,74,45,70,401,0.559322033898305,4.0
95,100,85,108,70,70,528,0.5652173913043478,110,65,105,55,95,80,510,0.6258503401360545,1.0
78,52,60,63,65,23,341,0.06015037593984962,64,88,50,88,50,106,446,0.9111111111111111,2.0
39,52,43,60,50,65,309,0.5041322314049587,75,80,85,110,90,50,490,0.3548387096774194,2.0
60,105,60,120,60,105,510,0.8849557522123894,75,125,75,30,75,85,465,0.625,0.5
70,90,70,60,60,70,420,0.6390977443609023,78,52,60,63,65,23,341,0.06015037593984962,0.5
103,93,67,71,61,84,479,0.7142857142857143,90,110,80,100,80,95,555,0.7982456140350878,1.0
73,100,60,100,60,65,458,0.42657342657342656,100,120,100,150,120,90,680,0.728,1.0
50,55,50,36,30,43,264,0.2922077922077922,45,67,60,35,50,63,320,0.5128205128205128,1.0
95,145,130,120,90,120,700,0.9398496240601504,90,120,75,60,60,45,450,0.29411764705882354,0.0
75,95,95,95,95,85,540,0.6470588235294118,70,45,48,60,65,35,323,0.15748031496062992,0.0
78,92,75,74,63,118,500,0.8842975206611571,64,115,65,83,63,65,455,0.5323741007194245,0.0
67,82,62,46,48,43,348,0.22033898305084745,50,65,85,35,35,55,325,0.32575757575757575,1.0
73,100,60,100,60,65,458,0.42657342657342656,130,85,80,85,95,60,535,0.43884892086330934,1.0
125,120,90,170,100,95,700,0.78125,84,71,43,71,43,48,360,0.25874125874125875,1.0
35,35,40,35,55,50,250,0.40336134453781514,90,65,65,40,40,15,315,0.19672131147540983,2.0
100,134,110,95,100,61,600,0.4057971014492754,50,65,107,105,107,86,520,0.7313432835820896,1.0
50,70,160,70,160,90,600,0.7417218543046358,100,50,80,60,80,50,420,0.34375,1.0
55,95,115,45,45,35,390,0.2116788321167883,78,70,61,50,61,100,420,0.8145161290322581,1.0
65,125,100,60,70,70,490,0.6099290780141844,90,120,75,60,60,45,450,0.29411764705882354,0.25
91,134,95,100,100,80,600,0.6304347826086957,86,81,97,81,107,43,495,0.203125,1.0
65,40,50,125,60,30,370,0.07258064516129033,55,130,115,50,50,75,475,0.5982142857142857,1.0
80,120,80,120,80,100,580,0.8478260869565217,50,65,90,35,35,15,290,0.14678899082568808,1.0
60,70,50,100,50,65,395,0.5217391304347826,60,85,49,60,49,60,363,0.4444444444444444,0.5
85,90,80,70,80,130,535,0.9262295081967213,30,45,135,45,90,30,375,0.09285714285714286,0.25
160,110,65,65,110,30,540,0.35714285714285715,95,109,105,75,85,56,525,0.34513274336283184,1.0
35,35,35,35,35,35,210,0.13385826771653545,40,55,99,40,79,47,360,0.26262626262626265,0.25
75,90,50,110,80,95,500,0.7985611510791367,60,40,60,95,60,55,370,0.4222222222222222,1.0
110,123,65,100,65,65,528,0.5217391304347826,65,90,40,45,80,75,395,0.625,0.5
55,112,45,74,45,70,401,0.559322033898305,105,95,75,85,75,74,509,0.5714285714285714,0.5
104,91,63,91,73,68,490,0.5118110236220472,90,100,70,110,150,80,600,0.6037735849056604,1.0
76,25,45,67,55,24,292,0.0390625,85,110,76,65,82,56,474,0.3933333333333333,1.0
30,30,30,30,30,30,180,0.12612612612612611,40,35,30,20,20,50,195,0.23423423423423423,0.25
70,110,180,60,60,50,530,0.4117647058823529,75,90,140,60,60,40,465,0.3008130081300813,0.5
65,65,65,50,50,90,385,0.72,67,125,40,30,30,58,350,0.3431372549019608,2.0
10,55,25,35,45,95,265,0.5396825396825397,30,45,55,70,55,85,340,0.5633802816901409,1.0
55,20,35,20,45,75,250,0.37681159420289856,46,87,60,30,40,57,320,0.37777777777777777,1.0
70,140,230,60,80,50,630,0.32432432432432434,60,50,50,60,70,50,340,0.28346456692913385,0.5
80,70,70,90,100,70,480,0.5609756097560976,85,56,77,50,77,78,423,0.53125,4.0
80,95,82,60,82,75,474,0.6,110,80,90,95,90,65,530,0.5033557046979866,1.0
85,110,76,65,82,56,474,0.3933333333333333,85,100,122,58,75,54,494,0.3939393939393939,1.0
70,55,55,80,60,45,365,0.2222222222222222,50,65,107,105,107,86,520,0.703125,0.5
65,105,60,60,70,95,455,63.0,50,65,90,35,35,15,290,0.14678899082568808,0.5
65,65,65,50,50,90,385,0.72,90,85,75,115,100,115,580,0.9381443298969072,1.0
80,120,70,110,70,80,530,0.6422764227642277,35,60,44,40,54,55,288,0.366412213740458,0.5
83,80,80,135,80,121,579,0.9444444444444444,60,110,70,60,60,100,460,0.8461538461538461,1.0
85,50,95,120,115,80,545,0.5793650793650794,40,40,50,30,30,30,220,0.0873015873015873,2.0
125,130,90,130,90,95,660,0.7734375,62,48,54,63,60,68,355,0.5178571428571429,1.0
60,90,70,60,120,40,440,0.27419354838709675,90,85,100,95,125,85,580,0.6834532374100719,1.0
70,70,115,130,90,60,535,0.5338983050847458,60,48,45,43,90,42,328,0.21897810218978103,1.0
61,72,57,55,55,65,365,0.3984375,100,50,50,76,96,70,442,0.5,1.0
68,65,65,125,115,80,518,0.6461538461538462,60,50,70,50,90,65,385,0.39568345323741005,1.0
70,75,80,135,80,135,575,0.917910447761194,95,85,85,65,65,35,430,0.2571428571428571,0.0
108,130,95,80,85,102,600,0.7637795275590551,84,86,88,111,101,60,530,0.4634146341463415,1.0
80,160,60,170,130,80,680,0.6180555555555556,50,85,125,85,115,20,480,0.4306569343065693,0.0
69,55,45,55,55,15,294,0.11666666666666667,65,50,70,95,80,65,425,0.4262295081967213,1.0
116,55,85,107,95,29,487,0.06818181818181818,70,120,40,95,40,95,460,0.8106060606060606,0.0
90,90,85,125,90,100,580,0.768595041322314,35,85,45,35,35,75,310,0.6492537313432836,2.0
50,65,107,105,107,86,520,0.7272727272727273,105,130,120,45,45,40,485,0.4444444444444444,0.0
65,90,120,85,70,60,490,0.43410852713178294,60,50,50,60,70,50,340,0.28346456692913385,2.0
50,75,75,65,65,50,380,0.4049586776859504,62,48,54,63,60,68,355,0.5178571428571429,4.0
45,85,70,40,40,60,340,0.5229357798165137,80,120,70,110,70,80,530,0.6422764227642277,0.25
60,130,80,60,60,70,460,0.5153846153846153,55,45,45,25,25,15,210,0.048,4.0
60,50,50,60,70,50,340,0.28346456692913385,60,45,70,75,85,55,390,0.3008130081300813,1.0
50,45,45,35,35,50,260,0.23529411764705882,70,110,75,145,85,145,630,0.9444444444444444,1.0
65,65,60,110,95,130,525,0.9253731343283582,105,105,75,65,100,50,500,0.37593984962406013,1.0
55,65,35,60,30,85,330,0.6126126126126126,58,70,45,40,45,42,300,0.25925925925925924,1.0
45,60,40,70,50,45,310,0.2846715328467153,55,47,52,40,40,41,275,0.16806722689075632,1.0
70,83,50,37,50,60,350,0.3360655737704918,50,75,35,70,30,40,300,0.21296296296296297,2.0
57,24,86,24,86,23,300,0.12727272727272726,45,50,45,115,55,95,405,0.6936936936936937,2.0
50,65,107,105,107,86,520,0.7758620689655172,95,75,180,130,80,30,590,0.13793103448275862,1.0
53,54,53,37,46,45,288,0.3090909090909091,80,105,65,60,75,130,515,0.9645390070921985,1.0
69,55,45,55,55,15,294,0.11666666666666667,91,90,72,90,129,108,580,0.896,1.0
60,65,60,130,75,110,500,0.7719298245614035,60,80,110,50,80,45,425,0.2833333333333333,0.5
35,60,44,40,54,55,288,0.366412213740458,62,44,50,44,50,55,305,0.3629032258064516,1.0
78,81,71,74,69,126,499,0.9090909090909091,70,50,30,95,135,105,485,0.8040540540540541,2.0
55,55,45,63,45,45,308,0.25,125,58,58,76,76,67,460,0.515625,0.5
50,60,45,100,80,65,400,0.45689655172413796,78,70,61,50,61,100,420,0.8145161290322581,1.0
255,10,10,75,135,55,540,0.3125,80,160,80,130,80,100,630,0.8455284552845529,1.0
80,70,70,90,100,70,480,0.5609756097560976,55,66,44,44,56,85,350,0.6888888888888889,1.0
50,53,48,53,48,64,316,0.358974358974359,130,85,80,85,95,60,535,0.43884892086330934,0.5
46,87,60,30,40,57,320,0.37777777777777777,50,180,20,180,20,150,600,0.9029850746268657,1.0
55,40,50,65,85,40,335,0.3181818181818182,40,27,60,37,50,66,280,0.36220472440944884,0.5
54,63,52,83,56,97,405,0.7697841726618705,69,55,45,55,55,15,294,0.11666666666666667,0.5
70,50,30,95,135,105,485,0.8040540540540541,50,30,55,65,55,20,275,0.13675213675213677,0.5
40,40,50,30,30,30,220,0.0873015873015873,35,55,40,50,50,90,320,0.6838235294117647,1.0
105,105,75,65,100,50,500,0.37593984962406013,70,75,60,105,60,105,475,0.88,1.0
75,80,85,110,90,50,490,0.3548387096774194,56,61,65,48,45,38,313,0.17567567567567569,1.0
70,62,67,55,55,56,365,0.38513513513513514,70,43,53,43,53,40,302,0.19090909090909092,0.5
55,40,50,65,85,40,335,0.3181818181818182,91,72,90,129,90,108,580,0.8925619834710744,0.5
75,123,67,95,85,95,540,0.7642276422764228,75,90,50,110,80,95,500,0.7985611510791367,1.0
100,100,100,100,100,100,600,0.8345864661654135,75,125,100,70,80,45,495,0.33035714285714285,1.0
80,80,90,110,130,110,600,0.8721804511278195,45,63,37,65,55,95,360,0.8055555555555556,1.0
72,58,80,103,80,97,490,0.7171052631578947,95,75,110,100,80,30,490,0.15267175572519084,0.5
70,80,102,80,102,40,474,0.2677165354330709,70,90,90,135,90,125,600,0.9401709401709402,2.0
40,30,35,45,40,55,245,0.31496062992125984,100,73,83,73,83,55,467,0.371900826446281,1.0
45,60,40,70,50,45,310,0.2846715328467153,86,68,72,109,66,106,507,0.8099173553719008,0.5
50,50,150,50,150,50,500,0.2571428571428571,65,45,55,45,70,45,325,0.24369747899159663,1.0
45,49,49,65,65,45,318,0.2781954887218045,40,30,30,55,30,85,270,0.4666666666666667,1.0
75,80,60,65,90,102,472,0.8625954198473282,66,65,48,62,57,52,350,0.36220472440944884,1.0
70,90,70,60,60,70,420,0.6390977443609023,40,55,30,30,30,85,270,0.688,1.0
60,95,80,60,80,30,405,0.19480519480519481,50,105,125,55,95,50,480,0.375886524822695,0.125
50,50,120,80,80,30,410,0.07258064516129033,30,80,90,55,45,55,355,0.4295774647887324,0.25
60,70,105,70,120,75,500,0.5983606557377049,88,107,122,74,75,64,530,0.4596774193548387,0.5
75,80,85,110,90,50,490,0.3548387096774194,35,45,160,30,45,70,385,0.48148148148148145,1.0
100,73,83,73,83,55,467,0.371900826446281,85,80,70,135,75,90,535,0.7006802721088435,1.0
60,60,60,35,35,30,280,0.11194029850746269,80,130,100,160,120,110,700,0.8981481481481481,1.0
59,63,80,65,80,58,405,0.41843971631205673,75,75,75,125,95,40,485,0.15671641791044777,1.0
77,59,50,67,63,46,362,0.23140495867768596,75,80,85,110,90,50,490,0.3548387096774194,2.0
75,85,200,55,65,30,510,0.16778523489932887,64,51,23,51,23,28,240,0.11363636363636363,1.0
79,105,70,145,80,101,580,0.8608695652173913,50,65,107,105,107,86,520,0.7758620689655172,0.5
109,66,84,81,99,32,471,0.2013888888888889,123,77,72,99,92,58,521,0.4621212121212121,2.0
80,120,79,95,79,70,523,0.5833333333333334,70,140,230,60,80,50,630,0.32432432432432434,1.0
40,40,40,70,40,20,250,0.032520325203252036,60,85,60,85,60,55,405,0.3673469387755102,0.5
111,83,68,92,82,39,475,0.1774193548387097,44,38,33,61,43,70,289,0.5267857142857143,2.0
45,65,34,40,34,45,263,0.2589928057553957,60,110,70,60,60,100,460,0.8461538461538461,2.0
126,131,95,131,98,99,680,0.8102189781021898,100,103,75,120,75,127,600,0.940677966101695,2.0
55,130,115,50,50,75,475,0.5982142857142857,45,65,34,40,34,45,263,0.2589928057553957,1.0
60,115,105,65,70,80,495,0.7181818181818181,43,30,55,40,65,97,330,0.6030534351145038,0.5
62,73,55,56,52,84,382,0.7244094488188977,43,30,55,40,65,97,330,0.6030534351145038,0.5
60,62,63,80,80,60,405,0.38016528925619836,60,52,168,47,138,30,495,0.19834710743801653,0.0
75,69,72,114,100,104,534,0.8253968253968254,80,82,100,83,100,80,525,0.6821705426356589,2.0
40,40,50,30,30,30,220,0.0873015873015873,35,70,55,45,55,25,285,0.09420289855072464,0.25
30,45,55,70,55,85,340,0.5633802816901409,30,35,30,100,35,80,310,0.4765625,1.0
45,60,30,80,50,65,330,0.4603174603174603,80,130,100,160,120,110,700,0.8981481481481481,1.0
35,35,35,35,35,35,210,0.13385826771653545,54,66,70,44,55,46,335,0.4214876033057851,0.0
40,30,35,45,40,55,245,0.31496062992125984,60,85,40,30,45,68,328,0.6422018348623854,1.0
65,80,65,35,65,60,370,0.38405797101449274,150,120,100,120,100,90,680,0.664179104477612,0.0
59,63,80,65,80,58,405,0.41843971631205673,48,61,40,61,40,50,300,0.2543859649122807,1.0
91,90,129,90,72,108,580,0.9140625,75,125,70,125,70,115,580,0.9037037037037037,0.5
40,60,30,31,31,70,262,0.4492753623188406,50,180,20,180,20,150,600,0.9029850746268657,1.0
70,62,67,55,55,56,365,0.38513513513513514,45,63,37,65,55,95,360,0.8055555555555556,1.0
45,50,43,40,38,62,278,0.40441176470588236,110,135,60,50,65,88,508,0.7744360902255639,0.25
55,55,85,65,85,35,380,0.2014388489208633,60,115,105,65,70,80,495,0.7181818181818181,1.0
59,59,58,90,70,73,409,0.5826086956521739,76,104,71,104,71,108,534,0.912751677852349,0.5
55,20,35,20,45,75,250,0.37681159420289856,90,92,75,92,85,60,494,0.49586776859504134,1.0
50,75,70,35,70,48,348,0.29357798165137616,44,38,39,61,79,42,303,0.2251655629139073,0.25
37,25,41,25,41,25,194,0.08870967741935484,55,55,50,45,65,55,325,0.37373737373737376,1.0
74,94,131,54,116,20,489,0.4485294117647059,65,73,55,47,75,85,400,0.6846846846846847,0.5
110,130,80,70,60,80,530,0.5862068965517241,105,125,100,60,100,100,590,0.8359375,1.0
90,120,100,150,120,100,680,0.7718120805369127,50,95,180,85,45,70,525,0.5298507462686567,0.5
90,50,34,60,44,70,348,0.6283185840707964,100,100,100,100,100,100,600,0.8805970149253731,1.0
65,95,100,60,50,50,420,0.34959349593495936,60,85,69,65,79,80,438,0.576,1.0
45,30,40,105,50,20,290,0.031007751937984496,55,70,45,70,50,60,350,0.45,1.0
80,70,65,80,120,100,515,0.8034188034188035,20,40,15,35,35,60,205,0.34285714285714286,1.0
108,100,121,81,95,95,600,0.7476635514018691,50,85,40,85,40,35,335,0.1746031746031746,0.5
105,125,100,60,100,100,590,0.8359375,70,75,80,135,80,135,575,0.917910447761194,1.0
80,82,100,83,100,80,525,0.6821705426356589,95,75,110,100,80,30,490,0.15267175572519084,2.0
65,75,105,35,65,85,430,0.6940298507462687,116,55,85,107,95,29,487,0.06818181818181818,1.0
84,71,43,71,43,48,360,0.25874125874125875,55,66,44,44,56,85,350,0.6888888888888889,1.0
60,55,90,145,90,80,520,0.6071428571428571,105,150,90,150,90,95,680,0.8285714285714286,0.5
125,58,58,76,76,67,460,0.515625,50,40,85,40,65,25,305,0.08870967741935484,1.0
75,95,95,95,95,85,540,0.6470588235294118,50,50,62,40,62,65,329,0.4188034188034188,1.0
85,105,55,85,50,115,495,0.9032258064516129,70,60,75,110,75,90,480,0.7165354330708661,0.5
66,41,77,61,87,23,355,0.12096774193548387,50,160,110,160,110,110,700,0.8854961832061069,2.0
65,75,90,97,123,44,494,0.1987179487179487,86,81,97,81,107,43,495,0.203125,1.0
55,45,43,55,43,72,313,0.5853658536585366,65,60,70,85,75,40,395,0.1796875,1.0
55,50,45,135,95,120,500,0.7714285714285715,50,72,35,35,35,65,292,0.5373134328358209,0.0
44,50,91,24,86,10,305,0.1981981981981982,65,76,84,54,96,105,480,0.9008264462809917,1.0
60,45,70,75,85,55,390,0.3008130081300813,80,80,80,80,80,80,480,0.5606060606060606,1.0
111,83,68,92,82,39,475,0.1774193548387097,125,120,90,170,100,95,700,0.78125,0.5
50,160,110,160,110,110,700,0.8854961832061069,35,55,35,30,30,35,220,0.23684210526315788,2.0
50,50,40,50,40,64,294,0.45588235294117646,90,70,80,70,95,70,475,0.5190839694656488,0.5
44,50,91,24,86,10,305,0.1981981981981982,85,100,122,58,75,54,494,0.3939393939393939,0.5
75,80,85,110,90,50,490,0.3548387096774194,50,95,180,85,45,70,525,0.5298507462686567,2.0
80,50,100,100,200,50,580,0.2357142857142857,42,52,67,39,56,50,306,0.2868217054263566,0.5
45,67,60,35,50,63,320,0.5128205128205128,59,66,70,44,55,41,335,0.25190839694656486,0.5
40,70,130,60,130,25,455,0.17355371900826447,150,120,100,120,100,90,680,0.664179104477612,2.0
126,131,95,131,98,99,680,0.8294573643410853,52,65,55,58,62,60,352,0.4482758620689655,1.0
90,85,100,95,125,85,580,0.6834532374100719,55,85,122,58,75,99,494,0.8099173553719008,4.0
116,55,85,107,95,29,487,0.06818181818181818,55,65,35,60,30,85,330,0.6126126126126126,1.0
68,165,95,65,115,110,618,0.8615384615384616,50,85,55,65,65,90,410,0.7478260869565218,1.0
50,20,55,25,25,30,205,0.09774436090225563,65,90,65,61,61,100,442,0.8373983739837398,0.5
65,65,60,130,95,110,525,0.823943661971831,60,85,42,85,42,91,405,0.8227848101265823,0.0
30,45,55,70,55,85,340,0.5633802816901409,74,94,131,54,116,20,489,0.4485294117647059,0.5
45,95,50,40,50,75,355,0.54,55,85,122,58,75,99,494,0.8099173553719008,1.0
95,135,80,110,80,100,600,0.8248175182481752,85,105,100,79,83,78,530,0.5869565217391305,1.0
30,40,55,40,55,60,280,0.3237410071942446,20,40,15,35,35,60,205,0.34285714285714286,1.0
80,100,70,50,60,45,405,0.25806451612903225,35,70,55,45,55,25,285,0.09420289855072464,0.5
30,80,90,55,45,55,355,0.4295774647887324,70,95,85,55,65,70,440,0.5,2.0
55,70,55,40,55,85,360,0.7073170731707317,45,30,35,20,20,45,195,0.14782608695652175,1.0
50,60,60,60,60,30,320,0.11290322580645161,35,45,160,30,45,70,385,0.48148148148148145,1.0
50,50,150,50,150,50,500,0.2571428571428571,70,50,30,95,135,105,485,0.8040540540540541,2.0
41,50,37,50,37,66,281,0.5175438596491229,60,40,50,75,85,95,405,0.6044776119402985,1.0
77,85,51,55,51,65,384,0.5163934426229508,90,120,75,60,60,45,450,0.29411764705882354,0.5
45,90,20,65,20,65,305,0.5116279069767442,70,95,85,55,65,70,440,0.5,4.0
105,180,100,180,100,115,780,0.9477611940298507,31,45,90,30,30,40,266,0.21929824561403508,2.0
35,70,55,45,55,25,285,0.09420289855072464,50,72,35,35,35,65,292,0.5373134328358209,4.0
70,115,60,115,60,55,475,0.4647887323943662,50,20,55,25,25,30,205,0.09774436090225563,0.5
115,115,85,90,75,100,580,0.8134328358208955,55,75,50,40,40,80,340,0.6302521008403361,1.0
75,80,95,90,100,50,490,0.2158273381294964,80,52,50,90,50,89,411,0.6666666666666666,0.25
60,60,40,65,45,35,305,0.15833333333333333,65,150,40,15,80,145,495,0.9663865546218487,2.0
55,47,52,40,40,41,275,0.16806722689075632,40,45,35,40,40,90,290,0.65,1.0
75,80,95,90,100,50,490,0.2158273381294964,82,80,86,85,75,72,480,0.6183206106870229,1.0
100,120,120,150,100,90,680,0.7880794701986755,40,55,70,45,60,30,300,0.10619469026548672,0.25
35,64,85,74,55,32,345,0.19827586206896552,100,50,50,76,96,70,442,0.5,1.0
55,45,43,55,43,72,313,0.5853658536585366,95,124,78,69,71,58,495,0.37398373983739835,0.0
90,85,100,95,125,85,580,0.6834532374100719,60,85,69,60,69,77,420,0.518796992481203,1.0
70,100,115,30,65,30,410,0.24390243902439024,60,55,90,145,90,80,520,0.6071428571428571,2.0
60,85,60,50,50,125,430,0.9090909090909091,60,80,95,70,85,50,440,0.2231404958677686,0.25
100,50,80,60,80,50,420,0.34375,50,80,95,10,45,10,290,0.232,2.0
35,64,85,74,55,32,345,0.19827586206896552,60,45,50,90,80,70,395,0.625,1.0
75,65,55,65,55,69,384,0.43548387096774194,80,100,70,60,70,95,475,0.7416666666666667,0.25
55,70,45,70,50,60,350,0.45,75,100,63,80,63,116,497,0.9345794392523364,1.0
60,105,60,120,60,105,510,0.8849557522123894,72,58,80,103,80,97,490,0.7171052631578947,2.0
71,73,88,120,89,59,500,0.43537414965986393,70,90,110,60,75,95,500,0.7333333333333333,1.0
38,35,35,65,55,50,278,0.2647058823529412,95,75,80,100,110,30,490,0.24242424242424243,0.5
90,132,105,132,105,30,594,0.4246575342465753,60,30,30,36,56,50,262,0.32432432432432434,1.0
60,100,85,80,85,100,510,0.7007874015748031,80,120,80,120,80,100,580,0.8478260869565217,2.0
65,80,65,35,65,60,370,0.38405797101449274,60,130,80,60,60,70,460,0.5153846153846153,1.0
70,90,45,15,45,50,315,0.3629032258064516,60,115,105,65,70,80,495,0.7181818181818181,0.25
53,51,53,61,56,40,314,0.14285714285714285,45,40,60,40,75,50,310,0.2926829268292683,1.0
40,60,30,31,31,70,262,0.4492753623188406,70,70,40,60,40,60,340,0.4247787610619469,2.0
50,40,85,40,65,25,305,0.08870967741935484,80,80,80,80,80,80,480,0.6015037593984962,1.0
60,50,100,85,70,65,430,0.47580645161290325,78,84,78,109,85,100,534,0.8646616541353384,2.0
111,83,68,92,82,39,475,0.1774193548387097,71,82,64,64,59,112,452,0.9327731092436975,1.0
71,120,95,120,95,99,600,0.8203125,45,95,50,40,50,75,355,0.54,2.0
75,110,110,110,105,80,590,0.656934306569343,70,50,30,95,135,105,485,0.8040540540540541,1.0
75,140,65,112,65,110,567,0.9140625,44,48,65,50,64,43,314,0.1623931623931624,1.0
60,55,90,145,90,80,520,0.6071428571428571,50,40,85,40,65,25,305,0.08870967741935484,2.0
75,98,63,98,63,101,498,0.889763779527559,50,60,60,60,60,30,320,0.11290322580645161,0.5
60,25,35,70,80,60,330,0.3076923076923077,65,90,115,45,115,58,488,0.5041322314049587,0.0
105,30,105,140,105,55,540,0.3524590163934426,66,41,77,61,87,23,355,0.12096774193548387,1.0
60,45,70,75,85,55,390,0.3008130081300813,79,115,70,125,80,111,580,0.864,1.0
115,45,20,45,25,20,270,0.11538461538461539,65,60,70,85,75,40,395,0.1796875,1.0
100,180,160,150,90,90,770,0.7520661157024794,70,70,115,130,90,60,535,0.5338983050847458,8.0
105,95,75,85,75,74,509,0.5714285714285714,95,70,73,95,90,60,483,0.3983739837398374,1.0
65,73,55,47,75,85,400,0.6846846846846847,71,120,95,120,95,99,600,0.8203125,0.5
95,110,95,40,95,55,490,0.40336134453781514,80,110,120,130,90,70,600,0.6198347107438017,1.0
64,66,68,81,76,50,405,0.25190839694656486,65,125,100,60,70,70,490,0.6099290780141844,1.0
60,62,80,63,80,60,405,0.4336283185840708,65,63,45,45,45,45,308,0.2595419847328244,0.5
63,120,85,90,55,55,468,0.2809917355371901,90,120,75,60,60,45,450,0.29411764705882354,0.5
75,125,75,30,75,85,465,0.625,20,40,90,30,90,25,295,0.11363636363636363,0.0
100,70,70,65,65,45,415,0.1897810218978102,76,104,71,104,71,108,534,0.912751677852349,1.0
150,160,100,95,65,100,670,0.8866666666666667,85,135,130,60,80,25,515,0.40540540540540543,0.5
50,53,48,53,48,64,316,0.46153846153846156,59,59,58,90,70,73,409,0.5826086956521739,0.5
65,65,60,130,95,110,525,0.823943661971831,60,70,65,125,105,90,515,0.6911764705882353,2.0
77,120,90,60,90,48,485,0.2785714285714286,80,105,65,60,75,130,515,0.9645390070921985,1.0
100,100,100,100,100,100,600,0.8778625954198473,50,75,45,40,45,60,315,0.4380165289256198,2.0
60,50,70,80,80,140,480,0.8449612403100775,78,104,78,159,115,100,634,0.8444444444444444,2.0
65,40,50,125,60,30,370,0.07258064516129033,54,78,103,53,45,22,355,0.23255813953488372,1.0
40,30,30,40,50,30,220,0.07936507936507936,76,48,48,57,62,34,325,0.11688311688311688,1.0
60,60,60,85,85,85,435,0.631578947368421,70,150,140,65,100,75,600,0.55,1.0
100,150,90,180,160,90,770,0.7348484848484849,91,90,129,90,72,108,580,0.9140625,1.0
100,100,80,60,60,50,450,0.3050847457627119,65,65,45,75,45,95,390,0.72,0.0
85,135,130,60,80,25,515,0.40540540540540543,85,120,70,50,60,100,485,0.8308823529411765,2.0
78,84,78,109,85,100,534,0.8620689655172413,60,85,69,60,69,77,420,0.518796992481203,1.0
64,78,52,78,52,81,405,0.6422764227642277,50,105,79,35,110,76,455,0.6214285714285714,1.0
45,85,50,55,50,65,350,0.5076923076923077,125,120,90,170,100,95,700,0.78125,2.0
50,60,45,100,80,65,400,0.45689655172413796,67,125,40,30,30,58,350,0.3431372549019608,1.0
68,165,95,65,115,110,618,0.8615384615384616,60,65,70,85,75,40,395,0.21705426356589147,1.0
85,110,76,65,82,56,474,0.3933333333333333,30,105,90,25,25,50,325,0.2773722627737226,2.0
50,65,107,105,107,86,520,0.7313432835820896,40,45,35,30,40,55,245,0.3793103448275862,0.5
60,40,60,40,60,35,295,0.18055555555555555,60,62,63,80,80,60,405,0.38016528925619836,0.25
70,120,100,145,105,20,560,0.2824427480916031,80,80,80,80,80,80,480,0.5606060606060606,0.5
75,90,140,60,60,40,465,0.3008130081300813,70,62,67,55,55,56,365,0.38513513513513514,0.5
40,45,35,40,40,90,290,0.65,100,100,100,100,100,100,600,0.8602941176470589,1.0
40,20,30,40,80,55,265,0.22764227642276422,79,115,70,125,80,111,580,0.864,0.25
74,48,76,83,81,104,466,0.7322834645669292,85,73,70,73,115,67,483,0.5126050420168067,0.5
43,30,55,40,65,97,330,0.6030534351145038,54,63,52,83,56,97,405,0.7697841726618705,0.5
100,77,77,128,128,90,600,0.6901408450704225,70,75,60,105,60,105,475,0.88,1.0
50,120,53,35,110,87,455,0.640625,10,55,25,35,45,95,265,0.5396825396825397,1.0
60,85,40,30,45,68,328,0.6422018348623854,60,75,100,55,80,50,420,0.3088235294117647,2.0
78,104,78,159,115,100,634,0.8444444444444444,72,60,30,20,30,25,237,0.11570247933884298,2.0
80,80,90,110,130,110,600,0.8721804511278195,75,140,65,112,65,110,567,0.9140625,1.0
40,55,70,45,60,30,300,0.10619469026548672,60,70,65,125,105,90,515,0.6911764705882353,1.0
50,70,100,40,40,30,330,0.2222222222222222,71,73,88,120,89,59,500,0.43537414965986393,0.5
70,70,40,60,40,60,340,0.4247787610619469,60,85,60,85,60,55,405,0.3673469387755102,0.25
70,83,50,37,50,60,350,0.3360655737704918,80,105,65,60,75,130,515,0.9645390070921985,0.25
70,85,65,105,85,120,530,0.9262295081967213,40,65,95,60,45,35,340,0.13986013986013987,0.5
126,131,95,131,98,99,680,0.8294573643410853,50,95,90,95,90,180,600,0.9172413793103448,1.0
50,105,79,35,110,76,455,0.6214285714285714,55,75,60,75,60,103,428,0.7982456140350878,0.5
35,65,35,65,35,65,300,0.46621621621621623,30,35,30,100,35,80,310,0.4765625,1.0
65,76,84,54,96,105,480,0.9008264462809917,56,61,65,48,45,38,313,0.17567567567567569,1.0
105,150,90,150,90,95,680,0.8285714285714286,80,120,130,55,65,45,495,0.37037037037037035,0.5
63,60,55,50,50,71,349,0.5289256198347108,45,55,45,65,45,75,330,0.5692307692307692,1.0
55,70,40,60,40,40,305,0.26956521739130435,90,100,90,125,85,90,580,0.7352941176470589,1.0
59,110,150,45,49,35,448,0.3333333333333333,39,52,43,60,50,65,309,0.5041322314049587,0.5
31,45,90,30,30,40,266,0.21929824561403508,73,95,62,85,65,85,465,0.6666666666666666,1.0
80,120,130,55,65,45,495,0.37037037037037035,45,35,50,70,50,30,280,0.15753424657534246,0.5
60,45,70,75,85,55,390,0.3008130081300813,65,50,70,95,80,65,425,0.4262295081967213,0.5
100,110,90,85,90,60,535,0.47794117647058826,75,75,60,83,60,60,413,0.39344262295081966,0.5
70,80,70,80,70,110,480,0.6594202898550725,30,30,30,30,30,30,180,0.12612612612612611,2.0
80,75,150,75,150,50,580,0.30973451327433627,95,110,95,40,95,55,490,0.40336134453781514,1.0
55,130,115,50,50,75,475,0.5982142857142857,85,110,76,65,82,56,474,0.3933333333333333,0.5
70,84,70,65,70,51,410,0.2949640287769784,60,55,50,40,55,45,305,0.22377622377622378,2.0
90,65,65,40,40,15,315,0.19672131147540983,45,53,70,40,60,42,310,0.25735294117647056,0.5
40,50,45,70,45,70,320,0.5517241379310345,40,65,95,60,45,35,340,0.13986013986013987,2.0
75,90,50,110,80,95,500,0.7985611510791367,73,115,60,60,60,90,458,0.6694915254237288,1.0
45,95,50,40,50,75,355,0.54,50,85,55,65,65,90,410,0.7478260869565218,1.0
160,110,65,65,110,30,540,0.35714285714285715,40,45,65,100,120,90,460,0.5588235294117647,1.0
70,55,55,80,60,45,365,0.2222222222222222,60,69,95,69,95,36,424,0.2608695652173913,1.0
60,40,60,40,60,35,295,0.18055555555555555,50,70,100,40,40,30,330,0.2222222222222222,1.0
100,150,120,120,100,90,680,0.6493506493506493,50,50,62,40,62,65,329,0.4188034188034188,1.0
35,45,160,30,45,70,385,0.48148148148148145,60,105,60,120,60,105,510,0.8849557522123894,1.0
30,45,59,30,39,57,260,0.2803030303030303,100,150,90,180,160,90,770,0.7348484848484849,1.0
60,59,85,79,105,36,424,0.16666666666666666,70,40,50,55,50,25,290,0.061068702290076333,2.0
55,40,85,80,105,40,405,0.23622047244094488,60,80,50,40,40,30,300,0.15328467153284672,1.0
72,105,115,54,86,68,500,0.5149253731343284,109,66,84,81,99,32,471,0.2013888888888889,1.0
85,105,85,40,50,40,405,0.211864406779661,100,164,150,95,120,71,700,0.5645161290322581,4.0
60,40,50,75,85,95,405,0.6044776119402985,74,100,72,90,72,46,454,0.24561403508771928,0.5
50,35,55,25,25,15,205,0.021739130434782608,105,150,90,150,90,95,680,0.8285714285714286,0.5
50,65,64,44,48,43,314,0.2196969696969697,35,35,40,35,55,50,250,0.40336134453781514,0.5
80,82,83,100,100,80,525,0.6742424242424242,105,105,75,65,100,50,500,0.37593984962406013,0.25
80,145,150,105,110,110,700,0.8692307692307693,78,104,78,159,115,100,634,0.8444444444444444,0.5
71,82,64,64,59,112,452,0.9327731092436975,55,55,85,65,85,35,380,0.2014388489208633,0.5
40,30,35,45,40,55,245,0.31496062992125984,45,35,50,70,50,30,280,0.15753424657534246,2.0
40,45,35,30,40,55,245,0.3793103448275862,40,40,40,70,40,20,250,0.032520325203252036,1.0
55,40,50,65,85,40,335,0.3181818181818182,125,120,90,170,100,95,700,0.78125,0.5
38,36,38,32,36,57,237,0.3893805309734513,30,65,100,45,25,40,305,0.1891891891891892,1.0
65,75,90,97,123,44,494,0.1987179487179487,50,35,55,25,25,15,205,0.021739130434782608,1.0
70,150,140,65,100,75,600,0.55,35,65,35,65,35,65,300,0.46621621621621623,0.5
60,150,50,150,50,60,520,0.5,61,84,65,70,70,70,420,0.5,1.0
70,60,125,115,70,55,495,0.35507246376811596,65,76,84,54,96,105,480,0.9008264462809917,1.0
58,64,58,80,65,80,405,0.5423728813559322,55,75,60,75,60,103,428,0.7982456140350878,1.0
89,124,80,55,80,55,483,0.5714285714285714,50,48,43,46,41,60,288,0.47297297297297297,1.0
60,80,110,50,80,45,425,0.2833333333333333,71,95,85,110,95,79,535,0.664,1.0
40,30,32,50,52,65,269,0.3671875,60,50,70,80,80,140,480,0.8449612403100775,1.0
70,115,60,115,60,55,475,0.4647887323943662,70,20,50,20,50,40,250,0.1557377049180328,1.0
100,100,100,100,100,100,600,0.8805970149253731,90,100,90,125,85,90,580,0.7352941176470589,2.0
40,55,99,40,79,47,360,0.26262626262626265,65,60,70,85,75,40,395,0.1796875,1.0
60,55,90,145,90,80,520,0.6071428571428571,95,95,85,125,65,55,520,0.3894736842105263,4.0
65,90,115,45,115,58,488,0.5041322314049587,110,135,60,50,65,88,508,0.7744360902255639,2.0
50,50,77,95,77,91,440,0.5916666666666667,60,55,145,75,150,40,525,0.2,1.0
50,65,90,35,35,15,290,0.14678899082568808,65,73,55,47,75,85,400,0.6846846846846847,1.0
50,53,62,58,63,44,330,0.13709677419354838,77,85,51,55,51,65,384,0.5163934426229508,1.0
45,35,45,62,53,35,275,0.11851851851851852,67,58,57,81,67,101,431,0.8790322580645161,1.0
50,53,48,53,48,64,316,0.46153846153846156,54,45,47,75,98,52,371,0.39669421487603307,1.0
50,65,107,105,107,86,520,0.6991150442477876,150,120,100,120,100,90,680,0.664179104477612,0.25
123,100,62,97,81,68,531,0.4806201550387597,38,35,35,65,55,50,278,0.2647058823529412,1.0
55,40,40,65,45,35,280,0.16428571428571428,65,70,60,65,65,115,440,0.8583333333333333,1.0
100,100,100,100,100,100,600,0.8778625954198473,70,55,95,95,110,65,490,0.48872180451127817,0.5
60,105,60,120,60,105,510,0.8849557522123894,70,85,65,105,85,120,530,0.9262295081967213,1.0
85,115,80,105,80,50,515,0.3063063063063063,60,62,50,62,60,40,334,0.18181818181818182,0.5
100,100,100,100,100,100,600,0.8345864661654135,60,50,50,60,70,50,340,0.28346456692913385,1.0
75,55,70,55,95,110,460,0.8444444444444444,100,73,83,73,83,55,467,0.371900826446281,0.5
90,100,70,110,150,80,600,0.6037735849056604,95,65,110,60,130,65,525,0.5275590551181102,1.0
65,90,40,45,80,75,395,0.625,45,60,40,70,50,45,310,0.2846715328467153,0.5
50,47,50,57,50,65,319,0.463768115942029,50,50,95,40,50,35,320,0.20279720279720279,0.0
61,90,45,50,50,160,456,0.9230769230769231,70,140,70,110,65,105,560,0.95,2.0
55,55,45,63,45,45,308,0.25,75,95,125,45,75,95,510,0.8257575757575758,2.0
110,78,73,76,71,60,468,0.3333333333333333,80,80,80,80,80,80,480,0.5606060606060606,0.5
90,95,105,165,110,45,610,0.2890625,38,30,85,55,65,30,303,0.21428571428571427,1.0
70,65,65,55,55,70,380,0.5,49,55,42,42,37,85,310,0.6068376068376068,1.0
70,75,80,135,80,135,575,0.917910447761194,68,75,53,83,113,60,452,0.45384615384615384,0.5
95,145,130,120,90,120,700,0.9398496240601504,60,85,60,85,60,55,405,0.3673469387755102,2.0
75,125,75,30,75,85,465,0.625,70,85,70,60,70,50,405,0.28378378378378377,1.0
55,70,55,40,55,85,360,0.7073170731707317,50,95,180,85,45,70,525,0.5298507462686567,1.0
35,45,160,30,45,70,385,0.48148148148148145,100,70,70,65,65,45,415,0.1897810218978102,1.0
55,81,60,50,70,97,413,0.7214285714285714,45,63,37,65,55,95,360,0.8055555555555556,1.0
65,83,57,95,85,105,490,0.8914728682170543,80,80,80,55,55,90,440,0.6417910447761194,1.0
70,85,140,85,70,20,470,0.272,80,100,70,50,60,45,405,0.25806451612903225,1.0
95,110,80,70,80,50,485,0.37209302325581395,50,75,45,40,45,60,315,0.4380165289256198,1.0
70,83,50,37,50,60,350,0.3360655737704918,60,80,50,50,50,40,330,0.23853211009174313,1.0
60,60,60,85,85,85,435,0.631578947368421,83,106,65,86,65,85,490,0.6640625,1.0
41,50,37,50,37,66,281,0.5175438596491229,75,90,140,60,60,40,465,0.3008130081300813,1.0
80,120,79,95,79,70,523,0.5833333333333334,106,90,130,90,154,110,680,0.8699186991869918,2.0
65,63,45,45,45,45,308,0.2595419847328244,65,90,65,61,61,100,442,0.8373983739837398,1.0
80,120,79,95,79,70,523,0.5833333333333334,65,50,70,95,80,65,425,0.4262295081967213,1.0
80,95,82,60,82,75,474,0.6,35,55,40,45,40,60,275,0.35714285714285715,1.0
57,24,86,24,86,23,300,0.12727272727272726,30,42,118,42,88,30,350,0.112,0.5
55,84,105,114,75,52,485,0.2890625,50,92,108,92,108,35,485,0.2457627118644068,1.0
55,85,55,50,55,60,360,0.4233576642335766,95,110,95,40,95,55,490,0.40336134453781514,1.0
50,95,180,85,45,70,525,0.5298507462686567,35,20,65,40,65,20,245,0.02459016393442623,1.0
44,38,39,61,79,42,303,0.2251655629139073,75,95,122,58,75,69,494,0.5725806451612904,1.0
53,54,53,37,46,45,288,0.3090909090909091,100,150,110,95,110,70,635,0.5923076923076923,2.0
100,100,100,100,100,100,600,0.8758169934640523,30,40,55,40,55,60,280,0.3237410071942446,0.5
60,75,100,55,80,50,420,0.3088235294117647,62,48,54,63,60,68,355,0.5178571428571429,0.5
74,94,131,54,116,20,489,0.4485294117647059,55,104,105,94,75,52,485,0.36363636363636365,1.0
65,95,57,100,85,93,495,0.7441860465116279,45,75,60,40,30,50,300,0.304,0.5
60,50,100,85,70,65,430,0.47580645161290325,44,58,44,58,44,61,309,0.41964285714285715,2.0
90,120,100,150,120,100,680,0.7718120805369127,95,155,109,70,130,81,640,0.6788321167883211,0.5
72,58,80,103,80,97,490,0.7171052631578947,255,10,10,75,135,55,540,0.3125,1.0
70,95,125,65,75,45,475,0.33613445378151263,78,65,68,112,154,75,552,0.628099173553719,0.5
65,125,100,60,70,70,490,0.6099290780141844,79,115,70,125,80,111,580,0.8468468468468469,1.0
61,72,57,55,55,65,365,0.3984375,40,30,30,55,30,85,270,0.4666666666666667,1.0
44,50,91,24,86,10,305,0.1981981981981982,100,150,90,180,160,90,770,0.7348484848484849,1.0
80,125,75,40,95,85,500,0.6911764705882353,90,92,87,75,85,76,505,0.5409836065573771,0.25
90,100,60,90,60,80,480,0.6422764227642277,100,100,80,60,60,50,450,0.3050847457627119,2.0
65,85,70,75,70,40,405,0.203125,60,80,110,50,80,45,425,0.2833333333333333,0.0
60,70,65,125,105,90,515,0.6911764705882353,74,94,131,54,116,20,489,0.4485294117647059,0.0
120,100,85,30,85,45,465,0.22448979591836735,100,100,100,100,100,100,600,0.8778625954198473,0.5
70,80,65,90,65,85,455,0.578125,50,50,150,50,150,50,500,0.2571428571428571,0.5
72,105,115,54,86,68,500,0.5149253731343284,35,40,100,90,55,35,355,0.1796875,1.0
100,123,75,57,75,80,510,0.6923076923076923,64,115,65,83,63,65,455,0.5323741007194245,0.0
60,50,70,80,80,140,480,0.8449612403100775,60,60,40,65,45,35,305,0.15833333333333333,0.0
